fra;vaccin;jour;n_dose1;n_dose2;n_dose3;n_dose4;n_complet;n_rappel;n_2_rappel;n_rappel_biv;n_3_rappel;n_cum_dose1;n_cum_dose2;n_cum_dose3;n_cum_dose4;n_cum_complet;n_cum_rappel;n_cum_2_rappel;n_cum_rappel_biv;n_cum_3_rappel
FR;1;2020-12-27;616;0;0;0;55;0;0;0;0;616;0;0;0;55;0;0;0;0
FR;1;2020-12-28;707;1;0;0;44;0;0;0;0;1323;1;0;0;99;0;0;0;0
FR;1;2020-12-29;389;0;0;0;19;0;0;0;0;1712;1;0;0;118;0;0;0;0
FR;1;2020-12-30;455;0;0;0;19;0;0;0;0;2167;1;0;0;137;0;0;0;0
FR;1;2020-12-31;450;1;0;0;21;0;0;0;0;2617;2;0;0;158;0;0;0;0
FR;1;2021-01-01;1193;2;0;0;66;0;0;0;0;3810;4;0;0;224;0;0;0;0
FR;1;2021-01-02;369;4;0;0;29;0;0;0;0;4179;8;0;0;253;0;0;0;0
FR;1;2021-01-03;418;0;0;0;23;0;0;0;0;4597;8;0;0;276;0;0;0;0
FR;1;2021-01-04;2145;5;0;0;51;0;0;0;0;6742;13;0;0;327;0;0;0;0
FR;1;2021-01-05;7778;6;0;0;128;0;0;0;0;14520;19;0;0;455;0;0;0;0
FR;1;2021-01-06;12479;23;0;0;128;0;0;0;0;26999;42;0;0;583;0;0;0;0
FR;1;2021-01-07;29480;24;0;0;159;0;0;0;0;56479;66;0;0;742;0;0;0;0
FR;1;2021-01-08;37170;35;0;0;204;0;0;0;0;93649;101;0;0;946;0;0;0;0
FR;1;2021-01-09;11220;9;0;0;77;0;0;0;0;104869;110;0;0;1023;0;0;0;0
FR;1;2021-01-10;6017;8;0;0;28;0;0;0;0;110886;118;0;0;1051;0;0;0;0
FR;1;2021-01-11;39956;39;0;0;232;0;0;0;0;150842;157;0;0;1283;0;0;0;0
FR;1;2021-01-12;62162;30;0;0;298;0;0;0;0;213004;187;0;0;1581;0;0;0;0
FR;1;2021-01-13;65147;62;0;0;433;0;0;0;0;278151;249;0;0;2014;0;0;0;0
FR;1;2021-01-14;81471;261;0;0;958;0;0;0;0;359622;510;0;0;2972;0;0;0;0
FR;1;2021-01-15;68638;101;0;0;528;0;0;0;0;428260;611;0;0;3500;0;0;0;0
FR;1;2021-01-16;19903;73;0;0;171;0;0;0;0;448163;684;0;0;3671;0;0;0;0
FR;1;2021-01-17;10909;54;0;0;130;0;0;0;0;459072;738;0;0;3801;0;0;0;0
FR;1;2021-01-18;82848;176;0;0;587;0;0;0;0;541920;914;0;0;4388;0;0;0;0
FR;1;2021-01-19;125935;209;0;0;837;0;0;0;0;667855;1123;0;0;5225;0;0;0;0
FR;1;2021-01-20;132438;190;0;0;779;0;0;0;0;800293;1313;0;0;6004;0;0;0;0
FR;1;2021-01-21;153085;196;0;0;896;0;0;0;0;953378;1509;0;0;6900;0;0;0;0
FR;1;2021-01-22;115971;239;0;0;775;0;0;0;0;1069349;1748;0;0;7675;0;0;0;0
FR;1;2021-01-23;36617;84;0;0;207;0;0;0;0;1105966;1832;0;0;7882;0;0;0;0
FR;1;2021-01-24;9589;128;0;0;187;0;0;0;0;1115555;1960;0;0;8069;0;0;0;0
FR;1;2021-01-25;74442;1453;0;0;1771;0;0;0;0;1189997;3413;0;0;9840;0;0;0;0
FR;1;2021-01-26;96471;3702;1;0;4143;0;0;0;0;1286468;7115;1;0;13983;0;0;0;0
FR;1;2021-01-27;103660;6440;0;0;7124;0;0;0;0;1390128;13555;1;0;21107;0;0;0;0
FR;1;2021-01-28;120627;16407;0;0;17196;0;0;0;0;1510755;29962;1;0;38303;0;0;0;0
FR;1;2021-01-29;88901;18800;0;0;19341;0;0;0;0;1599656;48762;1;0;57644;0;0;0;0
FR;1;2021-01-30;27995;4532;0;0;4656;0;0;0;0;1627651;53294;1;0;62300;0;0;0;0
FR;1;2021-01-31;5194;1898;0;0;1936;0;0;0;0;1632845;55192;1;0;64236;0;0;0;0
FR;1;2021-02-01;49752;23035;0;0;23277;0;0;0;0;1682597;78227;1;0;87513;0;0;0;0
FR;1;2021-02-02;67838;38188;0;0;38646;0;0;0;0;1750435;116415;1;0;126159;0;0;0;0
FR;1;2021-02-03;67105;40236;0;0;40671;0;0;0;0;1817540;156651;1;0;166830;0;0;0;0
FR;1;2021-02-04;77155;55112;0;0;55683;0;0;0;0;1894695;211763;1;0;222513;0;0;0;0
FR;1;2021-02-05;63435;48226;0;0;48631;0;0;0;0;1958130;259989;1;0;271144;0;0;0;0
FR;1;2021-02-06;19428;11420;0;0;11527;0;0;0;0;1977558;271409;1;0;282671;0;0;0;0
FR;1;2021-02-07;3669;6065;0;0;6092;0;0;0;0;1981227;277474;1;0;288763;0;0;0;0
FR;1;2021-02-08;36507;48767;0;0;49020;0;0;0;0;2017734;326241;1;0;337783;0;0;0;0
FR;1;2021-02-09;50827;78418;0;0;78944;0;0;0;0;2068561;404659;1;0;416727;0;0;0;0
FR;1;2021-02-10;52088;83438;0;0;83921;0;0;0;0;2120649;488097;1;0;500648;0;0;0;0
FR;1;2021-02-11;63396;105513;0;0;106422;0;0;0;0;2184045;593610;1;0;607070;0;0;0;0
FR;1;2021-02-12;55886;75812;0;0;76498;0;0;0;0;2239931;669422;1;0;683568;0;0;0;0
FR;1;2021-02-13;15470;19311;0;0;19423;0;0;0;0;2255401;688733;1;0;702991;0;0;0;0
FR;1;2021-02-14;3747;7322;0;0;7388;0;0;0;0;2259148;696055;1;0;710379;0;0;0;0
FR;1;2021-02-15;24175;73663;0;0;73921;0;0;0;0;2283323;769718;1;0;784300;0;0;0;0
FR;1;2021-02-16;32788;95519;0;0;95930;0;0;0;0;2316111;865237;1;0;880230;0;0;0;0
FR;1;2021-02-17;35139;102377;20;0;103034;0;0;0;0;2351250;967614;21;0;983264;0;0;0;0
FR;1;2021-02-18;49465;118546;0;0;119542;0;0;0;0;2400715;1086160;21;0;1102806;0;0;0;0
FR;1;2021-02-19;45400;87840;1;0;88784;0;0;0;0;2446115;1174000;22;0;1191590;0;0;0;0
FR;1;2021-02-20;13398;27027;0;0;27203;0;0;0;0;2459513;1201027;22;0;1218793;0;0;0;0
FR;1;2021-02-21;2471;5945;0;0;6013;0;0;0;0;2461984;1206972;22;0;1224806;0;0;0;0
FR;1;2021-02-22;24727;69392;2;0;69691;0;0;0;0;2486711;1276364;24;0;1294497;0;0;0;0
FR;1;2021-02-23;37441;81549;1;0;82253;0;0;0;0;2524152;1357913;25;0;1376750;0;0;0;0
FR;1;2021-02-24;40717;79372;1;0;80072;0;0;0;0;2564869;1437285;26;0;1456822;0;0;0;0
FR;1;2021-02-25;50175;87706;1;0;88803;0;0;0;0;2615044;1524991;27;0;1545625;0;0;0;0
FR;1;2021-02-26;47234;67563;1;0;68451;0;0;0;0;2662278;1592554;28;0;1614076;0;0;0;0
FR;1;2021-02-27;15691;21359;1;0;21571;0;0;0;0;2677969;1613913;29;0;1635647;0;0;0;0
FR;1;2021-02-28;3566;4104;2;0;4177;0;0;0;0;2681535;1618017;31;0;1639824;0;0;0;0
FR;1;2021-03-01;40231;50281;1;0;51017;0;0;0;0;2721766;1668298;32;0;1690841;0;0;0;0
FR;1;2021-03-02;55995;62421;3;0;63601;0;0;0;0;2777761;1730719;35;0;1754442;0;0;0;0
FR;1;2021-03-03;61271;60503;0;0;61940;0;0;0;0;2839032;1791222;35;0;1816382;0;0;0;0
FR;1;2021-03-04;73022;68392;3;0;70609;0;0;0;0;2912054;1859614;38;0;1886991;0;0;0;0
FR;1;2021-03-05;74786;58605;3;0;60505;0;0;0;0;2986840;1918219;41;0;1947496;0;0;0;0
FR;1;2021-03-06;82475;15735;2;0;17443;0;0;0;0;3069315;1933954;43;0;1964939;0;0;0;0
FR;1;2021-03-07;63734;3919;1;0;5463;0;0;0;0;3133049;1937873;44;0;1970402;0;0;0;0
FR;1;2021-03-08;60200;41136;2;0;42422;0;0;0;0;3193249;1979009;46;0;2012824;0;0;0;0
FR;1;2021-03-09;86015;47359;1;0;49358;0;0;0;0;3279264;2026368;47;0;2062182;0;0;0;0
FR;1;2021-03-10;90949;47741;5;0;50013;0;0;0;0;3370213;2074109;52;0;2112195;0;0;0;0
FR;1;2021-03-11;105107;54591;1;0;57668;0;0;0;0;3475320;2128700;53;0;2169863;0;0;0;0
FR;1;2021-03-12;104169;44880;1;0;47877;0;0;0;0;3579489;2173580;54;0;2217740;0;0;0;0
FR;1;2021-03-13;89226;12579;1;0;14796;0;0;0;0;3668715;2186159;55;0;2232536;0;0;0;0
FR;1;2021-03-14;44462;2658;1;0;3991;0;0;0;0;3713177;2188817;56;0;2236527;0;0;0;0
FR;1;2021-03-15;95538;27942;3;0;30293;0;0;0;0;3808715;2216759;59;0;2266820;0;0;0;0
FR;1;2021-03-16;123607;34033;5;0;37580;0;0;0;0;3932322;2250792;64;0;2304400;0;0;0;0
FR;1;2021-03-17;129327;33513;4;0;37567;0;0;0;0;4061649;2284305;68;0;2341967;0;0;0;0
FR;1;2021-03-18;142918;39154;5;0;43832;0;0;0;0;4204567;2323459;73;0;2385799;0;0;0;0
FR;1;2021-03-19;136282;32011;2;0;36602;0;0;0;0;4340849;2355470;75;0;2422401;0;0;0;0
FR;1;2021-03-20;76026;9747;1;0;11964;0;0;0;0;4416875;2365217;76;0;2434365;0;0;0;0
FR;1;2021-03-21;26522;1972;1;0;2961;0;0;0;0;4443397;2367189;77;0;2437326;0;0;0;0
FR;1;2021-03-22;114783;30210;2;0;34041;0;0;0;0;4558180;2397399;79;0;2471367;0;0;0;0
FR;1;2021-03-23;143063;38000;1;0;42791;0;0;0;0;4701243;2435399;80;0;2514158;0;0;0;0
FR;1;2021-03-24;142030;38401;0;0;43271;0;0;0;0;4843273;2473800;80;0;2557429;0;0;0;0
FR;1;2021-03-25;165045;39882;4;0;46046;0;0;0;0;5008318;2513682;84;0;2603475;0;0;0;0
FR;1;2021-03-26;166426;37407;5;1;44028;0;0;0;0;5174744;2551089;89;1;2647503;0;0;0;0
FR;1;2021-03-27;110909;15484;1;0;19495;0;0;0;0;5285653;2566573;90;1;2666998;0;0;0;0
FR;1;2021-03-28;42315;4431;3;0;5986;0;0;0;0;5327968;2571004;93;1;2672984;0;0;0;0
FR;1;2021-03-29;129853;48966;4;0;53633;0;0;0;0;5457821;2619970;97;1;2726617;0;0;0;0
FR;1;2021-03-30;167765;63829;5;0;70840;0;0;0;0;5625586;2683799;102;1;2797457;0;0;0;0
FR;1;2021-03-31;170974;68015;4;0;75541;0;0;0;0;5796560;2751814;106;1;2872998;0;0;0;0
FR;1;2021-04-01;194888;84121;10;0;93629;0;0;0;0;5991448;2835935;116;1;2966627;0;0;0;0
FR;1;2021-04-02;164477;86899;7;0;94723;0;0;0;0;6155925;2922834;123;1;3061350;0;0;0;0
FR;1;2021-04-03;88262;58201;6;0;61749;0;0;0;0;6244187;2981035;129;1;3123099;0;0;0;0
FR;1;2021-04-04;33666;17734;0;0;19234;0;0;0;0;6277853;2998769;129;1;3142333;0;0;0;0
FR;1;2021-04-05;46432;9565;11;0;11442;0;0;0;0;6324285;3008334;140;1;3153775;0;0;0;0
FR;1;2021-04-06;160352;105670;17;0;112157;0;0;0;0;6484637;3114004;157;1;3265932;0;0;0;0
FR;1;2021-04-07;197042;108094;16;0;116932;0;0;0;0;6681679;3222098;173;1;3382864;0;0;0;0
FR;1;2021-04-08;222193;114352;14;0;125711;0;0;0;0;6903872;3336450;187;1;3508575;0;0;0;0
FR;1;2021-04-09;214620;108043;21;0;118940;0;0;0;0;7118492;3444493;208;1;3627515;0;0;0;0
FR;1;2021-04-10;117211;73238;14;0;78385;0;0;0;0;7235703;3517731;222;1;3705900;0;0;0;0
FR;1;2021-04-11;40903;29892;6;0;31796;0;0;0;0;7276606;3547623;228;1;3737696;0;0;0;0
FR;1;2021-04-12;168508;104585;46;0;111834;0;0;0;0;7445114;3652208;274;1;3849530;0;0;0;0
FR;1;2021-04-13;203854;127760;97;1;137109;0;0;0;0;7648968;3779968;371;2;3986639;0;0;0;0
FR;1;2021-04-14;208685;123029;208;0;133261;0;0;0;0;7857653;3902997;579;2;4119900;0;0;0;0
FR;1;2021-04-15;221747;128240;313;0;139288;0;0;0;0;8079400;4031237;892;2;4259188;0;0;0;0
FR;1;2021-04-16;206111;125786;309;0;135456;0;0;0;0;8285511;4157023;1201;2;4394644;0;0;0;0
FR;1;2021-04-17;122112;67117;103;0;72179;0;0;0;0;8407623;4224140;1304;2;4466823;0;0;0;0
FR;1;2021-04-18;35980;21012;42;0;22720;0;0;0;0;8443603;4245152;1346;2;4489543;0;0;0;0
FR;1;2021-04-19;163783;121611;432;0;129161;0;0;0;0;8607386;4366763;1778;2;4618704;0;0;0;0
FR;1;2021-04-20;189490;149795;531;0;158924;0;0;0;0;8796876;4516558;2309;2;4777628;0;0;0;0
FR;1;2021-04-21;194064;147783;760;0;157314;0;0;0;0;8990940;4664341;3069;2;4934942;0;0;0;0
FR;1;2021-04-22;209084;164616;779;0;175848;0;0;0;0;9200024;4828957;3848;2;5110790;0;0;0;0
FR;1;2021-04-23;198999;158142;671;0;169163;0;0;0;0;9399023;4987099;4519;2;5279953;0;0;0;0
FR;1;2021-04-24;126354;95889;148;0;101958;0;0;0;0;9525377;5082988;4667;2;5381911;0;0;0;0
FR;1;2021-04-25;53642;30082;46;0;32839;0;0;0;0;9579019;5113070;4713;2;5414750;0;0;0;0
FR;1;2021-04-26;181174;140327;543;0;149047;0;0;0;0;9760193;5253397;5256;2;5563797;0;0;0;0
FR;1;2021-04-27;221405;162612;901;0;173988;0;0;0;0;9981598;5416009;6157;2;5737785;0;0;0;0
FR;1;2021-04-28;238356;156225;1314;1;168907;1;0;0;0;10219954;5572234;7471;3;5906692;1;0;0;0
FR;1;2021-04-29;270351;161676;1211;0;177283;0;0;0;0;10490305;5733910;8682;3;6083975;1;0;0;0
FR;1;2021-04-30;272029;149041;1074;0;165142;0;0;0;0;10762334;5882951;9756;3;6249117;1;0;0;0
FR;1;2021-05-01;141181;40614;173;0;48642;0;0;0;0;10903515;5923565;9929;3;6297759;1;0;0;0
FR;1;2021-05-02;81564;28240;81;0;32996;0;0;0;0;10985079;5951805;10010;3;6330755;1;0;0;0
FR;1;2021-05-03;250824;142082;803;0;155777;0;0;0;0;11235903;6093887;10813;3;6486532;1;0;0;0
FR;1;2021-05-04;265939;188047;1204;0;203620;0;0;0;0;11501842;6281934;12017;3;6690152;1;0;0;0
FR;1;2021-05-05;283971;186300;1268;0;202964;0;0;0;0;11785813;6468234;13285;3;6893116;1;0;0;0
FR;1;2021-05-06;310052;184595;1502;0;204349;0;0;0;0;12095865;6652829;14787;3;7097465;1;0;0;0
FR;1;2021-05-07;284152;196757;1127;0;214578;0;0;0;0;12380017;6849586;15914;3;7312043;1;0;0;0
FR;1;2021-05-08;191686;51617;285;0;63001;0;0;0;0;12571703;6901203;16199;3;7375044;1;0;0;0
FR;1;2021-05-09;114075;34214;236;0;41386;0;0;0;0;12685778;6935417;16435;3;7416430;1;0;0;0
FR;1;2021-05-10;258241;195094;1188;0;211089;0;0;0;0;12944019;7130511;17623;3;7627519;1;0;0;0
FR;1;2021-05-11;318945;211249;1465;0;231489;0;0;0;0;13262964;7341760;19088;3;7859008;1;0;0;0
FR;1;2021-05-12;356698;186098;1401;0;208404;0;0;0;0;13619662;7527858;20489;3;8067412;1;0;0;0
FR;1;2021-05-13;283472;47324;401;0;64248;0;0;0;0;13903134;7575182;20890;3;8131660;1;0;0;0
FR;1;2021-05-14;370543;128528;998;0;151948;0;0;0;0;14273677;7703710;21888;3;8283608;1;0;0;0
FR;1;2021-05-15;298126;66208;404;0;84916;0;0;0;0;14571803;7769918;22292;3;8368524;1;0;0;0
FR;1;2021-05-16;157795;15470;158;0;26038;0;0;0;0;14729598;7785388;22450;3;8394562;1;0;0;0
FR;1;2021-05-17;318957;116204;1441;0;138167;0;0;0;0;15048555;7901592;23891;3;8532729;1;0;0;0
FR;1;2021-05-18;383393;111697;1801;0;137648;0;0;0;0;15431948;8013289;25692;3;8670377;1;0;0;0
FR;1;2021-05-19;395318;101552;2185;0;128492;0;0;0;0;15827266;8114841;27877;3;8798869;1;0;0;0
FR;1;2021-05-20;421861;95617;2049;0;125084;0;0;0;0;16249127;8210458;29926;3;8923953;1;0;0;0
FR;1;2021-05-21;399845;97447;1765;0;125850;0;0;0;0;16648972;8307905;31691;3;9049803;1;0;0;0
FR;1;2021-05-22;275711;41923;604;0;60949;0;0;0;0;16924683;8349828;32295;3;9110752;1;0;0;0
FR;1;2021-05-23;123033;10969;224;0;20572;0;0;0;0;17047716;8360797;32519;3;9131324;1;0;0;0
FR;1;2021-05-24;244028;26265;569;0;43793;0;0;0;0;17291744;8387062;33088;3;9175117;1;0;0;0
FR;1;2021-05-25;366247;131472;2115;1;158407;0;0;0;0;17657991;8518534;35203;4;9333524;1;0;0;0
FR;1;2021-05-26;380862;127523;1996;0;155849;0;0;0;0;18038853;8646057;37199;4;9489373;1;0;0;0
FR;1;2021-05-27;406203;128348;1978;0;158832;0;0;0;0;18445056;8774405;39177;4;9648205;1;0;0;0
FR;1;2021-05-28;366079;145709;1702;0;174272;0;0;0;0;18811135;8920114;40879;4;9822477;1;0;0;0
FR;1;2021-05-29;253851;81137;527;0;100337;0;0;0;0;19064986;9001251;41406;4;9922814;1;0;0;0
FR;1;2021-05-30;100983;22600;158;0;30834;0;0;0;0;19165969;9023851;41564;4;9953648;1;0;0;0
FR;1;2021-05-31;314352;149252;1287;1;172512;1;0;0;0;19480321;9173103;42851;5;10126160;2;0;0;0
FR;1;2021-06-01;361703;166430;1733;1;194134;1;0;0;0;19842024;9339533;44584;6;10320294;3;0;0;0
FR;1;2021-06-02;365436;154527;1798;0;184069;0;0;0;0;20207460;9494060;46382;6;10504363;3;0;0;0
FR;1;2021-06-03;391496;147431;1654;0;178405;0;0;0;0;20598956;9641491;48036;6;10682768;3;0;0;0
FR;1;2021-06-04;364144;175894;1496;1;205186;1;0;0;0;20963100;9817385;49532;7;10887954;4;0;0;0
FR;1;2021-06-05;258533;112821;597;0;133185;0;0;0;0;21221633;9930206;50129;7;11021139;4;0;0;0
FR;1;2021-06-06;126832;37554;216;0;48193;0;0;0;0;21348465;9967760;50345;7;11069332;4;0;0;0
FR;1;2021-06-07;301132;207771;1368;0;233047;0;0;0;0;21649597;10175531;51713;7;11302379;4;0;0;0
FR;1;2021-06-08;330904;221006;1645;0;248971;0;0;0;0;21980501;10396537;53358;7;11551350;4;0;0;0
FR;1;2021-06-09;336656;210951;1614;0;239711;0;0;0;0;22317157;10607488;54972;7;11791061;4;0;0;0
FR;1;2021-06-10;343946;199518;1615;0;229267;0;0;0;0;22661103;10807006;56587;7;12020328;4;0;0;0
FR;1;2021-06-11;311942;234706;1300;1;262618;0;0;0;0;22973045;11041712;57887;8;12282946;4;0;0;0
FR;1;2021-06-12;244100;150610;438;0;172221;0;0;0;0;23217145;11192322;58325;8;12455167;4;0;0;0
FR;1;2021-06-13;100383;61036;188;0;70698;0;0;0;0;23317528;11253358;58513;8;12525865;4;0;0;0
FR;1;2021-06-14;207878;287585;1320;1;307393;0;0;0;0;23525406;11540943;59833;9;12833258;4;0;0;0
FR;1;2021-06-15;256908;281124;1400;1;304974;0;0;0;0;23782314;11822067;61233;10;13138232;4;0;0;0
FR;1;2021-06-16;273687;270710;1264;1;296147;0;0;0;0;24056001;12092777;62497;11;13434379;4;0;0;0
FR;1;2021-06-17;268255;245093;1241;1;271164;0;0;0;0;24324256;12337870;63738;12;13705543;4;0;0;0
FR;1;2021-06-18;260625;295195;1155;1;321023;0;0;0;0;24584881;12633065;64893;13;14026566;4;0;0;0
FR;1;2021-06-19;193469;209609;388;0;228271;0;0;0;0;24778350;12842674;65281;13;14254837;4;0;0;0
FR;1;2021-06-20;69724;89031;122;0;96872;0;0;0;0;24848074;12931705;65403;13;14351709;4;0;0;0
FR;1;2021-06-21;172399;319786;934;1;338497;1;0;0;0;25020473;13251491;66337;14;14690206;5;0;0;0
FR;1;2021-06-22;185898;348071;1102;10;369136;1;0;0;0;25206371;13599562;67439;24;15059342;6;0;0;0
FR;1;2021-06-23;204242;339648;1050;0;363547;0;0;0;0;25410613;13939210;68489;24;15422889;6;0;0;0
FR;1;2021-06-24;203557;282077;1176;0;306822;0;0;0;0;25614170;14221287;69665;24;15729711;6;0;0;0
FR;1;2021-06-25;182684;371701;1200;0;395706;0;0;0;0;25796854;14592988;70865;24;16125417;6;0;0;0
FR;1;2021-06-26;131415;278607;506;0;295983;0;0;0;0;25928269;14871595;71371;24;16421400;6;0;0;0
FR;1;2021-06-27;52421;122846;146;0;130383;0;0;0;0;25980690;14994441;71517;24;16551783;6;0;0;0
FR;1;2021-06-28;136682;368238;1066;0;386839;0;0;0;0;26117372;15362679;72583;24;16938622;6;0;0;0
FR;1;2021-06-29;154924;391152;1849;0;412249;0;0;0;0;26272296;15753831;74432;24;17350871;6;0;0;0
FR;1;2021-06-30;180076;381952;1668;4;406554;2;0;0;0;26452372;16135783;76100;28;17757425;8;0;0;0
FR;1;2021-07-01;201589;332505;1890;5;360580;0;0;0;0;26653961;16468288;77990;33;18118005;8;0;0;0
FR;1;2021-07-02;193891;367286;1765;5;395487;2;0;0;0;26847852;16835574;79755;38;18513492;10;0;0;0
FR;1;2021-07-03;124485;280411;704;3;299517;1;0;0;0;26972337;17115985;80459;41;18813009;11;0;0;0
FR;1;2021-07-04;53969;113730;244;0;122137;0;0;0;0;27026306;17229715;80703;41;18935146;11;0;0;0
FR;1;2021-07-05;153985;355770;1500;8;379111;0;0;0;0;27180291;17585485;82203;49;19314257;11;0;0;0
FR;1;2021-07-06;173533;382276;1603;45;408166;8;0;0;0;27353824;17967761;83806;94;19722423;19;0;0;0
FR;1;2021-07-07;190872;362297;1659;25;390637;2;0;0;0;27544696;18330058;85465;119;20113060;21;0;0;0
FR;1;2021-07-08;201594;322962;1827;20;353609;2;0;0;0;27746290;18653020;87292;139;20466669;23;0;0;0
FR;1;2021-07-09;189994;387760;1854;3;418165;1;0;0;0;27936284;19040780;89146;142;20884834;24;0;0;0
FR;1;2021-07-10;129965;281180;818;1;302605;0;0;0;0;28066249;19321960;89964;143;21187439;24;0;0;0
FR;1;2021-07-11;57688;102528;263;0;112411;0;0;0;0;28123937;19424488;90227;143;21299850;24;0;0;0
FR;1;2021-07-12;149931;416800;1588;4;442791;0;0;0;0;28273868;19841288;91815;147;21742641;24;0;0;0
FR;1;2021-07-13;234309;438992;1808;8;476177;0;0;0;0;28508177;20280280;93623;155;22218818;24;0;0;0
FR;1;2021-07-14;171931;151303;418;0;176934;0;0;0;0;28680108;20431583;94041;155;22395752;24;0;0;0
FR;1;2021-07-15;279707;424130;1859;1;467104;0;0;0;0;28959815;20855713;95900;156;22862856;24;0;0;0
FR;1;2021-07-16;290445;400515;1711;3;445155;1;0;0;0;29250260;21256228;97611;159;23308011;25;0;0;0
FR;1;2021-07-17;217361;281973;755;1;315442;0;0;0;0;29467621;21538201;98366;160;23623453;25;0;0;0
FR;1;2021-07-18;102030;107204;288;0;123092;0;0;0;0;29569651;21645405;98654;160;23746545;25;0;0;0
FR;1;2021-07-19;238249;378362;1498;3;414407;0;0;0;0;29807900;22023767;100152;163;24160952;25;0;0;0
FR;1;2021-07-20;305777;379723;1471;0;425545;0;0;0;0;30113677;22403490;101623;163;24586497;25;0;0;0
FR;1;2021-07-21;333311;352704;1413;4;404074;1;0;0;0;30446988;22756194;103036;167;24990571;26;0;0;0
FR;1;2021-07-22;364708;318526;1502;3;374939;2;0;0;0;30811696;23074720;104538;170;25365510;28;0;0;0
FR;1;2021-07-23;349411;342717;1589;4;398256;1;0;0;0;31161107;23417437;106127;174;25763766;29;0;0;0
FR;1;2021-07-24;238967;240734;697;1;278061;0;0;0;0;31400074;23658171;106824;175;26041827;29;0;0;0
FR;1;2021-07-25;112810;76011;223;0;93706;0;0;0;0;31512884;23734182;107047;175;26135533;29;0;0;0
FR;1;2021-07-26;299149;289266;1495;2;334978;1;0;0;0;31812033;24023448;108542;177;26470511;30;0;0;0
FR;1;2021-07-27;385868;267855;1459;4;324825;1;0;0;0;32197901;24291303;110001;181;26795336;31;0;0;0
FR;1;2021-07-28;390228;250914;1463;4;307201;1;0;0;0;32588129;24542217;111464;185;27102537;32;0;0;0
FR;1;2021-07-29;406160;227574;1541;2;284270;0;0;0;0;32994289;24769791;113005;187;27386807;32;0;0;0
FR;1;2021-07-30;370761;246485;1639;4;298320;1;0;0;0;33365050;25016276;114644;191;27685127;33;0;0;0
FR;1;2021-07-31;243394;165089;794;1;199411;0;0;0;0;33608444;25181365;115438;192;27884538;33;0;0;0
FR;1;2021-08-01;105608;47204;237;0;61198;0;0;0;0;33714052;25228569;115675;192;27945736;33;0;0;0
FR;1;2021-08-02;297437;212826;1480;2;250611;0;0;0;0;34011489;25441395;117155;194;28196347;33;0;0;0
FR;1;2021-08-03;331353;208675;1557;2;250643;1;0;0;0;34342842;25650070;118712;196;28446990;34;0;0;0
FR;1;2021-08-04;328059;183817;1440;5;223971;3;0;0;0;34670901;25833887;120152;201;28670961;37;0;0;0
FR;1;2021-08-05;301299;193084;1483;0;229379;0;0;0;0;34972200;26026971;121635;201;28900340;37;0;0;0
FR;1;2021-08-06;290999;224079;1560;3;261366;0;0;0;0;35263199;26251050;123195;204;29161706;37;0;0;0
FR;1;2021-08-07;182685;158761;655;5;181670;1;0;0;0;35445884;26409811;123850;209;29343376;38;0;0;0
FR;1;2021-08-08;68896;59101;253;0;67629;0;0;0;0;35514780;26468912;124103;209;29411005;38;0;0;0
FR;1;2021-08-09;222801;235147;1446;4;263855;2;0;0;0;35737581;26704059;125549;213;29674860;40;0;0;0
FR;1;2021-08-10;252763;239823;1492;2;271655;0;0;0;0;35990344;26943882;127041;215;29946515;40;0;0;0
FR;1;2021-08-11;236255;231715;1272;5;261227;0;0;0;0;36226599;27175597;128313;220;30207742;40;0;0;0
FR;1;2021-08-12;220804;239728;1491;3;267819;0;0;0;0;36447403;27415325;129804;223;30475561;40;0;0;0
FR;1;2021-08-13;201731;238486;1360;2;264028;2;0;0;0;36649134;27653811;131164;225;30739589;42;0;0;0
FR;1;2021-08-14;122876;174029;645;0;189533;0;0;0;0;36772010;27827840;131809;225;30929122;42;0;0;0
FR;1;2021-08-15;34711;46114;201;1;50332;0;0;0;0;36806721;27873954;132010;226;30979454;42;0;0;0
FR;1;2021-08-16;156967;289321;1424;0;309889;0;0;0;0;36963688;28163275;133434;226;31289343;42;0;0;0
FR;1;2021-08-17;171626;290952;1422;5;313353;0;0;0;0;37135314;28454227;134856;231;31602696;42;0;0;0
FR;1;2021-08-18;161449;286668;1394;6;307297;3;0;0;0;37296763;28740895;136250;237;31909993;45;0;0;0
FR;1;2021-08-19;148961;277409;1405;1;297251;0;0;0;0;37445724;29018304;137655;238;32207244;45;0;0;0
FR;1;2021-08-20;140532;308913;1535;2;328145;2;0;0;0;37586256;29327217;139190;240;32535389;47;0;0;0
FR;1;2021-08-21;84284;213209;589;0;224528;0;0;0;0;37670540;29540426;139779;240;32759917;47;0;0;0
FR;1;2021-08-22;28584;82693;233;0;86698;0;0;0;0;37699124;29623119;140012;240;32846615;47;0;0;0
FR;1;2021-08-23;118672;320938;1422;2;337673;0;0;0;0;37817796;29944057;141434;242;33184288;47;0;0;0
FR;1;2021-08-24;126686;319603;1604;5;337420;0;0;0;0;37944482;30263660;143038;247;33521708;47;0;0;0
FR;1;2021-08-25;121547;306416;1783;8;323589;2;0;0;0;38066029;30570076;144821;255;33845297;49;0;0;0
FR;1;2021-08-26;106647;286078;2164;10;302377;0;0;0;0;38172676;30856154;146985;265;34147674;49;0;0;0
FR;1;2021-08-27;107657;321593;2303;9;338851;1;0;0;0;38280333;31177747;149288;274;34486525;50;0;0;0
FR;1;2021-08-28;71029;220699;1102;0;231220;0;0;0;0;38351362;31398446;150390;274;34717745;50;0;0;0
FR;1;2021-08-29;24156;78205;469;1;82095;0;0;0;0;38375518;31476651;150859;275;34799840;50;0;0;0
FR;1;2021-08-30;96905;286273;4315;6;299758;4968;0;0;0;38472423;31762924;155174;281;35099598;5018;0;0;0
FR;1;2021-08-31;98132;276227;9295;15;289895;10064;2;0;0;38570555;32039151;164469;296;35389493;15082;2;0;0
FR;1;2021-09-01;112367;245287;21121;8;257670;22157;1;0;0;38682922;32284438;185590;304;35647163;37239;3;0;0
FR;1;2021-09-02;86757;197900;24536;18;208296;25520;0;0;0;38769679;32482338;210126;322;35855459;62759;3;0;0
FR;1;2021-09-03;82431;227483;26958;21;238921;28037;0;0;0;38852110;32709821;237084;343;36094380;90796;3;0;0
FR;1;2021-09-04;71630;189716;11141;11;199299;11712;7;0;0;38923740;32899537;248225;354;36293679;102508;10;0;0
FR;1;2021-09-05;18614;41144;4126;2;43849;4277;0;0;0;38942354;32940681;252351;356;36337528;106785;10;0;0
FR;1;2021-09-06;59825;151363;30182;15;158894;31205;2;0;0;39002179;33092044;282533;371;36496422;137990;12;0;0
FR;1;2021-09-07;57401;139622;30214;30;146740;31253;2;0;0;39059580;33231666;312747;401;36643162;169243;14;0;0
FR;1;2021-09-08;72356;173796;26926;22;182269;27967;4;0;0;39131936;33405462;339673;423;36825431;197210;18;0;0
FR;1;2021-09-09;54513;124422;28637;24;131180;29748;5;0;0;39186449;33529884;368310;447;36956611;226958;23;0;0
FR;1;2021-09-10;66223;152066;30452;24;161153;31693;5;0;0;39252672;33681950;398762;471;37117764;258651;28;0;0
FR;1;2021-09-11;52689;146637;9732;14;154128;10357;0;0;0;39305361;33828587;408494;485;37271892;269008;28;0;0
FR;1;2021-09-12;10799;29269;2490;1;30967;2660;2;0;0;39316160;33857856;410984;486;37302859;271668;30;0;0
FR;1;2021-09-13;51518;104398;38767;31;110932;40096;16;0;0;39367678;33962254;449751;517;37413791;311764;46;0;0
FR;1;2021-09-14;53343;96006;51291;67;102376;53288;41;0;0;39421021;34058260;501042;584;37516167;365052;87;0;0
FR;1;2021-09-15;60588;139223;50498;55;146391;47069;68;0;0;39481609;34197483;551540;639;37662558;412121;155;0;0
FR;1;2021-09-16;46646;81366;53354;70;86261;49611;61;0;0;39528255;34278849;604894;709;37748819;461732;216;0;0
FR;1;2021-09-17;53226;109326;45081;61;115660;42713;62;0;0;39581481;34388175;649975;770;37864479;504445;278;0;0
FR;1;2021-09-18;37887;118496;11796;19;124081;11279;19;0;0;39619368;34506671;661771;789;37988560;515724;297;0;0
FR;1;2021-09-19;6531;21025;2044;1;22129;1984;1;0;0;39625899;34527696;663815;790;38010689;517708;298;0;0
FR;1;2021-09-20;36543;74841;46231;65;78562;44198;30;0;0;39662442;34602537;710046;855;38089251;561906;328;0;0
FR;1;2021-09-21;34208;68099;56270;72;71135;52746;76;0;0;39696650;34670636;766316;927;38160386;614652;404;0;0
FR;1;2021-09-22;38849;118598;49884;76;123018;46936;39;0;0;39735499;34789234;816200;1003;38283404;661588;443;0;0
FR;1;2021-09-23;32039;62888;54515;85;65791;50922;76;0;0;39767538;34852122;870715;1088;38349195;712510;519;0;0
FR;1;2021-09-24;36804;90025;43677;89;94384;41957;57;0;0;39804342;34942147;914392;1177;38443579;754467;576;0;0
FR;1;2021-09-25;27656;96709;12307;27;101065;12186;19;0;0;39831998;35038856;926699;1204;38544644;766653;595;0;0
FR;1;2021-09-26;4390;15202;1777;5;16066;1700;4;0;0;39836388;35054058;928476;1209;38560710;768353;599;0;0
FR;1;2021-09-27;27356;60204;42914;89;63433;41644;79;0;1;39863744;35114262;971390;1298;38624143;809997;678;0;1
FR;1;2021-09-28;26914;49418;47207;76;52036;44494;40;0;0;39890658;35163680;1018597;1374;38676179;854491;718;0;1
FR;1;2021-09-29;35927;80253;47297;87;84640;45623;33;0;0;39926585;35243933;1065894;1461;38760819;900114;751;0;1
FR;1;2021-09-30;26078;46897;47527;80;49256;45476;52;0;0;39952663;35290830;1113421;1541;38810075;945590;803;0;1
FR;1;2021-10-01;47306;66911;44908;83;70793;44633;14;0;0;39999969;35357741;1158329;1624;38880868;990223;817;0;1
FR;1;2021-10-02;32383;62413;16114;32;67221;16325;6;0;0;40032352;35420154;1174443;1656;38948089;1006548;823;0;1
FR;1;2021-10-03;4343;8564;2043;3;9312;2039;4;0;0;40036695;35428718;1176486;1659;38957401;1008587;827;0;1
FR;1;2021-10-04;28983;44423;47114;79;46837;46982;31;0;0;40065678;35473141;1223600;1738;39004238;1055569;858;0;1
FR;1;2021-10-05;24576;41638;49894;116;43135;49351;47;0;0;40090254;35514779;1273494;1854;39047373;1104920;905;0;1
FR;1;2021-10-06;34659;61386;57510;101;64495;57264;25;0;0;40124913;35576165;1331004;1955;39111868;1162184;930;0;1
FR;1;2021-10-07;21083;39913;53052;74;41092;51997;32;0;0;40145996;35616078;1384056;2029;39152960;1214181;962;0;1
FR;1;2021-10-08;35672;59642;60412;83;62869;61170;28;0;0;40181668;35675720;1444468;2112;39215829;1275351;990;0;1
FR;1;2021-10-09;27466;48024;25498;29;52493;26028;10;0;0;40209134;35723744;1469966;2141;39268322;1301379;1000;0;1
FR;1;2021-10-10;3728;5810;2759;7;6289;2865;1;0;0;40212862;35729554;1472725;2148;39274611;1304244;1001;0;1
FR;1;2021-10-11;24858;38212;54589;88;40296;55270;44;0;0;40237720;35767766;1527314;2236;39314907;1359514;1045;0;1
FR;1;2021-10-12;23386;36589;58078;128;37089;59240;18;0;0;40261106;35804355;1585392;2364;39351996;1418754;1063;0;1
FR;1;2021-10-13;32974;47843;64177;125;50647;65704;22;0;1;40294080;35852198;1649569;2489;39402643;1484458;1085;0;2
FR;1;2021-10-14;21715;34774;53776;103;35680;54370;24;0;0;40315795;35886972;1703345;2592;39438323;1538828;1109;0;2
FR;1;2021-10-15;32755;48761;72338;165;50454;75035;22;0;0;40348550;35935733;1775683;2757;39488777;1613863;1131;0;2
FR;1;2021-10-16;26014;35284;34874;45;38300;36431;13;0;0;40374564;35971017;1810557;2802;39527077;1650294;1144;0;2
FR;1;2021-10-17;3161;4052;3418;2;4495;3319;3;0;0;40377725;35975069;1813975;2804;39531572;1653613;1147;0;2
FR;1;2021-10-18;24353;34875;66850;132;34913;69734;27;0;0;40402078;36009944;1880825;2936;39566485;1723347;1174;0;2
FR;1;2021-10-19;20724;35571;75677;135;33223;79609;40;0;0;40422802;36045515;1956502;3071;39599708;1802956;1214;0;2
FR;1;2021-10-20;29917;44203;96190;178;43277;99881;45;0;0;40452719;36089718;2052692;3249;39642985;1902837;1259;0;2
FR;1;2021-10-21;19804;35052;83200;107;31763;87063;29;0;0;40472523;36124770;2135892;3356;39674748;1989900;1288;0;2
FR;1;2021-10-22;29756;47759;103757;196;44555;109723;58;0;0;40502279;36172529;2239649;3552;39719303;2099623;1346;0;2
FR;1;2021-10-23;23055;35140;44876;57;36130;47386;11;0;0;40525334;36207669;2284525;3609;39755433;2147009;1357;0;2
FR;1;2021-10-24;2406;3843;3584;6;4043;3717;1;0;0;40527740;36211512;2288109;3615;39759476;2150726;1358;0;2
FR;1;2021-10-25;22504;30715;82031;143;29597;85840;36;0;0;40550244;36242227;2370140;3758;39789073;2236566;1394;0;2
FR;1;2021-10-26;19368;27644;86123;162;24738;90355;29;0;0;40569612;36269871;2456263;3920;39813811;2326921;1423;0;2
FR;1;2021-10-27;26224;39612;107826;252;37305;112740;45;0;0;40595836;36309483;2564089;4172;39851116;2439661;1468;0;2
FR;1;2021-10-28;18803;27109;86968;150;23483;91736;34;0;0;40614639;36336592;2651057;4322;39874599;2531397;1502;0;2
FR;1;2021-10-29;25936;40254;114844;202;35491;121680;49;0;0;40640575;36376846;2765901;4524;39910090;2653077;1551;0;2
FR;1;2021-10-30;17713;28718;49372;74;28303;51969;18;0;0;40658288;36405564;2815273;4598;39938393;2705046;1569;0;2
FR;1;2021-10-31;2088;3169;3452;2;3215;3686;2;0;0;40660376;36408733;2818725;4600;39941608;2708732;1571;0;2
FR;1;2021-11-01;8025;4274;3036;3;4358;3293;6;0;0;40668401;36413007;2821761;4603;39945966;2712025;1577;0;2
FR;1;2021-11-02;22917;33218;92416;156;29172;97870;39;0;1;40691318;36446225;2914177;4759;39975138;2809895;1616;0;3
FR;1;2021-11-03;26638;41548;117525;219;36997;123910;56;0;0;40717956;36487773;3031702;4978;40012135;2933805;1672;0;3
FR;1;2021-11-04;19629;30287;105825;213;24184;111969;42;0;0;40737585;36518060;3137527;5191;40036319;3045774;1714;0;3
FR;1;2021-11-05;27030;42296;138800;230;34176;147490;47;0;0;40764615;36560356;3276327;5421;40070495;3193264;1761;0;3
FR;1;2021-11-06;18865;29807;63501;123;27607;66521;24;0;0;40783480;36590163;3339828;5544;40098102;3259785;1785;0;3
FR;1;2021-11-07;1834;3267;4985;6;3024;5302;5;0;0;40785314;36593430;3344813;5550;40101126;3265087;1790;0;3
FR;1;2021-11-08;17881;32245;126020;224;25389;132657;47;0;0;40803195;36625675;3470833;5774;40126515;3397744;1837;0;3
FR;1;2021-11-09;19521;37603;159329;334;26128;169153;63;0;0;40822716;36663278;3630162;6108;40152643;3566897;1900;0;3
FR;1;2021-11-10;28893;49050;181930;441;39012;192549;82;0;0;40851609;36712328;3812092;6549;40191655;3759446;1982;0;3
FR;1;2021-11-11;4191;5930;12239;26;5106;13029;14;0;0;40855800;36718258;3824331;6575;40196761;3772475;1996;0;3
FR;1;2021-11-12;26025;46825;174849;244;35292;186550;76;0;0;40881825;36765083;3999180;6819;40232053;3959025;2072;0;3
FR;1;2021-11-13;18736;29143;76847;111;25369;81792;40;0;0;40900561;36794226;4076027;6930;40257422;4040817;2112;0;3
FR;1;2021-11-14;2051;3241;6827;5;2796;7358;6;0;0;40902612;36797467;4082854;6935;40260218;4048175;2118;0;3
FR;1;2021-11-15;18797;34709;156448;306;24617;166285;59;0;0;40921409;36832176;4239302;7241;40284835;4214460;2177;0;3
FR;1;2021-11-16;21369;37813;192163;380;23319;205080;99;0;1;40942778;36869989;4431465;7621;40308154;4419540;2276;0;4
FR;1;2021-11-17;28674;45551;193256;398;33024;205080;92;0;0;40971452;36915540;4624721;8019;40341178;4624620;2368;0;4
FR;1;2021-11-18;21147;39598;182541;459;25137;194669;85;0;0;40992599;36955138;4807262;8478;40366315;4819289;2453;0;4
FR;1;2021-11-19;30894;53320;230285;532;34816;246781;135;0;0;41023493;37008458;5037547;9010;40401131;5066070;2588;0;4
FR;1;2021-11-20;23776;33216;97001;202;26733;103657;40;0;0;41047269;37041674;5134548;9212;40427864;5169727;2628;0;4
FR;1;2021-11-21;2342;3907;9133;19;2956;9939;16;0;0;41049611;37045581;5143681;9231;40430820;5179666;2644;0;4
FR;1;2021-11-22;21426;30326;175933;467;16945;189480;79;0;0;41071037;37075907;5319614;9698;40447765;5369146;2723;0;4
FR;1;2021-11-23;24031;40971;221266;540;21320;238019;77;0;0;41095068;37116878;5540880;10238;40469085;5607165;2800;0;4
FR;1;2021-11-24;30298;49644;217402;701;31965;234585;67;0;0;41125366;37166522;5758282;10939;40501050;5841750;2867;0;4
FR;1;2021-11-25;23733;44043;244524;718;22072;264224;101;0;0;41149099;37210565;6002806;11657;40523122;6105974;2968;0;4
FR;1;2021-11-26;30618;66636;356843;836;33239;388629;154;0;0;41179717;37277201;6359649;12493;40556361;6494603;3122;0;4
FR;1;2021-11-27;21960;45263;202665;372;26152;222696;112;0;0;41201677;37322464;6562314;12865;40582513;6717299;3234;0;4
FR;1;2021-11-28;3180;9544;54803;63;3467;61016;37;0;0;41204857;37332008;6617117;12928;40585980;6778315;3271;0;4
FR;1;2021-11-29;17904;49467;326434;841;20775;354580;150;0;0;41222761;37381475;6943551;13769;40606755;7132895;3421;0;4
FR;1;2021-11-30;22790;64816;431195;952;23799;470841;266;0;0;41245551;37446291;7374746;14721;40630554;7603736;3687;0;4
FR;1;2021-12-01;25363;69038;442955;1131;28428;481821;271;0;0;41270914;37515329;7817701;15852;40658982;8085557;3958;0;4
FR;1;2021-12-02;20091;64301;489464;1230;18434;532971;274;0;0;41291005;37579630;8307165;17082;40677416;8618528;4232;0;4
FR;1;2021-12-03;22913;82305;542840;1310;30277;591855;308;0;0;41313918;37661935;8850005;18392;40707693;9210383;4540;0;4
FR;1;2021-12-04;16417;53781;299137;654;23207;328996;180;0;0;41330335;37715716;9149142;19046;40730900;9539379;4720;0;4
FR;1;2021-12-05;3635;13775;81548;143;4196;91046;85;0;0;41333970;37729491;9230690;19189;40735096;9630425;4805;0;4
FR;1;2021-12-06;25847;62419;415524;1066;22062;455252;356;0;0;41359817;37791910;9646214;20255;40757158;10085677;5161;0;4
FR;1;2021-12-07;20019;75458;523077;1536;24274;572740;372;0;0;41379836;37867368;10169291;21791;40781432;10658417;5533;0;4
FR;1;2021-12-08;21717;75484;458556;1545;30642;502213;378;0;0;41401553;37942852;10627847;23336;40812074;11160630;5911;0;4
FR;1;2021-12-09;19473;73945;493099;1624;24328;541115;398;0;0;41421026;38016797;11120946;24960;40836402;11701745;6309;0;4
FR;1;2021-12-10;23330;87516;547469;1585;32416;600109;392;0;1;41444356;38104313;11668415;26545;40868818;12301854;6701;0;5
FR;1;2021-12-11;16531;59083;302768;751;25944;335501;278;0;0;41460887;38163396;11971183;27296;40894762;12637355;6979;0;5
FR;1;2021-12-12;4397;15876;83240;179;5243;94045;96;0;0;41465284;38179272;12054423;27475;40900005;12731400;7075;0;5
FR;1;2021-12-13;15761;63400;367086;1094;23906;406372;236;0;0;41481045;38242672;12421509;28569;40923911;13137772;7311;0;5
FR;1;2021-12-14;20870;80115;464896;1748;28643;515355;506;0;1;41501915;38322787;12886405;30317;40952554;13653127;7817;0;6
FR;1;2021-12-15;21631;77294;409185;1309;33009;453258;311;0;1;41523546;38400081;13295590;31626;40985563;14106385;8128;0;7
FR;1;2021-12-16;20070;77052;452006;1577;27921;500744;324;0;0;41543616;38477133;13747596;33203;41013484;14607129;8452;0;7
FR;1;2021-12-17;22628;86369;480027;1737;34639;531052;372;0;0;41566244;38563502;14227623;34940;41048123;15138181;8824;0;7
FR;1;2021-12-18;17610;54550;257660;731;24686;288528;232;0;0;41583854;38618052;14485283;35671;41072809;15426709;9056;0;7
FR;1;2021-12-19;5563;16910;79205;194;5920;90680;117;0;0;41589417;38634962;14564488;35865;41078729;15517389;9173;0;7
FR;1;2021-12-20;20957;62874;316303;1082;26493;355335;286;0;0;41610374;38697836;14880791;36947;41105222;15872724;9459;0;7
FR;1;2021-12-21;26342;72862;372821;1422;30557;418146;338;0;0;41636716;38770698;15253612;38369;41135779;16290870;9797;0;7
FR;1;2021-12-22;24989;65648;310703;1217;29577;349627;361;0;1;41661705;38836346;15564315;39586;41165356;16640497;10158;0;8
FR;1;2021-12-23;21276;52109;241541;958;23344;273075;362;0;0;41682981;38888455;15805856;40544;41188700;16913572;10520;0;8
FR;1;2021-12-24;7130;18266;67173;258;9244;77064;154;0;1;41690111;38906721;15873029;40802;41197944;16990636;10674;0;9
FR;1;2021-12-25;509;2865;5595;15;1796;6540;55;0;0;41690620;38909586;15878624;40817;41199740;16997176;10729;0;9
FR;1;2021-12-26;2751;7569;26960;71;3493;31470;100;0;0;41693371;38917155;15905584;40888;41203233;17028646;10829;0;9
FR;1;2021-12-27;18312;53464;235147;705;25454;265805;365;0;0;41711683;38970619;16140731;41593;41228687;17294451;11194;0;9
FR;1;2021-12-28;23302;61878;292070;1026;26986;330242;595;0;1;41734985;39032497;16432801;42619;41255673;17624693;11789;0;10
FR;1;2021-12-29;22218;55373;255047;921;25257;288244;645;0;1;41757203;39087870;16687848;43540;41280930;17912937;12434;0;11
FR;1;2021-12-30;21240;46405;212184;857;22440;239633;718;0;0;41778443;39134275;16900032;44397;41303370;18152570;13152;0;11
FR;1;2021-12-31;7468;16536;61881;229;8714;70416;346;0;0;41785911;39150811;16961913;44626;41312084;18222986;13498;0;11
FR;1;2022-01-01;1167;2488;5668;30;1543;6576;73;0;0;41787078;39153299;16967581;44656;41313627;18229562;13571;0;11
FR;1;2022-01-02;3088;8074;28897;50;3671;33539;190;0;0;41790166;39161373;16996478;44706;41317298;18263101;13761;0;11
FR;1;2022-01-03;26781;54164;228287;790;27531;257748;964;0;1;41816947;39215537;17224765;45496;41344829;18520849;14725;0;12
FR;1;2022-01-04;26326;64976;299320;1241;29775;337366;1367;0;2;41843273;39280513;17524085;46737;41374604;18858215;16092;0;14
FR;1;2022-01-05;30565;64242;274931;1099;32510;310310;1264;0;0;41873838;39344755;17799016;47836;41407114;19168525;17356;0;14
FR;1;2022-01-06;26859;66191;306954;1404;29267;346626;1569;0;1;41900697;39410946;18105970;49240;41436381;19515151;18925;0;15
FR;1;2022-01-07;31579;74963;349878;1538;34387;394008;1822;0;1;41932276;39485909;18455848;50778;41470768;19909159;20747;0;16
FR;1;2022-01-08;23390;51357;222511;698;25571;251139;913;0;1;41955666;39537266;18678359;51476;41496339;20160298;21660;0;17
FR;1;2022-01-09;7091;17133;66036;163;8166;76143;336;0;0;41962757;39554399;18744395;51639;41504505;20236441;21996;0;17
FR;1;2022-01-10;21811;60579;236837;957;32915;267630;1258;0;1;41984568;39614978;18981232;52596;41537420;20504071;23254;0;18
FR;1;2022-01-11;26777;63431;282345;1280;31193;317861;1837;0;1;42011345;39678409;19263577;53876;41568613;20821932;25091;0;19
FR;1;2022-01-12;28966;62480;246303;1106;35042;278093;1686;0;3;42040311;39740889;19509880;54982;41603655;21100025;26777;0;22
FR;1;2022-01-13;24789;60151;262842;1253;30022;296163;1993;0;4;42065100;39801040;19772722;56235;41633677;21396188;28770;0;26
FR;1;2022-01-14;27971;66684;314051;1366;32105;351304;2475;0;1;42093071;39867724;20086773;57601;41665782;21747492;31245;0;27
FR;1;2022-01-15;19372;44407;199332;619;22463;223868;1363;0;1;42112443;39912131;20286105;58220;41688245;21971360;32608;0;28
FR;1;2022-01-16;5161;12956;51536;135;6020;59557;338;0;0;42117604;39925087;20337641;58355;41694265;22030917;32946;0;28
FR;1;2022-01-17;16884;39665;184863;783;20113;206843;1690;0;2;42134488;39964752;20522504;59138;41714378;22237760;34636;0;30
FR;1;2022-01-18;19461;45960;212457;1154;22988;237057;2456;0;1;42153949;40010712;20734961;60292;41737366;22474817;37092;0;31
FR;1;2022-01-19;20314;43940;176148;898;25466;197204;1977;0;4;42174263;40054652;20911109;61190;41762832;22672021;39069;0;35
FR;1;2022-01-20;16852;40562;183722;1147;20810;204767;2516;0;2;42191115;40095214;21094831;62337;41783642;22876788;41585;0;37
FR;1;2022-01-21;19920;47006;228984;1405;23885;253361;3106;0;1;42211035;40142220;21323815;63742;41807527;23130149;44691;0;38
FR;1;2022-01-22;13844;33332;144509;579;18433;161397;1404;0;2;42224879;40175552;21468324;64321;41825960;23291546;46095;0;40
FR;1;2022-01-23;3380;8764;33438;132;4576;38325;352;0;1;42228259;40184316;21501762;64453;41830536;23329871;46447;0;41
FR;1;2022-01-24;11816;32967;142243;718;17789;158279;2104;0;1;42240075;40217283;21644005;65171;41848325;23488150;48551;0;42
FR;1;2022-01-25;14214;38156;163433;1049;20281;181565;3182;0;1;42254289;40255439;21807438;66220;41868606;23669715;51733;0;43
FR;1;2022-01-26;14865;37722;150273;933;22637;166400;2515;0;1;42269154;40293161;21957711;67153;41891243;23836115;54248;0;44
FR;1;2022-01-27;12340;33334;143472;896;18500;158047;3230;0;3;42281494;40326495;22101183;68049;41909743;23994162;57478;0;47
FR;1;2022-01-28;16329;56904;198333;1144;32661;222393;4007;0;3;42297823;40383399;22299516;69193;41942404;24216555;61485;0;50
FR;1;2022-01-29;10270;35472;135215;525;19612;151543;1879;0;1;42308093;40418871;22434731;69718;41962016;24368098;63364;0;51
FR;1;2022-01-30;2484;9255;29687;86;4827;34449;434;0;1;42310577;40428126;22464418;69804;41966843;24402547;63798;0;52
FR;1;2022-01-31;8759;32462;104353;533;19471;117344;2340;0;3;42319336;40460588;22568771;70337;41986314;24519891;66138;0;55
FR;1;2022-02-01;11006;36447;127088;865;20630;141212;4321;0;1;42330342;40497035;22695859;71202;42006944;24661103;70459;0;56
FR;1;2022-02-02;12080;41571;130369;782;25263;145818;3774;0;9;42342422;40538606;22826228;71984;42032207;24806921;74233;0;65
FR;1;2022-02-03;9510;34052;117034;785;19118;130336;4284;0;4;42351932;40572658;22943262;72769;42051325;24937257;78517;0;69
FR;1;2022-02-04;11540;49617;172589;968;26908;192726;5479;0;5;42363472;40622275;23115851;73737;42078233;25129983;83996;0;74
FR;1;2022-02-05;8000;33921;117593;391;18170;133025;2414;0;3;42371472;40656196;23233444;74128;42096403;25263008;86410;0;77
FR;1;2022-02-06;1706;7995;22754;86;3873;26905;444;0;0;42373178;40664191;23256198;74214;42100276;25289913;86854;0;77
FR;1;2022-02-07;7365;35385;119113;460;18171;134970;3398;0;4;42380543;40699576;23375311;74674;42118447;25424883;90252;0;81
FR;1;2022-02-08;7770;31960;125673;696;14893;140663;4301;0;5;42388313;40731536;23500984;75370;42133340;25565546;94553;0;86
FR;1;2022-02-09;8717;36528;135267;702;17928;152511;3884;0;7;42397030;40768064;23636251;76072;42151268;25718057;98437;0;93
FR;1;2022-02-10;7027;30138;116383;677;13901;130171;4445;0;1;42404057;40798202;23752634;76749;42165169;25848228;102882;0;94
FR;1;2022-02-11;8662;41562;165150;878;18375;185374;5430;0;3;42412719;40839764;23917784;77627;42183544;26033602;108312;0;97
FR;1;2022-02-12;5346;27617;106714;379;12540;120899;2396;0;2;42418065;40867381;24024498;78006;42196084;26154501;110708;0;99
FR;1;2022-02-13;1269;5721;21721;66;2188;25339;402;0;3;42419334;40873102;24046219;78072;42198272;26179840;111110;0;102
FR;1;2022-02-14;5460;27229;118096;395;10645;133124;3385;0;4;42424794;40900331;24164315;78467;42208917;26312964;114495;0;106
FR;1;2022-02-15;5798;28869;118940;611;12218;132572;4882;0;1;42430592;40929200;24283255;79078;42221135;26445536;119377;0;107
FR;1;2022-02-16;5762;28495;110428;597;13762;123058;4153;0;3;42436354;40957695;24393683;79675;42234897;26568594;123530;0;110
FR;1;2022-02-17;4616;19745;73154;489;10126;80260;3999;0;3;42440970;40977440;24466837;80164;42245023;26648854;127529;0;113
FR;1;2022-02-18;5614;26800;99208;673;14172;108169;5519;0;2;42446584;41004240;24566045;80837;42259195;26757023;133048;0;115
FR;1;2022-02-19;3551;17177;59479;305;9570;66060;2267;0;0;42450135;41021417;24625524;81142;42268765;26823083;135315;0;115
FR;1;2022-02-20;792;3258;10706;36;1651;12333;360;0;1;42450927;41024675;24636230;81178;42270416;26835416;135675;0;116
FR;1;2022-02-21;3430;14599;52830;286;7919;57678;3126;0;2;42454357;41039274;24689060;81464;42278335;26893094;138801;0;118
FR;1;2022-02-22;3804;15549;51919;500;9046;55657;4070;0;1;42458161;41054823;24740979;81964;42287381;26948751;142871;0;119
FR;1;2022-02-23;4235;17828;57485;510;10748;62587;3568;0;3;42462396;41072651;24798464;82474;42298129;27011338;146439;0;122
FR;1;2022-02-24;3344;13144;43620;436;7838;46410;3658;0;2;42465740;41085795;24842084;82910;42305967;27057748;150097;0;124
FR;1;2022-02-25;4478;20131;64927;697;12249;68798;5768;0;4;42470218;41105926;24907011;83607;42318216;27126546;155865;0;128
FR;1;2022-02-26;2698;12806;41371;310;7653;45124;2494;0;2;42472916;41118732;24948382;83917;42325869;27171670;158359;0;130
FR;1;2022-02-27;644;2192;7131;42;1207;7994;433;0;0;42473560;41120924;24955513;83959;42327076;27179664;158792;0;130
FR;1;2022-02-28;2613;10500;34967;306;6080;37393;3124;0;0;42476173;41131424;24990480;84265;42333156;27217057;161916;0;130
FR;1;2022-03-01;3591;10762;38706;391;6365;39662;4548;0;4;42479764;41142186;25029186;84656;42339521;27256719;166464;0;134
FR;1;2022-03-02;3685;12204;41870;398;7471;43940;4110;0;1;42483449;41154390;25071056;85054;42346992;27300659;170574;0;135
FR;1;2022-03-03;2463;7990;26186;329;5245;26524;3380;0;1;42485912;41162380;25097242;85383;42352237;27327183;173954;0;136
FR;1;2022-03-04;2690;10545;35468;594;6976;34962;5280;0;3;42488602;41172925;25132710;85977;42359213;27362145;179234;0;139
FR;1;2022-03-05;1823;6369;21972;280;4207;22370;2572;0;1;42490425;41179294;25154682;86257;42363420;27384515;181806;0;140
FR;1;2022-03-06;359;959;2917;38;605;3120;327;0;0;42490784;41180253;25157599;86295;42364025;27387635;182133;0;140
FR;1;2022-03-07;1908;4724;16442;245;3046;15910;2831;0;4;42492692;41184977;25174041;86540;42367071;27403545;184964;0;144
FR;1;2022-03-08;1717;5259;17173;309;3670;16002;3471;0;3;42494409;41190236;25191214;86849;42370741;27419547;188435;0;147
FR;1;2022-03-09;1988;6726;19820;371;4801;19179;3423;0;4;42496397;41196962;25211034;87220;42375542;27438726;191858;0;151
FR;1;2022-03-10;1415;5018;15299;309;3669;14337;2944;0;2;42497812;41201980;25226333;87529;42379211;27453063;194802;0;153
FR;1;2022-03-11;1761;6410;21717;487;4445;19870;4739;0;1;42499573;41208390;25248050;88016;42383656;27472933;199541;0;154
FR;1;2022-03-12;1263;4653;15367;281;3094;14915;2687;0;2;42500836;41213043;25263417;88297;42386750;27487848;202228;0;156
FR;1;2022-03-13;257;613;2119;119;414;2065;468;0;0;42501093;41213656;25265536;88416;42387164;27489913;202696;0;156
FR;1;2022-03-14;1157;3679;13407;3882;2294;12528;6342;0;8;42502250;41217335;25278943;92298;42389458;27502441;209038;0;164
FR;1;2022-03-15;1409;5735;14665;6865;4319;13262;9847;0;8;42503659;41223070;25293608;99163;42393777;27515703;218885;0;172
FR;1;2022-03-16;1695;5090;17401;11521;3600;16465;14126;0;6;42505354;41228160;25311009;110684;42397377;27532168;233011;0;178
FR;1;2022-03-17;1178;3441;11735;9648;2366;10830;11732;0;8;42506532;41231601;25322744;120332;42399743;27542998;244743;0;186
FR;1;2022-03-18;1725;4930;17980;16508;3324;16419;19722;0;14;42508257;41236531;25340724;136840;42403067;27559417;264465;0;200
FR;1;2022-03-19;1126;3301;11891;8460;2277;11361;10142;0;6;42509383;41239832;25352615;145300;42405344;27570778;274607;0;206
FR;1;2022-03-20;224;561;1726;1015;363;1761;1224;0;2;42509607;41240393;25354341;146315;42405707;27572539;275831;0;208
FR;1;2022-03-21;1088;2768;11503;13462;1787;10854;15142;0;10;42510695;41243161;25365844;159777;42407494;27583393;290973;0;218
FR;1;2022-03-22;1282;3214;12264;18716;2155;11252;20619;0;5;42511977;41246375;25378108;178493;42409649;27594645;311592;0;223
FR;1;2022-03-23;1514;4360;16033;20111;2956;15714;21883;0;34;42513491;41250735;25394141;198604;42412605;27610359;333475;0;257
FR;1;2022-03-24;1120;2754;10405;16060;1910;9666;17565;0;15;42514611;41253489;25404546;214664;42414515;27620025;351040;0;272
FR;1;2022-03-25;1540;4363;16754;25315;2881;15406;27959;0;23;42516151;41257852;25421300;239979;42417396;27635431;378999;0;295
FR;1;2022-03-26;1110;3017;10856;11450;2065;10517;12862;0;20;42517261;41260869;25432156;251429;42419461;27645948;391861;0;315
FR;1;2022-03-27;236;546;1750;1383;334;1803;1594;0;1;42517497;41261415;25433906;252812;42419795;27647751;393455;0;316
FR;1;2022-03-28;1086;2490;9981;15885;1558;9602;17230;0;10;42518583;41263905;25443887;268697;42421353;27657353;410685;0;326
FR;1;2022-03-29;1141;2754;11562;25111;1603;10926;26508;0;30;42519724;41266659;25455449;293808;42422956;27668279;437193;0;356
FR;1;2022-03-30;1632;3676;14174;24233;2450;13714;25897;0;19;42521356;41270335;25469623;318041;42425406;27681993;463090;0;375
FR;1;2022-03-31;1281;3025;11701;22700;2052;11214;24021;0;40;42522637;41273360;25481324;340741;42427458;27693207;487111;0;415
FR;1;2022-04-01;2239;4025;18492;28534;2481;17362;30806;0;53;42524876;41277385;25499816;369275;42429939;27710569;517917;0;468
FR;1;2022-04-02;911;1894;8196;9240;1106;7959;10233;0;28;42525787;41279279;25508012;378515;42431045;27718528;528150;0;496
FR;1;2022-04-03;207;382;1433;1058;219;1435;1249;0;1;42525994;41279661;25509445;379573;42431264;27719963;529399;0;497
FR;1;2022-04-04;4232;2600;11380;17680;1688;10772;18899;0;30;42530226;41282261;25520825;397253;42432952;27730735;548298;0;527
FR;1;2022-04-05;2260;2721;13007;31222;1704;12033;32603;0;68;42532486;41284982;25533832;428475;42434656;27742768;580901;0;595
FR;1;2022-04-06;1891;3018;12205;23981;1926;11642;25278;0;62;42534377;41288000;25546037;452456;42436582;27754410;606179;0;657
FR;1;2022-04-07;1694;2754;12358;31115;1652;11825;32191;0;68;42536071;41290754;25558395;483571;42438234;27766235;638370;0;725
FR;1;2022-04-08;1847;3711;17571;40647;2098;16500;42700;0;76;42537918;41294465;25575966;524218;42440332;27782735;681070;0;801
FR;1;2022-04-09;827;2000;8406;12504;1078;8106;13502;0;26;42538745;41296465;25584372;536722;42441410;27790841;694572;0;827
FR;1;2022-04-10;201;654;1837;1855;419;1883;2075;0;6;42538946;41297119;25586209;538577;42441829;27792724;696647;0;833
FR;1;2022-04-11;1107;2258;10973;22371;1310;10688;23479;0;68;42540053;41299377;25597182;560948;42443139;27803412;720126;0;901
FR;1;2022-04-12;1352;2677;12827;38146;1591;12316;38897;0;119;42541405;41302054;25610009;599094;42444730;27815728;759023;0;1020
FR;1;2022-04-13;1282;2894;12278;30627;1790;12008;31399;0;85;42542687;41304948;25622287;629721;42446520;27827736;790422;0;1105
FR;1;2022-04-14;1232;2596;12118;33658;1599;12132;34095;0;87;42543919;41307544;25634405;663379;42448119;27839868;824517;0;1192
FR;1;2022-04-15;1503;3305;14409;33269;2121;13813;34672;0;107;42545422;41310849;25648814;696648;42450240;27853681;859189;0;1299
FR;1;2022-04-16;662;1410;5845;8003;767;5777;8757;0;31;42546084;41312259;25654659;704651;42451007;27859458;867946;0;1330
FR;1;2022-04-17;157;290;930;1121;177;975;1171;0;7;42546241;41312549;25655589;705772;42451184;27860433;869117;0;1337
FR;1;2022-04-18;169;484;2636;1002;299;2660;1187;0;5;42546410;41313033;25658225;706774;42451483;27863093;870304;0;1342
FR;1;2022-04-19;1259;2610;11788;27936;1500;11519;28791;0;69;42547669;41315643;25670013;734710;42452983;27874612;899095;0;1411
FR;1;2022-04-20;1359;2674;12179;26885;1678;12031;27710;0;82;42549028;41318317;25682192;761595;42454661;27886643;926805;0;1493
FR;1;2022-04-21;1244;2463;11553;33284;1511;11785;33621;0;107;42550272;41320780;25693745;794879;42456172;27898428;960426;0;1600
FR;1;2022-04-22;1527;3093;15217;35507;1927;14795;36705;0;120;42551799;41323873;25708962;830386;42458099;27913223;997131;0;1720
FR;1;2022-04-23;767;1588;6738;9894;925;6644;10578;0;30;42552566;41325461;25715700;840280;42459024;27919867;1007709;0;1750
FR;1;2022-04-24;196;378;1376;1524;242;1329;1749;0;7;42552762;41325839;25717076;841804;42459266;27921196;1009458;0;1757
FR;1;2022-04-25;1041;2132;9857;19735;1255;9757;20557;0;64;42553803;41327971;25726933;861539;42460521;27930953;1030015;0;1821
FR;1;2022-04-26;1351;2627;12608;36639;1608;12207;37227;0;163;42555154;41330598;25739541;898178;42462129;27943160;1067242;0;1984
FR;1;2022-04-27;1330;2408;10654;29290;1468;10790;29675;0;123;42556484;41333006;25750195;927468;42463597;27953950;1096917;0;2107
FR;1;2022-04-28;1284;2415;11565;34323;1521;11406;34473;0;127;42557768;41335421;25761760;961791;42465118;27965356;1131390;0;2234
FR;1;2022-04-29;1615;4296;14407;35563;3168;13859;36853;0;153;42559383;41339717;25776167;997354;42468286;27979215;1168243;0;2387
FR;1;2022-04-30;841;4302;6448;9173;3729;6292;9974;0;35;42560224;41344019;25782615;1006527;42472015;27985507;1178217;0;2422
FR;1;2022-05-01;178;288;832;951;190;826;1080;0;5;42560402;41344307;25783447;1007478;42472205;27986333;1179297;0;2427
FR;1;2022-05-02;2085;2617;10380;16953;1772;10305;17634;0;64;42562487;41346924;25793827;1024431;42473977;27996638;1196931;0;2491
FR;1;2022-05-03;1687;2879;12712;32915;1762;12604;33714;0;149;42564174;41349803;25806539;1057346;42475739;28009242;1230645;0;2640
FR;1;2022-05-04;1381;2747;11234;23826;1692;11394;24365;0;96;42565555;41352550;25817773;1081172;42477431;28020636;1255010;0;2736
FR;1;2022-05-05;1497;2735;12200;31862;1719;12123;32410;0;170;42567052;41355285;25829973;1113034;42479150;28032759;1287420;0;2906
FR;1;2022-05-06;1822;3238;14241;34940;1915;13825;36202;0;166;42568874;41358523;25844214;1147974;42481065;28046584;1323622;0;3072
FR;1;2022-05-07;860;1473;5979;9097;878;6013;9731;0;44;42569734;41359996;25850193;1157071;42481943;28052597;1333353;0;3116
FR;1;2022-05-08;190;329;1062;1472;221;1124;1548;0;8;42569924;41360325;25851255;1158543;42482164;28053721;1334901;0;3124
FR;1;2022-05-09;1167;2019;9251;19262;1159;9165;20035;0;93;42571091;41362344;25860506;1177805;42483323;28062886;1354936;0;3217
FR;1;2022-05-10;1510;3050;12616;37145;1961;12215;38043;0;177;42572601;41365394;25873122;1214950;42485284;28075101;1392979;0;3394
FR;1;2022-05-11;1441;2477;9912;26042;1695;9860;26559;0;138;42574042;41367871;25883034;1240992;42486979;28084961;1419538;0;3532
FR;1;2022-05-12;1325;2455;10526;33632;1546;10229;34275;0;188;42575367;41370326;25893560;1274624;42488525;28095190;1453813;0;3720
FR;1;2022-05-13;1618;2806;12770;35855;1684;12418;36950;0;149;42576985;41373132;25906330;1310479;42490209;28107608;1490763;0;3869
FR;1;2022-05-14;782;1324;5481;10217;809;5365;10732;0;51;42577767;41374456;25911811;1320696;42491018;28112973;1501495;0;3920
FR;1;2022-05-15;223;422;1182;1352;246;1252;1497;0;5;42577990;41374878;25912993;1322048;42491264;28114225;1502992;0;3925
FR;1;2022-05-16;972;1787;8079;20138;1005;8144;20550;0;117;42578962;41376665;25921072;1342186;42492269;28122369;1523542;0;4042
FR;1;2022-05-17;1296;2303;11125;36187;1386;10729;36973;0;172;42580258;41378968;25932197;1378373;42493655;28133098;1560515;0;4214
FR;1;2022-05-18;1313;2135;9041;25730;1367;8991;26289;0;99;42581571;41381103;25941238;1404103;42495022;28142089;1586804;0;4313
FR;1;2022-05-19;1204;2404;9856;33999;1413;9951;34202;0;150;42582775;41383507;25951094;1438102;42496435;28152040;1621006;0;4463
FR;1;2022-05-20;1563;2757;12532;37655;1720;12113;38515;0;151;42584338;41386264;25963626;1475757;42498155;28164153;1659521;0;4614
FR;1;2022-05-21;775;1387;5247;9374;879;5164;9944;0;37;42585113;41387651;25968873;1485131;42499034;28169317;1669465;0;4651
FR;1;2022-05-22;194;292;953;1397;204;952;1520;0;10;42585307;41387943;25969826;1486528;42499238;28170269;1670985;0;4661
FR;1;2022-05-23;972;1890;8372;19438;1177;8349;20055;0;79;42586279;41389833;25978198;1505966;42500415;28178618;1691040;0;4740
FR;1;2022-05-24;1288;2449;10728;37251;1441;10598;37824;0;173;42587567;41392282;25988926;1543217;42501856;28189216;1728864;0;4913
FR;1;2022-05-25;1272;2299;8793;23693;1424;8957;24055;0;111;42588839;41394581;25997719;1566910;42503280;28198173;1752919;0;5024
FR;1;2022-05-26;175;385;1584;1155;261;1579;1288;0;24;42589014;41394966;25999303;1568065;42503541;28199752;1754207;0;5048
FR;1;2022-05-27;1120;2192;8789;20457;1377;8537;21410;0;84;42590134;41397158;26008092;1588522;42504918;28208289;1775617;0;5132
FR;1;2022-05-28;486;1059;3692;6543;627;3729;6930;0;37;42590620;41398217;26011784;1595065;42505545;28212018;1782547;0;5169
FR;1;2022-05-29;121;257;707;896;149;718;1005;0;4;42590741;41398474;26012491;1595961;42505694;28212736;1783552;0;5173
FR;1;2022-05-30;832;1743;6559;18536;1044;6592;18990;0;85;42591573;41400217;26019050;1614497;42506738;28219328;1802542;0;5258
FR;1;2022-05-31;1266;2239;9248;34376;1370;9118;34976;0;159;42592839;41402456;26028298;1648873;42508108;28228446;1837518;0;5417
FR;1;2022-06-01;1333;2605;10439;23460;1752;10302;24307;0;116;42594172;41405061;26038737;1672333;42509860;28238748;1861825;0;5533
FR;1;2022-06-02;1228;2309;10663;34153;1447;10241;34986;0;162;42595400;41407370;26049400;1706486;42511307;28248989;1896811;0;5695
FR;1;2022-06-03;1446;2746;12736;37111;1737;12157;38287;0;157;42596846;41410116;26062136;1743597;42513044;28261146;1935098;0;5852
FR;1;2022-06-04;686;1262;4750;8677;759;4826;9167;0;62;42597532;41411378;26066886;1752274;42513803;28265972;1944265;0;5914
FR;1;2022-06-05;134;292;810;1049;150;834;1154;0;3;42597666;41411670;26067696;1753323;42513953;28266806;1945419;0;5917
FR;1;2022-06-06;824;1196;2028;1252;1018;2047;1427;0;9;42598490;41412866;26069724;1754575;42514971;28268853;1946846;0;5926
FR;1;2022-06-07;1262;2343;9184;34056;1439;8844;35155;0;143;42599752;41415209;26078908;1788631;42516410;28277697;1982001;0;6069
FR;1;2022-06-08;1138;2238;8682;27613;1401;8566;28484;0;107;42600890;41417447;26087590;1816244;42517811;28286263;2010485;0;6176
FR;1;2022-06-09;1075;2151;9984;37570;1282;9669;38337;0;148;42601965;41419598;26097574;1853814;42519093;28295932;2048822;0;6324
FR;1;2022-06-10;1335;2859;12423;43134;1822;12014;44363;0;200;42603300;41422457;26109997;1896948;42520915;28307946;2093185;0;6524
FR;1;2022-06-11;661;1450;5136;11085;797;5185;11614;0;50;42603961;41423907;26115133;1908033;42521712;28313131;2104799;0;6574
FR;1;2022-06-12;156;377;1019;1687;189;1077;1788;0;11;42604117;41424284;26116152;1909720;42521901;28314208;2106587;0;6585
FR;1;2022-06-13;946;1840;7014;22226;1135;6871;23067;0;84;42605063;41426124;26123166;1931946;42523036;28321079;2129654;0;6669
FR;1;2022-06-14;1117;2233;9840;42851;1312;9243;43943;0;186;42606180;41428357;26133006;1974797;42524348;28330322;2173597;0;6855
FR;1;2022-06-15;1093;2010;8787;29393;1361;8475;29941;0;169;42607273;41430367;26141793;2004190;42525709;28338797;2203538;0;7024
FR;1;2022-06-16;959;1840;9403;38509;1061;8881;39416;0;188;42608232;41432207;26151196;2042699;42526770;28347678;2242954;0;7212
FR;1;2022-06-17;1227;2568;11915;44864;1483;11381;46004;0;224;42609459;41434775;26163111;2087563;42528253;28359059;2288958;0;7436
FR;1;2022-06-18;563;1277;4319;10544;717;4258;11086;0;62;42610022;41436052;26167430;2098107;42528970;28363317;2300044;0;7498
FR;1;2022-06-19;137;325;1003;1543;173;1082;1609;0;12;42610159;41436377;26168433;2099650;42529143;28364399;2301653;0;7510
FR;1;2022-06-20;861;1706;8493;25049;1005;8157;25910;0;146;42611020;41438083;26176926;2124699;42530148;28372556;2327563;0;7656
FR;1;2022-06-21;1102;2139;9764;47759;1256;8855;49103;0;241;42612122;41440222;26186690;2172458;42531404;28381411;2376666;0;7897
FR;1;2022-06-22;1045;2070;8442;37162;1297;7963;38022;0;231;42613167;41442292;26195132;2209620;42532701;28389374;2414688;0;8128
FR;1;2022-06-23;1054;2180;10124;52816;1209;9408;53825;0;290;42614221;41444472;26205256;2262436;42533910;28398782;2468513;0;8418
FR;1;2022-06-24;1256;2719;12916;65969;1487;11700;67641;0;367;42615477;41447191;26218172;2328405;42535397;28410482;2536154;0;8785
FR;1;2022-06-25;685;1506;5931;18922;792;5713;19721;0;163;42616162;41448697;26224103;2347327;42536189;28416195;2555875;0;8948
FR;1;2022-06-26;167;406;1817;3494;191;1713;3730;0;34;42616329;41449103;26225920;2350821;42536380;28417908;2559605;0;8982
FR;1;2022-06-27;944;1777;9901;45979;942;9127;47114;0;300;42617273;41450880;26235821;2396800;42537322;28427035;2606719;0;9282
FR;1;2022-06-28;1215;2576;13844;86574;1381;12406;88261;0;569;42618488;41453456;26249665;2483374;42538703;28439441;2694980;0;9851
FR;1;2022-06-29;1242;2295;11481;67402;1259;10548;68447;0;487;42619730;41455751;26261146;2550776;42539962;28449989;2763427;0;10338
FR;1;2022-06-30;1290;2485;13518;89967;1436;11828;91769;0;645;42621020;41458236;26274664;2640743;42541398;28461817;2855196;0;10983
FR;1;2022-07-01;1658;3481;20315;109200;1991;17971;111596;0;859;42622678;41461717;26294979;2749943;42543389;28479788;2966792;0;11842
FR;1;2022-07-02;770;1527;8024;33775;751;7253;34802;0;315;42623448;41463244;26303003;2783718;42544140;28487041;3001594;0;12157
FR;1;2022-07-03;229;480;1943;6118;257;1759;6444;0;71;42623677;41463724;26304946;2789836;42544397;28488800;3008038;0;12228
FR;1;2022-07-04;1650;3177;13935;75418;2060;12362;77307;0;589;42625327;41466901;26318881;2865254;42546457;28501162;3085345;0;12817
FR;1;2022-07-05;1504;2857;17689;126370;1511;15146;128483;0;1060;42626831;41469758;26336570;2991624;42547968;28516308;3213828;0;13877
FR;1;2022-07-06;1375;2404;14888;93747;1383;12912;95183;0;815;42628206;41472162;26351458;3085371;42549351;28529220;3309011;0;14692
FR;1;2022-07-07;1442;2539;16937;119491;1407;14008;121586;0;1074;42629648;41474701;26368395;3204862;42550758;28543228;3430597;0;15766
FR;1;2022-07-08;1534;2823;19608;130003;1541;15971;132808;0;1220;42631182;41477524;26388003;3334865;42552299;28559199;3563405;0;16986
FR;1;2022-07-09;663;1281;7308;36020;699;6351;36809;0;392;42631845;41478805;26395311;3370885;42552998;28565550;3600214;0;17378
FR;1;2022-07-10;243;656;2240;6689;411;2032;7068;0;89;42632088;41479461;26397551;3377574;42553409;28567582;3607282;0;17467
FR;1;2022-07-11;1239;2243;14320;84454;1178;11942;86565;0;734;42633327;41481704;26411871;3462028;42554587;28579524;3693847;0;18201
FR;1;2022-07-12;1603;2804;19464;137423;1441;15902;139914;0;1485;42634930;41484508;26431335;3599451;42556028;28595426;3833761;0;19686
FR;1;2022-07-13;1460;2439;14790;89838;1316;12643;91523;0;1002;42636390;41486947;26446125;3689289;42557344;28608069;3925284;0;20688
FR;1;2022-07-14;162;350;1865;5290;195;1774;5437;0;74;42636552;41487297;26447990;3694579;42557539;28609843;3930721;0;20762
FR;1;2022-07-15;1266;2319;14362;80599;1206;12005;82603;0;960;42637818;41489616;26462352;3775178;42558745;28621848;4013324;0;21722
FR;1;2022-07-16;514;1063;5641;23949;555;4894;24590;0;302;42638332;41490679;26467993;3799127;42559300;28626742;4037914;0;22024
FR;1;2022-07-17;163;369;1656;4464;193;1501;4727;0;60;42638495;41491048;26469649;3803591;42559493;28628243;4042641;0;22084
FR;1;2022-07-18;975;2034;11301;59281;1145;9571;61005;0;715;42639470;41493082;26480950;3862872;42560638;28637814;4103646;0;22799
FR;1;2022-07-19;1233;2131;14694;99430;1195;11726;101427;0;1386;42640703;41495213;26495644;3962302;42561833;28649540;4205073;0;24185
FR;1;2022-07-20;1183;2007;12372;74374;1174;10283;75859;0;964;42641886;41497220;26508016;4036676;42563007;28659823;4280932;0;25149
FR;1;2022-07-21;1136;1954;12417;84546;1188;9993;85911;0;1211;42643022;41499174;26520433;4121222;42564195;28669816;4366843;0;26360
FR;1;2022-07-22;1272;2243;14102;85947;1255;11434;87686;0;1264;42644294;41501417;26534535;4207169;42565450;28681250;4454529;0;27624
FR;1;2022-07-23;548;1093;5236;21296;634;4610;21841;0;373;42644842;41502510;26539771;4228465;42566084;28685860;4476370;0;27997
FR;1;2022-07-24;148;306;1327;3700;153;1168;3925;0;65;42644990;41502816;26541098;4232165;42566237;28687028;4480295;0;28062
FR;1;2022-07-25;890;1632;9076;46123;982;7526;47496;0;680;42645880;41504448;26550174;4278288;42567219;28694554;4527791;0;28742
FR;1;2022-07-26;1136;1962;12681;81967;1119;10336;83581;0;1198;42647016;41506410;26562855;4360255;42568338;28704890;4611372;0;29940
FR;1;2022-07-27;1021;1729;9760;58521;1046;8138;59702;0;874;42648037;41508139;26572615;4418776;42569384;28713028;4671074;0;30814
FR;1;2022-07-28;982;1705;9857;61908;1113;7853;63135;0;967;42649019;41509844;26582472;4480684;42570497;28720881;4734209;0;31781
FR;1;2022-07-29;1112;1845;10461;62989;1171;8385;64303;0;1066;42650131;41511689;26592933;4543673;42571668;28729266;4798512;0;32847
FR;1;2022-07-30;395;726;3349;14491;442;2849;14851;0;279;42650526;41512415;26596282;4558164;42572110;28732115;4813363;0;33126
FR;1;2022-07-31;141;264;900;2335;159;766;2477;0;47;42650667;41512679;26597182;4560499;42572269;28732881;4815840;0;33173
FR;1;2022-08-01;862;1468;7257;28966;1083;6118;29959;0;519;42651529;41514147;26604439;4589465;42573352;28738999;4845799;0;33692
FR;1;2022-08-02;928;1486;8237;54037;999;6633;54687;0;1091;42652457;41515633;26612676;4643502;42574351;28745632;4900486;0;34783
FR;1;2022-08-03;738;1107;6156;37044;752;4938;37774;0;645;42653195;41516740;26618832;4680546;42575103;28750570;4938260;0;35428
FR;1;2022-08-04;651;1080;6263;41453;696;5058;42007;0;850;42653846;41517820;26625095;4721999;42575799;28755628;4980267;0;36278
FR;1;2022-08-05;743;1198;6766;43078;809;5436;43706;0;933;42654589;41519018;26631861;4765077;42576608;28761064;5023973;0;37211
FR;1;2022-08-06;277;462;1993;8999;302;1674;9191;0;218;42654866;41519480;26633854;4774076;42576910;28762738;5033164;0;37429
FR;1;2022-08-07;89;148;520;1557;104;436;1630;0;35;42654955;41519628;26634374;4775633;42577014;28763174;5034794;0;37464
FR;1;2022-08-08;570;1073;3806;21228;827;3140;21626;0;457;42655525;41520701;26638180;4796861;42577841;28766314;5056420;0;37921
FR;1;2022-08-09;668;1056;5682;38473;746;4557;38967;0;794;42656193;41521757;26643862;4835334;42578587;28770871;5095387;0;38715
FR;1;2022-08-10;566;1179;4434;26915;880;3635;27228;0;601;42656759;41522936;26648296;4862249;42579467;28774506;5122615;0;39316
FR;1;2022-08-11;564;917;4313;28210;629;3587;28538;0;634;42657323;41523853;26652609;4890459;42580096;28778093;5151153;0;39950
FR;1;2022-08-12;726;1041;4555;27171;718;3762;27583;0;668;42658049;41524894;26657164;4917630;42580814;28781855;5178736;0;40618
FR;1;2022-08-13;294;370;1248;5111;262;1066;5282;0;116;42658343;41525264;26658412;4922741;42581076;28782921;5184018;0;40734
FR;1;2022-08-14;67;115;277;871;96;236;941;0;24;42658410;41525379;26658689;4923612;42581172;28783157;5184959;0;40758
FR;1;2022-08-15;111;216;574;542;185;535;593;0;16;42658521;41525595;26659263;4924154;42581357;28783692;5185552;0;40774
FR;1;2022-08-16;549;953;3792;21488;712;3221;21689;0;582;42659070;41526548;26663055;4945642;42582069;28786913;5207241;0;41356
FR;1;2022-08-17;546;912;3769;22149;679;3195;22391;0;579;42659616;41527460;26666824;4967791;42582748;28790108;5229632;0;41935
FR;1;2022-08-18;562;897;3941;25451;698;3140;25673;0;630;42660178;41528357;26670765;4993242;42583446;28793248;5255305;0;42565
FR;1;2022-08-19;536;1049;4369;26547;748;3601;26855;0;732;42660714;41529406;26675134;5019789;42584194;28796849;5282160;0;43297
FR;1;2022-08-20;250;421;1290;5371;321;1107;5524;0;138;42660964;41529827;26676424;5025160;42584515;28797956;5287684;0;43435
FR;1;2022-08-21;84;112;287;990;77;253;1013;0;27;42661048;41529939;26676711;5026150;42584592;28798209;5288697;0;43462
FR;1;2022-08-22;511;899;3141;14956;673;2713;15232;0;411;42661559;41530838;26679852;5041106;42585265;28800922;5303929;0;43873
FR;1;2022-08-23;655;1063;4153;28323;747;3486;28403;0;830;42662214;41531901;26684005;5069429;42586012;28804408;5332332;0;44703
FR;1;2022-08-24;568;837;3402;19069;659;2772;19253;0;587;42662782;41532738;26687407;5088498;42586671;28807180;5351585;0;45290
FR;1;2022-08-25;566;933;3830;22919;652;3213;23148;0;655;42663348;41533671;26691237;5111417;42587323;28810393;5374733;0;45945
FR;1;2022-08-26;754;1137;4350;25157;811;3568;25532;0;745;42664102;41534808;26695587;5136574;42588134;28813961;5400265;0;46690
FR;1;2022-08-27;221;432;1324;5306;277;1191;5360;0;192;42664323;41535240;26696911;5141880;42588411;28815152;5405625;0;46882
FR;1;2022-08-28;113;147;298;899;106;280;948;0;33;42664436;41535387;26697209;5142779;42588517;28815432;5406573;0;46915
FR;1;2022-08-29;504;857;2976;14250;634;2516;14560;0;409;42664940;41536244;26700185;5157029;42589151;28817948;5421133;0;47324
FR;1;2022-08-30;744;1111;4626;27712;788;3776;28033;0;793;42665684;41537355;26704811;5184741;42589939;28821724;5449166;0;48117
FR;1;2022-08-31;586;835;3112;17238;613;2622;17500;0;483;42666270;41538190;26707923;5201979;42590552;28824346;5466666;0;48600
FR;1;2022-09-01;692;926;4333;21885;651;3693;22147;0;587;42666962;41539116;26712256;5223864;42591203;28828039;5488813;0;49187
FR;1;2022-09-02;804;1057;4885;27864;755;4082;28152;0;882;42667766;41540173;26717141;5251728;42591958;28832121;5516965;0;50069
FR;1;2022-09-03;319;511;1833;5876;349;1595;6105;0;174;42668085;41540684;26718974;5257604;42592307;28833716;5523070;0;50243
FR;1;2022-09-04;109;137;341;845;73;334;915;0;21;42668194;41540821;26719315;5258449;42592380;28834050;5523985;0;50264
FR;1;2022-09-05;688;849;3049;15698;672;2556;15981;0;499;42668882;41541670;26722364;5274147;42593052;28836606;5539966;0;50763
FR;1;2022-09-06;824;963;4571;31063;610;3711;31284;0;1002;42669706;41542633;26726935;5305210;42593662;28840317;5571250;0;51765
FR;1;2022-09-07;603;703;2921;16443;464;2425;16580;0;550;42670309;41543336;26729856;5321653;42594126;28842742;5587830;0;52315
FR;1;2022-09-08;582;794;3701;24222;541;3041;24303;0;796;42670891;41544130;26733557;5345875;42594667;28845783;5612133;0;53111
FR;1;2022-09-09;777;976;4308;26897;616;3597;27079;0;903;42671668;41545106;26737865;5372772;42595283;28849380;5639212;0;54014
FR;1;2022-09-10;346;566;1679;5590;396;1479;5782;0;203;42672014;41545672;26739544;5378362;42595679;28850859;5644994;0;54217
FR;1;2022-09-11;106;120;313;646;82;293;703;0;17;42672120;41545792;26739857;5379008;42595761;28851152;5645697;0;54234
FR;1;2022-09-12;480;606;2616;12954;427;2233;13234;0;462;42672600;41546398;26742473;5391962;42596188;28853385;5658931;0;54696
FR;1;2022-09-13;631;827;3868;25845;538;3382;25719;0;834;42673231;41547225;26746341;5417807;42596726;28856767;5684650;0;55530
FR;1;2022-09-14;619;723;2881;15695;507;2412;15931;0;537;42673850;41547948;26749222;5433502;42597233;28859179;5700581;0;56067
FR;1;2022-09-15;531;771;3342;23091;544;2847;23155;0;679;42674381;41548719;26752564;5456593;42597777;28862026;5723736;0;56746
FR;1;2022-09-16;725;944;4017;25347;629;3390;25548;0;891;42675106;41549663;26756581;5481940;42598406;28865416;5749284;0;57637
FR;1;2022-09-17;301;428;1397;5979;299;1222;6087;0;227;42675407;41550091;26757978;5487919;42598705;28866638;5755371;0;57864
FR;1;2022-09-18;99;126;310;923;103;278;979;0;33;42675506;41550217;26758288;5488842;42598808;28866916;5756350;0;57897
FR;1;2022-09-19;400;577;2140;12863;379;1835;13017;0;414;42675906;41550794;26760428;5501705;42599187;28868751;5769367;0;58311
FR;1;2022-09-20;563;835;3667;25830;583;3064;25870;0;854;42676469;41551629;26764095;5527535;42599770;28871815;5795237;0;59165
FR;1;2022-09-21;482;690;2628;15863;490;2256;15827;0;561;42676951;41552319;26766723;5543398;42600260;28874071;5811064;0;59726
FR;1;2022-09-22;547;772;3294;22967;511;2693;23155;0;744;42677498;41553091;26770017;5566365;42600771;28876764;5834219;0;60470
FR;1;2022-09-23;767;944;4353;28154;678;3633;28318;0;981;42678265;41554035;26774370;5594519;42601449;28880397;5862537;0;61451
FR;1;2022-09-24;354;539;1587;6694;379;1370;6867;0;300;42678619;41554574;26775957;5601213;42601828;28881767;5869404;0;61751
FR;1;2022-09-25;81;157;321;1072;110;293;1110;0;32;42678700;41554731;26776278;5602285;42601938;28882060;5870514;0;61783
FR;1;2022-09-26;383;652;2182;13073;429;1935;13167;0;412;42679083;41555383;26778460;5615358;42602367;28883995;5883681;0;62195
FR;1;2022-09-27;542;767;3458;25025;541;2794;25223;0;906;42679625;41556150;26781918;5640383;42602908;28886789;5908904;0;63101
FR;1;2022-09-28;525;720;2448;14971;507;2217;15060;0;597;42680150;41556870;26784366;5655354;42603415;28889006;5923964;0;63698
FR;1;2022-09-29;504;697;2997;20365;487;2522;20379;0;767;42680654;41557567;26787363;5675719;42603902;28891528;5944343;0;64465
FR;1;2022-09-30;694;992;3776;24429;700;3160;24677;0;970;42681348;41558559;26791139;5700148;42604602;28894688;5969020;0;65435
FR;1;2022-10-01;352;550;1905;5507;386;1659;5733;0;273;42681700;41559109;26793044;5705655;42604988;28896347;5974753;0;65708
FR;1;2022-10-02;56;120;204;568;82;204;589;0;29;42681756;41559229;26793248;5706223;42605070;28896551;5975342;0;65737
FR;1;2022-10-03;505;828;2225;10042;672;1985;10210;0;489;42682261;41560057;26795473;5716265;42605742;28898536;5985552;0;66226
FR;1;2022-10-04;599;736;2930;18922;504;2481;19010;0;1086;42682860;41560793;26798403;5735187;42606246;28901017;6004562;0;67312
FR;1;2022-10-05;462;726;2098;11113;499;1871;11242;0;723;42683322;41561519;26800501;5746300;42606745;28902888;6015804;0;68035
FR;1;2022-10-06;446;642;2496;15777;465;2061;15959;0;1062;42683768;41562161;26802997;5762077;42607210;28904949;6031763;0;69097
FR;1;2022-10-07;556;768;2693;16068;567;2310;16092;0;1161;42684324;41562929;26805690;5778145;42607777;28907259;6047855;0;70258
FR;1;2022-10-08;237;315;888;3171;248;776;3276;0;291;42684561;41563244;26806578;5781316;42608025;28908035;6051131;0;70549
FR;1;2022-10-09;76;88;151;461;78;135;487;0;51;42684637;41563332;26806729;5781777;42608103;28908170;6051618;0;70600
FR;1;2022-10-10;308;547;1323;4999;454;1240;5095;0;463;42684945;41563879;26808052;5786776;42608557;28909410;6056713;0;71063
FR;1;2022-10-11;325;455;1315;8086;340;1197;8187;0;757;42685270;41564334;26809367;5794862;42608897;28910607;6064900;0;71820
FR;1;2022-10-12;338;477;1076;5222;364;1073;5239;0;521;42685608;41564811;26810443;5800084;42609261;28911680;6070139;0;72341
FR;1;2022-10-13;331;445;1078;6099;354;935;6146;0;629;42685939;41565256;26811521;5806183;42609615;28912615;6076285;0;72970
FR;1;2022-10-14;410;549;1175;6710;464;1048;6779;0;676;42686349;41565805;26812696;5812893;42610079;28913663;6083064;0;73646
FR;1;2022-10-15;210;336;531;1860;288;514;1868;0;226;42686559;41566141;26813227;5814753;42610367;28914177;6084932;0;73872
FR;1;2022-10-16;47;66;111;296;47;118;315;0;48;42686606;41566207;26813338;5815049;42610414;28914295;6085247;0;73920
FR;1;2022-10-17;236;333;740;2653;265;696;2698;0;366;42686842;41566540;26814078;5817702;42610679;28914991;6087945;0;74286
FR;1;2022-10-18;263;319;954;4596;255;833;4698;0;866;42687105;41566859;26815032;5822298;42610934;28915824;6092643;0;75152
FR;1;2022-10-19;285;404;696;3185;337;665;3164;0;502;42687390;41567263;26815728;5825483;42611271;28916489;6095807;0;75654
FR;1;2022-10-20;286;350;902;4369;296;794;4404;0;771;42687676;41567613;26816630;5829852;42611567;28917283;6100211;0;76425
FR;1;2022-10-21;304;419;847;3806;370;743;3878;0;675;42687980;41568032;26817477;5833658;42611937;28918026;6104089;0;77100
FR;1;2022-10-22;135;183;306;1253;161;300;1218;0;210;42688115;41568215;26817783;5834911;42612098;28918326;6105307;0;77310
FR;1;2022-10-23;32;43;65;197;41;59;213;0;25;42688147;41568258;26817848;5835108;42612139;28918385;6105520;0;77335
FR;1;2022-10-24;272;236;479;1603;204;476;1660;0;306;42688419;41568494;26818327;5836711;42612343;28918861;6107180;0;77641
FR;1;2022-10-25;222;258;526;2651;227;447;2707;0;487;42688641;41568752;26818853;5839362;42612570;28919308;6109887;0;78128
FR;1;2022-10-26;235;250;393;1958;238;370;1965;0;438;42688876;41569002;26819246;5841320;42612808;28919678;6111852;0;78566
FR;1;2022-10-27;260;232;490;2167;204;509;2151;0;518;42689136;41569234;26819736;5843487;42613012;28920187;6114003;0;79084
FR;1;2022-10-28;312;329;533;2335;308;470;2402;0;478;42689448;41569563;26820269;5845822;42613320;28920657;6116405;0;79562
FR;1;2022-10-29;99;151;176;712;121;210;703;0;203;42689547;41569714;26820445;5846534;42613441;28920867;6117108;0;79765
FR;1;2022-10-30;38;47;62;184;39;56;189;0;38;42689585;41569761;26820507;5846718;42613480;28920923;6117297;0;79803
FR;1;2022-10-31;136;186;295;796;165;273;863;0;143;42689721;41569947;26820802;5847514;42613645;28921196;6118160;0;79946
FR;1;2022-11-01;55;131;767;115;113;767;134;0;19;42689776;41570078;26821569;5847629;42613758;28921963;6118294;0;79965
FR;1;2022-11-02;265;243;530;985;239;496;1048;0;356;42690041;41570321;26822099;5848614;42613997;28922459;6119342;0;80321
FR;1;2022-11-03;271;236;442;1379;221;403;1418;0;377;42690312;41570557;26822541;5849993;42614218;28922862;6120760;0;80698
FR;1;2022-11-04;232;261;424;1597;241;401;1637;0;438;42690544;41570818;26822965;5851590;42614459;28923263;6122397;0;81136
FR;1;2022-11-05;100;124;273;503;113;255;525;0;111;42690644;41570942;26823238;5852093;42614572;28923518;6122922;0;81247
FR;1;2022-11-06;36;46;32;131;45;35;129;0;33;42690680;41570988;26823270;5852224;42614617;28923553;6123051;0;81280
FR;1;2022-11-07;201;249;322;893;236;314;939;0;211;42690881;41571237;26823592;5853117;42614853;28923867;6123990;0;81491
FR;1;2022-11-08;210;256;471;1688;244;416;1717;0;524;42691091;41571493;26824063;5854805;42615097;28924283;6125707;0;82015
FR;1;2022-11-09;187;243;335;1104;231;301;1141;0;477;42691278;41571736;26824398;5855909;42615328;28924584;6126848;0;82492
FR;1;2022-11-10;214;328;432;1680;320;441;1668;0;605;42691492;41572064;26824830;5857589;42615648;28925025;6128516;0;83097
FR;1;2022-11-11;32;45;105;100;43;91;114;0;44;42691524;41572109;26824935;5857689;42615691;28925116;6128630;0;83141
FR;1;2022-11-12;93;146;257;375;133;256;390;0;101;42691617;41572255;26825192;5858064;42615824;28925372;6129020;0;83242
FR;1;2022-11-13;23;56;28;64;53;31;66;0;26;42691640;41572311;26825220;5858128;42615877;28925403;6129086;0;83268
FR;1;2022-11-14;171;183;264;768;171;268;838;0;235;42691811;41572494;26825484;5858896;42616048;28925671;6129924;0;83503
FR;1;2022-11-15;220;374;391;1300;373;369;1338;0;436;42692031;41572868;26825875;5860196;42616421;28926040;6131262;0;83939
FR;1;2022-11-16;191;259;335;983;253;349;1017;0;359;42692222;41573127;26826210;5861179;42616674;28926389;6132279;0;84298
FR;1;2022-11-17;168;206;296;1207;200;272;1211;0;387;42692390;41573333;26826506;5862386;42616874;28926661;6133490;0;84685
FR;1;2022-11-18;228;267;393;1314;259;382;1348;0;411;42692618;41573600;26826899;5863700;42617133;28927043;6134838;0;85096
FR;1;2022-11-19;120;115;249;441;114;214;474;0;102;42692738;41573715;26827148;5864141;42617247;28927257;6135312;0;85198
FR;1;2022-11-20;35;120;31;66;116;33;74;0;28;42692773;41573835;26827179;5864207;42617363;28927290;6135386;0;85226
FR;1;2022-11-21;175;170;270;640;143;286;677;0;211;42692948;41574005;26827449;5864847;42617506;28927576;6136063;0;85437
FR;1;2022-11-22;155;168;412;1155;151;396;1177;0;406;42693103;41574173;26827861;5866002;42617657;28927972;6137240;0;85843
FR;1;2022-11-23;178;182;245;763;166;246;786;0;241;42693281;41574355;26828106;5866765;42617823;28928218;6138026;0;86084
FR;1;2022-11-24;136;168;287;1203;149;299;1207;0;440;42693417;41574523;26828393;5867968;42617972;28928517;6139233;0;86524
FR;1;2022-11-25;208;243;426;1154;229;415;1186;0;392;42693625;41574766;26828819;5869122;42618201;28928932;6140419;0;86916
FR;1;2022-11-26;90;109;113;323;101;125;311;0;118;42693715;41574875;26828932;5869445;42618302;28929057;6140730;0;87034
FR;1;2022-11-27;21;37;19;72;27;31;78;0;49;42693736;41574912;26828951;5869517;42618329;28929088;6140808;0;87083
FR;1;2022-11-28;210;145;208;665;152;204;708;0;332;42693946;41575057;26829159;5870182;42618481;28929292;6141516;0;87415
FR;1;2022-11-29;171;141;269;1107;126;251;1119;0;458;42694117;41575198;26829428;5871289;42618607;28929543;6142635;0;87873
FR;1;2022-11-30;161;201;233;938;187;236;960;0;322;42694278;41575399;26829661;5872227;42618794;28929779;6143595;0;88195
FR;1;2022-12-01;163;157;713;1091;145;679;1139;0;379;42694441;41575556;26830374;5873318;42618939;28930458;6144734;0;88574
FR;1;2022-12-02;200;199;516;1186;194;512;1234;0;470;42694641;41575755;26830890;5874504;42619133;28930970;6145968;0;89044
FR;1;2022-12-03;102;108;261;532;96;239;529;0;180;42694743;41575863;26831151;5875036;42619229;28931209;6146497;0;89224
FR;1;2022-12-04;26;27;19;138;24;20;129;0;58;42694769;41575890;26831170;5875174;42619253;28931229;6146626;0;89282
FR;1;2022-12-05;144;149;301;867;146;295;899;0;316;42694913;41576039;26831471;5876041;42619399;28931524;6147525;0;89598
FR;1;2022-12-06;154;150;272;1448;137;276;1454;0;739;42695067;41576189;26831743;5877489;42619536;28931800;6148979;0;90337
FR;1;2022-12-07;154;158;250;1187;167;230;1203;0;576;42695221;41576347;26831993;5878676;42619703;28932030;6150182;0;90913
FR;1;2022-12-08;129;140;301;1756;132;258;1797;0;765;42695350;41576487;26832294;5880432;42619835;28932288;6151979;0;91678
FR;1;2022-12-09;202;195;354;1815;168;363;1835;0;721;42695552;41576682;26832648;5882247;42620003;28932651;6153814;0;92399
FR;1;2022-12-10;116;107;341;856;94;324;877;0;292;42695668;41576789;26832989;5883103;42620097;28932975;6154691;0;92691
FR;1;2022-12-11;31;30;32;218;27;30;200;0;62;42695699;41576819;26833021;5883321;42620124;28933005;6154891;0;92753
FR;1;2022-12-12;127;101;293;1099;97;281;1111;0;457;42695826;41576920;26833314;5884420;42620221;28933286;6156002;0;93210
FR;1;2022-12-13;122;123;291;1307;97;266;1321;0;618;42695948;41577043;26833605;5885727;42620318;28933552;6157323;0;93828
FR;1;2022-12-14;105;144;253;866;138;232;891;0;370;42696053;41577187;26833858;5886593;42620456;28933784;6158214;0;94198
FR;1;2022-12-15;137;161;448;1491;149;418;1517;0;692;42696190;41577348;26834306;5888084;42620605;28934202;6159731;0;94890
FR;1;2022-12-16;205;214;566;1344;217;551;1366;0;623;42696395;41577562;26834872;5889428;42620822;28934753;6161097;0;95513
FR;1;2022-12-17;88;91;223;467;80;218;475;0;204;42696483;41577653;26835095;5889895;42620902;28934971;6161572;0;95717
FR;1;2022-12-18;17;22;26;111;19;28;107;0;37;42696500;41577675;26835121;5890006;42620921;28934999;6161679;0;95754
FR;1;2022-12-19;151;128;248;791;136;219;834;0;381;42696651;41577803;26835369;5890797;42621057;28935218;6162513;0;96135
FR;1;2022-12-20;143;161;352;905;148;346;911;0;426;42696794;41577964;26835721;5891702;42621205;28935564;6163424;0;96561
FR;1;2022-12-21;136;107;213;638;117;179;646;0;388;42696930;41578071;26835934;5892340;42621322;28935743;6164070;0;96949
FR;1;2022-12-22;146;109;165;552;118;150;542;0;326;42697076;41578180;26836099;5892892;42621440;28935893;6164612;0;97275
FR;1;2022-12-23;128;154;453;419;137;444;425;0;182;42697204;41578334;26836552;5893311;42621577;28936337;6165037;0;97457
FR;1;2022-12-24;30;27;33;56;29;32;63;0;21;42697234;41578361;26836585;5893367;42621606;28936369;6165100;0;97478
FR;1;2022-12-25;4;10;20;12;11;14;15;0;11;42697238;41578371;26836605;5893379;42621617;28936383;6165115;0;97489
FR;1;2022-12-26;94;90;248;251;89;253;257;0;93;42697332;41578461;26836853;5893630;42621706;28936636;6165372;0;97582
FR;1;2022-12-27;117;159;309;387;150;315;402;0;180;42697449;41578620;26837162;5894017;42621856;28936951;6165774;0;97762
FR;1;2022-12-28;105;142;202;270;128;204;281;0;126;42697554;41578762;26837364;5894287;42621984;28937155;6166055;0;97888
FR;1;2022-12-29;105;102;154;282;102;153;303;0;114;42697659;41578864;26837518;5894569;42622086;28937308;6166358;0;98002
FR;1;2022-12-30;122;122;86;258;111;91;268;0;143;42697781;41578986;26837604;5894827;42622197;28937399;6166626;0;98145
FR;1;2022-12-31;38;34;28;74;39;25;74;0;25;42697819;41579020;26837632;5894901;42622236;28937424;6166700;0;98170
FR;1;2023-01-01;6;11;61;22;11;57;27;0;10;42697825;41579031;26837693;5894923;42622247;28937481;6166727;0;98180
FR;1;2023-01-02;91;112;664;169;119;645;191;0;64;42697916;41579143;26838357;5895092;42622366;28938126;6166918;0;98244
FR;1;2023-01-03;162;93;364;207;91;357;215;0;146;42698078;41579236;26838721;5895299;42622457;28938483;6167133;0;98390
FR;1;2023-01-04;92;86;244;198;87;245;208;0;192;42698170;41579322;26838965;5895497;42622544;28938728;6167341;0;98582
FR;1;2023-01-05;143;109;170;334;120;170;335;0;206;42698313;41579431;26839135;5895831;42622664;28938898;6167676;0;98788
FR;1;2023-01-06;197;140;223;325;143;209;350;0;230;42698510;41579571;26839358;5896156;42622807;28939107;6168026;0;99018
FR;1;2023-01-07;106;88;175;147;91;158;164;0;92;42698616;41579659;26839533;5896303;42622898;28939265;6168190;0;99110
FR;1;2023-01-08;26;18;29;59;17;25;63;0;24;42698642;41579677;26839562;5896362;42622915;28939290;6168253;0;99134
FR;1;2023-01-09;138;121;133;135;117;141;153;0;115;42698780;41579798;26839695;5896497;42623032;28939431;6168406;0;99249
FR;1;2023-01-10;115;115;272;266;115;276;267;0;192;42698895;41579913;26839967;5896763;42623147;28939707;6168673;0;99441
FR;1;2023-01-11;104;100;89;199;108;94;210;0;96;42698999;41580013;26840056;5896962;42623255;28939801;6168883;0;99537
FR;1;2023-01-12;122;109;210;242;104;210;267;0;166;42699121;41580122;26840266;5897204;42623359;28940011;6169150;0;99703
FR;1;2023-01-13;195;146;166;285;145;165;306;0;188;42699316;41580268;26840432;5897489;42623504;28940176;6169456;0;99891
FR;1;2023-01-14;89;63;161;104;65;171;103;0;62;42699405;41580331;26840593;5897593;42623569;28940347;6169559;0;99953
FR;1;2023-01-15;23;24;31;41;21;31;45;0;29;42699428;41580355;26840624;5897634;42623590;28940378;6169604;0;99982
FR;1;2023-01-16;111;102;310;155;96;314;133;0;100;42699539;41580457;26840934;5897789;42623686;28940692;6169737;0;100082
FR;1;2023-01-17;113;98;163;213;97;160;240;0;128;42699652;41580555;26841097;5898002;42623783;28940852;6169977;0;100210
FR;1;2023-01-18;99;87;93;143;86;89;183;0;121;42699751;41580642;26841190;5898145;42623869;28940941;6170160;0;100331
FR;1;2023-01-19;113;78;98;130;77;110;130;0;135;42699864;41580720;26841288;5898275;42623946;28941051;6170290;0;100466
FR;1;2023-01-20;166;141;162;277;143;190;266;0;202;42700030;41580861;26841450;5898552;42624089;28941241;6170556;0;100668
FR;1;2023-01-21;58;70;91;85;70;102;75;0;35;42700088;41580931;26841541;5898637;42624159;28941343;6170631;0;100703
FR;1;2023-01-22;10;8;12;21;6;8;25;0;14;42700098;41580939;26841553;5898658;42624165;28941351;6170656;0;100717
FR;1;2023-01-23;87;83;108;99;86;100;118;0;85;42700185;41581022;26841661;5898757;42624251;28941451;6170774;0;100802
FR;1;2023-01-24;121;74;71;122;87;69;131;0;183;42700306;41581096;26841732;5898879;42624338;28941520;6170905;0;100985
FR;1;2023-01-25;98;118;77;104;117;77;119;0;106;42700404;41581214;26841809;5898983;42624455;28941597;6171024;0;101091
FR;1;2023-01-26;105;104;61;152;93;66;173;0;107;42700509;41581318;26841870;5899135;42624548;28941663;6171197;0;101198
FR;1;2023-01-27;171;134;104;137;150;121;137;0;199;42700680;41581452;26841974;5899272;42624698;28941784;6171334;0;101397
FR;1;2023-01-28;73;74;55;40;77;52;48;0;28;42700753;41581526;26842029;5899312;42624775;28941836;6171382;0;101425
FR;1;2023-01-29;12;22;33;10;20;31;16;0;12;42700765;41581548;26842062;5899322;42624795;28941867;6171398;0;101437
FR;1;2023-01-30;144;108;64;72;110;70;80;0;51;42700909;41581656;26842126;5899394;42624905;28941937;6171478;0;101488
FR;1;2023-01-31;122;83;64;135;72;68;146;0;142;42701031;41581739;26842190;5899529;42624977;28942005;6171624;0;101630
FR;1;2023-02-01;118;132;340;105;130;335;131;0;77;42701149;41581871;26842530;5899634;42625107;28942340;6171755;0;101707
FR;1;2023-02-02;88;89;88;104;84;95;105;0;97;42701237;41581960;26842618;5899738;42625191;28942435;6171860;0;101804
FR;1;2023-02-03;154;142;129;98;142;135;104;0;93;42701391;41582102;26842747;5899836;42625333;28942570;6171964;0;101897
FR;1;2023-02-04;49;78;72;46;84;74;47;0;24;42701440;41582180;26842819;5899882;42625417;28942644;6172011;0;101921
FR;1;2023-02-05;6;8;18;6;7;21;7;0;8;42701446;41582188;26842837;5899888;42625424;28942665;6172018;0;101929
FR;1;2023-02-06;93;75;110;75;81;112;79;0;89;42701539;41582263;26842947;5899963;42625505;28942777;6172097;0;102018
FR;1;2023-02-07;89;75;95;75;76;90;94;0;114;42701628;41582338;26843042;5900038;42625581;28942867;6172191;0;102132
FR;1;2023-02-08;80;89;59;30;87;64;34;0;51;42701708;41582427;26843101;5900068;42625668;28942931;6172225;0;102183
FR;1;2023-02-09;64;65;77;58;75;76;66;0;79;42701772;41582492;26843178;5900126;42625743;28943007;6172291;0;102262
FR;1;2023-02-10;139;128;52;71;131;64;72;0;117;42701911;41582620;26843230;5900197;42625874;28943071;6172363;0;102379
FR;1;2023-02-11;44;49;78;25;46;87;27;0;11;42701955;41582669;26843308;5900222;42625920;28943158;6172390;0;102390
FR;1;2023-02-12;8;2;9;8;6;9;9;0;9;42701963;41582671;26843317;5900230;42625926;28943167;6172399;0;102399
FR;1;2023-02-13;76;95;37;36;97;44;33;0;31;42702039;41582766;26843354;5900266;42626023;28943211;6172432;0;102430
FR;1;2023-02-14;66;66;70;48;65;76;46;0;77;42702105;41582832;26843424;5900314;42626088;28943287;6172478;0;102507
FR;1;2023-02-15;72;94;69;52;102;75;60;0;81;42702177;41582926;26843493;5900366;42626190;28943362;6172538;0;102588
FR;1;2023-02-16;58;72;107;81;60;116;85;0;73;42702235;41582998;26843600;5900447;42626250;28943478;6172623;0;102661
FR;1;2023-02-17;101;119;157;61;123;161;70;0;47;42702336;41583117;26843757;5900508;42626373;28943639;6172693;0;102708
FR;1;2023-02-18;44;55;146;41;55;152;43;0;9;42702380;41583172;26843903;5900549;42626428;28943791;6172736;0;102717
FR;1;2023-02-19;14;0;5;4;3;4;4;0;5;42702394;41583172;26843908;5900553;42626431;28943795;6172740;0;102722
FR;1;2023-02-20;73;63;49;28;68;53;32;0;16;42702467;41583235;26843957;5900581;42626499;28943848;6172772;0;102738
FR;1;2023-02-21;63;74;54;49;78;57;47;0;38;42702530;41583309;26844011;5900630;42626577;28943905;6172819;0;102776
FR;1;2023-02-22;63;76;31;18;77;35;18;0;22;42702593;41583385;26844042;5900648;42626654;28943940;6172837;0;102798
FR;1;2023-02-23;50;77;47;35;74;57;30;0;54;42702643;41583462;26844089;5900683;42626728;28943997;6172867;0;102852
FR;1;2023-02-24;92;109;34;33;110;42;34;0;37;42702735;41583571;26844123;5900716;42626838;28944039;6172901;0;102889
FR;1;2023-02-25;40;47;68;22;54;68;24;0;26;42702775;41583618;26844191;5900738;42626892;28944107;6172925;0;102915
FR;1;2023-02-26;2;3;1;2;1;3;1;0;3;42702777;41583621;26844192;5900740;42626893;28944110;6172926;0;102918
FR;1;2023-02-27;86;75;58;34;75;66;32;0;19;42702863;41583696;26844250;5900774;42626968;28944176;6172958;0;102937
FR;1;2023-02-28;82;68;32;49;65;41;51;0;32;42702945;41583764;26844282;5900823;42627033;28944217;6173009;0;102969
FR;1;2023-03-01;66;83;188;51;82;184;64;0;42;42703011;41583847;26844470;5900874;42627115;28944401;6173073;0;103011
FR;1;2023-03-02;62;59;78;44;61;73;58;0;54;42703073;41583906;26844548;5900918;42627176;28944474;6173131;0;103065
FR;1;2023-03-03;98;103;56;51;102;55;54;0;45;42703171;41584009;26844604;5900969;42627278;28944529;6173185;0;103110
FR;1;2023-03-04;48;45;51;23;42;53;27;0;13;42703219;41584054;26844655;5900992;42627320;28944582;6173212;0;103123
FR;1;2023-03-05;4;2;2;0;3;2;1;0;0;42703223;41584056;26844657;5900992;42627323;28944584;6173213;0;103123
FR;1;2023-03-06;84;56;72;16;62;78;22;0;14;42703307;41584112;26844729;5901008;42627385;28944662;6173235;0;103137
FR;1;2023-03-07;51;69;43;40;66;41;50;0;71;42703358;41584181;26844772;5901048;42627451;28944703;6173285;0;103208
FR;1;2023-03-08;47;63;28;15;66;31;20;0;6;42703405;41584244;26844800;5901063;42627517;28944734;6173305;0;103214
FR;1;2023-03-09;35;51;42;21;47;45;30;0;27;42703440;41584295;26844842;5901084;42627564;28944779;6173335;0;103241
FR;1;2023-03-10;92;91;74;39;91;77;44;0;24;42703532;41584386;26844916;5901123;42627655;28944856;6173379;0;103265
FR;1;2023-03-11;45;37;18;4;30;25;7;0;6;42703577;41584423;26844934;5901127;42627685;28944881;6173386;0;103271
FR;1;2023-03-12;2;9;3;0;11;2;1;0;0;42703579;41584432;26844937;5901127;42627696;28944883;6173387;0;103271
FR;1;2023-03-13;44;49;34;14;45;42;13;0;18;42703623;41584481;26844971;5901141;42627741;28944925;6173400;0;103289
FR;1;2023-03-14;64;43;45;21;48;50;22;0;30;42703687;41584524;26845016;5901162;42627789;28944975;6173422;0;103319
FR;1;2023-03-15;39;53;35;14;53;44;14;0;19;42703726;41584577;26845051;5901176;42627842;28945019;6173436;0;103338
FR;1;2023-03-16;54;41;34;18;44;35;21;0;20;42703780;41584618;26845085;5901194;42627886;28945054;6173457;0;103358
FR;1;2023-03-17;106;79;32;22;95;33;28;0;31;42703886;41584697;26845117;5901216;42627981;28945087;6173485;0;103389
FR;1;2023-03-18;31;22;7;3;15;13;5;0;5;42703917;41584719;26845124;5901219;42627996;28945100;6173490;0;103394
FR;1;2023-03-19;11;2;0;2;3;0;3;0;0;42703928;41584721;26845124;5901221;42627999;28945100;6173493;0;103394
FR;1;2023-03-20;38;44;10;11;38;16;15;0;8;42703966;41584765;26845134;5901232;42628037;28945116;6173508;0;103402
FR;1;2023-03-21;71;51;14;10;57;17;14;0;26;42704037;41584816;26845148;5901242;42628094;28945133;6173522;0;103428
FR;1;2023-03-22;58;53;25;30;53;39;25;0;13;42704095;41584869;26845173;5901272;42628147;28945172;6173547;0;103441
FR;1;2023-03-23;55;43;20;22;44;24;23;0;45;42704150;41584912;26845193;5901294;42628191;28945196;6173570;0;103486
FR;1;2023-03-24;75;76;18;16;82;22;18;0;18;42704225;41584988;26845211;5901310;42628273;28945218;6173588;0;103504
FR;1;2023-03-25;44;38;11;8;36;14;11;0;5;42704269;41585026;26845222;5901318;42628309;28945232;6173599;0;103509
FR;1;2023-03-26;2;3;2;0;0;3;2;0;2;42704271;41585029;26845224;5901318;42628309;28945235;6173601;0;103511
FR;1;2023-03-27;100;54;49;10;55;54;12;0;11;42704371;41585083;26845273;5901328;42628364;28945289;6173613;0;103522
FR;1;2023-03-28;43;31;12;19;36;14;18;0;30;42704414;41585114;26845285;5901347;42628400;28945303;6173631;0;103552
FR;1;2023-03-29;52;36;27;23;35;34;21;0;11;42704466;41585150;26845312;5901370;42628435;28945337;6173652;0;103563
FR;2;2020-12-27;0;0;0;0;0;0;0;0;0;0;0;0;0;0;0;0;0;0
FR;2;2020-12-28;0;0;0;0;0;0;0;0;0;0;0;0;0;0;0;0;0;0
FR;2;2020-12-29;0;0;0;0;0;0;0;0;0;0;0;0;0;0;0;0;0;0
FR;2;2020-12-30;0;0;0;0;0;0;0;0;0;0;0;0;0;0;0;0;0;0
FR;2;2020-12-31;0;0;0;0;0;0;0;0;0;0;0;0;0;0;0;0;0;0
FR;2;2021-01-01;0;0;0;0;0;0;0;0;0;0;0;0;0;0;0;0;0;0
FR;2;2021-01-02;0;0;0;0;0;0;0;0;0;0;0;0;0;0;0;0;0;0
FR;2;2021-01-03;0;0;0;0;0;0;0;0;0;0;0;0;0;0;0;0;0;0
FR;2;2021-01-04;0;0;0;0;0;0;0;0;0;0;0;0;0;0;0;0;0;0
FR;2;2021-01-05;0;0;0;0;0;0;0;0;0;0;0;0;0;0;0;0;0;0
FR;2;2021-01-06;0;0;0;0;0;0;0;0;0;0;0;0;0;0;0;0;0;0
FR;2;2021-01-07;0;0;0;0;0;0;0;0;0;0;0;0;0;0;0;0;0;0
FR;2;2021-01-08;0;0;0;0;0;0;0;0;0;0;0;0;0;0;0;0;0;0
FR;2;2021-01-09;0;0;0;0;0;0;0;0;0;0;0;0;0;0;0;0;0;0
FR;2;2021-01-10;0;0;0;0;0;0;0;0;0;0;0;0;0;0;0;0;0;0
FR;2;2021-01-11;0;0;0;0;0;0;0;0;0;0;0;0;0;0;0;0;0;0
FR;2;2021-01-12;0;0;0;0;0;0;0;0;0;0;0;0;0;0;0;0;0;0
FR;2;2021-01-13;0;0;0;0;0;0;0;0;0;0;0;0;0;0;0;0;0;0
FR;2;2021-01-14;1636;0;0;0;213;0;0;0;0;1636;0;0;0;213;0;0;0;0
FR;2;2021-01-15;398;0;0;0;28;0;0;0;0;2034;0;0;0;241;0;0;0;0
FR;2;2021-01-16;316;0;0;0;12;0;0;0;0;2350;0;0;0;253;0;0;0;0
FR;2;2021-01-17;84;0;0;0;7;0;0;0;0;2434;0;0;0;260;0;0;0;0
FR;2;2021-01-18;3075;3;0;0;27;0;0;0;0;5509;3;0;0;287;0;0;0;0
FR;2;2021-01-19;4681;2;0;0;31;0;0;0;0;10190;5;0;0;318;0;0;0;0
FR;2;2021-01-20;5138;6;0;0;58;0;0;0;0;15328;11;0;0;376;0;0;0;0
FR;2;2021-01-21;5345;9;0;0;55;0;0;0;0;20673;20;0;0;431;0;0;0;0
FR;2;2021-01-22;5119;19;0;0;70;0;0;0;0;25792;39;0;0;501;0;0;0;0
FR;2;2021-01-23;1875;2;0;0;16;0;0;0;0;27667;41;0;0;517;0;0;0;0
FR;2;2021-01-24;163;2;0;0;8;0;0;0;0;27830;43;0;0;525;0;0;0;0
FR;2;2021-01-25;3814;4;0;0;37;0;0;0;0;31644;47;0;0;562;0;0;0;0
FR;2;2021-01-26;3930;6;0;0;42;0;0;0;0;35574;53;0;0;604;0;0;0;0
FR;2;2021-01-27;3606;4;0;0;36;0;0;0;0;39180;57;0;0;640;0;0;0;0
FR;2;2021-01-28;3757;9;0;0;44;0;0;0;0;42937;66;0;0;684;0;0;0;0
FR;2;2021-01-29;3300;6;0;0;42;0;0;0;0;46237;72;0;0;726;0;0;0;0
FR;2;2021-01-30;1133;3;0;0;16;0;0;0;0;47370;75;0;0;742;0;0;0;0
FR;2;2021-01-31;46;2;0;0;9;0;0;0;0;47416;77;0;0;751;0;0;0;0
FR;2;2021-02-01;3408;13;0;0;44;0;0;0;0;50824;90;0;0;795;0;0;0;0
FR;2;2021-02-02;4497;19;0;0;53;0;0;0;0;55321;109;0;0;848;0;0;0;0
FR;2;2021-02-03;5223;12;0;0;83;0;0;0;0;60544;121;0;0;931;0;0;0;0
FR;2;2021-02-04;4941;11;0;0;36;0;0;0;0;65485;132;0;0;967;0;0;0;0
FR;2;2021-02-05;4817;17;0;0;50;0;0;0;0;70302;149;0;0;1017;0;0;0;0
FR;2;2021-02-06;2047;15;0;0;41;0;0;0;0;72349;164;0;0;1058;0;0;0;0
FR;2;2021-02-07;103;6;0;0;20;0;0;0;0;72452;170;0;0;1078;0;0;0;0
FR;2;2021-02-08;7559;27;0;0;86;0;0;0;0;80011;197;0;0;1164;0;0;0;0
FR;2;2021-02-09;8435;31;0;0;100;0;0;0;0;88446;228;0;0;1264;0;0;0;0
FR;2;2021-02-10;9349;63;0;0;183;0;0;0;0;97795;291;0;0;1447;0;0;0;0
FR;2;2021-02-11;10292;132;0;0;256;0;0;0;0;108087;423;0;0;1703;0;0;0;0
FR;2;2021-02-12;10059;276;0;0;430;0;0;0;0;118146;699;0;0;2133;0;0;0;0
FR;2;2021-02-13;3121;223;0;0;261;0;0;0;0;121267;922;0;0;2394;0;0;0;0
FR;2;2021-02-14;358;11;0;0;21;0;0;0;0;121625;933;0;0;2415;0;0;0;0
FR;2;2021-02-15;3460;3129;0;0;3176;0;0;0;0;125085;4062;0;0;5591;0;0;0;0
FR;2;2021-02-16;5076;4164;0;0;4237;0;0;0;0;130161;8226;0;0;9828;0;0;0;0
FR;2;2021-02-17;4259;4554;0;0;4631;0;0;0;0;134420;12780;0;0;14459;0;0;0;0
FR;2;2021-02-18;5406;5177;0;0;5247;0;0;0;0;139826;17957;0;0;19706;0;0;0;0
FR;2;2021-02-19;5329;4491;0;0;4592;0;0;0;0;145155;22448;0;0;24298;0;0;0;0
FR;2;2021-02-20;1872;1520;0;0;1537;0;0;0;0;147027;23968;0;0;25835;0;0;0;0
FR;2;2021-02-21;244;96;0;0;98;0;0;0;0;147271;24064;0;0;25933;0;0;0;0
FR;2;2021-02-22;3614;3782;0;0;3844;0;0;0;0;150885;27846;0;0;29777;0;0;0;0
FR;2;2021-02-23;4956;3740;0;0;3804;0;0;0;0;155841;31586;0;0;33581;0;0;0;0
FR;2;2021-02-24;5017;3558;0;0;3611;0;0;0;0;160858;35144;0;0;37192;0;0;0;0
FR;2;2021-02-25;5501;3495;0;0;3585;0;0;0;0;166359;38639;0;0;40777;0;0;0;0
FR;2;2021-02-26;4368;3179;0;0;3253;0;0;0;0;170727;41818;0;0;44030;0;0;0;0
FR;2;2021-02-27;1629;1067;0;0;1086;0;0;0;0;172356;42885;0;0;45116;0;0;0;0
FR;2;2021-02-28;179;17;0;0;28;0;0;0;0;172535;42902;0;0;45144;0;0;0;0
FR;2;2021-03-01;5193;3763;0;0;3852;0;0;0;0;177728;46665;0;0;48996;0;0;0;0
FR;2;2021-03-02;6542;4726;0;0;4827;0;0;0;0;184270;51391;0;0;53823;0;0;0;0
FR;2;2021-03-03;6544;4955;0;0;5096;0;0;0;0;190814;56346;0;0;58919;0;0;0;0
FR;2;2021-03-04;8412;4210;0;0;4396;0;0;0;0;199226;60556;0;0;63315;0;0;0;0
FR;2;2021-03-05;8037;4054;0;0;4237;0;0;0;0;207263;64610;0;0;67552;0;0;0;0
FR;2;2021-03-06;4790;1683;0;0;1783;0;0;0;0;212053;66293;0;0;69335;0;0;0;0
FR;2;2021-03-07;2373;32;0;0;76;0;0;0;0;214426;66325;0;0;69411;0;0;0;0
FR;2;2021-03-08;4166;8392;0;0;8549;0;0;0;0;218592;74717;0;0;77960;0;0;0;0
FR;2;2021-03-09;7494;8610;1;0;8868;0;0;0;0;226086;83327;1;0;86828;0;0;0;0
FR;2;2021-03-10;7108;9246;0;0;9473;0;0;0;0;233194;92573;1;0;96301;0;0;0;0
FR;2;2021-03-11;9379;9365;1;0;9685;0;0;0;0;242573;101938;2;0;105986;0;0;0;0
FR;2;2021-03-12;7988;8367;0;0;8669;0;0;0;0;250561;110305;2;0;114655;0;0;0;0
FR;2;2021-03-13;10057;2593;0;0;2914;0;0;0;0;260618;112898;2;0;117569;0;0;0;0
FR;2;2021-03-14;4841;380;0;0;539;0;0;0;0;265459;113278;2;0;118108;0;0;0;0
FR;2;2021-03-15;10919;3476;0;0;3765;0;0;0;0;276378;116754;2;0;121873;0;0;0;0
FR;2;2021-03-16;16770;4732;1;0;5282;0;0;0;0;293148;121486;3;0;127155;0;0;0;0
FR;2;2021-03-17;20242;3998;0;0;4672;0;0;0;0;313390;125484;3;0;131827;0;0;0;0
FR;2;2021-03-18;23375;5128;0;0;5957;0;0;0;0;336765;130612;3;0;137784;0;0;0;0
FR;2;2021-03-19;23316;4680;0;0;5442;0;0;0;0;360081;135292;3;0;143226;0;0;0;0
FR;2;2021-03-20;25452;1587;0;0;2344;0;0;0;0;385533;136879;3;0;145570;0;0;0;0
FR;2;2021-03-21;17674;153;0;0;731;0;0;0;0;403207;137032;3;0;146301;0;0;0;0
FR;2;2021-03-22;17791;3261;0;0;3930;0;0;0;0;420998;140293;3;0;150231;0;0;0;0
FR;2;2021-03-23;22707;4287;0;0;5141;0;0;0;0;443705;144580;3;0;155372;0;0;0;0
FR;2;2021-03-24;23966;5091;0;0;5928;0;0;0;0;467671;149671;3;0;161300;0;0;0;0
FR;2;2021-03-25;26762;5257;1;0;6454;0;0;0;0;494433;154928;4;0;167754;0;0;0;0
FR;2;2021-03-26;26992;4237;0;0;5383;0;0;0;0;521425;159165;4;0;173137;0;0;0;0
FR;2;2021-03-27;15923;1368;0;0;1898;0;0;0;0;537348;160533;4;0;175035;0;0;0;0
FR;2;2021-03-28;10563;136;0;0;428;0;0;0;0;547911;160669;4;0;175463;0;0;0;0
FR;2;2021-03-29;19004;4349;0;0;5049;0;0;0;0;566915;165018;4;0;180512;0;0;0;0
FR;2;2021-03-30;24597;6105;0;0;7045;0;0;0;0;591512;171123;4;0;187557;0;0;0;0
FR;2;2021-03-31;28562;5930;0;0;7222;0;0;0;0;620074;177053;4;0;194779;0;0;0;0
FR;2;2021-04-01;34559;8575;1;0;10268;0;0;0;0;654633;185628;5;0;205047;0;0;0;0
FR;2;2021-04-02;29992;7736;0;0;9164;0;0;0;0;684625;193364;5;0;214211;0;0;0;0
FR;2;2021-04-03;16959;4263;0;0;4945;0;0;0;0;701584;197627;5;0;219156;0;0;0;0
FR;2;2021-04-04;9309;1268;2;0;1676;0;0;0;0;710893;198895;7;0;220832;0;0;0;0
FR;2;2021-04-05;12448;797;0;0;1381;0;0;0;0;723341;199692;7;0;222213;0;0;0;0
FR;2;2021-04-06;27159;7358;0;0;8750;0;0;0;0;750500;207050;7;0;230963;0;0;0;0
FR;2;2021-04-07;30931;7071;1;0;8647;0;0;0;0;781431;214121;8;0;239610;0;0;0;0
FR;2;2021-04-08;36896;8591;1;0;10516;0;0;0;0;818327;222712;9;0;250126;0;0;0;0
FR;2;2021-04-09;33856;8389;28;0;10174;0;0;0;0;852183;231101;37;0;260300;0;0;0;0
FR;2;2021-04-10;19689;9270;1;0;10182;0;0;0;0;871872;240371;38;0;270482;0;0;0;0
FR;2;2021-04-11;7943;4240;1;0;4603;0;0;0;0;879815;244611;39;0;275085;0;0;0;0
FR;2;2021-04-12;17136;11028;0;0;11869;0;0;0;0;896951;255639;39;0;286954;0;0;0;0
FR;2;2021-04-13;19465;16038;1;0;17106;0;0;0;0;916416;271677;40;0;304060;0;0;0;0
FR;2;2021-04-14;18072;16445;7;0;17541;0;0;0;0;934488;288122;47;0;321601;0;0;0;0
FR;2;2021-04-15;22207;21886;27;0;23340;0;0;0;0;956695;310008;74;0;344941;0;0;0;0
FR;2;2021-04-16;20721;20645;45;0;21918;0;0;0;0;977416;330653;119;0;366859;0;0;0;0
FR;2;2021-04-17;13258;22495;5;0;23226;0;0;0;0;990674;353148;124;0;390085;0;0;0;0
FR;2;2021-04-18;5911;14398;6;0;14739;0;0;0;0;996585;367546;130;0;404824;0;0;0;0
FR;2;2021-04-19;16850;16395;24;0;17198;0;0;0;0;1013435;383941;154;0;422022;0;0;0;0
FR;2;2021-04-20;19328;21806;38;0;22868;0;0;0;0;1032763;405747;192;0;444890;0;0;0;0
FR;2;2021-04-21;20294;21901;76;0;23051;0;0;0;0;1053057;427648;268;0;467941;0;0;0;0
FR;2;2021-04-22;23824;24955;41;0;26367;0;0;0;0;1076881;452603;309;0;494308;0;0;0;0
FR;2;2021-04-23;24534;25499;76;0;27010;0;0;0;0;1101415;478102;385;0;521318;0;0;0;0
FR;2;2021-04-24;25305;15068;104;0;16506;0;0;0;0;1126720;493170;489;0;537824;0;0;0;0
FR;2;2021-04-25;9597;8622;5;0;9183;0;0;0;0;1136317;501792;494;0;547007;0;0;0;0
FR;2;2021-04-26;17169;17678;21;0;18564;0;0;0;0;1153486;519470;515;0;565571;0;0;0;0
FR;2;2021-04-27;19246;24099;40;0;25283;0;0;0;0;1172732;543569;555;0;590854;0;0;0;0
FR;2;2021-04-28;22343;26463;113;0;27864;0;0;0;0;1195075;570032;668;0;618718;0;0;0;0
FR;2;2021-04-29;25476;30497;70;0;32187;0;0;0;0;1220551;600529;738;0;650905;0;0;0;0
FR;2;2021-04-30;25540;27976;49;1;29626;0;0;0;0;1246091;628505;787;1;680531;0;0;0;0
FR;2;2021-05-01;14988;9853;6;0;10654;0;0;0;0;1261079;638358;793;1;691185;0;0;0;0
FR;2;2021-05-02;6642;9160;2;0;9506;0;0;0;0;1267721;647518;795;1;700691;0;0;0;0
FR;2;2021-05-03;20026;19126;40;0;20333;0;0;0;0;1287747;666644;835;1;721024;0;0;0;0
FR;2;2021-05-04;18288;29202;33;0;30348;0;0;0;0;1306035;695846;868;1;751372;0;0;0;0
FR;2;2021-05-05;18385;29524;48;0;30823;0;0;0;0;1324420;725370;916;1;782195;0;0;0;0
FR;2;2021-05-06;23553;35413;132;0;36986;0;0;0;0;1347973;760783;1048;1;819181;0;0;0;0
FR;2;2021-05-07;25349;33240;97;0;35098;0;0;0;0;1373322;794023;1145;1;854279;0;0;0;0
FR;2;2021-05-08;21343;10683;15;0;11770;0;0;0;0;1394665;804706;1160;1;866049;0;0;0;0
FR;2;2021-05-09;13170;7622;7;0;8297;0;0;0;0;1407835;812328;1167;1;874346;0;0;0;0
FR;2;2021-05-10;32947;21717;50;0;23574;0;0;0;0;1440782;834045;1217;1;897920;0;0;0;0
FR;2;2021-05-11;43616;20904;101;0;23529;0;0;0;0;1484398;854949;1318;1;921449;0;0;0;0
FR;2;2021-05-12;50070;19638;143;0;22519;0;0;0;0;1534468;874587;1461;1;943968;0;0;0;0
FR;2;2021-05-13;51301;5599;31;0;8467;0;0;0;0;1585769;880186;1492;1;952435;0;0;0;0
FR;2;2021-05-14;61361;12884;132;0;16538;0;0;0;0;1647130;893070;1624;1;968973;0;0;0;0
FR;2;2021-05-15;65938;7100;40;0;10650;0;0;0;0;1713068;900170;1664;1;979623;0;0;0;0
FR;2;2021-05-16;43588;2573;10;0;4944;0;0;0;0;1756656;902743;1674;1;984567;0;0;0;0
FR;2;2021-05-17;44756;12448;114;0;15355;0;0;0;0;1801412;915191;1788;1;999922;0;0;0;0
FR;2;2021-05-18;54650;12286;190;0;15969;0;0;0;0;1856062;927477;1978;1;1015891;0;0;0;0
FR;2;2021-05-19;57179;10459;281;0;14499;0;0;0;0;1913241;937936;2259;1;1030390;0;0;0;0
FR;2;2021-05-20;63451;10797;288;0;14893;0;0;0;0;1976692;948733;2547;1;1045283;0;0;0;0
FR;2;2021-05-21;64306;11603;230;0;16028;0;0;0;0;2040998;960336;2777;1;1061311;0;0;0;0
FR;2;2021-05-22;61488;4531;65;0;8501;0;0;0;0;2102486;964867;2842;1;1069812;0;0;0;0
FR;2;2021-05-23;37536;576;22;0;2913;0;0;0;0;2140022;965443;2864;1;1072725;0;0;0;0
FR;2;2021-05-24;17248;2052;35;0;3259;0;0;0;0;2157270;967495;2899;1;1075984;0;0;0;0
FR;2;2021-05-25;21121;12253;241;0;13854;0;0;0;0;2178391;979748;3140;1;1089838;0;0;0;0
FR;2;2021-05-26;19946;11539;230;0;13067;0;0;0;0;2198337;991287;3370;1;1102905;0;0;0;0
FR;2;2021-05-27;23001;12664;182;0;14402;0;0;0;0;2221338;1003951;3552;1;1117307;0;0;0;0
FR;2;2021-05-28;29397;15046;190;0;17226;0;0;0;0;2250735;1018997;3742;1;1134533;0;0;0;0
FR;2;2021-05-29;30425;8194;58;0;10103;0;0;0;0;2281160;1027191;3800;1;1144636;0;0;0;0
FR;2;2021-05-30;4648;1820;6;0;2155;0;0;0;0;2285808;1029011;3806;1;1146791;0;0;0;0
FR;2;2021-05-31;28590;18743;184;0;20822;0;0;0;0;2314398;1047754;3990;1;1167613;0;0;0;0
FR;2;2021-06-01;45744;19915;225;0;23151;0;0;0;0;2360142;1067669;4215;1;1190764;0;0;0;0
FR;2;2021-06-02;37483;19311;182;0;22317;0;0;0;0;2397625;1086980;4397;1;1213081;0;0;0;0
FR;2;2021-06-03;51283;23117;161;0;26970;0;0;0;0;2448908;1110097;4558;1;1240051;0;0;0;0
FR;2;2021-06-04;65518;24090;217;0;29055;0;0;0;0;2514426;1134187;4775;1;1269106;0;0;0;0
FR;2;2021-06-05;34607;24111;52;0;26966;0;0;0;0;2549033;1158298;4827;1;1296072;0;0;0;0
FR;2;2021-06-06;4958;6194;10;0;6613;0;0;0;0;2553991;1164492;4837;1;1302685;0;0;0;0
FR;2;2021-06-07;28177;23015;150;0;25431;0;0;0;0;2582168;1187507;4987;1;1328116;0;0;0;0
FR;2;2021-06-08;46379;22944;143;0;26910;0;0;0;0;2628547;1210451;5130;1;1355026;0;0;0;0
FR;2;2021-06-09;34297;20999;107;0;24131;0;0;0;0;2662844;1231450;5237;1;1379157;0;0;0;0
FR;2;2021-06-10;42644;19081;96;1;23003;0;0;0;0;2705488;1250531;5333;2;1402160;0;0;0;0
FR;2;2021-06-11;55305;25133;134;0;30232;0;0;0;0;2760793;1275664;5467;2;1432392;0;0;0;0
FR;2;2021-06-12;30566;19800;53;0;22654;0;0;0;0;2791359;1295464;5520;2;1455046;0;0;0;0
FR;2;2021-06-13;3334;9197;13;0;9586;0;0;0;0;2794693;1304661;5533;2;1464632;0;0;0;0
FR;2;2021-06-14;25304;24119;92;0;26699;0;0;0;0;2819997;1328780;5625;2;1491331;0;0;0;0
FR;2;2021-06-15;39049;22819;154;0;26567;0;0;0;0;2859046;1351599;5779;2;1517898;0;0;0;0
FR;2;2021-06-16;30168;21368;135;0;24522;0;0;0;0;2889214;1372967;5914;2;1542420;0;0;0;0
FR;2;2021-06-17;36913;25739;150;0;29601;0;0;0;0;2926127;1398706;6064;2;1572021;0;0;0;0
FR;2;2021-06-18;46860;28887;123;0;33589;0;0;0;0;2972987;1427593;6187;2;1605610;0;0;0;0
FR;2;2021-06-19;24527;24939;39;0;27713;0;0;0;0;2997514;1452532;6226;2;1633323;0;0;0;0
FR;2;2021-06-20;3745;10058;9;0;10557;0;0;0;0;3001259;1462590;6235;2;1643880;0;0;0;0
FR;2;2021-06-21;17538;42860;88;0;44872;0;0;0;0;3018797;1505450;6323;2;1688752;0;0;0;0
FR;2;2021-06-22;28366;49616;110;0;53044;0;0;0;0;3047163;1555066;6433;2;1741796;0;0;0;0
FR;2;2021-06-23;21790;49618;107;1;52467;1;0;0;0;3068953;1604684;6540;3;1794263;1;0;0;0
FR;2;2021-06-24;28380;50316;134;0;54047;0;0;0;0;3097333;1655000;6674;3;1848310;1;0;0;0
FR;2;2021-06-25;33402;60490;129;0;64879;0;0;0;0;3130735;1715490;6803;3;1913189;1;0;0;0
FR;2;2021-06-26;16395;59356;54;1;61748;0;0;0;0;3147130;1774846;6857;4;1974937;1;0;0;0
FR;2;2021-06-27;2566;29316;22;1;29898;0;0;0;0;3149696;1804162;6879;5;2004835;1;0;0;0
FR;2;2021-06-28;12641;54340;84;0;56316;0;0;0;0;3162337;1858502;6963;5;2061151;1;0;0;0
FR;2;2021-06-29;19857;59998;178;0;62941;0;0;0;0;3182194;1918500;7141;5;2124092;1;0;0;0
FR;2;2021-06-30;16337;58037;253;17;60721;0;0;0;0;3198531;1976537;7394;22;2184813;1;0;0;0
FR;2;2021-07-01;20497;59873;228;0;63200;0;0;0;0;3219028;2036410;7622;22;2248013;1;0;0;0
FR;2;2021-07-02;24083;62159;184;0;66373;0;0;0;0;3243111;2098569;7806;22;2314386;1;0;0;0
FR;2;2021-07-03;12123;57146;153;0;59485;0;0;0;0;3255234;2155715;7959;22;2373871;1;0;0;0
FR;2;2021-07-04;1961;23304;18;0;23871;0;0;0;0;3257195;2179019;7977;22;2397742;1;0;0;0
FR;2;2021-07-05;9179;29257;106;0;30893;0;0;0;0;3266374;2208276;8083;22;2428635;1;0;0;0
FR;2;2021-07-06;14584;36279;135;0;38958;0;0;0;0;3280958;2244555;8218;22;2467593;1;0;0;0
FR;2;2021-07-07;14420;33663;140;0;36417;0;0;0;0;3295378;2278218;8358;22;2504010;1;0;0;0
FR;2;2021-07-08;19723;40322;162;0;43979;0;0;0;0;3315101;2318540;8520;22;2547989;1;0;0;0
FR;2;2021-07-09;27105;54333;202;1;59483;0;0;0;0;3342206;2372873;8722;23;2607472;1;0;0;0
FR;2;2021-07-10;13388;33710;107;0;36394;0;0;0;0;3355594;2406583;8829;23;2643866;1;0;0;0
FR;2;2021-07-11;1812;4344;16;0;4772;0;0;0;0;3357406;2410927;8845;23;2648638;1;0;0;0
FR;2;2021-07-12;12971;37265;119;0;39921;0;0;0;0;3370377;2448192;8964;23;2688559;1;0;0;0
FR;2;2021-07-13;37120;53147;152;0;60283;0;0;0;0;3407497;2501339;9116;23;2748842;1;0;0;0
FR;2;2021-07-14;6628;3540;15;0;4888;0;0;0;0;3414125;2504879;9131;23;2753730;1;0;0;0
FR;2;2021-07-15;47244;47014;156;0;55212;0;0;0;0;3461369;2551893;9287;23;2808942;1;0;0;0
FR;2;2021-07-16;64320;55754;188;0;66738;0;0;0;0;3525689;2607647;9475;23;2875680;1;0;0;0
FR;2;2021-07-17;31603;23919;96;0;29376;0;0;0;0;3557292;2631566;9571;23;2905056;1;0;0;0
FR;2;2021-07-18;6091;4807;19;0;5953;0;0;0;0;3563383;2636373;9590;23;2911009;1;0;0;0
FR;2;2021-07-19;33007;28599;94;0;34212;0;0;0;0;3596390;2664972;9684;23;2945221;1;0;0;0
FR;2;2021-07-20;52000;44525;155;0;53161;0;0;0;0;3648390;2709497;9839;23;2998382;1;0;0;0
FR;2;2021-07-21;45257;34626;93;0;42131;0;0;0;0;3693647;2744123;9932;23;3040513;1;0;0;0
FR;2;2021-07-22;56280;41083;128;1;50357;0;0;0;0;3749927;2785206;10060;24;3090870;1;0;0;0
FR;2;2021-07-23;68304;48965;170;0;60256;0;0;0;0;3818231;2834171;10230;24;3151126;1;0;0;0
FR;2;2021-07-24;36178;21613;82;0;27471;0;0;0;0;3854409;2855784;10312;24;3178597;1;0;0;0
FR;2;2021-07-25;6751;2608;10;0;3866;0;0;0;0;3861160;2858392;10322;24;3182463;1;0;0;0
FR;2;2021-07-26;36320;22335;91;1;27838;0;0;0;0;3897480;2880727;10413;25;3210301;1;0;0;0
FR;2;2021-07-27;62391;34563;180;0;43709;0;0;0;0;3959871;2915290;10593;25;3254010;1;0;0;0
FR;2;2021-07-28;55327;26426;132;0;34514;0;0;0;0;4015198;2941716;10725;25;3288524;1;0;0;0
FR;2;2021-07-29;68481;32797;189;0;42478;0;0;0;0;4083679;2974513;10914;25;3331002;1;0;0;0
FR;2;2021-07-30;74468;37814;222;1;48607;0;0;0;0;4158147;3012327;11136;26;3379609;1;0;0;0
FR;2;2021-07-31;34778;16206;105;0;21405;0;0;0;0;4192925;3028533;11241;26;3401014;1;0;0;0
FR;2;2021-08-01;5416;2260;19;0;3123;0;0;0;0;4198341;3030793;11260;26;3404137;1;0;0;0
FR;2;2021-08-02;35896;16150;101;0;21052;0;0;0;0;4234237;3046943;11361;26;3425189;1;0;0;0
FR;2;2021-08-03;55988;28258;143;0;35461;0;0;0;0;4290225;3075201;11504;26;3460650;1;0;0;0
FR;2;2021-08-04;46639;20828;128;1;26936;0;0;0;0;4336864;3096029;11632;27;3487586;1;0;0;0
FR;2;2021-08-05;54641;31562;215;0;38738;0;0;0;0;4391505;3127591;11847;27;3526324;1;0;0;0
FR;2;2021-08-06;58098;42398;242;1;50227;0;0;0;0;4449603;3169989;12089;28;3576551;1;0;0;0
FR;2;2021-08-07;25152;17628;89;0;21318;0;0;0;0;4474755;3187617;12178;28;3597869;1;0;0;0
FR;2;2021-08-08;3840;3653;21;0;4311;0;0;0;0;4478595;3191270;12199;28;3602180;1;0;0;0
FR;2;2021-08-09;29308;21023;92;0;24850;0;0;0;0;4507903;3212293;12291;28;3627030;1;0;0;0
FR;2;2021-08-10;45013;33464;155;0;39226;0;0;0;0;4552916;3245757;12446;28;3666256;1;0;0;0
FR;2;2021-08-11;35277;25141;151;0;29742;0;0;0;0;4588193;3270898;12597;28;3695998;1;0;0;0
FR;2;2021-08-12;41905;35692;163;0;41229;0;0;0;0;4630098;3306590;12760;28;3737227;1;0;0;0
FR;2;2021-08-13;42608;37351;218;0;43037;0;0;0;0;4672706;3343941;12978;28;3780264;1;0;0;0
FR;2;2021-08-14;18524;22132;94;0;24763;0;0;0;0;4691230;3366073;13072;28;3805027;1;0;0;0
FR;2;2021-08-15;3865;3795;17;0;4382;0;0;0;0;4695095;3369868;13089;28;3809409;1;0;0;0
FR;2;2021-08-16;25094;27123;111;0;30445;0;0;0;0;4720189;3396991;13200;28;3839854;1;0;0;0
FR;2;2021-08-17;38269;43399;207;2;48384;0;0;0;0;4758458;3440390;13407;30;3888238;1;0;0;0
FR;2;2021-08-18;32254;36352;195;1;40695;0;0;0;0;4790712;3476742;13602;31;3928933;1;0;0;0
FR;2;2021-08-19;37435;46574;224;0;51777;0;0;0;0;4828147;3523316;13826;31;3980710;1;0;0;0
FR;2;2021-08-20;40568;55649;271;1;61575;0;0;0;0;4868715;3578965;14097;32;4042285;1;0;0;0
FR;2;2021-08-21;18120;24320;117;0;27112;0;0;0;0;4886835;3603285;14214;32;4069397;1;0;0;0
FR;2;2021-08-22;2909;4321;22;1;4853;1;0;0;0;4889744;3607606;14236;33;4074250;2;0;0;0
FR;2;2021-08-23;19249;35149;131;1;38038;0;0;0;0;4908993;3642755;14367;34;4112288;2;0;0;0
FR;2;2021-08-24;31952;56036;236;0;60693;0;0;0;0;4940945;3698791;14603;34;4172981;2;0;0;0
FR;2;2021-08-25;25934;43455;251;0;47404;0;0;0;0;4966879;3742246;14854;34;4220385;2;0;0;0
FR;2;2021-08-26;32362;55844;388;0;60583;0;0;0;0;4999241;3798090;15242;34;4280968;2;0;0;0
FR;2;2021-08-27;37004;65679;477;2;71405;0;0;0;0;5036245;3863769;15719;36;4352373;2;0;0;0
FR;2;2021-08-28;17819;28556;300;0;31616;0;0;0;0;5054064;3892325;16019;36;4383989;2;0;0;0
FR;2;2021-08-29;2656;5010;47;0;5621;0;0;0;0;5056720;3897335;16066;36;4389610;2;0;0;0
FR;2;2021-08-30;18418;37728;399;0;40148;756;0;0;0;5075138;3935063;16465;36;4429758;758;0;0;0
FR;2;2021-08-31;28077;57518;887;4;60949;1558;0;0;0;5103215;3992581;17352;40;4490707;2316;0;0;0
FR;2;2021-09-01;21594;39874;1309;0;42256;2128;0;0;0;5124809;4032455;18661;40;4532963;4444;0;0;0
FR;2;2021-09-02;25486;48669;1963;2;50944;3369;0;0;0;5150295;4081124;20624;42;4583907;7813;0;0;0
FR;2;2021-09-03;33414;64575;2988;3;67539;4886;1;0;0;5183709;4145699;23612;45;4651446;12699;1;0;0
FR;2;2021-09-04;16833;27766;1443;1;29557;2386;0;0;0;5200542;4173465;25055;46;4681003;15085;1;0;0
FR;2;2021-09-05;2265;3584;266;0;3940;412;0;0;0;5202807;4177049;25321;46;4684943;15497;1;0;0
FR;2;2021-09-06;14044;28693;1771;1;29759;2945;0;0;0;5216851;4205742;27092;47;4714702;18442;1;0;0
FR;2;2021-09-07;21111;41112;3022;13;42266;4944;0;0;0;5237962;4246854;30114;60;4756968;23386;1;0;0
FR;2;2021-09-08;17248;31920;2735;6;32738;4497;0;0;0;5255210;4278774;32849;66;4789706;27883;1;0;0
FR;2;2021-09-09;20982;40484;4437;3;41229;6842;0;0;0;5276192;4319258;37286;69;4830935;34725;1;0;0
FR;2;2021-09-10;28203;51314;5286;4;51884;8979;1;0;0;5304395;4370572;42572;73;4882819;43704;2;0;0
FR;2;2021-09-11;13655;22457;2405;5;23133;3987;0;0;0;5318050;4393029;44977;78;4905952;47691;2;0;0
FR;2;2021-09-12;1824;2773;292;0;2965;512;0;0;0;5319874;4395802;45269;78;4908917;48203;2;0;0
FR;2;2021-09-13;11659;21441;2474;4;21702;4051;0;0;0;5331533;4417243;47743;82;4930619;52254;2;0;0
FR;2;2021-09-14;18577;32720;5092;13;31679;9055;2;0;0;5350110;4449963;52835;95;4962298;61309;4;0;0
FR;2;2021-09-15;14917;28227;5168;3;26928;7748;9;0;0;5365027;4478190;58003;98;4989226;69057;13;0;0
FR;2;2021-09-16;16078;32798;6737;12;30179;10541;4;0;0;5381105;4510988;64740;110;5019405;79598;17;0;0
FR;2;2021-09-17;20916;47179;8782;10;42826;14631;6;0;0;5402021;4558167;73522;120;5062231;94229;23;0;0
FR;2;2021-09-18;9857;20960;3804;6;19596;6034;1;0;0;5411878;4579127;77326;126;5081827;100263;24;0;0
FR;2;2021-09-19;1166;2590;396;0;2533;631;0;0;0;5413044;4581717;77722;126;5084360;100894;24;0;0
FR;2;2021-09-20;7503;18703;3856;7;17026;6135;4;0;0;5420547;4600420;81578;133;5101386;107029;28;0;0
FR;2;2021-09-21;11215;29983;6495;5;26536;10744;3;0;0;5431762;4630403;88073;138;5127922;117773;31;0;0
FR;2;2021-09-22;9414;23545;5490;6;21193;8526;8;0;0;5441176;4653948;93563;144;5149115;126299;39;0;0
FR;2;2021-09-23;10730;28904;7881;10;24733;12646;10;0;0;5451906;4682852;101444;154;5173848;138945;49;0;0
FR;2;2021-09-24;15075;42945;10878;18;37280;17245;21;0;0;5466981;4725797;112322;172;5211128;156190;70;0;0
FR;2;2021-09-25;7258;18798;3965;9;17152;6120;3;0;0;5474239;4744595;116287;181;5228280;162310;73;0;0
FR;2;2021-09-26;1080;2544;495;0;2490;630;1;0;0;5475319;4747139;116782;181;5230770;162940;74;0;0
FR;2;2021-09-27;6311;16400;4287;8;14792;6533;2;0;0;5481630;4763539;121069;189;5245562;169473;76;0;0
FR;2;2021-09-28;9243;25572;7770;14;21721;12087;7;0;0;5490873;4789111;128839;203;5267283;181560;83;0;0
FR;2;2021-09-29;8081;20199;6067;25;17605;9261;8;0;0;5498954;4809310;134906;228;5284888;190821;91;0;0
FR;2;2021-09-30;9865;25838;9509;16;21639;14099;6;0;0;5508819;4835148;144415;244;5306527;204920;97;0;0
FR;2;2021-10-01;13978;35733;12921;25;30043;19328;9;0;0;5522797;4870881;157336;269;5336570;224248;106;0;0
FR;2;2021-10-02;6874;15933;4850;7;14227;7046;6;0;0;5529671;4886814;162186;276;5350797;231294;112;0;0
FR;2;2021-10-03;841;1909;492;1;1840;502;0;0;0;5530512;4888723;162678;277;5352637;231796;112;0;0
FR;2;2021-10-04;5826;13901;5516;5;12137;7854;6;0;0;5536338;4902624;168194;282;5364774;239650;118;0;0
FR;2;2021-10-05;9058;22570;11125;19;18530;15741;1;0;0;5545396;4925194;179319;301;5383304;255391;119;0;0
FR;2;2021-10-06;7785;17747;8243;11;15273;11091;4;0;0;5553181;4942941;187562;312;5398577;266482;123;0;0
FR;2;2021-10-07;9203;22213;12386;14;18005;16879;6;0;0;5562384;4965154;199948;326;5416582;283361;129;0;0
FR;2;2021-10-08;13432;32144;17349;28;26518;23609;11;0;0;5575816;4997298;217297;354;5443100;306970;140;0;0
FR;2;2021-10-09;6000;12847;6044;6;11381;7897;7;0;0;5581816;5010145;223341;360;5454481;314867;147;0;0
FR;2;2021-10-10;885;1592;436;2;1536;604;1;0;0;5582701;5011737;223777;362;5456017;315471;148;0;0
FR;2;2021-10-11;5607;11545;6455;17;9934;8828;3;0;0;5588308;5023282;230232;379;5465951;324299;151;0;0
FR;2;2021-10-12;8030;17789;12551;13;13920;16790;9;0;0;5596338;5041071;242783;392;5479871;341089;160;0;0
FR;2;2021-10-13;6947;14863;10256;12;11808;13659;7;0;0;5603285;5055934;253039;404;5491679;354748;167;0;0
FR;2;2021-10-14;8314;17940;14996;13;13558;19477;10;0;0;5611599;5073874;268035;417;5505237;374225;177;0;0
FR;2;2021-10-15;11856;26309;20902;26;19412;27981;4;0;0;5623455;5100183;288937;443;5524649;402206;181;0;0
FR;2;2021-10-16;5141;8732;1819;0;8173;3209;2;0;0;5628596;5108915;290756;443;5532822;405415;183;0;0
FR;2;2021-10-17;654;1149;185;0;1082;354;1;0;0;5629250;5110064;290941;443;5533904;405769;184;0;0
FR;2;2021-10-18;4564;7337;665;2;7243;1630;0;0;0;5633814;5117401;291606;445;5541147;407399;184;0;0
FR;2;2021-10-19;6239;9849;732;5;9656;2030;5;0;0;5640053;5127250;292338;450;5550803;409429;189;0;0
FR;2;2021-10-20;5170;8050;759;3;8172;1675;0;0;0;5645223;5135300;293097;453;5558975;411104;189;0;0
FR;2;2021-10-21;6090;9981;780;5;9838;2105;1;0;0;5651313;5145281;293877;458;5568813;413209;190;0;0
FR;2;2021-10-22;8452;14599;1151;4;14475;2891;2;0;0;5659765;5159880;295028;462;5583288;416100;192;0;0
FR;2;2021-10-23;3845;5994;587;0;6127;1235;3;0;0;5663610;5165874;295615;462;5589415;417335;195;0;0
FR;2;2021-10-24;494;882;101;0;900;204;0;0;0;5664104;5166756;295716;462;5590315;417539;195;0;0
FR;2;2021-10-25;3360;5343;307;1;5519;825;2;0;0;5667464;5172099;296023;463;5595834;418364;197;0;0
FR;2;2021-10-26;4177;7237;1133;4;7126;2022;5;0;0;5671641;5179336;297156;467;5602960;420386;202;0;0
FR;2;2021-10-27;3677;6587;1194;5;6448;1990;1;0;0;5675318;5185923;298350;472;5609408;422376;203;0;0
FR;2;2021-10-28;4597;7687;1737;3;7415;2746;1;0;0;5679915;5193610;300087;475;5616823;425122;204;0;0
FR;2;2021-10-29;5414;11082;2438;4;10692;3684;3;0;0;5685329;5204692;302525;479;5627515;428806;207;0;0
FR;2;2021-10-30;2749;4459;976;1;4454;1448;2;0;0;5688078;5209151;303501;480;5631969;430254;209;0;0
FR;2;2021-10-31;364;535;140;1;544;191;1;0;0;5688442;5209686;303641;481;5632513;430445;210;0;0
FR;2;2021-11-01;429;546;181;0;563;267;1;0;0;5688871;5210232;303822;481;5633076;430712;211;0;0
FR;2;2021-11-02;3294;6759;1184;0;6799;1771;5;0;0;5692165;5216991;305006;481;5639875;432483;216;0;0
FR;2;2021-11-03;3340;6226;1389;2;6311;1970;2;0;0;5695505;5223217;306395;483;5646186;434453;218;0;0
FR;2;2021-11-04;3987;7069;1769;4;7109;2495;3;0;0;5699492;5230286;308164;487;5653295;436948;221;0;0
FR;2;2021-11-05;5235;10502;2868;5;10215;3957;5;0;0;5704727;5240788;311032;492;5663510;440905;226;0;0
FR;2;2021-11-06;2597;4683;1407;0;4640;1824;2;0;0;5707324;5245471;312439;492;5668150;442729;228;0;0
FR;2;2021-11-07;506;862;221;0;869;291;2;0;0;5707830;5246333;312660;492;5669019;443020;230;0;0
FR;2;2021-11-08;2578;5348;1207;3;5268;1678;3;0;0;5710408;5251681;313867;495;5674287;444698;233;0;0
FR;2;2021-11-09;2749;6908;2402;5;6442;3182;2;0;0;5713157;5258589;316269;500;5680729;447880;235;0;0
FR;2;2021-11-10;2590;5669;5117;6;4761;6294;7;0;0;5715747;5264258;321386;506;5685490;454174;242;0;0
FR;2;2021-11-11;446;754;755;2;647;938;3;0;0;5716193;5265012;322141;508;5686137;455112;245;0;0
FR;2;2021-11-12;2953;8087;8982;8;6195;10933;9;0;0;5719146;5273099;331123;516;5692332;466045;254;0;0
FR;2;2021-11-13;1539;3373;3872;7;2722;4538;4;0;0;5720685;5276472;334995;523;5695054;470583;258;0;0
FR;2;2021-11-14;258;585;351;1;486;480;3;0;0;5720943;5277057;335346;524;5695540;471063;261;0;0
FR;2;2021-11-15;1621;3655;4449;8;2909;5329;16;0;0;5722564;5280712;339795;532;5698449;476392;277;0;0
FR;2;2021-11-16;2184;5878;8313;14;4155;10082;16;0;0;5724748;5286590;348108;546;5702604;486474;293;0;0
FR;2;2021-11-17;1740;4523;6634;8;3168;7852;5;0;0;5726488;5291113;354742;554;5705772;494326;298;0;0
FR;2;2021-11-18;2192;5920;9188;10;4018;11018;8;0;0;5728680;5297033;363930;564;5709790;505344;306;0;0
FR;2;2021-11-19;2701;7752;12981;19;4832;15480;12;0;0;5731381;5304785;376911;583;5714622;520824;318;0;0
FR;2;2021-11-20;1566;3333;5184;5;2351;6097;3;0;0;5732947;5308118;382095;588;5716973;526921;321;0;0
FR;2;2021-11-21;251;502;543;0;392;655;3;0;0;5733198;5308620;382638;588;5717365;527576;324;0;0
FR;2;2021-11-22;1278;2573;4485;5;1675;5398;9;0;0;5734476;5311193;387123;593;5719040;532974;333;0;0
FR;2;2021-11-23;1617;4277;8206;9;2536;9922;6;0;0;5736093;5315470;395329;602;5721576;542896;339;0;0
FR;2;2021-11-24;1421;3747;7486;14;2246;8736;9;0;0;5737514;5319217;402815;616;5723822;551632;348;0;0
FR;2;2021-11-25;1813;4863;11474;21;2682;13668;6;0;0;5739327;5324080;414289;637;5726504;565300;354;0;0
FR;2;2021-11-26;2541;7735;22676;31;3812;26091;14;0;0;5741868;5331815;436965;668;5730316;591391;368;0;0
FR;2;2021-11-27;1498;4144;12278;19;2127;14042;13;0;0;5743366;5335959;449243;687;5732443;605433;381;0;0
FR;2;2021-11-28;292;835;1976;3;477;2303;5;0;0;5743658;5336794;451219;690;5732920;607736;386;0;0
FR;2;2021-11-29;1449;4349;15099;23;2010;17269;25;0;0;5745107;5341143;466318;713;5734930;625005;411;0;0
FR;2;2021-11-30;1912;6657;26251;36;2639;30012;22;0;0;5747019;5347800;492569;749;5737569;655017;433;0;0
FR;2;2021-12-01;1917;6007;26210;31;2477;29519;20;0;0;5748936;5353807;518779;780;5740046;684536;453;0;0
FR;2;2021-12-02;1916;6780;37736;52;2112;41995;32;0;0;5750852;5360587;556515;832;5742158;726531;485;0;0
FR;2;2021-12-03;2558;10068;53644;111;3591;59392;30;0;0;5753410;5370655;610159;943;5745749;785923;515;0;0
FR;2;2021-12-04;1850;6275;37132;38;2185;40820;16;0;0;5755260;5376930;647291;981;5747934;826743;531;0;0
FR;2;2021-12-05;458;2242;14265;14;533;15990;7;0;0;5755718;5379172;661556;995;5748467;842733;538;0;0
FR;2;2021-12-06;2486;9850;77735;109;2700;84788;25;0;0;5758204;5389022;739291;1104;5751167;927521;563;0;0
FR;2;2021-12-07;3458;15287;122473;238;3742;133794;40;0;0;5761662;5404309;861764;1342;5754909;1061315;603;0;0
FR;2;2021-12-08;3725;15969;133225;330;3846;145414;54;0;0;5765387;5420278;994989;1672;5758755;1206729;657;0;0
FR;2;2021-12-09;4547;19626;170241;554;4167;185638;61;0;0;5769934;5439904;1165230;2226;5762922;1392367;718;0;0
FR;2;2021-12-10;4676;22805;188698;490;5012;206187;69;0;0;5774610;5462709;1353928;2716;5767934;1598554;787;0;0
FR;2;2021-12-11;3688;16620;132468;239;3663;144936;60;0;0;5778298;5479329;1486396;2955;5771597;1743490;847;0;0
FR;2;2021-12-12;1256;7119;59116;83;1015;65170;12;0;0;5779554;5486448;1545512;3038;5772612;1808660;859;0;0
FR;2;2021-12-13;5530;26812;220731;605;5224;243028;159;0;0;5785084;5513260;1766243;3643;5777836;2051688;1018;0;0
FR;2;2021-12-14;7019;37458;300806;909;6136;332278;190;0;0;5792103;5550718;2067049;4552;5783972;2383966;1208;0;0
FR;2;2021-12-15;6555;36214;285263;958;5866;315900;186;0;0;5798658;5586932;2352312;5510;5789838;2699866;1394;0;0
FR;2;2021-12-16;7765;37921;312177;982;6566;343816;186;0;0;5806423;5624853;2664489;6492;5796404;3043682;1580;0;0
FR;2;2021-12-17;8681;41188;327909;976;8019;360987;232;0;0;5815104;5666041;2992398;7468;5804423;3404669;1812;0;0
FR;2;2021-12-18;6514;26530;212374;448;4904;233676;120;0;0;5821618;5692571;3204772;7916;5809327;3638345;1932;0;0
FR;2;2021-12-19;2603;11403;90226;182;1655;100356;26;0;0;5824221;5703974;3294998;8098;5810982;3738701;1958;0;0
FR;2;2021-12-20;9548;33517;275258;707;6588;303404;209;0;0;5833769;5737491;3570256;8805;5817570;4042105;2167;0;0
FR;2;2021-12-21;11567;38270;309662;968;7370;341437;262;0;0;5845336;5775761;3879918;9773;5824940;4383542;2429;0;0
FR;2;2021-12-22;10461;32776;265147;952;6442;292503;316;0;1;5855797;5808537;4145065;10725;5831382;4676045;2745;0;1
FR;2;2021-12-23;9426;26618;199534;701;5874;221292;225;0;0;5865223;5835155;4344599;11426;5837256;4897337;2970;0;1
FR;2;2021-12-24;2783;7466;43866;140;2036;49561;78;0;0;5868006;5842621;4388465;11566;5839292;4946898;3048;0;1
FR;2;2021-12-25;201;671;2003;10;209;2478;15;0;0;5868207;5843292;4390468;11576;5839501;4949376;3063;0;1
FR;2;2021-12-26;1320;4215;25161;71;1052;28693;70;0;0;5869527;5847507;4415629;11647;5840553;4978069;3133;0;1
FR;2;2021-12-27;8076;29928;218436;659;6623;243387;294;0;0;5877603;5877435;4634065;12306;5847176;5221456;3427;0;1
FR;2;2021-12-28;9832;36287;272116;742;6982;302014;957;0;1;5887435;5913722;4906181;13048;5854158;5523470;4384;0;2
FR;2;2021-12-29;9498;32219;246150;765;6403;272696;1088;0;0;5896933;5945941;5152331;13813;5860561;5796166;5472;0;2
FR;2;2021-12-30;9464;28093;208838;663;5971;231479;1155;0;0;5906397;5974034;5361169;14476;5866532;6027645;6627;0;2
FR;2;2021-12-31;3011;8341;54991;176;2170;61233;392;0;0;5909408;5982375;5416160;14652;5868702;6088878;7019;0;2
FR;2;2022-01-01;231;693;2858;7;207;3353;29;0;0;5909639;5983068;5419018;14659;5868909;6092231;7048;0;2
FR;2;2022-01-02;1503;4853;29524;76;1165;33413;217;0;0;5911142;5987921;5448542;14735;5870074;6125644;7265;0;2
FR;2;2022-01-03;9606;35396;266544;806;8497;293922;1672;0;0;5920748;6023317;5715086;15541;5878571;6419566;8937;0;2
FR;2;2022-01-04;12856;45400;342103;1068;9971;377040;2458;0;1;5933604;6068717;6057189;16609;5888542;6796606;11395;0;3
FR;2;2022-01-05;11273;38629;294222;884;8635;323858;2154;0;2;5944877;6107346;6351411;17493;5897177;7120464;13549;0;5
FR;2;2022-01-06;13653;43490;331957;1298;9934;364769;2977;0;1;5958530;6150836;6683368;18791;5907111;7485233;16526;0;6
FR;2;2022-01-07;14224;47608;361123;1271;11229;396468;3159;0;0;5972754;6198444;7044491;20062;5918340;7881701;19685;0;6
FR;2;2022-01-08;7946;28136;201273;515;7209;221702;1528;0;2;5980700;6226580;7245764;20577;5925549;8103403;21213;0;8
FR;2;2022-01-09;2749;8948;62531;137;2070;69498;493;0;0;5983449;6235528;7308295;20714;5927619;8172901;21706;0;8
FR;2;2022-01-10;10100;31907;232510;859;8902;255085;2460;0;0;5993549;6267435;7540805;21573;5936521;8427986;24166;0;8
FR;2;2022-01-11;11466;36236;265945;1030;10056;290651;3380;0;1;6005015;6303671;7806750;22603;5946577;8718637;27546;0;9
FR;2;2022-01-12;8766;29783;206336;863;8714;226176;2798;0;5;6013781;6333454;8013086;23466;5955291;8944813;30344;0;14
FR;2;2022-01-13;9387;31334;224510;831;9037;244857;3463;0;4;6023168;6364788;8237596;24297;5964328;9189670;33807;0;18
FR;2;2022-01-14;9744;35576;254550;920;9842;277654;3979;0;1;6032912;6400364;8492146;25217;5974170;9467324;37786;0;19
FR;2;2022-01-15;5361;19443;140786;363;5320;153646;1929;0;0;6038273;6419807;8632932;25580;5979490;9620970;39715;0;19
FR;2;2022-01-16;1512;5457;35893;81;1619;39819;424;0;0;6039785;6425264;8668825;25661;5981109;9660789;40139;0;19
FR;2;2022-01-17;5546;19263;135421;601;6599;147263;2264;0;2;6045331;6444527;8804246;26262;5987708;9808052;42403;0;21
FR;2;2022-01-18;6422;21480;148647;647;7519;160470;3311;0;0;6051753;6466007;8952893;26909;5995227;9968522;45714;0;21
FR;2;2022-01-19;4398;16304;105112;552;6206;113702;2411;0;1;6056151;6482311;9058005;27461;6001433;10082224;48125;0;22
FR;2;2022-01-20;4873;17573;115304;603;7068;123695;3111;0;2;6061024;6499884;9173309;28064;6008501;10205919;51236;0;24
FR;2;2022-01-21;5198;20041;137356;679;7169;147774;3455;0;1;6066222;6519925;9310665;28743;6015670;10353693;54691;0;25
FR;2;2022-01-22;3033;10956;74264;260;3956;80338;1428;0;0;6069255;6530881;9384929;29003;6019626;10434031;56119;0;25
FR;2;2022-01-23;724;2707;15243;41;1055;16826;238;0;0;6069979;6533588;9400172;29044;6020681;10450857;56357;0;25
FR;2;2022-01-24;3292;12792;75084;431;5842;81019;1994;0;2;6073271;6546380;9475256;29475;6026523;10531876;58351;0;27
FR;2;2022-01-25;3575;14405;79636;496;6649;85462;2879;0;4;6076846;6560785;9554892;29971;6033172;10617338;61230;0;31
FR;2;2022-01-26;2515;10702;58986;363;5333;63034;1958;0;1;6079361;6571487;9613878;30334;6038505;10680372;63188;0;32
FR;2;2022-01-27;2684;11385;64185;391;5738;67971;2462;0;1;6082045;6582872;9678063;30725;6044243;10748343;65650;0;33
FR;2;2022-01-28;3551;18259;91730;430;8612;98908;3399;0;1;6085596;6601131;9769793;31155;6052855;10847251;69049;0;34
FR;2;2022-01-29;1896;9233;48856;164;4169;52929;1374;0;1;6087492;6610364;9818649;31319;6057024;10900180;70423;0;35
FR;2;2022-01-30;464;2208;9457;38;1051;10585;203;0;0;6087956;6612572;9828106;31357;6058075;10910765;70626;0;35
FR;2;2022-01-31;1891;9552;43834;209;4710;47322;1886;0;2;6089847;6622124;9871940;31566;6062785;10958087;72512;0;37
FR;2;2022-02-01;1916;10020;47030;279;4797;50080;2707;0;0;6091763;6632144;9918970;31845;6067582;11008167;75219;0;37
FR;2;2022-02-02;1614;8972;41124;250;4191;44148;2189;0;1;6093377;6641116;9960094;32095;6071773;11052315;77408;0;38
FR;2;2022-02-03;1732;8929;40526;205;4370;42910;2640;0;2;6095109;6650045;10000620;32300;6076143;11095225;80048;0;40
FR;2;2022-02-04;2151;15168;66648;299;7382;71316;3670;0;1;6097260;6665213;10067268;32599;6083525;11166541;83718;0;41
FR;2;2022-02-05;1360;8519;35948;132;4214;39222;1369;0;0;6098620;6673732;10103216;32731;6087739;11205763;85087;0;41
FR;2;2022-02-06;275;1761;6130;16;842;6899;217;0;0;6098895;6675493;10109346;32747;6088581;11212662;85304;0;41
FR;2;2022-02-07;1352;9544;37760;134;4535;41289;1888;0;2;6100247;6685037;10147106;32881;6093116;11253951;87192;0;43
FR;2;2022-02-08;1299;9833;40956;173;4645;43750;2741;0;1;6101546;6694870;10188062;33054;6097761;11297701;89933;0;44
FR;2;2022-02-09;1160;8841;37040;174;3804;40465;1901;0;2;6102706;6703711;10225102;33228;6101565;11338166;91834;0;46
FR;2;2022-02-10;1030;8001;33837;204;3605;36511;2051;0;1;6103736;6711712;10258939;33432;6105170;11374677;93885;0;47
FR;2;2022-02-11;1391;12086;53348;223;5282;57701;2888;0;0;6105127;6723798;10312287;33655;6110452;11432378;96773;0;47
FR;2;2022-02-12;753;6535;27989;86;2792;30808;1113;0;2;6105880;6730333;10340276;33741;6113244;11463186;97886;0;49
FR;2;2022-02-13;200;1340;4836;20;562;5577;141;0;0;6106080;6731673;10345112;33761;6113806;11468763;98027;0;49
FR;2;2022-02-14;836;6732;30274;92;2599;33233;1399;0;1;6106916;6738405;10375386;33853;6116405;11501996;99426;0;50
FR;2;2022-02-15;774;6473;28051;140;2801;29994;1965;0;2;6107690;6744878;10403437;33993;6119206;11531990;101391;0;52
FR;2;2022-02-16;657;5363;22069;124;2529;23635;1569;0;3;6108347;6750241;10425506;34117;6121735;11555625;102960;0;55
FR;2;2022-02-17;518;3786;14152;98;2131;14617;1406;0;2;6108865;6754027;10439658;34215;6123866;11570242;104366;0;57
FR;2;2022-02-18;723;5368;20443;134;3040;21130;1895;0;0;6109588;6759395;10460101;34349;6126906;11591372;106261;0;57
FR;2;2022-02-19;431;3061;10533;66;1699;11247;753;0;2;6110019;6762456;10470634;34415;6128605;11602619;107014;0;59
FR;2;2022-02-20;102;520;1463;3;314;1613;100;0;0;6110121;6762976;10472097;34418;6128919;11604232;107114;0;59
FR;2;2022-02-21;423;2685;9122;65;1569;9499;930;0;0;6110544;6765661;10481219;34483;6130488;11613731;108044;0;59
FR;2;2022-02-22;393;2568;8894;77;1622;8797;1180;0;0;6110937;6768229;10490113;34560;6132110;11622528;109224;0;59
FR;2;2022-02-23;432;2605;8992;82;1522;9269;1022;0;0;6111369;6770834;10499105;34642;6133632;11631797;110246;0;59
FR;2;2022-02-24;314;2039;6805;82;1251;6835;870;0;0;6111683;6772873;10505910;34724;6134883;11638632;111116;0;59
FR;2;2022-02-25;456;3210;11423;107;1979;11286;1560;0;3;6112139;6776083;10517333;34831;6136862;11649918;112676;0;62
FR;2;2022-02-26;297;1892;6038;49;1161;6345;587;0;1;6112436;6777975;10523371;34880;6138023;11656263;113263;0;63
FR;2;2022-02-27;76;313;908;5;214;951;98;0;0;6112512;6778288;10524279;34885;6138237;11657214;113361;0;63
FR;2;2022-02-28;332;1689;5525;53;1088;5531;733;0;0;6112844;6779977;10529804;34938;6139325;11662745;114094;0;63
FR;2;2022-03-01;279;1569;5484;46;952;5201;964;0;2;6113123;6781546;10535288;34984;6140277;11667946;115058;0;65
FR;2;2022-03-02;298;1446;5248;46;878;5092;816;0;1;6113421;6782992;10540536;35030;6141155;11673038;115874;0;66
FR;2;2022-03-03;226;1112;3709;42;721;3486;668;0;1;6113647;6784104;10544245;35072;6141876;11676524;116542;0;67
FR;2;2022-03-04;243;1469;4860;74;983;4506;950;0;1;6113890;6785573;10549105;35146;6142859;11681030;117492;0;68
FR;2;2022-03-05;174;906;2981;34;613;2725;561;0;0;6114064;6786479;10552086;35180;6143472;11683755;118053;0;68
FR;2;2022-03-06;42;188;280;5;110;320;52;0;0;6114106;6786667;10552366;35185;6143582;11684075;118105;0;68
FR;2;2022-03-07;157;659;1988;70;491;1778;472;0;0;6114263;6787326;10554354;35255;6144073;11685853;118577;0;68
FR;2;2022-03-08;144;670;2273;53;461;1908;619;0;0;6114407;6787996;10556627;35308;6144534;11687761;119196;0;68
FR;2;2022-03-09;156;709;2351;37;473;2052;617;0;0;6114563;6788705;10558978;35345;6145007;11689813;119813;0;68
FR;2;2022-03-10;123;603;1695;35;446;1470;456;0;1;6114686;6789308;10560673;35380;6145453;11691283;120269;0;69
FR;2;2022-03-11;172;757;2770;57;505;2369;737;0;1;6114858;6790065;10563443;35437;6145958;11693652;121006;0;70
FR;2;2022-03-12;149;485;1787;27;331;1557;450;0;0;6115007;6790550;10565230;35464;6146289;11695209;121456;0;70
FR;2;2022-03-13;25;75;203;30;45;204;69;0;0;6115032;6790625;10565433;35494;6146334;11695413;121525;0;70
FR;2;2022-03-14;129;470;1572;529;333;1301;951;0;0;6115161;6791095;10567005;36023;6146667;11696714;122476;0;70
FR;2;2022-03-15;139;441;1713;691;333;1333;1186;0;1;6115300;6791536;10568718;36714;6147000;11698047;123662;0;71
FR;2;2022-03-16;142;476;2013;1616;331;1593;2160;0;2;6115442;6792012;10570731;38330;6147331;11699640;125822;0;73
FR;2;2022-03-17;95;413;1412;1192;273;1148;1576;0;1;6115537;6792425;10572143;39522;6147604;11700788;127398;0;74
FR;2;2022-03-18;147;496;2025;1795;335;1668;2313;0;1;6115684;6792921;10574168;41317;6147939;11702456;129711;0;75
FR;2;2022-03-19;108;321;1210;941;219;1015;1259;0;0;6115792;6793242;10575378;42258;6148158;11703471;130970;0;75
FR;2;2022-03-20;13;77;191;59;39;168;115;0;0;6115805;6793319;10575569;42317;6148197;11703639;131085;0;75
FR;2;2022-03-21;98;307;1218;1483;181;1081;1760;0;1;6115903;6793626;10576787;43800;6148378;11704720;132845;0;76
FR;2;2022-03-22;118;391;1533;1830;244;1294;2219;0;0;6116021;6794017;10578320;45630;6148622;11706014;135064;0;76
FR;2;2022-03-23;137;362;1684;3032;232;1475;3374;0;6;6116158;6794379;10580004;48662;6148854;11707489;138438;0;82
FR;2;2022-03-24;117;293;1183;1548;186;1001;1814;0;8;6116275;6794672;10581187;50210;6149040;11708490;140252;0;90
FR;2;2022-03-25;119;361;1807;2451;238;1477;2837;0;8;6116394;6795033;10582994;52661;6149278;11709967;143089;0;98
FR;2;2022-03-26;79;247;1205;1222;138;953;1531;0;5;6116473;6795280;10584199;53883;6149416;11710920;144620;0;103
FR;2;2022-03-27;19;36;154;100;19;133;144;0;0;6116492;6795316;10584353;53983;6149435;11711053;144764;0;103
FR;2;2022-03-28;94;290;1139;1602;189;995;1835;0;6;6116586;6795606;10585492;55585;6149624;11712048;146599;0;109
FR;2;2022-03-29;108;258;1325;2467;167;1105;2760;0;4;6116694;6795864;10586817;58052;6149791;11713153;149359;0;113
FR;2;2022-03-30;91;312;1489;3187;163;1320;3424;0;2;6116785;6796176;10588306;61239;6149954;11714473;152783;0;115
FR;2;2022-03-31;104;284;1277;2332;171;1092;2616;0;3;6116889;6796460;10589583;63571;6150125;11715565;155399;0;118
FR;2;2022-04-01;123;324;1568;2349;164;1323;2667;0;7;6117012;6796784;10591151;65920;6150289;11716888;158066;0;125
FR;2;2022-04-02;81;161;845;891;83;737;1052;0;1;6117093;6796945;10591996;66811;6150372;11717625;159118;0;126
FR;2;2022-04-03;16;53;128;113;27;142;133;0;1;6117109;6796998;10592124;66924;6150399;11717767;159251;0;127
FR;2;2022-04-04;114;249;990;1447;151;799;1693;0;5;6117223;6797247;10593114;68371;6150550;11718566;160944;0;132
FR;2;2022-04-05;143;302;1322;2920;162;1150;3149;0;17;6117366;6797549;10594436;71291;6150712;11719716;164093;0;149
FR;2;2022-04-06;89;261;1308;2523;129;1131;2688;0;10;6117455;6797810;10595744;73814;6150841;11720847;166781;0;159
FR;2;2022-04-07;120;230;1303;2682;141;1042;2958;0;8;6117575;6798040;10597047;76496;6150982;11721889;169739;0;167
FR;2;2022-04-08;126;346;1636;3351;182;1328;3642;0;12;6117701;6798386;10598683;79847;6151164;11723217;173381;0;179
FR;2;2022-04-09;90;219;900;1046;144;732;1288;0;4;6117791;6798605;10599583;80893;6151308;11723949;174669;0;183
FR;2;2022-04-10;37;49;143;162;46;119;200;0;1;6117828;6798654;10599726;81055;6151354;11724068;174869;0;184
FR;2;2022-04-11;88;196;892;1560;122;782;1718;0;6;6117916;6798850;10600618;82615;6151476;11724850;176587;0;190
FR;2;2022-04-12;176;273;1183;2770;175;1062;2903;0;8;6118092;6799123;10601801;85385;6151651;11725912;179490;0;198
FR;2;2022-04-13;147;232;1125;2477;111;989;2671;0;11;6118239;6799355;10602926;87862;6151762;11726901;182161;0;209
FR;2;2022-04-14;115;227;1085;2677;114;919;2911;0;18;6118354;6799582;10604011;90539;6151876;11727820;185072;0;227
FR;2;2022-04-15;114;261;1221;2304;131;1078;2544;0;7;6118468;6799843;10605232;92843;6152007;11728898;187616;0;234
FR;2;2022-04-16;67;108;548;549;68;459;675;0;9;6118535;6799951;10605780;93392;6152075;11729357;188291;0;243
FR;2;2022-04-17;15;27;57;53;16;53;71;0;0;6118550;6799978;10605837;93445;6152091;11729410;188362;0;243
FR;2;2022-04-18;12;35;121;70;18;116;95;0;0;6118562;6800013;10605958;93515;6152109;11729526;188457;0;243
FR;2;2022-04-19;112;237;1120;1750;149;951;1934;0;9;6118674;6800250;10607078;95265;6152258;11730477;190391;0;252
FR;2;2022-04-20;95;243;1110;2172;127;934;2366;0;14;6118769;6800493;10608188;97437;6152385;11731411;192757;0;266
FR;2;2022-04-21;111;233;983;1912;125;838;2141;0;10;6118880;6800726;10609171;99349;6152510;11732249;194898;0;276
FR;2;2022-04-22;100;276;1242;2102;141;1023;2440;0;11;6118980;6801002;10610413;101451;6152651;11733272;197338;0;287
FR;2;2022-04-23;67;156;645;762;107;574;862;0;8;6119047;6801158;10611058;102213;6152758;11733846;198200;0;295
FR;2;2022-04-24;12;30;101;68;12;79;100;0;0;6119059;6801188;10611159;102281;6152770;11733925;198300;0;295
FR;2;2022-04-25;104;204;822;1329;103;711;1528;0;15;6119163;6801392;10611981;103610;6152873;11734636;199828;0;310
FR;2;2022-04-26;110;184;1041;2022;118;879;2219;0;18;6119273;6801576;10613022;105632;6152991;11735515;202047;0;328
FR;2;2022-04-27;98;181;860;1786;122;764;1808;0;7;6119371;6801757;10613882;107418;6153113;11736279;203855;0;335
FR;2;2022-04-28;93;214;949;1931;128;842;2087;0;12;6119464;6801971;10614831;109349;6153241;11737121;205942;0;347
FR;2;2022-04-29;81;282;1133;1697;131;1044;1876;0;11;6119545;6802253;10615964;111046;6153372;11738165;207818;0;358
FR;2;2022-04-30;66;127;471;540;80;430;628;0;9;6119611;6802380;10616435;111586;6153452;11738595;208446;0;367
FR;2;2022-05-01;24;24;84;49;20;85;61;0;1;6119635;6802404;10616519;111635;6153472;11738680;208507;0;368
FR;2;2022-05-02;115;232;763;1217;141;661;1375;0;5;6119750;6802636;10617282;112852;6153613;11739341;209882;0;373
FR;2;2022-05-03;152;233;999;1781;156;938;1895;0;14;6119902;6802869;10618281;114633;6153769;11740279;211777;0;387
FR;2;2022-05-04;90;226;926;1811;116;869;1822;0;13;6119992;6803095;10619207;116444;6153885;11741148;213599;0;400
FR;2;2022-05-05;127;198;856;1732;147;773;1848;0;10;6120119;6803293;10620063;118176;6154032;11741921;215447;0;410
FR;2;2022-05-06;133;246;1100;1855;139;1016;2052;0;16;6120252;6803539;10621163;120031;6154171;11742937;217499;0;426
FR;2;2022-05-07;40;99;470;504;61;406;593;0;4;6120292;6803638;10621633;120535;6154232;11743343;218092;0;430
FR;2;2022-05-08;48;54;107;71;41;102;101;0;0;6120340;6803692;10621740;120606;6154273;11743445;218193;0;430
FR;2;2022-05-09;101;174;654;986;103;604;1130;0;9;6120441;6803866;10622394;121592;6154376;11744049;219323;0;439
FR;2;2022-05-10;121;252;938;1841;155;893;1965;0;23;6120562;6804118;10623332;123433;6154531;11744942;221288;0;462
FR;2;2022-05-11;103;179;814;1879;117;793;1868;0;8;6120665;6804297;10624146;125312;6154648;11745735;223156;0;470
FR;2;2022-05-12;111;174;845;2096;116;803;2213;0;21;6120776;6804471;10624991;127408;6154764;11746538;225369;0;491
FR;2;2022-05-13;100;236;969;2097;122;900;2273;0;13;6120876;6804707;10625960;129505;6154886;11747438;227642;0;504
FR;2;2022-05-14;76;124;451;553;93;411;632;0;6;6120952;6804831;10626411;130058;6154979;11747849;228274;0;510
FR;2;2022-05-15;24;39;94;88;20;108;95;0;1;6120976;6804870;10626505;130146;6154999;11747957;228369;0;511
FR;2;2022-05-16;102;170;601;925;115;537;1037;0;11;6121078;6805040;10627106;131071;6155114;11748494;229406;0;522
FR;2;2022-05-17;95;184;690;1687;119;658;1739;0;8;6121173;6805224;10627796;132758;6155233;11749152;231145;0;530
FR;2;2022-05-18;80;181;643;1431;97;648;1486;0;10;6121253;6805405;10628439;134189;6155330;11749800;232631;0;540
FR;2;2022-05-19;73;161;709;1830;81;751;1816;0;12;6121326;6805566;10629148;136019;6155411;11750551;234447;0;552
FR;2;2022-05-20;107;181;874;1701;111;779;1849;0;17;6121433;6805747;10630022;137720;6155522;11751330;236296;0;569
FR;2;2022-05-21;48;96;398;517;71;339;581;0;8;6121481;6805843;10630420;138237;6155593;11751669;236877;0;577
FR;2;2022-05-22;8;23;69;37;18;57;56;0;0;6121489;6805866;10630489;138274;6155611;11751726;236933;0;577
FR;2;2022-05-23;86;133;498;931;100;469;967;0;7;6121575;6805999;10630987;139205;6155711;11752195;237900;0;584
FR;2;2022-05-24;87;164;627;1626;103;615;1680;0;17;6121662;6806163;10631614;140831;6155814;11752810;239580;0;601
FR;2;2022-05-25;72;146;539;1149;90;494;1260;0;5;6121734;6806309;10632153;141980;6155904;11753304;240840;0;606
FR;2;2022-05-26;12;31;77;45;13;85;56;0;1;6121746;6806340;10632230;142025;6155917;11753389;240896;0;607
FR;2;2022-05-27;44;124;456;818;68;438;893;0;9;6121790;6806464;10632686;142843;6155985;11753827;241789;0;616
FR;2;2022-05-28;28;60;221;244;29;221;266;0;1;6121818;6806524;10632907;143087;6156014;11754048;242055;0;617
FR;2;2022-05-29;13;34;43;25;22;51;28;0;0;6121831;6806558;10632950;143112;6156036;11754099;242083;0;617
FR;2;2022-05-30;65;109;425;755;60;410;806;0;6;6121896;6806667;10633375;143867;6156096;11754509;242889;0;623
FR;2;2022-05-31;76;135;564;1278;92;511;1304;0;12;6121972;6806802;10633939;145145;6156188;11755020;244193;0;635
FR;2;2022-06-01;59;160;564;1075;86;543;1170;0;6;6122031;6806962;10634503;146220;6156274;11755563;245363;0;641
FR;2;2022-06-02;92;178;626;1414;109;593;1520;0;12;6122123;6807140;10635129;147634;6156383;11756156;246883;0;653
FR;2;2022-06-03;71;157;668;1605;96;595;1694;0;19;6122194;6807297;10635797;149239;6156479;11756751;248577;0;672
FR;2;2022-06-04;69;93;283;434;66;269;476;0;11;6122263;6807390;10636080;149673;6156545;11757020;249053;0;683
FR;2;2022-06-05;12;17;63;58;16;47;75;0;1;6122275;6807407;10636143;149731;6156561;11757067;249128;0;684
FR;2;2022-06-06;12;40;93;76;29;92;81;0;4;6122287;6807447;10636236;149807;6156590;11757159;249209;0;688
FR;2;2022-06-07;99;222;667;1535;154;577;1661;0;10;6122386;6807669;10636903;151342;6156744;11757736;250870;0;698
FR;2;2022-06-08;70;119;477;1166;76;411;1262;0;5;6122456;6807788;10637380;152508;6156820;11758147;252132;0;703
FR;2;2022-06-09;93;166;613;1923;107;571;1927;0;18;6122549;6807954;10637993;154431;6156927;11758718;254059;0;721
FR;2;2022-06-10;93;168;650;1683;107;622;1774;0;23;6122642;6808122;10638643;156114;6157034;11759340;255833;0;744
FR;2;2022-06-11;44;85;287;529;42;258;583;0;5;6122686;6808207;10638930;156643;6157076;11759598;256416;0;749
FR;2;2022-06-12;18;38;58;78;27;60;78;0;0;6122704;6808245;10638988;156721;6157103;11759658;256494;0;749
FR;2;2022-06-13;39;121;395;953;63;379;1021;0;6;6122743;6808366;10639383;157674;6157166;11760037;257515;0;755
FR;2;2022-06-14;68;157;599;2088;101;537;2189;0;14;6122811;6808523;10639982;159762;6157267;11760574;259704;0;769
FR;2;2022-06-15;78;104;522;1504;84;444;1641;0;10;6122889;6808627;10640504;161266;6157351;11761018;261345;0;779
FR;2;2022-06-16;127;128;497;1411;123;424;1526;0;12;6123016;6808755;10641001;162677;6157474;11761442;262871;0;791
FR;2;2022-06-17;73;138;589;1817;88;516;1921;0;16;6123089;6808893;10641590;164494;6157562;11761958;264792;0;807
FR;2;2022-06-18;76;93;224;579;81;196;630;0;4;6123165;6808986;10641814;165073;6157643;11762154;265422;0;811
FR;2;2022-06-19;11;17;53;71;7;41;90;0;2;6123176;6809003;10641867;165144;6157650;11762195;265512;0;813
FR;2;2022-06-20;62;125;401;1028;72;392;1105;0;10;6123238;6809128;10642268;166172;6157722;11762587;266617;0;823
FR;2;2022-06-21;108;116;526;2127;105;455;2164;0;22;6123346;6809244;10642794;168299;6157827;11763042;268781;0;845
FR;2;2022-06-22;39;110;462;1889;57;415;1971;0;25;6123385;6809354;10643256;170188;6157884;11763457;270752;0;870
FR;2;2022-06-23;58;109;537;2282;68;452;2400;0;30;6123443;6809463;10643793;172470;6157952;11763909;273152;0;900
FR;2;2022-06-24;66;122;709;3199;65;571;3339;0;38;6123509;6809585;10644502;175669;6158017;11764480;276491;0;938
FR;2;2022-06-25;30;90;298;988;55;254;1041;0;13;6123539;6809675;10644800;176657;6158072;11764734;277532;0;951
FR;2;2022-06-26;30;27;131;194;29;97;236;0;5;6123569;6809702;10644931;176851;6158101;11764831;277768;0;956
FR;2;2022-06-27;79;137;582;2490;94;483;2623;0;39;6123648;6809839;10645513;179341;6158195;11765314;280391;0;995
FR;2;2022-06-28;110;140;812;4817;81;650;4894;0;54;6123758;6809979;10646325;184158;6158276;11765964;285285;0;1049
FR;2;2022-06-29;73;150;776;4436;80;637;4532;0;56;6123831;6810129;10647101;188594;6158356;11766601;289817;0;1105
FR;2;2022-06-30;72;133;834;5177;71;619;5398;0;79;6123903;6810262;10647935;193771;6158427;11767220;295215;0;1184
FR;2;2022-07-01;113;161;1152;6692;95;853;6944;0;92;6124016;6810423;10649087;200463;6158522;11768073;302159;0;1276
FR;2;2022-07-02;69;132;474;1977;82;392;2068;0;27;6124085;6810555;10649561;202440;6158604;11768465;304227;0;1303
FR;2;2022-07-03;23;30;147;334;21;131;357;0;8;6124108;6810585;10649708;202774;6158625;11768596;304584;0;1311
FR;2;2022-07-04;122;184;776;3785;113;612;3971;0;49;6124230;6810769;10650484;206559;6158738;11769208;308555;0;1360
FR;2;2022-07-05;119;187;1121;6818;121;828;6999;0;85;6124349;6810956;10651605;213377;6158859;11770036;315554;0;1445
FR;2;2022-07-06;92;152;951;5807;94;698;5933;0;84;6124441;6811108;10652556;219184;6158953;11770734;321487;0;1529
FR;2;2022-07-07;81;185;1021;6501;116;752;6732;0;101;6124522;6811293;10653577;225685;6159069;11771486;328219;0;1630
FR;2;2022-07-08;65;122;1095;7044;51;758;7235;0;123;6124587;6811415;10654672;232729;6159120;11772244;335454;0;1753
FR;2;2022-07-09;34;62;417;1869;31;299;1919;0;33;6124621;6811477;10655089;234598;6159151;11772543;337373;0;1786
FR;2;2022-07-10;7;17;97;315;8;83;327;0;5;6124628;6811494;10655186;234913;6159159;11772626;337700;0;1791
FR;2;2022-07-11;68;121;683;3826;76;541;3901;0;67;6124696;6811615;10655869;238739;6159235;11773167;341601;0;1858
FR;2;2022-07-12;102;180;1054;6517;107;809;6725;0;119;6124798;6811795;10656923;245256;6159342;11773976;348326;0;1977
FR;2;2022-07-13;65;127;879;4664;75;591;4830;0;78;6124863;6811922;10657802;249920;6159417;11774567;353156;0;2055
FR;2;2022-07-14;6;13;89;250;8;60;269;0;8;6124869;6811935;10657891;250170;6159425;11774627;353425;0;2063
FR;2;2022-07-15;61;129;739;3794;53;560;3960;0;75;6124930;6812064;10658630;253964;6159478;11775187;357385;0;2138
FR;2;2022-07-16;27;54;289;1031;30;242;1077;0;25;6124957;6812118;10658919;254995;6159508;11775429;358462;0;2163
FR;2;2022-07-17;5;12;78;201;6;67;207;0;6;6124962;6812130;10658997;255196;6159514;11775496;358669;0;2169
FR;2;2022-07-18;57;103;514;2510;61;385;2648;0;59;6125019;6812233;10659511;257706;6159575;11775881;361317;0;2228
FR;2;2022-07-19;66;133;770;4258;72;555;4447;0;72;6125085;6812366;10660281;261964;6159647;11776436;365764;0;2300
FR;2;2022-07-20;59;117;582;3179;68;430;3278;0;87;6125144;6812483;10660863;265143;6159715;11776866;369042;0;2387
FR;2;2022-07-21;60;110;673;3680;73;487;3797;0;105;6125204;6812593;10661536;268823;6159788;11777353;372839;0;2492
FR;2;2022-07-22;51;100;700;3550;48;507;3701;0;80;6125255;6812693;10662236;272373;6159836;11777860;376540;0;2572
FR;2;2022-07-23;38;97;290;1175;51;229;1228;0;37;6125293;6812790;10662526;273548;6159887;11778089;377768;0;2609
FR;2;2022-07-24;14;24;69;201;19;68;203;0;7;6125307;6812814;10662595;273749;6159906;11778157;377971;0;2616
FR;2;2022-07-25;50;71;405;1938;60;300;2000;0;56;6125357;6812885;10663000;275687;6159966;11778457;379971;0;2672
FR;2;2022-07-26;57;133;606;3423;67;476;3496;0;113;6125414;6813018;10663606;279110;6160033;11778933;383467;0;2785
FR;2;2022-07-27;42;81;457;2782;50;361;2801;0;89;6125456;6813099;10664063;281892;6160083;11779294;386268;0;2874
FR;2;2022-07-28;29;75;450;2487;36;357;2491;0;78;6125485;6813174;10664513;284379;6160119;11779651;388759;0;2952
FR;2;2022-07-29;68;88;535;2857;63;347;2978;0;73;6125553;6813262;10665048;287236;6160182;11779998;391737;0;3025
FR;2;2022-07-30;22;39;163;776;32;110;796;0;24;6125575;6813301;10665211;288012;6160214;11780108;392533;0;3049
FR;2;2022-07-31;6;13;27;104;12;21;110;0;2;6125581;6813314;10665238;288116;6160226;11780129;392643;0;3051
FR;2;2022-08-01;38;106;323;1261;73;260;1343;0;29;6125619;6813420;10665561;289377;6160299;11780389;393986;0;3080
FR;2;2022-08-02;49;75;325;2061;50;247;2097;0;78;6125668;6813495;10665886;291438;6160349;11780636;396083;0;3158
FR;2;2022-08-03;29;53;260;1611;25;188;1617;0;57;6125697;6813548;10666146;293049;6160374;11780824;397700;0;3215
FR;2;2022-08-04;40;65;306;1692;39;240;1701;0;66;6125737;6813613;10666452;294741;6160413;11781064;399401;0;3281
FR;2;2022-08-05;33;94;328;1881;67;236;1912;0;60;6125770;6813707;10666780;296622;6160480;11781300;401313;0;3341
FR;2;2022-08-06;22;41;106;365;29;82;372;0;10;6125792;6813748;10666886;296987;6160509;11781382;401685;0;3351
FR;2;2022-08-07;7;8;15;69;5;16;71;0;3;6125799;6813756;10666901;297056;6160514;11781398;401756;0;3354
FR;2;2022-08-08;19;35;220;877;22;148;915;0;33;6125818;6813791;10667121;297933;6160536;11781546;402671;0;3387
FR;2;2022-08-09;29;52;279;1474;41;238;1470;0;50;6125847;6813843;10667400;299407;6160577;11781784;404141;0;3437
FR;2;2022-08-10;16;22;213;1134;19;150;1155;0;46;6125863;6813865;10667613;300541;6160596;11781934;405296;0;3483
FR;2;2022-08-11;21;41;174;1038;26;117;1047;0;40;6125884;6813906;10667787;301579;6160622;11782051;406343;0;3523
FR;2;2022-08-12;36;50;184;1046;38;140;1069;0;35;6125920;6813956;10667971;302625;6160660;11782191;407412;0;3558
FR;2;2022-08-13;11;19;47;149;15;53;137;0;5;6125931;6813975;10668018;302774;6160675;11782244;407549;0;3563
FR;2;2022-08-14;1;2;12;52;1;11;54;0;1;6125932;6813977;10668030;302826;6160676;11782255;407603;0;3564
FR;2;2022-08-15;0;5;32;22;2;21;21;0;3;6125932;6813982;10668062;302848;6160678;11782276;407624;0;3567
FR;2;2022-08-16;27;33;144;681;34;120;678;0;33;6125959;6814015;10668206;303529;6160712;11782396;408302;0;3600
FR;2;2022-08-17;18;27;109;738;18;88;744;0;34;6125977;6814042;10668315;304267;6160730;11782484;409046;0;3634
FR;2;2022-08-18;14;30;160;836;14;107;852;0;42;6125991;6814072;10668475;305103;6160744;11782591;409898;0;3676
FR;2;2022-08-19;8;38;118;706;31;88;706;0;33;6125999;6814110;10668593;305809;6160775;11782679;410604;0;3709
FR;2;2022-08-20;6;26;61;197;16;52;201;0;8;6126005;6814136;10668654;306006;6160791;11782731;410805;0;3717
FR;2;2022-08-21;4;14;15;19;6;13;31;0;0;6126009;6814150;10668669;306025;6160797;11782744;410836;0;3717
FR;2;2022-08-22;11;25;116;395;17;73;451;0;13;6126020;6814175;10668785;306420;6160814;11782817;411287;0;3730
FR;2;2022-08-23;11;42;134;671;23;112;679;0;38;6126031;6814217;10668919;307091;6160837;11782929;411966;0;3768
FR;2;2022-08-24;11;28;87;466;21;80;472;0;18;6126042;6814245;10669006;307557;6160858;11783009;412438;0;3786
FR;2;2022-08-25;8;32;109;481;16;69;516;0;17;6126050;6814277;10669115;308038;6160874;11783078;412954;0;3803
FR;2;2022-08-26;16;46;117;720;36;91;713;0;32;6126066;6814323;10669232;308758;6160910;11783169;413667;0;3835
FR;2;2022-08-27;10;19;47;158;16;42;166;0;2;6126076;6814342;10669279;308916;6160926;11783211;413833;0;3837
FR;2;2022-08-28;1;5;5;15;1;7;16;0;1;6126077;6814347;10669284;308931;6160927;11783218;413849;0;3838
FR;2;2022-08-29;24;43;94;400;29;88;396;0;24;6126101;6814390;10669378;309331;6160956;11783306;414245;0;3862
FR;2;2022-08-30;31;54;154;791;34;119;798;0;29;6126132;6814444;10669532;310122;6160990;11783425;415043;0;3891
FR;2;2022-08-31;19;37;85;392;24;79;393;0;25;6126151;6814481;10669617;310514;6161014;11783504;415436;0;3916
FR;2;2022-09-01;19;43;139;600;25;122;609;0;36;6126170;6814524;10669756;311114;6161039;11783626;416045;0;3952
FR;2;2022-09-02;34;57;147;744;34;160;748;0;32;6126204;6814581;10669903;311858;6161073;11783786;416793;0;3984
FR;2;2022-09-03;17;20;83;205;11;67;213;0;7;6126221;6814601;10669986;312063;6161084;11783853;417006;0;3991
FR;2;2022-09-04;8;5;9;31;2;10;30;0;3;6126229;6814606;10669995;312094;6161086;11783863;417036;0;3994
FR;2;2022-09-05;29;32;126;367;24;98;397;0;24;6126258;6814638;10670121;312461;6161110;11783961;417433;0;4018
FR;2;2022-09-06;44;63;158;761;43;153;767;0;36;6126302;6814701;10670279;313222;6161153;11784114;418200;0;4054
FR;2;2022-09-07;21;22;74;375;18;49;387;0;23;6126323;6814723;10670353;313597;6161171;11784163;418587;0;4077
FR;2;2022-09-08;31;58;109;636;41;100;646;0;22;6126354;6814781;10670462;314233;6161212;11784263;419233;0;4099
FR;2;2022-09-09;18;24;126;754;21;74;747;0;48;6126372;6814805;10670588;314987;6161233;11784337;419980;0;4147
FR;2;2022-09-10;14;24;57;117;16;48;131;0;4;6126386;6814829;10670645;315104;6161249;11784385;420111;0;4151
FR;2;2022-09-11;12;5;11;11;3;13;13;0;0;6126398;6814834;10670656;315115;6161252;11784398;420124;0;4151
FR;2;2022-09-12;20;31;70;340;26;56;352;0;16;6126418;6814865;10670726;315455;6161278;11784454;420476;0;4167
FR;2;2022-09-13;15;34;125;670;13;99;674;0;40;6126433;6814899;10670851;316125;6161291;11784553;421150;0;4207
FR;2;2022-09-14;19;23;81;480;20;60;478;0;36;6126452;6814922;10670932;316605;6161311;11784613;421628;0;4243
FR;2;2022-09-15;23;44;126;486;26;102;493;0;47;6126475;6814966;10671058;317091;6161337;11784715;422121;0;4290
FR;2;2022-09-16;22;31;124;563;17;89;585;0;39;6126497;6814997;10671182;317654;6161354;11784804;422706;0;4329
FR;2;2022-09-17;6;20;56;160;15;52;147;0;13;6126503;6815017;10671238;317814;6161369;11784856;422853;0;4342
FR;2;2022-09-18;4;7;13;37;6;10;37;0;3;6126507;6815024;10671251;317851;6161375;11784866;422890;0;4345
FR;2;2022-09-19;26;24;114;353;16;87;381;0;22;6126533;6815048;10671365;318204;6161391;11784953;423271;0;4367
FR;2;2022-09-20;29;27;117;624;21;84;639;0;38;6126562;6815075;10671482;318828;6161412;11785037;423910;0;4405
FR;2;2022-09-21;15;30;100;393;15;78;418;0;22;6126577;6815105;10671582;319221;6161427;11785115;424328;0;4427
FR;2;2022-09-22;19;39;124;581;18;95;619;0;28;6126596;6815144;10671706;319802;6161445;11785210;424947;0;4455
FR;2;2022-09-23;21;38;135;555;22;111;570;0;39;6126617;6815182;10671841;320357;6161467;11785321;425517;0;4494
FR;2;2022-09-24;10;8;52;190;8;37;201;0;6;6126627;6815190;10671893;320547;6161475;11785358;425718;0;4500
FR;2;2022-09-25;9;11;15;29;11;12;33;0;5;6126636;6815201;10671908;320576;6161486;11785370;425751;0;4505
FR;2;2022-09-26;22;41;116;447;27;79;458;0;20;6126658;6815242;10672024;321023;6161513;11785449;426209;0;4525
FR;2;2022-09-27;30;46;162;906;35;108;861;0;52;6126688;6815288;10672186;321929;6161548;11785557;427070;0;4577
FR;2;2022-09-28;15;31;93;421;18;74;439;0;23;6126703;6815319;10672279;322350;6161566;11785631;427509;0;4600
FR;2;2022-09-29;26;48;115;618;23;110;630;0;33;6126729;6815367;10672394;322968;6161589;11785741;428139;0;4633
FR;2;2022-09-30;25;44;111;520;44;84;533;0;31;6126754;6815411;10672505;323488;6161633;11785825;428672;0;4664
FR;2;2022-10-01;11;20;51;128;20;36;129;0;8;6126765;6815431;10672556;323616;6161653;11785861;428801;0;4672
FR;2;2022-10-02;0;5;8;21;4;5;25;0;2;6126765;6815436;10672564;323637;6161657;11785866;428826;0;4674
FR;2;2022-10-03;22;35;85;291;30;69;306;0;22;6126787;6815471;10672649;323928;6161687;11785935;429132;0;4696
FR;2;2022-10-04;17;21;106;601;19;71;620;0;46;6126804;6815492;10672755;324529;6161706;11786006;429752;0;4742
FR;2;2022-10-05;20;31;75;491;26;67;488;0;54;6126824;6815523;10672830;325020;6161732;11786073;430240;0;4796
FR;2;2022-10-06;30;23;74;442;17;71;428;0;65;6126854;6815546;10672904;325462;6161749;11786144;430668;0;4861
FR;2;2022-10-07;21;30;86;499;27;66;503;0;42;6126875;6815576;10672990;325961;6161776;11786210;431171;0;4903
FR;2;2022-10-08;12;8;24;114;3;25;108;0;12;6126887;6815584;10673014;326075;6161779;11786235;431279;0;4915
FR;2;2022-10-09;1;8;15;17;6;11;22;0;5;6126888;6815592;10673029;326092;6161785;11786246;431301;0;4920
FR;2;2022-10-10;18;25;47;223;23;49;218;0;21;6126906;6815617;10673076;326315;6161808;11786295;431519;0;4941
FR;2;2022-10-11;16;15;48;253;11;39;241;0;52;6126922;6815632;10673124;326568;6161819;11786334;431760;0;4993
FR;2;2022-10-12;9;20;52;290;16;36;305;0;56;6126931;6815652;10673176;326858;6161835;11786370;432065;0;5049
FR;2;2022-10-13;11;14;48;271;9;48;261;0;26;6126942;6815666;10673224;327129;6161844;11786418;432326;0;5075
FR;2;2022-10-14;13;29;36;230;17;40;231;0;29;6126955;6815695;10673260;327359;6161861;11786458;432557;0;5104
FR;2;2022-10-15;4;12;22;111;6;17;113;0;15;6126959;6815707;10673282;327470;6161867;11786475;432670;0;5119
FR;2;2022-10-16;0;7;4;11;6;7;8;0;1;6126959;6815714;10673286;327481;6161873;11786482;432678;0;5120
FR;2;2022-10-17;15;19;31;121;18;26;131;0;29;6126974;6815733;10673317;327602;6161891;11786508;432809;0;5149
FR;2;2022-10-18;13;12;68;185;6;34;247;0;46;6126987;6815745;10673385;327787;6161897;11786542;433056;0;5195
FR;2;2022-10-19;8;17;38;184;12;31;222;0;52;6126995;6815762;10673423;327971;6161909;11786573;433278;0;5247
FR;2;2022-10-20;11;29;41;200;15;40;196;0;52;6127006;6815791;10673464;328171;6161924;11786613;433474;0;5299
FR;2;2022-10-21;6;15;60;233;6;53;222;0;31;6127012;6815806;10673524;328404;6161930;11786666;433696;0;5330
FR;2;2022-10-22;8;7;25;102;2;23;103;0;20;6127020;6815813;10673549;328506;6161932;11786689;433799;0;5350
FR;2;2022-10-23;0;3;1;5;3;0;6;0;2;6127020;6815816;10673550;328511;6161935;11786689;433805;0;5352
FR;2;2022-10-24;12;12;16;110;12;16;113;0;20;6127032;6815828;10673566;328621;6161947;11786705;433918;0;5372
FR;2;2022-10-25;12;7;23;138;6;15;145;0;51;6127044;6815835;10673589;328759;6161953;11786720;434063;0;5423
FR;2;2022-10-26;4;3;17;90;2;11;96;0;27;6127048;6815838;10673606;328849;6161955;11786731;434159;0;5450
FR;2;2022-10-27;7;10;18;88;10;20;71;0;27;6127055;6815848;10673624;328937;6161965;11786751;434230;0;5477
FR;2;2022-10-28;5;3;15;91;3;7;92;0;27;6127060;6815851;10673639;329028;6161968;11786758;434322;0;5504
FR;2;2022-10-29;7;8;18;33;6;14;37;0;8;6127067;6815859;10673657;329061;6161974;11786772;434359;0;5512
FR;2;2022-10-30;3;7;5;8;5;2;5;0;1;6127070;6815866;10673662;329069;6161979;11786774;434364;0;5513
FR;2;2022-10-31;2;8;6;49;6;10;48;0;11;6127072;6815874;10673668;329118;6161985;11786784;434412;0;5524
FR;2;2022-11-01;0;5;8;1;5;5;4;0;0;6127072;6815879;10673676;329119;6161990;11786789;434416;0;5524
FR;2;2022-11-02;6;5;12;44;5;12;45;0;11;6127078;6815884;10673688;329163;6161995;11786801;434461;0;5535
FR;2;2022-11-03;6;7;16;77;6;10;75;0;18;6127084;6815891;10673704;329240;6162001;11786811;434536;0;5553
FR;2;2022-11-04;7;12;15;85;10;14;93;0;10;6127091;6815903;10673719;329325;6162011;11786825;434629;0;5563
FR;2;2022-11-05;0;11;13;38;6;17;35;0;6;6127091;6815914;10673732;329363;6162017;11786842;434664;0;5569
FR;2;2022-11-06;0;2;2;1;0;4;0;0;2;6127091;6815916;10673734;329364;6162017;11786846;434664;0;5571
FR;2;2022-11-07;13;8;15;67;6;14;66;0;20;6127104;6815924;10673749;329431;6162023;11786860;434730;0;5591
FR;2;2022-11-08;13;8;18;58;6;14;65;0;27;6127117;6815932;10673767;329489;6162029;11786874;434795;0;5618
FR;2;2022-11-09;4;5;17;56;2;17;50;0;28;6127121;6815937;10673784;329545;6162031;11786891;434845;0;5646
FR;2;2022-11-10;7;10;17;74;7;14;76;0;14;6127128;6815947;10673801;329619;6162038;11786905;434921;0;5660
FR;2;2022-11-11;0;3;9;3;0;10;4;0;0;6127128;6815950;10673810;329622;6162038;11786915;434925;0;5660
FR;2;2022-11-12;2;5;7;19;4;7;19;0;4;6127130;6815955;10673817;329641;6162042;11786922;434944;0;5664
FR;2;2022-11-13;3;2;4;2;1;5;1;0;0;6127133;6815957;10673821;329643;6162043;11786927;434945;0;5664
FR;2;2022-11-14;7;6;13;29;3;10;33;0;7;6127140;6815963;10673834;329672;6162046;11786937;434978;0;5671
FR;2;2022-11-15;8;15;15;35;16;18;32;0;7;6127148;6815978;10673849;329707;6162062;11786955;435010;0;5678
FR;2;2022-11-16;3;6;4;45;6;4;46;0;18;6127151;6815984;10673853;329752;6162068;11786959;435056;0;5696
FR;2;2022-11-17;2;6;12;56;5;9;55;0;22;6127153;6815990;10673865;329808;6162073;11786968;435111;0;5718
FR;2;2022-11-18;3;4;7;41;4;6;44;0;10;6127156;6815994;10673872;329849;6162077;11786974;435155;0;5728
FR;2;2022-11-19;3;3;2;25;3;3;18;0;5;6127159;6815997;10673874;329874;6162080;11786977;435173;0;5733
FR;2;2022-11-20;0;2;6;9;2;6;10;0;26;6127159;6815999;10673880;329883;6162082;11786983;435183;0;5759
FR;2;2022-11-21;6;10;9;31;7;8;34;0;22;6127165;6816009;10673889;329914;6162089;11786991;435217;0;5781
FR;2;2022-11-22;8;8;20;65;6;21;70;0;71;6127173;6816017;10673909;329979;6162095;11787012;435287;0;5852
FR;2;2022-11-23;7;6;8;68;3;5;73;0;8;6127180;6816023;10673917;330047;6162098;11787017;435360;0;5860
FR;2;2022-11-24;2;2;11;50;2;7;57;0;10;6127182;6816025;10673928;330097;6162100;11787024;435417;0;5870
FR;2;2022-11-25;11;8;14;25;11;14;26;0;8;6127193;6816033;10673942;330122;6162111;11787038;435443;0;5878
FR;2;2022-11-26;1;5;4;8;4;7;6;0;0;6127194;6816038;10673946;330130;6162115;11787045;435449;0;5878
FR;2;2022-11-27;2;2;12;2;0;11;4;0;1;6127196;6816040;10673958;330132;6162115;11787056;435453;0;5879
FR;2;2022-11-28;0;2;8;35;1;6;37;0;5;6127196;6816042;10673966;330167;6162116;11787062;435490;0;5884
FR;2;2022-11-29;1;1;10;24;0;4;30;0;8;6127197;6816043;10673976;330191;6162116;11787066;435520;0;5892
FR;2;2022-11-30;2;2;10;47;1;11;44;0;21;6127199;6816045;10673986;330238;6162117;11787077;435564;0;5913
FR;2;2022-12-01;2;12;6;63;9;13;55;0;24;6127201;6816057;10673992;330301;6162126;11787090;435619;0;5937
FR;2;2022-12-02;1;2;12;51;2;10;51;0;27;6127202;6816059;10674004;330352;6162128;11787100;435670;0;5964
FR;2;2022-12-03;1;3;8;19;1;8;18;0;10;6127203;6816062;10674012;330371;6162129;11787108;435688;0;5974
FR;2;2022-12-04;0;0;0;4;0;0;4;0;2;6127203;6816062;10674012;330375;6162129;11787108;435692;0;5976
FR;2;2022-12-05;3;5;8;51;8;4;45;0;16;6127206;6816067;10674020;330426;6162137;11787112;435737;0;5992
FR;2;2022-12-06;3;4;14;45;3;6;48;0;17;6127209;6816071;10674034;330471;6162140;11787118;435785;0;6009
FR;2;2022-12-07;1;4;9;42;2;8;44;0;11;6127210;6816075;10674043;330513;6162142;11787126;435829;0;6020
FR;2;2022-12-08;0;2;11;44;0;6;49;0;16;6127210;6816077;10674054;330557;6162142;11787132;435878;0;6036
FR;2;2022-12-09;0;1;13;52;0;9;57;0;17;6127210;6816078;10674067;330609;6162142;11787141;435935;0;6053
FR;2;2022-12-10;0;2;15;50;0;6;52;0;9;6127210;6816080;10674082;330659;6162142;11787147;435987;0;6062
FR;2;2022-12-11;0;0;2;2;0;2;1;0;3;6127210;6816080;10674084;330661;6162142;11787149;435988;0;6065
FR;2;2022-12-12;1;0;6;37;0;6;36;0;11;6127211;6816080;10674090;330698;6162142;11787155;436024;0;6076
FR;2;2022-12-13;0;2;1;37;1;1;36;0;14;6127211;6816082;10674091;330735;6162143;11787156;436060;0;6090
FR;2;2022-12-14;0;5;8;26;5;3;31;0;14;6127211;6816087;10674099;330761;6162148;11787159;436091;0;6104
FR;2;2022-12-15;0;4;12;43;4;9;44;0;17;6127211;6816091;10674111;330804;6162152;11787168;436135;0;6121
FR;2;2022-12-16;2;4;27;56;3;20;62;0;16;6127213;6816095;10674138;330860;6162155;11787188;436197;0;6137
FR;2;2022-12-17;1;4;10;44;3;6;39;0;5;6127214;6816099;10674148;330904;6162158;11787194;436236;0;6142
FR;2;2022-12-18;1;0;0;0;0;0;0;0;1;6127215;6816099;10674148;330904;6162158;11787194;436236;0;6143
FR;2;2022-12-19;6;5;4;31;6;5;24;0;24;6127221;6816104;10674152;330935;6162164;11787199;436260;0;6167
FR;2;2022-12-20;0;3;6;37;1;7;38;0;24;6127221;6816107;10674158;330972;6162165;11787206;436298;0;6191
FR;2;2022-12-21;0;1;4;13;1;4;13;0;8;6127221;6816108;10674162;330985;6162166;11787210;436311;0;6199
FR;2;2022-12-22;0;5;17;32;2;6;45;0;10;6127221;6816113;10674179;331017;6162168;11787216;436356;0;6209
FR;2;2022-12-23;1;5;15;18;3;12;22;0;4;6127222;6816118;10674194;331035;6162171;11787228;436378;0;6213
FR;2;2022-12-24;0;0;1;1;0;1;1;0;0;6127222;6816118;10674195;331036;6162171;11787229;436379;0;6213
FR;2;2022-12-25;0;1;1;3;0;1;4;0;0;6127222;6816119;10674196;331039;6162171;11787230;436383;0;6213
FR;2;2022-12-26;0;0;7;11;0;5;11;0;3;6127222;6816119;10674203;331050;6162171;11787235;436394;0;6216
FR;2;2022-12-27;0;1;7;5;1;5;7;0;4;6127222;6816120;10674210;331055;6162172;11787240;436401;0;6220
FR;2;2022-12-28;0;2;4;13;2;3;14;0;5;6127222;6816122;10674214;331068;6162174;11787243;436415;0;6225
FR;2;2022-12-29;1;2;4;18;1;5;18;0;7;6127223;6816124;10674218;331086;6162175;11787248;436433;0;6232
FR;2;2022-12-30;1;0;2;8;0;2;7;0;1;6127224;6816124;10674220;331094;6162175;11787250;436440;0;6233
FR;2;2022-12-31;0;0;1;2;0;1;2;0;1;6127224;6816124;10674221;331096;6162175;11787251;436442;0;6234
FR;2;2023-01-01;0;0;0;0;0;0;0;0;0;6127224;6816124;10674221;331096;6162175;11787251;436442;0;6234
FR;2;2023-01-02;5;2;9;21;1;7;23;0;2;6127229;6816126;10674230;331117;6162176;11787258;436465;0;6236
FR;2;2023-01-03;1;0;6;13;0;7;11;0;6;6127230;6816126;10674236;331130;6162176;11787265;436476;0;6242
FR;2;2023-01-04;1;1;9;13;2;7;13;0;6;6127231;6816127;10674245;331143;6162178;11787272;436489;0;6248
FR;2;2023-01-05;0;2;7;6;2;4;7;0;3;6127231;6816129;10674252;331149;6162180;11787276;436496;0;6251
FR;2;2023-01-06;1;0;9;9;0;4;13;0;9;6127232;6816129;10674261;331158;6162180;11787280;436509;0;6260
FR;2;2023-01-07;0;0;4;10;0;4;8;0;5;6127232;6816129;10674265;331168;6162180;11787284;436517;0;6265
FR;2;2023-01-08;0;0;3;3;0;3;3;0;2;6127232;6816129;10674268;331171;6162180;11787287;436520;0;6267
FR;2;2023-01-09;0;2;8;9;2;3;13;0;5;6127232;6816131;10674276;331180;6162182;11787290;436533;0;6272
FR;2;2023-01-10;0;4;3;8;3;2;10;0;6;6127232;6816135;10674279;331188;6162185;11787292;436543;0;6278
FR;2;2023-01-11;3;0;4;7;0;3;9;0;3;6127235;6816135;10674283;331195;6162185;11787295;436552;0;6281
FR;2;2023-01-12;1;0;9;13;0;7;10;0;11;6127236;6816135;10674292;331208;6162185;11787302;436562;0;6292
FR;2;2023-01-13;0;1;4;7;1;2;10;0;3;6127236;6816136;10674296;331215;6162186;11787304;436572;0;6295
FR;2;2023-01-14;0;1;2;6;0;3;6;0;1;6127236;6816137;10674298;331221;6162186;11787307;436578;0;6296
FR;2;2023-01-15;0;0;0;0;0;0;0;0;0;6127236;6816137;10674298;331221;6162186;11787307;436578;0;6296
FR;2;2023-01-16;1;1;5;6;2;2;7;0;1;6127237;6816138;10674303;331227;6162188;11787309;436585;0;6297
FR;2;2023-01-17;1;0;5;4;0;5;3;0;0;6127238;6816138;10674308;331231;6162188;11787314;436588;0;6297
FR;2;2023-01-18;0;0;2;2;0;2;2;0;0;6127238;6816138;10674310;331233;6162188;11787316;436590;0;6297
FR;2;2023-01-19;0;0;1;6;0;1;6;0;6;6127238;6816138;10674311;331239;6162188;11787317;436596;0;6303
FR;2;2023-01-20;0;0;1;7;0;1;7;0;4;6127238;6816138;10674312;331246;6162188;11787318;436603;0;6307
FR;2;2023-01-21;0;0;0;3;0;0;0;0;0;6127238;6816138;10674312;331249;6162188;11787318;436603;0;6307
FR;2;2023-01-22;0;0;0;0;0;0;0;0;0;6127238;6816138;10674312;331249;6162188;11787318;436603;0;6307
FR;2;2023-01-23;0;0;3;3;0;2;3;0;1;6127238;6816138;10674315;331252;6162188;11787320;436606;0;6308
FR;2;2023-01-24;1;3;1;6;3;0;7;0;4;6127239;6816141;10674316;331258;6162191;11787320;436613;0;6312
FR;2;2023-01-25;1;0;0;6;1;0;6;0;0;6127240;6816141;10674316;331264;6162192;11787320;436619;0;6312
FR;2;2023-01-26;1;0;3;7;0;1;9;0;3;6127241;6816141;10674319;331271;6162192;11787321;436628;0;6315
FR;2;2023-01-27;0;2;3;3;1;2;3;0;2;6127241;6816143;10674322;331274;6162193;11787323;436631;0;6317
FR;2;2023-01-28;0;0;0;1;0;0;1;0;0;6127241;6816143;10674322;331275;6162193;11787323;436632;0;6317
FR;2;2023-01-29;0;0;1;0;0;0;1;0;0;6127241;6816143;10674323;331275;6162193;11787323;436633;0;6317
FR;2;2023-01-30;0;1;2;3;1;1;4;0;1;6127241;6816144;10674325;331278;6162194;11787324;436637;0;6318
FR;2;2023-01-31;1;0;3;2;0;2;3;0;0;6127242;6816144;10674328;331280;6162194;11787326;436640;0;6318
FR;2;2023-02-01;0;3;2;0;2;3;0;0;0;6127242;6816147;10674330;331280;6162196;11787329;436640;0;6318
FR;2;2023-02-02;0;1;3;4;1;3;6;0;4;6127242;6816148;10674333;331284;6162197;11787332;436646;0;6322
FR;2;2023-02-03;0;2;1;12;2;0;11;0;9;6127242;6816150;10674334;331296;6162199;11787332;436657;0;6331
FR;2;2023-02-04;0;1;1;0;0;2;0;0;0;6127242;6816151;10674335;331296;6162199;11787334;436657;0;6331
FR;2;2023-02-05;0;0;0;0;0;0;0;0;0;6127242;6816151;10674335;331296;6162199;11787334;436657;0;6331
FR;2;2023-02-06;0;3;2;2;2;3;2;0;0;6127242;6816154;10674337;331298;6162201;11787337;436659;0;6331
FR;2;2023-02-07;2;1;0;0;0;1;0;0;1;6127244;6816155;10674337;331298;6162201;11787338;436659;0;6332
FR;2;2023-02-08;0;0;3;2;0;2;4;0;1;6127244;6816155;10674340;331300;6162201;11787340;436663;0;6333
FR;2;2023-02-09;0;0;1;4;0;2;3;0;3;6127244;6816155;10674341;331304;6162201;11787342;436666;0;6336
FR;2;2023-02-10;0;0;1;3;0;1;2;0;6;6127244;6816155;10674342;331307;6162201;11787343;436668;0;6342
FR;2;2023-02-11;2;2;1;1;0;2;2;0;0;6127246;6816157;10674343;331308;6162201;11787345;436670;0;6342
FR;2;2023-02-12;0;0;0;0;0;0;0;0;0;6127246;6816157;10674343;331308;6162201;11787345;436670;0;6342
FR;2;2023-02-13;3;0;1;5;0;0;5;0;1;6127249;6816157;10674344;331313;6162201;11787345;436675;0;6343
FR;2;2023-02-14;1;1;1;1;1;0;2;0;0;6127250;6816158;10674345;331314;6162202;11787345;436677;0;6343
FR;2;2023-02-15;2;0;1;1;0;1;1;0;0;6127252;6816158;10674346;331315;6162202;11787346;436678;0;6343
FR;2;2023-02-16;0;1;1;1;1;1;1;0;2;6127252;6816159;10674347;331316;6162203;11787347;436679;0;6345
FR;2;2023-02-17;0;0;1;4;0;1;3;0;4;6127252;6816159;10674348;331320;6162203;11787348;436682;0;6349
FR;2;2023-02-18;0;0;4;1;0;4;0;0;1;6127252;6816159;10674352;331321;6162203;11787352;436682;0;6350
FR;2;2023-02-19;0;1;0;0;1;0;0;0;0;6127252;6816160;10674352;331321;6162204;11787352;436682;0;6350
FR;2;2023-02-20;1;0;0;1;0;0;1;0;2;6127253;6816160;10674352;331322;6162204;11787352;436683;0;6352
FR;2;2023-02-21;0;0;0;1;0;0;1;0;2;6127253;6816160;10674352;331323;6162204;11787352;436684;0;6354
FR;2;2023-02-22;1;0;0;3;0;0;3;0;0;6127254;6816160;10674352;331326;6162204;11787352;436687;0;6354
FR;2;2023-02-23;0;0;0;1;0;0;1;0;3;6127254;6816160;10674352;331327;6162204;11787352;436688;0;6357
FR;2;2023-02-24;1;0;1;2;0;0;3;0;0;6127255;6816160;10674353;331329;6162204;11787352;436691;0;6357
FR;2;2023-02-25;0;0;1;2;0;1;2;0;0;6127255;6816160;10674354;331331;6162204;11787353;436693;0;6357
FR;2;2023-02-26;0;0;0;0;0;0;0;0;0;6127255;6816160;10674354;331331;6162204;11787353;436693;0;6357
FR;2;2023-02-27;1;0;1;1;0;1;1;0;0;6127256;6816160;10674355;331332;6162204;11787354;436694;0;6357
FR;2;2023-02-28;0;0;0;0;0;0;0;0;2;6127256;6816160;10674355;331332;6162204;11787354;436694;0;6359
FR;2;2023-03-01;0;2;2;2;1;2;1;0;1;6127256;6816162;10674357;331334;6162205;11787356;436695;0;6360
FR;2;2023-03-02;0;2;2;1;2;1;1;0;1;6127256;6816164;10674359;331335;6162207;11787357;436696;0;6361
FR;2;2023-03-03;1;0;3;1;0;3;1;0;0;6127257;6816164;10674362;331336;6162207;11787360;436697;0;6361
FR;2;2023-03-04;0;0;1;0;0;1;0;0;0;6127257;6816164;10674363;331336;6162207;11787361;436697;0;6361
FR;2;2023-03-05;0;0;0;0;0;0;0;0;0;6127257;6816164;10674363;331336;6162207;11787361;436697;0;6361
FR;2;2023-03-06;0;0;1;0;0;1;0;0;2;6127257;6816164;10674364;331336;6162207;11787362;436697;0;6363
FR;2;2023-03-07;0;1;2;1;1;2;1;0;1;6127257;6816165;10674366;331337;6162208;11787364;436698;0;6364
FR;2;2023-03-08;0;0;0;0;0;0;0;0;2;6127257;6816165;10674366;331337;6162208;11787364;436698;0;6366
FR;2;2023-03-09;0;0;1;1;0;0;2;0;0;6127257;6816165;10674367;331338;6162208;11787364;436700;0;6366
FR;2;2023-03-10;0;0;1;0;0;1;0;0;0;6127257;6816165;10674368;331338;6162208;11787365;436700;0;6366
FR;2;2023-03-11;0;0;1;0;0;1;0;0;0;6127257;6816165;10674369;331338;6162208;11787366;436700;0;6366
FR;2;2023-03-12;0;0;0;0;0;0;0;0;0;6127257;6816165;10674369;331338;6162208;11787366;436700;0;6366
FR;2;2023-03-13;0;0;1;3;0;1;3;0;0;6127257;6816165;10674370;331341;6162208;11787367;436703;0;6366
FR;2;2023-03-14;1;0;0;0;0;0;0;0;0;6127258;6816165;10674370;331341;6162208;11787367;436703;0;6366
FR;2;2023-03-15;0;1;0;3;1;0;3;0;0;6127258;6816166;10674370;331344;6162209;11787367;436706;0;6366
FR;2;2023-03-16;0;0;0;0;0;0;1;0;0;6127258;6816166;10674370;331344;6162209;11787367;436707;0;6366
FR;2;2023-03-17;0;0;1;1;0;1;0;0;0;6127258;6816166;10674371;331345;6162209;11787368;436707;0;6366
FR;2;2023-03-18;0;0;0;0;0;0;0;0;1;6127258;6816166;10674371;331345;6162209;11787368;436707;0;6367
FR;2;2023-03-19;0;0;0;0;0;0;0;0;0;6127258;6816166;10674371;331345;6162209;11787368;436707;0;6367
FR;2;2023-03-20;0;0;1;0;0;1;0;0;0;6127258;6816166;10674372;331345;6162209;11787369;436707;0;6367
FR;2;2023-03-21;0;0;1;2;0;1;2;0;1;6127258;6816166;10674373;331347;6162209;11787370;436709;0;6368
FR;2;2023-03-22;0;0;0;0;0;0;0;0;1;6127258;6816166;10674373;331347;6162209;11787370;436709;0;6369
FR;2;2023-03-23;0;1;0;0;1;0;0;0;1;6127258;6816167;10674373;331347;6162210;11787370;436709;0;6370
FR;2;2023-03-24;0;1;0;2;1;0;2;0;2;6127258;6816168;10674373;331349;6162211;11787370;436711;0;6372
FR;2;2023-03-25;0;0;0;2;0;0;2;0;0;6127258;6816168;10674373;331351;6162211;11787370;436713;0;6372
FR;2;2023-03-26;0;0;1;0;0;1;0;0;0;6127258;6816168;10674374;331351;6162211;11787371;436713;0;6372
FR;2;2023-03-27;0;2;1;0;2;1;0;0;1;6127258;6816170;10674375;331351;6162213;11787372;436713;0;6373
FR;2;2023-03-28;0;0;0;0;0;0;0;0;1;6127258;6816170;10674375;331351;6162213;11787372;436713;0;6374
FR;2;2023-03-29;0;0;0;2;0;0;2;0;0;6127258;6816170;10674375;331353;6162213;11787372;436715;0;6374
FR;3;2020-12-27;0;0;0;0;0;0;0;0;0;0;0;0;0;0;0;0;0;0
FR;3;2020-12-28;0;0;0;0;0;0;0;0;0;0;0;0;0;0;0;0;0;0
FR;3;2020-12-29;0;0;0;0;0;0;0;0;0;0;0;0;0;0;0;0;0;0
FR;3;2020-12-30;0;0;0;0;0;0;0;0;0;0;0;0;0;0;0;0;0;0
FR;3;2020-12-31;0;0;0;0;0;0;0;0;0;0;0;0;0;0;0;0;0;0
FR;3;2021-01-01;0;0;0;0;0;0;0;0;0;0;0;0;0;0;0;0;0;0
FR;3;2021-01-02;0;0;0;0;0;0;0;0;0;0;0;0;0;0;0;0;0;0
FR;3;2021-01-03;0;0;0;0;0;0;0;0;0;0;0;0;0;0;0;0;0;0
FR;3;2021-01-04;0;0;0;0;0;0;0;0;0;0;0;0;0;0;0;0;0;0
FR;3;2021-01-05;0;0;0;0;0;0;0;0;0;0;0;0;0;0;0;0;0;0
FR;3;2021-01-06;0;0;0;0;0;0;0;0;0;0;0;0;0;0;0;0;0;0
FR;3;2021-01-07;0;0;0;0;0;0;0;0;0;0;0;0;0;0;0;0;0;0
FR;3;2021-01-08;0;0;0;0;0;0;0;0;0;0;0;0;0;0;0;0;0;0
FR;3;2021-01-09;0;0;0;0;0;0;0;0;0;0;0;0;0;0;0;0;0;0
FR;3;2021-01-10;0;0;0;0;0;0;0;0;0;0;0;0;0;0;0;0;0;0
FR;3;2021-01-11;0;0;0;0;0;0;0;0;0;0;0;0;0;0;0;0;0;0
FR;3;2021-01-12;0;0;0;0;0;0;0;0;0;0;0;0;0;0;0;0;0;0
FR;3;2021-01-13;0;0;0;0;0;0;0;0;0;0;0;0;0;0;0;0;0;0
FR;3;2021-01-14;0;0;0;0;0;0;0;0;0;0;0;0;0;0;0;0;0;0
FR;3;2021-01-15;0;0;0;0;0;0;0;0;0;0;0;0;0;0;0;0;0;0
FR;3;2021-01-16;0;0;0;0;0;0;0;0;0;0;0;0;0;0;0;0;0;0
FR;3;2021-01-17;0;0;0;0;0;0;0;0;0;0;0;0;0;0;0;0;0;0
FR;3;2021-01-18;0;0;0;0;0;0;0;0;0;0;0;0;0;0;0;0;0;0
FR;3;2021-01-19;0;0;0;0;0;0;0;0;0;0;0;0;0;0;0;0;0;0
FR;3;2021-01-20;0;0;0;0;0;0;0;0;0;0;0;0;0;0;0;0;0;0
FR;3;2021-01-21;0;0;0;0;0;0;0;0;0;0;0;0;0;0;0;0;0;0
FR;3;2021-01-22;0;0;0;0;0;0;0;0;0;0;0;0;0;0;0;0;0;0
FR;3;2021-01-23;0;0;0;0;0;0;0;0;0;0;0;0;0;0;0;0;0;0
FR;3;2021-01-24;0;0;0;0;0;0;0;0;0;0;0;0;0;0;0;0;0;0
FR;3;2021-01-25;0;0;0;0;0;0;0;0;0;0;0;0;0;0;0;0;0;0
FR;3;2021-01-26;0;0;0;0;0;0;0;0;0;0;0;0;0;0;0;0;0;0
FR;3;2021-01-27;0;0;0;0;0;0;0;0;0;0;0;0;0;0;0;0;0;0
FR;3;2021-01-28;0;0;0;0;0;0;0;0;0;0;0;0;0;0;0;0;0;0
FR;3;2021-01-29;0;0;0;0;0;0;0;0;0;0;0;0;0;0;0;0;0;0
FR;3;2021-01-30;0;0;0;0;0;0;0;0;0;0;0;0;0;0;0;0;0;0
FR;3;2021-01-31;0;0;0;0;0;0;0;0;0;0;0;0;0;0;0;0;0;0
FR;3;2021-02-01;0;0;0;0;0;0;0;0;0;0;0;0;0;0;0;0;0;0
FR;3;2021-02-02;0;0;0;0;0;0;0;0;0;0;0;0;0;0;0;0;0;0
FR;3;2021-02-03;0;0;0;0;0;0;0;0;0;0;0;0;0;0;0;0;0;0
FR;3;2021-02-04;0;0;0;0;0;0;0;0;0;0;0;0;0;0;0;0;0;0
FR;3;2021-02-05;0;0;0;0;0;0;0;0;0;0;0;0;0;0;0;0;0;0
FR;3;2021-02-06;1477;0;0;0;106;0;0;0;0;1477;0;0;0;106;0;0;0;0
FR;3;2021-02-07;1423;2;0;0;87;0;0;0;0;2900;2;0;0;193;0;0;0;0
FR;3;2021-02-08;2789;1;0;0;177;0;0;0;0;5689;3;0;0;370;0;0;0;0
FR;3;2021-02-09;6786;0;0;0;502;0;0;0;0;12475;3;0;0;872;0;0;0;0
FR;3;2021-02-10;9612;0;0;0;695;0;0;0;0;22087;3;0;0;1567;0;0;0;0
FR;3;2021-02-11;13620;4;0;0;919;0;0;0;0;35707;7;0;0;2486;0;0;0;0
FR;3;2021-02-12;13410;0;0;0;907;0;0;0;0;49117;7;0;0;3393;0;0;0;0
FR;3;2021-02-13;3800;1;0;0;218;0;0;0;0;52917;8;0;0;3611;0;0;0;0
FR;3;2021-02-14;975;1;0;0;53;0;0;0;0;53892;9;0;0;3664;0;0;0;0
FR;3;2021-02-15;10497;2;0;0;719;0;0;0;0;64389;11;0;0;4383;0;0;0;0
FR;3;2021-02-16;12556;5;0;0;871;0;0;0;0;76945;16;0;0;5254;0;0;0;0
FR;3;2021-02-17;11159;1;0;0;716;0;0;0;0;88104;17;0;0;5970;0;0;0;0
FR;3;2021-02-18;14943;2;0;0;985;0;0;0;0;103047;19;0;0;6955;0;0;0;0
FR;3;2021-02-19;14364;1;0;0;846;0;0;0;0;117411;20;0;0;7801;0;0;0;0
FR;3;2021-02-20;3332;0;0;0;178;0;0;0;0;120743;20;0;0;7979;0;0;0;0
FR;3;2021-02-21;620;0;0;0;35;0;0;0;0;121363;20;0;0;8014;0;0;0;0
FR;3;2021-02-22;9171;1;0;0;654;0;0;0;0;130534;21;0;0;8668;0;0;0;0
FR;3;2021-02-23;11406;6;0;0;761;0;0;0;0;141940;27;0;0;9429;0;0;0;0
FR;3;2021-02-24;14305;1;0;0;829;0;0;0;0;156245;28;0;0;10258;0;0;0;0
FR;3;2021-02-25;44935;3;0;0;1814;0;0;0;0;201180;31;0;0;12072;0;0;0;0
FR;3;2021-02-26;61889;13;0;0;2201;0;0;0;0;263069;44;0;0;14273;0;0;0;0
FR;3;2021-02-27;34811;14;0;0;1028;0;0;0;0;297880;58;0;0;15301;0;0;0;0
FR;3;2021-02-28;2464;0;0;0;114;0;0;0;0;300344;58;0;0;15415;0;0;0;0
FR;3;2021-03-01;20521;21;0;0;1067;0;0;0;0;320865;79;0;0;16482;0;0;0;0
FR;3;2021-03-02;38878;25;0;0;1790;0;0;0;0;359743;104;0;0;18272;0;0;0;0
FR;3;2021-03-03;48750;18;0;0;2130;0;0;0;0;408493;122;0;0;20402;0;0;0;0
FR;3;2021-03-04;82228;25;0;0;3193;0;0;0;0;490721;147;0;0;23595;0;0;0;0
FR;3;2021-03-05;118139;42;0;0;4692;0;0;0;0;608860;189;0;0;28287;0;0;0;0
FR;3;2021-03-06;120727;65;1;0;3559;0;0;0;0;729587;254;1;0;31846;0;0;0;0
FR;3;2021-03-07;55186;23;0;0;1729;0;0;0;0;784773;277;1;0;33575;0;0;0;0
FR;3;2021-03-08;42814;29;0;0;2074;0;0;0;0;827587;306;1;0;35649;0;0;0;0
FR;3;2021-03-09;78978;51;0;0;3288;0;0;0;0;906565;357;1;0;38937;0;0;0;0
FR;3;2021-03-10;80985;67;0;0;3243;0;0;0;0;987550;424;1;0;42180;0;0;0;0
FR;3;2021-03-11;128447;66;0;0;4766;0;0;0;0;1115997;490;1;0;46946;0;0;0;0
FR;3;2021-03-12;182719;122;0;0;6279;0;0;0;0;1298716;612;1;0;53225;0;0;0;0
FR;3;2021-03-13;132160;91;0;0;3530;0;0;0;0;1430876;703;1;0;56755;0;0;0;0
FR;3;2021-03-14;14061;6;0;0;550;0;0;0;0;1444937;709;1;0;57305;0;0;0;0
FR;3;2021-03-15;52242;82;0;0;2097;0;0;0;0;1497179;791;1;0;59402;0;0;0;0
FR;3;2021-03-16;1221;51;0;0;105;0;0;0;0;1498400;842;1;0;59507;0;0;0;0
FR;3;2021-03-17;950;56;0;0;95;0;0;0;0;1499350;898;1;0;59602;0;0;0;0
FR;3;2021-03-18;1576;42;0;0;102;0;0;0;0;1500926;940;1;0;59704;0;0;0;0
FR;3;2021-03-19;70458;56;0;0;2060;0;0;0;0;1571384;996;1;0;61764;0;0;0;0
FR;3;2021-03-20;65241;51;0;0;1702;0;0;0;0;1636625;1047;1;0;63466;0;0;0;0
FR;3;2021-03-21;5761;8;0;0;199;0;0;0;0;1642386;1055;1;0;63665;0;0;0;0
FR;3;2021-03-22;37511;49;0;0;1052;0;0;0;0;1679897;1104;1;0;64717;0;0;0;0
FR;3;2021-03-23;84670;87;0;0;2288;0;0;0;0;1764567;1191;1;0;67005;0;0;0;0
FR;3;2021-03-24;90955;99;0;0;2491;0;0;0;0;1855522;1290;1;0;69496;0;0;0;0
FR;3;2021-03-25;150068;149;0;0;3792;0;0;0;0;2005590;1439;1;0;73288;0;0;0;0
FR;3;2021-03-26;165431;157;0;0;4148;0;0;0;0;2171021;1596;1;0;77436;0;0;0;0
FR;3;2021-03-27;68465;101;0;0;2004;0;0;0;0;2239486;1697;1;0;79440;0;0;0;0
FR;3;2021-03-28;6480;20;0;0;238;0;0;0;0;2245966;1717;1;0;79678;0;0;0;0
FR;3;2021-03-29;54171;82;0;0;1479;0;0;0;0;2300137;1799;1;0;81157;0;0;0;0
FR;3;2021-03-30;93185;103;0;0;2564;0;0;0;0;2393322;1902;1;0;83721;0;0;0;0
FR;3;2021-03-31;63546;110;0;0;1964;0;0;0;0;2456868;2012;1;0;85685;0;0;0;0
FR;3;2021-04-01;86136;115;0;0;2495;0;0;0;0;2543004;2127;1;0;88180;0;0;0;0
FR;3;2021-04-02;86915;187;0;0;2766;0;0;0;0;2629919;2314;1;0;90946;0;0;0;0
FR;3;2021-04-03;35876;133;0;0;1164;0;0;0;0;2665795;2447;1;0;92110;0;0;0;0
FR;3;2021-04-04;3577;19;0;0;164;0;0;0;0;2669372;2466;1;0;92274;0;0;0;0
FR;3;2021-04-05;4492;40;0;0;236;0;0;0;0;2673864;2506;1;0;92510;0;0;0;0
FR;3;2021-04-06;29762;104;0;0;1090;0;0;0;0;2703626;2610;1;0;93600;0;0;0;0
FR;3;2021-04-07;32350;113;0;0;1052;0;0;0;0;2735976;2723;1;0;94652;0;0;0;0
FR;3;2021-04-08;78826;273;0;0;2618;0;0;0;0;2814802;2996;1;0;97270;0;0;0;0
FR;3;2021-04-09;161764;454;0;0;5180;0;0;0;0;2976566;3450;1;0;102450;0;0;0;0
FR;3;2021-04-10;75765;364;0;0;2696;0;0;0;0;3052331;3814;1;0;105146;0;0;0;0
FR;3;2021-04-11;7316;47;0;0;306;0;0;0;0;3059647;3861;1;0;105452;0;0;0;0
FR;3;2021-04-12;51484;219;0;0;1738;0;0;0;0;3111131;4080;1;0;107190;0;0;0;0
FR;3;2021-04-13;86236;364;0;0;2911;0;0;0;0;3197367;4444;1;0;110101;0;0;0;0
FR;3;2021-04-14;67847;377;0;0;2429;0;0;0;0;3265214;4821;1;0;112530;0;0;0;0
FR;3;2021-04-15;93246;403;0;0;3441;0;0;0;0;3358460;5224;1;0;115971;0;0;0;0
FR;3;2021-04-16;112532;627;0;0;4342;0;0;0;0;3470992;5851;1;0;120313;0;0;0;0
FR;3;2021-04-17;53319;371;1;0;2277;0;0;0;0;3524311;6222;2;0;122590;0;0;0;0
FR;3;2021-04-18;9752;49;0;0;423;0;0;0;0;3534063;6271;2;0;123013;0;0;0;0
FR;3;2021-04-19;25117;287;0;0;1093;0;0;0;0;3559180;6558;2;0;124106;0;0;0;0
FR;3;2021-04-20;45676;438;0;0;1908;0;0;0;0;3604856;6996;2;0;126014;0;0;0;0
FR;3;2021-04-21;38988;552;0;0;1896;0;0;0;0;3643844;7548;2;0;127910;0;0;0;0
FR;3;2021-04-22;54723;875;0;0;2827;0;0;0;0;3698567;8423;2;0;130737;0;0;0;0
FR;3;2021-04-23;70493;1094;0;0;3696;0;0;0;0;3769060;9517;2;0;134433;0;0;0;0
FR;3;2021-04-24;37253;1101;0;0;2490;0;0;0;0;3806313;10618;2;0;136923;0;0;0;0
FR;3;2021-04-25;6213;158;0;0;446;0;0;0;0;3812526;10776;2;0;137369;0;0;0;0
FR;3;2021-04-26;19792;699;0;0;1434;0;0;0;0;3832318;11475;2;0;138803;0;0;0;0
FR;3;2021-04-27;34486;1337;0;0;2595;0;0;0;0;3866804;12812;2;0;141398;0;0;0;0
FR;3;2021-04-28;28971;2046;0;0;3163;0;0;0;0;3895775;14858;2;0;144561;0;0;0;0
FR;3;2021-04-29;45393;6124;0;0;7943;0;0;0;0;3941168;20982;2;0;152504;0;0;0;0
FR;3;2021-04-30;55465;9117;1;0;11512;0;0;0;0;3996633;30099;3;0;164016;0;0;0;0
FR;3;2021-05-01;9518;2064;0;0;2495;0;0;0;0;4006151;32163;3;0;166511;0;0;0;0
FR;3;2021-05-02;3081;465;0;0;610;0;0;0;0;4009232;32628;3;0;167121;0;0;0;0
FR;3;2021-05-03;13067;3940;0;0;4507;0;0;0;0;4022299;36568;3;0;171628;0;0;0;0
FR;3;2021-05-04;23123;8373;0;0;9440;0;0;0;0;4045422;44941;3;0;181068;0;0;0;0
FR;3;2021-05-05;18767;10833;0;0;11771;0;0;0;0;4064189;55774;3;0;192839;0;0;0;0
FR;3;2021-05-06;34632;21264;0;0;22814;0;0;0;0;4098821;77038;3;0;215653;0;0;0;0
FR;3;2021-05-07;44211;28901;0;0;31204;0;0;0;0;4143032;105939;3;0;246857;0;0;0;0
FR;3;2021-05-08;6786;9192;0;0;9558;0;0;0;0;4149818;115131;3;0;256415;0;0;0;0
FR;3;2021-05-09;1797;2666;0;0;2767;0;0;0;0;4151615;117797;3;0;259182;0;0;0;0
FR;3;2021-05-10;15001;12917;0;0;13610;0;0;0;0;4166616;130714;3;0;272792;0;0;0;0
FR;3;2021-05-11;27100;26275;0;0;27548;0;0;0;0;4193716;156989;3;0;300340;0;0;0;0
FR;3;2021-05-12;17273;28143;0;0;29081;0;0;0;0;4210989;185132;3;0;329421;0;0;0;0
FR;3;2021-05-13;2285;3510;0;0;3630;0;0;0;0;4213274;188642;3;0;333051;0;0;0;0
FR;3;2021-05-14;14521;26084;0;0;26865;0;0;0;0;4227795;214726;3;0;359916;0;0;0;0
FR;3;2021-05-15;7233;21086;0;0;21516;0;0;0;0;4235028;235812;3;0;381432;0;0;0;0
FR;3;2021-05-16;977;2647;0;0;2693;0;0;0;0;4236005;238459;3;0;384125;0;0;0;0
FR;3;2021-05-17;7967;20221;0;0;20665;0;0;0;0;4243972;258680;3;0;404790;0;0;0;0
FR;3;2021-05-18;13418;30158;0;0;30920;0;0;0;0;4257390;288838;3;0;435710;0;0;0;0
FR;3;2021-05-19;9277;30524;0;0;31118;0;0;0;0;4266667;319362;3;0;466828;0;0;0;0
FR;3;2021-05-20;12808;53830;3;0;54757;0;0;0;0;4279475;373192;6;0;521585;0;0;0;0
FR;3;2021-05-21;12771;66183;2;0;67114;0;0;0;0;4292246;439375;8;0;588699;0;0;0;0
FR;3;2021-05-22;4967;33780;1;0;34163;0;0;0;0;4297213;473155;9;0;622862;0;0;0;0
FR;3;2021-05-23;651;2664;0;0;2696;0;0;0;0;4297864;475819;9;0;625558;0;0;0;0
FR;3;2021-05-24;885;4784;0;0;4828;0;0;0;0;4298749;480603;9;0;630386;0;0;0;0
FR;3;2021-05-25;5314;46733;1;0;47137;0;0;0;0;4304063;527336;10;0;677523;0;0;0;0
FR;3;2021-05-26;4982;52190;1;0;52664;0;0;0;0;4309045;579526;11;0;730187;0;0;0;0
FR;3;2021-05-27;6338;79065;3;0;79676;0;0;0;0;4315383;658591;14;0;809863;0;0;0;0
FR;3;2021-05-28;7546;100335;2;0;101141;0;0;0;0;4322929;758926;16;0;911004;0;0;0;0
FR;3;2021-05-29;3350;61183;1;0;61565;0;0;0;0;4326279;820109;17;0;972569;0;0;0;0
FR;3;2021-05-30;551;8078;0;0;8127;0;0;0;0;4326830;828187;17;0;980696;0;0;0;0
FR;3;2021-05-31;2442;35484;3;0;35750;0;0;0;0;4329272;863671;20;0;1016446;0;0;0;0
FR;3;2021-06-01;3416;64902;10;0;65353;0;0;0;0;4332688;928573;30;0;1081799;0;0;0;0
FR;3;2021-06-02;2735;58932;6;0;59267;0;0;0;0;4335423;987505;36;0;1141066;0;0;0;0
FR;3;2021-06-03;3496;87202;10;0;87741;0;0;0;0;4338919;1074707;46;0;1228807;0;0;0;0
FR;3;2021-06-04;4125;105866;22;0;106531;0;0;0;0;4343044;1180573;68;0;1335338;0;0;0;0
FR;3;2021-06-05;1983;52606;4;0;52924;0;0;0;0;4345027;1233179;72;0;1388262;0;0;0;0
FR;3;2021-06-06;511;5268;1;0;5316;0;0;0;0;4345538;1238447;73;0;1393578;0;0;0;0
FR;3;2021-06-07;1487;30715;11;0;30896;0;0;0;0;4347025;1269162;84;0;1424474;0;0;0;0
FR;3;2021-06-08;2065;47426;18;0;47772;0;0;0;0;4349090;1316588;102;0;1472246;0;0;0;0
FR;3;2021-06-09;1796;41809;13;0;42114;0;0;0;0;4350886;1358397;115;0;1514360;0;0;0;0
FR;3;2021-06-10;2261;67662;17;0;68060;0;0;0;0;4353147;1426059;132;0;1582420;0;0;0;0
FR;3;2021-06-11;2492;96633;34;0;97109;0;0;0;0;4355639;1522692;166;0;1679529;0;0;0;0
FR;3;2021-06-12;1179;40557;6;0;40789;0;0;0;0;4356818;1563249;172;0;1720318;0;0;0;0
FR;3;2021-06-13;283;3606;3;0;3641;0;0;0;0;4357101;1566855;175;0;1723959;0;0;0;0
FR;3;2021-06-14;1051;42318;17;0;42487;0;0;0;0;4358152;1609173;192;0;1766446;0;0;0;0
FR;3;2021-06-15;1379;80350;20;0;80655;0;0;0;0;4359531;1689523;212;0;1847101;0;0;0;0
FR;3;2021-06-16;1263;65504;20;0;65777;0;0;0;0;4360794;1755027;232;0;1912878;0;0;0;0
FR;3;2021-06-17;1667;102293;41;0;102679;0;0;0;0;4362461;1857320;273;0;2015557;0;0;0;0
FR;3;2021-06-18;1873;118467;63;0;118937;0;0;0;0;4364334;1975787;336;0;2134494;0;0;0;0
FR;3;2021-06-19;804;39454;22;0;39649;0;0;0;0;4365138;2015241;358;0;2174143;0;0;0;0
FR;3;2021-06-20;162;3195;0;0;3224;0;0;0;0;4365300;2018436;358;0;2177367;0;0;0;0
FR;3;2021-06-21;775;39089;16;0;39247;0;0;0;0;4366075;2057525;374;0;2216614;0;0;0;0
FR;3;2021-06-22;1065;70093;52;0;70363;0;0;0;0;4367140;2127618;426;0;2286977;0;0;0;0
FR;3;2021-06-23;946;50834;39;0;51106;0;0;0;0;4368086;2178452;465;0;2338083;0;0;0;0
FR;3;2021-06-24;1314;77296;48;0;77669;0;0;0;0;4369400;2255748;513;0;2415752;0;0;0;0
FR;3;2021-06-25;1410;90854;73;0;91287;0;0;0;0;4370810;2346602;586;0;2507039;0;0;0;0
FR;3;2021-06-26;631;33112;29;0;33304;0;0;0;0;4371441;2379714;615;0;2540343;0;0;0;0
FR;3;2021-06-27;168;3779;1;0;3803;0;0;0;0;4371609;2383493;616;0;2544146;0;0;0;0
FR;3;2021-06-28;655;29931;27;0;30125;0;0;0;0;4372264;2413424;643;0;2574271;0;0;0;0
FR;3;2021-06-29;856;56654;95;0;56899;0;0;0;0;4373120;2470078;738;0;2631170;0;0;0;0
FR;3;2021-06-30;905;45215;93;0;45483;0;0;0;0;4374025;2515293;831;0;2676653;0;0;0;0
FR;3;2021-07-01;1164;66127;108;0;66476;0;0;0;0;4375189;2581420;939;0;2743129;0;0;0;0
FR;3;2021-07-02;1305;90528;170;0;91011;0;0;0;0;4376494;2671948;1109;0;2834140;0;0;0;0
FR;3;2021-07-03;602;31187;51;0;31388;0;0;0;0;4377096;2703135;1160;0;2865528;0;0;0;0
FR;3;2021-07-04;144;3967;3;0;3997;0;0;0;0;4377240;2707102;1163;0;2869525;0;0;0;0
FR;3;2021-07-05;613;33604;60;0;33805;0;0;0;0;4377853;2740706;1223;0;2903330;0;0;0;0
FR;3;2021-07-06;965;55935;88;0;56246;0;0;0;0;4378818;2796641;1311;0;2959576;0;0;0;0
FR;3;2021-07-07;874;42963;80;0;43261;0;0;0;0;4379692;2839604;1391;0;3002837;0;0;0;0
FR;3;2021-07-08;1127;60813;99;0;61223;0;0;0;0;4380819;2900417;1490;0;3064060;0;0;0;0
FR;3;2021-07-09;1261;68938;128;0;69403;0;0;0;0;4382080;2969355;1618;0;3133463;0;0;0;0
FR;3;2021-07-10;644;25020;59;0;25217;0;0;0;0;4382724;2994375;1677;0;3158680;0;0;0;0
FR;3;2021-07-11;132;3173;4;0;3198;0;0;0;0;4382856;2997548;1681;0;3161878;0;0;0;0
FR;3;2021-07-12;662;23597;59;0;23810;0;0;0;0;4383518;3021145;1740;0;3185688;0;0;0;0
FR;3;2021-07-13;1648;34426;90;0;34916;0;0;0;0;4385166;3055571;1830;0;3220604;0;0;0;0
FR;3;2021-07-14;272;2475;2;0;2532;0;0;0;0;4385438;3058046;1832;0;3223136;0;0;0;0
FR;3;2021-07-15;1941;30419;85;0;30994;0;0;0;0;4387379;3088465;1917;0;3254130;0;0;0;0
FR;3;2021-07-16;2520;38620;122;0;39354;0;0;0;0;4389899;3127085;2039;0;3293484;0;0;0;0
FR;3;2021-07-17;1051;13725;26;0;14033;0;0;0;0;4390950;3140810;2065;0;3307517;0;0;0;0
FR;3;2021-07-18;266;2549;3;0;2597;0;0;0;0;4391216;3143359;2068;0;3310114;0;0;0;0
FR;3;2021-07-19;1280;16885;38;0;17253;0;0;0;0;4392496;3160244;2106;0;3327367;0;0;0;0
FR;3;2021-07-20;1823;26929;98;0;27471;0;0;0;0;4394319;3187173;2204;0;3354838;0;0;0;0
FR;3;2021-07-21;1652;19475;44;0;19980;0;0;0;0;4395971;3206648;2248;0;3374818;0;0;0;0
FR;3;2021-07-22;1856;27646;83;0;28211;0;0;0;0;4397827;3234294;2331;0;3403029;0;0;0;0
FR;3;2021-07-23;2217;30212;117;0;30949;0;0;0;0;4400044;3264506;2448;0;3433978;0;0;0;0
FR;3;2021-07-24;828;6928;25;0;7151;0;0;0;0;4400872;3271434;2473;0;3441129;0;0;0;0
FR;3;2021-07-25;210;1287;1;0;1342;0;0;0;0;4401082;3272721;2474;0;3442471;0;0;0;0
FR;3;2021-07-26;933;10508;28;0;10816;0;0;0;0;4402015;3283229;2502;0;3453287;0;0;0;0
FR;3;2021-07-27;1171;16802;56;0;17165;0;0;0;0;4403186;3300031;2558;0;3470452;0;0;0;0
FR;3;2021-07-28;989;12000;40;0;12312;0;0;0;0;4404175;3312031;2598;0;3482764;0;0;0;0
FR;3;2021-07-29;1127;15679;63;0;16092;0;0;0;0;4405302;3327710;2661;0;3498856;0;0;0;0
FR;3;2021-07-30;1129;17990;79;0;18365;0;0;0;0;4406431;3345700;2740;0;3517221;0;0;0;0
FR;3;2021-07-31;407;3711;15;0;3837;0;0;0;0;4406838;3349411;2755;0;3521058;0;0;0;0
FR;3;2021-08-01;117;445;1;0;467;0;0;0;0;4406955;3349856;2756;0;3521525;0;0;0;0
FR;3;2021-08-02;424;5015;22;0;5136;0;0;0;0;4407379;3354871;2778;0;3526661;0;0;0;0
FR;3;2021-08-03;498;7466;27;0;7599;0;0;0;0;4407877;3362337;2805;0;3534260;0;0;0;0
FR;3;2021-08-04;440;4831;26;0;4976;0;0;0;0;4408317;3367168;2831;0;3539236;0;0;0;0
FR;3;2021-08-05;433;3654;13;0;3764;0;0;0;0;4408750;3370822;2844;0;3543000;0;0;0;0
FR;3;2021-08-06;456;4699;30;0;4800;0;0;0;0;4409206;3375521;2874;0;3547800;0;0;0;0
FR;3;2021-08-07;214;1900;11;0;1946;0;0;0;0;4409420;3377421;2885;0;3549746;0;0;0;0
FR;3;2021-08-08;251;423;2;0;456;0;0;0;0;4409671;3377844;2887;0;3550202;0;0;0;0
FR;3;2021-08-09;320;2376;11;0;2446;0;0;0;0;4409991;3380220;2898;0;3552648;0;0;0;0
FR;3;2021-08-10;369;3735;15;0;3823;0;0;0;0;4410360;3383955;2913;0;3556471;0;0;0;0
FR;3;2021-08-11;291;2639;15;0;2699;0;0;0;0;4410651;3386594;2928;0;3559170;0;0;0;0
FR;3;2021-08-12;279;2563;13;0;2651;0;0;0;0;4410930;3389157;2941;0;3561821;0;0;0;0
FR;3;2021-08-13;279;2255;16;0;2341;0;0;0;0;4411209;3391412;2957;0;3564162;0;0;0;0
FR;3;2021-08-14;172;874;1;0;905;0;0;0;0;4411381;3392286;2958;0;3565067;0;0;0;0
FR;3;2021-08-15;56;174;0;0;183;0;0;0;0;4411437;3392460;2958;0;3565250;0;0;0;0
FR;3;2021-08-16;126;1002;8;0;1041;0;0;0;0;4411563;3393462;2966;0;3566291;0;0;0;0
FR;3;2021-08-17;191;1430;8;0;1471;0;0;0;0;4411754;3394892;2974;0;3567762;0;0;0;0
FR;3;2021-08-18;205;1309;10;0;1351;0;0;0;0;4411959;3396201;2984;0;3569113;0;0;0;0
FR;3;2021-08-19;165;1373;10;0;1420;0;0;0;0;4412124;3397574;2994;0;3570533;0;0;0;0
FR;3;2021-08-20;167;1596;16;0;1658;0;0;0;0;4412291;3399170;3010;0;3572191;0;0;0;0
FR;3;2021-08-21;94;576;2;0;591;0;0;0;0;4412385;3399746;3012;0;3572782;0;0;0;0
FR;3;2021-08-22;42;192;1;0;195;0;0;0;0;4412427;3399938;3013;0;3572977;0;0;0;0
FR;3;2021-08-23;141;885;7;0;930;0;0;0;0;4412568;3400823;3020;0;3573907;0;0;0;0
FR;3;2021-08-24;125;924;10;0;956;0;0;0;0;4412693;3401747;3030;0;3574863;0;0;0;0
FR;3;2021-08-25;137;820;3;0;849;0;0;0;0;4412830;3402567;3033;0;3575712;0;0;0;0
FR;3;2021-08-26;172;824;9;0;872;0;0;0;0;4413002;3403391;3042;0;3576584;0;0;0;0
FR;3;2021-08-27;178;937;9;0;989;0;0;0;0;4413180;3404328;3051;0;3577573;0;0;0;0
FR;3;2021-08-28;101;373;4;0;390;0;0;0;0;4413281;3404701;3055;0;3577963;0;0;0;0
FR;3;2021-08-29;128;129;1;0;162;0;0;0;0;4413409;3404830;3056;0;3578125;0;0;0;0
FR;3;2021-08-30;100;560;0;0;469;108;0;0;0;4413509;3405390;3056;0;3578594;108;0;0;0
FR;3;2021-08-31;134;684;7;0;589;134;0;0;0;4413643;3406074;3063;0;3579183;242;0;0;0
FR;3;2021-09-01;122;459;5;0;381;106;0;0;0;4413765;3406533;3068;0;3579564;348;0;0;0
FR;3;2021-09-02;100;595;22;0;531;105;0;0;0;4413865;3407128;3090;0;3580095;453;0;0;0
FR;3;2021-09-03;116;552;17;0;477;116;0;0;0;4413981;3407680;3107;0;3580572;569;0;0;0
FR;3;2021-09-04;55;295;3;0;256;50;0;0;0;4414036;3407975;3110;0;3580828;619;0;0;0
FR;3;2021-09-05;52;65;5;0;55;25;0;0;0;4414088;3408040;3115;0;3580883;644;0;0;0
FR;3;2021-09-06;118;367;4;0;261;130;0;0;0;4414206;3408407;3119;0;3581144;774;0;0;0
FR;3;2021-09-07;125;431;14;0;347;116;0;0;0;4414331;3408838;3133;0;3581491;890;0;0;0
FR;3;2021-09-08;122;344;2;0;274;87;0;0;0;4414453;3409182;3135;0;3581765;977;0;0;0
FR;3;2021-09-09;94;377;8;0;297;103;0;0;0;4414547;3409559;3143;0;3582062;1080;0;0;0
FR;3;2021-09-10;101;402;3;0;332;93;0;0;0;4414648;3409961;3146;0;3582394;1173;0;0;0
FR;3;2021-09-11;78;232;4;0;177;65;0;0;0;4414726;3410193;3150;0;3582571;1238;0;0;0
FR;3;2021-09-12;37;48;1;0;37;16;0;0;0;4414763;3410241;3151;0;3582608;1254;0;0;0
FR;3;2021-09-13;78;298;7;0;215;102;1;0;0;4414841;3410539;3158;0;3582823;1356;1;0;0
FR;3;2021-09-14;75;272;6;0;192;94;0;0;0;4414916;3410811;3164;0;3583015;1450;1;0;0
FR;3;2021-09-15;64;252;3;0;257;6;0;0;0;4414980;3411063;3167;0;3583272;1456;1;0;0
FR;3;2021-09-16;65;320;6;0;331;6;0;0;0;4415045;3411383;3173;0;3583603;1462;1;0;0
FR;3;2021-09-17;52;327;3;0;339;6;0;0;0;4415097;3411710;3176;0;3583942;1468;1;0;0
FR;3;2021-09-18;37;172;1;0;176;1;0;0;0;4415134;3411882;3177;0;3584118;1469;1;0;0
FR;3;2021-09-19;29;31;2;0;34;1;0;0;0;4415163;3411913;3179;0;3584152;1470;1;0;0
FR;3;2021-09-20;82;188;0;0;196;1;0;0;0;4415245;3412101;3179;0;3584348;1471;1;0;0
FR;3;2021-09-21;60;273;7;0;277;8;0;0;0;4415305;3412374;3186;0;3584625;1479;1;0;0
FR;3;2021-09-22;67;229;6;0;242;7;0;0;0;4415372;3412603;3192;0;3584867;1486;1;0;0
FR;3;2021-09-23;37;257;11;0;261;7;0;0;0;4415409;3412860;3203;0;3585128;1493;1;0;0
FR;3;2021-09-24;29;315;12;0;313;18;0;0;0;4415438;3413175;3215;0;3585441;1511;1;0;0
FR;3;2021-09-25;31;144;3;0;150;3;0;0;0;4415469;3413319;3218;0;3585591;1514;1;0;0
FR;3;2021-09-26;16;57;1;0;59;1;0;0;0;4415485;3413376;3219;0;3585650;1515;1;0;0
FR;3;2021-09-27;49;282;3;0;285;5;0;0;0;4415534;3413658;3222;0;3585935;1520;1;0;0
FR;3;2021-09-28;49;245;6;0;253;8;0;0;0;4415583;3413903;3228;0;3586188;1528;1;0;0
FR;3;2021-09-29;40;218;10;0;222;15;0;0;0;4415623;3414121;3238;0;3586410;1543;1;0;0
FR;3;2021-09-30;40;200;8;0;204;11;0;0;0;4415663;3414321;3246;0;3586614;1554;1;0;0
FR;3;2021-10-01;23;159;6;0;161;8;0;0;0;4415686;3414480;3252;0;3586775;1562;1;0;0
FR;3;2021-10-02;17;88;0;0;89;0;0;0;0;4415703;3414568;3252;0;3586864;1562;1;0;0
FR;3;2021-10-03;19;19;1;0;19;2;0;0;0;4415722;3414587;3253;0;3586883;1564;1;0;0
FR;3;2021-10-04;33;157;4;0;162;4;0;0;0;4415755;3414744;3257;0;3587045;1568;1;0;0
FR;3;2021-10-05;17;148;10;0;153;12;0;0;0;4415772;3414892;3267;0;3587198;1580;1;0;0
FR;3;2021-10-06;34;144;9;0;152;10;0;0;0;4415806;3415036;3276;0;3587350;1590;1;0;0
FR;3;2021-10-07;20;132;6;0;130;6;0;0;0;4415826;3415168;3282;0;3587480;1596;1;0;0
FR;3;2021-10-08;25;136;10;0;141;9;0;0;0;4415851;3415304;3292;0;3587621;1605;1;0;0
FR;3;2021-10-09;17;72;1;0;73;1;0;0;0;4415868;3415376;3293;0;3587694;1606;1;0;0
FR;3;2021-10-10;13;17;2;0;16;3;0;0;0;4415881;3415393;3295;0;3587710;1609;1;0;0
FR;3;2021-10-11;17;116;4;0;121;5;0;0;0;4415898;3415509;3299;0;3587831;1614;1;0;0
FR;3;2021-10-12;22;99;6;0;99;6;0;0;0;4415920;3415608;3305;0;3587930;1620;1;0;0
FR;3;2021-10-13;25;114;9;0;121;7;0;0;0;4415945;3415722;3314;0;3588051;1627;1;0;0
FR;3;2021-10-14;19;138;3;0;139;4;0;0;0;4415964;3415860;3317;0;3588190;1631;1;0;0
FR;3;2021-10-15;23;140;8;0;139;13;0;0;0;4415987;3416000;3325;0;3588329;1644;1;0;0
FR;3;2021-10-16;13;66;6;0;65;8;0;0;0;4416000;3416066;3331;0;3588394;1652;1;0;0
FR;3;2021-10-17;13;24;0;0;26;0;0;0;0;4416013;3416090;3331;0;3588420;1652;1;0;0
FR;3;2021-10-18;18;112;2;0;117;2;0;0;0;4416031;3416202;3333;0;3588537;1654;1;0;0
FR;3;2021-10-19;18;112;19;0;113;21;0;0;0;4416049;3416314;3352;0;3588650;1675;1;0;0
FR;3;2021-10-20;27;124;6;0;126;7;0;0;0;4416076;3416438;3358;0;3588776;1682;1;0;0
FR;3;2021-10-21;28;120;17;0;120;13;0;0;0;4416104;3416558;3375;0;3588896;1695;1;0;0
FR;3;2021-10-22;25;103;18;0;102;21;0;0;0;4416129;3416661;3393;0;3588998;1716;1;0;0
FR;3;2021-10-23;17;53;3;0;53;2;0;0;0;4416146;3416714;3396;0;3589051;1718;1;0;0
FR;3;2021-10-24;7;36;0;0;34;0;0;0;0;4416153;3416750;3396;0;3589085;1718;1;0;0
FR;3;2021-10-25;27;141;7;0;145;7;0;0;0;4416180;3416891;3403;0;3589230;1725;1;0;0
FR;3;2021-10-26;25;96;22;0;93;19;0;0;0;4416205;3416987;3425;0;3589323;1744;1;0;0
FR;3;2021-10-27;19;91;9;0;93;9;0;0;0;4416224;3417078;3434;0;3589416;1753;1;0;0
FR;3;2021-10-28;23;114;33;0;111;36;0;0;0;4416247;3417192;3467;0;3589527;1789;1;0;0
FR;3;2021-10-29;12;98;64;0;92;54;0;0;0;4416259;3417290;3531;0;3589619;1843;1;0;0
FR;3;2021-10-30;11;62;11;1;62;10;0;0;0;4416270;3417352;3542;1;3589681;1853;1;0;0
FR;3;2021-10-31;8;25;1;0;25;1;0;0;0;4416278;3417377;3543;1;3589706;1854;1;0;0
FR;3;2021-11-01;11;22;2;0;23;1;0;0;0;4416289;3417399;3545;1;3589729;1855;1;0;0
FR;3;2021-11-02;11;100;10;0;100;12;0;0;0;4416300;3417499;3555;1;3589829;1867;1;0;0
FR;3;2021-11-03;22;105;10;0;113;10;0;0;0;4416322;3417604;3565;1;3589942;1877;1;0;0
FR;3;2021-11-04;20;88;6;0;93;5;0;0;0;4416342;3417692;3571;1;3590035;1882;1;0;0
FR;3;2021-11-05;19;119;9;1;125;6;1;0;0;4416361;3417811;3580;2;3590160;1888;2;0;0
FR;3;2021-11-06;11;54;3;0;56;3;0;0;0;4416372;3417865;3583;2;3590216;1891;2;0;0
FR;3;2021-11-07;6;23;1;0;24;1;0;0;0;4416378;3417888;3584;2;3590240;1892;2;0;0
FR;3;2021-11-08;12;124;7;0;129;5;0;0;0;4416390;3418012;3591;2;3590369;1897;2;0;0
FR;3;2021-11-09;15;123;6;0;125;6;0;0;0;4416405;3418135;3597;2;3590494;1903;2;0;0
FR;3;2021-11-10;15;130;15;0;128;16;0;0;0;4416420;3418265;3612;2;3590622;1919;2;0;0
FR;3;2021-11-11;12;49;3;0;51;3;0;0;0;4416432;3418314;3615;2;3590673;1922;2;0;0
FR;3;2021-11-12;15;126;6;0;128;5;0;0;0;4416447;3418440;3621;2;3590801;1927;2;0;0
FR;3;2021-11-13;7;66;9;0;61;10;0;0;0;4416454;3418506;3630;2;3590862;1937;2;0;0
FR;3;2021-11-14;3;24;1;0;24;1;0;0;0;4416457;3418530;3631;2;3590886;1938;2;0;0
FR;3;2021-11-15;7;161;11;0;158;12;0;0;0;4416464;3418691;3642;2;3591044;1950;2;0;0
FR;3;2021-11-16;9;125;11;0;120;10;0;0;0;4416473;3418816;3653;2;3591164;1960;2;0;0
FR;3;2021-11-17;8;134;11;0;135;8;0;0;0;4416481;3418950;3664;2;3591299;1968;2;0;0
FR;3;2021-11-18;16;131;10;0;132;11;0;0;0;4416497;3419081;3674;2;3591431;1979;2;0;0
FR;3;2021-11-19;12;178;23;0;173;28;0;0;0;4416509;3419259;3697;2;3591604;2007;2;0;0
FR;3;2021-11-20;6;101;6;0;102;6;0;0;0;4416515;3419360;3703;2;3591706;2013;2;0;0
FR;3;2021-11-21;3;25;4;0;24;4;0;0;0;4416518;3419385;3707;2;3591730;2017;2;0;0
FR;3;2021-11-22;11;185;11;0;185;11;0;0;0;4416529;3419570;3718;2;3591915;2028;2;0;0
FR;3;2021-11-23;9;181;16;0;179;15;0;0;0;4416538;3419751;3734;2;3592094;2043;2;0;0
FR;3;2021-11-24;11;180;9;0;172;17;0;0;0;4416549;3419931;3743;2;3592266;2060;2;0;0
FR;3;2021-11-25;12;197;11;0;196;11;0;0;0;4416561;3420128;3754;2;3592462;2071;2;0;0
FR;3;2021-11-26;10;251;35;0;250;33;1;0;0;4416571;3420379;3789;2;3592712;2104;3;0;0
FR;3;2021-11-27;8;124;20;0;123;21;0;0;0;4416579;3420503;3809;2;3592835;2125;3;0;0
FR;3;2021-11-28;3;56;7;0;57;7;0;0;0;4416582;3420559;3816;2;3592892;2132;3;0;0
FR;3;2021-11-29;5;214;22;0;209;23;1;0;0;4416587;3420773;3838;2;3593101;2155;4;0;0
FR;3;2021-11-30;9;282;31;0;281;33;1;0;0;4416596;3421055;3869;2;3593382;2188;5;0;0
FR;3;2021-12-01;30;316;38;0;314;40;2;0;0;4416626;3421371;3907;2;3593696;2228;7;0;0
FR;3;2021-12-02;9;337;33;0;333;36;0;0;0;4416635;3421708;3940;2;3594029;2264;7;0;0
FR;3;2021-12-03;6;364;37;0;360;38;0;0;0;4416641;3422072;3977;2;3594389;2302;7;0;0
FR;3;2021-12-04;3;201;26;0;197;28;0;0;0;4416644;3422273;4003;2;3594586;2330;7;0;0
FR;3;2021-12-05;1;61;5;0;61;5;0;0;0;4416645;3422334;4008;2;3594647;2335;7;0;0
FR;3;2021-12-06;7;350;14;0;349;15;0;0;0;4416652;3422684;4022;2;3594996;2350;7;0;0
FR;3;2021-12-07;6;411;20;0;405;24;1;0;0;4416658;3423095;4042;2;3595401;2374;8;0;0
FR;3;2021-12-08;8;375;29;0;367;30;1;0;0;4416666;3423470;4071;2;3595768;2404;9;0;0
FR;3;2021-12-09;3;424;17;0;411;22;1;0;0;4416669;3423894;4088;2;3596179;2426;10;0;0
FR;3;2021-12-10;10;443;29;0;440;25;0;0;0;4416679;3424337;4117;2;3596619;2451;10;0;0
FR;3;2021-12-11;4;299;10;0;296;9;2;0;0;4416683;3424636;4127;2;3596915;2460;12;0;0
FR;3;2021-12-12;1;96;3;0;96;3;0;0;0;4416684;3424732;4130;2;3597011;2463;12;0;0
FR;3;2021-12-13;2;432;19;0;426;21;0;0;0;4416686;3425164;4149;2;3597437;2484;12;0;0
FR;3;2021-12-14;8;551;18;0;539;21;1;0;0;4416694;3425715;4167;2;3597976;2505;13;0;0
FR;3;2021-12-15;10;523;17;0;510;21;0;0;0;4416704;3426238;4184;2;3598486;2526;13;0;0
FR;3;2021-12-16;10;529;19;0;523;18;3;0;0;4416714;3426767;4203;2;3599009;2544;16;0;0
FR;3;2021-12-17;5;593;18;0;589;19;0;0;0;4416719;3427360;4221;2;3599598;2563;16;0;0
FR;3;2021-12-18;5;344;4;0;338;5;1;0;0;4416724;3427704;4225;2;3599936;2568;17;0;0
FR;3;2021-12-19;3;176;2;0;174;2;0;0;0;4416727;3427880;4227;2;3600110;2570;17;0;0
FR;3;2021-12-20;10;567;23;0;561;28;0;0;0;4416737;3428447;4250;2;3600671;2598;17;0;0
FR;3;2021-12-21;5;660;10;0;652;13;2;0;0;4416742;3429107;4260;2;3601323;2611;19;0;0
FR;3;2021-12-22;10;614;9;0;608;10;1;0;0;4416752;3429721;4269;2;3601931;2621;20;0;0
FR;3;2021-12-23;4;539;8;0;537;8;0;0;0;4416756;3430260;4277;2;3602468;2629;20;0;0
FR;3;2021-12-24;2;233;3;0;228;6;0;0;0;4416758;3430493;4280;2;3602696;2635;20;0;0
FR;3;2021-12-25;0;24;0;0;24;0;0;0;0;4416758;3430517;4280;2;3602720;2635;20;0;0
FR;3;2021-12-26;0;87;1;0;87;1;0;0;0;4416758;3430604;4281;2;3602807;2636;20;0;0
FR;3;2021-12-27;7;456;17;0;453;20;1;0;0;4416765;3431060;4298;2;3603260;2656;21;0;0
FR;3;2021-12-28;3;573;6;0;572;5;0;0;0;4416768;3431633;4304;2;3603832;2661;21;0;0
FR;3;2021-12-29;5;488;14;0;483;16;0;0;0;4416773;3432121;4318;2;3604315;2677;21;0;0
FR;3;2021-12-30;3;517;7;0;510;10;2;0;0;4416776;3432638;4325;2;3604825;2687;23;0;0
FR;3;2021-12-31;0;182;5;0;178;7;0;0;0;4416776;3432820;4330;2;3605003;2694;23;0;0
FR;3;2022-01-01;0;26;0;0;24;2;0;0;0;4416776;3432846;4330;2;3605027;2696;23;0;0
FR;3;2022-01-02;0;76;0;0;76;0;0;0;0;4416776;3432922;4330;2;3605103;2696;23;0;0
FR;3;2022-01-03;5;489;17;0;479;21;3;0;0;4416781;3433411;4347;2;3605582;2717;26;0;0
FR;3;2022-01-04;7;536;9;0;535;8;0;0;0;4416788;3433947;4356;2;3606117;2725;26;0;0
FR;3;2022-01-05;5;487;10;0;479;14;1;0;0;4416793;3434434;4366;2;3606596;2739;27;0;0
FR;3;2022-01-06;6;464;9;0;459;10;1;0;0;4416799;3434898;4375;2;3607055;2749;28;0;0
FR;3;2022-01-07;2;490;11;0;484;13;1;0;1;4416801;3435388;4386;2;3607539;2762;29;0;1
FR;3;2022-01-08;6;251;4;0;248;5;0;0;0;4416807;3435639;4390;2;3607787;2767;29;0;1
FR;3;2022-01-09;0;116;0;0;116;0;0;0;0;4416807;3435755;4390;2;3607903;2767;29;0;1
FR;3;2022-01-10;2;421;12;0;419;12;0;0;0;4416809;3436176;4402;2;3608322;2779;29;0;1
FR;3;2022-01-11;3;456;1;0;455;1;0;0;0;4416812;3436632;4403;2;3608777;2780;29;0;1
FR;3;2022-01-12;4;393;9;0;390;10;2;0;0;4416816;3437025;4412;2;3609167;2790;31;0;1
FR;3;2022-01-13;3;382;11;0;380;12;1;0;0;4416819;3437407;4423;2;3609547;2802;32;0;1
FR;3;2022-01-14;4;420;10;0;414;13;1;0;0;4416823;3437827;4433;2;3609961;2815;33;0;1
FR;3;2022-01-15;0;275;2;0;271;3;0;0;0;4416823;3438102;4435;2;3610232;2818;33;0;1
FR;3;2022-01-16;1;108;1;0;106;1;1;0;0;4416824;3438210;4436;2;3610338;2819;34;0;1
FR;3;2022-01-17;2;318;8;0;315;9;1;0;0;4416826;3438528;4444;2;3610653;2828;35;0;1
FR;3;2022-01-18;2;359;1;0;355;2;1;0;0;4416828;3438887;4445;2;3611008;2830;36;0;1
FR;3;2022-01-19;2;322;5;0;316;10;0;0;0;4416830;3439209;4450;2;3611324;2840;36;0;1
FR;3;2022-01-20;1;351;5;0;350;3;2;0;0;4416831;3439560;4455;2;3611674;2843;38;0;1
FR;3;2022-01-21;4;337;5;0;331;7;2;0;0;4416835;3439897;4460;2;3612005;2850;40;0;1
FR;3;2022-01-22;2;218;1;0;214;2;3;0;0;4416837;3440115;4461;2;3612219;2852;43;0;1
FR;3;2022-01-23;0;77;0;0;75;1;1;0;0;4416837;3440192;4461;2;3612294;2853;44;0;1
FR;3;2022-01-24;3;316;1;0;308;6;2;0;0;4416840;3440508;4462;2;3612602;2859;46;0;1
FR;3;2022-01-25;0;171;0;0;168;0;1;0;0;4416840;3440679;4462;2;3612770;2859;47;0;1
FR;3;2022-01-26;0;77;0;0;77;0;0;0;0;4416840;3440756;4462;2;3612847;2859;47;0;1
FR;3;2022-01-27;0;52;0;0;52;0;0;0;0;4416840;3440808;4462;2;3612899;2859;47;0;1
FR;3;2022-01-28;0;115;0;0;114;0;0;0;0;4416840;3440923;4462;2;3613013;2859;47;0;1
FR;3;2022-01-29;0;97;0;0;97;0;0;0;0;4416840;3441020;4462;2;3613110;2859;47;0;1
FR;3;2022-01-30;0;50;0;0;50;0;0;0;0;4416840;3441070;4462;2;3613160;2859;47;0;1
FR;3;2022-01-31;0;91;0;0;91;0;0;0;0;4416840;3441161;4462;2;3613251;2859;47;0;1
FR;3;2022-02-01;0;98;0;0;96;1;0;0;0;4416840;3441259;4462;2;3613347;2860;47;0;1
FR;3;2022-02-02;0;85;0;0;83;0;0;0;0;4416840;3441344;4462;2;3613430;2860;47;0;1
FR;3;2022-02-03;0;91;0;0;89;0;0;0;0;4416840;3441435;4462;2;3613519;2860;47;0;1
FR;3;2022-02-04;0;113;0;0;110;0;1;0;0;4416840;3441548;4462;2;3613629;2860;48;0;1
FR;3;2022-02-05;0;70;0;0;70;0;0;0;0;4416840;3441618;4462;2;3613699;2860;48;0;1
FR;3;2022-02-06;0;10;0;0;10;0;0;0;0;4416840;3441628;4462;2;3613709;2860;48;0;1
FR;3;2022-02-07;0;75;0;0;75;0;0;0;0;4416840;3441703;4462;2;3613784;2860;48;0;1
FR;3;2022-02-08;0;0;0;0;0;0;0;0;0;4416840;3441703;4462;2;3613784;2860;48;0;1
FR;3;2022-02-09;0;0;0;0;0;0;0;0;0;4416840;3441703;4462;2;3613784;2860;48;0;1
FR;3;2022-02-10;0;0;0;0;0;0;0;0;0;4416840;3441703;4462;2;3613784;2860;48;0;1
FR;3;2022-02-11;0;0;0;0;0;0;0;0;0;4416840;3441703;4462;2;3613784;2860;48;0;1
FR;3;2022-02-12;0;0;0;0;0;0;0;0;0;4416840;3441703;4462;2;3613784;2860;48;0;1
FR;3;2022-02-13;0;0;0;0;0;0;0;0;0;4416840;3441703;4462;2;3613784;2860;48;0;1
FR;3;2022-02-14;0;0;0;0;0;0;0;0;0;4416840;3441703;4462;2;3613784;2860;48;0;1
FR;3;2022-02-15;0;0;0;0;0;0;0;0;0;4416840;3441703;4462;2;3613784;2860;48;0;1
FR;3;2022-02-16;0;0;0;0;0;0;0;0;0;4416840;3441703;4462;2;3613784;2860;48;0;1
FR;3;2022-02-17;0;0;0;0;0;0;0;0;0;4416840;3441703;4462;2;3613784;2860;48;0;1
FR;3;2022-02-18;0;0;0;0;0;0;0;0;0;4416840;3441703;4462;2;3613784;2860;48;0;1
FR;3;2022-02-19;0;0;0;0;0;0;0;0;0;4416840;3441703;4462;2;3613784;2860;48;0;1
FR;3;2022-02-20;0;0;0;0;0;0;0;0;0;4416840;3441703;4462;2;3613784;2860;48;0;1
FR;3;2022-02-21;2;0;0;0;0;0;0;0;0;4416842;3441703;4462;2;3613784;2860;48;0;1
FR;3;2022-02-22;0;0;0;0;0;0;0;0;0;4416842;3441703;4462;2;3613784;2860;48;0;1
FR;3;2022-02-23;0;0;0;0;0;0;0;0;0;4416842;3441703;4462;2;3613784;2860;48;0;1
FR;3;2022-02-24;0;0;0;0;0;0;0;0;0;4416842;3441703;4462;2;3613784;2860;48;0;1
FR;3;2022-02-25;0;0;0;0;0;0;0;0;0;4416842;3441703;4462;2;3613784;2860;48;0;1
FR;3;2022-02-26;0;0;0;0;0;0;0;0;0;4416842;3441703;4462;2;3613784;2860;48;0;1
FR;3;2022-02-27;0;0;0;0;0;0;0;0;0;4416842;3441703;4462;2;3613784;2860;48;0;1
FR;3;2022-02-28;1;0;0;0;0;0;0;0;0;4416843;3441703;4462;2;3613784;2860;48;0;1
FR;3;2022-03-01;1;0;0;0;0;0;0;0;0;4416844;3441703;4462;2;3613784;2860;48;0;1
FR;3;2022-03-02;0;0;0;0;0;0;0;0;0;4416844;3441703;4462;2;3613784;2860;48;0;1
FR;3;2022-03-03;0;0;0;0;0;0;0;0;0;4416844;3441703;4462;2;3613784;2860;48;0;1
FR;3;2022-03-04;0;0;0;0;0;0;0;0;0;4416844;3441703;4462;2;3613784;2860;48;0;1
FR;3;2022-03-05;0;0;0;0;0;0;0;0;0;4416844;3441703;4462;2;3613784;2860;48;0;1
FR;3;2022-03-06;1;0;0;0;0;0;0;0;0;4416845;3441703;4462;2;3613784;2860;48;0;1
FR;3;2022-03-07;0;0;0;0;0;0;0;0;0;4416845;3441703;4462;2;3613784;2860;48;0;1
FR;3;2022-03-08;1;0;0;0;0;0;0;0;0;4416846;3441703;4462;2;3613784;2860;48;0;1
FR;3;2022-03-09;0;0;0;0;0;0;0;0;0;4416846;3441703;4462;2;3613784;2860;48;0;1
FR;3;2022-03-10;0;0;0;0;0;0;0;0;0;4416846;3441703;4462;2;3613784;2860;48;0;1
FR;3;2022-03-11;0;0;0;0;0;0;0;0;0;4416846;3441703;4462;2;3613784;2860;48;0;1
FR;3;2022-03-12;0;0;0;0;0;0;0;0;0;4416846;3441703;4462;2;3613784;2860;48;0;1
FR;3;2022-03-13;0;0;0;0;0;0;0;0;0;4416846;3441703;4462;2;3613784;2860;48;0;1
FR;3;2022-03-14;0;0;0;0;0;0;0;0;0;4416846;3441703;4462;2;3613784;2860;48;0;1
FR;3;2022-03-15;0;0;0;0;0;0;0;0;0;4416846;3441703;4462;2;3613784;2860;48;0;1
FR;3;2022-03-16;0;0;0;0;0;0;0;0;0;4416846;3441703;4462;2;3613784;2860;48;0;1
FR;3;2022-03-17;0;0;0;0;0;0;0;0;0;4416846;3441703;4462;2;3613784;2860;48;0;1
FR;3;2022-03-18;0;0;0;0;0;0;0;0;0;4416846;3441703;4462;2;3613784;2860;48;0;1
FR;3;2022-03-19;0;0;0;0;0;0;0;0;0;4416846;3441703;4462;2;3613784;2860;48;0;1
FR;3;2022-03-20;1;0;0;0;0;0;0;0;0;4416847;3441703;4462;2;3613784;2860;48;0;1
FR;3;2022-03-21;0;0;0;0;0;0;0;0;0;4416847;3441703;4462;2;3613784;2860;48;0;1
FR;3;2022-03-22;0;0;0;0;0;0;0;0;0;4416847;3441703;4462;2;3613784;2860;48;0;1
FR;3;2022-03-23;1;0;0;0;0;0;0;0;0;4416848;3441703;4462;2;3613784;2860;48;0;1
FR;3;2022-03-24;0;0;0;0;0;0;0;0;0;4416848;3441703;4462;2;3613784;2860;48;0;1
FR;3;2022-03-25;1;0;0;0;0;0;0;0;0;4416849;3441703;4462;2;3613784;2860;48;0;1
FR;3;2022-03-26;0;0;0;0;0;0;0;0;0;4416849;3441703;4462;2;3613784;2860;48;0;1
FR;3;2022-03-27;0;0;0;0;0;0;0;0;0;4416849;3441703;4462;2;3613784;2860;48;0;1
FR;3;2022-03-28;0;0;0;0;0;0;0;0;0;4416849;3441703;4462;2;3613784;2860;48;0;1
FR;3;2022-03-29;0;0;0;0;0;0;0;0;0;4416849;3441703;4462;2;3613784;2860;48;0;1
FR;3;2022-03-30;0;0;0;0;0;0;0;0;0;4416849;3441703;4462;2;3613784;2860;48;0;1
FR;3;2022-03-31;0;0;0;0;0;0;0;0;0;4416849;3441703;4462;2;3613784;2860;48;0;1
FR;3;2022-04-01;0;0;0;0;0;0;0;0;0;4416849;3441703;4462;2;3613784;2860;48;0;1
FR;3;2022-04-02;0;0;0;0;0;0;0;0;0;4416849;3441703;4462;2;3613784;2860;48;0;1
FR;3;2022-04-03;0;0;0;0;0;0;0;0;0;4416849;3441703;4462;2;3613784;2860;48;0;1
FR;3;2022-04-04;0;0;0;0;0;0;0;0;0;4416849;3441703;4462;2;3613784;2860;48;0;1
FR;3;2022-04-05;0;0;0;0;0;0;0;0;0;4416849;3441703;4462;2;3613784;2860;48;0;1
FR;3;2022-04-06;0;0;0;0;0;0;0;0;0;4416849;3441703;4462;2;3613784;2860;48;0;1
FR;3;2022-04-07;0;0;0;0;0;0;0;0;0;4416849;3441703;4462;2;3613784;2860;48;0;1
FR;3;2022-04-08;0;0;0;0;0;0;0;0;0;4416849;3441703;4462;2;3613784;2860;48;0;1
FR;3;2022-04-09;0;0;0;0;0;0;0;0;0;4416849;3441703;4462;2;3613784;2860;48;0;1
FR;3;2022-04-10;0;0;0;0;0;0;0;0;0;4416849;3441703;4462;2;3613784;2860;48;0;1
FR;3;2022-04-11;0;0;0;0;0;0;0;0;0;4416849;3441703;4462;2;3613784;2860;48;0;1
FR;3;2022-04-12;0;0;0;0;0;0;0;0;0;4416849;3441703;4462;2;3613784;2860;48;0;1
FR;3;2022-04-13;0;0;0;0;0;0;0;0;0;4416849;3441703;4462;2;3613784;2860;48;0;1
FR;3;2022-04-14;0;0;0;0;0;0;0;0;0;4416849;3441703;4462;2;3613784;2860;48;0;1
FR;3;2022-04-15;1;0;0;0;0;0;0;0;0;4416850;3441703;4462;2;3613784;2860;48;0;1
FR;3;2022-04-16;0;0;0;0;0;0;0;0;0;4416850;3441703;4462;2;3613784;2860;48;0;1
FR;3;2022-04-17;0;0;0;0;0;0;0;0;0;4416850;3441703;4462;2;3613784;2860;48;0;1
FR;3;2022-04-18;0;0;0;0;0;0;0;0;0;4416850;3441703;4462;2;3613784;2860;48;0;1
FR;3;2022-04-19;0;0;0;0;0;0;0;0;0;4416850;3441703;4462;2;3613784;2860;48;0;1
FR;3;2022-04-20;0;0;0;0;0;0;0;0;0;4416850;3441703;4462;2;3613784;2860;48;0;1
FR;3;2022-04-21;0;0;0;0;0;0;0;0;0;4416850;3441703;4462;2;3613784;2860;48;0;1
FR;3;2022-04-22;0;0;0;0;0;0;0;0;0;4416850;3441703;4462;2;3613784;2860;48;0;1
FR;3;2022-04-23;0;0;0;0;0;0;0;0;0;4416850;3441703;4462;2;3613784;2860;48;0;1
FR;3;2022-04-24;0;0;0;0;0;0;0;0;0;4416850;3441703;4462;2;3613784;2860;48;0;1
FR;3;2022-04-25;0;0;0;0;0;0;0;0;0;4416850;3441703;4462;2;3613784;2860;48;0;1
FR;3;2022-04-26;0;0;0;0;0;0;0;0;0;4416850;3441703;4462;2;3613784;2860;48;0;1
FR;3;2022-04-27;0;0;0;0;0;0;0;0;0;4416850;3441703;4462;2;3613784;2860;48;0;1
FR;3;2022-04-28;0;0;0;0;0;0;0;0;0;4416850;3441703;4462;2;3613784;2860;48;0;1
FR;3;2022-04-29;0;0;0;0;0;0;0;0;0;4416850;3441703;4462;2;3613784;2860;48;0;1
FR;3;2022-04-30;0;0;0;0;0;0;0;0;0;4416850;3441703;4462;2;3613784;2860;48;0;1
FR;3;2022-05-01;0;0;0;0;0;0;0;0;0;4416850;3441703;4462;2;3613784;2860;48;0;1
FR;3;2022-05-02;0;0;0;0;0;0;0;0;0;4416850;3441703;4462;2;3613784;2860;48;0;1
FR;3;2022-05-03;0;0;0;0;0;0;0;0;0;4416850;3441703;4462;2;3613784;2860;48;0;1
FR;3;2022-05-04;0;0;0;0;0;0;0;0;0;4416850;3441703;4462;2;3613784;2860;48;0;1
FR;3;2022-05-05;0;0;0;0;0;0;0;0;0;4416850;3441703;4462;2;3613784;2860;48;0;1
FR;3;2022-05-06;0;0;0;0;0;0;0;0;0;4416850;3441703;4462;2;3613784;2860;48;0;1
FR;3;2022-05-07;0;0;0;0;0;0;0;0;0;4416850;3441703;4462;2;3613784;2860;48;0;1
FR;3;2022-05-08;0;0;0;0;0;0;0;0;0;4416850;3441703;4462;2;3613784;2860;48;0;1
FR;3;2022-05-09;0;0;0;0;0;0;0;0;0;4416850;3441703;4462;2;3613784;2860;48;0;1
FR;3;2022-05-10;0;0;0;0;0;0;0;0;0;4416850;3441703;4462;2;3613784;2860;48;0;1
FR;3;2022-05-11;0;0;0;0;0;0;0;0;0;4416850;3441703;4462;2;3613784;2860;48;0;1
FR;3;2022-05-12;0;0;0;0;0;0;0;0;0;4416850;3441703;4462;2;3613784;2860;48;0;1
FR;3;2022-05-13;0;0;0;0;0;0;0;0;0;4416850;3441703;4462;2;3613784;2860;48;0;1
FR;3;2022-05-14;1;0;0;0;0;0;0;0;0;4416851;3441703;4462;2;3613784;2860;48;0;1
FR;3;2022-05-15;0;0;0;0;0;0;0;0;0;4416851;3441703;4462;2;3613784;2860;48;0;1
FR;3;2022-05-16;0;0;0;0;0;0;0;0;0;4416851;3441703;4462;2;3613784;2860;48;0;1
FR;3;2022-05-17;0;0;0;0;0;0;0;0;0;4416851;3441703;4462;2;3613784;2860;48;0;1
FR;3;2022-05-18;0;0;0;0;0;0;0;0;0;4416851;3441703;4462;2;3613784;2860;48;0;1
FR;3;2022-05-19;0;0;0;0;0;0;0;0;0;4416851;3441703;4462;2;3613784;2860;48;0;1
FR;3;2022-05-20;0;0;0;0;0;0;0;0;0;4416851;3441703;4462;2;3613784;2860;48;0;1
FR;3;2022-05-21;0;0;0;0;0;0;0;0;0;4416851;3441703;4462;2;3613784;2860;48;0;1
FR;3;2022-05-22;0;0;0;0;0;0;0;0;0;4416851;3441703;4462;2;3613784;2860;48;0;1
FR;3;2022-05-23;0;0;0;0;0;0;0;0;0;4416851;3441703;4462;2;3613784;2860;48;0;1
FR;3;2022-05-24;0;0;0;0;0;0;0;0;0;4416851;3441703;4462;2;3613784;2860;48;0;1
FR;3;2022-05-25;0;0;0;0;0;0;0;0;0;4416851;3441703;4462;2;3613784;2860;48;0;1
FR;3;2022-05-26;0;0;0;0;0;0;0;0;0;4416851;3441703;4462;2;3613784;2860;48;0;1
FR;3;2022-05-27;0;0;0;0;0;0;0;0;0;4416851;3441703;4462;2;3613784;2860;48;0;1
FR;3;2022-05-28;0;0;0;0;0;0;0;0;0;4416851;3441703;4462;2;3613784;2860;48;0;1
FR;3;2022-05-29;0;0;0;0;0;0;0;0;0;4416851;3441703;4462;2;3613784;2860;48;0;1
FR;3;2022-05-30;0;0;0;0;0;0;0;0;0;4416851;3441703;4462;2;3613784;2860;48;0;1
FR;3;2022-05-31;0;0;0;0;0;0;0;0;0;4416851;3441703;4462;2;3613784;2860;48;0;1
FR;3;2022-06-01;0;0;0;0;0;0;0;0;0;4416851;3441703;4462;2;3613784;2860;48;0;1
FR;3;2022-06-02;0;0;0;0;0;0;0;0;0;4416851;3441703;4462;2;3613784;2860;48;0;1
FR;3;2022-06-03;0;0;0;0;0;0;0;0;0;4416851;3441703;4462;2;3613784;2860;48;0;1
FR;3;2022-06-04;0;0;0;0;0;0;0;0;0;4416851;3441703;4462;2;3613784;2860;48;0;1
FR;3;2022-06-05;0;0;0;0;0;0;0;0;0;4416851;3441703;4462;2;3613784;2860;48;0;1
FR;3;2022-06-06;0;0;0;0;0;0;0;0;0;4416851;3441703;4462;2;3613784;2860;48;0;1
FR;3;2022-06-07;0;0;0;0;0;0;0;0;0;4416851;3441703;4462;2;3613784;2860;48;0;1
FR;3;2022-06-08;0;0;0;0;0;0;0;0;0;4416851;3441703;4462;2;3613784;2860;48;0;1
FR;3;2022-06-09;0;0;0;0;0;0;0;0;0;4416851;3441703;4462;2;3613784;2860;48;0;1
FR;3;2022-06-10;0;0;0;0;0;0;0;0;0;4416851;3441703;4462;2;3613784;2860;48;0;1
FR;3;2022-06-11;0;0;0;0;0;0;0;0;0;4416851;3441703;4462;2;3613784;2860;48;0;1
FR;3;2022-06-12;0;0;0;0;0;0;0;0;0;4416851;3441703;4462;2;3613784;2860;48;0;1
FR;3;2022-06-13;1;0;0;0;0;0;0;0;0;4416852;3441703;4462;2;3613784;2860;48;0;1
FR;3;2022-06-14;0;0;0;0;0;0;0;0;0;4416852;3441703;4462;2;3613784;2860;48;0;1
FR;3;2022-06-15;0;0;0;0;0;0;0;0;0;4416852;3441703;4462;2;3613784;2860;48;0;1
FR;3;2022-06-16;0;0;0;0;0;0;0;0;0;4416852;3441703;4462;2;3613784;2860;48;0;1
FR;3;2022-06-17;0;0;0;0;0;0;0;0;0;4416852;3441703;4462;2;3613784;2860;48;0;1
FR;3;2022-06-18;0;0;0;0;0;0;0;0;0;4416852;3441703;4462;2;3613784;2860;48;0;1
FR;3;2022-06-19;0;0;0;0;0;0;0;0;0;4416852;3441703;4462;2;3613784;2860;48;0;1
FR;3;2022-06-20;0;0;0;0;0;0;0;0;0;4416852;3441703;4462;2;3613784;2860;48;0;1
FR;3;2022-06-21;0;0;0;0;0;0;0;0;0;4416852;3441703;4462;2;3613784;2860;48;0;1
FR;3;2022-06-22;0;0;0;0;0;0;0;0;0;4416852;3441703;4462;2;3613784;2860;48;0;1
FR;3;2022-06-23;0;0;0;0;0;0;0;0;0;4416852;3441703;4462;2;3613784;2860;48;0;1
FR;3;2022-06-24;0;0;0;0;0;0;0;0;0;4416852;3441703;4462;2;3613784;2860;48;0;1
FR;3;2022-06-25;0;0;0;0;0;0;0;0;0;4416852;3441703;4462;2;3613784;2860;48;0;1
FR;3;2022-06-26;0;0;0;0;0;0;0;0;0;4416852;3441703;4462;2;3613784;2860;48;0;1
FR;3;2022-06-27;0;0;0;0;0;0;0;0;0;4416852;3441703;4462;2;3613784;2860;48;0;1
FR;3;2022-06-28;0;0;0;0;0;0;0;0;0;4416852;3441703;4462;2;3613784;2860;48;0;1
FR;3;2022-06-29;1;0;0;0;0;0;0;0;0;4416853;3441703;4462;2;3613784;2860;48;0;1
FR;3;2022-06-30;0;0;0;0;0;0;0;0;0;4416853;3441703;4462;2;3613784;2860;48;0;1
FR;3;2022-07-01;0;0;0;0;0;0;0;0;0;4416853;3441703;4462;2;3613784;2860;48;0;1
FR;3;2022-07-02;0;0;0;0;0;0;0;0;0;4416853;3441703;4462;2;3613784;2860;48;0;1
FR;3;2022-07-03;0;0;0;0;0;0;0;0;0;4416853;3441703;4462;2;3613784;2860;48;0;1
FR;3;2022-07-04;0;0;0;0;0;0;0;0;0;4416853;3441703;4462;2;3613784;2860;48;0;1
FR;3;2022-07-05;0;0;0;0;0;0;0;0;0;4416853;3441703;4462;2;3613784;2860;48;0;1
FR;3;2022-07-06;0;0;0;0;0;0;0;0;0;4416853;3441703;4462;2;3613784;2860;48;0;1
FR;3;2022-07-07;0;0;0;0;0;0;0;0;0;4416853;3441703;4462;2;3613784;2860;48;0;1
FR;3;2022-07-08;0;0;0;0;0;0;0;0;0;4416853;3441703;4462;2;3613784;2860;48;0;1
FR;3;2022-07-09;0;0;0;0;0;0;0;0;0;4416853;3441703;4462;2;3613784;2860;48;0;1
FR;3;2022-07-10;0;0;0;0;0;0;0;0;0;4416853;3441703;4462;2;3613784;2860;48;0;1
FR;3;2022-07-11;0;0;0;0;0;0;0;0;0;4416853;3441703;4462;2;3613784;2860;48;0;1
FR;3;2022-07-12;0;0;0;0;0;0;0;0;0;4416853;3441703;4462;2;3613784;2860;48;0;1
FR;3;2022-07-13;0;0;0;0;0;0;0;0;0;4416853;3441703;4462;2;3613784;2860;48;0;1
FR;3;2022-07-14;0;0;0;0;0;0;0;0;0;4416853;3441703;4462;2;3613784;2860;48;0;1
FR;3;2022-07-15;0;0;0;0;0;0;0;0;0;4416853;3441703;4462;2;3613784;2860;48;0;1
FR;3;2022-07-16;0;0;0;0;0;0;0;0;0;4416853;3441703;4462;2;3613784;2860;48;0;1
FR;3;2022-07-17;0;0;0;0;0;0;0;0;0;4416853;3441703;4462;2;3613784;2860;48;0;1
FR;3;2022-07-18;0;0;0;0;0;0;0;0;0;4416853;3441703;4462;2;3613784;2860;48;0;1
FR;3;2022-07-19;0;0;0;0;0;0;0;0;0;4416853;3441703;4462;2;3613784;2860;48;0;1
FR;3;2022-07-20;0;0;0;0;0;0;0;0;0;4416853;3441703;4462;2;3613784;2860;48;0;1
FR;3;2022-07-21;0;0;0;0;0;0;0;0;0;4416853;3441703;4462;2;3613784;2860;48;0;1
FR;3;2022-07-22;0;0;0;0;0;0;0;0;0;4416853;3441703;4462;2;3613784;2860;48;0;1
FR;3;2022-07-23;0;0;0;0;0;0;0;0;0;4416853;3441703;4462;2;3613784;2860;48;0;1
FR;3;2022-07-24;0;0;0;0;0;0;0;0;0;4416853;3441703;4462;2;3613784;2860;48;0;1
FR;3;2022-07-25;0;0;0;0;0;0;0;0;0;4416853;3441703;4462;2;3613784;2860;48;0;1
FR;3;2022-07-26;0;0;0;0;0;0;0;0;0;4416853;3441703;4462;2;3613784;2860;48;0;1
FR;3;2022-07-27;0;0;0;0;0;0;0;0;0;4416853;3441703;4462;2;3613784;2860;48;0;1
FR;3;2022-07-28;0;0;0;0;0;0;0;0;0;4416853;3441703;4462;2;3613784;2860;48;0;1
FR;3;2022-07-29;0;0;0;0;0;0;0;0;0;4416853;3441703;4462;2;3613784;2860;48;0;1
FR;3;2022-07-30;0;0;0;0;0;0;0;0;0;4416853;3441703;4462;2;3613784;2860;48;0;1
FR;3;2022-07-31;0;0;0;0;0;0;0;0;0;4416853;3441703;4462;2;3613784;2860;48;0;1
FR;3;2022-08-01;0;0;0;0;0;0;0;0;0;4416853;3441703;4462;2;3613784;2860;48;0;1
FR;3;2022-08-02;0;0;0;0;0;0;0;0;0;4416853;3441703;4462;2;3613784;2860;48;0;1
FR;3;2022-08-03;0;0;0;0;0;0;0;0;0;4416853;3441703;4462;2;3613784;2860;48;0;1
FR;3;2022-08-04;0;0;0;0;0;0;0;0;0;4416853;3441703;4462;2;3613784;2860;48;0;1
FR;3;2022-08-05;0;0;0;0;0;0;0;0;0;4416853;3441703;4462;2;3613784;2860;48;0;1
FR;3;2022-08-06;0;0;0;0;0;0;0;0;0;4416853;3441703;4462;2;3613784;2860;48;0;1
FR;3;2022-08-07;0;0;0;0;0;0;0;0;0;4416853;3441703;4462;2;3613784;2860;48;0;1
FR;3;2022-08-08;0;0;0;0;0;0;0;0;0;4416853;3441703;4462;2;3613784;2860;48;0;1
FR;3;2022-08-09;0;0;0;0;0;0;0;0;0;4416853;3441703;4462;2;3613784;2860;48;0;1
FR;3;2022-08-10;0;0;0;0;0;0;0;0;0;4416853;3441703;4462;2;3613784;2860;48;0;1
FR;3;2022-08-11;0;0;0;0;0;0;0;0;0;4416853;3441703;4462;2;3613784;2860;48;0;1
FR;3;2022-08-12;0;0;0;0;0;0;0;0;0;4416853;3441703;4462;2;3613784;2860;48;0;1
FR;3;2022-08-13;0;0;0;0;0;0;0;0;0;4416853;3441703;4462;2;3613784;2860;48;0;1
FR;3;2022-08-14;0;0;0;0;0;0;0;0;0;4416853;3441703;4462;2;3613784;2860;48;0;1
FR;3;2022-08-15;0;0;0;0;0;0;0;0;0;4416853;3441703;4462;2;3613784;2860;48;0;1
FR;3;2022-08-16;0;0;0;0;0;0;0;0;0;4416853;3441703;4462;2;3613784;2860;48;0;1
FR;3;2022-08-17;0;0;0;0;0;0;0;0;0;4416853;3441703;4462;2;3613784;2860;48;0;1
FR;3;2022-08-18;0;0;0;0;0;0;0;0;0;4416853;3441703;4462;2;3613784;2860;48;0;1
FR;3;2022-08-19;0;0;0;0;0;0;0;0;0;4416853;3441703;4462;2;3613784;2860;48;0;1
FR;3;2022-08-20;0;0;0;0;0;0;0;0;0;4416853;3441703;4462;2;3613784;2860;48;0;1
FR;3;2022-08-21;0;0;0;0;0;0;0;0;0;4416853;3441703;4462;2;3613784;2860;48;0;1
FR;3;2022-08-22;0;0;0;0;0;0;0;0;0;4416853;3441703;4462;2;3613784;2860;48;0;1
FR;3;2022-08-23;0;0;0;0;0;0;0;0;0;4416853;3441703;4462;2;3613784;2860;48;0;1
FR;3;2022-08-24;0;0;0;0;0;0;0;0;0;4416853;3441703;4462;2;3613784;2860;48;0;1
FR;3;2022-08-25;0;0;0;0;0;0;0;0;0;4416853;3441703;4462;2;3613784;2860;48;0;1
FR;3;2022-08-26;0;0;0;0;0;0;0;0;0;4416853;3441703;4462;2;3613784;2860;48;0;1
FR;3;2022-08-27;0;0;0;0;0;0;0;0;0;4416853;3441703;4462;2;3613784;2860;48;0;1
FR;3;2022-08-28;0;0;0;0;0;0;0;0;0;4416853;3441703;4462;2;3613784;2860;48;0;1
FR;3;2022-08-29;0;0;0;0;0;0;0;0;0;4416853;3441703;4462;2;3613784;2860;48;0;1
FR;3;2022-08-30;0;0;0;0;0;0;0;0;0;4416853;3441703;4462;2;3613784;2860;48;0;1
FR;3;2022-08-31;0;0;0;0;0;0;0;0;0;4416853;3441703;4462;2;3613784;2860;48;0;1
FR;3;2022-09-01;0;0;0;0;0;0;0;0;0;4416853;3441703;4462;2;3613784;2860;48;0;1
FR;3;2022-09-02;0;0;0;0;0;0;0;0;0;4416853;3441703;4462;2;3613784;2860;48;0;1
FR;3;2022-09-03;0;0;0;0;0;0;0;0;0;4416853;3441703;4462;2;3613784;2860;48;0;1
FR;3;2022-09-04;0;0;0;0;0;0;0;0;0;4416853;3441703;4462;2;3613784;2860;48;0;1
FR;3;2022-09-05;0;0;0;0;0;0;0;0;0;4416853;3441703;4462;2;3613784;2860;48;0;1
FR;3;2022-09-06;0;0;0;0;0;0;0;0;0;4416853;3441703;4462;2;3613784;2860;48;0;1
FR;3;2022-09-07;0;0;0;0;0;0;0;0;0;4416853;3441703;4462;2;3613784;2860;48;0;1
FR;3;2022-09-08;0;0;0;0;0;0;0;0;0;4416853;3441703;4462;2;3613784;2860;48;0;1
FR;3;2022-09-09;0;0;0;0;0;0;0;0;0;4416853;3441703;4462;2;3613784;2860;48;0;1
FR;3;2022-09-10;0;0;0;0;0;0;0;0;0;4416853;3441703;4462;2;3613784;2860;48;0;1
FR;3;2022-09-11;0;0;0;0;0;0;0;0;0;4416853;3441703;4462;2;3613784;2860;48;0;1
FR;3;2022-09-12;0;0;0;0;0;0;0;0;0;4416853;3441703;4462;2;3613784;2860;48;0;1
FR;3;2022-09-13;0;0;0;0;0;0;0;0;0;4416853;3441703;4462;2;3613784;2860;48;0;1
FR;3;2022-09-14;0;0;0;0;0;0;0;0;0;4416853;3441703;4462;2;3613784;2860;48;0;1
FR;3;2022-09-15;0;0;0;0;0;0;0;0;0;4416853;3441703;4462;2;3613784;2860;48;0;1
FR;3;2022-09-16;0;0;0;0;0;0;0;0;0;4416853;3441703;4462;2;3613784;2860;48;0;1
FR;3;2022-09-17;0;0;0;0;0;0;0;0;0;4416853;3441703;4462;2;3613784;2860;48;0;1
FR;3;2022-09-18;0;0;0;0;0;0;0;0;0;4416853;3441703;4462;2;3613784;2860;48;0;1
FR;3;2022-09-19;0;0;0;0;0;0;0;0;0;4416853;3441703;4462;2;3613784;2860;48;0;1
FR;3;2022-09-20;0;0;0;0;0;0;0;0;0;4416853;3441703;4462;2;3613784;2860;48;0;1
FR;3;2022-09-21;0;0;0;0;0;0;0;0;0;4416853;3441703;4462;2;3613784;2860;48;0;1
FR;3;2022-09-22;0;0;0;0;0;0;0;0;0;4416853;3441703;4462;2;3613784;2860;48;0;1
FR;3;2022-09-23;0;0;0;0;0;0;0;0;0;4416853;3441703;4462;2;3613784;2860;48;0;1
FR;3;2022-09-24;0;0;0;0;0;0;0;0;0;4416853;3441703;4462;2;3613784;2860;48;0;1
FR;3;2022-09-25;0;0;0;0;0;0;0;0;0;4416853;3441703;4462;2;3613784;2860;48;0;1
FR;3;2022-09-26;0;0;0;0;0;0;0;0;0;4416853;3441703;4462;2;3613784;2860;48;0;1
FR;3;2022-09-27;0;0;0;0;0;0;0;0;0;4416853;3441703;4462;2;3613784;2860;48;0;1
FR;3;2022-09-28;0;0;0;0;0;0;0;0;0;4416853;3441703;4462;2;3613784;2860;48;0;1
FR;3;2022-09-29;0;0;0;0;0;0;0;0;0;4416853;3441703;4462;2;3613784;2860;48;0;1
FR;3;2022-09-30;0;0;0;0;0;0;0;0;0;4416853;3441703;4462;2;3613784;2860;48;0;1
FR;3;2022-10-01;0;0;0;0;0;0;0;0;0;4416853;3441703;4462;2;3613784;2860;48;0;1
FR;3;2022-10-02;0;0;0;0;0;0;0;0;0;4416853;3441703;4462;2;3613784;2860;48;0;1
FR;3;2022-10-03;0;0;0;0;0;0;0;0;0;4416853;3441703;4462;2;3613784;2860;48;0;1
FR;3;2022-10-04;0;0;0;0;0;0;0;0;0;4416853;3441703;4462;2;3613784;2860;48;0;1
FR;3;2022-10-05;0;0;0;0;0;0;0;0;0;4416853;3441703;4462;2;3613784;2860;48;0;1
FR;3;2022-10-06;0;0;0;0;0;0;0;0;0;4416853;3441703;4462;2;3613784;2860;48;0;1
FR;3;2022-10-07;0;0;0;0;0;0;0;0;0;4416853;3441703;4462;2;3613784;2860;48;0;1
FR;3;2022-10-08;0;0;0;0;0;0;0;0;0;4416853;3441703;4462;2;3613784;2860;48;0;1
FR;3;2022-10-09;0;0;0;0;0;0;0;0;0;4416853;3441703;4462;2;3613784;2860;48;0;1
FR;3;2022-10-10;0;0;0;0;0;0;0;0;0;4416853;3441703;4462;2;3613784;2860;48;0;1
FR;3;2022-10-11;0;0;0;0;0;0;0;0;0;4416853;3441703;4462;2;3613784;2860;48;0;1
FR;3;2022-10-12;0;0;0;0;0;0;0;0;0;4416853;3441703;4462;2;3613784;2860;48;0;1
FR;3;2022-10-13;0;0;0;0;0;0;0;0;0;4416853;3441703;4462;2;3613784;2860;48;0;1
FR;3;2022-10-14;0;0;0;0;0;0;0;0;0;4416853;3441703;4462;2;3613784;2860;48;0;1
FR;3;2022-10-15;0;0;0;0;0;0;0;0;0;4416853;3441703;4462;2;3613784;2860;48;0;1
FR;3;2022-10-16;0;0;0;0;0;0;0;0;0;4416853;3441703;4462;2;3613784;2860;48;0;1
FR;3;2022-10-17;0;0;0;0;0;0;0;0;0;4416853;3441703;4462;2;3613784;2860;48;0;1
FR;3;2022-10-18;0;0;0;0;0;0;0;0;0;4416853;3441703;4462;2;3613784;2860;48;0;1
FR;3;2022-10-19;0;0;0;0;0;0;0;0;0;4416853;3441703;4462;2;3613784;2860;48;0;1
FR;3;2022-10-20;0;0;0;0;0;0;0;0;0;4416853;3441703;4462;2;3613784;2860;48;0;1
FR;3;2022-10-21;0;0;0;0;0;0;0;0;0;4416853;3441703;4462;2;3613784;2860;48;0;1
FR;3;2022-10-22;0;0;0;0;0;0;0;0;0;4416853;3441703;4462;2;3613784;2860;48;0;1
FR;3;2022-10-23;0;0;0;0;0;0;0;0;0;4416853;3441703;4462;2;3613784;2860;48;0;1
FR;3;2022-10-24;0;0;0;0;0;0;0;0;0;4416853;3441703;4462;2;3613784;2860;48;0;1
FR;3;2022-10-25;0;0;0;0;0;0;0;0;0;4416853;3441703;4462;2;3613784;2860;48;0;1
FR;3;2022-10-26;0;0;0;0;0;0;0;0;0;4416853;3441703;4462;2;3613784;2860;48;0;1
FR;3;2022-10-27;0;0;0;0;0;0;0;0;0;4416853;3441703;4462;2;3613784;2860;48;0;1
FR;3;2022-10-28;0;0;0;0;0;0;0;0;0;4416853;3441703;4462;2;3613784;2860;48;0;1
FR;3;2022-10-29;0;0;0;0;0;0;0;0;0;4416853;3441703;4462;2;3613784;2860;48;0;1
FR;3;2022-10-30;0;0;0;0;0;0;0;0;0;4416853;3441703;4462;2;3613784;2860;48;0;1
FR;3;2022-10-31;0;0;0;0;0;0;0;0;0;4416853;3441703;4462;2;3613784;2860;48;0;1
FR;3;2022-11-01;0;0;0;0;0;0;0;0;0;4416853;3441703;4462;2;3613784;2860;48;0;1
FR;3;2022-11-02;0;0;0;0;0;0;0;0;0;4416853;3441703;4462;2;3613784;2860;48;0;1
FR;3;2022-11-03;0;0;0;0;0;0;0;0;0;4416853;3441703;4462;2;3613784;2860;48;0;1
FR;3;2022-11-04;0;0;0;0;0;0;0;0;0;4416853;3441703;4462;2;3613784;2860;48;0;1
FR;3;2022-11-05;0;0;0;0;0;0;0;0;0;4416853;3441703;4462;2;3613784;2860;48;0;1
FR;3;2022-11-06;0;0;0;0;0;0;0;0;0;4416853;3441703;4462;2;3613784;2860;48;0;1
FR;3;2022-11-07;0;0;0;0;0;0;0;0;0;4416853;3441703;4462;2;3613784;2860;48;0;1
FR;3;2022-11-08;1;0;0;0;0;0;0;0;0;4416854;3441703;4462;2;3613784;2860;48;0;1
FR;3;2022-11-09;0;0;0;0;0;0;0;0;0;4416854;3441703;4462;2;3613784;2860;48;0;1
FR;3;2022-11-10;0;0;0;0;0;0;0;0;0;4416854;3441703;4462;2;3613784;2860;48;0;1
FR;3;2022-11-11;0;0;0;0;0;0;0;0;0;4416854;3441703;4462;2;3613784;2860;48;0;1
FR;3;2022-11-12;0;0;0;0;0;0;0;0;0;4416854;3441703;4462;2;3613784;2860;48;0;1
FR;3;2022-11-13;0;0;0;0;0;0;0;0;0;4416854;3441703;4462;2;3613784;2860;48;0;1
FR;3;2022-11-14;0;0;0;0;0;0;0;0;0;4416854;3441703;4462;2;3613784;2860;48;0;1
FR;3;2022-11-15;0;0;0;0;0;0;0;0;0;4416854;3441703;4462;2;3613784;2860;48;0;1
FR;3;2022-11-16;0;0;0;0;0;0;0;0;0;4416854;3441703;4462;2;3613784;2860;48;0;1
FR;3;2022-11-17;0;0;0;0;0;0;0;0;0;4416854;3441703;4462;2;3613784;2860;48;0;1
FR;3;2022-11-18;0;0;0;0;0;0;0;0;0;4416854;3441703;4462;2;3613784;2860;48;0;1
FR;3;2022-11-19;0;0;0;0;0;0;0;0;0;4416854;3441703;4462;2;3613784;2860;48;0;1
FR;3;2022-11-20;0;0;0;0;0;0;0;0;0;4416854;3441703;4462;2;3613784;2860;48;0;1
FR;3;2022-11-21;0;0;0;0;0;0;0;0;0;4416854;3441703;4462;2;3613784;2860;48;0;1
FR;3;2022-11-22;0;0;0;0;0;0;0;0;0;4416854;3441703;4462;2;3613784;2860;48;0;1
FR;3;2022-11-23;0;0;0;0;0;0;0;0;0;4416854;3441703;4462;2;3613784;2860;48;0;1
FR;3;2022-11-24;0;0;0;0;0;0;0;0;0;4416854;3441703;4462;2;3613784;2860;48;0;1
FR;3;2022-11-25;0;0;0;0;0;0;0;0;0;4416854;3441703;4462;2;3613784;2860;48;0;1
FR;3;2022-11-26;0;0;0;0;0;0;0;0;0;4416854;3441703;4462;2;3613784;2860;48;0;1
FR;3;2022-11-27;0;0;0;0;0;0;0;0;0;4416854;3441703;4462;2;3613784;2860;48;0;1
FR;3;2022-11-28;0;0;0;0;0;0;0;0;0;4416854;3441703;4462;2;3613784;2860;48;0;1
FR;3;2022-11-29;0;0;0;0;0;0;0;0;0;4416854;3441703;4462;2;3613784;2860;48;0;1
FR;3;2022-11-30;0;0;0;0;0;0;0;0;0;4416854;3441703;4462;2;3613784;2860;48;0;1
FR;3;2022-12-01;0;0;0;0;0;0;0;0;0;4416854;3441703;4462;2;3613784;2860;48;0;1
FR;3;2022-12-02;0;0;0;0;0;0;0;0;0;4416854;3441703;4462;2;3613784;2860;48;0;1
FR;3;2022-12-03;0;0;0;0;0;0;0;0;0;4416854;3441703;4462;2;3613784;2860;48;0;1
FR;3;2022-12-04;0;0;0;0;0;0;0;0;0;4416854;3441703;4462;2;3613784;2860;48;0;1
FR;3;2022-12-05;0;0;0;0;0;0;0;0;0;4416854;3441703;4462;2;3613784;2860;48;0;1
FR;3;2022-12-06;0;0;0;0;0;0;0;0;0;4416854;3441703;4462;2;3613784;2860;48;0;1
FR;3;2022-12-07;0;0;0;0;0;0;0;0;0;4416854;3441703;4462;2;3613784;2860;48;0;1
FR;3;2022-12-08;0;0;0;0;0;0;0;0;0;4416854;3441703;4462;2;3613784;2860;48;0;1
FR;3;2022-12-09;0;0;0;0;0;0;0;0;0;4416854;3441703;4462;2;3613784;2860;48;0;1
FR;3;2022-12-10;0;0;0;0;0;0;0;0;0;4416854;3441703;4462;2;3613784;2860;48;0;1
FR;3;2022-12-11;0;0;0;0;0;0;0;0;0;4416854;3441703;4462;2;3613784;2860;48;0;1
FR;3;2022-12-12;0;0;0;0;0;0;0;0;0;4416854;3441703;4462;2;3613784;2860;48;0;1
FR;3;2022-12-13;0;0;0;0;0;0;0;0;0;4416854;3441703;4462;2;3613784;2860;48;0;1
FR;3;2022-12-14;0;0;0;0;0;0;0;0;0;4416854;3441703;4462;2;3613784;2860;48;0;1
FR;3;2022-12-15;0;0;0;0;0;0;0;0;0;4416854;3441703;4462;2;3613784;2860;48;0;1
FR;3;2022-12-16;0;0;0;0;0;0;0;0;0;4416854;3441703;4462;2;3613784;2860;48;0;1
FR;3;2022-12-17;0;0;0;0;0;0;0;0;0;4416854;3441703;4462;2;3613784;2860;48;0;1
FR;3;2022-12-18;0;0;0;0;0;0;0;0;0;4416854;3441703;4462;2;3613784;2860;48;0;1
FR;3;2022-12-19;0;0;0;0;0;0;0;0;0;4416854;3441703;4462;2;3613784;2860;48;0;1
FR;3;2022-12-20;0;0;0;0;0;0;0;0;0;4416854;3441703;4462;2;3613784;2860;48;0;1
FR;3;2022-12-21;0;0;0;0;0;0;0;0;0;4416854;3441703;4462;2;3613784;2860;48;0;1
FR;3;2022-12-22;0;0;0;0;0;0;0;0;0;4416854;3441703;4462;2;3613784;2860;48;0;1
FR;3;2022-12-23;0;0;0;0;0;0;0;0;0;4416854;3441703;4462;2;3613784;2860;48;0;1
FR;3;2022-12-24;0;0;0;0;0;0;0;0;0;4416854;3441703;4462;2;3613784;2860;48;0;1
FR;3;2022-12-25;0;0;0;0;0;0;0;0;0;4416854;3441703;4462;2;3613784;2860;48;0;1
FR;3;2022-12-26;0;0;0;0;0;0;0;0;0;4416854;3441703;4462;2;3613784;2860;48;0;1
FR;3;2022-12-27;0;0;0;0;0;0;0;0;0;4416854;3441703;4462;2;3613784;2860;48;0;1
FR;3;2022-12-28;0;0;0;0;0;0;0;0;0;4416854;3441703;4462;2;3613784;2860;48;0;1
FR;3;2022-12-29;0;0;0;0;0;0;0;0;0;4416854;3441703;4462;2;3613784;2860;48;0;1
FR;3;2022-12-30;0;0;0;0;0;0;0;0;0;4416854;3441703;4462;2;3613784;2860;48;0;1
FR;3;2022-12-31;0;0;0;0;0;0;0;0;0;4416854;3441703;4462;2;3613784;2860;48;0;1
FR;3;2023-01-01;0;0;0;0;0;0;0;0;0;4416854;3441703;4462;2;3613784;2860;48;0;1
FR;3;2023-01-02;0;0;0;0;0;0;0;0;0;4416854;3441703;4462;2;3613784;2860;48;0;1
FR;3;2023-01-03;0;0;0;0;0;0;0;0;0;4416854;3441703;4462;2;3613784;2860;48;0;1
FR;3;2023-01-04;0;0;0;0;0;0;0;0;0;4416854;3441703;4462;2;3613784;2860;48;0;1
FR;3;2023-01-05;0;0;0;0;0;0;0;0;0;4416854;3441703;4462;2;3613784;2860;48;0;1
FR;3;2023-01-06;0;0;0;0;0;0;0;0;0;4416854;3441703;4462;2;3613784;2860;48;0;1
FR;3;2023-01-07;0;0;0;0;0;0;0;0;0;4416854;3441703;4462;2;3613784;2860;48;0;1
FR;3;2023-01-08;0;0;0;0;0;0;0;0;0;4416854;3441703;4462;2;3613784;2860;48;0;1
FR;3;2023-01-09;0;0;0;0;0;0;0;0;0;4416854;3441703;4462;2;3613784;2860;48;0;1
FR;3;2023-01-10;0;0;0;0;0;0;0;0;0;4416854;3441703;4462;2;3613784;2860;48;0;1
FR;3;2023-01-11;0;0;0;0;0;0;0;0;0;4416854;3441703;4462;2;3613784;2860;48;0;1
FR;3;2023-01-12;0;0;0;0;0;0;0;0;0;4416854;3441703;4462;2;3613784;2860;48;0;1
FR;3;2023-01-13;0;0;0;0;0;0;0;0;0;4416854;3441703;4462;2;3613784;2860;48;0;1
FR;3;2023-01-14;0;0;0;0;0;0;0;0;0;4416854;3441703;4462;2;3613784;2860;48;0;1
FR;3;2023-01-15;0;0;0;0;0;0;0;0;0;4416854;3441703;4462;2;3613784;2860;48;0;1
FR;3;2023-01-16;0;0;0;0;0;0;0;0;0;4416854;3441703;4462;2;3613784;2860;48;0;1
FR;3;2023-01-17;0;0;0;0;0;0;0;0;0;4416854;3441703;4462;2;3613784;2860;48;0;1
FR;3;2023-01-18;0;0;0;0;0;0;0;0;0;4416854;3441703;4462;2;3613784;2860;48;0;1
FR;3;2023-01-19;0;0;0;0;0;0;0;0;0;4416854;3441703;4462;2;3613784;2860;48;0;1
FR;3;2023-01-20;0;0;0;0;0;0;0;0;0;4416854;3441703;4462;2;3613784;2860;48;0;1
FR;3;2023-01-21;0;0;0;0;0;0;0;0;0;4416854;3441703;4462;2;3613784;2860;48;0;1
FR;3;2023-01-22;0;0;0;0;0;0;0;0;0;4416854;3441703;4462;2;3613784;2860;48;0;1
FR;3;2023-01-23;0;0;0;0;0;0;0;0;0;4416854;3441703;4462;2;3613784;2860;48;0;1
FR;3;2023-01-24;0;0;0;0;0;0;0;0;0;4416854;3441703;4462;2;3613784;2860;48;0;1
FR;3;2023-01-25;1;0;0;0;0;0;0;0;0;4416855;3441703;4462;2;3613784;2860;48;0;1
FR;3;2023-01-26;0;0;0;0;0;0;0;0;0;4416855;3441703;4462;2;3613784;2860;48;0;1
FR;3;2023-01-27;0;0;0;0;0;0;0;0;0;4416855;3441703;4462;2;3613784;2860;48;0;1
FR;3;2023-01-28;0;0;0;0;0;0;0;0;0;4416855;3441703;4462;2;3613784;2860;48;0;1
FR;3;2023-01-29;0;0;0;0;0;0;0;0;0;4416855;3441703;4462;2;3613784;2860;48;0;1
FR;3;2023-01-30;0;0;0;0;0;0;0;0;0;4416855;3441703;4462;2;3613784;2860;48;0;1
FR;3;2023-01-31;0;0;0;0;0;0;0;0;0;4416855;3441703;4462;2;3613784;2860;48;0;1
FR;3;2023-02-01;0;0;0;0;0;0;0;0;0;4416855;3441703;4462;2;3613784;2860;48;0;1
FR;3;2023-02-02;0;0;0;0;0;0;0;0;0;4416855;3441703;4462;2;3613784;2860;48;0;1
FR;3;2023-02-03;0;0;0;0;0;0;0;0;0;4416855;3441703;4462;2;3613784;2860;48;0;1
FR;3;2023-02-04;0;0;0;0;0;0;0;0;0;4416855;3441703;4462;2;3613784;2860;48;0;1
FR;3;2023-02-05;0;0;0;0;0;0;0;0;0;4416855;3441703;4462;2;3613784;2860;48;0;1
FR;3;2023-02-06;0;0;0;0;0;0;0;0;0;4416855;3441703;4462;2;3613784;2860;48;0;1
FR;3;2023-02-07;0;0;0;0;0;0;0;0;0;4416855;3441703;4462;2;3613784;2860;48;0;1
FR;3;2023-02-08;0;0;0;0;0;0;0;0;0;4416855;3441703;4462;2;3613784;2860;48;0;1
FR;3;2023-02-09;0;0;0;0;0;0;0;0;0;4416855;3441703;4462;2;3613784;2860;48;0;1
FR;3;2023-02-10;0;0;0;0;0;0;0;0;0;4416855;3441703;4462;2;3613784;2860;48;0;1
FR;3;2023-02-11;0;0;0;0;0;0;0;0;0;4416855;3441703;4462;2;3613784;2860;48;0;1
FR;3;2023-02-12;0;0;0;0;0;0;0;0;0;4416855;3441703;4462;2;3613784;2860;48;0;1
FR;3;2023-02-13;0;0;0;0;0;0;0;0;0;4416855;3441703;4462;2;3613784;2860;48;0;1
FR;3;2023-02-14;0;0;0;0;0;0;0;0;0;4416855;3441703;4462;2;3613784;2860;48;0;1
FR;3;2023-02-15;0;0;0;0;0;0;0;0;0;4416855;3441703;4462;2;3613784;2860;48;0;1
FR;3;2023-02-16;0;0;0;0;0;0;0;0;0;4416855;3441703;4462;2;3613784;2860;48;0;1
FR;3;2023-02-17;0;0;0;0;0;0;0;0;0;4416855;3441703;4462;2;3613784;2860;48;0;1
FR;3;2023-02-18;0;0;0;0;0;0;0;0;0;4416855;3441703;4462;2;3613784;2860;48;0;1
FR;3;2023-02-19;0;0;0;0;0;0;0;0;0;4416855;3441703;4462;2;3613784;2860;48;0;1
FR;3;2023-02-20;0;0;0;0;0;0;0;0;0;4416855;3441703;4462;2;3613784;2860;48;0;1
FR;3;2023-02-21;0;0;0;0;0;0;0;0;0;4416855;3441703;4462;2;3613784;2860;48;0;1
FR;3;2023-02-22;0;0;0;0;0;0;0;0;0;4416855;3441703;4462;2;3613784;2860;48;0;1
FR;3;2023-02-23;0;0;0;0;0;0;0;0;0;4416855;3441703;4462;2;3613784;2860;48;0;1
FR;3;2023-02-24;0;0;0;0;0;0;0;0;0;4416855;3441703;4462;2;3613784;2860;48;0;1
FR;3;2023-02-25;0;0;0;0;0;0;0;0;0;4416855;3441703;4462;2;3613784;2860;48;0;1
FR;3;2023-02-26;0;0;0;0;0;0;0;0;0;4416855;3441703;4462;2;3613784;2860;48;0;1
FR;3;2023-02-27;0;0;0;0;0;0;0;0;0;4416855;3441703;4462;2;3613784;2860;48;0;1
FR;3;2023-02-28;0;0;0;0;0;0;0;0;0;4416855;3441703;4462;2;3613784;2860;48;0;1
FR;3;2023-03-01;0;0;0;0;0;0;0;0;0;4416855;3441703;4462;2;3613784;2860;48;0;1
FR;3;2023-03-02;0;0;0;0;0;0;0;0;0;4416855;3441703;4462;2;3613784;2860;48;0;1
FR;3;2023-03-03;0;0;0;0;0;0;0;0;0;4416855;3441703;4462;2;3613784;2860;48;0;1
FR;3;2023-03-04;0;0;0;0;0;0;0;0;0;4416855;3441703;4462;2;3613784;2860;48;0;1
FR;3;2023-03-05;0;0;0;0;0;0;0;0;0;4416855;3441703;4462;2;3613784;2860;48;0;1
FR;3;2023-03-06;0;0;0;0;0;0;0;0;0;4416855;3441703;4462;2;3613784;2860;48;0;1
FR;3;2023-03-07;0;0;0;0;0;0;0;0;0;4416855;3441703;4462;2;3613784;2860;48;0;1
FR;3;2023-03-08;0;0;0;0;0;0;0;0;0;4416855;3441703;4462;2;3613784;2860;48;0;1
FR;3;2023-03-09;0;0;0;0;0;0;0;0;0;4416855;3441703;4462;2;3613784;2860;48;0;1
FR;3;2023-03-10;0;0;0;0;0;0;0;0;0;4416855;3441703;4462;2;3613784;2860;48;0;1
FR;3;2023-03-11;0;0;0;0;0;0;0;0;0;4416855;3441703;4462;2;3613784;2860;48;0;1
FR;3;2023-03-12;0;0;0;0;0;0;0;0;0;4416855;3441703;4462;2;3613784;2860;48;0;1
FR;3;2023-03-13;0;0;0;0;0;0;0;0;0;4416855;3441703;4462;2;3613784;2860;48;0;1
FR;3;2023-03-14;0;0;0;0;0;0;0;0;0;4416855;3441703;4462;2;3613784;2860;48;0;1
FR;3;2023-03-15;0;0;0;0;0;0;0;0;0;4416855;3441703;4462;2;3613784;2860;48;0;1
FR;3;2023-03-16;0;0;0;0;0;0;0;0;0;4416855;3441703;4462;2;3613784;2860;48;0;1
FR;3;2023-03-17;0;0;0;0;0;0;0;0;0;4416855;3441703;4462;2;3613784;2860;48;0;1
FR;3;2023-03-18;0;0;0;0;0;0;0;0;0;4416855;3441703;4462;2;3613784;2860;48;0;1
FR;3;2023-03-19;0;0;0;0;0;0;0;0;0;4416855;3441703;4462;2;3613784;2860;48;0;1
FR;3;2023-03-20;0;0;0;0;0;0;0;0;0;4416855;3441703;4462;2;3613784;2860;48;0;1
FR;3;2023-03-21;0;0;0;0;0;0;0;0;0;4416855;3441703;4462;2;3613784;2860;48;0;1
FR;3;2023-03-22;0;0;0;0;0;0;0;0;0;4416855;3441703;4462;2;3613784;2860;48;0;1
FR;3;2023-03-23;0;0;0;0;0;0;0;0;0;4416855;3441703;4462;2;3613784;2860;48;0;1
FR;3;2023-03-24;0;0;0;0;0;0;0;0;0;4416855;3441703;4462;2;3613784;2860;48;0;1
FR;3;2023-03-25;0;0;0;0;0;0;0;0;0;4416855;3441703;4462;2;3613784;2860;48;0;1
FR;3;2023-03-26;0;0;0;0;0;0;0;0;0;4416855;3441703;4462;2;3613784;2860;48;0;1
FR;3;2023-03-27;0;0;0;0;0;0;0;0;0;4416855;3441703;4462;2;3613784;2860;48;0;1
FR;3;2023-03-28;0;0;0;0;0;0;0;0;0;4416855;3441703;4462;2;3613784;2860;48;0;1
FR;3;2023-03-29;0;0;0;0;0;0;0;0;0;4416855;3441703;4462;2;3613784;2860;48;0;1
FR;4;2020-12-27;0;0;0;0;0;0;0;0;0;0;0;0;0;0;0;0;0;0
FR;4;2020-12-28;0;0;0;0;0;0;0;0;0;0;0;0;0;0;0;0;0;0
FR;4;2020-12-29;0;0;0;0;0;0;0;0;0;0;0;0;0;0;0;0;0;0
FR;4;2020-12-30;0;0;0;0;0;0;0;0;0;0;0;0;0;0;0;0;0;0
FR;4;2020-12-31;0;0;0;0;0;0;0;0;0;0;0;0;0;0;0;0;0;0
FR;4;2021-01-01;0;0;0;0;0;0;0;0;0;0;0;0;0;0;0;0;0;0
FR;4;2021-01-02;0;0;0;0;0;0;0;0;0;0;0;0;0;0;0;0;0;0
FR;4;2021-01-03;0;0;0;0;0;0;0;0;0;0;0;0;0;0;0;0;0;0
FR;4;2021-01-04;0;0;0;0;0;0;0;0;0;0;0;0;0;0;0;0;0;0
FR;4;2021-01-05;0;0;0;0;0;0;0;0;0;0;0;0;0;0;0;0;0;0
FR;4;2021-01-06;0;0;0;0;0;0;0;0;0;0;0;0;0;0;0;0;0;0
FR;4;2021-01-07;0;0;0;0;0;0;0;0;0;0;0;0;0;0;0;0;0;0
FR;4;2021-01-08;0;0;0;0;0;0;0;0;0;0;0;0;0;0;0;0;0;0
FR;4;2021-01-09;0;0;0;0;0;0;0;0;0;0;0;0;0;0;0;0;0;0
FR;4;2021-01-10;0;0;0;0;0;0;0;0;0;0;0;0;0;0;0;0;0;0
FR;4;2021-01-11;0;0;0;0;0;0;0;0;0;0;0;0;0;0;0;0;0;0
FR;4;2021-01-12;0;0;0;0;0;0;0;0;0;0;0;0;0;0;0;0;0;0
FR;4;2021-01-13;0;0;0;0;0;0;0;0;0;0;0;0;0;0;0;0;0;0
FR;4;2021-01-14;0;0;0;0;0;0;0;0;0;0;0;0;0;0;0;0;0;0
FR;4;2021-01-15;0;0;0;0;0;0;0;0;0;0;0;0;0;0;0;0;0;0
FR;4;2021-01-16;0;0;0;0;0;0;0;0;0;0;0;0;0;0;0;0;0;0
FR;4;2021-01-17;0;0;0;0;0;0;0;0;0;0;0;0;0;0;0;0;0;0
FR;4;2021-01-18;0;0;0;0;0;0;0;0;0;0;0;0;0;0;0;0;0;0
FR;4;2021-01-19;0;0;0;0;0;0;0;0;0;0;0;0;0;0;0;0;0;0
FR;4;2021-01-20;0;0;0;0;0;0;0;0;0;0;0;0;0;0;0;0;0;0
FR;4;2021-01-21;0;0;0;0;0;0;0;0;0;0;0;0;0;0;0;0;0;0
FR;4;2021-01-22;0;0;0;0;0;0;0;0;0;0;0;0;0;0;0;0;0;0
FR;4;2021-01-23;0;0;0;0;0;0;0;0;0;0;0;0;0;0;0;0;0;0
FR;4;2021-01-24;0;0;0;0;0;0;0;0;0;0;0;0;0;0;0;0;0;0
FR;4;2021-01-25;0;0;0;0;0;0;0;0;0;0;0;0;0;0;0;0;0;0
FR;4;2021-01-26;0;0;0;0;0;0;0;0;0;0;0;0;0;0;0;0;0;0
FR;4;2021-01-27;0;0;0;0;0;0;0;0;0;0;0;0;0;0;0;0;0;0
FR;4;2021-01-28;0;0;0;0;0;0;0;0;0;0;0;0;0;0;0;0;0;0
FR;4;2021-01-29;0;0;0;0;0;0;0;0;0;0;0;0;0;0;0;0;0;0
FR;4;2021-01-30;0;0;0;0;0;0;0;0;0;0;0;0;0;0;0;0;0;0
FR;4;2021-01-31;0;0;0;0;0;0;0;0;0;0;0;0;0;0;0;0;0;0
FR;4;2021-02-01;0;0;0;0;0;0;0;0;0;0;0;0;0;0;0;0;0;0
FR;4;2021-02-02;0;0;0;0;0;0;0;0;0;0;0;0;0;0;0;0;0;0
FR;4;2021-02-03;0;0;0;0;0;0;0;0;0;0;0;0;0;0;0;0;0;0
FR;4;2021-02-04;0;0;0;0;0;0;0;0;0;0;0;0;0;0;0;0;0;0
FR;4;2021-02-05;0;0;0;0;0;0;0;0;0;0;0;0;0;0;0;0;0;0
FR;4;2021-02-06;0;0;0;0;0;0;0;0;0;0;0;0;0;0;0;0;0;0
FR;4;2021-02-07;0;0;0;0;0;0;0;0;0;0;0;0;0;0;0;0;0;0
FR;4;2021-02-08;0;0;0;0;0;0;0;0;0;0;0;0;0;0;0;0;0;0
FR;4;2021-02-09;0;0;0;0;0;0;0;0;0;0;0;0;0;0;0;0;0;0
FR;4;2021-02-10;0;0;0;0;0;0;0;0;0;0;0;0;0;0;0;0;0;0
FR;4;2021-02-11;0;0;0;0;0;0;0;0;0;0;0;0;0;0;0;0;0;0
FR;4;2021-02-12;0;0;0;0;0;0;0;0;0;0;0;0;0;0;0;0;0;0
FR;4;2021-02-13;0;0;0;0;0;0;0;0;0;0;0;0;0;0;0;0;0;0
FR;4;2021-02-14;0;0;0;0;0;0;0;0;0;0;0;0;0;0;0;0;0;0
FR;4;2021-02-15;0;0;0;0;0;0;0;0;0;0;0;0;0;0;0;0;0;0
FR;4;2021-02-16;0;0;0;0;0;0;0;0;0;0;0;0;0;0;0;0;0;0
FR;4;2021-02-17;0;0;0;0;0;0;0;0;0;0;0;0;0;0;0;0;0;0
FR;4;2021-02-18;0;0;0;0;0;0;0;0;0;0;0;0;0;0;0;0;0;0
FR;4;2021-02-19;0;0;0;0;0;0;0;0;0;0;0;0;0;0;0;0;0;0
FR;4;2021-02-20;0;0;0;0;0;0;0;0;0;0;0;0;0;0;0;0;0;0
FR;4;2021-02-21;0;0;0;0;0;0;0;0;0;0;0;0;0;0;0;0;0;0
FR;4;2021-02-22;0;0;0;0;0;0;0;0;0;0;0;0;0;0;0;0;0;0
FR;4;2021-02-23;0;0;0;0;0;0;0;0;0;0;0;0;0;0;0;0;0;0
FR;4;2021-02-24;0;0;0;0;0;0;0;0;0;0;0;0;0;0;0;0;0;0
FR;4;2021-02-25;0;0;0;0;0;0;0;0;0;0;0;0;0;0;0;0;0;0
FR;4;2021-02-26;0;0;0;0;0;0;0;0;0;0;0;0;0;0;0;0;0;0
FR;4;2021-02-27;0;0;0;0;0;0;0;0;0;0;0;0;0;0;0;0;0;0
FR;4;2021-02-28;0;0;0;0;0;0;0;0;0;0;0;0;0;0;0;0;0;0
FR;4;2021-03-01;0;0;0;0;0;0;0;0;0;0;0;0;0;0;0;0;0;0
FR;4;2021-03-02;0;0;0;0;0;0;0;0;0;0;0;0;0;0;0;0;0;0
FR;4;2021-03-03;0;0;0;0;0;0;0;0;0;0;0;0;0;0;0;0;0;0
FR;4;2021-03-04;0;0;0;0;0;0;0;0;0;0;0;0;0;0;0;0;0;0
FR;4;2021-03-05;0;0;0;0;0;0;0;0;0;0;0;0;0;0;0;0;0;0
FR;4;2021-03-06;0;0;0;0;0;0;0;0;0;0;0;0;0;0;0;0;0;0
FR;4;2021-03-07;0;0;0;0;0;0;0;0;0;0;0;0;0;0;0;0;0;0
FR;4;2021-03-08;0;0;0;0;0;0;0;0;0;0;0;0;0;0;0;0;0;0
FR;4;2021-03-09;0;0;0;0;0;0;0;0;0;0;0;0;0;0;0;0;0;0
FR;4;2021-03-10;0;0;0;0;0;0;0;0;0;0;0;0;0;0;0;0;0;0
FR;4;2021-03-11;0;0;0;0;0;0;0;0;0;0;0;0;0;0;0;0;0;0
FR;4;2021-03-12;0;0;0;0;0;0;0;0;0;0;0;0;0;0;0;0;0;0
FR;4;2021-03-13;0;0;0;0;0;0;0;0;0;0;0;0;0;0;0;0;0;0
FR;4;2021-03-14;0;0;0;0;0;0;0;0;0;0;0;0;0;0;0;0;0;0
FR;4;2021-03-15;0;0;0;0;0;0;0;0;0;0;0;0;0;0;0;0;0;0
FR;4;2021-03-16;0;0;0;0;0;0;0;0;0;0;0;0;0;0;0;0;0;0
FR;4;2021-03-17;0;0;0;0;0;0;0;0;0;0;0;0;0;0;0;0;0;0
FR;4;2021-03-18;0;0;0;0;0;0;0;0;0;0;0;0;0;0;0;0;0;0
FR;4;2021-03-19;0;0;0;0;0;0;0;0;0;0;0;0;0;0;0;0;0;0
FR;4;2021-03-20;0;0;0;0;0;0;0;0;0;0;0;0;0;0;0;0;0;0
FR;4;2021-03-21;0;0;0;0;0;0;0;0;0;0;0;0;0;0;0;0;0;0
FR;4;2021-03-22;0;0;0;0;0;0;0;0;0;0;0;0;0;0;0;0;0;0
FR;4;2021-03-23;0;0;0;0;0;0;0;0;0;0;0;0;0;0;0;0;0;0
FR;4;2021-03-24;0;0;0;0;0;0;0;0;0;0;0;0;0;0;0;0;0;0
FR;4;2021-03-25;0;0;0;0;0;0;0;0;0;0;0;0;0;0;0;0;0;0
FR;4;2021-03-26;0;0;0;0;0;0;0;0;0;0;0;0;0;0;0;0;0;0
FR;4;2021-03-27;0;0;0;0;0;0;0;0;0;0;0;0;0;0;0;0;0;0
FR;4;2021-03-28;0;0;0;0;0;0;0;0;0;0;0;0;0;0;0;0;0;0
FR;4;2021-03-29;0;0;0;0;0;0;0;0;0;0;0;0;0;0;0;0;0;0
FR;4;2021-03-30;0;0;0;0;0;0;0;0;0;0;0;0;0;0;0;0;0;0
FR;4;2021-03-31;0;0;0;0;0;0;0;0;0;0;0;0;0;0;0;0;0;0
FR;4;2021-04-01;0;0;0;0;0;0;0;0;0;0;0;0;0;0;0;0;0;0
FR;4;2021-04-02;0;0;0;0;0;0;0;0;0;0;0;0;0;0;0;0;0;0
FR;4;2021-04-03;0;0;0;0;0;0;0;0;0;0;0;0;0;0;0;0;0;0
FR;4;2021-04-04;0;0;0;0;0;0;0;0;0;0;0;0;0;0;0;0;0;0
FR;4;2021-04-05;0;0;0;0;0;0;0;0;0;0;0;0;0;0;0;0;0;0
FR;4;2021-04-06;0;0;0;0;0;0;0;0;0;0;0;0;0;0;0;0;0;0
FR;4;2021-04-07;0;0;0;0;0;0;0;0;0;0;0;0;0;0;0;0;0;0
FR;4;2021-04-08;0;0;0;0;0;0;0;0;0;0;0;0;0;0;0;0;0;0
FR;4;2021-04-09;0;0;0;0;0;0;0;0;0;0;0;0;0;0;0;0;0;0
FR;4;2021-04-10;0;0;0;0;0;0;0;0;0;0;0;0;0;0;0;0;0;0
FR;4;2021-04-11;0;0;0;0;0;0;0;0;0;0;0;0;0;0;0;0;0;0
FR;4;2021-04-12;0;0;0;0;0;0;0;0;0;0;0;0;0;0;0;0;0;0
FR;4;2021-04-13;0;0;0;0;0;0;0;0;0;0;0;0;0;0;0;0;0;0
FR;4;2021-04-14;0;0;0;0;0;0;0;0;0;0;0;0;0;0;0;0;0;0
FR;4;2021-04-15;0;0;0;0;0;0;0;0;0;0;0;0;0;0;0;0;0;0
FR;4;2021-04-16;0;0;0;0;0;0;0;0;0;0;0;0;0;0;0;0;0;0
FR;4;2021-04-17;0;0;0;0;0;0;0;0;0;0;0;0;0;0;0;0;0;0
FR;4;2021-04-18;0;0;0;0;0;0;0;0;0;0;0;0;0;0;0;0;0;0
FR;4;2021-04-19;0;0;0;0;0;0;0;0;0;0;0;0;0;0;0;0;0;0
FR;4;2021-04-20;0;0;0;0;0;0;0;0;0;0;0;0;0;0;0;0;0;0
FR;4;2021-04-21;0;0;0;0;0;0;0;0;0;0;0;0;0;0;0;0;0;0
FR;4;2021-04-22;0;0;0;0;0;0;0;0;0;0;0;0;0;0;0;0;0;0
FR;4;2021-04-23;3660;0;0;0;3622;0;0;0;0;3660;0;0;0;3622;0;0;0;0
FR;4;2021-04-24;1570;1;0;0;1559;0;0;0;0;5230;1;0;0;5181;0;0;0;0
FR;4;2021-04-25;125;0;0;0;125;0;0;0;0;5355;1;0;0;5306;0;0;0;0
FR;4;2021-04-26;2872;1;0;0;2861;0;0;0;0;8227;2;0;0;8167;0;0;0;0
FR;4;2021-04-27;9520;3;0;0;9501;0;0;0;0;17747;5;0;0;17668;0;0;0;0
FR;4;2021-04-28;9910;6;0;0;9885;0;0;0;0;27657;11;0;0;27553;0;0;0;0
FR;4;2021-04-29;15995;8;0;0;15979;0;0;0;0;43652;19;0;0;43532;0;0;0;0
FR;4;2021-04-30;19234;10;0;0;19205;0;0;0;0;62886;29;0;0;62737;0;0;0;0
FR;4;2021-05-01;1994;6;0;0;1992;0;0;0;0;64880;35;0;0;64729;0;0;0;0
FR;4;2021-05-02;484;0;0;0;482;0;0;0;0;65364;35;0;0;65211;0;0;0;0
FR;4;2021-05-03;5066;2;0;0;5059;0;0;0;0;70430;37;0;0;70270;0;0;0;0
FR;4;2021-05-04;8411;11;0;0;8400;0;0;0;0;78841;48;0;0;78670;0;0;0;0
FR;4;2021-05-05;6193;7;0;0;6188;0;0;0;0;85034;55;0;0;84858;0;0;0;0
FR;4;2021-05-06;11388;11;0;0;11385;0;0;0;0;96422;66;0;0;96243;0;0;0;0
FR;4;2021-05-07;19127;9;0;0;19088;0;0;0;0;115549;75;0;0;115331;0;0;0;0
FR;4;2021-05-08;2376;7;0;0;2380;0;0;0;0;117925;82;0;0;117711;0;0;0;0
FR;4;2021-05-09;692;3;0;0;693;0;0;0;0;118617;85;0;0;118404;0;0;0;0
FR;4;2021-05-10;7246;5;1;0;7243;0;0;0;0;125863;90;1;0;125647;0;0;0;0
FR;4;2021-05-11;14325;13;0;0;14305;0;0;0;0;140188;103;1;0;139952;0;0;0;0
FR;4;2021-05-12;10176;15;0;0;10179;0;0;0;0;150364;118;1;0;150131;0;0;0;0
FR;4;2021-05-13;1584;4;0;0;1585;0;0;0;0;151948;122;1;0;151716;0;0;0;0
FR;4;2021-05-14;7768;7;0;0;7763;0;0;0;0;159716;129;1;0;159479;0;0;0;0
FR;4;2021-05-15;3721;8;1;0;3720;0;0;0;0;163437;137;2;0;163199;0;0;0;0
FR;4;2021-05-16;417;1;0;0;417;0;0;0;0;163854;138;2;0;163616;0;0;0;0
FR;4;2021-05-17;4485;8;0;0;4484;0;0;0;0;168339;146;2;0;168100;0;0;0;0
FR;4;2021-05-18;8769;10;0;0;8769;0;0;0;0;177108;156;2;0;176869;0;0;0;0
FR;4;2021-05-19;5699;7;0;0;5701;0;0;0;0;182807;163;2;0;182570;0;0;0;0
FR;4;2021-05-20;9487;8;0;0;9479;0;0;0;0;192294;171;2;0;192049;0;0;0;0
FR;4;2021-05-21;12816;30;0;0;12823;0;0;0;0;205110;201;2;0;204872;0;0;0;0
FR;4;2021-05-22;5061;15;0;0;5068;0;0;0;0;210171;216;2;0;209940;0;0;0;0
FR;4;2021-05-23;498;4;0;0;501;0;0;0;0;210669;220;2;0;210441;0;0;0;0
FR;4;2021-05-24;1062;7;0;0;1066;0;0;0;0;211731;227;2;0;211507;0;0;0;0
FR;4;2021-05-25;7637;16;0;0;7643;0;0;0;0;219368;243;2;0;219150;0;0;0;0
FR;4;2021-05-26;7731;16;0;0;7739;0;0;0;0;227099;259;2;0;226889;0;0;0;0
FR;4;2021-05-27;14340;35;0;0;14349;0;0;0;0;241439;294;2;0;241238;0;0;0;0
FR;4;2021-05-28;26593;82;1;0;26634;0;0;0;0;268032;376;3;0;267872;0;0;0;0
FR;4;2021-05-29;11385;19;0;0;11385;0;0;0;0;279417;395;3;0;279257;0;0;0;0
FR;4;2021-05-30;974;7;0;0;973;0;0;0;0;280391;402;3;0;280230;0;0;0;0
FR;4;2021-05-31;12700;21;0;0;12700;0;0;0;0;293091;423;3;0;292930;0;0;0;0
FR;4;2021-06-01;20283;48;1;0;20301;0;0;0;0;313374;471;4;0;313231;0;0;0;0
FR;4;2021-06-02;14526;33;0;0;14538;0;0;0;0;327900;504;4;0;327769;0;0;0;0
FR;4;2021-06-03;19436;24;1;0;19434;0;0;0;0;347336;528;5;0;347203;0;0;0;0
FR;4;2021-06-04;22520;48;0;0;22538;0;0;0;0;369856;576;5;0;369741;0;0;0;0
FR;4;2021-06-05;9717;32;0;0;9721;0;0;0;0;379573;608;5;0;379462;0;0;0;0
FR;4;2021-06-06;1041;2;0;0;1037;0;0;0;0;380614;610;5;0;380499;0;0;0;0
FR;4;2021-06-07;9230;19;0;0;9238;0;0;0;0;389844;629;5;0;389737;0;0;0;0
FR;4;2021-06-08;14614;32;0;0;14626;0;0;0;0;404458;661;5;0;404363;0;0;0;0
FR;4;2021-06-09;12218;25;0;0;12226;0;0;0;0;416676;686;5;0;416589;0;0;0;0
FR;4;2021-06-10;15408;30;0;0;15416;0;0;0;0;432084;716;5;0;432005;0;0;0;0
FR;4;2021-06-11;16989;57;0;0;17016;0;0;0;0;449073;773;5;0;449021;0;0;0;0
FR;4;2021-06-12;7453;27;0;0;7478;0;0;0;0;456526;800;5;0;456499;0;0;0;0
FR;4;2021-06-13;908;3;0;0;910;0;0;0;0;457434;803;5;0;457409;0;0;0;0
FR;4;2021-06-14;6652;27;0;0;6662;0;0;0;0;464086;830;5;0;464071;0;0;0;0
FR;4;2021-06-15;10896;39;0;0;10913;0;0;0;0;474982;869;5;0;474984;0;0;0;0
FR;4;2021-06-16;8909;17;0;0;8917;0;0;0;0;483891;886;5;0;483901;0;0;0;0
FR;4;2021-06-17;10903;36;0;0;10915;0;0;0;0;494794;922;5;0;494816;0;0;0;0
FR;4;2021-06-18;12427;45;0;0;12454;0;0;0;0;507221;967;5;0;507270;0;0;0;0
FR;4;2021-06-19;5568;25;0;0;5588;0;0;0;0;512789;992;5;0;512858;0;0;0;0
FR;4;2021-06-20;828;5;0;0;832;0;0;0;0;513617;997;5;0;513690;0;0;0;0
FR;4;2021-06-21;5106;21;0;0;5106;0;0;0;0;518723;1018;5;0;518796;0;0;0;0
FR;4;2021-06-22;7914;29;2;0;7932;0;0;0;0;526637;1047;7;0;526728;0;0;0;0
FR;4;2021-06-23;7106;43;2;0;7133;0;0;0;0;533743;1090;9;0;533861;0;0;0;0
FR;4;2021-06-24;8657;46;1;0;8689;0;0;0;0;542400;1136;10;0;542550;0;0;0;0
FR;4;2021-06-25;10179;41;2;0;10211;0;0;0;0;552579;1177;12;0;552761;0;0;0;0
FR;4;2021-06-26;4854;21;0;0;4871;0;0;0;0;557433;1198;12;0;557632;0;0;0;0
FR;4;2021-06-27;769;4;0;0;771;0;0;0;0;558202;1202;12;0;558403;0;0;0;0
FR;4;2021-06-28;4835;16;1;0;4843;0;0;0;0;563037;1218;13;0;563246;0;0;0;0
FR;4;2021-06-29;7110;28;2;0;7119;0;0;0;0;570147;1246;15;0;570365;0;0;0;0
FR;4;2021-06-30;6728;40;2;0;6756;0;0;0;0;576875;1286;17;0;577121;0;0;0;0
FR;4;2021-07-01;8212;42;0;0;8234;0;0;0;0;585087;1328;17;0;585355;0;0;0;0
FR;4;2021-07-02;9430;53;1;0;9470;0;0;0;0;594517;1381;18;0;594825;0;0;0;0
FR;4;2021-07-03;4847;20;0;0;4862;0;0;0;0;599364;1401;18;0;599687;0;0;0;0
FR;4;2021-07-04;690;5;0;0;692;0;0;0;0;600054;1406;18;0;600379;0;0;0;0
FR;4;2021-07-05;4774;19;2;0;4785;0;0;0;0;604828;1425;20;0;605164;0;0;0;0
FR;4;2021-07-06;7729;29;4;0;7742;0;0;0;0;612557;1454;24;0;612906;0;0;0;0
FR;4;2021-07-07;7088;34;2;0;7100;0;0;0;0;619645;1488;26;0;620006;0;0;0;0
FR;4;2021-07-08;9235;40;2;0;9258;0;0;0;0;628880;1528;28;0;629264;0;0;0;0
FR;4;2021-07-09;10282;34;1;0;10305;0;0;0;0;639162;1562;29;0;639569;0;0;0;0
FR;4;2021-07-10;4639;14;2;0;4646;0;0;0;0;643801;1576;31;0;644215;0;0;0;0
FR;4;2021-07-11;586;4;1;0;584;0;0;0;0;644387;1580;32;0;644799;0;0;0;0
FR;4;2021-07-12;5878;29;0;0;5900;0;0;0;0;650265;1609;32;0;650699;0;0;0;0
FR;4;2021-07-13;14231;29;0;0;14249;0;0;0;0;664496;1638;32;0;664948;0;0;0;0
FR;4;2021-07-14;2291;15;0;0;2291;0;0;0;0;666787;1653;32;0;667239;0;0;0;0
FR;4;2021-07-15;18239;37;0;0;18256;0;0;0;0;685026;1690;32;0;685495;0;0;0;0
FR;4;2021-07-16;22838;71;2;0;22888;0;0;0;0;707864;1761;34;0;708383;0;0;0;0
FR;4;2021-07-17;9741;20;0;0;9749;0;0;0;0;717605;1781;34;0;718132;0;0;0;0
FR;4;2021-07-18;1359;5;0;0;1362;0;0;0;0;718964;1786;34;0;719494;0;0;0;0
FR;4;2021-07-19;12991;30;1;0;13016;0;0;0;0;731955;1816;35;0;732510;0;0;0;0
FR;4;2021-07-20;17343;26;1;0;17359;0;0;0;0;749298;1842;36;0;749869;0;0;0;0
FR;4;2021-07-21;15623;33;0;0;15643;0;0;0;0;764921;1875;36;0;765512;0;0;0;0
FR;4;2021-07-22;18247;45;2;0;18271;0;0;0;0;783168;1920;38;0;783783;0;0;0;0
FR;4;2021-07-23;20420;57;7;0;20453;0;0;0;0;803588;1977;45;0;804236;0;0;0;0
FR;4;2021-07-24;9290;34;0;0;9305;0;0;0;0;812878;2011;45;0;813541;0;0;0;0
FR;4;2021-07-25;1356;11;0;0;1358;0;0;0;0;814234;2022;45;0;814899;0;0;0;0
FR;4;2021-07-26;11050;23;0;0;11057;0;0;0;0;825284;2045;45;0;825956;0;0;0;0
FR;4;2021-07-27;14688;35;3;0;14708;0;0;0;0;839972;2080;48;0;840664;0;0;0;0
FR;4;2021-07-28;12937;26;2;0;12954;0;0;0;0;852909;2106;50;0;853618;0;0;0;0
FR;4;2021-07-29;14097;54;4;0;14139;0;0;0;0;867006;2160;54;0;867757;0;0;0;0
FR;4;2021-07-30;15502;46;2;0;15533;0;0;0;0;882508;2206;56;0;883290;0;0;0;0
FR;4;2021-07-31;6845;14;2;0;6855;0;0;0;0;889353;2220;58;0;890145;0;0;0;0
FR;4;2021-08-01;906;1;0;0;901;0;0;0;0;890259;2221;58;0;891046;0;0;0;0
FR;4;2021-08-02;7918;31;0;0;7919;0;0;0;0;898177;2252;58;0;898965;0;0;0;0
FR;4;2021-08-03;10805;31;2;0;10801;0;0;0;0;908982;2283;60;0;909766;0;0;0;0
FR;4;2021-08-04;9749;29;0;0;9748;0;0;0;0;918731;2312;60;0;919514;0;0;0;0
FR;4;2021-08-05;9831;42;0;0;9837;0;0;0;0;928562;2354;60;0;929351;0;0;0;0
FR;4;2021-08-06;10201;30;3;0;10198;0;0;0;0;938763;2384;63;0;939549;0;0;0;0
FR;4;2021-08-07;5100;30;1;0;5116;0;0;0;0;943863;2414;64;0;944665;0;0;0;0
FR;4;2021-08-08;1225;13;0;0;1228;0;0;0;0;945088;2427;64;0;945893;0;0;0;0
FR;4;2021-08-09;6350;31;0;0;6343;0;0;0;0;951438;2458;64;0;952236;0;0;0;0
FR;4;2021-08-10;8753;18;0;0;8724;0;0;0;0;960191;2476;64;0;960960;0;0;0;0
FR;4;2021-08-11;7945;34;4;0;7934;0;0;0;0;968136;2510;68;0;968894;0;0;0;0
FR;4;2021-08-12;8585;31;1;0;8573;0;0;0;0;976721;2541;69;0;977467;0;0;0;0
FR;4;2021-08-13;7561;25;0;1;7548;0;0;0;0;984282;2566;69;1;985015;0;0;0;0
FR;4;2021-08-14;3793;20;0;0;3777;0;0;0;0;988075;2586;69;1;988792;0;0;0;0
FR;4;2021-08-15;771;5;0;0;773;0;0;0;0;988846;2591;69;1;989565;0;0;0;0
FR;4;2021-08-16;4009;17;0;0;4004;0;0;0;0;992855;2608;69;1;993569;0;0;0;0
FR;4;2021-08-17;5634;17;1;0;5624;0;0;0;0;998489;2625;70;1;999193;0;0;0;0
FR;4;2021-08-18;5172;37;0;0;5189;0;0;0;0;1003661;2662;70;1;1004382;0;0;0;0
FR;4;2021-08-19;5488;34;3;0;5502;0;0;0;0;1009149;2696;73;1;1009884;0;0;0;0
FR;4;2021-08-20;5225;25;1;0;5235;0;0;0;0;1014374;2721;74;1;1015119;0;0;0;0
FR;4;2021-08-21;2311;23;1;0;2328;0;0;0;0;1016685;2744;75;1;1017447;0;0;0;0
FR;4;2021-08-22;414;2;0;0;415;0;0;0;0;1017099;2746;75;1;1017862;0;0;0;0
FR;4;2021-08-23;2936;21;1;0;2944;0;0;0;0;1020035;2767;76;1;1020806;0;0;0;0
FR;4;2021-08-24;3758;16;0;0;3761;0;0;0;0;1023793;2783;76;1;1024567;0;0;0;0
FR;4;2021-08-25;3545;25;1;0;3561;0;0;0;0;1027338;2808;77;1;1028128;0;0;0;0
FR;4;2021-08-26;3716;21;2;0;3728;0;0;0;0;1031054;2829;79;1;1031856;0;0;0;0
FR;4;2021-08-27;3617;31;2;0;3635;0;0;0;0;1034671;2860;81;1;1035491;0;0;0;0
FR;4;2021-08-28;1732;10;1;0;1737;0;0;0;0;1036403;2870;82;1;1037228;0;0;0;0
FR;4;2021-08-29;385;7;1;0;389;0;0;0;0;1036788;2877;83;1;1037617;0;0;0;0
FR;4;2021-08-30;2010;25;0;0;2018;16;0;0;0;1038798;2902;83;1;1039635;16;0;0;0
FR;4;2021-08-31;2487;21;0;0;2494;14;0;0;0;1041285;2923;83;1;1042129;30;0;0;0
FR;4;2021-09-01;2085;38;1;0;2096;22;0;0;0;1043370;2961;84;1;1044225;52;0;0;0
FR;4;2021-09-02;2309;31;4;0;2322;18;0;0;0;1045679;2992;88;1;1046547;70;0;0;0
FR;4;2021-09-03;2366;44;5;0;2375;36;0;0;0;1048045;3036;93;1;1048922;106;0;0;0
FR;4;2021-09-04;1374;18;0;0;1381;9;0;0;0;1049419;3054;93;1;1050303;115;0;0;0
FR;4;2021-09-05;434;2;0;0;434;2;0;0;0;1049853;3056;93;1;1050737;117;0;0;0
FR;4;2021-09-06;1713;62;0;0;1750;24;0;0;0;1051566;3118;93;1;1052487;141;0;0;0
FR;4;2021-09-07;1681;18;0;0;1690;8;0;0;0;1053247;3136;93;1;1054177;149;0;0;0
FR;4;2021-09-08;1286;26;3;0;1291;19;0;0;0;1054533;3162;96;1;1055468;168;0;0;0
FR;4;2021-09-09;1394;23;2;0;1404;9;0;0;0;1055927;3185;98;1;1056872;177;0;0;0
FR;4;2021-09-10;1521;31;2;0;1525;23;1;0;0;1057448;3216;100;1;1058397;200;1;0;0
FR;4;2021-09-11;746;11;0;0;749;3;0;0;0;1058194;3227;100;1;1059146;203;1;0;0
FR;4;2021-09-12;169;5;0;0;170;4;0;0;0;1058363;3232;100;1;1059316;207;1;0;0
FR;4;2021-09-13;1325;22;1;0;1328;16;0;0;0;1059688;3254;101;1;1060644;223;1;0;0
FR;4;2021-09-14;1507;9;2;0;1509;7;0;0;0;1061195;3263;103;1;1062153;230;1;0;0
FR;4;2021-09-15;1095;28;1;0;1098;25;0;0;0;1062290;3291;104;1;1063251;255;1;0;0
FR;4;2021-09-16;1106;22;2;0;1110;15;0;0;0;1063396;3313;106;1;1064361;270;1;0;0
FR;4;2021-09-17;898;21;1;0;905;12;0;0;0;1064294;3334;107;1;1065266;282;1;0;0
FR;4;2021-09-18;464;7;1;0;465;6;0;0;0;1064758;3341;108;1;1065731;288;1;0;0
FR;4;2021-09-19;182;3;0;0;183;2;0;0;0;1064940;3344;108;1;1065914;290;1;0;0
FR;4;2021-09-20;452;19;0;0;458;13;0;0;0;1065392;3363;108;1;1066372;303;1;0;0
FR;4;2021-09-21;434;11;0;0;436;7;0;0;0;1065826;3374;108;1;1066808;310;1;0;0
FR;4;2021-09-22;377;19;4;0;384;15;0;0;0;1066203;3393;112;1;1067192;325;1;0;0
FR;4;2021-09-23;488;15;1;0;489;14;0;0;0;1066691;3408;113;1;1067681;339;1;0;0
FR;4;2021-09-24;415;13;2;0;419;9;0;0;0;1067106;3421;115;1;1068100;348;1;0;0
FR;4;2021-09-25;281;10;1;0;282;5;0;0;0;1067387;3431;116;1;1068382;353;1;0;0
FR;4;2021-09-26;75;2;0;0;76;1;0;0;0;1067462;3433;116;1;1068458;354;1;0;0
FR;4;2021-09-27;270;10;1;0;271;8;0;0;0;1067732;3443;117;1;1068729;362;1;0;0
FR;4;2021-09-28;319;8;0;0;319;8;0;0;0;1068051;3451;117;1;1069048;370;1;0;0
FR;4;2021-09-29;378;19;1;0;380;13;0;0;0;1068429;3470;118;1;1069428;383;1;0;0
FR;4;2021-09-30;367;41;0;0;381;22;0;0;0;1068796;3511;118;1;1069809;405;1;0;0
FR;4;2021-10-01;411;56;0;0;413;50;0;0;0;1069207;3567;118;1;1070222;455;1;0;0
FR;4;2021-10-02;196;23;1;0;198;14;0;0;0;1069403;3590;119;1;1070420;469;1;0;0
FR;4;2021-10-03;86;1;0;0;87;0;0;0;0;1069489;3591;119;1;1070507;469;1;0;0
FR;4;2021-10-04;363;20;1;0;367;16;0;0;0;1069852;3611;120;1;1070874;485;1;0;0
FR;4;2021-10-05;286;19;2;0;288;15;0;0;0;1070138;3630;122;1;1071162;500;1;0;0
FR;4;2021-10-06;249;23;1;0;254;18;0;0;0;1070387;3653;123;1;1071416;518;1;0;0
FR;4;2021-10-07;268;25;2;0;273;13;0;0;0;1070655;3678;125;1;1071689;531;1;0;0
FR;4;2021-10-08;357;24;2;0;360;20;0;0;0;1071012;3702;127;1;1072049;551;1;0;0
FR;4;2021-10-09;194;6;6;0;195;7;0;0;0;1071206;3708;133;1;1072244;558;1;0;0
FR;4;2021-10-10;97;3;2;0;99;3;0;0;0;1071303;3711;135;1;1072343;561;1;0;0
FR;4;2021-10-11;252;15;1;0;253;14;0;0;0;1071555;3726;136;1;1072596;575;1;0;0
FR;4;2021-10-12;211;14;0;0;211;13;0;0;0;1071766;3740;136;1;1072807;588;1;0;0
FR;4;2021-10-13;221;28;1;0;224;25;0;0;0;1071987;3768;137;1;1073031;613;1;0;0
FR;4;2021-10-14;316;21;4;0;320;15;0;0;0;1072303;3789;141;1;1073351;628;1;0;0
FR;4;2021-10-15;324;24;5;0;325;25;0;0;0;1072627;3813;146;1;1073676;653;1;0;0
FR;4;2021-10-16;167;6;2;0;167;6;0;0;0;1072794;3819;148;1;1073843;659;1;0;0
FR;4;2021-10-17;70;2;0;0;71;1;0;0;0;1072864;3821;148;1;1073914;660;1;0;0
FR;4;2021-10-18;281;16;1;0;283;13;0;0;0;1073145;3837;149;1;1074197;673;1;0;0
FR;4;2021-10-19;216;14;2;0;216;15;0;0;0;1073361;3851;151;1;1074413;688;1;0;0
FR;4;2021-10-20;232;27;4;0;235;15;0;0;0;1073593;3878;155;1;1074648;703;1;0;0
FR;4;2021-10-21;244;18;0;0;246;14;0;0;0;1073837;3896;155;1;1074894;717;1;0;0
FR;4;2021-10-22;217;25;2;0;219;20;1;0;0;1074054;3921;157;1;1075113;737;2;0;0
FR;4;2021-10-23;117;16;1;0;118;15;0;0;0;1074171;3937;158;1;1075231;752;2;0;0
FR;4;2021-10-24;39;4;0;0;39;1;0;0;0;1074210;3941;158;1;1075270;753;2;0;0
FR;4;2021-10-25;218;7;2;0;218;9;0;0;0;1074428;3948;160;1;1075488;762;2;0;0
FR;4;2021-10-26;200;14;0;0;202;12;0;0;0;1074628;3962;160;1;1075690;774;2;0;0
FR;4;2021-10-27;196;12;4;0;196;12;2;0;0;1074824;3974;164;1;1075886;786;4;0;0
FR;4;2021-10-28;186;18;5;0;186;22;0;0;0;1075010;3992;169;1;1076072;808;4;0;0
FR;4;2021-10-29;227;18;2;0;228;16;0;0;0;1075237;4010;171;1;1076300;824;4;0;0
FR;4;2021-10-30;104;2;1;0;105;2;0;0;0;1075341;4012;172;1;1076405;826;4;0;0
FR;4;2021-10-31;59;3;2;0;60;3;0;0;0;1075400;4015;174;1;1076465;829;4;0;0
FR;4;2021-11-01;76;27;4;0;77;24;3;0;0;1075476;4042;178;1;1076542;853;7;0;0
FR;4;2021-11-02;164;21;2;0;165;21;0;0;0;1075640;4063;180;1;1076707;874;7;0;0
FR;4;2021-11-03;132;21;8;1;133;19;6;0;0;1075772;4084;188;2;1076840;893;13;0;0
FR;4;2021-11-04;187;15;1;0;188;12;1;0;0;1075959;4099;189;2;1077028;905;14;0;0
FR;4;2021-11-05;130;17;1;0;131;16;0;0;0;1076089;4116;190;2;1077159;921;14;0;0
FR;4;2021-11-06;82;6;1;0;82;6;0;0;0;1076171;4122;191;2;1077241;927;14;0;0
FR;4;2021-11-07;83;2;2;0;83;4;0;0;0;1076254;4124;193;2;1077324;931;14;0;0
FR;4;2021-11-08;162;20;1;0;163;20;0;0;0;1076416;4144;194;2;1077487;951;14;0;0
FR;4;2021-11-09;159;14;3;0;159;16;0;0;0;1076575;4158;197;2;1077646;967;14;0;0
FR;4;2021-11-10;121;30;7;0;121;33;2;0;0;1076696;4188;204;2;1077767;1000;16;0;0
FR;4;2021-11-11;100;10;1;0;100;11;0;0;0;1076796;4198;205;2;1077867;1011;16;0;0
FR;4;2021-11-12;107;19;2;0;108;18;1;0;0;1076903;4217;207;2;1077975;1029;17;0;0
FR;4;2021-11-13;74;15;2;0;75;14;0;0;0;1076977;4232;209;2;1078050;1043;17;0;0
FR;4;2021-11-14;55;5;4;0;56;8;0;0;0;1077032;4237;213;2;1078106;1051;17;0;0
FR;4;2021-11-15;99;26;2;0;101;24;2;0;0;1077131;4263;215;2;1078207;1075;19;0;0
FR;4;2021-11-16;112;14;3;0;112;17;0;0;0;1077243;4277;218;2;1078319;1092;19;0;0
FR;4;2021-11-17;122;30;4;0;122;30;1;0;0;1077365;4307;222;2;1078441;1122;20;0;0
FR;4;2021-11-18;103;34;14;0;105;43;1;0;0;1077468;4341;236;2;1078546;1165;21;0;0
FR;4;2021-11-19;89;21;3;0;89;22;1;0;0;1077557;4362;239;2;1078635;1187;22;0;0
FR;4;2021-11-20;78;8;1;0;78;8;0;0;0;1077635;4370;240;2;1078713;1195;22;0;0
FR;4;2021-11-21;69;7;2;0;69;9;0;0;0;1077704;4377;242;2;1078782;1204;22;0;0
FR;4;2021-11-22;109;28;9;0;110;33;2;0;0;1077813;4405;251;2;1078892;1237;24;0;0
FR;4;2021-11-23;78;31;6;0;79;29;2;0;0;1077891;4436;257;2;1078971;1266;26;0;0
FR;4;2021-11-24;91;23;12;0;93;25;4;0;0;1077982;4459;269;2;1079064;1291;30;0;0
FR;4;2021-11-25;96;28;19;0;97;35;5;0;0;1078078;4487;288;2;1079161;1326;35;0;0
FR;4;2021-11-26;86;43;12;0;90;45;3;0;0;1078164;4530;300;2;1079251;1371;38;0;0
FR;4;2021-11-27;42;22;15;0;42;25;10;0;0;1078206;4552;315;2;1079293;1396;48;0;0
FR;4;2021-11-28;53;8;0;0;54;7;0;0;0;1078259;4560;315;2;1079347;1403;48;0;0
FR;4;2021-11-29;90;31;16;0;90;40;2;0;0;1078349;4591;331;2;1079437;1443;50;0;0
FR;4;2021-11-30;77;37;13;0;77;42;2;0;0;1078426;4628;344;2;1079514;1485;52;0;0
FR;4;2021-12-01;88;60;19;0;88;67;11;0;0;1078514;4688;363;2;1079602;1552;63;0;0
FR;4;2021-12-02;114;48;21;0;118;56;3;0;0;1078628;4736;384;2;1079720;1608;66;0;0
FR;4;2021-12-03;105;36;15;0;105;44;4;0;0;1078733;4772;399;2;1079825;1652;70;0;0
FR;4;2021-12-04;73;31;18;0;75;44;1;0;0;1078806;4803;417;2;1079900;1696;71;0;0
FR;4;2021-12-05;64;7;1;0;65;7;0;0;0;1078870;4810;418;2;1079965;1703;71;0;0
FR;4;2021-12-06;112;46;20;0;112;60;3;0;0;1078982;4856;438;2;1080077;1763;74;0;0
FR;4;2021-12-07;85;37;9;0;88;36;3;0;0;1079067;4893;447;2;1080165;1799;77;0;0
FR;4;2021-12-08;73;31;17;0;75;38;7;0;0;1079140;4924;464;2;1080240;1837;84;0;0
FR;4;2021-12-09;65;32;10;1;65;39;3;0;0;1079205;4956;474;3;1080305;1876;87;0;0
FR;4;2021-12-10;64;64;20;0;65;68;10;0;0;1079269;5020;494;3;1080370;1944;97;0;0
FR;4;2021-12-11;30;34;7;0;30;34;3;0;0;1079299;5054;501;3;1080400;1978;100;0;0
FR;4;2021-12-12;30;12;3;0;30;15;0;0;0;1079329;5066;504;3;1080430;1993;100;0;0
FR;4;2021-12-13;78;40;14;0;80;49;2;0;0;1079407;5106;518;3;1080510;2042;102;0;0
FR;4;2021-12-14;61;43;18;0;62;55;2;0;0;1079468;5149;536;3;1080572;2097;104;0;0
FR;4;2021-12-15;68;65;29;0;68;86;6;0;0;1079536;5214;565;3;1080640;2183;110;0;0
FR;4;2021-12-16;35;45;18;0;36;58;3;0;0;1079571;5259;583;3;1080676;2241;113;0;0
FR;4;2021-12-17;39;55;11;0;39;59;6;0;0;1079610;5314;594;3;1080715;2300;119;0;0
FR;4;2021-12-18;49;31;3;0;50;33;0;0;0;1079659;5345;597;3;1080765;2333;119;0;0
FR;4;2021-12-19;16;4;1;0;17;4;0;0;0;1079675;5349;598;3;1080782;2337;119;0;0
FR;4;2021-12-20;45;38;10;0;46;41;6;0;0;1079720;5387;608;3;1080828;2378;125;0;0
FR;4;2021-12-21;31;32;17;0;33;39;5;0;0;1079751;5419;625;3;1080861;2417;130;0;0
FR;4;2021-12-22;37;39;10;0;38;39;7;0;0;1079788;5458;635;3;1080899;2456;137;0;0
FR;4;2021-12-23;40;45;8;0;40;49;2;0;0;1079828;5503;643;3;1080939;2505;139;0;0
FR;4;2021-12-24;24;28;10;0;26;31;4;0;0;1079852;5531;653;3;1080965;2536;143;0;0
FR;4;2021-12-25;7;3;3;0;7;4;2;0;0;1079859;5534;656;3;1080972;2540;145;0;0
FR;4;2021-12-26;5;3;1;0;6;2;0;0;0;1079864;5537;657;3;1080978;2542;145;0;0
FR;4;2021-12-27;31;41;9;0;32;43;4;0;0;1079895;5578;666;3;1081010;2585;149;0;0
FR;4;2021-12-28;27;28;7;0;29;29;4;0;0;1079922;5606;673;3;1081039;2614;153;0;0
FR;4;2021-12-29;56;25;11;0;57;30;5;0;0;1079978;5631;684;3;1081096;2644;158;0;0
FR;4;2021-12-30;48;19;12;0;51;22;5;0;0;1080026;5650;696;3;1081147;2666;163;0;0
FR;4;2021-12-31;20;6;8;0;21;11;2;0;0;1080046;5656;704;3;1081168;2677;165;0;0
FR;4;2022-01-01;6;4;5;0;6;7;1;0;0;1080052;5660;709;3;1081174;2684;166;0;0
FR;4;2022-01-02;43;5;16;0;43;20;1;0;0;1080095;5665;725;3;1081217;2704;167;0;0
FR;4;2022-01-03;45;55;25;1;47;65;10;0;0;1080140;5720;750;4;1081264;2769;177;0;0
FR;4;2022-01-04;40;28;16;0;41;33;8;0;0;1080180;5748;766;4;1081305;2802;185;0;0
FR;4;2022-01-05;52;24;19;0;58;27;9;0;0;1080232;5772;785;4;1081363;2829;194;0;0
FR;4;2022-01-06;52;24;24;0;52;40;8;0;0;1080284;5796;809;4;1081415;2869;202;0;0
FR;4;2022-01-07;31;20;16;0;33;21;12;0;0;1080315;5816;825;4;1081448;2890;214;0;0
FR;4;2022-01-08;13;6;10;0;14;12;3;0;0;1080328;5822;835;4;1081462;2902;217;0;0
FR;4;2022-01-09;20;2;3;0;21;4;0;0;0;1080348;5824;838;4;1081483;2906;217;0;0
FR;4;2022-01-10;52;22;19;0;52;36;4;0;0;1080400;5846;857;4;1081535;2942;221;0;0
FR;4;2022-01-11;30;31;12;0;34;35;1;0;0;1080430;5877;869;4;1081569;2977;222;0;0
FR;4;2022-01-12;35;21;13;0;37;23;9;0;0;1080465;5898;882;4;1081606;3000;231;0;0
FR;4;2022-01-13;55;20;27;0;56;38;8;0;0;1080520;5918;909;4;1081662;3038;239;0;0
FR;4;2022-01-14;25;32;13;0;26;35;7;0;0;1080545;5950;922;4;1081688;3073;246;0;0
FR;4;2022-01-15;15;6;8;0;16;12;1;0;0;1080560;5956;930;4;1081704;3085;247;0;0
FR;4;2022-01-16;13;9;14;0;13;22;1;0;0;1080573;5965;944;4;1081717;3107;248;0;0
FR;4;2022-01-17;27;20;15;0;27;29;5;0;0;1080600;5985;959;4;1081744;3136;253;0;0
FR;4;2022-01-18;17;14;10;0;17;21;3;0;0;1080617;5999;969;4;1081761;3157;256;0;0
FR;4;2022-01-19;33;23;13;0;33;34;1;0;0;1080650;6022;982;4;1081794;3191;257;0;0
FR;4;2022-01-20;34;34;13;0;36;39;5;0;0;1080684;6056;995;4;1081830;3230;262;0;0
FR;4;2022-01-21;13;12;20;1;13;17;15;0;1;1080697;6068;1015;5;1081843;3247;277;0;1
FR;4;2022-01-22;30;13;3;0;30;14;2;0;0;1080727;6081;1018;5;1081873;3261;279;0;1
FR;4;2022-01-23;8;2;7;0;8;9;0;0;0;1080735;6083;1025;5;1081881;3270;279;0;1
FR;4;2022-01-24;14;21;9;0;15;28;1;0;0;1080749;6104;1034;5;1081896;3298;280;0;1
FR;4;2022-01-25;22;32;10;1;23;38;3;0;0;1080771;6136;1044;6;1081919;3336;283;0;1
FR;4;2022-01-26;20;17;9;1;21;21;4;0;0;1080791;6153;1053;7;1081940;3357;287;0;1
FR;4;2022-01-27;22;19;8;0;23;25;1;0;0;1080813;6172;1061;7;1081963;3382;288;0;1
FR;4;2022-01-28;14;23;8;0;15;26;4;0;0;1080827;6195;1069;7;1081978;3408;292;0;1
FR;4;2022-01-29;17;6;5;0;17;10;0;0;0;1080844;6201;1074;7;1081995;3418;292;0;1
FR;4;2022-01-30;19;3;2;0;19;5;0;0;0;1080863;6204;1076;7;1082014;3423;292;0;1
FR;4;2022-01-31;22;28;8;0;22;32;2;0;0;1080885;6232;1084;7;1082036;3455;294;0;1
FR;4;2022-02-01;13;24;13;0;15;25;9;0;0;1080898;6256;1097;7;1082051;3480;303;0;1
FR;4;2022-02-02;19;12;14;2;20;20;7;0;0;1080917;6268;1111;9;1082071;3500;310;0;1
FR;4;2022-02-03;16;24;11;0;18;29;4;0;0;1080933;6292;1122;9;1082089;3529;314;0;1
FR;4;2022-02-04;7;5;7;0;7;9;3;0;0;1080940;6297;1129;9;1082096;3538;317;0;1
FR;4;2022-02-05;7;14;1;0;8;13;1;0;0;1080947;6311;1130;9;1082104;3551;318;0;1
FR;4;2022-02-06;8;4;4;0;8;7;1;0;0;1080955;6315;1134;9;1082112;3558;319;0;1
FR;4;2022-02-07;15;20;8;0;17;20;6;0;0;1080970;6335;1142;9;1082129;3578;325;0;1
FR;4;2022-02-08;20;21;13;1;22;22;10;0;0;1080990;6356;1155;10;1082151;3600;335;0;1
FR;4;2022-02-09;18;12;9;0;19;17;2;0;0;1081008;6368;1164;10;1082170;3617;337;0;1
FR;4;2022-02-10;23;23;10;0;24;25;7;0;0;1081031;6391;1174;10;1082194;3642;344;0;1
FR;4;2022-02-11;18;15;8;0;18;20;3;0;0;1081049;6406;1182;10;1082212;3662;347;0;1
FR;4;2022-02-12;24;6;3;0;26;7;0;0;0;1081073;6412;1185;10;1082238;3669;347;0;1
FR;4;2022-02-13;7;3;3;0;7;6;0;0;0;1081080;6415;1188;10;1082245;3675;347;0;1
FR;4;2022-02-14;21;10;10;0;21;16;4;0;0;1081101;6425;1198;10;1082266;3691;351;0;1
FR;4;2022-02-15;18;7;2;0;18;8;0;0;0;1081119;6432;1200;10;1082284;3699;351;0;1
FR;4;2022-02-16;17;10;11;0;17;17;3;0;0;1081136;6442;1211;10;1082301;3716;354;0;1
FR;4;2022-02-17;11;4;5;0;11;7;2;0;0;1081147;6446;1216;10;1082312;3723;356;0;1
FR;4;2022-02-18;16;15;8;0;16;21;2;0;0;1081163;6461;1224;10;1082328;3744;358;0;1
FR;4;2022-02-19;16;4;2;0;17;5;0;0;0;1081179;6465;1226;10;1082345;3749;358;0;1
FR;4;2022-02-20;8;3;0;0;9;2;0;0;0;1081187;6468;1226;10;1082354;3751;358;0;1
FR;4;2022-02-21;24;5;4;0;24;7;2;0;0;1081211;6473;1230;10;1082378;3758;360;0;1
FR;4;2022-02-22;8;5;10;0;9;10;4;0;0;1081219;6478;1240;10;1082387;3768;364;0;1
FR;4;2022-02-23;17;6;10;0;17;10;5;0;0;1081236;6484;1250;10;1082404;3778;369;0;1
FR;4;2022-02-24;11;5;4;0;11;7;2;0;0;1081247;6489;1254;10;1082415;3785;371;0;1
FR;4;2022-02-25;17;5;7;0;17;6;6;0;0;1081264;6494;1261;10;1082432;3791;377;0;1
FR;4;2022-02-26;27;3;1;0;27;4;0;0;0;1081291;6497;1262;10;1082459;3795;377;0;1
FR;4;2022-02-27;9;0;1;0;9;1;0;0;0;1081300;6497;1263;10;1082468;3796;377;0;1
FR;4;2022-02-28;18;3;2;0;19;3;1;0;0;1081318;6500;1265;10;1082487;3799;378;0;1
FR;4;2022-03-01;8;4;7;0;8;5;5;0;0;1081326;6504;1272;10;1082495;3804;383;0;1
FR;4;2022-03-02;16;3;5;0;17;6;1;0;0;1081342;6507;1277;10;1082512;3810;384;0;1
FR;4;2022-03-03;19;5;3;0;19;6;1;0;0;1081361;6512;1280;10;1082531;3816;385;0;1
FR;4;2022-03-04;7;8;2;1;7;6;3;0;0;1081368;6520;1282;11;1082538;3822;388;0;1
FR;4;2022-03-05;9;2;0;0;9;2;0;0;0;1081377;6522;1282;11;1082547;3824;388;0;1
FR;4;2022-03-06;4;0;1;0;4;1;0;0;0;1081381;6522;1283;11;1082551;3825;388;0;1
FR;4;2022-03-07;11;6;2;0;11;5;2;0;0;1081392;6528;1285;11;1082562;3830;390;0;1
FR;4;2022-03-08;15;3;0;0;15;3;0;0;0;1081407;6531;1285;11;1082577;3833;390;0;1
FR;4;2022-03-09;9;7;2;0;11;7;0;0;0;1081416;6538;1287;11;1082588;3840;390;0;1
FR;4;2022-03-10;6;1;6;0;6;3;4;0;0;1081422;6539;1293;11;1082594;3843;394;0;1
FR;4;2022-03-11;10;4;5;0;12;2;5;0;0;1081432;6543;1298;11;1082606;3845;399;0;1
FR;4;2022-03-12;10;2;0;0;11;0;0;0;0;1081442;6545;1298;11;1082617;3845;399;0;1
FR;4;2022-03-13;6;2;1;0;7;2;0;0;0;1081448;6547;1299;11;1082624;3847;399;0;1
FR;4;2022-03-14;4;3;1;0;5;3;0;0;0;1081452;6550;1300;11;1082629;3850;399;0;1
FR;4;2022-03-15;8;8;3;0;10;7;2;0;0;1081460;6558;1303;11;1082639;3857;401;0;1
FR;4;2022-03-16;7;3;4;0;7;4;3;0;0;1081467;6561;1307;11;1082646;3861;404;0;1
FR;4;2022-03-17;3;4;1;0;3;5;0;0;0;1081470;6565;1308;11;1082649;3866;404;0;1
FR;4;2022-03-18;9;3;0;0;9;3;0;0;0;1081479;6568;1308;11;1082658;3869;404;0;1
FR;4;2022-03-19;1;1;1;0;1;2;0;0;0;1081480;6569;1309;11;1082659;3871;404;0;1
FR;4;2022-03-20;3;1;2;0;3;2;1;0;0;1081483;6570;1311;11;1082662;3873;405;0;1
FR;4;2022-03-21;6;4;1;0;6;5;0;0;0;1081489;6574;1312;11;1082668;3878;405;0;1
FR;4;2022-03-22;4;2;2;0;4;3;1;0;0;1081493;6576;1314;11;1082672;3881;406;0;1
FR;4;2022-03-23;6;4;5;0;6;8;1;0;0;1081499;6580;1319;11;1082678;3889;407;0;1
FR;4;2022-03-24;2;5;3;1;2;7;2;0;0;1081501;6585;1322;12;1082680;3896;409;0;1
FR;4;2022-03-25;4;1;2;0;4;1;2;0;0;1081505;6586;1324;12;1082684;3897;411;0;1
FR;4;2022-03-26;5;5;0;0;5;5;0;0;0;1081510;6591;1324;12;1082689;3902;411;0;1
FR;4;2022-03-27;1;0;3;0;1;2;1;0;0;1081511;6591;1327;12;1082690;3904;412;0;1
FR;4;2022-03-28;6;1;3;0;7;3;0;0;0;1081517;6592;1330;12;1082697;3907;412;0;1
FR;4;2022-03-29;9;0;4;1;9;0;2;0;0;1081526;6592;1334;13;1082706;3907;414;0;1
FR;4;2022-03-30;3;4;0;0;3;4;0;0;0;1081529;6596;1334;13;1082709;3911;414;0;1
FR;4;2022-03-31;5;3;2;1;5;4;1;0;0;1081534;6599;1336;14;1082714;3915;415;0;1
FR;4;2022-04-01;15;3;5;0;15;6;2;0;0;1081549;6602;1341;14;1082729;3921;417;0;1
FR;4;2022-04-02;4;4;0;0;5;3;0;0;0;1081553;6606;1341;14;1082734;3924;417;0;1
FR;4;2022-04-03;0;1;0;0;0;1;0;0;0;1081553;6607;1341;14;1082734;3925;417;0;1
FR;4;2022-04-04;4;4;4;0;5;5;2;0;0;1081557;6611;1345;14;1082739;3930;419;0;1
FR;4;2022-04-05;4;3;3;1;5;3;3;0;0;1081561;6614;1348;15;1082744;3933;422;0;1
FR;4;2022-04-06;6;1;0;0;6;1;0;0;0;1081567;6615;1348;15;1082750;3934;422;0;1
FR;4;2022-04-07;3;2;3;2;3;5;0;0;0;1081570;6617;1351;17;1082753;3939;422;0;1
FR;4;2022-04-08;4;2;1;0;4;2;1;0;0;1081574;6619;1352;17;1082757;3941;423;0;1
FR;4;2022-04-09;0;0;1;1;0;1;1;0;0;1081574;6619;1353;18;1082757;3942;424;0;1
FR;4;2022-04-10;2;2;0;0;2;2;0;0;0;1081576;6621;1353;18;1082759;3944;424;0;1
FR;4;2022-04-11;4;3;4;0;4;5;2;0;0;1081580;6624;1357;18;1082763;3949;426;0;1
FR;4;2022-04-12;5;1;4;0;5;2;3;0;0;1081585;6625;1361;18;1082768;3951;429;0;1
FR;4;2022-04-13;5;8;2;1;5;10;1;0;0;1081590;6633;1363;19;1082773;3961;430;0;1
FR;4;2022-04-14;6;4;2;1;7;5;1;0;0;1081596;6637;1365;20;1082780;3966;431;0;1
FR;4;2022-04-15;7;9;1;0;7;10;0;0;0;1081603;6646;1366;20;1082787;3976;431;0;1
FR;4;2022-04-16;1;0;0;0;1;0;0;0;0;1081604;6646;1366;20;1082788;3976;431;0;1
FR;4;2022-04-17;3;2;1;0;3;3;0;0;0;1081607;6648;1367;20;1082791;3979;431;0;1
FR;4;2022-04-18;2;2;6;0;2;4;4;0;0;1081609;6650;1373;20;1082793;3983;435;0;1
FR;4;2022-04-19;3;0;1;0;3;0;1;0;0;1081612;6650;1374;20;1082796;3983;436;0;1
FR;4;2022-04-20;15;4;1;1;16;3;1;0;0;1081627;6654;1375;21;1082812;3986;437;0;1
FR;4;2022-04-21;7;1;0;0;7;1;0;0;0;1081634;6655;1375;21;1082819;3987;437;0;1
FR;4;2022-04-22;1;1;2;0;1;2;1;0;0;1081635;6656;1377;21;1082820;3989;438;0;1
FR;4;2022-04-23;2;3;3;0;2;6;0;0;0;1081637;6659;1380;21;1082822;3995;438;0;1
FR;4;2022-04-24;0;3;0;0;0;3;0;0;0;1081637;6662;1380;21;1082822;3998;438;0;1
FR;4;2022-04-25;3;5;3;0;3;8;0;0;0;1081640;6667;1383;21;1082825;4006;438;0;1
FR;4;2022-04-26;5;6;1;0;5;6;1;0;0;1081645;6673;1384;21;1082830;4012;439;0;1
FR;4;2022-04-27;4;1;1;2;5;1;2;0;0;1081649;6674;1385;23;1082835;4013;441;0;1
FR;4;2022-04-28;3;5;5;1;3;7;4;0;0;1081652;6679;1390;24;1082838;4020;445;0;1
FR;4;2022-04-29;6;3;0;0;6;2;0;0;0;1081658;6682;1390;24;1082844;4022;445;0;1
FR;4;2022-04-30;2;1;1;0;2;2;0;0;0;1081660;6683;1391;24;1082846;4024;445;0;1
FR;4;2022-05-01;0;0;0;0;0;0;0;0;0;1081660;6683;1391;24;1082846;4024;445;0;1
FR;4;2022-05-02;5;16;6;0;5;19;3;0;0;1081665;6699;1397;24;1082851;4043;448;0;1
FR;4;2022-05-03;2;6;2;0;2;7;1;0;0;1081667;6705;1399;24;1082853;4050;449;0;1
FR;4;2022-05-04;7;4;1;0;7;4;1;0;0;1081674;6709;1400;24;1082860;4054;450;0;1
FR;4;2022-05-05;5;2;1;1;6;1;2;0;0;1081679;6711;1401;25;1082866;4055;452;0;1
FR;4;2022-05-06;5;3;1;0;6;2;1;0;0;1081684;6714;1402;25;1082872;4057;453;0;1
FR;4;2022-05-07;0;1;0;0;0;1;0;0;0;1081684;6715;1402;25;1082872;4058;453;0;1
FR;4;2022-05-08;1;1;0;0;1;1;0;0;0;1081685;6716;1402;25;1082873;4059;453;0;1
FR;4;2022-05-09;5;1;0;1;5;1;1;0;0;1081690;6717;1402;26;1082878;4060;454;0;1
FR;4;2022-05-10;3;1;0;2;3;3;0;0;0;1081693;6718;1402;28;1082881;4063;454;0;1
FR;4;2022-05-11;4;2;4;0;4;5;1;0;0;1081697;6720;1406;28;1082885;4068;455;0;1
FR;4;2022-05-12;7;4;2;1;7;5;1;0;1;1081704;6724;1408;29;1082892;4073;456;0;2
FR;4;2022-05-13;1;0;2;0;1;2;0;0;0;1081705;6724;1410;29;1082893;4075;456;0;2
FR;4;2022-05-14;0;2;0;0;0;2;0;0;0;1081705;6726;1410;29;1082893;4077;456;0;2
FR;4;2022-05-15;2;2;0;0;4;0;0;0;0;1081707;6728;1410;29;1082897;4077;456;0;2
FR;4;2022-05-16;5;2;2;0;5;2;2;0;0;1081712;6730;1412;29;1082902;4079;458;0;2
FR;4;2022-05-17;5;1;2;0;5;3;0;0;0;1081717;6731;1414;29;1082907;4082;458;0;2
FR;4;2022-05-18;3;6;0;0;3;6;0;0;0;1081720;6737;1414;29;1082910;4088;458;0;2
FR;4;2022-05-19;2;3;3;0;2;5;1;0;0;1081722;6740;1417;29;1082912;4093;459;0;2
FR;4;2022-05-20;5;2;3;0;5;2;3;0;0;1081727;6742;1420;29;1082917;4095;462;0;2
FR;4;2022-05-21;2;0;1;0;2;1;0;0;0;1081729;6742;1421;29;1082919;4096;462;0;2
FR;4;2022-05-22;0;0;1;0;0;1;0;0;0;1081729;6742;1422;29;1082919;4097;462;0;2
FR;4;2022-05-23;0;0;2;0;0;0;2;0;0;1081729;6742;1424;29;1082919;4097;464;0;2
FR;4;2022-05-24;2;4;1;0;2;5;0;0;0;1081731;6746;1425;29;1082921;4102;464;0;2
FR;4;2022-05-25;1;4;1;0;3;3;0;0;0;1081732;6750;1426;29;1082924;4105;464;0;2
FR;4;2022-05-26;5;0;1;0;5;1;0;0;0;1081737;6750;1427;29;1082929;4106;464;0;2
FR;4;2022-05-27;0;2;1;1;0;3;1;0;0;1081737;6752;1428;30;1082929;4109;465;0;2
FR;4;2022-05-28;1;0;0;0;1;0;0;0;0;1081738;6752;1428;30;1082930;4109;465;0;2
FR;4;2022-05-29;1;0;1;0;1;1;0;0;0;1081739;6752;1429;30;1082931;4110;465;0;2
FR;4;2022-05-30;3;4;2;0;3;5;1;0;0;1081742;6756;1431;30;1082934;4115;466;0;2
FR;4;2022-05-31;2;1;0;0;2;1;0;0;0;1081744;6757;1431;30;1082936;4116;466;0;2
FR;4;2022-06-01;3;11;7;0;3;15;3;0;0;1081747;6768;1438;30;1082939;4131;469;0;2
FR;4;2022-06-02;6;7;3;0;6;7;2;0;0;1081753;6775;1441;30;1082945;4138;471;0;2
FR;4;2022-06-03;2;6;4;1;2;7;4;0;0;1081755;6781;1445;31;1082947;4145;475;0;2
FR;4;2022-06-04;0;1;1;1;0;1;2;0;0;1081755;6782;1446;32;1082947;4146;477;0;2
FR;4;2022-06-05;0;0;0;0;0;0;0;0;0;1081755;6782;1446;32;1082947;4146;477;0;2
FR;4;2022-06-06;8;0;3;0;8;2;1;0;0;1081763;6782;1449;32;1082955;4148;478;0;2
FR;4;2022-06-07;6;2;0;1;6;2;1;0;0;1081769;6784;1449;33;1082961;4150;479;0;2
FR;4;2022-06-08;0;5;3;0;1;7;0;0;0;1081769;6789;1452;33;1082962;4157;479;0;2
FR;4;2022-06-09;1;2;0;0;2;1;0;0;0;1081770;6791;1452;33;1082964;4158;479;0;2
FR;4;2022-06-10;4;0;3;0;4;1;2;0;0;1081774;6791;1455;33;1082968;4159;481;0;2
FR;4;2022-06-11;1;0;0;0;1;0;0;0;0;1081775;6791;1455;33;1082969;4159;481;0;2
FR;4;2022-06-12;4;0;1;0;4;1;0;0;0;1081779;6791;1456;33;1082973;4160;481;0;2
FR;4;2022-06-13;6;2;3;0;7;2;1;0;0;1081785;6793;1459;33;1082980;4162;482;0;2
FR;4;2022-06-14;4;3;0;0;5;2;0;0;0;1081789;6796;1459;33;1082985;4164;482;0;2
FR;4;2022-06-15;9;3;4;0;9;3;4;0;0;1081798;6799;1463;33;1082994;4167;486;0;2
FR;4;2022-06-16;2;3;1;1;3;2;1;0;1;1081800;6802;1464;34;1082997;4169;487;0;3
FR;4;2022-06-17;6;1;0;0;6;1;0;0;0;1081806;6803;1464;34;1083003;4170;487;0;3
FR;4;2022-06-18;0;0;0;0;0;0;0;0;0;1081806;6803;1464;34;1083003;4170;487;0;3
FR;4;2022-06-19;3;0;0;0;3;0;0;0;0;1081809;6803;1464;34;1083006;4170;487;0;3
FR;4;2022-06-20;6;2;2;1;6;3;2;0;0;1081815;6805;1466;35;1083012;4173;489;0;3
FR;4;2022-06-21;5;2;4;1;6;4;2;0;0;1081820;6807;1470;36;1083018;4177;491;0;3
FR;4;2022-06-22;3;2;1;3;4;2;1;0;0;1081823;6809;1471;39;1083022;4179;492;0;3
FR;4;2022-06-23;3;3;3;0;3;5;1;0;0;1081826;6812;1474;39;1083025;4184;493;0;3
FR;4;2022-06-24;3;0;2;0;3;0;2;0;0;1081829;6812;1476;39;1083028;4184;495;0;3
FR;4;2022-06-25;3;0;1;1;3;1;1;0;0;1081832;6812;1477;40;1083031;4185;496;0;3
FR;4;2022-06-26;0;0;2;0;0;2;0;0;0;1081832;6812;1479;40;1083031;4187;496;0;3
FR;4;2022-06-27;2;2;1;3;2;3;3;0;0;1081834;6814;1480;43;1083033;4190;499;0;3
FR;4;2022-06-28;0;4;2;1;0;5;2;0;0;1081834;6818;1482;44;1083033;4195;501;0;3
FR;4;2022-06-29;1;2;0;0;1;2;0;0;0;1081835;6820;1482;44;1083034;4197;501;0;3
FR;4;2022-06-30;2;0;0;0;2;0;0;0;0;1081837;6820;1482;44;1083036;4197;501;0;3
FR;4;2022-07-01;2;4;8;0;2;4;8;0;0;1081839;6824;1490;44;1083038;4201;509;0;3
FR;4;2022-07-02;0;1;0;0;1;0;0;0;0;1081839;6825;1490;44;1083039;4201;509;0;3
FR;4;2022-07-03;0;0;0;0;0;0;0;0;0;1081839;6825;1490;44;1083039;4201;509;0;3
FR;4;2022-07-04;4;1;0;0;4;1;0;0;0;1081843;6826;1490;44;1083043;4202;509;0;3
FR;4;2022-07-05;3;1;3;0;3;3;1;0;0;1081846;6827;1493;44;1083046;4205;510;0;3
FR;4;2022-07-06;5;0;1;1;5;0;1;0;1;1081851;6827;1494;45;1083051;4205;511;0;4
FR;4;2022-07-07;2;1;2;1;2;1;3;0;0;1081853;6828;1496;46;1083053;4206;514;0;4
FR;4;2022-07-08;4;1;0;0;4;1;0;0;0;1081857;6829;1496;46;1083057;4207;514;0;4
FR;4;2022-07-09;2;2;1;0;2;3;0;0;0;1081859;6831;1497;46;1083059;4210;514;0;4
FR;4;2022-07-10;2;0;1;0;2;0;0;0;0;1081861;6831;1498;46;1083061;4210;514;0;4
FR;4;2022-07-11;3;0;2;0;3;0;1;0;0;1081864;6831;1500;46;1083064;4210;515;0;4
FR;4;2022-07-12;0;0;2;0;0;2;0;0;0;1081864;6831;1502;46;1083064;4212;515;0;4
FR;4;2022-07-13;3;2;3;1;3;2;4;0;0;1081867;6833;1505;47;1083067;4214;519;0;4
FR;4;2022-07-14;6;0;1;0;6;0;1;0;0;1081873;6833;1506;47;1083073;4214;520;0;4
FR;4;2022-07-15;11;2;0;0;11;2;0;0;0;1081884;6835;1506;47;1083084;4216;520;0;4
FR;4;2022-07-16;5;0;0;2;5;0;2;0;0;1081889;6835;1506;49;1083089;4216;522;0;4
FR;4;2022-07-17;1;0;1;1;1;0;2;0;0;1081890;6835;1507;50;1083090;4216;524;0;4
FR;4;2022-07-18;3;3;2;0;3;3;2;0;0;1081893;6838;1509;50;1083093;4219;526;0;4
FR;4;2022-07-19;5;0;1;0;5;1;0;0;0;1081898;6838;1510;50;1083098;4220;526;0;4
FR;4;2022-07-20;12;1;1;0;13;1;0;0;0;1081910;6839;1511;50;1083111;4221;526;0;4
FR;4;2022-07-21;2;3;1;0;2;3;1;0;0;1081912;6842;1512;50;1083113;4224;527;0;4
FR;4;2022-07-22;5;1;3;0;5;2;2;0;0;1081917;6843;1515;50;1083118;4226;529;0;4
FR;4;2022-07-23;1;2;0;0;1;1;0;0;0;1081918;6845;1515;50;1083119;4227;529;0;4
FR;4;2022-07-24;1;0;0;0;1;0;0;0;0;1081919;6845;1515;50;1083120;4227;529;0;4
FR;4;2022-07-25;7;0;2;0;7;2;0;0;0;1081926;6845;1517;50;1083127;4229;529;0;4
FR;4;2022-07-26;2;0;0;0;2;0;0;0;0;1081928;6845;1517;50;1083129;4229;529;0;4
FR;4;2022-07-27;3;1;0;0;3;0;0;0;0;1081931;6846;1517;50;1083132;4229;529;0;4
FR;4;2022-07-28;13;0;0;0;13;0;0;0;0;1081944;6846;1517;50;1083145;4229;529;0;4
FR;4;2022-07-29;3;0;2;0;3;1;1;0;0;1081947;6846;1519;50;1083148;4230;530;0;4
FR;4;2022-07-30;5;0;2;0;5;0;2;0;0;1081952;6846;1521;50;1083153;4230;532;0;4
FR;4;2022-07-31;0;0;0;0;0;0;0;0;0;1081952;6846;1521;50;1083153;4230;532;0;4
FR;4;2022-08-01;4;0;3;0;4;2;1;0;0;1081956;6846;1524;50;1083157;4232;533;0;4
FR;4;2022-08-02;6;0;0;0;6;0;0;0;0;1081962;6846;1524;50;1083163;4232;533;0;4
FR;4;2022-08-03;2;2;1;0;2;2;1;0;0;1081964;6848;1525;50;1083165;4234;534;0;4
FR;4;2022-08-04;5;2;0;1;5;2;1;0;0;1081969;6850;1525;51;1083170;4236;535;0;4
FR;4;2022-08-05;3;1;1;0;3;1;1;0;0;1081972;6851;1526;51;1083173;4237;536;0;4
FR;4;2022-08-06;2;0;0;0;2;0;0;0;0;1081974;6851;1526;51;1083175;4237;536;0;4
FR;4;2022-08-07;5;0;0;0;5;0;0;0;0;1081979;6851;1526;51;1083180;4237;536;0;4
FR;4;2022-08-08;2;0;1;1;2;1;1;0;0;1081981;6851;1527;52;1083182;4238;537;0;4
FR;4;2022-08-09;1;1;2;2;1;2;3;0;0;1081982;6852;1529;54;1083183;4240;540;0;4
FR;4;2022-08-10;6;1;1;0;7;1;0;0;0;1081988;6853;1530;54;1083190;4241;540;0;4
FR;4;2022-08-11;2;0;1;0;2;1;0;0;0;1081990;6853;1531;54;1083192;4242;540;0;4
FR;4;2022-08-12;4;0;1;0;4;0;1;0;0;1081994;6853;1532;54;1083196;4242;541;0;4
FR;4;2022-08-13;1;0;0;0;1;0;0;0;0;1081995;6853;1532;54;1083197;4242;541;0;4
FR;4;2022-08-14;1;0;0;0;1;0;0;0;0;1081996;6853;1532;54;1083198;4242;541;0;4
FR;4;2022-08-15;1;2;3;0;1;2;3;0;0;1081997;6855;1535;54;1083199;4244;544;0;4
FR;4;2022-08-16;0;0;1;0;0;1;0;0;0;1081997;6855;1536;54;1083199;4245;544;0;4
FR;4;2022-08-17;3;0;0;0;3;0;0;0;0;1082000;6855;1536;54;1083202;4245;544;0;4
FR;4;2022-08-18;5;0;0;0;5;0;0;0;0;1082005;6855;1536;54;1083207;4245;544;0;4
FR;4;2022-08-19;5;0;0;0;5;0;0;0;0;1082010;6855;1536;54;1083212;4245;544;0;4
FR;4;2022-08-20;3;1;0;0;4;0;0;0;0;1082013;6856;1536;54;1083216;4245;544;0;4
FR;4;2022-08-21;1;0;0;0;1;0;0;0;0;1082014;6856;1536;54;1083217;4245;544;0;4
FR;4;2022-08-22;3;9;0;0;3;9;0;0;0;1082017;6865;1536;54;1083220;4254;544;0;4
FR;4;2022-08-23;3;3;3;0;3;4;2;0;0;1082020;6868;1539;54;1083223;4258;546;0;4
FR;4;2022-08-24;6;0;0;1;6;0;1;0;0;1082026;6868;1539;55;1083229;4258;547;0;4
FR;4;2022-08-25;1;3;2;0;1;4;1;0;0;1082027;6871;1541;55;1083230;4262;548;0;4
FR;4;2022-08-26;2;0;0;1;2;0;1;0;0;1082029;6871;1541;56;1083232;4262;549;0;4
FR;4;2022-08-27;1;0;0;0;1;0;0;0;0;1082030;6871;1541;56;1083233;4262;549;0;4
FR;4;2022-08-28;0;1;0;0;0;0;0;0;0;1082030;6872;1541;56;1083233;4262;549;0;4
FR;4;2022-08-29;8;0;0;0;8;0;0;0;0;1082038;6872;1541;56;1083241;4262;549;0;4
FR;4;2022-08-30;5;1;0;0;5;1;0;0;0;1082043;6873;1541;56;1083246;4263;549;0;4
FR;4;2022-08-31;3;1;0;0;3;1;0;0;0;1082046;6874;1541;56;1083249;4264;549;0;4
FR;4;2022-09-01;4;8;2;0;5;7;2;0;0;1082050;6882;1543;56;1083254;4271;551;0;4
FR;4;2022-09-02;2;2;1;0;3;2;0;0;0;1082052;6884;1544;56;1083257;4273;551;0;4
FR;4;2022-09-03;3;0;0;0;3;0;0;0;0;1082055;6884;1544;56;1083260;4273;551;0;4
FR;4;2022-09-04;1;0;0;0;1;0;0;0;0;1082056;6884;1544;56;1083261;4273;551;0;4
FR;4;2022-09-05;4;2;0;0;4;2;0;0;0;1082060;6886;1544;56;1083265;4275;551;0;4
FR;4;2022-09-06;1;0;0;0;1;0;0;0;0;1082061;6886;1544;56;1083266;4275;551;0;4
FR;4;2022-09-07;2;0;1;1;2;1;1;0;0;1082063;6886;1545;57;1083268;4276;552;0;4
FR;4;2022-09-08;3;0;0;0;3;0;0;0;0;1082066;6886;1545;57;1083271;4276;552;0;4
FR;4;2022-09-09;2;2;0;0;2;2;0;0;0;1082068;6888;1545;57;1083273;4278;552;0;4
FR;4;2022-09-10;0;1;0;3;0;2;2;0;0;1082068;6889;1545;60;1083273;4280;554;0;4
FR;4;2022-09-11;2;0;0;0;2;0;0;0;0;1082070;6889;1545;60;1083275;4280;554;0;4
FR;4;2022-09-12;1;1;1;0;1;1;1;0;0;1082071;6890;1546;60;1083276;4281;555;0;4
FR;4;2022-09-13;1;0;0;0;1;0;0;0;0;1082072;6890;1546;60;1083277;4281;555;0;4
FR;4;2022-09-14;4;0;0;0;4;0;0;0;0;1082076;6890;1546;60;1083281;4281;555;0;4
FR;4;2022-09-15;4;0;0;0;4;0;0;0;0;1082080;6890;1546;60;1083285;4281;555;0;4
FR;4;2022-09-16;1;0;0;0;1;0;0;0;0;1082081;6890;1546;60;1083286;4281;555;0;4
FR;4;2022-09-17;2;0;0;0;2;0;0;0;0;1082083;6890;1546;60;1083288;4281;555;0;4
FR;4;2022-09-18;0;1;0;0;0;1;0;0;0;1082083;6891;1546;60;1083288;4282;555;0;4
FR;4;2022-09-19;3;0;2;0;3;2;0;0;0;1082086;6891;1548;60;1083291;4284;555;0;4
FR;4;2022-09-20;4;0;0;0;4;0;0;0;0;1082090;6891;1548;60;1083295;4284;555;0;4
FR;4;2022-09-21;2;1;0;0;2;1;0;0;0;1082092;6892;1548;60;1083297;4285;555;0;4
FR;4;2022-09-22;2;1;0;0;2;1;0;0;0;1082094;6893;1548;60;1083299;4286;555;0;4
FR;4;2022-09-23;2;3;0;0;3;2;0;0;0;1082096;6896;1548;60;1083302;4288;555;0;4
FR;4;2022-09-24;1;0;0;0;1;0;0;0;0;1082097;6896;1548;60;1083303;4288;555;0;4
FR;4;2022-09-25;0;0;0;0;0;0;0;0;0;1082097;6896;1548;60;1083303;4288;555;0;4
FR;4;2022-09-26;2;0;1;0;2;0;1;0;0;1082099;6896;1549;60;1083305;4288;556;0;4
FR;4;2022-09-27;1;0;1;1;1;0;2;0;0;1082100;6896;1550;61;1083306;4288;558;0;4
FR;4;2022-09-28;3;0;2;0;3;2;0;0;0;1082103;6896;1552;61;1083309;4290;558;0;4
FR;4;2022-09-29;3;0;1;1;3;1;1;0;0;1082106;6896;1553;62;1083312;4291;559;0;4
FR;4;2022-09-30;1;1;0;0;1;1;0;0;0;1082107;6897;1553;62;1083313;4292;559;0;4
FR;4;2022-10-01;1;1;0;0;2;0;0;0;0;1082108;6898;1553;62;1083315;4292;559;0;4
FR;4;2022-10-02;0;1;0;0;0;1;0;0;0;1082108;6899;1553;62;1083315;4293;559;0;4
FR;4;2022-10-03;2;3;1;1;3;3;1;0;0;1082110;6902;1554;63;1083318;4296;560;0;4
FR;4;2022-10-04;3;0;0;0;3;0;0;0;0;1082113;6902;1554;63;1083321;4296;560;0;4
FR;4;2022-10-05;0;1;0;0;0;1;0;0;0;1082113;6903;1554;63;1083321;4297;560;0;4
FR;4;2022-10-06;2;0;0;0;2;0;0;0;0;1082115;6903;1554;63;1083323;4297;560;0;4
FR;4;2022-10-07;3;1;1;0;3;1;1;0;0;1082118;6904;1555;63;1083326;4298;561;0;4
FR;4;2022-10-08;4;1;0;0;4;0;0;0;0;1082122;6905;1555;63;1083330;4298;561;0;4
FR;4;2022-10-09;0;0;0;0;0;0;0;0;0;1082122;6905;1555;63;1083330;4298;561;0;4
FR;4;2022-10-10;5;0;2;3;5;2;1;0;2;1082127;6905;1557;66;1083335;4300;562;0;6
FR;4;2022-10-11;2;2;0;0;2;1;0;0;0;1082129;6907;1557;66;1083337;4301;562;0;6
FR;4;2022-10-12;1;0;0;0;1;0;0;0;0;1082130;6907;1557;66;1083338;4301;562;0;6
FR;4;2022-10-13;5;0;0;0;5;0;0;0;0;1082135;6907;1557;66;1083343;4301;562;0;6
FR;4;2022-10-14;1;0;0;0;1;0;0;0;0;1082136;6907;1557;66;1083344;4301;562;0;6
FR;4;2022-10-15;1;2;0;0;1;2;0;0;0;1082137;6909;1557;66;1083345;4303;562;0;6
FR;4;2022-10-16;0;0;0;0;0;0;0;0;0;1082137;6909;1557;66;1083345;4303;562;0;6
FR;4;2022-10-17;2;0;1;0;2;1;0;0;0;1082139;6909;1558;66;1083347;4304;562;0;6
FR;4;2022-10-18;1;0;0;1;1;0;1;0;0;1082140;6909;1558;67;1083348;4304;563;0;6
FR;4;2022-10-19;1;0;0;2;1;0;2;0;3;1082141;6909;1558;69;1083349;4304;565;0;9
FR;4;2022-10-20;4;1;0;0;4;1;0;0;0;1082145;6910;1558;69;1083353;4305;565;0;9
FR;4;2022-10-21;3;1;0;0;3;1;0;0;0;1082148;6911;1558;69;1083356;4306;565;0;9
FR;4;2022-10-22;1;0;0;0;1;0;0;0;0;1082149;6911;1558;69;1083357;4306;565;0;9
FR;4;2022-10-23;0;0;0;0;0;0;0;0;0;1082149;6911;1558;69;1083357;4306;565;0;9
FR;4;2022-10-24;3;0;0;0;3;0;0;0;0;1082152;6911;1558;69;1083360;4306;565;0;9
FR;4;2022-10-25;4;0;0;0;4;0;0;0;0;1082156;6911;1558;69;1083364;4306;565;0;9
FR;4;2022-10-26;2;1;0;0;2;1;0;0;0;1082158;6912;1558;69;1083366;4307;565;0;9
FR;4;2022-10-27;3;1;1;0;3;0;1;0;0;1082161;6913;1559;69;1083369;4307;566;0;9
FR;4;2022-10-28;0;0;0;0;0;0;0;0;0;1082161;6913;1559;69;1083369;4307;566;0;9
FR;4;2022-10-29;1;0;0;3;1;0;3;0;3;1082162;6913;1559;72;1083370;4307;569;0;12
FR;4;2022-10-30;1;0;0;0;1;0;0;0;0;1082163;6913;1559;72;1083371;4307;569;0;12
FR;4;2022-10-31;1;0;0;0;1;0;0;0;0;1082164;6913;1559;72;1083372;4307;569;0;12
FR;4;2022-11-01;1;6;0;0;1;6;0;0;0;1082165;6919;1559;72;1083373;4313;569;0;12
FR;4;2022-11-02;0;0;2;2;0;1;3;0;0;1082165;6919;1561;74;1083373;4314;572;0;12
FR;4;2022-11-03;1;0;0;0;1;0;0;0;0;1082166;6919;1561;74;1083374;4314;572;0;12
FR;4;2022-11-04;4;1;0;0;4;0;0;0;0;1082170;6920;1561;74;1083378;4314;572;0;12
FR;4;2022-11-05;0;0;0;0;0;0;0;0;0;1082170;6920;1561;74;1083378;4314;572;0;12
FR;4;2022-11-06;2;0;0;0;2;0;0;0;0;1082172;6920;1561;74;1083380;4314;572;0;12
FR;4;2022-11-07;2;0;0;0;2;0;0;0;0;1082174;6920;1561;74;1083382;4314;572;0;12
FR;4;2022-11-08;7;0;0;0;7;0;0;0;0;1082181;6920;1561;74;1083389;4314;572;0;12
FR;4;2022-11-09;0;0;0;0;0;0;0;0;0;1082181;6920;1561;74;1083389;4314;572;0;12
FR;4;2022-11-10;1;0;1;0;1;1;0;0;0;1082182;6920;1562;74;1083390;4315;572;0;12
FR;4;2022-11-11;1;0;0;0;1;0;0;0;0;1082183;6920;1562;74;1083391;4315;572;0;12
FR;4;2022-11-12;3;1;0;0;3;1;0;0;0;1082186;6921;1562;74;1083394;4316;572;0;12
FR;4;2022-11-13;2;0;0;0;2;0;0;0;0;1082188;6921;1562;74;1083396;4316;572;0;12
FR;4;2022-11-14;0;0;0;0;0;0;0;0;0;1082188;6921;1562;74;1083396;4316;572;0;12
FR;4;2022-11-15;3;1;0;0;3;1;0;0;0;1082191;6922;1562;74;1083399;4317;572;0;12
FR;4;2022-11-16;1;1;1;0;1;1;1;0;0;1082192;6923;1563;74;1083400;4318;573;0;12
FR;4;2022-11-17;0;2;0;0;0;2;0;0;0;1082192;6925;1563;74;1083400;4320;573;0;12
FR;4;2022-11-18;5;0;1;0;5;0;1;0;0;1082197;6925;1564;74;1083405;4320;574;0;12
FR;4;2022-11-19;0;0;0;0;0;0;0;0;0;1082197;6925;1564;74;1083405;4320;574;0;12
FR;4;2022-11-20;0;0;0;1;0;0;0;0;1;1082197;6925;1564;75;1083405;4320;574;0;13
FR;4;2022-11-21;0;0;0;0;0;0;0;0;0;1082197;6925;1564;75;1083405;4320;574;0;13
FR;4;2022-11-22;0;1;1;0;0;2;0;0;0;1082197;6926;1565;75;1083405;4322;574;0;13
FR;4;2022-11-23;1;0;0;0;1;0;0;0;1;1082198;6926;1565;75;1083406;4322;574;0;14
FR;4;2022-11-24;0;2;0;0;0;2;0;0;0;1082198;6928;1565;75;1083406;4324;574;0;14
FR;4;2022-11-25;3;4;0;0;3;4;0;0;0;1082201;6932;1565;75;1083409;4328;574;0;14
FR;4;2022-11-26;1;0;0;0;1;0;0;0;0;1082202;6932;1565;75;1083410;4328;574;0;14
FR;4;2022-11-27;0;0;0;0;0;0;0;0;0;1082202;6932;1565;75;1083410;4328;574;0;14
FR;4;2022-11-28;3;0;0;0;3;0;0;0;0;1082205;6932;1565;75;1083413;4328;574;0;14
FR;4;2022-11-29;3;0;0;0;3;0;0;0;0;1082208;6932;1565;75;1083416;4328;574;0;14
FR;4;2022-11-30;0;0;0;0;0;0;0;0;0;1082208;6932;1565;75;1083416;4328;574;0;14
FR;4;2022-12-01;1;2;2;0;2;2;1;0;0;1082209;6934;1567;75;1083418;4330;575;0;14
FR;4;2022-12-02;6;1;0;1;6;1;0;0;1;1082215;6935;1567;76;1083424;4331;575;0;15
FR;4;2022-12-03;1;0;0;0;1;0;0;0;0;1082216;6935;1567;76;1083425;4331;575;0;15
FR;4;2022-12-04;0;0;0;0;0;0;0;0;0;1082216;6935;1567;76;1083425;4331;575;0;15
FR;4;2022-12-05;2;1;0;0;2;1;0;0;0;1082218;6936;1567;76;1083427;4332;575;0;15
FR;4;2022-12-06;2;0;0;0;2;0;0;0;0;1082220;6936;1567;76;1083429;4332;575;0;15
FR;4;2022-12-07;2;3;1;0;2;4;0;0;0;1082222;6939;1568;76;1083431;4336;575;0;15
FR;4;2022-12-08;1;0;0;0;1;0;0;0;0;1082223;6939;1568;76;1083432;4336;575;0;15
FR;4;2022-12-09;2;0;1;0;2;0;1;0;0;1082225;6939;1569;76;1083434;4336;576;0;15
FR;4;2022-12-10;1;0;0;0;1;0;0;0;0;1082226;6939;1569;76;1083435;4336;576;0;15
FR;4;2022-12-11;0;0;0;0;0;0;0;0;0;1082226;6939;1569;76;1083435;4336;576;0;15
FR;4;2022-12-12;2;1;0;5;2;1;5;0;0;1082228;6940;1569;81;1083437;4337;581;0;15
FR;4;2022-12-13;1;0;0;0;1;0;0;0;0;1082229;6940;1569;81;1083438;4337;581;0;15
FR;4;2022-12-14;0;0;0;0;0;0;0;0;0;1082229;6940;1569;81;1083438;4337;581;0;15
FR;4;2022-12-15;1;1;0;0;1;1;0;0;0;1082230;6941;1569;81;1083439;4338;581;0;15
FR;4;2022-12-16;2;0;0;0;2;0;0;0;0;1082232;6941;1569;81;1083441;4338;581;0;15
FR;4;2022-12-17;0;0;1;0;0;0;1;0;0;1082232;6941;1570;81;1083441;4338;582;0;15
FR;4;2022-12-18;1;0;0;0;1;0;0;0;0;1082233;6941;1570;81;1083442;4338;582;0;15
FR;4;2022-12-19;1;0;0;0;1;0;0;0;0;1082234;6941;1570;81;1083443;4338;582;0;15
FR;4;2022-12-20;4;2;0;0;5;1;0;0;0;1082238;6943;1570;81;1083448;4339;582;0;15
FR;4;2022-12-21;4;0;0;0;4;0;0;0;0;1082242;6943;1570;81;1083452;4339;582;0;15
FR;4;2022-12-22;2;1;0;0;2;1;0;0;0;1082244;6944;1570;81;1083454;4340;582;0;15
FR;4;2022-12-23;3;0;0;0;3;0;0;0;0;1082247;6944;1570;81;1083457;4340;582;0;15
FR;4;2022-12-24;0;0;1;0;0;1;0;0;0;1082247;6944;1571;81;1083457;4341;582;0;15
FR;4;2022-12-25;0;0;0;0;0;0;0;0;0;1082247;6944;1571;81;1083457;4341;582;0;15
FR;4;2022-12-26;1;2;0;0;1;1;0;0;0;1082248;6946;1571;81;1083458;4342;582;0;15
FR;4;2022-12-27;1;1;0;0;1;1;0;0;0;1082249;6947;1571;81;1083459;4343;582;0;15
FR;4;2022-12-28;0;0;0;0;0;0;0;0;0;1082249;6947;1571;81;1083459;4343;582;0;15
FR;4;2022-12-29;0;1;0;0;1;0;0;0;0;1082249;6948;1571;81;1083460;4343;582;0;15
FR;4;2022-12-30;1;0;0;0;1;0;0;0;0;1082250;6948;1571;81;1083461;4343;582;0;15
FR;4;2022-12-31;0;0;0;0;0;0;0;0;0;1082250;6948;1571;81;1083461;4343;582;0;15
FR;4;2023-01-01;0;0;0;0;0;0;0;0;0;1082250;6948;1571;81;1083461;4343;582;0;15
FR;4;2023-01-02;2;0;2;0;2;1;1;0;0;1082252;6948;1573;81;1083463;4344;583;0;15
FR;4;2023-01-03;1;1;0;0;1;1;0;0;0;1082253;6949;1573;81;1083464;4345;583;0;15
FR;4;2023-01-04;0;0;0;0;0;0;0;0;0;1082253;6949;1573;81;1083464;4345;583;0;15
FR;4;2023-01-05;0;0;0;0;0;0;0;0;0;1082253;6949;1573;81;1083464;4345;583;0;15
FR;4;2023-01-06;1;1;3;0;1;4;0;0;0;1082254;6950;1576;81;1083465;4349;583;0;15
FR;4;2023-01-07;1;0;0;0;1;0;0;0;0;1082255;6950;1576;81;1083466;4349;583;0;15
FR;4;2023-01-08;1;0;0;0;1;0;0;0;0;1082256;6950;1576;81;1083467;4349;583;0;15
FR;4;2023-01-09;1;0;0;0;1;0;0;0;0;1082257;6950;1576;81;1083468;4349;583;0;15
FR;4;2023-01-10;2;0;0;0;2;0;0;0;0;1082259;6950;1576;81;1083470;4349;583;0;15
FR;4;2023-01-11;0;0;0;0;0;0;0;0;0;1082259;6950;1576;81;1083470;4349;583;0;15
FR;4;2023-01-12;2;2;0;0;2;2;0;0;0;1082261;6952;1576;81;1083472;4351;583;0;15
FR;4;2023-01-13;3;0;2;0;3;0;2;0;0;1082264;6952;1578;81;1083475;4351;585;0;15
FR;4;2023-01-14;0;0;1;0;0;0;1;0;0;1082264;6952;1579;81;1083475;4351;586;0;15
FR;4;2023-01-15;0;0;0;0;0;0;0;0;0;1082264;6952;1579;81;1083475;4351;586;0;15
FR;4;2023-01-16;2;0;0;0;2;0;0;0;0;1082266;6952;1579;81;1083477;4351;586;0;15
FR;4;2023-01-17;2;0;0;0;2;0;0;0;0;1082268;6952;1579;81;1083479;4351;586;0;15
FR;4;2023-01-18;3;0;0;0;3;0;0;0;0;1082271;6952;1579;81;1083482;4351;586;0;15
FR;4;2023-01-19;1;0;0;2;1;0;0;0;0;1082272;6952;1579;83;1083483;4351;586;0;15
FR;4;2023-01-20;0;0;0;0;0;0;0;0;0;1082272;6952;1579;83;1083483;4351;586;0;15
FR;4;2023-01-21;0;0;0;0;0;0;0;0;0;1082272;6952;1579;83;1083483;4351;586;0;15
FR;4;2023-01-22;0;0;0;0;0;0;0;0;0;1082272;6952;1579;83;1083483;4351;586;0;15
FR;4;2023-01-23;1;0;0;0;1;0;0;0;0;1082273;6952;1579;83;1083484;4351;586;0;15
FR;4;2023-01-24;2;1;0;0;2;1;0;0;0;1082275;6953;1579;83;1083486;4352;586;0;15
FR;4;2023-01-25;6;0;0;0;6;0;0;0;0;1082281;6953;1579;83;1083492;4352;586;0;15
FR;4;2023-01-26;0;0;0;0;0;0;0;0;0;1082281;6953;1579;83;1083492;4352;586;0;15
FR;4;2023-01-27;0;0;0;0;0;0;0;0;0;1082281;6953;1579;83;1083492;4352;586;0;15
FR;4;2023-01-28;0;0;0;0;0;0;0;0;0;1082281;6953;1579;83;1083492;4352;586;0;15
FR;4;2023-01-29;0;0;0;0;0;0;0;0;0;1082281;6953;1579;83;1083492;4352;586;0;15
FR;4;2023-01-30;0;0;0;0;0;0;0;0;0;1082281;6953;1579;83;1083492;4352;586;0;15
FR;4;2023-01-31;0;0;0;0;0;0;0;0;0;1082281;6953;1579;83;1083492;4352;586;0;15
FR;4;2023-02-01;0;0;0;0;0;0;0;0;0;1082281;6953;1579;83;1083492;4352;586;0;15
FR;4;2023-02-02;2;2;2;1;2;3;1;0;0;1082283;6955;1581;84;1083494;4355;587;0;15
FR;4;2023-02-03;0;0;0;0;0;0;0;0;0;1082283;6955;1581;84;1083494;4355;587;0;15
FR;4;2023-02-04;1;0;0;0;1;0;0;0;0;1082284;6955;1581;84;1083495;4355;587;0;15
FR;4;2023-02-05;0;0;0;0;0;0;0;0;0;1082284;6955;1581;84;1083495;4355;587;0;15
FR;4;2023-02-06;1;0;0;0;1;0;0;0;0;1082285;6955;1581;84;1083496;4355;587;0;15
FR;4;2023-02-07;2;0;0;0;2;0;0;0;0;1082287;6955;1581;84;1083498;4355;587;0;15
FR;4;2023-02-08;2;1;0;0;2;0;0;0;0;1082289;6956;1581;84;1083500;4355;587;0;15
FR;4;2023-02-09;1;1;0;0;1;1;0;0;0;1082290;6957;1581;84;1083501;4356;587;0;15
FR;4;2023-02-10;4;1;0;0;4;0;0;0;0;1082294;6958;1581;84;1083505;4356;587;0;15
FR;4;2023-02-11;4;0;0;0;4;0;0;0;0;1082298;6958;1581;84;1083509;4356;587;0;15
FR;4;2023-02-12;0;0;0;0;0;0;0;0;0;1082298;6958;1581;84;1083509;4356;587;0;15
FR;4;2023-02-13;2;0;0;0;2;0;0;0;0;1082300;6958;1581;84;1083511;4356;587;0;15
FR;4;2023-02-14;0;2;0;0;2;0;0;0;0;1082300;6960;1581;84;1083513;4356;587;0;15
FR;4;2023-02-15;2;0;0;0;2;0;0;0;0;1082302;6960;1581;84;1083515;4356;587;0;15
FR;4;2023-02-16;1;1;0;0;1;1;0;0;0;1082303;6961;1581;84;1083516;4357;587;0;15
FR;4;2023-02-17;1;0;0;0;1;0;0;0;0;1082304;6961;1581;84;1083517;4357;587;0;15
FR;4;2023-02-18;0;2;0;0;0;2;0;0;0;1082304;6963;1581;84;1083517;4359;587;0;15
FR;4;2023-02-19;0;0;0;0;0;0;0;0;0;1082304;6963;1581;84;1083517;4359;587;0;15
FR;4;2023-02-20;1;0;0;0;1;0;0;0;0;1082305;6963;1581;84;1083518;4359;587;0;15
FR;4;2023-02-21;2;0;0;0;2;0;0;0;0;1082307;6963;1581;84;1083520;4359;587;0;15
FR;4;2023-02-22;0;0;0;0;0;0;0;0;0;1082307;6963;1581;84;1083520;4359;587;0;15
FR;4;2023-02-23;0;0;0;0;0;0;0;0;0;1082307;6963;1581;84;1083520;4359;587;0;15
FR;4;2023-02-24;1;0;0;0;1;0;0;0;0;1082308;6963;1581;84;1083521;4359;587;0;15
FR;4;2023-02-25;2;1;0;0;2;1;0;0;0;1082310;6964;1581;84;1083523;4360;587;0;15
FR;4;2023-02-26;0;0;0;0;0;0;0;0;0;1082310;6964;1581;84;1083523;4360;587;0;15
FR;4;2023-02-27;0;0;0;0;0;0;0;0;0;1082310;6964;1581;84;1083523;4360;587;0;15
FR;4;2023-02-28;0;0;0;0;0;0;0;0;0;1082310;6964;1581;84;1083523;4360;587;0;15
FR;4;2023-03-01;1;0;0;0;1;0;0;0;0;1082311;6964;1581;84;1083524;4360;587;0;15
FR;4;2023-03-02;1;1;2;0;1;1;2;0;0;1082312;6965;1583;84;1083525;4361;589;0;15
FR;4;2023-03-03;0;0;0;0;0;0;0;0;0;1082312;6965;1583;84;1083525;4361;589;0;15
FR;4;2023-03-04;0;0;0;0;0;0;0;0;0;1082312;6965;1583;84;1083525;4361;589;0;15
FR;4;2023-03-05;0;0;0;0;0;0;0;0;0;1082312;6965;1583;84;1083525;4361;589;0;15
FR;4;2023-03-06;0;0;0;0;0;0;0;0;0;1082312;6965;1583;84;1083525;4361;589;0;15
FR;4;2023-03-07;0;0;0;0;0;0;0;0;0;1082312;6965;1583;84;1083525;4361;589;0;15
FR;4;2023-03-08;0;0;0;0;0;0;0;0;0;1082312;6965;1583;84;1083525;4361;589;0;15
FR;4;2023-03-09;0;0;0;0;0;0;0;0;0;1082312;6965;1583;84;1083525;4361;589;0;15
FR;4;2023-03-10;2;0;1;0;2;0;1;0;0;1082314;6965;1584;84;1083527;4361;590;0;15
FR;4;2023-03-11;0;0;0;0;0;0;0;0;0;1082314;6965;1584;84;1083527;4361;590;0;15
FR;4;2023-03-12;0;0;0;0;0;0;0;0;0;1082314;6965;1584;84;1083527;4361;590;0;15
FR;4;2023-03-13;0;0;0;0;0;0;0;0;0;1082314;6965;1584;84;1083527;4361;590;0;15
FR;4;2023-03-14;0;0;0;0;0;0;0;0;0;1082314;6965;1584;84;1083527;4361;590;0;15
FR;4;2023-03-15;1;0;0;0;1;0;0;0;0;1082315;6965;1584;84;1083528;4361;590;0;15
FR;4;2023-03-16;1;0;0;0;1;0;0;0;0;1082316;6965;1584;84;1083529;4361;590;0;15
FR;4;2023-03-17;1;0;0;0;1;0;0;0;0;1082317;6965;1584;84;1083530;4361;590;0;15
FR;4;2023-03-18;0;0;0;0;0;0;0;0;0;1082317;6965;1584;84;1083530;4361;590;0;15
FR;4;2023-03-19;0;0;0;0;0;0;0;0;0;1082317;6965;1584;84;1083530;4361;590;0;15
FR;4;2023-03-20;0;0;0;0;0;0;0;0;0;1082317;6965;1584;84;1083530;4361;590;0;15
FR;4;2023-03-21;1;0;0;0;1;0;0;0;0;1082318;6965;1584;84;1083531;4361;590;0;15
FR;4;2023-03-22;0;0;0;0;0;0;0;0;0;1082318;6965;1584;84;1083531;4361;590;0;15
FR;4;2023-03-23;0;0;0;0;0;0;0;0;0;1082318;6965;1584;84;1083531;4361;590;0;15
FR;4;2023-03-24;0;0;0;0;0;0;0;0;0;1082318;6965;1584;84;1083531;4361;590;0;15
FR;4;2023-03-25;0;0;0;0;0;0;0;0;0;1082318;6965;1584;84;1083531;4361;590;0;15
FR;4;2023-03-26;0;0;0;0;0;0;0;0;0;1082318;6965;1584;84;1083531;4361;590;0;15
FR;4;2023-03-27;0;0;0;0;0;0;0;0;0;1082318;6965;1584;84;1083531;4361;590;0;15
FR;4;2023-03-28;1;0;0;0;1;0;0;0;0;1082319;6965;1584;84;1083532;4361;590;0;15
FR;4;2023-03-29;0;0;0;0;0;0;0;0;0;1082319;6965;1584;84;1083532;4361;590;0;15
FR;5;2020-12-27;0;0;0;0;0;0;0;0;0;0;0;0;0;0;0;0;0;0
FR;5;2020-12-28;0;0;0;0;0;0;0;0;0;0;0;0;0;0;0;0;0;0
FR;5;2020-12-29;0;0;0;0;0;0;0;0;0;0;0;0;0;0;0;0;0;0
FR;5;2020-12-30;0;0;0;0;0;0;0;0;0;0;0;0;0;0;0;0;0;0
FR;5;2020-12-31;0;0;0;0;0;0;0;0;0;0;0;0;0;0;0;0;0;0
FR;5;2021-01-01;0;0;0;0;0;0;0;0;0;0;0;0;0;0;0;0;0;0
FR;5;2021-01-02;0;0;0;0;0;0;0;0;0;0;0;0;0;0;0;0;0;0
FR;5;2021-01-03;0;0;0;0;0;0;0;0;0;0;0;0;0;0;0;0;0;0
FR;5;2021-01-04;0;0;0;0;0;0;0;0;0;0;0;0;0;0;0;0;0;0
FR;5;2021-01-05;0;0;0;0;0;0;0;0;0;0;0;0;0;0;0;0;0;0
FR;5;2021-01-06;0;0;0;0;0;0;0;0;0;0;0;0;0;0;0;0;0;0
FR;5;2021-01-07;0;0;0;0;0;0;0;0;0;0;0;0;0;0;0;0;0;0
FR;5;2021-01-08;0;0;0;0;0;0;0;0;0;0;0;0;0;0;0;0;0;0
FR;5;2021-01-09;0;0;0;0;0;0;0;0;0;0;0;0;0;0;0;0;0;0
FR;5;2021-01-10;0;0;0;0;0;0;0;0;0;0;0;0;0;0;0;0;0;0
FR;5;2021-01-11;0;0;0;0;0;0;0;0;0;0;0;0;0;0;0;0;0;0
FR;5;2021-01-12;0;0;0;0;0;0;0;0;0;0;0;0;0;0;0;0;0;0
FR;5;2021-01-13;0;0;0;0;0;0;0;0;0;0;0;0;0;0;0;0;0;0
FR;5;2021-01-14;0;0;0;0;0;0;0;0;0;0;0;0;0;0;0;0;0;0
FR;5;2021-01-15;0;0;0;0;0;0;0;0;0;0;0;0;0;0;0;0;0;0
FR;5;2021-01-16;0;0;0;0;0;0;0;0;0;0;0;0;0;0;0;0;0;0
FR;5;2021-01-17;0;0;0;0;0;0;0;0;0;0;0;0;0;0;0;0;0;0
FR;5;2021-01-18;0;0;0;0;0;0;0;0;0;0;0;0;0;0;0;0;0;0
FR;5;2021-01-19;0;0;0;0;0;0;0;0;0;0;0;0;0;0;0;0;0;0
FR;5;2021-01-20;0;0;0;0;0;0;0;0;0;0;0;0;0;0;0;0;0;0
FR;5;2021-01-21;0;0;0;0;0;0;0;0;0;0;0;0;0;0;0;0;0;0
FR;5;2021-01-22;0;0;0;0;0;0;0;0;0;0;0;0;0;0;0;0;0;0
FR;5;2021-01-23;0;0;0;0;0;0;0;0;0;0;0;0;0;0;0;0;0;0
FR;5;2021-01-24;0;0;0;0;0;0;0;0;0;0;0;0;0;0;0;0;0;0
FR;5;2021-01-25;0;0;0;0;0;0;0;0;0;0;0;0;0;0;0;0;0;0
FR;5;2021-01-26;0;0;0;0;0;0;0;0;0;0;0;0;0;0;0;0;0;0
FR;5;2021-01-27;0;0;0;0;0;0;0;0;0;0;0;0;0;0;0;0;0;0
FR;5;2021-01-28;0;0;0;0;0;0;0;0;0;0;0;0;0;0;0;0;0;0
FR;5;2021-01-29;0;0;0;0;0;0;0;0;0;0;0;0;0;0;0;0;0;0
FR;5;2021-01-30;0;0;0;0;0;0;0;0;0;0;0;0;0;0;0;0;0;0
FR;5;2021-01-31;0;0;0;0;0;0;0;0;0;0;0;0;0;0;0;0;0;0
FR;5;2021-02-01;0;0;0;0;0;0;0;0;0;0;0;0;0;0;0;0;0;0
FR;5;2021-02-02;0;0;0;0;0;0;0;0;0;0;0;0;0;0;0;0;0;0
FR;5;2021-02-03;0;0;0;0;0;0;0;0;0;0;0;0;0;0;0;0;0;0
FR;5;2021-02-04;0;0;0;0;0;0;0;0;0;0;0;0;0;0;0;0;0;0
FR;5;2021-02-05;0;0;0;0;0;0;0;0;0;0;0;0;0;0;0;0;0;0
FR;5;2021-02-06;0;0;0;0;0;0;0;0;0;0;0;0;0;0;0;0;0;0
FR;5;2021-02-07;0;0;0;0;0;0;0;0;0;0;0;0;0;0;0;0;0;0
FR;5;2021-02-08;0;0;0;0;0;0;0;0;0;0;0;0;0;0;0;0;0;0
FR;5;2021-02-09;0;0;0;0;0;0;0;0;0;0;0;0;0;0;0;0;0;0
FR;5;2021-02-10;0;0;0;0;0;0;0;0;0;0;0;0;0;0;0;0;0;0
FR;5;2021-02-11;0;0;0;0;0;0;0;0;0;0;0;0;0;0;0;0;0;0
FR;5;2021-02-12;0;0;0;0;0;0;0;0;0;0;0;0;0;0;0;0;0;0
FR;5;2021-02-13;0;0;0;0;0;0;0;0;0;0;0;0;0;0;0;0;0;0
FR;5;2021-02-14;0;0;0;0;0;0;0;0;0;0;0;0;0;0;0;0;0;0
FR;5;2021-02-15;0;0;0;0;0;0;0;0;0;0;0;0;0;0;0;0;0;0
FR;5;2021-02-16;0;0;0;0;0;0;0;0;0;0;0;0;0;0;0;0;0;0
FR;5;2021-02-17;0;0;0;0;0;0;0;0;0;0;0;0;0;0;0;0;0;0
FR;5;2021-02-18;0;0;0;0;0;0;0;0;0;0;0;0;0;0;0;0;0;0
FR;5;2021-02-19;0;0;0;0;0;0;0;0;0;0;0;0;0;0;0;0;0;0
FR;5;2021-02-20;0;0;0;0;0;0;0;0;0;0;0;0;0;0;0;0;0;0
FR;5;2021-02-21;0;0;0;0;0;0;0;0;0;0;0;0;0;0;0;0;0;0
FR;5;2021-02-22;0;0;0;0;0;0;0;0;0;0;0;0;0;0;0;0;0;0
FR;5;2021-02-23;0;0;0;0;0;0;0;0;0;0;0;0;0;0;0;0;0;0
FR;5;2021-02-24;0;0;0;0;0;0;0;0;0;0;0;0;0;0;0;0;0;0
FR;5;2021-02-25;0;0;0;0;0;0;0;0;0;0;0;0;0;0;0;0;0;0
FR;5;2021-02-26;0;0;0;0;0;0;0;0;0;0;0;0;0;0;0;0;0;0
FR;5;2021-02-27;0;0;0;0;0;0;0;0;0;0;0;0;0;0;0;0;0;0
FR;5;2021-02-28;0;0;0;0;0;0;0;0;0;0;0;0;0;0;0;0;0;0
FR;5;2021-03-01;0;0;0;0;0;0;0;0;0;0;0;0;0;0;0;0;0;0
FR;5;2021-03-02;0;0;0;0;0;0;0;0;0;0;0;0;0;0;0;0;0;0
FR;5;2021-03-03;0;0;0;0;0;0;0;0;0;0;0;0;0;0;0;0;0;0
FR;5;2021-03-04;0;0;0;0;0;0;0;0;0;0;0;0;0;0;0;0;0;0
FR;5;2021-03-05;0;0;0;0;0;0;0;0;0;0;0;0;0;0;0;0;0;0
FR;5;2021-03-06;0;0;0;0;0;0;0;0;0;0;0;0;0;0;0;0;0;0
FR;5;2021-03-07;0;0;0;0;0;0;0;0;0;0;0;0;0;0;0;0;0;0
FR;5;2021-03-08;0;0;0;0;0;0;0;0;0;0;0;0;0;0;0;0;0;0
FR;5;2021-03-09;0;0;0;0;0;0;0;0;0;0;0;0;0;0;0;0;0;0
FR;5;2021-03-10;0;0;0;0;0;0;0;0;0;0;0;0;0;0;0;0;0;0
FR;5;2021-03-11;0;0;0;0;0;0;0;0;0;0;0;0;0;0;0;0;0;0
FR;5;2021-03-12;0;0;0;0;0;0;0;0;0;0;0;0;0;0;0;0;0;0
FR;5;2021-03-13;0;0;0;0;0;0;0;0;0;0;0;0;0;0;0;0;0;0
FR;5;2021-03-14;0;0;0;0;0;0;0;0;0;0;0;0;0;0;0;0;0;0
FR;5;2021-03-15;0;0;0;0;0;0;0;0;0;0;0;0;0;0;0;0;0;0
FR;5;2021-03-16;0;0;0;0;0;0;0;0;0;0;0;0;0;0;0;0;0;0
FR;5;2021-03-17;0;0;0;0;0;0;0;0;0;0;0;0;0;0;0;0;0;0
FR;5;2021-03-18;0;0;0;0;0;0;0;0;0;0;0;0;0;0;0;0;0;0
FR;5;2021-03-19;0;0;0;0;0;0;0;0;0;0;0;0;0;0;0;0;0;0
FR;5;2021-03-20;0;0;0;0;0;0;0;0;0;0;0;0;0;0;0;0;0;0
FR;5;2021-03-21;0;0;0;0;0;0;0;0;0;0;0;0;0;0;0;0;0;0
FR;5;2021-03-22;0;0;0;0;0;0;0;0;0;0;0;0;0;0;0;0;0;0
FR;5;2021-03-23;0;0;0;0;0;0;0;0;0;0;0;0;0;0;0;0;0;0
FR;5;2021-03-24;0;0;0;0;0;0;0;0;0;0;0;0;0;0;0;0;0;0
FR;5;2021-03-25;0;0;0;0;0;0;0;0;0;0;0;0;0;0;0;0;0;0
FR;5;2021-03-26;0;0;0;0;0;0;0;0;0;0;0;0;0;0;0;0;0;0
FR;5;2021-03-27;0;0;0;0;0;0;0;0;0;0;0;0;0;0;0;0;0;0
FR;5;2021-03-28;0;0;0;0;0;0;0;0;0;0;0;0;0;0;0;0;0;0
FR;5;2021-03-29;0;0;0;0;0;0;0;0;0;0;0;0;0;0;0;0;0;0
FR;5;2021-03-30;0;0;0;0;0;0;0;0;0;0;0;0;0;0;0;0;0;0
FR;5;2021-03-31;0;0;0;0;0;0;0;0;0;0;0;0;0;0;0;0;0;0
FR;5;2021-04-01;0;0;0;0;0;0;0;0;0;0;0;0;0;0;0;0;0;0
FR;5;2021-04-02;0;0;0;0;0;0;0;0;0;0;0;0;0;0;0;0;0;0
FR;5;2021-04-03;0;0;0;0;0;0;0;0;0;0;0;0;0;0;0;0;0;0
FR;5;2021-04-04;0;0;0;0;0;0;0;0;0;0;0;0;0;0;0;0;0;0
FR;5;2021-04-05;0;0;0;0;0;0;0;0;0;0;0;0;0;0;0;0;0;0
FR;5;2021-04-06;0;0;0;0;0;0;0;0;0;0;0;0;0;0;0;0;0;0
FR;5;2021-04-07;0;0;0;0;0;0;0;0;0;0;0;0;0;0;0;0;0;0
FR;5;2021-04-08;0;0;0;0;0;0;0;0;0;0;0;0;0;0;0;0;0;0
FR;5;2021-04-09;0;0;0;0;0;0;0;0;0;0;0;0;0;0;0;0;0;0
FR;5;2021-04-10;0;0;0;0;0;0;0;0;0;0;0;0;0;0;0;0;0;0
FR;5;2021-04-11;0;0;0;0;0;0;0;0;0;0;0;0;0;0;0;0;0;0
FR;5;2021-04-12;0;0;0;0;0;0;0;0;0;0;0;0;0;0;0;0;0;0
FR;5;2021-04-13;0;0;0;0;0;0;0;0;0;0;0;0;0;0;0;0;0;0
FR;5;2021-04-14;0;0;0;0;0;0;0;0;0;0;0;0;0;0;0;0;0;0
FR;5;2021-04-15;0;0;0;0;0;0;0;0;0;0;0;0;0;0;0;0;0;0
FR;5;2021-04-16;0;0;0;0;0;0;0;0;0;0;0;0;0;0;0;0;0;0
FR;5;2021-04-17;0;0;0;0;0;0;0;0;0;0;0;0;0;0;0;0;0;0
FR;5;2021-04-18;0;0;0;0;0;0;0;0;0;0;0;0;0;0;0;0;0;0
FR;5;2021-04-19;0;0;0;0;0;0;0;0;0;0;0;0;0;0;0;0;0;0
FR;5;2021-04-20;0;0;0;0;0;0;0;0;0;0;0;0;0;0;0;0;0;0
FR;5;2021-04-21;0;0;0;0;0;0;0;0;0;0;0;0;0;0;0;0;0;0
FR;5;2021-04-22;0;0;0;0;0;0;0;0;0;0;0;0;0;0;0;0;0;0
FR;5;2021-04-23;0;0;0;0;0;0;0;0;0;0;0;0;0;0;0;0;0;0
FR;5;2021-04-24;0;0;0;0;0;0;0;0;0;0;0;0;0;0;0;0;0;0
FR;5;2021-04-25;0;0;0;0;0;0;0;0;0;0;0;0;0;0;0;0;0;0
FR;5;2021-04-26;0;0;0;0;0;0;0;0;0;0;0;0;0;0;0;0;0;0
FR;5;2021-04-27;0;0;0;0;0;0;0;0;0;0;0;0;0;0;0;0;0;0
FR;5;2021-04-28;0;0;0;0;0;0;0;0;0;0;0;0;0;0;0;0;0;0
FR;5;2021-04-29;0;0;0;0;0;0;0;0;0;0;0;0;0;0;0;0;0;0
FR;5;2021-04-30;0;0;0;0;0;0;0;0;0;0;0;0;0;0;0;0;0;0
FR;5;2021-05-01;0;0;0;0;0;0;0;0;0;0;0;0;0;0;0;0;0;0
FR;5;2021-05-02;0;0;0;0;0;0;0;0;0;0;0;0;0;0;0;0;0;0
FR;5;2021-05-03;0;0;0;0;0;0;0;0;0;0;0;0;0;0;0;0;0;0
FR;5;2021-05-04;0;0;0;0;0;0;0;0;0;0;0;0;0;0;0;0;0;0
FR;5;2021-05-05;0;0;0;0;0;0;0;0;0;0;0;0;0;0;0;0;0;0
FR;5;2021-05-06;0;0;0;0;0;0;0;0;0;0;0;0;0;0;0;0;0;0
FR;5;2021-05-07;0;0;0;0;0;0;0;0;0;0;0;0;0;0;0;0;0;0
FR;5;2021-05-08;0;0;0;0;0;0;0;0;0;0;0;0;0;0;0;0;0;0
FR;5;2021-05-09;0;0;0;0;0;0;0;0;0;0;0;0;0;0;0;0;0;0
FR;5;2021-05-10;0;0;0;0;0;0;0;0;0;0;0;0;0;0;0;0;0;0
FR;5;2021-05-11;0;0;0;0;0;0;0;0;0;0;0;0;0;0;0;0;0;0
FR;5;2021-05-12;0;0;0;0;0;0;0;0;0;0;0;0;0;0;0;0;0;0
FR;5;2021-05-13;0;0;0;0;0;0;0;0;0;0;0;0;0;0;0;0;0;0
FR;5;2021-05-14;0;0;0;0;0;0;0;0;0;0;0;0;0;0;0;0;0;0
FR;5;2021-05-15;0;0;0;0;0;0;0;0;0;0;0;0;0;0;0;0;0;0
FR;5;2021-05-16;0;0;0;0;0;0;0;0;0;0;0;0;0;0;0;0;0;0
FR;5;2021-05-17;0;0;0;0;0;0;0;0;0;0;0;0;0;0;0;0;0;0
FR;5;2021-05-18;0;0;0;0;0;0;0;0;0;0;0;0;0;0;0;0;0;0
FR;5;2021-05-19;0;0;0;0;0;0;0;0;0;0;0;0;0;0;0;0;0;0
FR;5;2021-05-20;0;0;0;0;0;0;0;0;0;0;0;0;0;0;0;0;0;0
FR;5;2021-05-21;0;0;0;0;0;0;0;0;0;0;0;0;0;0;0;0;0;0
FR;5;2021-05-22;0;0;0;0;0;0;0;0;0;0;0;0;0;0;0;0;0;0
FR;5;2021-05-23;0;0;0;0;0;0;0;0;0;0;0;0;0;0;0;0;0;0
FR;5;2021-05-24;0;0;0;0;0;0;0;0;0;0;0;0;0;0;0;0;0;0
FR;5;2021-05-25;0;0;0;0;0;0;0;0;0;0;0;0;0;0;0;0;0;0
FR;5;2021-05-26;0;0;0;0;0;0;0;0;0;0;0;0;0;0;0;0;0;0
FR;5;2021-05-27;0;0;0;0;0;0;0;0;0;0;0;0;0;0;0;0;0;0
FR;5;2021-05-28;0;0;0;0;0;0;0;0;0;0;0;0;0;0;0;0;0;0
FR;5;2021-05-29;0;0;0;0;0;0;0;0;0;0;0;0;0;0;0;0;0;0
FR;5;2021-05-30;0;0;0;0;0;0;0;0;0;0;0;0;0;0;0;0;0;0
FR;5;2021-05-31;0;0;0;0;0;0;0;0;0;0;0;0;0;0;0;0;0;0
FR;5;2021-06-01;0;0;0;0;0;0;0;0;0;0;0;0;0;0;0;0;0;0
FR;5;2021-06-02;0;0;0;0;0;0;0;0;0;0;0;0;0;0;0;0;0;0
FR;5;2021-06-03;0;0;0;0;0;0;0;0;0;0;0;0;0;0;0;0;0;0
FR;5;2021-06-04;0;0;0;0;0;0;0;0;0;0;0;0;0;0;0;0;0;0
FR;5;2021-06-05;0;0;0;0;0;0;0;0;0;0;0;0;0;0;0;0;0;0
FR;5;2021-06-06;0;0;0;0;0;0;0;0;0;0;0;0;0;0;0;0;0;0
FR;5;2021-06-07;0;0;0;0;0;0;0;0;0;0;0;0;0;0;0;0;0;0
FR;5;2021-06-08;0;0;0;0;0;0;0;0;0;0;0;0;0;0;0;0;0;0
FR;5;2021-06-09;0;0;0;0;0;0;0;0;0;0;0;0;0;0;0;0;0;0
FR;5;2021-06-10;0;0;0;0;0;0;0;0;0;0;0;0;0;0;0;0;0;0
FR;5;2021-06-11;0;0;0;0;0;0;0;0;0;0;0;0;0;0;0;0;0;0
FR;5;2021-06-12;0;0;0;0;0;0;0;0;0;0;0;0;0;0;0;0;0;0
FR;5;2021-06-13;0;0;0;0;0;0;0;0;0;0;0;0;0;0;0;0;0;0
FR;5;2021-06-14;0;0;0;0;0;0;0;0;0;0;0;0;0;0;0;0;0;0
FR;5;2021-06-15;0;0;0;0;0;0;0;0;0;0;0;0;0;0;0;0;0;0
FR;5;2021-06-16;0;0;0;0;0;0;0;0;0;0;0;0;0;0;0;0;0;0
FR;5;2021-06-17;0;0;0;0;0;0;0;0;0;0;0;0;0;0;0;0;0;0
FR;5;2021-06-18;0;0;0;0;0;0;0;0;0;0;0;0;0;0;0;0;0;0
FR;5;2021-06-19;0;0;0;0;0;0;0;0;0;0;0;0;0;0;0;0;0;0
FR;5;2021-06-20;0;0;0;0;0;0;0;0;0;0;0;0;0;0;0;0;0;0
FR;5;2021-06-21;0;0;0;0;0;0;0;0;0;0;0;0;0;0;0;0;0;0
FR;5;2021-06-22;0;0;0;0;0;0;0;0;0;0;0;0;0;0;0;0;0;0
FR;5;2021-06-23;0;0;0;0;0;0;0;0;0;0;0;0;0;0;0;0;0;0
FR;5;2021-06-24;0;0;0;0;0;0;0;0;0;0;0;0;0;0;0;0;0;0
FR;5;2021-06-25;0;0;0;0;0;0;0;0;0;0;0;0;0;0;0;0;0;0
FR;5;2021-06-26;0;0;0;0;0;0;0;0;0;0;0;0;0;0;0;0;0;0
FR;5;2021-06-27;0;0;0;0;0;0;0;0;0;0;0;0;0;0;0;0;0;0
FR;5;2021-06-28;0;0;0;0;0;0;0;0;0;0;0;0;0;0;0;0;0;0
FR;5;2021-06-29;0;0;0;0;0;0;0;0;0;0;0;0;0;0;0;0;0;0
FR;5;2021-06-30;0;0;0;0;0;0;0;0;0;0;0;0;0;0;0;0;0;0
FR;5;2021-07-01;0;0;0;0;0;0;0;0;0;0;0;0;0;0;0;0;0;0
FR;5;2021-07-02;0;0;0;0;0;0;0;0;0;0;0;0;0;0;0;0;0;0
FR;5;2021-07-03;0;0;0;0;0;0;0;0;0;0;0;0;0;0;0;0;0;0
FR;5;2021-07-04;0;0;0;0;0;0;0;0;0;0;0;0;0;0;0;0;0;0
FR;5;2021-07-05;0;0;0;0;0;0;0;0;0;0;0;0;0;0;0;0;0;0
FR;5;2021-07-06;0;0;0;0;0;0;0;0;0;0;0;0;0;0;0;0;0;0
FR;5;2021-07-07;0;0;0;0;0;0;0;0;0;0;0;0;0;0;0;0;0;0
FR;5;2021-07-08;0;0;0;0;0;0;0;0;0;0;0;0;0;0;0;0;0;0
FR;5;2021-07-09;0;0;0;0;0;0;0;0;0;0;0;0;0;0;0;0;0;0
FR;5;2021-07-10;0;0;0;0;0;0;0;0;0;0;0;0;0;0;0;0;0;0
FR;5;2021-07-11;0;0;0;0;0;0;0;0;0;0;0;0;0;0;0;0;0;0
FR;5;2021-07-12;0;0;0;0;0;0;0;0;0;0;0;0;0;0;0;0;0;0
FR;5;2021-07-13;0;0;0;0;0;0;0;0;0;0;0;0;0;0;0;0;0;0
FR;5;2021-07-14;0;0;0;0;0;0;0;0;0;0;0;0;0;0;0;0;0;0
FR;5;2021-07-15;0;0;0;0;0;0;0;0;0;0;0;0;0;0;0;0;0;0
FR;5;2021-07-16;0;0;0;0;0;0;0;0;0;0;0;0;0;0;0;0;0;0
FR;5;2021-07-17;0;0;0;0;0;0;0;0;0;0;0;0;0;0;0;0;0;0
FR;5;2021-07-18;0;0;0;0;0;0;0;0;0;0;0;0;0;0;0;0;0;0
FR;5;2021-07-19;0;0;0;0;0;0;0;0;0;0;0;0;0;0;0;0;0;0
FR;5;2021-07-20;0;0;0;0;0;0;0;0;0;0;0;0;0;0;0;0;0;0
FR;5;2021-07-21;0;0;0;0;0;0;0;0;0;0;0;0;0;0;0;0;0;0
FR;5;2021-07-22;0;0;0;0;0;0;0;0;0;0;0;0;0;0;0;0;0;0
FR;5;2021-07-23;0;0;0;0;0;0;0;0;0;0;0;0;0;0;0;0;0;0
FR;5;2021-07-24;0;0;0;0;0;0;0;0;0;0;0;0;0;0;0;0;0;0
FR;5;2021-07-25;0;0;0;0;0;0;0;0;0;0;0;0;0;0;0;0;0;0
FR;5;2021-07-26;0;0;0;0;0;0;0;0;0;0;0;0;0;0;0;0;0;0
FR;5;2021-07-27;0;0;0;0;0;0;0;0;0;0;0;0;0;0;0;0;0;0
FR;5;2021-07-28;0;0;0;0;0;0;0;0;0;0;0;0;0;0;0;0;0;0
FR;5;2021-07-29;0;0;0;0;0;0;0;0;0;0;0;0;0;0;0;0;0;0
FR;5;2021-07-30;0;0;0;0;0;0;0;0;0;0;0;0;0;0;0;0;0;0
FR;5;2021-07-31;0;0;0;0;0;0;0;0;0;0;0;0;0;0;0;0;0;0
FR;5;2021-08-01;0;0;0;0;0;0;0;0;0;0;0;0;0;0;0;0;0;0
FR;5;2021-08-02;0;0;0;0;0;0;0;0;0;0;0;0;0;0;0;0;0;0
FR;5;2021-08-03;0;0;0;0;0;0;0;0;0;0;0;0;0;0;0;0;0;0
FR;5;2021-08-04;0;0;0;0;0;0;0;0;0;0;0;0;0;0;0;0;0;0
FR;5;2021-08-05;0;0;0;0;0;0;0;0;0;0;0;0;0;0;0;0;0;0
FR;5;2021-08-06;0;0;0;0;0;0;0;0;0;0;0;0;0;0;0;0;0;0
FR;5;2021-08-07;0;0;0;0;0;0;0;0;0;0;0;0;0;0;0;0;0;0
FR;5;2021-08-08;0;0;0;0;0;0;0;0;0;0;0;0;0;0;0;0;0;0
FR;5;2021-08-09;0;0;0;0;0;0;0;0;0;0;0;0;0;0;0;0;0;0
FR;5;2021-08-10;0;0;0;0;0;0;0;0;0;0;0;0;0;0;0;0;0;0
FR;5;2021-08-11;0;0;0;0;0;0;0;0;0;0;0;0;0;0;0;0;0;0
FR;5;2021-08-12;0;0;0;0;0;0;0;0;0;0;0;0;0;0;0;0;0;0
FR;5;2021-08-13;0;0;0;0;0;0;0;0;0;0;0;0;0;0;0;0;0;0
FR;5;2021-08-14;0;0;0;0;0;0;0;0;0;0;0;0;0;0;0;0;0;0
FR;5;2021-08-15;0;0;0;0;0;0;0;0;0;0;0;0;0;0;0;0;0;0
FR;5;2021-08-16;0;0;0;0;0;0;0;0;0;0;0;0;0;0;0;0;0;0
FR;5;2021-08-17;0;0;0;0;0;0;0;0;0;0;0;0;0;0;0;0;0;0
FR;5;2021-08-18;0;0;0;0;0;0;0;0;0;0;0;0;0;0;0;0;0;0
FR;5;2021-08-19;0;0;0;0;0;0;0;0;0;0;0;0;0;0;0;0;0;0
FR;5;2021-08-20;0;0;0;0;0;0;0;0;0;0;0;0;0;0;0;0;0;0
FR;5;2021-08-21;0;0;0;0;0;0;0;0;0;0;0;0;0;0;0;0;0;0
FR;5;2021-08-22;0;0;0;0;0;0;0;0;0;0;0;0;0;0;0;0;0;0
FR;5;2021-08-23;0;0;0;0;0;0;0;0;0;0;0;0;0;0;0;0;0;0
FR;5;2021-08-24;0;0;0;0;0;0;0;0;0;0;0;0;0;0;0;0;0;0
FR;5;2021-08-25;0;0;0;0;0;0;0;0;0;0;0;0;0;0;0;0;0;0
FR;5;2021-08-26;0;0;0;0;0;0;0;0;0;0;0;0;0;0;0;0;0;0
FR;5;2021-08-27;0;0;0;0;0;0;0;0;0;0;0;0;0;0;0;0;0;0
FR;5;2021-08-28;0;0;0;0;0;0;0;0;0;0;0;0;0;0;0;0;0;0
FR;5;2021-08-29;0;0;0;0;0;0;0;0;0;0;0;0;0;0;0;0;0;0
FR;5;2021-08-30;0;0;0;0;0;0;0;0;0;0;0;0;0;0;0;0;0;0
FR;5;2021-08-31;0;0;0;0;0;0;0;0;0;0;0;0;0;0;0;0;0;0
FR;5;2021-09-01;0;0;0;0;0;0;0;0;0;0;0;0;0;0;0;0;0;0
FR;5;2021-09-02;0;0;0;0;0;0;0;0;0;0;0;0;0;0;0;0;0;0
FR;5;2021-09-03;0;0;0;0;0;0;0;0;0;0;0;0;0;0;0;0;0;0
FR;5;2021-09-04;0;0;0;0;0;0;0;0;0;0;0;0;0;0;0;0;0;0
FR;5;2021-09-05;0;0;0;0;0;0;0;0;0;0;0;0;0;0;0;0;0;0
FR;5;2021-09-06;0;0;0;0;0;0;0;0;0;0;0;0;0;0;0;0;0;0
FR;5;2021-09-07;0;0;0;0;0;0;0;0;0;0;0;0;0;0;0;0;0;0
FR;5;2021-09-08;0;0;0;0;0;0;0;0;0;0;0;0;0;0;0;0;0;0
FR;5;2021-09-09;0;0;0;0;0;0;0;0;0;0;0;0;0;0;0;0;0;0
FR;5;2021-09-10;0;0;0;0;0;0;0;0;0;0;0;0;0;0;0;0;0;0
FR;5;2021-09-11;0;0;0;0;0;0;0;0;0;0;0;0;0;0;0;0;0;0
FR;5;2021-09-12;0;0;0;0;0;0;0;0;0;0;0;0;0;0;0;0;0;0
FR;5;2021-09-13;0;0;0;0;0;0;0;0;0;0;0;0;0;0;0;0;0;0
FR;5;2021-09-14;0;0;0;0;0;0;0;0;0;0;0;0;0;0;0;0;0;0
FR;5;2021-09-15;0;0;0;0;0;0;0;0;0;0;0;0;0;0;0;0;0;0
FR;5;2021-09-16;0;0;0;0;0;0;0;0;0;0;0;0;0;0;0;0;0;0
FR;5;2021-09-17;0;0;0;0;0;0;0;0;0;0;0;0;0;0;0;0;0;0
FR;5;2021-09-18;0;0;0;0;0;0;0;0;0;0;0;0;0;0;0;0;0;0
FR;5;2021-09-19;0;0;0;0;0;0;0;0;0;0;0;0;0;0;0;0;0;0
FR;5;2021-09-20;0;0;0;0;0;0;0;0;0;0;0;0;0;0;0;0;0;0
FR;5;2021-09-21;0;0;0;0;0;0;0;0;0;0;0;0;0;0;0;0;0;0
FR;5;2021-09-22;0;0;0;0;0;0;0;0;0;0;0;0;0;0;0;0;0;0
FR;5;2021-09-23;0;0;0;0;0;0;0;0;0;0;0;0;0;0;0;0;0;0
FR;5;2021-09-24;0;0;0;0;0;0;0;0;0;0;0;0;0;0;0;0;0;0
FR;5;2021-09-25;0;0;0;0;0;0;0;0;0;0;0;0;0;0;0;0;0;0
FR;5;2021-09-26;0;0;0;0;0;0;0;0;0;0;0;0;0;0;0;0;0;0
FR;5;2021-09-27;0;0;0;0;0;0;0;0;0;0;0;0;0;0;0;0;0;0
FR;5;2021-09-28;0;0;0;0;0;0;0;0;0;0;0;0;0;0;0;0;0;0
FR;5;2021-09-29;0;0;0;0;0;0;0;0;0;0;0;0;0;0;0;0;0;0
FR;5;2021-09-30;0;0;0;0;0;0;0;0;0;0;0;0;0;0;0;0;0;0
FR;5;2021-10-01;0;0;0;0;0;0;0;0;0;0;0;0;0;0;0;0;0;0
FR;5;2021-10-02;0;0;0;0;0;0;0;0;0;0;0;0;0;0;0;0;0;0
FR;5;2021-10-03;0;0;0;0;0;0;0;0;0;0;0;0;0;0;0;0;0;0
FR;5;2021-10-04;0;0;0;0;0;0;0;0;0;0;0;0;0;0;0;0;0;0
FR;5;2021-10-05;0;0;0;0;0;0;0;0;0;0;0;0;0;0;0;0;0;0
FR;5;2021-10-06;0;0;0;0;0;0;0;0;0;0;0;0;0;0;0;0;0;0
FR;5;2021-10-07;0;0;0;0;0;0;0;0;0;0;0;0;0;0;0;0;0;0
FR;5;2021-10-08;0;0;0;0;0;0;0;0;0;0;0;0;0;0;0;0;0;0
FR;5;2021-10-09;0;0;0;0;0;0;0;0;0;0;0;0;0;0;0;0;0;0
FR;5;2021-10-10;0;0;0;0;0;0;0;0;0;0;0;0;0;0;0;0;0;0
FR;5;2021-10-11;0;0;0;0;0;0;0;0;0;0;0;0;0;0;0;0;0;0
FR;5;2021-10-12;0;0;0;0;0;0;0;0;0;0;0;0;0;0;0;0;0;0
FR;5;2021-10-13;0;0;0;0;0;0;0;0;0;0;0;0;0;0;0;0;0;0
FR;5;2021-10-14;0;0;0;0;0;0;0;0;0;0;0;0;0;0;0;0;0;0
FR;5;2021-10-15;0;0;0;0;0;0;0;0;0;0;0;0;0;0;0;0;0;0
FR;5;2021-10-16;0;0;0;0;0;0;0;0;0;0;0;0;0;0;0;0;0;0
FR;5;2021-10-17;0;0;0;0;0;0;0;0;0;0;0;0;0;0;0;0;0;0
FR;5;2021-10-18;0;0;0;0;0;0;0;0;0;0;0;0;0;0;0;0;0;0
FR;5;2021-10-19;0;0;0;0;0;0;0;0;0;0;0;0;0;0;0;0;0;0
FR;5;2021-10-20;0;0;0;0;0;0;0;0;0;0;0;0;0;0;0;0;0;0
FR;5;2021-10-21;0;0;0;0;0;0;0;0;0;0;0;0;0;0;0;0;0;0
FR;5;2021-10-22;0;0;0;0;0;0;0;0;0;0;0;0;0;0;0;0;0;0
FR;5;2021-10-23;0;0;0;0;0;0;0;0;0;0;0;0;0;0;0;0;0;0
FR;5;2021-10-24;0;0;0;0;0;0;0;0;0;0;0;0;0;0;0;0;0;0
FR;5;2021-10-25;0;0;0;0;0;0;0;0;0;0;0;0;0;0;0;0;0;0
FR;5;2021-10-26;0;0;0;0;0;0;0;0;0;0;0;0;0;0;0;0;0;0
FR;5;2021-10-27;0;0;0;0;0;0;0;0;0;0;0;0;0;0;0;0;0;0
FR;5;2021-10-28;0;0;0;0;0;0;0;0;0;0;0;0;0;0;0;0;0;0
FR;5;2021-10-29;0;0;0;0;0;0;0;0;0;0;0;0;0;0;0;0;0;0
FR;5;2021-10-30;0;0;0;0;0;0;0;0;0;0;0;0;0;0;0;0;0;0
FR;5;2021-10-31;0;0;0;0;0;0;0;0;0;0;0;0;0;0;0;0;0;0
FR;5;2021-11-01;0;0;0;0;0;0;0;0;0;0;0;0;0;0;0;0;0;0
FR;5;2021-11-02;0;0;0;0;0;0;0;0;0;0;0;0;0;0;0;0;0;0
FR;5;2021-11-03;0;0;0;0;0;0;0;0;0;0;0;0;0;0;0;0;0;0
FR;5;2021-11-04;0;0;0;0;0;0;0;0;0;0;0;0;0;0;0;0;0;0
FR;5;2021-11-05;0;0;0;0;0;0;0;0;0;0;0;0;0;0;0;0;0;0
FR;5;2021-11-06;0;0;0;0;0;0;0;0;0;0;0;0;0;0;0;0;0;0
FR;5;2021-11-07;0;0;0;0;0;0;0;0;0;0;0;0;0;0;0;0;0;0
FR;5;2021-11-08;0;0;0;0;0;0;0;0;0;0;0;0;0;0;0;0;0;0
FR;5;2021-11-09;0;0;0;0;0;0;0;0;0;0;0;0;0;0;0;0;0;0
FR;5;2021-11-10;0;0;0;0;0;0;0;0;0;0;0;0;0;0;0;0;0;0
FR;5;2021-11-11;0;0;0;0;0;0;0;0;0;0;0;0;0;0;0;0;0;0
FR;5;2021-11-12;0;0;0;0;0;0;0;0;0;0;0;0;0;0;0;0;0;0
FR;5;2021-11-13;0;0;0;0;0;0;0;0;0;0;0;0;0;0;0;0;0;0
FR;5;2021-11-14;0;0;0;0;0;0;0;0;0;0;0;0;0;0;0;0;0;0
FR;5;2021-11-15;0;0;0;0;0;0;0;0;0;0;0;0;0;0;0;0;0;0
FR;5;2021-11-16;0;0;0;0;0;0;0;0;0;0;0;0;0;0;0;0;0;0
FR;5;2021-11-17;0;0;0;0;0;0;0;0;0;0;0;0;0;0;0;0;0;0
FR;5;2021-11-18;0;0;0;0;0;0;0;0;0;0;0;0;0;0;0;0;0;0
FR;5;2021-11-19;0;0;0;0;0;0;0;0;0;0;0;0;0;0;0;0;0;0
FR;5;2021-11-20;0;0;0;0;0;0;0;0;0;0;0;0;0;0;0;0;0;0
FR;5;2021-11-21;0;0;0;0;0;0;0;0;0;0;0;0;0;0;0;0;0;0
FR;5;2021-11-22;0;0;0;0;0;0;0;0;0;0;0;0;0;0;0;0;0;0
FR;5;2021-11-23;0;0;0;0;0;0;0;0;0;0;0;0;0;0;0;0;0;0
FR;5;2021-11-24;0;0;0;0;0;0;0;0;0;0;0;0;0;0;0;0;0;0
FR;5;2021-11-25;0;0;0;0;0;0;0;0;0;0;0;0;0;0;0;0;0;0
FR;5;2021-11-26;0;0;0;0;0;0;0;0;0;0;0;0;0;0;0;0;0;0
FR;5;2021-11-27;0;0;0;0;0;0;0;0;0;0;0;0;0;0;0;0;0;0
FR;5;2021-11-28;0;0;0;0;0;0;0;0;0;0;0;0;0;0;0;0;0;0
FR;5;2021-11-29;0;0;0;0;0;0;0;0;0;0;0;0;0;0;0;0;0;0
FR;5;2021-11-30;0;0;0;0;0;0;0;0;0;0;0;0;0;0;0;0;0;0
FR;5;2021-12-01;0;0;0;0;0;0;0;0;0;0;0;0;0;0;0;0;0;0
FR;5;2021-12-02;0;0;0;0;0;0;0;0;0;0;0;0;0;0;0;0;0;0
FR;5;2021-12-03;0;0;0;0;0;0;0;0;0;0;0;0;0;0;0;0;0;0
FR;5;2021-12-04;0;0;0;0;0;0;0;0;0;0;0;0;0;0;0;0;0;0
FR;5;2021-12-05;0;0;0;0;0;0;0;0;0;0;0;0;0;0;0;0;0;0
FR;5;2021-12-06;0;0;0;0;0;0;0;0;0;0;0;0;0;0;0;0;0;0
FR;5;2021-12-07;0;0;0;0;0;0;0;0;0;0;0;0;0;0;0;0;0;0
FR;5;2021-12-08;0;0;0;0;0;0;0;0;0;0;0;0;0;0;0;0;0;0
FR;5;2021-12-09;0;0;0;0;0;0;0;0;0;0;0;0;0;0;0;0;0;0
FR;5;2021-12-10;0;0;0;0;0;0;0;0;0;0;0;0;0;0;0;0;0;0
FR;5;2021-12-11;0;0;0;0;0;0;0;0;0;0;0;0;0;0;0;0;0;0
FR;5;2021-12-12;0;0;0;0;0;0;0;0;0;0;0;0;0;0;0;0;0;0
FR;5;2021-12-13;0;0;0;0;0;0;0;0;0;0;0;0;0;0;0;0;0;0
FR;5;2021-12-14;33;45;77;0;27;88;1;0;0;33;45;77;0;27;88;1;0;0
FR;5;2021-12-15;196;44;37;0;42;49;0;0;0;229;89;114;0;69;137;1;0;0
FR;5;2021-12-16;181;21;44;0;38;48;0;0;0;410;110;158;0;107;185;1;0;0
FR;5;2021-12-17;313;16;72;0;34;74;2;0;0;723;126;230;0;141;259;3;0;0
FR;5;2021-12-18;766;24;22;0;67;29;0;0;0;1489;150;252;0;208;288;3;0;0
FR;5;2021-12-19;585;15;15;0;67;17;0;0;0;2074;165;267;0;275;305;3;0;0
FR;5;2021-12-20;1225;31;34;0;134;37;2;0;0;3299;196;301;0;409;342;5;0;0
FR;5;2021-12-21;1535;22;54;1;141;60;0;0;0;4834;218;355;1;550;402;5;0;0
FR;5;2021-12-22;4069;40;37;0;420;46;2;0;0;8903;258;392;1;970;448;7;0;0
FR;5;2021-12-23;3043;16;21;0;305;25;0;0;0;11946;274;413;1;1275;473;7;0;0
FR;5;2021-12-24;761;18;9;0;103;14;0;0;0;12707;292;422;1;1378;487;7;0;0
FR;5;2021-12-25;61;5;2;0;9;3;0;0;0;12768;297;424;1;1387;490;7;0;0
FR;5;2021-12-26;623;6;3;0;101;4;0;0;0;13391;303;427;1;1488;494;7;0;0
FR;5;2021-12-27;4085;25;21;0;458;23;1;0;0;17476;328;448;1;1946;517;8;0;0
FR;5;2021-12-28;5204;23;41;1;513;43;2;0;0;22680;351;489;2;2459;560;10;0;0
FR;5;2021-12-29;8105;34;66;1;886;69;0;0;0;30785;385;555;3;3345;629;10;0;0
FR;5;2021-12-30;5173;18;33;0;525;39;0;0;0;35958;403;588;3;3870;668;10;0;0
FR;5;2021-12-31;1554;8;10;0;182;11;0;0;0;37512;411;598;3;4052;679;10;0;0
FR;5;2022-01-01;186;2;2;0;24;3;0;0;0;37698;413;600;3;4076;682;10;0;0
FR;5;2022-01-02;1489;1;1;0;152;1;0;0;0;39187;414;601;3;4228;683;10;0;0
FR;5;2022-01-03;3068;36;34;0;322;33;1;0;0;42255;450;635;3;4550;716;11;0;0
FR;5;2022-01-04;3034;39;33;0;321;42;3;0;0;45289;489;668;3;4871;758;14;0;0
FR;5;2022-01-05;19324;203;97;1;2115;108;0;0;0;64613;692;765;4;6986;866;14;0;0
FR;5;2022-01-06;3748;134;122;0;507;142;2;0;0;68361;826;887;4;7493;1008;16;0;0
FR;5;2022-01-07;5006;202;48;2;704;56;1;0;0;73367;1028;935;6;8197;1064;17;0;0
FR;5;2022-01-08;13659;514;45;0;2003;52;0;0;0;87026;1542;980;6;10200;1116;17;0;0
FR;5;2022-01-09;5754;399;15;0;1112;20;1;0;0;92780;1941;995;6;11312;1136;18;0;0
FR;5;2022-01-10;3455;326;25;0;734;29;0;0;0;96235;2267;1020;6;12046;1165;18;0;0
FR;5;2022-01-11;3671;283;38;0;661;41;1;0;0;99906;2550;1058;6;12707;1206;19;0;0
FR;5;2022-01-12;22650;3005;89;0;5297;112;2;0;0;122556;5555;1147;6;18004;1318;21;0;0
FR;5;2022-01-13;4039;623;29;0;1051;31;2;0;0;126595;6178;1176;6;19055;1349;23;0;0
FR;5;2022-01-14;4843;583;45;0;1115;52;1;0;0;131438;6761;1221;6;20170;1401;24;0;0
FR;5;2022-01-15;14686;1747;38;3;3376;49;3;0;0;146124;8508;1259;9;23546;1450;27;0;0
FR;5;2022-01-16;4728;666;3;0;1261;5;0;0;0;150852;9174;1262;9;24807;1455;27;0;0
FR;5;2022-01-17;2297;718;26;0;986;29;0;0;0;153149;9892;1288;9;25793;1484;27;0;0
FR;5;2022-01-18;2431;870;30;0;1141;40;0;0;0;155580;10762;1318;9;26934;1524;27;0;0
FR;5;2022-01-19;18484;6423;74;2;8366;142;3;0;0;174064;17185;1392;11;35300;1666;30;0;0
FR;5;2022-01-20;1920;1067;25;0;1295;34;2;0;0;175984;18252;1417;11;36595;1700;32;0;0
FR;5;2022-01-21;3077;1372;47;1;1677;59;2;0;0;179061;19624;1464;12;38272;1759;34;0;0
FR;5;2022-01-22;10720;3454;33;1;4671;43;1;0;0;189781;23078;1497;13;42943;1802;35;0;0
FR;5;2022-01-23;2629;1415;6;0;1789;10;0;0;0;192410;24493;1503;13;44732;1812;35;0;0
FR;5;2022-01-24;1161;1340;19;0;1446;23;1;0;0;193571;25833;1522;13;46178;1835;36;0;0
FR;5;2022-01-25;1220;1549;20;2;1683;31;3;0;0;194791;27382;1542;15;47861;1866;39;0;0
FR;5;2022-01-26;10748;12032;50;1;13300;89;1;0;1;205539;39414;1592;16;61161;1955;40;0;1
FR;5;2022-01-27;1291;1693;10;0;1838;17;0;0;0;206830;41107;1602;16;62999;1972;40;0;1
FR;5;2022-01-28;1698;3346;16;0;3566;19;1;0;0;208528;44453;1618;16;66565;1991;41;0;1
FR;5;2022-01-29;6241;8041;68;0;8855;96;2;0;0;214769;52494;1686;16;75420;2087;43;0;1
FR;5;2022-01-30;1509;2950;5;0;3185;18;0;0;0;216278;55444;1691;16;78605;2105;43;0;1
FR;5;2022-01-31;589;1773;23;0;1837;24;3;0;0;216867;57217;1714;16;80442;2129;46;0;1
FR;5;2022-02-01;712;1706;10;0;1791;15;0;0;0;217579;58923;1724;16;82233;2144;46;0;1
FR;5;2022-02-02;6959;15655;52;0;16603;94;0;0;0;224538;74578;1776;16;98836;2238;46;0;1
FR;5;2022-02-03;492;1691;14;0;1748;13;5;0;0;225030;76269;1790;16;100584;2251;51;0;1
FR;5;2022-02-04;945;3002;19;0;3123;31;0;0;0;225975;79271;1809;16;103707;2282;51;0;1
FR;5;2022-02-05;3536;8919;23;0;9517;37;0;0;0;229511;88190;1832;16;113224;2319;51;0;1
FR;5;2022-02-06;737;2398;10;0;2556;19;0;0;0;230248;90588;1842;16;115780;2338;51;0;1
FR;5;2022-02-07;884;1596;23;0;1715;25;2;0;0;231132;92184;1865;16;117495;2363;53;0;1
FR;5;2022-02-08;725;1287;18;0;1407;20;2;0;0;231857;93471;1883;16;118902;2383;55;0;1
FR;5;2022-02-09;4544;12880;44;0;13608;76;1;0;0;236401;106351;1927;16;132510;2459;56;0;1
FR;5;2022-02-10;646;1059;14;0;1166;15;0;0;0;237047;107410;1941;16;133676;2474;56;0;1
FR;5;2022-02-11;793;2032;16;0;2163;21;1;0;0;237840;109442;1957;16;135839;2495;57;0;1
FR;5;2022-02-12;2286;6812;33;0;7279;53;0;0;0;240126;116254;1990;16;143118;2548;57;0;1
FR;5;2022-02-13;464;1541;8;0;1654;8;1;0;0;240590;117795;1998;16;144772;2556;58;0;1
FR;5;2022-02-14;678;1288;10;0;1407;13;1;0;0;241268;119083;2008;16;146179;2569;59;0;1
FR;5;2022-02-15;482;886;9;0;968;14;1;0;0;241750;119969;2017;16;147147;2583;60;0;1
FR;5;2022-02-16;2980;9124;41;1;9676;58;2;0;0;244730;129093;2058;17;156823;2641;62;0;1
FR;5;2022-02-17;436;809;6;0;876;7;1;0;0;245166;129902;2064;17;157699;2648;63;0;1
FR;5;2022-02-18;649;1408;13;0;1535;17;0;0;0;245815;131310;2077;17;159234;2665;63;0;1
FR;5;2022-02-19;1373;4315;16;0;4623;28;0;0;0;247188;135625;2093;17;163857;2693;63;0;1
FR;5;2022-02-20;247;879;6;0;941;8;0;0;0;247435;136504;2099;17;164798;2701;63;0;1
FR;5;2022-02-21;221;607;2;0;661;4;1;0;0;247656;137111;2101;17;165459;2705;64;0;1
FR;5;2022-02-22;262;545;17;0;591;17;1;0;0;247918;137656;2118;17;166050;2722;65;0;1
FR;5;2022-02-23;1909;6926;23;1;7346;43;0;0;0;249827;144582;2141;18;173396;2765;65;0;1
FR;5;2022-02-24;182;374;6;1;421;7;1;0;0;250009;144956;2147;19;173817;2772;66;0;1
FR;5;2022-02-25;336;951;13;0;1028;12;2;0;0;250345;145907;2160;19;174845;2784;68;0;1
FR;5;2022-02-26;972;3071;11;0;3333;15;2;0;0;251317;148978;2171;19;178178;2799;70;0;1
FR;5;2022-02-27;151;506;0;0;549;3;0;0;0;251468;149484;2171;19;178727;2802;70;0;1
FR;5;2022-02-28;162;369;1;0;408;1;0;0;0;251630;149853;2172;19;179135;2803;70;0;1
FR;5;2022-03-01;130;280;6;0;315;7;1;0;0;251760;150133;2178;19;179450;2810;71;0;1
FR;5;2022-03-02;1242;4156;28;3;4497;40;3;0;0;253002;154289;2206;22;183947;2850;74;0;1
FR;5;2022-03-03;121;251;5;0;271;10;1;0;0;253123;154540;2211;22;184218;2860;75;0;1
FR;5;2022-03-04;197;488;13;0;538;14;2;0;0;253320;155028;2224;22;184756;2874;77;0;1
FR;5;2022-03-05;677;1990;8;0;2243;16;2;0;0;253997;157018;2232;22;186999;2890;79;0;1
FR;5;2022-03-06;108;260;0;0;310;0;0;0;0;254105;157278;2232;22;187309;2890;79;0;1
FR;5;2022-03-07;71;228;5;0;254;3;2;0;0;254176;157506;2237;22;187563;2893;81;0;1
FR;5;2022-03-08;46;134;7;1;141;8;3;0;0;254222;157640;2244;23;187704;2901;84;0;1
FR;5;2022-03-09;910;3078;24;0;3407;36;0;0;0;255132;160718;2268;23;191111;2937;84;0;1
FR;5;2022-03-10;82;202;9;0;215;13;3;0;0;255214;160920;2277;23;191326;2950;87;0;1
FR;5;2022-03-11;148;369;13;1;426;15;0;0;0;255362;161289;2290;24;191752;2965;87;0;1
FR;5;2022-03-12;758;1613;13;1;1976;30;0;0;0;256120;162902;2303;25;193728;2995;87;0;1
FR;5;2022-03-13;78;102;0;0;135;0;0;0;0;256198;163004;2303;25;193863;2995;87;0;1
FR;5;2022-03-14;69;119;7;1;139;7;1;0;0;256267;163123;2310;26;194002;3002;88;0;1
FR;5;2022-03-15;83;99;4;0;119;7;1;0;0;256350;163222;2314;26;194121;3009;89;0;1
FR;5;2022-03-16;882;1827;15;3;2227;36;7;0;0;257232;165049;2329;29;196348;3045;96;0;1
FR;5;2022-03-17;68;123;8;4;151;10;4;0;0;257300;165172;2337;33;196499;3055;100;0;1
FR;5;2022-03-18;172;318;13;4;391;18;4;0;0;257472;165490;2350;37;196890;3073;104;0;1
FR;5;2022-03-19;752;1163;12;5;1555;33;8;0;0;258224;166653;2362;42;198445;3106;112;0;1
FR;5;2022-03-20;45;93;1;0;119;1;0;0;0;258269;166746;2363;42;198564;3107;112;0;1
FR;5;2022-03-21;71;120;10;6;136;15;8;0;0;258340;166866;2373;48;198700;3122;120;0;1
FR;5;2022-03-22;56;119;8;7;143;9;6;0;0;258396;166985;2381;55;198843;3131;126;0;1
FR;5;2022-03-23;805;1461;14;8;1878;36;9;0;0;259201;168446;2395;63;200721;3167;135;0;1
FR;5;2022-03-24;71;93;8;7;118;7;10;0;0;259272;168539;2403;70;200839;3174;145;0;1
FR;5;2022-03-25;222;293;14;8;388;18;9;0;0;259494;168832;2417;78;201227;3192;154;0;1
FR;5;2022-03-26;707;853;12;5;1273;26;6;0;1;260201;169685;2429;83;202500;3218;160;0;2
FR;5;2022-03-27;75;81;0;0;124;3;0;0;0;260276;169766;2429;83;202624;3221;160;0;2
FR;5;2022-03-28;81;93;1;2;132;3;2;0;0;260357;169859;2430;85;202756;3224;162;0;2
FR;5;2022-03-29;71;82;10;4;113;12;5;0;0;260428;169941;2440;89;202869;3236;167;0;2
FR;5;2022-03-30;823;1116;16;13;1604;29;14;0;0;261251;171057;2456;102;204473;3265;181;0;2
FR;5;2022-03-31;102;125;1;4;173;6;4;0;0;261353;171182;2457;106;204646;3271;185;0;2
FR;5;2022-04-01;114;86;7;12;135;11;12;0;1;261467;171268;2464;118;204781;3282;197;0;3
FR;5;2022-04-02;330;349;3;3;535;15;4;0;0;261797;171617;2467;121;205316;3297;201;0;3
FR;5;2022-04-03;54;59;1;0;88;1;0;0;0;261851;171676;2468;121;205404;3298;201;0;3
FR;5;2022-04-04;40;57;4;1;70;8;2;0;0;261891;171733;2472;122;205474;3306;203;0;3
FR;5;2022-04-05;53;60;6;6;75;9;5;0;0;261944;171793;2478;128;205549;3315;208;0;3
FR;5;2022-04-06;421;439;7;14;678;16;14;0;0;262365;172232;2485;142;206227;3331;222;0;3
FR;5;2022-04-07;45;69;5;7;89;7;10;0;0;262410;172301;2490;149;206316;3338;232;0;3
FR;5;2022-04-08;134;112;12;13;175;14;15;0;0;262544;172413;2502;162;206491;3352;247;0;3
FR;5;2022-04-09;311;324;2;5;511;17;5;0;0;262855;172737;2504;167;207002;3369;252;0;3
FR;5;2022-04-10;44;31;2;0;61;2;1;0;0;262899;172768;2506;167;207063;3371;253;0;3
FR;5;2022-04-11;50;60;3;2;78;4;3;0;0;262949;172828;2509;169;207141;3375;256;0;3
FR;5;2022-04-12;59;54;3;3;78;5;3;0;0;263008;172882;2512;172;207219;3380;259;0;3
FR;5;2022-04-13;382;413;3;8;606;16;8;0;0;263390;173295;2515;180;207825;3396;267;0;3
FR;5;2022-04-14;48;53;5;5;70;9;3;0;0;263438;173348;2520;185;207895;3405;270;0;3
FR;5;2022-04-15;91;111;4;4;152;5;6;0;0;263529;173459;2524;189;208047;3410;276;0;3
FR;5;2022-04-16;188;184;2;1;265;13;1;0;0;263717;173643;2526;190;208312;3423;277;0;3
FR;5;2022-04-17;12;11;1;0;17;1;0;0;0;263729;173654;2527;190;208329;3424;277;0;3
FR;5;2022-04-18;9;10;2;0;11;3;1;0;0;263738;173664;2529;190;208340;3427;278;0;3
FR;5;2022-04-19;75;71;6;1;96;6;4;0;0;263813;173735;2535;191;208436;3433;282;0;3
FR;5;2022-04-20;361;349;9;6;521;12;7;0;0;264174;174084;2544;197;208957;3445;289;0;3
FR;5;2022-04-21;42;64;9;10;71;12;14;0;0;264216;174148;2553;207;209028;3457;303;0;3
FR;5;2022-04-22;113;96;5;4;144;5;5;0;0;264329;174244;2558;211;209172;3462;308;0;3
FR;5;2022-04-23;209;193;4;2;284;11;3;0;0;264538;174437;2562;213;209456;3473;311;0;3
FR;5;2022-04-24;37;35;0;0;50;3;0;0;0;264575;174472;2562;213;209506;3476;311;0;3
FR;5;2022-04-25;69;65;1;1;102;4;1;0;0;264644;174537;2563;214;209608;3480;312;0;3
FR;5;2022-04-26;60;63;2;1;85;5;1;0;0;264704;174600;2565;215;209693;3485;313;0;3
FR;5;2022-04-27;335;316;3;7;463;14;8;0;0;265039;174916;2568;222;210156;3499;321;0;3
FR;5;2022-04-28;81;54;4;5;81;8;7;0;0;265120;174970;2572;227;210237;3507;328;0;3
FR;5;2022-04-29;117;84;5;19;118;12;17;0;0;265237;175054;2577;246;210355;3519;345;0;3
FR;5;2022-04-30;183;114;2;3;184;10;4;0;0;265420;175168;2579;249;210539;3529;349;0;3
FR;5;2022-05-01;11;7;0;0;11;0;0;0;0;265431;175175;2579;249;210550;3529;349;0;3
FR;5;2022-05-02;52;28;4;5;48;2;7;0;0;265483;175203;2583;254;210598;3531;356;0;3
FR;5;2022-05-03;87;57;2;4;84;11;4;0;0;265570;175260;2585;258;210682;3542;360;0;3
FR;5;2022-05-04;278;205;1;2;324;7;2;0;0;265848;175465;2586;260;211006;3549;362;0;3
FR;5;2022-05-05;62;32;3;4;46;5;4;0;0;265910;175497;2589;264;211052;3554;366;0;3
FR;5;2022-05-06;105;65;2;3;106;5;3;0;0;266015;175562;2591;267;211158;3559;369;0;3
FR;5;2022-05-07;171;117;2;10;180;13;7;0;0;266186;175679;2593;277;211338;3572;376;0;3
FR;5;2022-05-08;8;8;0;0;9;2;0;0;0;266194;175687;2593;277;211347;3574;376;0;3
FR;5;2022-05-09;44;34;15;3;51;16;4;0;0;266238;175721;2608;280;211398;3590;380;0;3
FR;5;2022-05-10;54;49;3;4;67;5;5;0;0;266292;175770;2611;284;211465;3595;385;0;3
FR;5;2022-05-11;327;237;12;7;344;21;11;0;0;266619;176007;2623;291;211809;3616;396;0;3
FR;5;2022-05-12;46;34;2;2;47;2;3;0;0;266665;176041;2625;293;211856;3618;399;0;3
FR;5;2022-05-13;109;83;3;8;120;8;7;0;0;266774;176124;2628;301;211976;3626;406;0;3
FR;5;2022-05-14;209;131;0;1;212;8;0;0;0;266983;176255;2628;302;212188;3634;406;0;3
FR;5;2022-05-15;22;9;2;0;18;1;1;0;0;267005;176264;2630;302;212206;3635;407;0;3
FR;5;2022-05-16;52;34;4;5;53;4;5;0;0;267057;176298;2634;307;212259;3639;412;0;3
FR;5;2022-05-17;72;40;5;0;68;2;3;0;0;267129;176338;2639;307;212327;3641;415;0;3
FR;5;2022-05-18;289;215;4;4;330;8;6;0;0;267418;176553;2643;311;212657;3649;421;0;3
FR;5;2022-05-19;45;35;5;3;42;3;4;0;0;267463;176588;2648;314;212699;3652;425;0;3
FR;5;2022-05-20;76;63;3;10;92;1;11;0;0;267539;176651;2651;324;212791;3653;436;0;3
FR;5;2022-05-21;242;166;2;3;268;17;1;0;0;267781;176817;2653;327;213059;3670;437;0;3
FR;5;2022-05-22;20;14;2;5;20;2;6;0;0;267801;176831;2655;332;213079;3672;443;0;3
FR;5;2022-05-23;42;31;4;3;42;6;3;0;0;267843;176862;2659;335;213121;3678;446;0;3
FR;5;2022-05-24;47;45;3;2;60;5;2;0;0;267890;176907;2662;337;213181;3683;448;0;3
FR;5;2022-05-25;329;258;4;1;386;16;1;0;0;268219;177165;2666;338;213567;3699;449;0;3
FR;5;2022-05-26;17;5;0;1;9;2;0;0;1;268236;177170;2666;339;213576;3701;449;0;4
FR;5;2022-05-27;99;54;4;4;89;9;3;0;0;268335;177224;2670;343;213665;3710;452;0;4
FR;5;2022-05-28;100;78;5;3;106;10;3;0;0;268435;177302;2675;346;213771;3720;455;0;4
FR;5;2022-05-29;14;14;1;0;18;2;0;0;0;268449;177316;2676;346;213789;3722;455;0;4
FR;5;2022-05-30;56;41;2;1;54;2;2;0;0;268505;177357;2678;347;213843;3724;457;0;4
FR;5;2022-05-31;57;43;1;8;62;1;8;0;0;268562;177400;2679;355;213905;3725;465;0;4
FR;5;2022-06-01;257;241;9;2;300;25;5;0;0;268819;177641;2688;357;214205;3750;470;0;4
FR;5;2022-06-02;63;61;5;0;73;9;1;0;0;268882;177702;2693;357;214278;3759;471;0;4
FR;5;2022-06-03;82;71;4;5;88;10;6;0;0;268964;177773;2697;362;214366;3769;477;0;4
FR;5;2022-06-04;157;109;2;1;187;9;1;0;0;269121;177882;2699;363;214553;3778;478;0;4
FR;5;2022-06-05;18;11;0;0;21;1;0;0;0;269139;177893;2699;363;214574;3779;478;0;4
FR;5;2022-06-06;16;12;0;1;15;0;1;0;0;269155;177905;2699;364;214589;3779;479;0;4
FR;5;2022-06-07;50;56;1;1;76;2;1;0;0;269205;177961;2700;365;214665;3781;480;0;4
FR;5;2022-06-08;283;225;3;4;332;17;2;0;0;269488;178186;2703;369;214997;3798;482;0;4
FR;5;2022-06-09;52;41;6;3;57;7;2;0;1;269540;178227;2709;372;215054;3805;484;0;5
FR;5;2022-06-10;81;72;1;1;105;6;1;0;0;269621;178299;2710;373;215159;3811;485;0;5
FR;5;2022-06-11;173;141;3;3;202;10;4;0;0;269794;178440;2713;376;215361;3821;489;0;5
FR;5;2022-06-12;17;16;0;0;19;2;0;0;0;269811;178456;2713;376;215380;3823;489;0;5
FR;5;2022-06-13;56;47;9;3;70;10;6;0;0;269867;178503;2722;379;215450;3833;495;0;5
FR;5;2022-06-14;59;56;1;4;64;6;4;0;0;269926;178559;2723;383;215514;3839;499;0;5
FR;5;2022-06-15;266;260;5;2;363;27;1;0;0;270192;178819;2728;385;215877;3866;500;0;5
FR;5;2022-06-16;47;30;5;2;44;5;2;0;0;270239;178849;2733;387;215921;3871;502;0;5
FR;5;2022-06-17;100;67;5;5;102;10;5;0;0;270339;178916;2738;392;216023;3881;507;0;5
FR;5;2022-06-18;146;95;10;2;152;26;2;0;1;270485;179011;2748;394;216175;3907;509;0;6
FR;5;2022-06-19;26;15;0;1;18;4;1;0;0;270511;179026;2748;395;216193;3911;510;0;6
FR;5;2022-06-20;56;50;8;0;62;11;2;0;0;270567;179076;2756;395;216255;3922;512;0;6
FR;5;2022-06-21;53;73;5;3;91;7;5;0;1;270620;179149;2761;398;216346;3929;517;0;7
FR;5;2022-06-22;224;248;7;9;348;33;10;0;0;270844;179397;2768;407;216694;3962;527;0;7
FR;5;2022-06-23;50;38;2;5;43;6;6;0;0;270894;179435;2770;412;216737;3968;533;0;7
FR;5;2022-06-24;91;70;12;5;101;16;8;0;0;270985;179505;2782;417;216838;3984;541;0;7
FR;5;2022-06-25;154;124;3;7;185;14;8;0;1;271139;179629;2785;424;217023;3998;549;0;8
FR;5;2022-06-26;26;19;2;0;29;5;0;0;0;271165;179648;2787;424;217052;4003;549;0;8
FR;5;2022-06-27;57;60;5;7;78;11;9;0;0;271222;179708;2792;431;217130;4014;558;0;8
FR;5;2022-06-28;70;49;8;2;69;14;5;0;0;271292;179757;2800;433;217199;4028;563;0;8
FR;5;2022-06-29;297;268;9;21;390;34;23;0;0;271589;180025;2809;454;217589;4062;586;0;8
FR;5;2022-06-30;89;57;10;12;89;17;11;0;0;271678;180082;2819;466;217678;4079;597;0;8
FR;5;2022-07-01;127;65;7;11;118;12;11;0;2;271805;180147;2826;477;217796;4091;608;0;10
FR;5;2022-07-02;191;132;4;0;210;22;0;0;0;271996;180279;2830;477;218006;4113;608;0;10
FR;5;2022-07-03;30;25;1;0;36;4;0;0;0;272026;180304;2831;477;218042;4117;608;0;10
FR;5;2022-07-04;103;65;2;5;102;7;5;0;1;272129;180369;2833;482;218144;4124;613;0;11
FR;5;2022-07-05;104;72;3;8;107;13;8;0;1;272233;180441;2836;490;218251;4137;621;0;12
FR;5;2022-07-06;277;168;9;36;289;27;36;0;0;272510;180609;2845;526;218540;4164;657;0;12
FR;5;2022-07-07;88;69;6;9;89;13;11;0;0;272598;180678;2851;535;218629;4177;668;0;12
FR;5;2022-07-08;152;120;7;14;146;25;13;0;1;272750;180798;2858;549;218775;4202;681;0;13
FR;5;2022-07-09;116;68;1;8;100;10;8;0;0;272866;180866;2859;557;218875;4212;689;0;13
FR;5;2022-07-10;15;6;0;0;10;1;0;0;0;272881;180872;2859;557;218885;4213;689;0;13
FR;5;2022-07-11;92;72;10;2;98;19;3;0;0;272973;180944;2869;559;218983;4232;692;0;13
FR;5;2022-07-12;67;63;5;10;81;7;12;0;0;273040;181007;2874;569;219064;4239;704;0;13
FR;5;2022-07-13;169;118;10;19;196;16;23;0;0;273209;181125;2884;588;219260;4255;727;0;13
FR;5;2022-07-14;8;4;0;0;7;0;0;0;0;273217;181129;2884;588;219267;4255;727;0;13
FR;5;2022-07-15;74;66;5;14;86;15;15;0;0;273291;181195;2889;602;219353;4270;742;0;13
FR;5;2022-07-16;54;44;3;0;71;3;2;0;0;273345;181239;2892;602;219424;4273;744;0;13
FR;5;2022-07-17;10;7;3;0;10;2;2;0;0;273355;181246;2895;602;219434;4275;746;0;13
FR;5;2022-07-18;60;47;0;4;70;4;3;0;0;273415;181293;2895;606;219504;4279;749;0;13
FR;5;2022-07-19;63;42;5;3;63;7;4;0;0;273478;181335;2900;609;219567;4286;753;0;13
FR;5;2022-07-20;119;106;4;11;141;14;9;0;0;273597;181441;2904;620;219708;4300;762;0;13
FR;5;2022-07-21;38;43;2;10;52;5;10;0;0;273635;181484;2906;630;219760;4305;772;0;13
FR;5;2022-07-22;48;69;11;13;75;23;11;0;1;273683;181553;2917;643;219835;4328;783;0;14
FR;5;2022-07-23;59;78;2;1;95;11;2;0;0;273742;181631;2919;644;219930;4339;785;0;14
FR;5;2022-07-24;11;9;3;1;12;3;1;0;0;273753;181640;2922;645;219942;4342;786;0;14
FR;5;2022-07-25;53;48;2;7;57;8;8;0;0;273806;181688;2924;652;219999;4350;794;0;14
FR;5;2022-07-26;58;52;5;41;70;6;44;0;0;273864;181740;2929;693;220069;4356;838;0;14
FR;5;2022-07-27;106;118;4;4;161;13;4;0;0;273970;181858;2933;697;220230;4369;842;0;14
FR;5;2022-07-28;39;35;2;2;47;6;1;0;0;274009;181893;2935;699;220277;4375;843;0;14
FR;5;2022-07-29;56;74;3;14;90;8;10;0;0;274065;181967;2938;713;220367;4383;853;0;14
FR;5;2022-07-30;55;53;5;1;76;7;2;0;0;274120;182020;2943;714;220443;4390;855;0;14
FR;5;2022-07-31;7;11;1;0;13;1;0;0;0;274127;182031;2944;714;220456;4391;855;0;14
FR;5;2022-08-01;39;53;1;2;64;6;2;0;0;274166;182084;2945;716;220520;4397;857;0;14
FR;5;2022-08-02;32;43;8;7;47;8;7;0;1;274198;182127;2953;723;220567;4405;864;0;15
FR;5;2022-08-03;54;51;4;10;70;9;8;0;0;274252;182178;2957;733;220637;4414;872;0;15
FR;5;2022-08-04;20;18;1;6;22;1;6;0;0;274272;182196;2958;739;220659;4415;878;0;15
FR;5;2022-08-05;35;26;3;3;39;3;3;0;0;274307;182222;2961;742;220698;4418;881;0;15
FR;5;2022-08-06;23;26;1;0;31;1;0;0;0;274330;182248;2962;742;220729;4419;881;0;15
FR;5;2022-08-07;2;2;1;0;1;1;1;0;0;274332;182250;2963;742;220730;4420;882;0;15
FR;5;2022-08-08;26;19;1;2;24;2;1;0;0;274358;182269;2964;744;220754;4422;883;0;15
FR;5;2022-08-09;26;28;3;3;35;3;3;0;0;274384;182297;2967;747;220789;4425;886;0;15
FR;5;2022-08-10;47;47;2;0;56;5;0;0;0;274431;182344;2969;747;220845;4430;886;0;15
FR;5;2022-08-11;19;36;2;2;42;5;2;0;0;274450;182380;2971;749;220887;4435;888;0;15
FR;5;2022-08-12;27;28;2;0;39;2;0;0;0;274477;182408;2973;749;220926;4437;888;0;15
FR;5;2022-08-13;16;18;0;0;24;0;0;0;0;274493;182426;2973;749;220950;4437;888;0;15
FR;5;2022-08-14;2;3;0;0;4;0;0;0;0;274495;182429;2973;749;220954;4437;888;0;15
FR;5;2022-08-15;2;5;0;0;5;0;0;0;0;274497;182434;2973;749;220959;4437;888;0;15
FR;5;2022-08-16;33;26;3;0;28;6;0;0;0;274530;182460;2976;749;220987;4443;888;0;15
FR;5;2022-08-17;52;55;2;1;72;1;1;0;0;274582;182515;2978;750;221059;4444;889;0;15
FR;5;2022-08-18;26;18;8;17;25;10;16;0;0;274608;182533;2986;767;221084;4454;905;0;15
FR;5;2022-08-19;26;34;1;2;43;2;2;0;0;274634;182567;2987;769;221127;4456;907;0;15
FR;5;2022-08-20;25;27;2;1;33;4;2;0;0;274659;182594;2989;770;221160;4460;909;0;15
FR;5;2022-08-21;7;4;1;0;7;1;0;0;0;274666;182598;2990;770;221167;4461;909;0;15
FR;5;2022-08-22;39;26;1;6;42;2;5;0;1;274705;182624;2991;776;221209;4463;914;0;16
FR;5;2022-08-23;27;26;1;1;32;2;1;0;0;274732;182650;2992;777;221241;4465;915;0;16
FR;5;2022-08-24;50;43;0;0;62;0;0;0;0;274782;182693;2992;777;221303;4465;915;0;16
FR;5;2022-08-25;27;26;3;1;31;2;0;0;1;274809;182719;2995;778;221334;4467;915;0;17
FR;5;2022-08-26;48;39;7;2;58;5;4;0;0;274857;182758;3002;780;221392;4472;919;0;17
FR;5;2022-08-27;46;28;1;0;46;3;1;0;0;274903;182786;3003;780;221438;4475;920;0;17
FR;5;2022-08-28;5;7;0;0;7;0;0;0;0;274908;182793;3003;780;221445;4475;920;0;17
FR;5;2022-08-29;58;44;1;1;66;4;1;0;0;274966;182837;3004;781;221511;4479;921;0;17
FR;5;2022-08-30;45;23;12;29;40;10;30;0;1;275011;182860;3016;810;221551;4489;951;0;18
FR;5;2022-08-31;53;47;6;1;58;11;1;0;0;275064;182907;3022;811;221609;4500;952;0;18
FR;5;2022-09-01;16;8;1;4;13;1;4;0;0;275080;182915;3023;815;221622;4501;956;0;18
FR;5;2022-09-02;42;23;8;2;35;9;3;0;0;275122;182938;3031;817;221657;4510;959;0;18
FR;5;2022-09-03;69;37;2;0;58;2;0;0;0;275191;182975;3033;817;221715;4512;959;0;18
FR;5;2022-09-04;12;7;1;0;8;3;0;0;0;275203;182982;3034;817;221723;4515;959;0;18
FR;5;2022-09-05;7;4;1;0;4;1;0;0;0;275210;182986;3035;817;221727;4516;959;0;18
FR;5;2022-09-06;23;14;3;15;17;2;14;0;2;275233;183000;3038;832;221744;4518;973;0;20
FR;5;2022-09-07;79;53;1;1;76;3;1;0;0;275312;183053;3039;833;221820;4521;974;0;20
FR;5;2022-09-08;10;4;0;4;7;0;4;0;0;275322;183057;3039;837;221827;4521;978;0;20
FR;5;2022-09-09;41;11;9;2;14;10;3;0;0;275363;183068;3048;839;221841;4531;981;0;20
FR;5;2022-09-10;40;45;1;1;50;8;1;0;0;275403;183113;3049;840;221891;4539;982;0;20
FR;5;2022-09-11;3;3;0;0;3;1;0;0;0;275406;183116;3049;840;221894;4540;982;0;20
FR;5;2022-09-12;7;5;2;2;7;2;2;0;0;275413;183121;3051;842;221901;4542;984;0;20
FR;5;2022-09-13;9;6;0;1;4;3;1;0;0;275422;183127;3051;843;221905;4545;985;0;20
FR;5;2022-09-14;52;47;4;6;55;9;5;0;0;275474;183174;3055;849;221960;4554;990;0;20
FR;5;2022-09-15;11;13;2;3;11;5;3;0;0;275485;183187;3057;852;221971;4559;993;0;20
FR;5;2022-09-16;25;33;1;4;38;3;3;0;0;275510;183220;3058;856;222009;4562;996;0;20
FR;5;2022-09-17;60;43;1;1;51;5;1;0;0;275570;183263;3059;857;222060;4567;997;0;20
FR;5;2022-09-18;9;6;0;1;10;1;0;0;0;275579;183269;3059;858;222070;4568;997;0;20
FR;5;2022-09-19;22;17;2;1;20;5;2;0;0;275601;183286;3061;859;222090;4573;999;0;20
FR;5;2022-09-20;15;11;3;3;15;1;4;0;0;275616;183297;3064;862;222105;4574;1003;0;20
FR;5;2022-09-21;68;45;9;0;65;13;0;0;0;275684;183342;3073;862;222170;4587;1003;0;20
FR;5;2022-09-22;12;6;4;24;6;4;23;0;1;275696;183348;3077;886;222176;4591;1026;0;21
FR;5;2022-09-23;20;25;2;3;23;8;3;0;0;275716;183373;3079;889;222199;4599;1029;0;21
FR;5;2022-09-24;44;51;1;8;65;5;8;0;0;275760;183424;3080;897;222264;4604;1037;0;21
FR;5;2022-09-25;6;12;0;0;13;1;0;0;0;275766;183436;3080;897;222277;4605;1037;0;21
FR;5;2022-09-26;15;7;0;2;12;0;1;0;1;275781;183443;3080;899;222289;4605;1038;0;22
FR;5;2022-09-27;7;12;4;9;14;4;9;0;1;275788;183455;3084;908;222303;4609;1047;0;23
FR;5;2022-09-28;65;67;5;0;91;7;0;0;0;275853;183522;3089;908;222394;4616;1047;0;23
FR;5;2022-09-29;17;9;1;0;15;1;1;0;1;275870;183531;3090;908;222409;4617;1048;0;24
FR;5;2022-09-30;28;46;2;2;53;4;3;0;0;275898;183577;3092;910;222462;4621;1051;0;24
FR;5;2022-10-01;40;35;5;5;48;8;7;0;0;275938;183612;3097;915;222510;4629;1058;0;24
FR;5;2022-10-02;1;9;1;0;10;1;0;0;0;275939;183621;3098;915;222520;4630;1058;0;24
FR;5;2022-10-03;7;6;3;0;5;4;0;0;0;275946;183627;3101;915;222525;4634;1058;0;24
FR;5;2022-10-04;11;8;1;3;11;2;3;0;0;275957;183635;3102;918;222536;4636;1061;0;24
FR;5;2022-10-05;57;62;2;2;79;13;2;0;0;276014;183697;3104;920;222615;4649;1063;0;24
FR;5;2022-10-06;12;10;1;4;15;2;4;0;0;276026;183707;3105;924;222630;4651;1067;0;24
FR;5;2022-10-07;21;31;1;0;34;5;0;0;0;276047;183738;3106;924;222664;4656;1067;0;24
FR;5;2022-10-08;33;51;1;0;54;7;0;0;0;276080;183789;3107;924;222718;4663;1067;0;24
FR;5;2022-10-09;7;10;0;0;11;1;0;0;0;276087;183799;3107;924;222729;4664;1067;0;24
FR;5;2022-10-10;14;6;0;1;8;1;1;0;0;276101;183805;3107;925;222737;4665;1068;0;24
FR;5;2022-10-11;6;13;2;1;14;2;2;0;0;276107;183818;3109;926;222751;4667;1070;0;24
FR;5;2022-10-12;39;57;3;2;69;8;2;0;0;276146;183875;3112;928;222820;4675;1072;0;24
FR;5;2022-10-13;11;16;2;0;18;4;0;0;0;276157;183891;3114;928;222838;4679;1072;0;24
FR;5;2022-10-14;21;21;1;0;20;5;0;0;0;276178;183912;3115;928;222858;4684;1072;0;24
FR;5;2022-10-15;19;26;10;0;25;11;2;0;0;276197;183938;3125;928;222883;4695;1074;0;24
FR;5;2022-10-16;3;1;0;0;1;1;0;0;0;276200;183939;3125;928;222884;4696;1074;0;24
FR;5;2022-10-17;8;8;2;1;8;3;1;0;2;276208;183947;3127;929;222892;4699;1075;0;26
FR;5;2022-10-18;6;7;0;2;8;0;2;0;0;276214;183954;3127;931;222900;4699;1077;0;26
FR;5;2022-10-19;38;43;8;0;52;11;0;0;1;276252;183997;3135;931;222952;4710;1077;0;27
FR;5;2022-10-20;18;15;2;1;16;3;1;0;0;276270;184012;3137;932;222968;4713;1078;0;27
FR;5;2022-10-21;22;15;6;0;19;8;1;0;2;276292;184027;3143;932;222987;4721;1079;0;29
FR;5;2022-10-22;35;29;2;12;32;5;12;0;0;276327;184056;3145;944;223019;4726;1091;0;29
FR;5;2022-10-23;9;3;0;0;4;0;0;0;0;276336;184059;3145;944;223023;4726;1091;0;29
FR;5;2022-10-24;14;7;6;7;9;9;8;0;0;276350;184066;3151;951;223032;4735;1099;0;29
FR;5;2022-10-25;13;9;6;3;9;8;3;0;2;276363;184075;3157;954;223041;4743;1102;0;31
FR;5;2022-10-26;34;22;6;0;29;10;0;0;0;276397;184097;3163;954;223070;4753;1102;0;31
FR;5;2022-10-27;16;4;4;0;11;4;0;0;0;276413;184101;3167;954;223081;4757;1102;0;31
FR;5;2022-10-28;19;13;5;3;14;6;4;0;0;276432;184114;3172;957;223095;4763;1106;0;31
FR;5;2022-10-29;21;13;0;0;17;3;0;0;0;276453;184127;3172;957;223112;4766;1106;0;31
FR;5;2022-10-30;1;4;2;0;4;3;0;0;0;276454;184131;3174;957;223116;4769;1106;0;31
FR;5;2022-10-31;14;11;2;1;12;3;1;0;0;276468;184142;3176;958;223128;4772;1107;0;31
FR;5;2022-11-01;3;3;0;1;3;0;1;0;0;276471;184145;3176;959;223131;4772;1108;0;31
FR;5;2022-11-02;23;17;5;4;23;5;5;0;0;276494;184162;3181;963;223154;4777;1113;0;31
FR;5;2022-11-03;22;4;1;1;11;1;1;0;0;276516;184166;3182;964;223165;4778;1114;0;31
FR;5;2022-11-04;19;18;1;0;18;2;0;0;0;276535;184184;3183;964;223183;4780;1114;0;31
FR;5;2022-11-05;25;16;1;0;21;1;0;0;0;276560;184200;3184;964;223204;4781;1114;0;31
FR;5;2022-11-06;1;7;0;0;7;0;0;0;0;276561;184207;3184;964;223211;4781;1114;0;31
FR;5;2022-11-07;9;3;3;0;3;3;0;0;0;276570;184210;3187;964;223214;4784;1114;0;31
FR;5;2022-11-08;12;7;1;2;8;1;1;0;0;276582;184217;3188;966;223222;4785;1115;0;31
FR;5;2022-11-09;30;29;6;1;32;6;1;0;0;276612;184246;3194;967;223254;4791;1116;0;31
FR;5;2022-11-10;11;16;1;0;17;1;0;0;0;276623;184262;3195;967;223271;4792;1116;0;31
FR;5;2022-11-11;2;4;0;1;6;0;1;0;0;276625;184266;3195;968;223277;4792;1117;0;31
FR;5;2022-11-12;19;10;5;9;18;6;9;0;2;276644;184276;3200;977;223295;4798;1126;0;33
FR;5;2022-11-13;2;2;0;1;2;0;1;0;0;276646;184278;3200;978;223297;4798;1127;0;33
FR;5;2022-11-14;8;11;0;1;10;3;0;0;0;276654;184289;3200;979;223307;4801;1127;0;33
FR;5;2022-11-15;8;6;4;3;6;4;3;0;0;276662;184295;3204;982;223313;4805;1130;0;33
FR;5;2022-11-16;29;28;2;1;33;5;0;0;0;276691;184323;3206;983;223346;4810;1130;0;33
FR;5;2022-11-17;6;15;4;0;15;5;0;0;0;276697;184338;3210;983;223361;4815;1130;0;33
FR;5;2022-11-18;16;17;7;0;19;9;0;0;0;276713;184355;3217;983;223380;4824;1130;0;33
FR;5;2022-11-19;18;27;2;0;28;6;0;0;0;276731;184382;3219;983;223408;4830;1130;0;33
FR;5;2022-11-20;6;3;0;0;5;0;0;0;0;276737;184385;3219;983;223413;4830;1130;0;33
FR;5;2022-11-21;8;5;0;2;4;2;1;0;0;276745;184390;3219;985;223417;4832;1131;0;33
FR;5;2022-11-22;9;3;0;1;4;0;1;0;0;276754;184393;3219;986;223421;4832;1132;0;33
FR;5;2022-11-23;34;25;6;1;27;13;0;0;0;276788;184418;3225;987;223448;4845;1132;0;33
FR;5;2022-11-24;3;7;2;0;8;1;1;0;0;276791;184425;3227;987;223456;4846;1133;0;33
FR;5;2022-11-25;15;20;2;0;25;3;0;0;1;276806;184445;3229;987;223481;4849;1133;0;34
FR;5;2022-11-26;22;19;4;0;20;8;0;0;0;276828;184464;3233;987;223501;4857;1133;0;34
FR;5;2022-11-27;7;0;1;0;3;1;0;0;0;276835;184464;3234;987;223504;4858;1133;0;34
FR;5;2022-11-28;7;15;3;0;15;5;0;0;0;276842;184479;3237;987;223519;4863;1133;0;34
FR;5;2022-11-29;10;9;1;0;11;3;0;0;1;276852;184488;3238;987;223530;4866;1133;0;35
FR;5;2022-11-30;35;48;12;0;56;17;1;0;0;276887;184536;3250;987;223586;4883;1134;0;35
FR;5;2022-12-01;5;10;2;0;10;3;0;0;0;276892;184546;3252;987;223596;4886;1134;0;35
FR;5;2022-12-02;1;5;2;1;4;3;1;0;0;276893;184551;3254;988;223600;4889;1135;0;35
FR;5;2022-12-03;3;3;8;1;5;8;1;0;0;276896;184554;3262;989;223605;4897;1136;0;35
FR;5;2022-12-04;3;2;1;0;2;2;0;0;0;276899;184556;3263;989;223607;4899;1136;0;35
FR;5;2022-12-05;1;1;0;0;0;1;0;0;0;276900;184557;3263;989;223607;4900;1136;0;35
FR;5;2022-12-06;5;1;0;0;1;0;0;0;1;276905;184558;3263;989;223608;4900;1136;0;36
FR;5;2022-12-07;5;8;1;0;8;1;0;0;0;276910;184566;3264;989;223616;4901;1136;0;36
FR;5;2022-12-08;2;2;0;0;2;0;0;0;0;276912;184568;3264;989;223618;4901;1136;0;36
FR;5;2022-12-09;3;8;0;0;6;2;0;0;0;276915;184576;3264;989;223624;4903;1136;0;36
FR;5;2022-12-10;4;7;2;1;8;2;1;0;0;276919;184583;3266;990;223632;4905;1137;0;36
FR;5;2022-12-11;2;0;0;0;0;0;0;0;0;276921;184583;3266;990;223632;4905;1137;0;36
FR;5;2022-12-12;0;0;0;0;0;0;0;0;0;276921;184583;3266;990;223632;4905;1137;0;36
FR;5;2022-12-13;2;3;0;0;4;1;0;0;0;276923;184586;3266;990;223636;4906;1137;0;36
FR;5;2022-12-14;2;2;0;9;2;1;8;0;3;276925;184588;3266;999;223638;4907;1145;0;39
FR;5;2022-12-15;0;2;0;0;2;0;0;0;0;276925;184590;3266;999;223640;4907;1145;0;39
FR;5;2022-12-16;3;2;2;0;3;3;0;0;0;276928;184592;3268;999;223643;4910;1145;0;39
FR;5;2022-12-17;3;3;3;0;3;2;1;0;0;276931;184595;3271;999;223646;4912;1146;0;39
FR;5;2022-12-18;3;0;0;1;0;0;1;0;1;276934;184595;3271;1000;223646;4912;1147;0;40
FR;5;2022-12-19;1;0;0;2;0;0;2;0;0;276935;184595;3271;1002;223646;4912;1149;0;40
FR;5;2022-12-20;0;1;3;0;1;3;0;0;0;276935;184596;3274;1002;223647;4915;1149;0;40
FR;5;2022-12-21;2;4;0;0;4;0;0;0;0;276937;184600;3274;1002;223651;4915;1149;0;40
FR;5;2022-12-22;2;2;0;0;2;0;0;0;0;276939;184602;3274;1002;223653;4915;1149;0;40
FR;5;2022-12-23;3;1;1;0;1;1;0;0;0;276942;184603;3275;1002;223654;4916;1149;0;40
FR;5;2022-12-24;0;1;0;0;1;0;0;0;0;276942;184604;3275;1002;223655;4916;1149;0;40
FR;5;2022-12-25;0;1;2;0;0;3;0;0;0;276942;184605;3277;1002;223655;4919;1149;0;40
FR;5;2022-12-26;2;2;0;0;2;0;0;0;0;276944;184607;3277;1002;223657;4919;1149;0;40
FR;5;2022-12-27;0;3;0;0;3;0;0;0;0;276944;184610;3277;1002;223660;4919;1149;0;40
FR;5;2022-12-28;5;3;3;0;3;3;2;0;0;276949;184613;3280;1002;223663;4922;1151;0;40
FR;5;2022-12-29;3;2;2;0;3;2;0;0;0;276952;184615;3282;1002;223666;4924;1151;0;40
FR;5;2022-12-30;3;2;1;0;2;1;0;0;0;276955;184617;3283;1002;223668;4925;1151;0;40
FR;5;2022-12-31;0;0;0;0;0;0;0;0;0;276955;184617;3283;1002;223668;4925;1151;0;40
FR;5;2023-01-01;0;0;0;0;0;0;0;0;0;276955;184617;3283;1002;223668;4925;1151;0;40
FR;5;2023-01-02;1;1;1;0;1;1;0;0;0;276956;184618;3284;1002;223669;4926;1151;0;40
FR;5;2023-01-03;3;1;0;0;2;0;0;0;0;276959;184619;3284;1002;223671;4926;1151;0;40
FR;5;2023-01-04;6;1;1;0;2;1;0;0;0;276965;184620;3285;1002;223673;4927;1151;0;40
FR;5;2023-01-05;0;3;0;0;3;0;0;0;0;276965;184623;3285;1002;223676;4927;1151;0;40
FR;5;2023-01-06;2;1;1;0;1;1;0;0;0;276967;184624;3286;1002;223677;4928;1151;0;40
FR;5;2023-01-07;5;1;1;0;1;2;0;0;0;276972;184625;3287;1002;223678;4930;1151;0;40
FR;5;2023-01-08;2;2;0;0;2;0;0;0;0;276974;184627;3287;1002;223680;4930;1151;0;40
FR;5;2023-01-09;4;0;1;0;1;1;0;0;0;276978;184627;3288;1002;223681;4931;1151;0;40
FR;5;2023-01-10;3;1;0;0;2;0;0;0;0;276981;184628;3288;1002;223683;4931;1151;0;40
FR;5;2023-01-11;7;5;2;0;4;3;0;0;0;276988;184633;3290;1002;223687;4934;1151;0;40
FR;5;2023-01-12;14;6;4;0;6;6;0;0;0;277002;184639;3294;1002;223693;4940;1151;0;40
FR;5;2023-01-13;55;16;15;0;31;17;0;0;0;277057;184655;3309;1002;223724;4957;1151;0;40
FR;5;2023-01-14;56;34;13;1;34;20;2;0;0;277113;184689;3322;1003;223758;4977;1153;0;40
FR;5;2023-01-15;13;9;0;0;5;4;0;0;0;277126;184698;3322;1003;223763;4981;1153;0;40
FR;5;2023-01-16;13;8;3;0;8;3;0;0;0;277139;184706;3325;1003;223771;4984;1153;0;40
FR;5;2023-01-17;12;8;3;0;4;7;0;0;0;277151;184714;3328;1003;223775;4991;1153;0;40
FR;5;2023-01-18;71;35;21;2;46;25;2;0;0;277222;184749;3349;1005;223821;5016;1155;0;40
FR;5;2023-01-19;13;6;8;0;5;10;1;0;0;277235;184755;3357;1005;223826;5026;1156;0;40
FR;5;2023-01-20;27;17;13;0;17;18;0;0;2;277262;184772;3370;1005;223843;5044;1156;0;42
FR;5;2023-01-21;34;23;18;1;31;21;1;0;0;277296;184795;3388;1006;223874;5065;1157;0;42
FR;5;2023-01-22;6;4;2;0;4;3;0;0;0;277302;184799;3390;1006;223878;5068;1157;0;42
FR;5;2023-01-23;6;5;3;0;3;5;0;0;0;277308;184804;3393;1006;223881;5073;1157;0;42
FR;5;2023-01-24;16;3;3;0;6;4;0;0;0;277324;184807;3396;1006;223887;5077;1157;0;42
FR;5;2023-01-25;33;31;12;2;27;23;2;0;0;277357;184838;3408;1008;223914;5100;1159;0;42
FR;5;2023-01-26;6;5;4;0;6;4;0;0;0;277363;184843;3412;1008;223920;5104;1159;0;42
FR;5;2023-01-27;18;13;8;0;17;8;1;0;0;277381;184856;3420;1008;223937;5112;1160;0;42
FR;5;2023-01-28;21;8;4;3;11;6;3;0;0;277402;184864;3424;1011;223948;5118;1163;0;42
FR;5;2023-01-29;0;3;0;0;2;1;0;0;0;277402;184867;3424;1011;223950;5119;1163;0;42
FR;5;2023-01-30;7;5;3;0;4;6;0;0;0;277409;184872;3427;1011;223954;5125;1163;0;42
FR;5;2023-01-31;3;7;2;0;5;4;0;0;0;277412;184879;3429;1011;223959;5129;1163;0;42
FR;5;2023-02-01;18;18;7;1;19;8;1;0;0;277430;184897;3436;1012;223978;5137;1164;0;42
FR;5;2023-02-02;7;8;1;0;7;2;0;0;0;277437;184905;3437;1012;223985;5139;1164;0;42
FR;5;2023-02-03;15;23;6;0;24;9;0;0;0;277452;184928;3443;1012;224009;5148;1164;0;42
FR;5;2023-02-04;15;23;5;0;25;6;0;0;0;277467;184951;3448;1012;224034;5154;1164;0;42
FR;5;2023-02-05;1;2;0;1;2;1;0;0;0;277468;184953;3448;1013;224036;5155;1164;0;42
FR;5;2023-02-06;11;11;7;0;12;7;0;0;0;277479;184964;3455;1013;224048;5162;1164;0;42
FR;5;2023-02-07;6;11;2;0;10;4;0;0;0;277485;184975;3457;1013;224058;5166;1164;0;42
FR;5;2023-02-08;29;34;8;0;38;10;0;0;0;277514;185009;3465;1013;224096;5176;1164;0;42
FR;5;2023-02-09;15;7;5;0;8;5;0;0;0;277529;185016;3470;1013;224104;5181;1164;0;42
FR;5;2023-02-10;11;22;5;0;24;7;0;0;0;277540;185038;3475;1013;224128;5188;1164;0;42
FR;5;2023-02-11;12;11;3;1;15;4;0;0;0;277552;185049;3478;1014;224143;5192;1164;0;42
FR;5;2023-02-12;3;7;1;0;8;1;0;0;0;277555;185056;3479;1014;224151;5193;1164;0;42
FR;5;2023-02-13;4;6;6;0;5;7;0;0;0;277559;185062;3485;1014;224156;5200;1164;0;42
FR;5;2023-02-14;11;8;2;0;9;3;0;0;0;277570;185070;3487;1014;224165;5203;1164;0;42
FR;5;2023-02-15;27;25;4;0;27;5;0;0;0;277597;185095;3491;1014;224192;5208;1164;0;42
FR;5;2023-02-16;8;4;3;0;8;3;0;0;0;277605;185099;3494;1014;224200;5211;1164;0;42
FR;5;2023-02-17;9;5;9;0;6;9;0;0;0;277614;185104;3503;1014;224206;5220;1164;0;42
FR;5;2023-02-18;9;14;3;1;16;3;1;0;0;277623;185118;3506;1015;224222;5223;1165;0;42
FR;5;2023-02-19;0;1;0;0;1;0;0;0;0;277623;185119;3506;1015;224223;5223;1165;0;42
FR;5;2023-02-20;6;6;4;0;6;5;0;0;0;277629;185125;3510;1015;224229;5228;1165;0;42
FR;5;2023-02-21;4;6;5;0;7;5;0;0;0;277633;185131;3515;1015;224236;5233;1165;0;42
FR;5;2023-02-22;10;16;5;0;15;5;1;0;0;277643;185147;3520;1015;224251;5238;1166;0;42
FR;5;2023-02-23;5;5;2;0;5;2;0;0;0;277648;185152;3522;1015;224256;5240;1166;0;42
FR;5;2023-02-24;17;22;1;0;21;3;0;0;0;277665;185174;3523;1015;224277;5243;1166;0;42
FR;5;2023-02-25;11;9;0;0;9;0;0;0;0;277676;185183;3523;1015;224286;5243;1166;0;42
FR;5;2023-02-26;1;1;0;0;1;0;0;0;0;277677;185184;3523;1015;224287;5243;1166;0;42
FR;5;2023-02-27;7;5;2;0;5;2;0;0;0;277684;185189;3525;1015;224292;5245;1166;0;42
FR;5;2023-02-28;4;8;2;0;8;4;0;0;0;277688;185197;3527;1015;224300;5249;1166;0;42
FR;5;2023-03-01;12;25;1;0;23;3;1;0;0;277700;185222;3528;1015;224323;5252;1167;0;42
FR;5;2023-03-02;6;13;3;0;12;5;0;0;0;277706;185235;3531;1015;224335;5257;1167;0;42
FR;5;2023-03-03;9;4;3;0;8;3;1;0;0;277715;185239;3534;1015;224343;5260;1168;0;42
FR;5;2023-03-04;8;17;7;0;18;8;0;0;0;277723;185256;3541;1015;224361;5268;1168;0;42
FR;5;2023-03-05;3;3;0;0;3;0;0;0;0;277726;185259;3541;1015;224364;5268;1168;0;42
FR;5;2023-03-06;2;8;1;0;6;3;0;0;0;277728;185267;3542;1015;224370;5271;1168;0;42
FR;5;2023-03-07;2;8;2;0;8;2;0;0;0;277730;185275;3544;1015;224378;5273;1168;0;42
FR;5;2023-03-08;9;21;1;0;22;1;0;0;0;277739;185296;3545;1015;224400;5274;1168;0;42
FR;5;2023-03-09;1;6;0;0;5;1;0;0;0;277740;185302;3545;1015;224405;5275;1168;0;42
FR;5;2023-03-10;3;6;2;1;7;2;1;0;0;277743;185308;3547;1016;224412;5277;1169;0;42
FR;5;2023-03-11;5;2;0;0;4;0;0;0;0;277748;185310;3547;1016;224416;5277;1169;0;42
FR;5;2023-03-12;0;1;0;0;1;0;0;0;0;277748;185311;3547;1016;224417;5277;1169;0;42
FR;5;2023-03-13;2;2;0;0;4;0;0;0;0;277750;185313;3547;1016;224421;5277;1169;0;42
FR;5;2023-03-14;6;1;1;1;5;1;1;0;0;277756;185314;3548;1017;224426;5278;1170;0;42
FR;5;2023-03-15;7;8;2;0;12;3;0;0;0;277763;185322;3550;1017;224438;5281;1170;0;42
FR;5;2023-03-16;2;6;0;0;6;0;0;0;0;277765;185328;3550;1017;224444;5281;1170;0;42
FR;5;2023-03-17;14;15;3;0;13;4;1;0;0;277779;185343;3553;1017;224457;5285;1171;0;42
FR;5;2023-03-18;4;9;0;0;9;1;0;0;0;277783;185352;3553;1017;224466;5286;1171;0;42
FR;5;2023-03-19;0;0;0;0;0;0;0;0;0;277783;185352;3553;1017;224466;5286;1171;0;42
FR;5;2023-03-20;3;7;0;0;8;0;0;0;0;277786;185359;3553;1017;224474;5286;1171;0;42
FR;5;2023-03-21;2;7;2;2;7;2;2;0;0;277788;185366;3555;1019;224481;5288;1173;0;42
FR;5;2023-03-22;8;22;3;0;20;4;0;0;0;277796;185388;3558;1019;224501;5292;1173;0;42
FR;5;2023-03-23;2;5;1;0;5;1;0;0;0;277798;185393;3559;1019;224506;5293;1173;0;42
FR;5;2023-03-24;5;9;1;0;9;3;0;0;0;277803;185402;3560;1019;224515;5296;1173;0;42
FR;5;2023-03-25;3;8;1;0;8;1;0;0;0;277806;185410;3561;1019;224523;5297;1173;0;42
FR;5;2023-03-26;0;0;0;0;0;0;0;0;0;277806;185410;3561;1019;224523;5297;1173;0;42
FR;5;2023-03-27;3;0;1;0;1;1;0;0;0;277809;185410;3562;1019;224524;5298;1173;0;42
FR;5;2023-03-28;3;3;0;0;4;0;0;0;0;277812;185413;3562;1019;224528;5298;1173;0;42
FR;5;2023-03-29;7;16;3;0;16;5;0;0;0;277819;185429;3565;1019;224544;5303;1173;0;42
FR;6;2020-12-27;0;0;0;0;0;0;0;0;0;0;0;0;0;0;0;0;0;0
FR;6;2020-12-28;0;0;0;0;0;0;0;0;0;0;0;0;0;0;0;0;0;0
FR;6;2020-12-29;0;0;0;0;0;0;0;0;0;0;0;0;0;0;0;0;0;0
FR;6;2020-12-30;0;0;0;0;0;0;0;0;0;0;0;0;0;0;0;0;0;0
FR;6;2020-12-31;0;0;0;0;0;0;0;0;0;0;0;0;0;0;0;0;0;0
FR;6;2021-01-01;0;0;0;0;0;0;0;0;0;0;0;0;0;0;0;0;0;0
FR;6;2021-01-02;0;0;0;0;0;0;0;0;0;0;0;0;0;0;0;0;0;0
FR;6;2021-01-03;0;0;0;0;0;0;0;0;0;0;0;0;0;0;0;0;0;0
FR;6;2021-01-04;0;0;0;0;0;0;0;0;0;0;0;0;0;0;0;0;0;0
FR;6;2021-01-05;0;0;0;0;0;0;0;0;0;0;0;0;0;0;0;0;0;0
FR;6;2021-01-06;0;0;0;0;0;0;0;0;0;0;0;0;0;0;0;0;0;0
FR;6;2021-01-07;0;0;0;0;0;0;0;0;0;0;0;0;0;0;0;0;0;0
FR;6;2021-01-08;0;0;0;0;0;0;0;0;0;0;0;0;0;0;0;0;0;0
FR;6;2021-01-09;0;0;0;0;0;0;0;0;0;0;0;0;0;0;0;0;0;0
FR;6;2021-01-10;0;0;0;0;0;0;0;0;0;0;0;0;0;0;0;0;0;0
FR;6;2021-01-11;0;0;0;0;0;0;0;0;0;0;0;0;0;0;0;0;0;0
FR;6;2021-01-12;0;0;0;0;0;0;0;0;0;0;0;0;0;0;0;0;0;0
FR;6;2021-01-13;0;0;0;0;0;0;0;0;0;0;0;0;0;0;0;0;0;0
FR;6;2021-01-14;0;0;0;0;0;0;0;0;0;0;0;0;0;0;0;0;0;0
FR;6;2021-01-15;0;0;0;0;0;0;0;0;0;0;0;0;0;0;0;0;0;0
FR;6;2021-01-16;0;0;0;0;0;0;0;0;0;0;0;0;0;0;0;0;0;0
FR;6;2021-01-17;0;0;0;0;0;0;0;0;0;0;0;0;0;0;0;0;0;0
FR;6;2021-01-18;0;0;0;0;0;0;0;0;0;0;0;0;0;0;0;0;0;0
FR;6;2021-01-19;0;0;0;0;0;0;0;0;0;0;0;0;0;0;0;0;0;0
FR;6;2021-01-20;0;0;0;0;0;0;0;0;0;0;0;0;0;0;0;0;0;0
FR;6;2021-01-21;0;0;0;0;0;0;0;0;0;0;0;0;0;0;0;0;0;0
FR;6;2021-01-22;0;0;0;0;0;0;0;0;0;0;0;0;0;0;0;0;0;0
FR;6;2021-01-23;0;0;0;0;0;0;0;0;0;0;0;0;0;0;0;0;0;0
FR;6;2021-01-24;0;0;0;0;0;0;0;0;0;0;0;0;0;0;0;0;0;0
FR;6;2021-01-25;0;0;0;0;0;0;0;0;0;0;0;0;0;0;0;0;0;0
FR;6;2021-01-26;0;0;0;0;0;0;0;0;0;0;0;0;0;0;0;0;0;0
FR;6;2021-01-27;0;0;0;0;0;0;0;0;0;0;0;0;0;0;0;0;0;0
FR;6;2021-01-28;0;0;0;0;0;0;0;0;0;0;0;0;0;0;0;0;0;0
FR;6;2021-01-29;0;0;0;0;0;0;0;0;0;0;0;0;0;0;0;0;0;0
FR;6;2021-01-30;0;0;0;0;0;0;0;0;0;0;0;0;0;0;0;0;0;0
FR;6;2021-01-31;0;0;0;0;0;0;0;0;0;0;0;0;0;0;0;0;0;0
FR;6;2021-02-01;0;0;0;0;0;0;0;0;0;0;0;0;0;0;0;0;0;0
FR;6;2021-02-02;0;0;0;0;0;0;0;0;0;0;0;0;0;0;0;0;0;0
FR;6;2021-02-03;0;0;0;0;0;0;0;0;0;0;0;0;0;0;0;0;0;0
FR;6;2021-02-04;0;0;0;0;0;0;0;0;0;0;0;0;0;0;0;0;0;0
FR;6;2021-02-05;0;0;0;0;0;0;0;0;0;0;0;0;0;0;0;0;0;0
FR;6;2021-02-06;0;0;0;0;0;0;0;0;0;0;0;0;0;0;0;0;0;0
FR;6;2021-02-07;0;0;0;0;0;0;0;0;0;0;0;0;0;0;0;0;0;0
FR;6;2021-02-08;0;0;0;0;0;0;0;0;0;0;0;0;0;0;0;0;0;0
FR;6;2021-02-09;0;0;0;0;0;0;0;0;0;0;0;0;0;0;0;0;0;0
FR;6;2021-02-10;0;0;0;0;0;0;0;0;0;0;0;0;0;0;0;0;0;0
FR;6;2021-02-11;0;0;0;0;0;0;0;0;0;0;0;0;0;0;0;0;0;0
FR;6;2021-02-12;0;0;0;0;0;0;0;0;0;0;0;0;0;0;0;0;0;0
FR;6;2021-02-13;0;0;0;0;0;0;0;0;0;0;0;0;0;0;0;0;0;0
FR;6;2021-02-14;0;0;0;0;0;0;0;0;0;0;0;0;0;0;0;0;0;0
FR;6;2021-02-15;0;0;0;0;0;0;0;0;0;0;0;0;0;0;0;0;0;0
FR;6;2021-02-16;0;0;0;0;0;0;0;0;0;0;0;0;0;0;0;0;0;0
FR;6;2021-02-17;0;0;0;0;0;0;0;0;0;0;0;0;0;0;0;0;0;0
FR;6;2021-02-18;0;0;0;0;0;0;0;0;0;0;0;0;0;0;0;0;0;0
FR;6;2021-02-19;0;0;0;0;0;0;0;0;0;0;0;0;0;0;0;0;0;0
FR;6;2021-02-20;0;0;0;0;0;0;0;0;0;0;0;0;0;0;0;0;0;0
FR;6;2021-02-21;0;0;0;0;0;0;0;0;0;0;0;0;0;0;0;0;0;0
FR;6;2021-02-22;0;0;0;0;0;0;0;0;0;0;0;0;0;0;0;0;0;0
FR;6;2021-02-23;0;0;0;0;0;0;0;0;0;0;0;0;0;0;0;0;0;0
FR;6;2021-02-24;0;0;0;0;0;0;0;0;0;0;0;0;0;0;0;0;0;0
FR;6;2021-02-25;0;0;0;0;0;0;0;0;0;0;0;0;0;0;0;0;0;0
FR;6;2021-02-26;0;0;0;0;0;0;0;0;0;0;0;0;0;0;0;0;0;0
FR;6;2021-02-27;0;0;0;0;0;0;0;0;0;0;0;0;0;0;0;0;0;0
FR;6;2021-02-28;0;0;0;0;0;0;0;0;0;0;0;0;0;0;0;0;0;0
FR;6;2021-03-01;0;0;0;0;0;0;0;0;0;0;0;0;0;0;0;0;0;0
FR;6;2021-03-02;0;0;0;0;0;0;0;0;0;0;0;0;0;0;0;0;0;0
FR;6;2021-03-03;0;0;0;0;0;0;0;0;0;0;0;0;0;0;0;0;0;0
FR;6;2021-03-04;0;0;0;0;0;0;0;0;0;0;0;0;0;0;0;0;0;0
FR;6;2021-03-05;0;0;0;0;0;0;0;0;0;0;0;0;0;0;0;0;0;0
FR;6;2021-03-06;0;0;0;0;0;0;0;0;0;0;0;0;0;0;0;0;0;0
FR;6;2021-03-07;0;0;0;0;0;0;0;0;0;0;0;0;0;0;0;0;0;0
FR;6;2021-03-08;0;0;0;0;0;0;0;0;0;0;0;0;0;0;0;0;0;0
FR;6;2021-03-09;0;0;0;0;0;0;0;0;0;0;0;0;0;0;0;0;0;0
FR;6;2021-03-10;0;0;0;0;0;0;0;0;0;0;0;0;0;0;0;0;0;0
FR;6;2021-03-11;0;0;0;0;0;0;0;0;0;0;0;0;0;0;0;0;0;0
FR;6;2021-03-12;0;0;0;0;0;0;0;0;0;0;0;0;0;0;0;0;0;0
FR;6;2021-03-13;0;0;0;0;0;0;0;0;0;0;0;0;0;0;0;0;0;0
FR;6;2021-03-14;0;0;0;0;0;0;0;0;0;0;0;0;0;0;0;0;0;0
FR;6;2021-03-15;0;0;0;0;0;0;0;0;0;0;0;0;0;0;0;0;0;0
FR;6;2021-03-16;0;0;0;0;0;0;0;0;0;0;0;0;0;0;0;0;0;0
FR;6;2021-03-17;0;0;0;0;0;0;0;0;0;0;0;0;0;0;0;0;0;0
FR;6;2021-03-18;0;0;0;0;0;0;0;0;0;0;0;0;0;0;0;0;0;0
FR;6;2021-03-19;0;0;0;0;0;0;0;0;0;0;0;0;0;0;0;0;0;0
FR;6;2021-03-20;0;0;0;0;0;0;0;0;0;0;0;0;0;0;0;0;0;0
FR;6;2021-03-21;0;0;0;0;0;0;0;0;0;0;0;0;0;0;0;0;0;0
FR;6;2021-03-22;0;0;0;0;0;0;0;0;0;0;0;0;0;0;0;0;0;0
FR;6;2021-03-23;0;0;0;0;0;0;0;0;0;0;0;0;0;0;0;0;0;0
FR;6;2021-03-24;0;0;0;0;0;0;0;0;0;0;0;0;0;0;0;0;0;0
FR;6;2021-03-25;0;0;0;0;0;0;0;0;0;0;0;0;0;0;0;0;0;0
FR;6;2021-03-26;0;0;0;0;0;0;0;0;0;0;0;0;0;0;0;0;0;0
FR;6;2021-03-27;0;0;0;0;0;0;0;0;0;0;0;0;0;0;0;0;0;0
FR;6;2021-03-28;0;0;0;0;0;0;0;0;0;0;0;0;0;0;0;0;0;0
FR;6;2021-03-29;0;0;0;0;0;0;0;0;0;0;0;0;0;0;0;0;0;0
FR;6;2021-03-30;0;0;0;0;0;0;0;0;0;0;0;0;0;0;0;0;0;0
FR;6;2021-03-31;0;0;0;0;0;0;0;0;0;0;0;0;0;0;0;0;0;0
FR;6;2021-04-01;0;0;0;0;0;0;0;0;0;0;0;0;0;0;0;0;0;0
FR;6;2021-04-02;0;0;0;0;0;0;0;0;0;0;0;0;0;0;0;0;0;0
FR;6;2021-04-03;0;0;0;0;0;0;0;0;0;0;0;0;0;0;0;0;0;0
FR;6;2021-04-04;0;0;0;0;0;0;0;0;0;0;0;0;0;0;0;0;0;0
FR;6;2021-04-05;0;0;0;0;0;0;0;0;0;0;0;0;0;0;0;0;0;0
FR;6;2021-04-06;0;0;0;0;0;0;0;0;0;0;0;0;0;0;0;0;0;0
FR;6;2021-04-07;0;0;0;0;0;0;0;0;0;0;0;0;0;0;0;0;0;0
FR;6;2021-04-08;0;0;0;0;0;0;0;0;0;0;0;0;0;0;0;0;0;0
FR;6;2021-04-09;0;0;0;0;0;0;0;0;0;0;0;0;0;0;0;0;0;0
FR;6;2021-04-10;0;0;0;0;0;0;0;0;0;0;0;0;0;0;0;0;0;0
FR;6;2021-04-11;0;0;0;0;0;0;0;0;0;0;0;0;0;0;0;0;0;0
FR;6;2021-04-12;0;0;0;0;0;0;0;0;0;0;0;0;0;0;0;0;0;0
FR;6;2021-04-13;0;0;0;0;0;0;0;0;0;0;0;0;0;0;0;0;0;0
FR;6;2021-04-14;0;0;0;0;0;0;0;0;0;0;0;0;0;0;0;0;0;0
FR;6;2021-04-15;0;0;0;0;0;0;0;0;0;0;0;0;0;0;0;0;0;0
FR;6;2021-04-16;0;0;0;0;0;0;0;0;0;0;0;0;0;0;0;0;0;0
FR;6;2021-04-17;0;0;0;0;0;0;0;0;0;0;0;0;0;0;0;0;0;0
FR;6;2021-04-18;0;0;0;0;0;0;0;0;0;0;0;0;0;0;0;0;0;0
FR;6;2021-04-19;0;0;0;0;0;0;0;0;0;0;0;0;0;0;0;0;0;0
FR;6;2021-04-20;0;0;0;0;0;0;0;0;0;0;0;0;0;0;0;0;0;0
FR;6;2021-04-21;0;0;0;0;0;0;0;0;0;0;0;0;0;0;0;0;0;0
FR;6;2021-04-22;0;0;0;0;0;0;0;0;0;0;0;0;0;0;0;0;0;0
FR;6;2021-04-23;0;0;0;0;0;0;0;0;0;0;0;0;0;0;0;0;0;0
FR;6;2021-04-24;0;0;0;0;0;0;0;0;0;0;0;0;0;0;0;0;0;0
FR;6;2021-04-25;0;0;0;0;0;0;0;0;0;0;0;0;0;0;0;0;0;0
FR;6;2021-04-26;0;0;0;0;0;0;0;0;0;0;0;0;0;0;0;0;0;0
FR;6;2021-04-27;0;0;0;0;0;0;0;0;0;0;0;0;0;0;0;0;0;0
FR;6;2021-04-28;0;0;0;0;0;0;0;0;0;0;0;0;0;0;0;0;0;0
FR;6;2021-04-29;0;0;0;0;0;0;0;0;0;0;0;0;0;0;0;0;0;0
FR;6;2021-04-30;0;0;0;0;0;0;0;0;0;0;0;0;0;0;0;0;0;0
FR;6;2021-05-01;0;0;0;0;0;0;0;0;0;0;0;0;0;0;0;0;0;0
FR;6;2021-05-02;0;0;0;0;0;0;0;0;0;0;0;0;0;0;0;0;0;0
FR;6;2021-05-03;0;0;0;0;0;0;0;0;0;0;0;0;0;0;0;0;0;0
FR;6;2021-05-04;0;0;0;0;0;0;0;0;0;0;0;0;0;0;0;0;0;0
FR;6;2021-05-05;0;0;0;0;0;0;0;0;0;0;0;0;0;0;0;0;0;0
FR;6;2021-05-06;0;0;0;0;0;0;0;0;0;0;0;0;0;0;0;0;0;0
FR;6;2021-05-07;0;0;0;0;0;0;0;0;0;0;0;0;0;0;0;0;0;0
FR;6;2021-05-08;0;0;0;0;0;0;0;0;0;0;0;0;0;0;0;0;0;0
FR;6;2021-05-09;0;0;0;0;0;0;0;0;0;0;0;0;0;0;0;0;0;0
FR;6;2021-05-10;0;0;0;0;0;0;0;0;0;0;0;0;0;0;0;0;0;0
FR;6;2021-05-11;0;0;0;0;0;0;0;0;0;0;0;0;0;0;0;0;0;0
FR;6;2021-05-12;0;0;0;0;0;0;0;0;0;0;0;0;0;0;0;0;0;0
FR;6;2021-05-13;0;0;0;0;0;0;0;0;0;0;0;0;0;0;0;0;0;0
FR;6;2021-05-14;0;0;0;0;0;0;0;0;0;0;0;0;0;0;0;0;0;0
FR;6;2021-05-15;0;0;0;0;0;0;0;0;0;0;0;0;0;0;0;0;0;0
FR;6;2021-05-16;0;0;0;0;0;0;0;0;0;0;0;0;0;0;0;0;0;0
FR;6;2021-05-17;0;0;0;0;0;0;0;0;0;0;0;0;0;0;0;0;0;0
FR;6;2021-05-18;0;0;0;0;0;0;0;0;0;0;0;0;0;0;0;0;0;0
FR;6;2021-05-19;0;0;0;0;0;0;0;0;0;0;0;0;0;0;0;0;0;0
FR;6;2021-05-20;0;0;0;0;0;0;0;0;0;0;0;0;0;0;0;0;0;0
FR;6;2021-05-21;0;0;0;0;0;0;0;0;0;0;0;0;0;0;0;0;0;0
FR;6;2021-05-22;0;0;0;0;0;0;0;0;0;0;0;0;0;0;0;0;0;0
FR;6;2021-05-23;0;0;0;0;0;0;0;0;0;0;0;0;0;0;0;0;0;0
FR;6;2021-05-24;0;0;0;0;0;0;0;0;0;0;0;0;0;0;0;0;0;0
FR;6;2021-05-25;0;0;0;0;0;0;0;0;0;0;0;0;0;0;0;0;0;0
FR;6;2021-05-26;0;0;0;0;0;0;0;0;0;0;0;0;0;0;0;0;0;0
FR;6;2021-05-27;0;0;0;0;0;0;0;0;0;0;0;0;0;0;0;0;0;0
FR;6;2021-05-28;0;0;0;0;0;0;0;0;0;0;0;0;0;0;0;0;0;0
FR;6;2021-05-29;0;0;0;0;0;0;0;0;0;0;0;0;0;0;0;0;0;0
FR;6;2021-05-30;0;0;0;0;0;0;0;0;0;0;0;0;0;0;0;0;0;0
FR;6;2021-05-31;0;0;0;0;0;0;0;0;0;0;0;0;0;0;0;0;0;0
FR;6;2021-06-01;0;0;0;0;0;0;0;0;0;0;0;0;0;0;0;0;0;0
FR;6;2021-06-02;0;0;0;0;0;0;0;0;0;0;0;0;0;0;0;0;0;0
FR;6;2021-06-03;0;0;0;0;0;0;0;0;0;0;0;0;0;0;0;0;0;0
FR;6;2021-06-04;0;0;0;0;0;0;0;0;0;0;0;0;0;0;0;0;0;0
FR;6;2021-06-05;0;0;0;0;0;0;0;0;0;0;0;0;0;0;0;0;0;0
FR;6;2021-06-06;0;0;0;0;0;0;0;0;0;0;0;0;0;0;0;0;0;0
FR;6;2021-06-07;0;0;0;0;0;0;0;0;0;0;0;0;0;0;0;0;0;0
FR;6;2021-06-08;0;0;0;0;0;0;0;0;0;0;0;0;0;0;0;0;0;0
FR;6;2021-06-09;0;0;0;0;0;0;0;0;0;0;0;0;0;0;0;0;0;0
FR;6;2021-06-10;0;0;0;0;0;0;0;0;0;0;0;0;0;0;0;0;0;0
FR;6;2021-06-11;0;0;0;0;0;0;0;0;0;0;0;0;0;0;0;0;0;0
FR;6;2021-06-12;0;0;0;0;0;0;0;0;0;0;0;0;0;0;0;0;0;0
FR;6;2021-06-13;0;0;0;0;0;0;0;0;0;0;0;0;0;0;0;0;0;0
FR;6;2021-06-14;0;0;0;0;0;0;0;0;0;0;0;0;0;0;0;0;0;0
FR;6;2021-06-15;0;0;0;0;0;0;0;0;0;0;0;0;0;0;0;0;0;0
FR;6;2021-06-16;0;0;0;0;0;0;0;0;0;0;0;0;0;0;0;0;0;0
FR;6;2021-06-17;0;0;0;0;0;0;0;0;0;0;0;0;0;0;0;0;0;0
FR;6;2021-06-18;0;0;0;0;0;0;0;0;0;0;0;0;0;0;0;0;0;0
FR;6;2021-06-19;0;0;0;0;0;0;0;0;0;0;0;0;0;0;0;0;0;0
FR;6;2021-06-20;0;0;0;0;0;0;0;0;0;0;0;0;0;0;0;0;0;0
FR;6;2021-06-21;0;0;0;0;0;0;0;0;0;0;0;0;0;0;0;0;0;0
FR;6;2021-06-22;0;0;0;0;0;0;0;0;0;0;0;0;0;0;0;0;0;0
FR;6;2021-06-23;0;0;0;0;0;0;0;0;0;0;0;0;0;0;0;0;0;0
FR;6;2021-06-24;0;0;0;0;0;0;0;0;0;0;0;0;0;0;0;0;0;0
FR;6;2021-06-25;0;0;0;0;0;0;0;0;0;0;0;0;0;0;0;0;0;0
FR;6;2021-06-26;0;0;0;0;0;0;0;0;0;0;0;0;0;0;0;0;0;0
FR;6;2021-06-27;0;0;0;0;0;0;0;0;0;0;0;0;0;0;0;0;0;0
FR;6;2021-06-28;0;0;0;0;0;0;0;0;0;0;0;0;0;0;0;0;0;0
FR;6;2021-06-29;0;0;0;0;0;0;0;0;0;0;0;0;0;0;0;0;0;0
FR;6;2021-06-30;0;0;0;0;0;0;0;0;0;0;0;0;0;0;0;0;0;0
FR;6;2021-07-01;0;0;0;0;0;0;0;0;0;0;0;0;0;0;0;0;0;0
FR;6;2021-07-02;0;0;0;0;0;0;0;0;0;0;0;0;0;0;0;0;0;0
FR;6;2021-07-03;0;0;0;0;0;0;0;0;0;0;0;0;0;0;0;0;0;0
FR;6;2021-07-04;0;0;0;0;0;0;0;0;0;0;0;0;0;0;0;0;0;0
FR;6;2021-07-05;0;0;0;0;0;0;0;0;0;0;0;0;0;0;0;0;0;0
FR;6;2021-07-06;0;0;0;0;0;0;0;0;0;0;0;0;0;0;0;0;0;0
FR;6;2021-07-07;0;0;0;0;0;0;0;0;0;0;0;0;0;0;0;0;0;0
FR;6;2021-07-08;0;0;0;0;0;0;0;0;0;0;0;0;0;0;0;0;0;0
FR;6;2021-07-09;0;0;0;0;0;0;0;0;0;0;0;0;0;0;0;0;0;0
FR;6;2021-07-10;0;0;0;0;0;0;0;0;0;0;0;0;0;0;0;0;0;0
FR;6;2021-07-11;0;0;0;0;0;0;0;0;0;0;0;0;0;0;0;0;0;0
FR;6;2021-07-12;0;0;0;0;0;0;0;0;0;0;0;0;0;0;0;0;0;0
FR;6;2021-07-13;0;0;0;0;0;0;0;0;0;0;0;0;0;0;0;0;0;0
FR;6;2021-07-14;0;0;0;0;0;0;0;0;0;0;0;0;0;0;0;0;0;0
FR;6;2021-07-15;0;0;0;0;0;0;0;0;0;0;0;0;0;0;0;0;0;0
FR;6;2021-07-16;0;0;0;0;0;0;0;0;0;0;0;0;0;0;0;0;0;0
FR;6;2021-07-17;0;0;0;0;0;0;0;0;0;0;0;0;0;0;0;0;0;0
FR;6;2021-07-18;0;0;0;0;0;0;0;0;0;0;0;0;0;0;0;0;0;0
FR;6;2021-07-19;0;0;0;0;0;0;0;0;0;0;0;0;0;0;0;0;0;0
FR;6;2021-07-20;0;0;0;0;0;0;0;0;0;0;0;0;0;0;0;0;0;0
FR;6;2021-07-21;0;0;0;0;0;0;0;0;0;0;0;0;0;0;0;0;0;0
FR;6;2021-07-22;0;0;0;0;0;0;0;0;0;0;0;0;0;0;0;0;0;0
FR;6;2021-07-23;0;0;0;0;0;0;0;0;0;0;0;0;0;0;0;0;0;0
FR;6;2021-07-24;0;0;0;0;0;0;0;0;0;0;0;0;0;0;0;0;0;0
FR;6;2021-07-25;0;0;0;0;0;0;0;0;0;0;0;0;0;0;0;0;0;0
FR;6;2021-07-26;0;0;0;0;0;0;0;0;0;0;0;0;0;0;0;0;0;0
FR;6;2021-07-27;0;0;0;0;0;0;0;0;0;0;0;0;0;0;0;0;0;0
FR;6;2021-07-28;0;0;0;0;0;0;0;0;0;0;0;0;0;0;0;0;0;0
FR;6;2021-07-29;0;0;0;0;0;0;0;0;0;0;0;0;0;0;0;0;0;0
FR;6;2021-07-30;0;0;0;0;0;0;0;0;0;0;0;0;0;0;0;0;0;0
FR;6;2021-07-31;0;0;0;0;0;0;0;0;0;0;0;0;0;0;0;0;0;0
FR;6;2021-08-01;0;0;0;0;0;0;0;0;0;0;0;0;0;0;0;0;0;0
FR;6;2021-08-02;0;0;0;0;0;0;0;0;0;0;0;0;0;0;0;0;0;0
FR;6;2021-08-03;0;0;0;0;0;0;0;0;0;0;0;0;0;0;0;0;0;0
FR;6;2021-08-04;0;0;0;0;0;0;0;0;0;0;0;0;0;0;0;0;0;0
FR;6;2021-08-05;0;0;0;0;0;0;0;0;0;0;0;0;0;0;0;0;0;0
FR;6;2021-08-06;0;0;0;0;0;0;0;0;0;0;0;0;0;0;0;0;0;0
FR;6;2021-08-07;0;0;0;0;0;0;0;0;0;0;0;0;0;0;0;0;0;0
FR;6;2021-08-08;0;0;0;0;0;0;0;0;0;0;0;0;0;0;0;0;0;0
FR;6;2021-08-09;0;0;0;0;0;0;0;0;0;0;0;0;0;0;0;0;0;0
FR;6;2021-08-10;0;0;0;0;0;0;0;0;0;0;0;0;0;0;0;0;0;0
FR;6;2021-08-11;0;0;0;0;0;0;0;0;0;0;0;0;0;0;0;0;0;0
FR;6;2021-08-12;0;0;0;0;0;0;0;0;0;0;0;0;0;0;0;0;0;0
FR;6;2021-08-13;0;0;0;0;0;0;0;0;0;0;0;0;0;0;0;0;0;0
FR;6;2021-08-14;0;0;0;0;0;0;0;0;0;0;0;0;0;0;0;0;0;0
FR;6;2021-08-15;0;0;0;0;0;0;0;0;0;0;0;0;0;0;0;0;0;0
FR;6;2021-08-16;0;0;0;0;0;0;0;0;0;0;0;0;0;0;0;0;0;0
FR;6;2021-08-17;0;0;0;0;0;0;0;0;0;0;0;0;0;0;0;0;0;0
FR;6;2021-08-18;0;0;0;0;0;0;0;0;0;0;0;0;0;0;0;0;0;0
FR;6;2021-08-19;0;0;0;0;0;0;0;0;0;0;0;0;0;0;0;0;0;0
FR;6;2021-08-20;0;0;0;0;0;0;0;0;0;0;0;0;0;0;0;0;0;0
FR;6;2021-08-21;0;0;0;0;0;0;0;0;0;0;0;0;0;0;0;0;0;0
FR;6;2021-08-22;0;0;0;0;0;0;0;0;0;0;0;0;0;0;0;0;0;0
FR;6;2021-08-23;0;0;0;0;0;0;0;0;0;0;0;0;0;0;0;0;0;0
FR;6;2021-08-24;0;0;0;0;0;0;0;0;0;0;0;0;0;0;0;0;0;0
FR;6;2021-08-25;0;0;0;0;0;0;0;0;0;0;0;0;0;0;0;0;0;0
FR;6;2021-08-26;0;0;0;0;0;0;0;0;0;0;0;0;0;0;0;0;0;0
FR;6;2021-08-27;0;0;0;0;0;0;0;0;0;0;0;0;0;0;0;0;0;0
FR;6;2021-08-28;0;0;0;0;0;0;0;0;0;0;0;0;0;0;0;0;0;0
FR;6;2021-08-29;0;0;0;0;0;0;0;0;0;0;0;0;0;0;0;0;0;0
FR;6;2021-08-30;0;0;0;0;0;0;0;0;0;0;0;0;0;0;0;0;0;0
FR;6;2021-08-31;0;0;0;0;0;0;0;0;0;0;0;0;0;0;0;0;0;0
FR;6;2021-09-01;0;0;0;0;0;0;0;0;0;0;0;0;0;0;0;0;0;0
FR;6;2021-09-02;0;0;0;0;0;0;0;0;0;0;0;0;0;0;0;0;0;0
FR;6;2021-09-03;0;0;0;0;0;0;0;0;0;0;0;0;0;0;0;0;0;0
FR;6;2021-09-04;0;0;0;0;0;0;0;0;0;0;0;0;0;0;0;0;0;0
FR;6;2021-09-05;0;0;0;0;0;0;0;0;0;0;0;0;0;0;0;0;0;0
FR;6;2021-09-06;0;0;0;0;0;0;0;0;0;0;0;0;0;0;0;0;0;0
FR;6;2021-09-07;0;0;0;0;0;0;0;0;0;0;0;0;0;0;0;0;0;0
FR;6;2021-09-08;0;0;0;0;0;0;0;0;0;0;0;0;0;0;0;0;0;0
FR;6;2021-09-09;0;0;0;0;0;0;0;0;0;0;0;0;0;0;0;0;0;0
FR;6;2021-09-10;0;0;0;0;0;0;0;0;0;0;0;0;0;0;0;0;0;0
FR;6;2021-09-11;0;0;0;0;0;0;0;0;0;0;0;0;0;0;0;0;0;0
FR;6;2021-09-12;0;0;0;0;0;0;0;0;0;0;0;0;0;0;0;0;0;0
FR;6;2021-09-13;0;0;0;0;0;0;0;0;0;0;0;0;0;0;0;0;0;0
FR;6;2021-09-14;0;0;0;0;0;0;0;0;0;0;0;0;0;0;0;0;0;0
FR;6;2021-09-15;0;0;0;0;0;0;0;0;0;0;0;0;0;0;0;0;0;0
FR;6;2021-09-16;0;0;0;0;0;0;0;0;0;0;0;0;0;0;0;0;0;0
FR;6;2021-09-17;0;0;0;0;0;0;0;0;0;0;0;0;0;0;0;0;0;0
FR;6;2021-09-18;0;0;0;0;0;0;0;0;0;0;0;0;0;0;0;0;0;0
FR;6;2021-09-19;0;0;0;0;0;0;0;0;0;0;0;0;0;0;0;0;0;0
FR;6;2021-09-20;0;0;0;0;0;0;0;0;0;0;0;0;0;0;0;0;0;0
FR;6;2021-09-21;0;0;0;0;0;0;0;0;0;0;0;0;0;0;0;0;0;0
FR;6;2021-09-22;0;0;0;0;0;0;0;0;0;0;0;0;0;0;0;0;0;0
FR;6;2021-09-23;0;0;0;0;0;0;0;0;0;0;0;0;0;0;0;0;0;0
FR;6;2021-09-24;0;0;0;0;0;0;0;0;0;0;0;0;0;0;0;0;0;0
FR;6;2021-09-25;0;0;0;0;0;0;0;0;0;0;0;0;0;0;0;0;0;0
FR;6;2021-09-26;0;0;0;0;0;0;0;0;0;0;0;0;0;0;0;0;0;0
FR;6;2021-09-27;0;0;0;0;0;0;0;0;0;0;0;0;0;0;0;0;0;0
FR;6;2021-09-28;0;0;0;0;0;0;0;0;0;0;0;0;0;0;0;0;0;0
FR;6;2021-09-29;0;0;0;0;0;0;0;0;0;0;0;0;0;0;0;0;0;0
FR;6;2021-09-30;0;0;0;0;0;0;0;0;0;0;0;0;0;0;0;0;0;0
FR;6;2021-10-01;0;0;0;0;0;0;0;0;0;0;0;0;0;0;0;0;0;0
FR;6;2021-10-02;0;0;0;0;0;0;0;0;0;0;0;0;0;0;0;0;0;0
FR;6;2021-10-03;0;0;0;0;0;0;0;0;0;0;0;0;0;0;0;0;0;0
FR;6;2021-10-04;0;0;0;0;0;0;0;0;0;0;0;0;0;0;0;0;0;0
FR;6;2021-10-05;0;0;0;0;0;0;0;0;0;0;0;0;0;0;0;0;0;0
FR;6;2021-10-06;0;0;0;0;0;0;0;0;0;0;0;0;0;0;0;0;0;0
FR;6;2021-10-07;0;0;0;0;0;0;0;0;0;0;0;0;0;0;0;0;0;0
FR;6;2021-10-08;0;0;0;0;0;0;0;0;0;0;0;0;0;0;0;0;0;0
FR;6;2021-10-09;0;0;0;0;0;0;0;0;0;0;0;0;0;0;0;0;0;0
FR;6;2021-10-10;0;0;0;0;0;0;0;0;0;0;0;0;0;0;0;0;0;0
FR;6;2021-10-11;0;0;0;0;0;0;0;0;0;0;0;0;0;0;0;0;0;0
FR;6;2021-10-12;0;0;0;0;0;0;0;0;0;0;0;0;0;0;0;0;0;0
FR;6;2021-10-13;0;0;0;0;0;0;0;0;0;0;0;0;0;0;0;0;0;0
FR;6;2021-10-14;0;0;0;0;0;0;0;0;0;0;0;0;0;0;0;0;0;0
FR;6;2021-10-15;0;0;0;0;0;0;0;0;0;0;0;0;0;0;0;0;0;0
FR;6;2021-10-16;0;0;0;0;0;0;0;0;0;0;0;0;0;0;0;0;0;0
FR;6;2021-10-17;0;0;0;0;0;0;0;0;0;0;0;0;0;0;0;0;0;0
FR;6;2021-10-18;0;0;0;0;0;0;0;0;0;0;0;0;0;0;0;0;0;0
FR;6;2021-10-19;0;0;0;0;0;0;0;0;0;0;0;0;0;0;0;0;0;0
FR;6;2021-10-20;0;0;0;0;0;0;0;0;0;0;0;0;0;0;0;0;0;0
FR;6;2021-10-21;0;0;0;0;0;0;0;0;0;0;0;0;0;0;0;0;0;0
FR;6;2021-10-22;0;0;0;0;0;0;0;0;0;0;0;0;0;0;0;0;0;0
FR;6;2021-10-23;0;0;0;0;0;0;0;0;0;0;0;0;0;0;0;0;0;0
FR;6;2021-10-24;0;0;0;0;0;0;0;0;0;0;0;0;0;0;0;0;0;0
FR;6;2021-10-25;0;0;0;0;0;0;0;0;0;0;0;0;0;0;0;0;0;0
FR;6;2021-10-26;0;0;0;0;0;0;0;0;0;0;0;0;0;0;0;0;0;0
FR;6;2021-10-27;0;0;0;0;0;0;0;0;0;0;0;0;0;0;0;0;0;0
FR;6;2021-10-28;0;0;0;0;0;0;0;0;0;0;0;0;0;0;0;0;0;0
FR;6;2021-10-29;0;0;0;0;0;0;0;0;0;0;0;0;0;0;0;0;0;0
FR;6;2021-10-30;0;0;0;0;0;0;0;0;0;0;0;0;0;0;0;0;0;0
FR;6;2021-10-31;0;0;0;0;0;0;0;0;0;0;0;0;0;0;0;0;0;0
FR;6;2021-11-01;0;0;0;0;0;0;0;0;0;0;0;0;0;0;0;0;0;0
FR;6;2021-11-02;0;0;0;0;0;0;0;0;0;0;0;0;0;0;0;0;0;0
FR;6;2021-11-03;0;0;0;0;0;0;0;0;0;0;0;0;0;0;0;0;0;0
FR;6;2021-11-04;0;0;0;0;0;0;0;0;0;0;0;0;0;0;0;0;0;0
FR;6;2021-11-05;0;0;0;0;0;0;0;0;0;0;0;0;0;0;0;0;0;0
FR;6;2021-11-06;0;0;0;0;0;0;0;0;0;0;0;0;0;0;0;0;0;0
FR;6;2021-11-07;0;0;0;0;0;0;0;0;0;0;0;0;0;0;0;0;0;0
FR;6;2021-11-08;0;0;0;0;0;0;0;0;0;0;0;0;0;0;0;0;0;0
FR;6;2021-11-09;0;0;0;0;0;0;0;0;0;0;0;0;0;0;0;0;0;0
FR;6;2021-11-10;0;0;0;0;0;0;0;0;0;0;0;0;0;0;0;0;0;0
FR;6;2021-11-11;0;0;0;0;0;0;0;0;0;0;0;0;0;0;0;0;0;0
FR;6;2021-11-12;0;0;0;0;0;0;0;0;0;0;0;0;0;0;0;0;0;0
FR;6;2021-11-13;0;0;0;0;0;0;0;0;0;0;0;0;0;0;0;0;0;0
FR;6;2021-11-14;0;0;0;0;0;0;0;0;0;0;0;0;0;0;0;0;0;0
FR;6;2021-11-15;0;0;0;0;0;0;0;0;0;0;0;0;0;0;0;0;0;0
FR;6;2021-11-16;0;0;0;0;0;0;0;0;0;0;0;0;0;0;0;0;0;0
FR;6;2021-11-17;0;0;0;0;0;0;0;0;0;0;0;0;0;0;0;0;0;0
FR;6;2021-11-18;0;0;0;0;0;0;0;0;0;0;0;0;0;0;0;0;0;0
FR;6;2021-11-19;0;0;0;0;0;0;0;0;0;0;0;0;0;0;0;0;0;0
FR;6;2021-11-20;0;0;0;0;0;0;0;0;0;0;0;0;0;0;0;0;0;0
FR;6;2021-11-21;0;0;0;0;0;0;0;0;0;0;0;0;0;0;0;0;0;0
FR;6;2021-11-22;0;0;0;0;0;0;0;0;0;0;0;0;0;0;0;0;0;0
FR;6;2021-11-23;0;0;0;0;0;0;0;0;0;0;0;0;0;0;0;0;0;0
FR;6;2021-11-24;0;0;0;0;0;0;0;0;0;0;0;0;0;0;0;0;0;0
FR;6;2021-11-25;0;0;0;0;0;0;0;0;0;0;0;0;0;0;0;0;0;0
FR;6;2021-11-26;0;0;0;0;0;0;0;0;0;0;0;0;0;0;0;0;0;0
FR;6;2021-11-27;0;0;0;0;0;0;0;0;0;0;0;0;0;0;0;0;0;0
FR;6;2021-11-28;0;0;0;0;0;0;0;0;0;0;0;0;0;0;0;0;0;0
FR;6;2021-11-29;0;0;0;0;0;0;0;0;0;0;0;0;0;0;0;0;0;0
FR;6;2021-11-30;0;0;0;0;0;0;0;0;0;0;0;0;0;0;0;0;0;0
FR;6;2021-12-01;0;0;0;0;0;0;0;0;0;0;0;0;0;0;0;0;0;0
FR;6;2021-12-02;0;0;0;0;0;0;0;0;0;0;0;0;0;0;0;0;0;0
FR;6;2021-12-03;0;0;0;0;0;0;0;0;0;0;0;0;0;0;0;0;0;0
FR;6;2021-12-04;0;0;0;0;0;0;0;0;0;0;0;0;0;0;0;0;0;0
FR;6;2021-12-05;0;0;0;0;0;0;0;0;0;0;0;0;0;0;0;0;0;0
FR;6;2021-12-06;0;0;0;0;0;0;0;0;0;0;0;0;0;0;0;0;0;0
FR;6;2021-12-07;0;0;0;0;0;0;0;0;0;0;0;0;0;0;0;0;0;0
FR;6;2021-12-08;0;0;0;0;0;0;0;0;0;0;0;0;0;0;0;0;0;0
FR;6;2021-12-09;0;0;0;0;0;0;0;0;0;0;0;0;0;0;0;0;0;0
FR;6;2021-12-10;0;0;0;0;0;0;0;0;0;0;0;0;0;0;0;0;0;0
FR;6;2021-12-11;0;0;0;0;0;0;0;0;0;0;0;0;0;0;0;0;0;0
FR;6;2021-12-12;0;0;0;0;0;0;0;0;0;0;0;0;0;0;0;0;0;0
FR;6;2021-12-13;0;0;0;0;0;0;0;0;0;0;0;0;0;0;0;0;0;0
FR;6;2021-12-14;0;0;0;0;0;0;0;0;0;0;0;0;0;0;0;0;0;0
FR;6;2021-12-15;0;0;0;0;0;0;0;0;0;0;0;0;0;0;0;0;0;0
FR;6;2021-12-16;0;0;0;0;0;0;0;0;0;0;0;0;0;0;0;0;0;0
FR;6;2021-12-17;0;0;0;0;0;0;0;0;0;0;0;0;0;0;0;0;0;0
FR;6;2021-12-18;0;0;0;0;0;0;0;0;0;0;0;0;0;0;0;0;0;0
FR;6;2021-12-19;0;0;0;0;0;0;0;0;0;0;0;0;0;0;0;0;0;0
FR;6;2021-12-20;0;0;0;0;0;0;0;0;0;0;0;0;0;0;0;0;0;0
FR;6;2021-12-21;0;0;0;0;0;0;0;0;0;0;0;0;0;0;0;0;0;0
FR;6;2021-12-22;0;0;0;0;0;0;0;0;0;0;0;0;0;0;0;0;0;0
FR;6;2021-12-23;0;0;0;0;0;0;0;0;0;0;0;0;0;0;0;0;0;0
FR;6;2021-12-24;0;0;0;0;0;0;0;0;0;0;0;0;0;0;0;0;0;0
FR;6;2021-12-25;0;0;0;0;0;0;0;0;0;0;0;0;0;0;0;0;0;0
FR;6;2021-12-26;0;0;0;0;0;0;0;0;0;0;0;0;0;0;0;0;0;0
FR;6;2021-12-27;0;0;0;0;0;0;0;0;0;0;0;0;0;0;0;0;0;0
FR;6;2021-12-28;0;0;0;0;0;0;0;0;0;0;0;0;0;0;0;0;0;0
FR;6;2021-12-29;0;0;0;0;0;0;0;0;0;0;0;0;0;0;0;0;0;0
FR;6;2021-12-30;0;0;0;0;0;0;0;0;0;0;0;0;0;0;0;0;0;0
FR;6;2021-12-31;0;0;0;0;0;0;0;0;0;0;0;0;0;0;0;0;0;0
FR;6;2022-01-01;0;0;0;0;0;0;0;0;0;0;0;0;0;0;0;0;0;0
FR;6;2022-01-02;0;0;0;0;0;0;0;0;0;0;0;0;0;0;0;0;0;0
FR;6;2022-01-03;0;0;0;0;0;0;0;0;0;0;0;0;0;0;0;0;0;0
FR;6;2022-01-04;0;0;0;0;0;0;0;0;0;0;0;0;0;0;0;0;0;0
FR;6;2022-01-05;0;0;0;0;0;0;0;0;0;0;0;0;0;0;0;0;0;0
FR;6;2022-01-06;0;0;0;0;0;0;0;0;0;0;0;0;0;0;0;0;0;0
FR;6;2022-01-07;0;0;0;0;0;0;0;0;0;0;0;0;0;0;0;0;0;0
FR;6;2022-01-08;0;0;0;0;0;0;0;0;0;0;0;0;0;0;0;0;0;0
FR;6;2022-01-09;0;0;0;0;0;0;0;0;0;0;0;0;0;0;0;0;0;0
FR;6;2022-01-10;0;0;0;0;0;0;0;0;0;0;0;0;0;0;0;0;0;0
FR;6;2022-01-11;0;0;0;0;0;0;0;0;0;0;0;0;0;0;0;0;0;0
FR;6;2022-01-12;0;0;0;0;0;0;0;0;0;0;0;0;0;0;0;0;0;0
FR;6;2022-01-13;0;0;0;0;0;0;0;0;0;0;0;0;0;0;0;0;0;0
FR;6;2022-01-14;0;0;0;0;0;0;0;0;0;0;0;0;0;0;0;0;0;0
FR;6;2022-01-15;0;0;0;0;0;0;0;0;0;0;0;0;0;0;0;0;0;0
FR;6;2022-01-16;0;0;0;0;0;0;0;0;0;0;0;0;0;0;0;0;0;0
FR;6;2022-01-17;0;0;0;0;0;0;0;0;0;0;0;0;0;0;0;0;0;0
FR;6;2022-01-18;0;0;0;0;0;0;0;0;0;0;0;0;0;0;0;0;0;0
FR;6;2022-01-19;0;0;0;0;0;0;0;0;0;0;0;0;0;0;0;0;0;0
FR;6;2022-01-20;0;0;0;0;0;0;0;0;0;0;0;0;0;0;0;0;0;0
FR;6;2022-01-21;0;0;0;0;0;0;0;0;0;0;0;0;0;0;0;0;0;0
FR;6;2022-01-22;0;0;0;0;0;0;0;0;0;0;0;0;0;0;0;0;0;0
FR;6;2022-01-23;0;0;0;0;0;0;0;0;0;0;0;0;0;0;0;0;0;0
FR;6;2022-01-24;0;0;0;0;0;0;0;0;0;0;0;0;0;0;0;0;0;0
FR;6;2022-01-25;0;0;0;0;0;0;0;0;0;0;0;0;0;0;0;0;0;0
FR;6;2022-01-26;0;0;0;0;0;0;0;0;0;0;0;0;0;0;0;0;0;0
FR;6;2022-01-27;0;0;0;0;0;0;0;0;0;0;0;0;0;0;0;0;0;0
FR;6;2022-01-28;0;0;0;0;0;0;0;0;0;0;0;0;0;0;0;0;0;0
FR;6;2022-01-29;0;0;0;0;0;0;0;0;0;0;0;0;0;0;0;0;0;0
FR;6;2022-01-30;0;0;0;0;0;0;0;0;0;0;0;0;0;0;0;0;0;0
FR;6;2022-01-31;0;0;0;0;0;0;0;0;0;0;0;0;0;0;0;0;0;0
FR;6;2022-02-01;0;0;0;0;0;0;0;0;0;0;0;0;0;0;0;0;0;0
FR;6;2022-02-02;0;0;0;0;0;0;0;0;0;0;0;0;0;0;0;0;0;0
FR;6;2022-02-03;0;0;0;0;0;0;0;0;0;0;0;0;0;0;0;0;0;0
FR;6;2022-02-04;0;0;0;0;0;0;0;0;0;0;0;0;0;0;0;0;0;0
FR;6;2022-02-05;0;0;0;0;0;0;0;0;0;0;0;0;0;0;0;0;0;0
FR;6;2022-02-06;0;0;0;0;0;0;0;0;0;0;0;0;0;0;0;0;0;0
FR;6;2022-02-07;0;0;0;0;0;0;0;0;0;0;0;0;0;0;0;0;0;0
FR;6;2022-02-08;0;0;0;0;0;0;0;0;0;0;0;0;0;0;0;0;0;0
FR;6;2022-02-09;0;0;0;0;0;0;0;0;0;0;0;0;0;0;0;0;0;0
FR;6;2022-02-10;0;0;0;0;0;0;0;0;0;0;0;0;0;0;0;0;0;0
FR;6;2022-02-11;0;0;0;0;0;0;0;0;0;0;0;0;0;0;0;0;0;0
FR;6;2022-02-12;0;0;0;0;0;0;0;0;0;0;0;0;0;0;0;0;0;0
FR;6;2022-02-13;0;0;0;0;0;0;0;0;0;0;0;0;0;0;0;0;0;0
FR;6;2022-02-14;0;0;0;0;0;0;0;0;0;0;0;0;0;0;0;0;0;0
FR;6;2022-02-15;0;0;0;0;0;0;0;0;0;0;0;0;0;0;0;0;0;0
FR;6;2022-02-16;0;0;0;0;0;0;0;0;0;0;0;0;0;0;0;0;0;0
FR;6;2022-02-17;0;0;0;0;0;0;0;0;0;0;0;0;0;0;0;0;0;0
FR;6;2022-02-18;0;0;0;0;0;0;0;0;0;0;0;0;0;0;0;0;0;0
FR;6;2022-02-19;0;0;0;0;0;0;0;0;0;0;0;0;0;0;0;0;0;0
FR;6;2022-02-20;0;0;0;0;0;0;0;0;0;0;0;0;0;0;0;0;0;0
FR;6;2022-02-21;0;0;0;0;0;0;0;0;0;0;0;0;0;0;0;0;0;0
FR;6;2022-02-22;0;0;0;0;0;0;0;0;0;0;0;0;0;0;0;0;0;0
FR;6;2022-02-23;0;0;0;0;0;0;0;0;0;0;0;0;0;0;0;0;0;0
FR;6;2022-02-24;0;0;0;0;0;0;0;0;0;0;0;0;0;0;0;0;0;0
FR;6;2022-02-25;0;0;0;0;0;0;0;0;0;0;0;0;0;0;0;0;0;0
FR;6;2022-02-26;1;0;0;0;0;0;0;0;0;1;0;0;0;0;0;0;0;0
FR;6;2022-02-27;1;0;0;0;1;0;0;0;0;2;0;0;0;1;0;0;0;0
FR;6;2022-02-28;0;0;0;0;0;0;0;0;0;2;0;0;0;1;0;0;0;0
FR;6;2022-03-01;3;0;0;0;0;0;0;0;0;5;0;0;0;1;0;0;0;0
FR;6;2022-03-02;97;9;2;0;15;7;0;0;0;102;9;2;0;16;7;0;0;0
FR;6;2022-03-03;0;0;0;0;0;0;0;0;0;102;9;2;0;16;7;0;0;0
FR;6;2022-03-04;92;4;0;0;8;4;0;0;0;194;13;2;0;24;11;0;0;0
FR;6;2022-03-05;391;23;2;0;60;14;0;0;0;585;36;4;0;84;25;0;0;0
FR;6;2022-03-06;7;1;0;0;2;0;0;0;0;592;37;4;0;86;25;0;0;0
FR;6;2022-03-07;337;19;0;0;51;13;0;0;0;929;56;4;0;137;38;0;0;0
FR;6;2022-03-08;230;14;0;0;47;5;0;0;0;1159;70;4;0;184;43;0;0;0
FR;6;2022-03-09;519;29;2;0;84;21;1;0;0;1678;99;6;0;268;64;1;0;0
FR;6;2022-03-10;206;19;0;1;54;12;1;0;0;1884;118;6;1;322;76;2;0;0
FR;6;2022-03-11;331;22;6;0;53;21;0;0;0;2215;140;12;1;375;97;2;0;0
FR;6;2022-03-12;518;25;1;0;83;20;0;0;0;2733;165;13;1;458;117;2;0;0
FR;6;2022-03-13;40;2;0;0;2;1;0;0;0;2773;167;13;1;460;118;2;0;0
FR;6;2022-03-14;201;4;2;0;39;3;1;0;0;2974;171;15;1;499;121;3;0;0
FR;6;2022-03-15;112;11;2;0;28;9;0;0;0;3086;182;17;1;527;130;3;0;0
FR;6;2022-03-16;310;17;2;1;49;15;1;0;0;3396;199;19;2;576;145;4;0;0
FR;6;2022-03-17;117;6;1;2;14;4;2;0;0;3513;205;20;4;590;149;6;0;0
FR;6;2022-03-18;215;10;0;0;40;6;0;0;0;3728;215;20;4;630;155;6;0;0
FR;6;2022-03-19;307;19;2;0;90;9;0;0;0;4035;234;22;4;720;164;6;0;0
FR;6;2022-03-20;15;5;0;0;5;1;0;0;0;4050;239;22;4;725;165;6;0;0
FR;6;2022-03-21;132;23;1;0;47;4;0;0;0;4182;262;23;4;772;169;6;0;0
FR;6;2022-03-22;97;15;0;0;34;4;0;0;0;4279;277;23;4;806;173;6;0;0
FR;6;2022-03-23;226;108;3;0;154;14;1;0;0;4505;385;26;4;960;187;7;0;0
FR;6;2022-03-24;100;15;1;3;32;4;3;0;0;4605;400;27;7;992;191;10;0;0
FR;6;2022-03-25;203;141;2;1;179;15;2;0;0;4808;541;29;8;1171;206;12;0;0
FR;6;2022-03-26;331;295;7;1;385;19;1;0;0;5139;836;36;9;1556;225;13;0;0
FR;6;2022-03-27;32;30;1;0;37;1;1;0;0;5171;866;37;9;1593;226;14;0;0
FR;6;2022-03-28;201;208;8;1;234;17;3;0;0;5372;1074;45;10;1827;243;17;0;0
FR;6;2022-03-29;124;189;12;2;206;12;9;0;0;5496;1263;57;12;2033;255;26;0;0
FR;6;2022-03-30;305;476;10;2;548;22;6;0;0;5801;1739;67;14;2581;277;32;0;0
FR;6;2022-03-31;123;140;10;0;160;14;5;0;0;5924;1879;77;14;2741;291;37;0;0
FR;6;2022-04-01;195;150;11;2;178;23;3;0;0;6119;2029;88;16;2919;314;40;0;0
FR;6;2022-04-02;206;241;9;1;280;13;8;0;0;6325;2270;97;17;3199;327;48;0;0
FR;6;2022-04-03;17;21;0;0;26;1;0;0;0;6342;2291;97;17;3225;328;48;0;0
FR;6;2022-04-04;137;114;6;1;131;9;5;0;0;6479;2405;103;18;3356;337;53;0;0
FR;6;2022-04-05;146;88;15;1;105;11;8;0;0;6625;2493;118;19;3461;348;61;0;0
FR;6;2022-04-06;204;245;22;26;291;27;33;0;0;6829;2738;140;45;3752;375;94;0;0
FR;6;2022-04-07;127;96;15;9;115;17;14;0;0;6956;2834;155;54;3867;392;108;0;0
FR;6;2022-04-08;199;171;16;3;214;17;9;0;1;7155;3005;171;57;4081;409;117;0;1
FR;6;2022-04-09;145;139;6;12;171;13;4;0;0;7300;3144;177;69;4252;422;121;0;1
FR;6;2022-04-10;11;20;3;0;26;1;3;0;0;7311;3164;180;69;4278;423;124;0;1
FR;6;2022-04-11;101;106;4;0;129;5;3;0;0;7412;3270;184;69;4407;428;127;0;1
FR;6;2022-04-12;136;75;5;8;114;10;10;0;0;7548;3345;189;77;4521;438;137;0;1
FR;6;2022-04-13;162;175;7;5;208;13;8;0;0;7710;3520;196;82;4729;451;145;0;1
FR;6;2022-04-14;100;103;5;10;121;8;10;0;0;7810;3623;201;92;4850;459;155;0;1
FR;6;2022-04-15;158;149;11;7;167;19;14;0;1;7968;3772;212;99;5017;478;169;0;2
FR;6;2022-04-16;127;132;5;0;162;14;2;0;0;8095;3904;217;99;5179;492;171;0;2
FR;6;2022-04-17;8;9;4;0;10;4;0;0;0;8103;3913;221;99;5189;496;171;0;2
FR;6;2022-04-18;8;15;3;0;14;4;0;0;0;8111;3928;224;99;5203;500;171;0;2
FR;6;2022-04-19;97;112;4;3;130;3;7;0;0;8208;4040;228;102;5333;503;178;0;2
FR;6;2022-04-20;177;227;8;7;269;15;3;0;0;8385;4267;236;109;5602;518;181;0;2
FR;6;2022-04-21;111;93;8;4;110;11;7;0;0;8496;4360;244;113;5712;529;188;0;2
FR;6;2022-04-22;139;160;13;12;189;13;13;0;0;8635;4520;257;125;5901;542;201;0;2
FR;6;2022-04-23;106;129;1;1;161;7;1;0;0;8741;4649;258;126;6062;549;202;0;2
FR;6;2022-04-24;5;21;1;0;22;0;1;0;0;8746;4670;259;126;6084;549;203;0;2
FR;6;2022-04-25;90;128;3;8;150;11;9;0;0;8836;4798;262;134;6234;560;212;0;2
FR;6;2022-04-26;101;128;19;2;151;17;13;0;0;8937;4926;281;136;6385;577;225;0;2
FR;6;2022-04-27;197;159;21;1;222;27;11;0;1;9134;5085;302;137;6607;604;236;0;3
FR;6;2022-04-28;109;87;7;1;123;8;7;0;0;9243;5172;309;138;6730;612;243;0;3
FR;6;2022-04-29;191;169;16;2;215;20;6;0;0;9434;5341;325;140;6945;632;249;0;3
FR;6;2022-04-30;133;125;7;1;168;24;2;0;0;9567;5466;332;141;7113;656;251;0;3
FR;6;2022-05-01;7;6;0;0;8;0;0;0;0;9574;5472;332;141;7121;656;251;0;3
FR;6;2022-05-02;94;65;3;4;88;3;4;0;0;9668;5537;335;145;7209;659;255;0;3
FR;6;2022-05-03;136;93;11;2;125;7;9;0;0;9804;5630;346;147;7334;666;264;0;3
FR;6;2022-05-04;167;118;25;12;161;29;12;0;1;9971;5748;371;159;7495;695;276;0;4
FR;6;2022-05-05;101;70;8;3;97;12;6;0;0;10072;5818;379;162;7592;707;282;0;4
FR;6;2022-05-06;152;110;10;9;155;16;11;0;0;10224;5928;389;171;7747;723;293;0;4
FR;6;2022-05-07;139;93;13;3;136;23;8;0;0;10363;6021;402;174;7883;746;301;0;4
FR;6;2022-05-08;20;8;6;5;16;7;5;0;0;10383;6029;408;179;7899;753;306;0;4
FR;6;2022-05-09;86;78;9;7;95;13;6;0;0;10469;6107;417;186;7994;766;312;0;4
FR;6;2022-05-10;112;80;15;7;110;12;13;0;0;10581;6187;432;193;8104;778;325;0;4
FR;6;2022-05-11;130;124;11;14;163;20;6;0;0;10711;6311;443;207;8267;798;331;0;4
FR;6;2022-05-12;105;76;7;5;96;15;6;0;1;10816;6387;450;212;8363;813;337;0;5
FR;6;2022-05-13;155;97;17;21;137;22;16;0;0;10971;6484;467;233;8500;835;353;0;5
FR;6;2022-05-14;81;60;6;7;84;15;2;0;0;11052;6544;473;240;8584;850;355;0;5
FR;6;2022-05-15;12;7;0;0;14;0;0;0;0;11064;6551;473;240;8598;850;355;0;5
FR;6;2022-05-16;65;54;6;2;69;12;3;0;0;11129;6605;479;242;8667;862;358;0;5
FR;6;2022-05-17;123;77;5;7;92;11;8;0;0;11252;6682;484;249;8759;873;366;0;5
FR;6;2022-05-18;131;116;5;1;158;14;3;0;0;11383;6798;489;250;8917;887;369;0;5
FR;6;2022-05-19;124;57;6;8;96;9;8;0;0;11507;6855;495;258;9013;896;377;0;5
FR;6;2022-05-20;125;115;13;3;151;18;10;0;0;11632;6970;508;261;9164;914;387;0;5
FR;6;2022-05-21;92;69;14;3;93;12;8;0;0;11724;7039;522;264;9257;926;395;0;5
FR;6;2022-05-22;19;12;5;0;21;4;1;0;0;11743;7051;527;264;9278;930;396;0;5
FR;6;2022-05-23;77;72;4;2;90;7;2;0;0;11820;7123;531;266;9368;937;398;0;5
FR;6;2022-05-24;117;98;8;2;131;16;4;0;0;11937;7221;539;268;9499;953;402;0;5
FR;6;2022-05-25;140;129;6;3;171;11;6;0;0;12077;7350;545;271;9670;964;408;0;5
FR;6;2022-05-26;7;9;3;0;5;9;0;0;0;12084;7359;548;271;9675;973;408;0;5
FR;6;2022-05-27;127;105;15;11;136;18;18;0;1;12211;7464;563;282;9811;991;426;0;6
FR;6;2022-05-28;54;75;1;5;89;8;5;0;0;12265;7539;564;287;9900;999;431;0;6
FR;6;2022-05-29;8;10;0;0;10;1;0;0;0;12273;7549;564;287;9910;1000;431;0;6
FR;6;2022-05-30;70;70;7;4;86;4;9;0;0;12343;7619;571;291;9996;1004;440;0;6
FR;6;2022-05-31;87;102;10;2;121;14;7;0;0;12430;7721;581;293;10117;1018;447;0;6
FR;6;2022-06-01;97;89;10;1;111;11;6;0;0;12527;7810;591;294;10228;1029;453;0;6
FR;6;2022-06-02;91;60;6;3;80;9;6;0;0;12618;7870;597;297;10308;1038;459;0;6
FR;6;2022-06-03;126;102;13;7;128;21;8;0;0;12744;7972;610;304;10436;1059;467;0;6
FR;6;2022-06-04;63;51;10;0;64;12;3;0;0;12807;8023;620;304;10500;1071;470;0;6
FR;6;2022-06-05;16;15;2;1;18;4;1;0;0;12823;8038;622;305;10518;1075;471;0;6
FR;6;2022-06-06;9;6;0;0;8;0;0;0;0;12832;8044;622;305;10526;1075;471;0;6
FR;6;2022-06-07;79;90;3;4;117;8;6;0;0;12911;8134;625;309;10643;1083;477;0;6
FR;6;2022-06-08;92;110;13;5;130;20;6;0;0;13003;8244;638;314;10773;1103;483;0;6
FR;6;2022-06-09;75;81;15;3;106;15;8;0;0;13078;8325;653;317;10879;1118;491;0;6
FR;6;2022-06-10;116;93;26;10;120;22;13;0;0;13194;8418;679;327;10999;1140;504;0;6
FR;6;2022-06-11;83;62;6;10;82;12;11;0;0;13277;8480;685;337;11081;1152;515;0;6
FR;6;2022-06-12;6;14;1;0;16;2;0;0;0;13283;8494;686;337;11097;1154;515;0;6
FR;6;2022-06-13;74;59;18;1;68;7;4;0;0;13357;8553;704;338;11165;1161;519;0;6
FR;6;2022-06-14;98;100;8;5;116;16;8;0;0;13455;8653;712;343;11281;1177;527;0;6
FR;6;2022-06-15;80;86;7;8;114;15;10;0;0;13535;8739;719;351;11395;1192;537;0;6
FR;6;2022-06-16;53;40;11;7;45;14;6;0;0;13588;8779;730;358;11440;1206;543;0;6
FR;6;2022-06-17;86;85;3;13;109;11;5;0;0;13674;8864;733;371;11549;1217;548;0;6
FR;6;2022-06-18;71;62;13;0;88;21;1;0;0;13745;8926;746;371;11637;1238;549;0;6
FR;6;2022-06-19;6;6;3;0;7;4;1;0;0;13751;8932;749;371;11644;1242;550;0;6
FR;6;2022-06-20;42;41;4;1;55;6;1;0;0;13793;8973;753;372;11699;1248;551;0;6
FR;6;2022-06-21;59;73;10;7;83;17;7;0;0;13852;9046;763;379;11782;1265;558;0;6
FR;6;2022-06-22;86;85;8;2;98;17;3;0;0;13938;9131;771;381;11880;1282;561;0;6
FR;6;2022-06-23;64;39;13;7;41;15;10;0;0;14002;9170;784;388;11921;1297;571;0;6
FR;6;2022-06-24;77;85;7;14;95;20;16;0;0;14079;9255;791;402;12016;1317;587;0;6
FR;6;2022-06-25;67;61;4;3;77;8;5;0;0;14146;9316;795;405;12093;1325;592;0;6
FR;6;2022-06-26;6;7;1;0;10;1;0;0;0;14152;9323;796;405;12103;1326;592;0;6
FR;6;2022-06-27;51;50;4;9;62;12;7;0;0;14203;9373;800;414;12165;1338;599;0;6
FR;6;2022-06-28;68;47;6;3;53;15;5;0;0;14271;9420;806;417;12218;1353;604;0;6
FR;6;2022-06-29;98;117;26;37;115;19;35;0;5;14369;9537;832;454;12333;1372;639;0;11
FR;6;2022-06-30;84;60;33;10;61;12;7;0;0;14453;9597;865;464;12394;1384;646;0;11
FR;6;2022-07-01;115;94;25;33;102;18;27;0;1;14568;9691;890;497;12496;1402;673;0;12
FR;6;2022-07-02;58;67;26;2;64;37;6;0;0;14626;9758;916;499;12560;1439;679;0;12
FR;6;2022-07-03;11;4;4;3;5;4;3;0;0;14637;9762;920;502;12565;1443;682;0;12
FR;6;2022-07-04;61;43;3;23;55;13;20;0;0;14698;9805;923;525;12620;1456;702;0;12
FR;6;2022-07-05;65;53;19;67;60;27;63;0;0;14763;9858;942;592;12680;1483;765;0;12
FR;6;2022-07-06;94;64;7;11;78;12;17;0;0;14857;9922;949;603;12758;1495;782;0;12
FR;6;2022-07-07;99;79;42;37;99;14;34;0;4;14956;10001;991;640;12857;1509;816;0;16
FR;6;2022-07-08;139;87;42;27;115;10;25;0;3;15095;10088;1033;667;12972;1519;841;0;19
FR;6;2022-07-09;53;51;16;29;51;27;33;0;1;15148;10139;1049;696;13023;1546;874;0;20
FR;6;2022-07-10;3;7;8;0;9;9;0;0;0;15151;10146;1057;696;13032;1555;874;0;20
FR;6;2022-07-11;54;44;5;4;47;12;4;0;0;15205;10190;1062;700;13079;1567;878;0;20
FR;6;2022-07-12;70;72;12;23;87;12;27;0;0;15275;10262;1074;723;13166;1579;905;0;20
FR;6;2022-07-13;84;65;14;21;71;25;22;0;0;15359;10327;1088;744;13237;1604;927;0;20
FR;6;2022-07-14;4;3;1;0;4;1;0;0;0;15363;10330;1089;744;13241;1605;927;0;20
FR;6;2022-07-15;74;59;9;57;85;16;45;0;0;15437;10389;1098;801;13326;1621;972;0;20
FR;6;2022-07-16;27;31;17;0;37;17;3;0;0;15464;10420;1115;801;13363;1638;975;0;20
FR;6;2022-07-17;3;7;0;0;8;0;0;0;0;15467;10427;1115;801;13371;1638;975;0;20
FR;6;2022-07-18;37;62;11;14;60;15;14;0;6;15504;10489;1126;815;13431;1653;989;0;26
FR;6;2022-07-19;54;48;4;19;60;6;21;0;1;15558;10537;1130;834;13491;1659;1010;0;27
FR;6;2022-07-20;53;70;7;22;75;11;27;0;0;15611;10607;1137;856;13566;1670;1037;0;27
FR;6;2022-07-21;51;61;4;7;56;11;9;0;0;15662;10668;1141;863;13622;1681;1046;0;27
FR;6;2022-07-22;55;74;7;26;82;8;16;0;2;15717;10742;1148;889;13704;1689;1062;0;29
FR;6;2022-07-23;38;40;6;10;40;6;9;0;1;15755;10782;1154;899;13744;1695;1071;0;30
FR;6;2022-07-24;11;14;1;3;19;3;3;0;0;15766;10796;1155;902;13763;1698;1074;0;30
FR;6;2022-07-25;60;44;8;12;41;9;13;0;1;15826;10840;1163;914;13804;1707;1087;0;31
FR;6;2022-07-26;47;64;14;6;62;10;13;0;0;15873;10904;1177;920;13866;1717;1100;0;31
FR;6;2022-07-27;54;78;15;11;80;18;15;0;8;15927;10982;1192;931;13946;1735;1115;0;39
FR;6;2022-07-28;30;48;4;6;50;8;7;0;1;15957;11030;1196;937;13996;1743;1122;0;40
FR;6;2022-07-29;43;71;10;38;60;24;36;0;1;16000;11101;1206;975;14056;1767;1158;0;41
FR;6;2022-07-30;26;48;4;15;49;7;15;0;0;16026;11149;1210;990;14105;1774;1173;0;41
FR;6;2022-07-31;0;1;1;0;1;0;1;0;0;16026;11150;1211;990;14106;1774;1174;0;41
FR;6;2022-08-01;39;36;14;8;32;10;6;0;1;16065;11186;1225;998;14138;1784;1180;0;42
FR;6;2022-08-02;37;46;10;14;52;6;16;0;0;16102;11232;1235;1012;14190;1790;1196;0;42
FR;6;2022-08-03;29;52;7;16;53;11;19;0;0;16131;11284;1242;1028;14243;1801;1215;0;42
FR;6;2022-08-04;25;21;4;9;20;6;10;0;1;16156;11305;1246;1037;14263;1807;1225;0;43
FR;6;2022-08-05;43;45;1;7;54;5;7;0;0;16199;11350;1247;1044;14317;1812;1232;0;43
FR;6;2022-08-06;17;27;1;3;33;2;4;0;0;16216;11377;1248;1047;14350;1814;1236;0;43
FR;6;2022-08-07;1;2;0;0;2;0;0;0;0;16217;11379;1248;1047;14352;1814;1236;0;43
FR;6;2022-08-08;24;33;1;0;40;1;0;0;0;16241;11412;1249;1047;14392;1815;1236;0;43
FR;6;2022-08-09;22;30;6;3;29;3;3;0;0;16263;11442;1255;1050;14421;1818;1239;0;43
FR;6;2022-08-10;32;36;5;9;38;5;9;0;5;16295;11478;1260;1059;14459;1823;1248;0;48
FR;6;2022-08-11;32;33;1;1;40;1;0;0;1;16327;11511;1261;1060;14499;1824;1248;0;49
FR;6;2022-08-12;50;44;6;2;50;15;3;0;1;16377;11555;1267;1062;14549;1839;1251;0;50
FR;6;2022-08-13;9;20;0;0;22;1;0;0;0;16386;11575;1267;1062;14571;1840;1251;0;50
FR;6;2022-08-14;3;1;0;0;2;0;0;0;0;16389;11576;1267;1062;14573;1840;1251;0;50
FR;6;2022-08-15;2;3;1;0;4;0;1;0;0;16391;11579;1268;1062;14577;1840;1252;0;50
FR;6;2022-08-16;35;66;21;7;66;7;2;0;0;16426;11645;1289;1069;14643;1847;1254;0;50
FR;6;2022-08-17;32;44;10;9;41;10;6;0;7;16458;11689;1299;1078;14684;1857;1260;0;57
FR;6;2022-08-18;29;55;14;4;61;4;0;0;1;16487;11744;1313;1082;14745;1861;1260;0;58
FR;6;2022-08-19;30;45;5;4;47;3;2;0;1;16517;11789;1318;1086;14792;1864;1262;0;59
FR;6;2022-08-20;26;28;3;0;27;8;1;0;0;16543;11817;1321;1086;14819;1872;1263;0;59
FR;6;2022-08-21;1;5;2;0;5;0;0;0;0;16544;11822;1323;1086;14824;1872;1263;0;59
FR;6;2022-08-22;20;42;15;1;45;0;0;0;0;16564;11864;1338;1087;14869;1872;1263;0;59
FR;6;2022-08-23;34;45;6;7;47;6;4;0;2;16598;11909;1344;1094;14916;1878;1267;0;61
FR;6;2022-08-24;34;30;6;3;36;6;2;0;3;16632;11939;1350;1097;14952;1884;1269;0;64
FR;6;2022-08-25;25;27;1;1;29;5;1;0;0;16657;11966;1351;1098;14981;1889;1270;0;64
FR;6;2022-08-26;38;44;4;4;51;7;7;0;0;16695;12010;1355;1102;15032;1896;1277;0;64
FR;6;2022-08-27;19;21;7;3;22;8;4;0;0;16714;12031;1362;1105;15054;1904;1281;0;64
FR;6;2022-08-28;6;3;0;6;3;1;1;0;4;16720;12034;1362;1111;15057;1905;1282;0;68
FR;6;2022-08-29;26;22;2;6;29;3;6;0;0;16746;12056;1364;1117;15086;1908;1288;0;68
FR;6;2022-08-30;28;35;4;12;33;8;13;0;0;16774;12091;1368;1129;15119;1916;1301;0;68
FR;6;2022-08-31;35;38;2;11;46;3;12;0;0;16809;12129;1370;1140;15165;1919;1313;0;68
FR;6;2022-09-01;17;11;5;1;13;4;3;0;0;16826;12140;1375;1141;15178;1923;1316;0;68
FR;6;2022-09-02;19;14;2;1;13;3;2;0;0;16845;12154;1377;1142;15191;1926;1318;0;68
FR;6;2022-09-03;10;3;1;5;4;2;5;0;0;16855;12157;1378;1147;15195;1928;1323;0;68
FR;6;2022-09-04;4;1;0;0;1;0;0;0;0;16859;12158;1378;1147;15196;1928;1323;0;68
FR;6;2022-09-05;8;7;0;0;10;0;0;0;0;16867;12165;1378;1147;15206;1928;1323;0;68
FR;6;2022-09-06;7;9;7;12;8;6;15;0;0;16874;12174;1385;1159;15214;1934;1338;0;68
FR;6;2022-09-07;3;8;1;0;8;1;0;0;0;16877;12182;1386;1159;15222;1935;1338;0;68
FR;6;2022-09-08;6;4;0;2;3;1;2;0;0;16883;12186;1386;1161;15225;1936;1340;0;68
FR;6;2022-09-09;7;9;2;7;9;3;8;0;0;16890;12195;1388;1168;15234;1939;1348;0;68
FR;6;2022-09-10;3;4;1;0;3;1;1;0;0;16893;12199;1389;1168;15237;1940;1349;0;68
FR;6;2022-09-11;1;3;0;0;3;0;0;0;0;16894;12202;1389;1168;15240;1940;1349;0;68
FR;6;2022-09-12;10;4;1;0;3;3;0;0;0;16904;12206;1390;1168;15243;1943;1349;0;68
FR;6;2022-09-13;7;2;3;0;2;2;2;0;0;16911;12208;1393;1168;15245;1945;1351;0;68
FR;6;2022-09-14;9;8;2;0;7;4;0;0;0;16920;12216;1395;1168;15252;1949;1351;0;68
FR;6;2022-09-15;8;13;5;5;9;9;3;0;2;16928;12229;1400;1173;15261;1958;1354;0;70
FR;6;2022-09-16;25;39;1;1;47;4;1;0;2;16953;12268;1401;1174;15308;1962;1355;0;72
FR;6;2022-09-17;24;22;0;6;24;5;3;0;2;16977;12290;1401;1180;15332;1967;1358;0;74
FR;6;2022-09-18;5;4;0;0;4;1;0;0;0;16982;12294;1401;1180;15336;1968;1358;0;74
FR;6;2022-09-19;30;30;2;1;32;5;1;0;0;17012;12324;1403;1181;15368;1973;1359;0;74
FR;6;2022-09-20;34;25;1;4;30;6;2;0;1;17046;12349;1404;1185;15398;1979;1361;0;75
FR;6;2022-09-21;21;9;3;3;7;7;5;0;3;17067;12358;1407;1188;15405;1986;1366;0;78
FR;6;2022-09-22;19;28;1;22;32;3;21;0;1;17086;12386;1408;1210;15437;1989;1387;0;79
FR;6;2022-09-23;28;41;5;9;47;9;2;0;0;17114;12427;1413;1219;15484;1998;1389;0;79
FR;6;2022-09-24;16;16;4;2;21;6;2;0;0;17130;12443;1417;1221;15505;2004;1391;0;79
FR;6;2022-09-25;3;14;0;0;14;1;0;0;0;17133;12457;1417;1221;15519;2005;1391;0;79
FR;6;2022-09-26;16;13;0;18;12;5;18;0;2;17149;12470;1417;1239;15531;2010;1409;0;81
FR;6;2022-09-27;32;19;2;3;23;4;4;0;0;17181;12489;1419;1242;15554;2014;1413;0;81
FR;6;2022-09-28;27;10;9;11;16;5;17;0;2;17208;12499;1428;1253;15570;2019;1430;0;83
FR;6;2022-09-29;13;13;10;34;16;6;33;0;7;17221;12512;1438;1287;15586;2025;1463;0;90
FR;6;2022-09-30;34;24;5;6;33;5;3;0;0;17255;12536;1443;1293;15619;2030;1466;0;90
FR;6;2022-10-01;17;12;5;8;9;8;8;0;2;17272;12548;1448;1301;15628;2038;1474;0;92
FR;6;2022-10-02;4;0;0;0;1;0;0;0;0;17276;12548;1448;1301;15629;2038;1474;0;92
FR;6;2022-10-03;11;10;3;5;11;4;6;0;0;17287;12558;1451;1306;15640;2042;1480;0;92
FR;6;2022-10-04;19;17;4;28;21;3;30;0;3;17306;12575;1455;1334;15661;2045;1510;0;95
FR;6;2022-10-05;11;12;3;2;9;7;4;0;0;17317;12587;1458;1336;15670;2052;1514;0;95
FR;6;2022-10-06;19;13;4;6;17;2;10;0;0;17336;12600;1462;1342;15687;2054;1524;0;95
FR;6;2022-10-07;27;26;5;24;24;11;16;0;5;17363;12626;1467;1366;15711;2065;1540;0;100
FR;6;2022-10-08;18;13;0;0;16;0;0;0;0;17381;12639;1467;1366;15727;2065;1540;0;100
FR;6;2022-10-09;7;3;4;27;3;4;30;0;6;17388;12642;1471;1393;15730;2069;1570;0;106
FR;6;2022-10-10;15;14;1;16;16;6;13;0;0;17403;12656;1472;1409;15746;2075;1583;0;106
FR;6;2022-10-11;21;23;3;11;22;8;13;0;3;17424;12679;1475;1420;15768;2083;1596;0;109
FR;6;2022-10-12;20;16;7;19;18;3;24;0;7;17444;12695;1482;1439;15786;2086;1620;0;116
FR;6;2022-10-13;28;15;2;36;23;0;38;0;6;17472;12710;1484;1475;15809;2086;1658;0;122
FR;6;2022-10-14;29;23;5;49;23;11;45;0;13;17501;12733;1489;1524;15832;2097;1703;0;135
FR;6;2022-10-15;13;9;0;22;8;4;21;0;6;17514;12742;1489;1546;15840;2101;1724;0;141
FR;6;2022-10-16;4;5;0;6;2;3;6;0;0;17518;12747;1489;1552;15842;2104;1730;0;141
FR;6;2022-10-17;14;14;2;10;14;1;12;0;2;17532;12761;1491;1562;15856;2105;1742;0;143
FR;6;2022-10-18;12;19;9;26;19;4;18;0;11;17544;12780;1500;1588;15875;2109;1760;0;154
FR;6;2022-10-19;10;20;6;16;20;5;19;0;5;17554;12800;1506;1604;15895;2114;1779;0;159
FR;6;2022-10-20;16;15;12;57;18;5;67;0;13;17570;12815;1518;1661;15913;2119;1846;0;172
FR;6;2022-10-21;16;21;9;34;22;11;37;0;10;17586;12836;1527;1695;15935;2130;1883;0;182
FR;6;2022-10-22;19;14;1;4;17;3;4;0;0;17605;12850;1528;1699;15952;2133;1887;0;182
FR;6;2022-10-23;3;3;1;0;4;0;1;0;0;17608;12853;1529;1699;15956;2133;1888;0;182
FR;6;2022-10-24;12;14;2;7;14;6;5;0;2;17620;12867;1531;1706;15970;2139;1893;0;184
FR;6;2022-10-25;20;13;6;17;16;7;19;0;4;17640;12880;1537;1723;15986;2146;1912;0;188
FR;6;2022-10-26;17;9;4;13;12;4;15;0;5;17657;12889;1541;1736;15998;2150;1927;0;193
FR;6;2022-10-27;20;7;8;37;10;6;36;0;14;17677;12896;1549;1773;16008;2156;1963;0;207
FR;6;2022-10-28;21;27;3;4;28;6;5;0;1;17698;12923;1552;1777;16036;2162;1968;0;208
FR;6;2022-10-29;7;11;5;11;10;6;14;0;12;17705;12934;1557;1788;16046;2168;1982;0;220
FR;6;2022-10-30;2;5;0;0;5;0;0;0;0;17707;12939;1557;1788;16051;2168;1982;0;220
FR;6;2022-10-31;20;14;2;13;17;4;12;0;3;17727;12953;1559;1801;16068;2172;1994;0;223
FR;6;2022-11-01;2;1;1;0;1;1;0;0;0;17729;12954;1560;1801;16069;2173;1994;0;223
FR;6;2022-11-02;15;25;9;21;26;11;19;0;12;17744;12979;1569;1822;16095;2184;2013;0;235
FR;6;2022-11-03;17;17;11;39;20;8;43;0;9;17761;12996;1580;1861;16115;2192;2056;0;244
FR;6;2022-11-04;19;22;9;16;27;5;16;0;10;17780;13018;1589;1877;16142;2197;2072;0;254
FR;6;2022-11-05;9;16;2;4;17;4;6;0;0;17789;13034;1591;1881;16159;2201;2078;0;254
FR;6;2022-11-06;5;1;0;0;1;0;0;0;0;17794;13035;1591;1881;16160;2201;2078;0;254
FR;6;2022-11-07;18;10;6;17;12;4;18;0;11;17812;13045;1597;1898;16172;2205;2096;0;265
FR;6;2022-11-08;18;10;2;3;8;5;5;0;4;17830;13055;1599;1901;16180;2210;2101;0;269
FR;6;2022-11-09;16;22;1;6;21;4;5;0;4;17846;13077;1600;1907;16201;2214;2106;0;273
FR;6;2022-11-10;10;10;4;12;8;5;11;0;10;17856;13087;1604;1919;16209;2219;2117;0;283
FR;6;2022-11-11;4;1;0;0;1;1;0;0;0;17860;13088;1604;1919;16210;2220;2117;0;283
FR;6;2022-11-12;4;11;1;7;11;2;5;0;9;17864;13099;1605;1926;16221;2222;2122;0;292
FR;6;2022-11-13;1;1;0;1;1;0;1;0;0;17865;13100;1605;1927;16222;2222;2123;0;292
FR;6;2022-11-14;13;10;7;32;14;8;33;0;14;17878;13110;1612;1959;16236;2230;2156;0;306
FR;6;2022-11-15;7;18;1;11;16;4;7;0;2;17885;13128;1613;1970;16252;2234;2163;0;308
FR;6;2022-11-16;16;15;9;32;16;3;42;0;9;17901;13143;1622;2002;16268;2237;2205;0;317
FR;6;2022-11-17;10;8;1;29;8;2;28;0;5;17911;13151;1623;2031;16276;2239;2233;0;322
FR;6;2022-11-18;19;12;5;23;17;4;25;0;7;17930;13163;1628;2054;16293;2243;2258;0;329
FR;6;2022-11-19;5;13;0;2;11;3;2;0;1;17935;13176;1628;2056;16304;2246;2260;0;330
FR;6;2022-11-20;2;1;2;0;1;2;0;0;0;17937;13177;1630;2056;16305;2248;2260;0;330
FR;6;2022-11-21;22;13;1;14;14;6;11;0;3;17959;13190;1631;2070;16319;2254;2271;0;333
FR;6;2022-11-22;14;9;0;4;11;1;3;0;1;17973;13199;1631;2074;16330;2255;2274;0;334
FR;6;2022-11-23;14;15;15;23;17;9;31;0;8;17987;13214;1646;2097;16347;2264;2305;0;342
FR;6;2022-11-24;14;17;1;13;19;5;12;0;7;18001;13231;1647;2110;16366;2269;2317;0;349
FR;6;2022-11-25;23;15;5;50;15;5;47;0;5;18024;13246;1652;2160;16381;2274;2364;0;354
FR;6;2022-11-26;9;5;2;4;3;2;5;0;1;18033;13251;1654;2164;16384;2276;2369;0;355
FR;6;2022-11-27;1;4;0;0;4;0;0;0;0;18034;13255;1654;2164;16388;2276;2369;0;355
FR;6;2022-11-28;9;11;6;22;11;3;24;0;11;18043;13266;1660;2186;16399;2279;2393;0;366
FR;6;2022-11-29;15;10;1;12;14;1;8;0;7;18058;13276;1661;2198;16413;2280;2401;0;373
FR;6;2022-11-30;18;20;8;23;19;12;22;0;8;18076;13296;1669;2221;16432;2292;2423;0;381
FR;6;2022-12-01;12;9;7;20;11;4;24;0;9;18088;13305;1676;2241;16443;2296;2447;0;390
FR;6;2022-12-02;17;9;12;36;12;8;42;0;1;18105;13314;1688;2277;16455;2304;2489;0;391
FR;6;2022-12-03;13;3;13;20;6;5;28;0;13;18118;13317;1701;2297;16461;2309;2517;0;404
FR;6;2022-12-04;3;1;0;2;1;0;2;0;0;18121;13318;1701;2299;16462;2309;2519;0;404
FR;6;2022-12-05;11;10;7;16;10;4;19;0;8;18132;13328;1708;2315;16472;2313;2538;0;412
FR;6;2022-12-06;10;19;3;30;12;11;28;0;3;18142;13347;1711;2345;16484;2324;2566;0;415
FR;6;2022-12-07;17;8;10;56;10;8;57;0;30;18159;13355;1721;2401;16494;2332;2623;0;445
FR;6;2022-12-08;9;13;8;19;11;7;21;0;13;18168;13368;1729;2420;16505;2339;2644;0;458
FR;6;2022-12-09;15;9;5;29;12;4;30;0;6;18183;13377;1734;2449;16517;2343;2674;0;464
FR;6;2022-12-10;12;9;6;9;7;4;14;0;7;18195;13386;1740;2458;16524;2347;2688;0;471
FR;6;2022-12-11;4;2;1;0;2;1;0;0;0;18199;13388;1741;2458;16526;2348;2688;0;471
FR;6;2022-12-12;17;10;8;36;14;9;33;0;17;18216;13398;1749;2494;16540;2357;2721;0;488
FR;6;2022-12-13;17;21;12;66;16;18;65;0;14;18233;13419;1761;2560;16556;2375;2786;0;502
FR;6;2022-12-14;14;13;8;53;11;12;53;0;14;18247;13432;1769;2613;16567;2387;2839;0;516
FR;6;2022-12-15;12;15;14;38;13;9;44;0;9;18259;13447;1783;2651;16580;2396;2883;0;525
FR;6;2022-12-16;18;14;15;39;15;14;39;0;13;18277;13461;1798;2690;16595;2410;2922;0;538
FR;6;2022-12-17;11;10;15;28;9;15;29;0;8;18288;13471;1813;2718;16604;2425;2951;0;546
FR;6;2022-12-18;7;4;0;2;5;0;2;0;0;18295;13475;1813;2720;16609;2425;2953;0;546
FR;6;2022-12-19;12;8;9;29;8;12;29;0;15;18307;13483;1822;2749;16617;2437;2982;0;561
FR;6;2022-12-20;17;23;11;23;17;19;22;0;21;18324;13506;1833;2772;16634;2456;3004;0;582
FR;6;2022-12-21;23;16;9;19;13;13;17;0;5;18347;13522;1842;2791;16647;2469;3021;0;587
FR;6;2022-12-22;13;14;9;21;15;13;18;0;11;18360;13536;1851;2812;16662;2482;3039;0;598
FR;6;2022-12-23;10;19;12;7;14;18;7;0;3;18370;13555;1863;2819;16676;2500;3046;0;601
FR;6;2022-12-24;4;5;3;1;5;2;2;0;1;18374;13560;1866;2820;16681;2502;3048;0;602
FR;6;2022-12-25;0;0;0;0;0;0;0;0;0;18374;13560;1866;2820;16681;2502;3048;0;602
FR;6;2022-12-26;8;12;12;11;10;18;11;0;3;18382;13572;1878;2831;16691;2520;3059;0;605
FR;6;2022-12-27;16;13;15;8;11;19;8;0;0;18398;13585;1893;2839;16702;2539;3067;0;605
FR;6;2022-12-28;15;19;6;8;19;9;9;0;4;18413;13604;1899;2847;16721;2548;3076;0;609
FR;6;2022-12-29;15;12;7;8;10;9;9;0;7;18428;13616;1906;2855;16731;2557;3085;0;616
FR;6;2022-12-30;20;19;13;8;20;13;11;0;4;18448;13635;1919;2863;16751;2570;3096;0;620
FR;6;2022-12-31;5;2;6;1;4;7;1;0;1;18453;13637;1925;2864;16755;2577;3097;0;621
FR;6;2023-01-01;2;1;0;3;0;3;0;0;1;18455;13638;1925;2867;16755;2580;3097;0;622
FR;6;2023-01-02;9;14;2;3;10;7;3;0;0;18464;13652;1927;2870;16765;2587;3100;0;622
FR;6;2023-01-03;8;17;9;21;17;9;21;0;7;18472;13669;1936;2891;16782;2596;3121;0;629
FR;6;2023-01-04;9;10;4;10;9;8;6;0;14;18481;13679;1940;2901;16791;2604;3127;0;643
FR;6;2023-01-05;11;11;6;23;10;3;26;0;8;18492;13690;1946;2924;16801;2607;3153;0;651
FR;6;2023-01-06;16;24;15;30;21;17;29;0;15;18508;13714;1961;2954;16822;2624;3182;0;666
FR;6;2023-01-07;9;19;4;1;10;13;3;0;1;18517;13733;1965;2955;16832;2637;3185;0;667
FR;6;2023-01-08;2;7;4;11;6;4;11;0;3;18519;13740;1969;2966;16838;2641;3196;0;670
FR;6;2023-01-09;16;10;5;35;8;8;34;0;17;18535;13750;1974;3001;16846;2649;3230;0;687
FR;6;2023-01-10;13;15;13;23;13;10;26;0;9;18548;13765;1987;3024;16859;2659;3256;0;696
FR;6;2023-01-11;15;14;5;16;18;6;14;0;12;18563;13779;1992;3040;16877;2665;3270;0;708
FR;6;2023-01-12;7;13;2;5;10;3;5;0;12;18570;13792;1994;3045;16887;2668;3275;0;720
FR;6;2023-01-13;19;14;18;43;14;20;43;0;31;18589;13806;2012;3088;16901;2688;3318;0;751
FR;6;2023-01-14;20;8;6;2;9;9;2;0;0;18609;13814;2018;3090;16910;2697;3320;0;751
FR;6;2023-01-15;0;0;1;3;0;1;3;0;0;18609;13814;2019;3093;16910;2698;3323;0;751
FR;6;2023-01-16;22;12;2;1;10;6;3;0;2;18631;13826;2021;3094;16920;2704;3326;0;753
FR;6;2023-01-17;8;17;12;8;17;11;14;0;5;18639;13843;2033;3102;16937;2715;3340;0;758
FR;6;2023-01-18;22;15;9;7;17;10;8;0;1;18661;13858;2042;3109;16954;2725;3348;0;759
FR;6;2023-01-19;9;9;14;9;11;12;13;0;7;18670;13867;2056;3118;16965;2737;3361;0;766
FR;6;2023-01-20;17;13;9;32;15;7;34;0;27;18687;13880;2065;3150;16980;2744;3395;0;793
FR;6;2023-01-21;12;7;5;2;6;8;3;0;1;18699;13887;2070;3152;16986;2752;3398;0;794
FR;6;2023-01-22;0;0;1;1;0;1;1;0;0;18699;13887;2071;3153;16986;2753;3399;0;794
FR;6;2023-01-23;9;9;5;11;8;5;11;0;3;18708;13896;2076;3164;16994;2758;3410;0;797
FR;6;2023-01-24;14;15;15;13;15;14;18;0;6;18722;13911;2091;3177;17009;2772;3428;0;803
FR;6;2023-01-25;15;7;5;3;6;6;4;0;4;18737;13918;2096;3180;17015;2778;3432;0;807
FR;6;2023-01-26;13;15;3;11;12;8;13;0;9;18750;13933;2099;3191;17027;2786;3445;0;816
FR;6;2023-01-27;21;17;7;34;22;7;29;0;29;18771;13950;2106;3225;17049;2793;3474;0;845
FR;6;2023-01-28;15;15;7;4;17;6;5;0;1;18786;13965;2113;3229;17066;2799;3479;0;846
FR;6;2023-01-29;1;4;0;0;3;1;0;0;0;18787;13969;2113;3229;17069;2800;3479;0;846
FR;6;2023-01-30;2;15;8;4;15;8;3;0;8;18789;13984;2121;3233;17084;2808;3482;0;854
FR;6;2023-01-31;9;8;5;8;8;5;8;0;5;18798;13992;2126;3241;17092;2813;3490;0;859
FR;6;2023-02-01;20;18;4;4;17;4;8;0;4;18818;14010;2130;3245;17109;2817;3498;0;863
FR;6;2023-02-02;8;10;9;1;10;10;1;0;1;18826;14020;2139;3246;17119;2827;3499;0;864
FR;6;2023-02-03;16;15;11;18;16;11;19;0;13;18842;14035;2150;3264;17135;2838;3518;0;877
FR;6;2023-02-04;6;9;9;7;11;9;8;0;2;18848;14044;2159;3271;17146;2847;3526;0;879
FR;6;2023-02-05;0;0;0;4;0;0;4;0;0;18848;14044;2159;3275;17146;2847;3530;0;879
FR;6;2023-02-06;10;16;1;4;15;5;4;0;0;18858;14060;2160;3279;17161;2852;3534;0;879
FR;6;2023-02-07;8;9;4;8;9;7;7;0;3;18866;14069;2164;3287;17170;2859;3541;0;882
FR;6;2023-02-08;7;3;3;2;2;6;1;0;1;18873;14072;2167;3289;17172;2865;3542;0;883
FR;6;2023-02-09;6;11;1;6;8;8;2;0;2;18879;14083;2168;3295;17180;2873;3544;0;885
FR;6;2023-02-10;13;21;6;12;15;15;11;0;2;18892;14104;2174;3307;17195;2888;3555;0;887
FR;6;2023-02-11;12;8;7;4;9;3;9;0;5;18904;14112;2181;3311;17204;2891;3564;0;892
FR;6;2023-02-12;0;1;0;0;1;0;0;0;0;18904;14113;2181;3311;17205;2891;3564;0;892
FR;6;2023-02-13;5;6;0;0;6;1;0;0;0;18909;14119;2181;3311;17211;2892;3564;0;892
FR;6;2023-02-14;12;13;3;15;15;4;14;0;0;18921;14132;2184;3326;17226;2896;3578;0;892
FR;6;2023-02-15;8;11;3;2;11;2;2;0;4;18929;14143;2187;3328;17237;2898;3580;0;896
FR;6;2023-02-16;17;8;1;3;18;1;3;0;4;18946;14151;2188;3331;17255;2899;3583;0;900
FR;6;2023-02-17;9;15;3;9;12;8;9;0;5;18955;14166;2191;3340;17267;2907;3592;0;905
FR;6;2023-02-18;10;6;1;1;7;1;1;0;0;18965;14172;2192;3341;17274;2908;3593;0;905
FR;6;2023-02-19;0;0;0;0;0;0;0;0;0;18965;14172;2192;3341;17274;2908;3593;0;905
FR;6;2023-02-20;10;8;3;2;9;5;1;0;0;18975;14180;2195;3343;17283;2913;3594;0;905
FR;6;2023-02-21;9;8;8;5;6;7;8;0;1;18984;14188;2203;3348;17289;2920;3602;0;906
FR;6;2023-02-22;4;13;1;3;13;3;3;0;5;18988;14201;2204;3351;17302;2923;3605;0;911
FR;6;2023-02-23;7;11;6;2;10;6;4;0;1;18995;14212;2210;3353;17312;2929;3609;0;912
FR;6;2023-02-24;9;13;5;21;14;5;19;0;15;19004;14225;2215;3374;17326;2934;3628;0;927
FR;6;2023-02-25;4;5;1;1;6;1;1;0;0;19008;14230;2216;3375;17332;2935;3629;0;927
FR;6;2023-02-26;0;1;0;0;0;1;0;0;0;19008;14231;2216;3375;17332;2936;3629;0;927
FR;6;2023-02-27;10;8;3;1;3;9;0;0;2;19018;14239;2219;3376;17335;2945;3629;0;929
FR;6;2023-02-28;3;8;4;4;9;3;6;0;0;19021;14247;2223;3380;17344;2948;3635;0;929
FR;6;2023-03-01;6;10;3;2;10;4;2;0;0;19027;14257;2226;3382;17354;2952;3637;0;929
FR;6;2023-03-02;8;7;1;3;7;3;2;0;5;19035;14264;2227;3385;17361;2955;3639;0;934
FR;6;2023-03-03;14;12;5;7;11;9;6;0;7;19049;14276;2232;3392;17372;2964;3645;0;941
FR;6;2023-03-04;8;14;1;0;13;3;0;0;0;19057;14290;2233;3392;17385;2967;3645;0;941
FR;6;2023-03-05;4;0;0;0;0;0;0;0;0;19061;14290;2233;3392;17385;2967;3645;0;941
FR;6;2023-03-06;8;12;0;1;11;2;0;0;1;19069;14302;2233;3393;17396;2969;3645;0;942
FR;6;2023-03-07;4;6;0;1;4;3;0;0;5;19073;14308;2233;3394;17400;2972;3645;0;947
FR;6;2023-03-08;3;7;2;0;7;2;0;0;0;19076;14315;2235;3394;17407;2974;3645;0;947
FR;6;2023-03-09;7;6;0;1;6;2;1;0;0;19083;14321;2235;3395;17413;2976;3646;0;947
FR;6;2023-03-10;9;9;2;9;9;2;9;0;9;19092;14330;2237;3404;17422;2978;3655;0;956
FR;6;2023-03-11;13;12;2;0;12;2;2;0;0;19105;14342;2239;3404;17434;2980;3657;0;956
FR;6;2023-03-12;2;0;0;0;1;0;0;0;0;19107;14342;2239;3404;17435;2980;3657;0;956
FR;6;2023-03-13;7;12;4;1;13;2;1;0;2;19114;14354;2243;3405;17448;2982;3658;0;958
FR;6;2023-03-14;5;12;2;0;8;6;0;0;0;19119;14366;2245;3405;17456;2988;3658;0;958
FR;6;2023-03-15;6;4;2;3;5;3;3;0;1;19125;14370;2247;3408;17461;2991;3661;0;959
FR;6;2023-03-16;9;5;2;0;5;3;0;0;0;19134;14375;2249;3408;17466;2994;3661;0;959
FR;6;2023-03-17;10;12;5;5;8;8;5;0;3;19144;14387;2254;3413;17474;3002;3666;0;962
FR;6;2023-03-18;6;2;2;0;3;2;0;0;0;19150;14389;2256;3413;17477;3004;3666;0;962
FR;6;2023-03-19;0;0;1;0;0;0;0;0;0;19150;14389;2257;3413;17477;3004;3666;0;962
FR;6;2023-03-20;2;6;3;7;5;4;5;0;4;19152;14395;2260;3420;17482;3008;3671;0;966
FR;6;2023-03-21;2;1;5;2;1;3;4;0;0;19154;14396;2265;3422;17483;3011;3675;0;966
FR;6;2023-03-22;1;4;3;0;4;3;0;0;3;19155;14400;2268;3422;17487;3014;3675;0;969
FR;6;2023-03-23;3;4;3;2;5;3;2;0;0;19158;14404;2271;3424;17492;3017;3677;0;969
FR;6;2023-03-24;3;9;6;0;9;7;0;0;0;19161;14413;2277;3424;17501;3024;3677;0;969
FR;6;2023-03-25;9;7;0;0;8;0;0;0;0;19170;14420;2277;3424;17509;3024;3677;0;969
FR;6;2023-03-26;0;0;0;0;0;0;0;0;0;19170;14420;2277;3424;17509;3024;3677;0;969
FR;6;2023-03-27;6;9;2;2;8;4;1;0;0;19176;14429;2279;3426;17517;3028;3678;0;969
FR;6;2023-03-28;10;2;2;2;6;2;2;0;2;19186;14431;2281;3428;17523;3030;3680;0;971
FR;6;2023-03-29;4;1;2;0;1;2;0;0;0;19190;14432;2283;3428;17524;3032;3680;0;971
FR;8;2020-12-27;0;0;0;0;0;0;0;0;0;0;0;0;0;0;0;0;0;0
FR;8;2020-12-28;0;0;0;0;0;0;0;0;0;0;0;0;0;0;0;0;0;0
FR;8;2020-12-29;0;0;0;0;0;0;0;0;0;0;0;0;0;0;0;0;0;0
FR;8;2020-12-30;0;0;0;0;0;0;0;0;0;0;0;0;0;0;0;0;0;0
FR;8;2020-12-31;0;0;0;0;0;0;0;0;0;0;0;0;0;0;0;0;0;0
FR;8;2021-01-01;0;0;0;0;0;0;0;0;0;0;0;0;0;0;0;0;0;0
FR;8;2021-01-02;0;0;0;0;0;0;0;0;0;0;0;0;0;0;0;0;0;0
FR;8;2021-01-03;0;0;0;0;0;0;0;0;0;0;0;0;0;0;0;0;0;0
FR;8;2021-01-04;0;0;0;0;0;0;0;0;0;0;0;0;0;0;0;0;0;0
FR;8;2021-01-05;0;0;0;0;0;0;0;0;0;0;0;0;0;0;0;0;0;0
FR;8;2021-01-06;0;0;0;0;0;0;0;0;0;0;0;0;0;0;0;0;0;0
FR;8;2021-01-07;0;0;0;0;0;0;0;0;0;0;0;0;0;0;0;0;0;0
FR;8;2021-01-08;0;0;0;0;0;0;0;0;0;0;0;0;0;0;0;0;0;0
FR;8;2021-01-09;0;0;0;0;0;0;0;0;0;0;0;0;0;0;0;0;0;0
FR;8;2021-01-10;0;0;0;0;0;0;0;0;0;0;0;0;0;0;0;0;0;0
FR;8;2021-01-11;0;0;0;0;0;0;0;0;0;0;0;0;0;0;0;0;0;0
FR;8;2021-01-12;0;0;0;0;0;0;0;0;0;0;0;0;0;0;0;0;0;0
FR;8;2021-01-13;0;0;0;0;0;0;0;0;0;0;0;0;0;0;0;0;0;0
FR;8;2021-01-14;0;0;0;0;0;0;0;0;0;0;0;0;0;0;0;0;0;0
FR;8;2021-01-15;0;0;0;0;0;0;0;0;0;0;0;0;0;0;0;0;0;0
FR;8;2021-01-16;0;0;0;0;0;0;0;0;0;0;0;0;0;0;0;0;0;0
FR;8;2021-01-17;0;0;0;0;0;0;0;0;0;0;0;0;0;0;0;0;0;0
FR;8;2021-01-18;0;0;0;0;0;0;0;0;0;0;0;0;0;0;0;0;0;0
FR;8;2021-01-19;0;0;0;0;0;0;0;0;0;0;0;0;0;0;0;0;0;0
FR;8;2021-01-20;0;0;0;0;0;0;0;0;0;0;0;0;0;0;0;0;0;0
FR;8;2021-01-21;0;0;0;0;0;0;0;0;0;0;0;0;0;0;0;0;0;0
FR;8;2021-01-22;0;0;0;0;0;0;0;0;0;0;0;0;0;0;0;0;0;0
FR;8;2021-01-23;0;0;0;0;0;0;0;0;0;0;0;0;0;0;0;0;0;0
FR;8;2021-01-24;0;0;0;0;0;0;0;0;0;0;0;0;0;0;0;0;0;0
FR;8;2021-01-25;0;0;0;0;0;0;0;0;0;0;0;0;0;0;0;0;0;0
FR;8;2021-01-26;0;0;0;0;0;0;0;0;0;0;0;0;0;0;0;0;0;0
FR;8;2021-01-27;0;0;0;0;0;0;0;0;0;0;0;0;0;0;0;0;0;0
FR;8;2021-01-28;0;0;0;0;0;0;0;0;0;0;0;0;0;0;0;0;0;0
FR;8;2021-01-29;0;0;0;0;0;0;0;0;0;0;0;0;0;0;0;0;0;0
FR;8;2021-01-30;0;0;0;0;0;0;0;0;0;0;0;0;0;0;0;0;0;0
FR;8;2021-01-31;0;0;0;0;0;0;0;0;0;0;0;0;0;0;0;0;0;0
FR;8;2021-02-01;0;0;0;0;0;0;0;0;0;0;0;0;0;0;0;0;0;0
FR;8;2021-02-02;0;0;0;0;0;0;0;0;0;0;0;0;0;0;0;0;0;0
FR;8;2021-02-03;0;0;0;0;0;0;0;0;0;0;0;0;0;0;0;0;0;0
FR;8;2021-02-04;0;0;0;0;0;0;0;0;0;0;0;0;0;0;0;0;0;0
FR;8;2021-02-05;0;0;0;0;0;0;0;0;0;0;0;0;0;0;0;0;0;0
FR;8;2021-02-06;0;0;0;0;0;0;0;0;0;0;0;0;0;0;0;0;0;0
FR;8;2021-02-07;0;0;0;0;0;0;0;0;0;0;0;0;0;0;0;0;0;0
FR;8;2021-02-08;0;0;0;0;0;0;0;0;0;0;0;0;0;0;0;0;0;0
FR;8;2021-02-09;0;0;0;0;0;0;0;0;0;0;0;0;0;0;0;0;0;0
FR;8;2021-02-10;0;0;0;0;0;0;0;0;0;0;0;0;0;0;0;0;0;0
FR;8;2021-02-11;0;0;0;0;0;0;0;0;0;0;0;0;0;0;0;0;0;0
FR;8;2021-02-12;0;0;0;0;0;0;0;0;0;0;0;0;0;0;0;0;0;0
FR;8;2021-02-13;0;0;0;0;0;0;0;0;0;0;0;0;0;0;0;0;0;0
FR;8;2021-02-14;0;0;0;0;0;0;0;0;0;0;0;0;0;0;0;0;0;0
FR;8;2021-02-15;0;0;0;0;0;0;0;0;0;0;0;0;0;0;0;0;0;0
FR;8;2021-02-16;0;0;0;0;0;0;0;0;0;0;0;0;0;0;0;0;0;0
FR;8;2021-02-17;0;0;0;0;0;0;0;0;0;0;0;0;0;0;0;0;0;0
FR;8;2021-02-18;0;0;0;0;0;0;0;0;0;0;0;0;0;0;0;0;0;0
FR;8;2021-02-19;0;0;0;0;0;0;0;0;0;0;0;0;0;0;0;0;0;0
FR;8;2021-02-20;0;0;0;0;0;0;0;0;0;0;0;0;0;0;0;0;0;0
FR;8;2021-02-21;0;0;0;0;0;0;0;0;0;0;0;0;0;0;0;0;0;0
FR;8;2021-02-22;0;0;0;0;0;0;0;0;0;0;0;0;0;0;0;0;0;0
FR;8;2021-02-23;0;0;0;0;0;0;0;0;0;0;0;0;0;0;0;0;0;0
FR;8;2021-02-24;0;0;0;0;0;0;0;0;0;0;0;0;0;0;0;0;0;0
FR;8;2021-02-25;0;0;0;0;0;0;0;0;0;0;0;0;0;0;0;0;0;0
FR;8;2021-02-26;0;0;0;0;0;0;0;0;0;0;0;0;0;0;0;0;0;0
FR;8;2021-02-27;0;0;0;0;0;0;0;0;0;0;0;0;0;0;0;0;0;0
FR;8;2021-02-28;0;0;0;0;0;0;0;0;0;0;0;0;0;0;0;0;0;0
FR;8;2021-03-01;0;0;0;0;0;0;0;0;0;0;0;0;0;0;0;0;0;0
FR;8;2021-03-02;0;0;0;0;0;0;0;0;0;0;0;0;0;0;0;0;0;0
FR;8;2021-03-03;0;0;0;0;0;0;0;0;0;0;0;0;0;0;0;0;0;0
FR;8;2021-03-04;0;0;0;0;0;0;0;0;0;0;0;0;0;0;0;0;0;0
FR;8;2021-03-05;0;0;0;0;0;0;0;0;0;0;0;0;0;0;0;0;0;0
FR;8;2021-03-06;0;0;0;0;0;0;0;0;0;0;0;0;0;0;0;0;0;0
FR;8;2021-03-07;0;0;0;0;0;0;0;0;0;0;0;0;0;0;0;0;0;0
FR;8;2021-03-08;0;0;0;0;0;0;0;0;0;0;0;0;0;0;0;0;0;0
FR;8;2021-03-09;0;0;0;0;0;0;0;0;0;0;0;0;0;0;0;0;0;0
FR;8;2021-03-10;0;0;0;0;0;0;0;0;0;0;0;0;0;0;0;0;0;0
FR;8;2021-03-11;0;0;0;0;0;0;0;0;0;0;0;0;0;0;0;0;0;0
FR;8;2021-03-12;0;0;0;0;0;0;0;0;0;0;0;0;0;0;0;0;0;0
FR;8;2021-03-13;0;0;0;0;0;0;0;0;0;0;0;0;0;0;0;0;0;0
FR;8;2021-03-14;0;0;0;0;0;0;0;0;0;0;0;0;0;0;0;0;0;0
FR;8;2021-03-15;0;0;0;0;0;0;0;0;0;0;0;0;0;0;0;0;0;0
FR;8;2021-03-16;0;0;0;0;0;0;0;0;0;0;0;0;0;0;0;0;0;0
FR;8;2021-03-17;0;0;0;0;0;0;0;0;0;0;0;0;0;0;0;0;0;0
FR;8;2021-03-18;0;0;0;0;0;0;0;0;0;0;0;0;0;0;0;0;0;0
FR;8;2021-03-19;0;0;0;0;0;0;0;0;0;0;0;0;0;0;0;0;0;0
FR;8;2021-03-20;0;0;0;0;0;0;0;0;0;0;0;0;0;0;0;0;0;0
FR;8;2021-03-21;0;0;0;0;0;0;0;0;0;0;0;0;0;0;0;0;0;0
FR;8;2021-03-22;0;0;0;0;0;0;0;0;0;0;0;0;0;0;0;0;0;0
FR;8;2021-03-23;0;0;0;0;0;0;0;0;0;0;0;0;0;0;0;0;0;0
FR;8;2021-03-24;0;0;0;0;0;0;0;0;0;0;0;0;0;0;0;0;0;0
FR;8;2021-03-25;0;0;0;0;0;0;0;0;0;0;0;0;0;0;0;0;0;0
FR;8;2021-03-26;0;0;0;0;0;0;0;0;0;0;0;0;0;0;0;0;0;0
FR;8;2021-03-27;0;0;0;0;0;0;0;0;0;0;0;0;0;0;0;0;0;0
FR;8;2021-03-28;0;0;0;0;0;0;0;0;0;0;0;0;0;0;0;0;0;0
FR;8;2021-03-29;0;0;0;0;0;0;0;0;0;0;0;0;0;0;0;0;0;0
FR;8;2021-03-30;0;0;0;0;0;0;0;0;0;0;0;0;0;0;0;0;0;0
FR;8;2021-03-31;0;0;0;0;0;0;0;0;0;0;0;0;0;0;0;0;0;0
FR;8;2021-04-01;0;0;0;0;0;0;0;0;0;0;0;0;0;0;0;0;0;0
FR;8;2021-04-02;0;0;0;0;0;0;0;0;0;0;0;0;0;0;0;0;0;0
FR;8;2021-04-03;0;0;0;0;0;0;0;0;0;0;0;0;0;0;0;0;0;0
FR;8;2021-04-04;0;0;0;0;0;0;0;0;0;0;0;0;0;0;0;0;0;0
FR;8;2021-04-05;0;0;0;0;0;0;0;0;0;0;0;0;0;0;0;0;0;0
FR;8;2021-04-06;0;0;0;0;0;0;0;0;0;0;0;0;0;0;0;0;0;0
FR;8;2021-04-07;0;0;0;0;0;0;0;0;0;0;0;0;0;0;0;0;0;0
FR;8;2021-04-08;0;0;0;0;0;0;0;0;0;0;0;0;0;0;0;0;0;0
FR;8;2021-04-09;0;0;0;0;0;0;0;0;0;0;0;0;0;0;0;0;0;0
FR;8;2021-04-10;0;0;0;0;0;0;0;0;0;0;0;0;0;0;0;0;0;0
FR;8;2021-04-11;0;0;0;0;0;0;0;0;0;0;0;0;0;0;0;0;0;0
FR;8;2021-04-12;0;0;0;0;0;0;0;0;0;0;0;0;0;0;0;0;0;0
FR;8;2021-04-13;0;0;0;0;0;0;0;0;0;0;0;0;0;0;0;0;0;0
FR;8;2021-04-14;0;0;0;0;0;0;0;0;0;0;0;0;0;0;0;0;0;0
FR;8;2021-04-15;0;0;0;0;0;0;0;0;0;0;0;0;0;0;0;0;0;0
FR;8;2021-04-16;0;0;0;0;0;0;0;0;0;0;0;0;0;0;0;0;0;0
FR;8;2021-04-17;0;0;0;0;0;0;0;0;0;0;0;0;0;0;0;0;0;0
FR;8;2021-04-18;0;0;0;0;0;0;0;0;0;0;0;0;0;0;0;0;0;0
FR;8;2021-04-19;0;0;0;0;0;0;0;0;0;0;0;0;0;0;0;0;0;0
FR;8;2021-04-20;0;0;0;0;0;0;0;0;0;0;0;0;0;0;0;0;0;0
FR;8;2021-04-21;0;0;0;0;0;0;0;0;0;0;0;0;0;0;0;0;0;0
FR;8;2021-04-22;0;0;0;0;0;0;0;0;0;0;0;0;0;0;0;0;0;0
FR;8;2021-04-23;0;0;0;0;0;0;0;0;0;0;0;0;0;0;0;0;0;0
FR;8;2021-04-24;0;0;0;0;0;0;0;0;0;0;0;0;0;0;0;0;0;0
FR;8;2021-04-25;0;0;0;0;0;0;0;0;0;0;0;0;0;0;0;0;0;0
FR;8;2021-04-26;0;0;0;0;0;0;0;0;0;0;0;0;0;0;0;0;0;0
FR;8;2021-04-27;0;0;0;0;0;0;0;0;0;0;0;0;0;0;0;0;0;0
FR;8;2021-04-28;0;0;0;0;0;0;0;0;0;0;0;0;0;0;0;0;0;0
FR;8;2021-04-29;0;0;0;0;0;0;0;0;0;0;0;0;0;0;0;0;0;0
FR;8;2021-04-30;0;0;0;0;0;0;0;0;0;0;0;0;0;0;0;0;0;0
FR;8;2021-05-01;0;0;0;0;0;0;0;0;0;0;0;0;0;0;0;0;0;0
FR;8;2021-05-02;0;0;0;0;0;0;0;0;0;0;0;0;0;0;0;0;0;0
FR;8;2021-05-03;0;0;0;0;0;0;0;0;0;0;0;0;0;0;0;0;0;0
FR;8;2021-05-04;0;0;0;0;0;0;0;0;0;0;0;0;0;0;0;0;0;0
FR;8;2021-05-05;0;0;0;0;0;0;0;0;0;0;0;0;0;0;0;0;0;0
FR;8;2021-05-06;0;0;0;0;0;0;0;0;0;0;0;0;0;0;0;0;0;0
FR;8;2021-05-07;0;0;0;0;0;0;0;0;0;0;0;0;0;0;0;0;0;0
FR;8;2021-05-08;0;0;0;0;0;0;0;0;0;0;0;0;0;0;0;0;0;0
FR;8;2021-05-09;0;0;0;0;0;0;0;0;0;0;0;0;0;0;0;0;0;0
FR;8;2021-05-10;0;0;0;0;0;0;0;0;0;0;0;0;0;0;0;0;0;0
FR;8;2021-05-11;0;0;0;0;0;0;0;0;0;0;0;0;0;0;0;0;0;0
FR;8;2021-05-12;0;0;0;0;0;0;0;0;0;0;0;0;0;0;0;0;0;0
FR;8;2021-05-13;0;0;0;0;0;0;0;0;0;0;0;0;0;0;0;0;0;0
FR;8;2021-05-14;0;0;0;0;0;0;0;0;0;0;0;0;0;0;0;0;0;0
FR;8;2021-05-15;0;0;0;0;0;0;0;0;0;0;0;0;0;0;0;0;0;0
FR;8;2021-05-16;0;0;0;0;0;0;0;0;0;0;0;0;0;0;0;0;0;0
FR;8;2021-05-17;0;0;0;0;0;0;0;0;0;0;0;0;0;0;0;0;0;0
FR;8;2021-05-18;0;0;0;0;0;0;0;0;0;0;0;0;0;0;0;0;0;0
FR;8;2021-05-19;0;0;0;0;0;0;0;0;0;0;0;0;0;0;0;0;0;0
FR;8;2021-05-20;0;0;0;0;0;0;0;0;0;0;0;0;0;0;0;0;0;0
FR;8;2021-05-21;0;0;0;0;0;0;0;0;0;0;0;0;0;0;0;0;0;0
FR;8;2021-05-22;0;0;0;0;0;0;0;0;0;0;0;0;0;0;0;0;0;0
FR;8;2021-05-23;0;0;0;0;0;0;0;0;0;0;0;0;0;0;0;0;0;0
FR;8;2021-05-24;0;0;0;0;0;0;0;0;0;0;0;0;0;0;0;0;0;0
FR;8;2021-05-25;0;0;0;0;0;0;0;0;0;0;0;0;0;0;0;0;0;0
FR;8;2021-05-26;0;0;0;0;0;0;0;0;0;0;0;0;0;0;0;0;0;0
FR;8;2021-05-27;0;0;0;0;0;0;0;0;0;0;0;0;0;0;0;0;0;0
FR;8;2021-05-28;0;0;0;0;0;0;0;0;0;0;0;0;0;0;0;0;0;0
FR;8;2021-05-29;0;0;0;0;0;0;0;0;0;0;0;0;0;0;0;0;0;0
FR;8;2021-05-30;0;0;0;0;0;0;0;0;0;0;0;0;0;0;0;0;0;0
FR;8;2021-05-31;0;0;0;0;0;0;0;0;0;0;0;0;0;0;0;0;0;0
FR;8;2021-06-01;0;0;0;0;0;0;0;0;0;0;0;0;0;0;0;0;0;0
FR;8;2021-06-02;0;0;0;0;0;0;0;0;0;0;0;0;0;0;0;0;0;0
FR;8;2021-06-03;0;0;0;0;0;0;0;0;0;0;0;0;0;0;0;0;0;0
FR;8;2021-06-04;0;0;0;0;0;0;0;0;0;0;0;0;0;0;0;0;0;0
FR;8;2021-06-05;0;0;0;0;0;0;0;0;0;0;0;0;0;0;0;0;0;0
FR;8;2021-06-06;0;0;0;0;0;0;0;0;0;0;0;0;0;0;0;0;0;0
FR;8;2021-06-07;0;0;0;0;0;0;0;0;0;0;0;0;0;0;0;0;0;0
FR;8;2021-06-08;0;0;0;0;0;0;0;0;0;0;0;0;0;0;0;0;0;0
FR;8;2021-06-09;0;0;0;0;0;0;0;0;0;0;0;0;0;0;0;0;0;0
FR;8;2021-06-10;0;0;0;0;0;0;0;0;0;0;0;0;0;0;0;0;0;0
FR;8;2021-06-11;0;0;0;0;0;0;0;0;0;0;0;0;0;0;0;0;0;0
FR;8;2021-06-12;0;0;0;0;0;0;0;0;0;0;0;0;0;0;0;0;0;0
FR;8;2021-06-13;0;0;0;0;0;0;0;0;0;0;0;0;0;0;0;0;0;0
FR;8;2021-06-14;0;0;0;0;0;0;0;0;0;0;0;0;0;0;0;0;0;0
FR;8;2021-06-15;0;0;0;0;0;0;0;0;0;0;0;0;0;0;0;0;0;0
FR;8;2021-06-16;0;0;0;0;0;0;0;0;0;0;0;0;0;0;0;0;0;0
FR;8;2021-06-17;0;0;0;0;0;0;0;0;0;0;0;0;0;0;0;0;0;0
FR;8;2021-06-18;0;0;0;0;0;0;0;0;0;0;0;0;0;0;0;0;0;0
FR;8;2021-06-19;0;0;0;0;0;0;0;0;0;0;0;0;0;0;0;0;0;0
FR;8;2021-06-20;0;0;0;0;0;0;0;0;0;0;0;0;0;0;0;0;0;0
FR;8;2021-06-21;0;0;0;0;0;0;0;0;0;0;0;0;0;0;0;0;0;0
FR;8;2021-06-22;0;0;0;0;0;0;0;0;0;0;0;0;0;0;0;0;0;0
FR;8;2021-06-23;0;0;0;0;0;0;0;0;0;0;0;0;0;0;0;0;0;0
FR;8;2021-06-24;0;0;0;0;0;0;0;0;0;0;0;0;0;0;0;0;0;0
FR;8;2021-06-25;0;0;0;0;0;0;0;0;0;0;0;0;0;0;0;0;0;0
FR;8;2021-06-26;0;0;0;0;0;0;0;0;0;0;0;0;0;0;0;0;0;0
FR;8;2021-06-27;0;0;0;0;0;0;0;0;0;0;0;0;0;0;0;0;0;0
FR;8;2021-06-28;0;0;0;0;0;0;0;0;0;0;0;0;0;0;0;0;0;0
FR;8;2021-06-29;0;0;0;0;0;0;0;0;0;0;0;0;0;0;0;0;0;0
FR;8;2021-06-30;0;0;0;0;0;0;0;0;0;0;0;0;0;0;0;0;0;0
FR;8;2021-07-01;0;0;0;0;0;0;0;0;0;0;0;0;0;0;0;0;0;0
FR;8;2021-07-02;0;0;0;0;0;0;0;0;0;0;0;0;0;0;0;0;0;0
FR;8;2021-07-03;0;0;0;0;0;0;0;0;0;0;0;0;0;0;0;0;0;0
FR;8;2021-07-04;0;0;0;0;0;0;0;0;0;0;0;0;0;0;0;0;0;0
FR;8;2021-07-05;0;0;0;0;0;0;0;0;0;0;0;0;0;0;0;0;0;0
FR;8;2021-07-06;0;0;0;0;0;0;0;0;0;0;0;0;0;0;0;0;0;0
FR;8;2021-07-07;0;0;0;0;0;0;0;0;0;0;0;0;0;0;0;0;0;0
FR;8;2021-07-08;0;0;0;0;0;0;0;0;0;0;0;0;0;0;0;0;0;0
FR;8;2021-07-09;0;0;0;0;0;0;0;0;0;0;0;0;0;0;0;0;0;0
FR;8;2021-07-10;0;0;0;0;0;0;0;0;0;0;0;0;0;0;0;0;0;0
FR;8;2021-07-11;0;0;0;0;0;0;0;0;0;0;0;0;0;0;0;0;0;0
FR;8;2021-07-12;0;0;0;0;0;0;0;0;0;0;0;0;0;0;0;0;0;0
FR;8;2021-07-13;0;0;0;0;0;0;0;0;0;0;0;0;0;0;0;0;0;0
FR;8;2021-07-14;0;0;0;0;0;0;0;0;0;0;0;0;0;0;0;0;0;0
FR;8;2021-07-15;0;0;0;0;0;0;0;0;0;0;0;0;0;0;0;0;0;0
FR;8;2021-07-16;0;0;0;0;0;0;0;0;0;0;0;0;0;0;0;0;0;0
FR;8;2021-07-17;0;0;0;0;0;0;0;0;0;0;0;0;0;0;0;0;0;0
FR;8;2021-07-18;0;0;0;0;0;0;0;0;0;0;0;0;0;0;0;0;0;0
FR;8;2021-07-19;0;0;0;0;0;0;0;0;0;0;0;0;0;0;0;0;0;0
FR;8;2021-07-20;0;0;0;0;0;0;0;0;0;0;0;0;0;0;0;0;0;0
FR;8;2021-07-21;0;0;0;0;0;0;0;0;0;0;0;0;0;0;0;0;0;0
FR;8;2021-07-22;0;0;0;0;0;0;0;0;0;0;0;0;0;0;0;0;0;0
FR;8;2021-07-23;0;0;0;0;0;0;0;0;0;0;0;0;0;0;0;0;0;0
FR;8;2021-07-24;0;0;0;0;0;0;0;0;0;0;0;0;0;0;0;0;0;0
FR;8;2021-07-25;0;0;0;0;0;0;0;0;0;0;0;0;0;0;0;0;0;0
FR;8;2021-07-26;0;0;0;0;0;0;0;0;0;0;0;0;0;0;0;0;0;0
FR;8;2021-07-27;0;0;0;0;0;0;0;0;0;0;0;0;0;0;0;0;0;0
FR;8;2021-07-28;0;0;0;0;0;0;0;0;0;0;0;0;0;0;0;0;0;0
FR;8;2021-07-29;0;0;0;0;0;0;0;0;0;0;0;0;0;0;0;0;0;0
FR;8;2021-07-30;0;0;0;0;0;0;0;0;0;0;0;0;0;0;0;0;0;0
FR;8;2021-07-31;0;0;0;0;0;0;0;0;0;0;0;0;0;0;0;0;0;0
FR;8;2021-08-01;0;0;0;0;0;0;0;0;0;0;0;0;0;0;0;0;0;0
FR;8;2021-08-02;0;0;0;0;0;0;0;0;0;0;0;0;0;0;0;0;0;0
FR;8;2021-08-03;0;0;0;0;0;0;0;0;0;0;0;0;0;0;0;0;0;0
FR;8;2021-08-04;0;0;0;0;0;0;0;0;0;0;0;0;0;0;0;0;0;0
FR;8;2021-08-05;0;0;0;0;0;0;0;0;0;0;0;0;0;0;0;0;0;0
FR;8;2021-08-06;0;0;0;0;0;0;0;0;0;0;0;0;0;0;0;0;0;0
FR;8;2021-08-07;0;0;0;0;0;0;0;0;0;0;0;0;0;0;0;0;0;0
FR;8;2021-08-08;0;0;0;0;0;0;0;0;0;0;0;0;0;0;0;0;0;0
FR;8;2021-08-09;0;0;0;0;0;0;0;0;0;0;0;0;0;0;0;0;0;0
FR;8;2021-08-10;0;0;0;0;0;0;0;0;0;0;0;0;0;0;0;0;0;0
FR;8;2021-08-11;0;0;0;0;0;0;0;0;0;0;0;0;0;0;0;0;0;0
FR;8;2021-08-12;0;0;0;0;0;0;0;0;0;0;0;0;0;0;0;0;0;0
FR;8;2021-08-13;0;0;0;0;0;0;0;0;0;0;0;0;0;0;0;0;0;0
FR;8;2021-08-14;0;0;0;0;0;0;0;0;0;0;0;0;0;0;0;0;0;0
FR;8;2021-08-15;0;0;0;0;0;0;0;0;0;0;0;0;0;0;0;0;0;0
FR;8;2021-08-16;0;0;0;0;0;0;0;0;0;0;0;0;0;0;0;0;0;0
FR;8;2021-08-17;0;0;0;0;0;0;0;0;0;0;0;0;0;0;0;0;0;0
FR;8;2021-08-18;0;0;0;0;0;0;0;0;0;0;0;0;0;0;0;0;0;0
FR;8;2021-08-19;0;0;0;0;0;0;0;0;0;0;0;0;0;0;0;0;0;0
FR;8;2021-08-20;0;0;0;0;0;0;0;0;0;0;0;0;0;0;0;0;0;0
FR;8;2021-08-21;0;0;0;0;0;0;0;0;0;0;0;0;0;0;0;0;0;0
FR;8;2021-08-22;0;0;0;0;0;0;0;0;0;0;0;0;0;0;0;0;0;0
FR;8;2021-08-23;0;0;0;0;0;0;0;0;0;0;0;0;0;0;0;0;0;0
FR;8;2021-08-24;0;0;0;0;0;0;0;0;0;0;0;0;0;0;0;0;0;0
FR;8;2021-08-25;0;0;0;0;0;0;0;0;0;0;0;0;0;0;0;0;0;0
FR;8;2021-08-26;0;0;0;0;0;0;0;0;0;0;0;0;0;0;0;0;0;0
FR;8;2021-08-27;0;0;0;0;0;0;0;0;0;0;0;0;0;0;0;0;0;0
FR;8;2021-08-28;0;0;0;0;0;0;0;0;0;0;0;0;0;0;0;0;0;0
FR;8;2021-08-29;0;0;0;0;0;0;0;0;0;0;0;0;0;0;0;0;0;0
FR;8;2021-08-30;0;0;0;0;0;0;0;0;0;0;0;0;0;0;0;0;0;0
FR;8;2021-08-31;0;0;0;0;0;0;0;0;0;0;0;0;0;0;0;0;0;0
FR;8;2021-09-01;0;0;0;0;0;0;0;0;0;0;0;0;0;0;0;0;0;0
FR;8;2021-09-02;0;0;0;0;0;0;0;0;0;0;0;0;0;0;0;0;0;0
FR;8;2021-09-03;0;0;0;0;0;0;0;0;0;0;0;0;0;0;0;0;0;0
FR;8;2021-09-04;0;0;0;0;0;0;0;0;0;0;0;0;0;0;0;0;0;0
FR;8;2021-09-05;0;0;0;0;0;0;0;0;0;0;0;0;0;0;0;0;0;0
FR;8;2021-09-06;0;0;0;0;0;0;0;0;0;0;0;0;0;0;0;0;0;0
FR;8;2021-09-07;0;0;0;0;0;0;0;0;0;0;0;0;0;0;0;0;0;0
FR;8;2021-09-08;0;0;0;0;0;0;0;0;0;0;0;0;0;0;0;0;0;0
FR;8;2021-09-09;0;0;0;0;0;0;0;0;0;0;0;0;0;0;0;0;0;0
FR;8;2021-09-10;0;0;0;0;0;0;0;0;0;0;0;0;0;0;0;0;0;0
FR;8;2021-09-11;0;0;0;0;0;0;0;0;0;0;0;0;0;0;0;0;0;0
FR;8;2021-09-12;0;0;0;0;0;0;0;0;0;0;0;0;0;0;0;0;0;0
FR;8;2021-09-13;0;0;0;0;0;0;0;0;0;0;0;0;0;0;0;0;0;0
FR;8;2021-09-14;0;0;0;0;0;0;0;0;0;0;0;0;0;0;0;0;0;0
FR;8;2021-09-15;0;0;0;0;0;0;0;0;0;0;0;0;0;0;0;0;0;0
FR;8;2021-09-16;0;0;0;0;0;0;0;0;0;0;0;0;0;0;0;0;0;0
FR;8;2021-09-17;0;0;0;0;0;0;0;0;0;0;0;0;0;0;0;0;0;0
FR;8;2021-09-18;0;0;0;0;0;0;0;0;0;0;0;0;0;0;0;0;0;0
FR;8;2021-09-19;0;0;0;0;0;0;0;0;0;0;0;0;0;0;0;0;0;0
FR;8;2021-09-20;0;0;0;0;0;0;0;0;0;0;0;0;0;0;0;0;0;0
FR;8;2021-09-21;0;0;0;0;0;0;0;0;0;0;0;0;0;0;0;0;0;0
FR;8;2021-09-22;0;0;0;0;0;0;0;0;0;0;0;0;0;0;0;0;0;0
FR;8;2021-09-23;0;0;0;0;0;0;0;0;0;0;0;0;0;0;0;0;0;0
FR;8;2021-09-24;0;0;0;0;0;0;0;0;0;0;0;0;0;0;0;0;0;0
FR;8;2021-09-25;0;0;0;0;0;0;0;0;0;0;0;0;0;0;0;0;0;0
FR;8;2021-09-26;0;0;0;0;0;0;0;0;0;0;0;0;0;0;0;0;0;0
FR;8;2021-09-27;0;0;0;0;0;0;0;0;0;0;0;0;0;0;0;0;0;0
FR;8;2021-09-28;0;0;0;0;0;0;0;0;0;0;0;0;0;0;0;0;0;0
FR;8;2021-09-29;0;0;0;0;0;0;0;0;0;0;0;0;0;0;0;0;0;0
FR;8;2021-09-30;0;0;0;0;0;0;0;0;0;0;0;0;0;0;0;0;0;0
FR;8;2021-10-01;0;0;0;0;0;0;0;0;0;0;0;0;0;0;0;0;0;0
FR;8;2021-10-02;0;0;0;0;0;0;0;0;0;0;0;0;0;0;0;0;0;0
FR;8;2021-10-03;0;0;0;0;0;0;0;0;0;0;0;0;0;0;0;0;0;0
FR;8;2021-10-04;0;0;0;0;0;0;0;0;0;0;0;0;0;0;0;0;0;0
FR;8;2021-10-05;0;0;0;0;0;0;0;0;0;0;0;0;0;0;0;0;0;0
FR;8;2021-10-06;0;0;0;0;0;0;0;0;0;0;0;0;0;0;0;0;0;0
FR;8;2021-10-07;0;0;0;0;0;0;0;0;0;0;0;0;0;0;0;0;0;0
FR;8;2021-10-08;0;0;0;0;0;0;0;0;0;0;0;0;0;0;0;0;0;0
FR;8;2021-10-09;0;0;0;0;0;0;0;0;0;0;0;0;0;0;0;0;0;0
FR;8;2021-10-10;0;0;0;0;0;0;0;0;0;0;0;0;0;0;0;0;0;0
FR;8;2021-10-11;0;0;0;0;0;0;0;0;0;0;0;0;0;0;0;0;0;0
FR;8;2021-10-12;0;0;0;0;0;0;0;0;0;0;0;0;0;0;0;0;0;0
FR;8;2021-10-13;0;0;0;0;0;0;0;0;0;0;0;0;0;0;0;0;0;0
FR;8;2021-10-14;0;0;0;0;0;0;0;0;0;0;0;0;0;0;0;0;0;0
FR;8;2021-10-15;0;0;0;0;0;0;0;0;0;0;0;0;0;0;0;0;0;0
FR;8;2021-10-16;0;0;0;0;0;0;0;0;0;0;0;0;0;0;0;0;0;0
FR;8;2021-10-17;0;0;0;0;0;0;0;0;0;0;0;0;0;0;0;0;0;0
FR;8;2021-10-18;0;0;0;0;0;0;0;0;0;0;0;0;0;0;0;0;0;0
FR;8;2021-10-19;0;0;0;0;0;0;0;0;0;0;0;0;0;0;0;0;0;0
FR;8;2021-10-20;0;0;0;0;0;0;0;0;0;0;0;0;0;0;0;0;0;0
FR;8;2021-10-21;0;0;0;0;0;0;0;0;0;0;0;0;0;0;0;0;0;0
FR;8;2021-10-22;0;0;0;0;0;0;0;0;0;0;0;0;0;0;0;0;0;0
FR;8;2021-10-23;0;0;0;0;0;0;0;0;0;0;0;0;0;0;0;0;0;0
FR;8;2021-10-24;0;0;0;0;0;0;0;0;0;0;0;0;0;0;0;0;0;0
FR;8;2021-10-25;0;0;0;0;0;0;0;0;0;0;0;0;0;0;0;0;0;0
FR;8;2021-10-26;0;0;0;0;0;0;0;0;0;0;0;0;0;0;0;0;0;0
FR;8;2021-10-27;0;0;0;0;0;0;0;0;0;0;0;0;0;0;0;0;0;0
FR;8;2021-10-28;0;0;0;0;0;0;0;0;0;0;0;0;0;0;0;0;0;0
FR;8;2021-10-29;0;0;0;0;0;0;0;0;0;0;0;0;0;0;0;0;0;0
FR;8;2021-10-30;0;0;0;0;0;0;0;0;0;0;0;0;0;0;0;0;0;0
FR;8;2021-10-31;0;0;0;0;0;0;0;0;0;0;0;0;0;0;0;0;0;0
FR;8;2021-11-01;0;0;0;0;0;0;0;0;0;0;0;0;0;0;0;0;0;0
FR;8;2021-11-02;0;0;0;0;0;0;0;0;0;0;0;0;0;0;0;0;0;0
FR;8;2021-11-03;0;0;0;0;0;0;0;0;0;0;0;0;0;0;0;0;0;0
FR;8;2021-11-04;0;0;0;0;0;0;0;0;0;0;0;0;0;0;0;0;0;0
FR;8;2021-11-05;0;0;0;0;0;0;0;0;0;0;0;0;0;0;0;0;0;0
FR;8;2021-11-06;0;0;0;0;0;0;0;0;0;0;0;0;0;0;0;0;0;0
FR;8;2021-11-07;0;0;0;0;0;0;0;0;0;0;0;0;0;0;0;0;0;0
FR;8;2021-11-08;0;0;0;0;0;0;0;0;0;0;0;0;0;0;0;0;0;0
FR;8;2021-11-09;0;0;0;0;0;0;0;0;0;0;0;0;0;0;0;0;0;0
FR;8;2021-11-10;0;0;0;0;0;0;0;0;0;0;0;0;0;0;0;0;0;0
FR;8;2021-11-11;0;0;0;0;0;0;0;0;0;0;0;0;0;0;0;0;0;0
FR;8;2021-11-12;0;0;0;0;0;0;0;0;0;0;0;0;0;0;0;0;0;0
FR;8;2021-11-13;0;0;0;0;0;0;0;0;0;0;0;0;0;0;0;0;0;0
FR;8;2021-11-14;0;0;0;0;0;0;0;0;0;0;0;0;0;0;0;0;0;0
FR;8;2021-11-15;0;0;0;0;0;0;0;0;0;0;0;0;0;0;0;0;0;0
FR;8;2021-11-16;0;0;0;0;0;0;0;0;0;0;0;0;0;0;0;0;0;0
FR;8;2021-11-17;0;0;0;0;0;0;0;0;0;0;0;0;0;0;0;0;0;0
FR;8;2021-11-18;0;0;0;0;0;0;0;0;0;0;0;0;0;0;0;0;0;0
FR;8;2021-11-19;0;0;0;0;0;0;0;0;0;0;0;0;0;0;0;0;0;0
FR;8;2021-11-20;0;0;0;0;0;0;0;0;0;0;0;0;0;0;0;0;0;0
FR;8;2021-11-21;0;0;0;0;0;0;0;0;0;0;0;0;0;0;0;0;0;0
FR;8;2021-11-22;0;0;0;0;0;0;0;0;0;0;0;0;0;0;0;0;0;0
FR;8;2021-11-23;0;0;0;0;0;0;0;0;0;0;0;0;0;0;0;0;0;0
FR;8;2021-11-24;0;0;0;0;0;0;0;0;0;0;0;0;0;0;0;0;0;0
FR;8;2021-11-25;0;0;0;0;0;0;0;0;0;0;0;0;0;0;0;0;0;0
FR;8;2021-11-26;0;0;0;0;0;0;0;0;0;0;0;0;0;0;0;0;0;0
FR;8;2021-11-27;0;0;0;0;0;0;0;0;0;0;0;0;0;0;0;0;0;0
FR;8;2021-11-28;0;0;0;0;0;0;0;0;0;0;0;0;0;0;0;0;0;0
FR;8;2021-11-29;0;0;0;0;0;0;0;0;0;0;0;0;0;0;0;0;0;0
FR;8;2021-11-30;0;0;0;0;0;0;0;0;0;0;0;0;0;0;0;0;0;0
FR;8;2021-12-01;0;0;0;0;0;0;0;0;0;0;0;0;0;0;0;0;0;0
FR;8;2021-12-02;0;0;0;0;0;0;0;0;0;0;0;0;0;0;0;0;0;0
FR;8;2021-12-03;0;0;0;0;0;0;0;0;0;0;0;0;0;0;0;0;0;0
FR;8;2021-12-04;0;0;0;0;0;0;0;0;0;0;0;0;0;0;0;0;0;0
FR;8;2021-12-05;0;0;0;0;0;0;0;0;0;0;0;0;0;0;0;0;0;0
FR;8;2021-12-06;0;0;0;0;0;0;0;0;0;0;0;0;0;0;0;0;0;0
FR;8;2021-12-07;0;0;0;0;0;0;0;0;0;0;0;0;0;0;0;0;0;0
FR;8;2021-12-08;0;0;0;0;0;0;0;0;0;0;0;0;0;0;0;0;0;0
FR;8;2021-12-09;0;0;0;0;0;0;0;0;0;0;0;0;0;0;0;0;0;0
FR;8;2021-12-10;0;0;0;0;0;0;0;0;0;0;0;0;0;0;0;0;0;0
FR;8;2021-12-11;0;0;0;0;0;0;0;0;0;0;0;0;0;0;0;0;0;0
FR;8;2021-12-12;0;0;0;0;0;0;0;0;0;0;0;0;0;0;0;0;0;0
FR;8;2021-12-13;0;0;0;0;0;0;0;0;0;0;0;0;0;0;0;0;0;0
FR;8;2021-12-14;0;0;0;0;0;0;0;0;0;0;0;0;0;0;0;0;0;0
FR;8;2021-12-15;0;0;0;0;0;0;0;0;0;0;0;0;0;0;0;0;0;0
FR;8;2021-12-16;0;0;0;0;0;0;0;0;0;0;0;0;0;0;0;0;0;0
FR;8;2021-12-17;0;0;0;0;0;0;0;0;0;0;0;0;0;0;0;0;0;0
FR;8;2021-12-18;0;0;0;0;0;0;0;0;0;0;0;0;0;0;0;0;0;0
FR;8;2021-12-19;0;0;0;0;0;0;0;0;0;0;0;0;0;0;0;0;0;0
FR;8;2021-12-20;0;0;0;0;0;0;0;0;0;0;0;0;0;0;0;0;0;0
FR;8;2021-12-21;0;0;0;0;0;0;0;0;0;0;0;0;0;0;0;0;0;0
FR;8;2021-12-22;0;0;0;0;0;0;0;0;0;0;0;0;0;0;0;0;0;0
FR;8;2021-12-23;0;0;0;0;0;0;0;0;0;0;0;0;0;0;0;0;0;0
FR;8;2021-12-24;0;0;0;0;0;0;0;0;0;0;0;0;0;0;0;0;0;0
FR;8;2021-12-25;0;0;0;0;0;0;0;0;0;0;0;0;0;0;0;0;0;0
FR;8;2021-12-26;0;0;0;0;0;0;0;0;0;0;0;0;0;0;0;0;0;0
FR;8;2021-12-27;0;0;0;0;0;0;0;0;0;0;0;0;0;0;0;0;0;0
FR;8;2021-12-28;0;0;0;0;0;0;0;0;0;0;0;0;0;0;0;0;0;0
FR;8;2021-12-29;0;0;0;0;0;0;0;0;0;0;0;0;0;0;0;0;0;0
FR;8;2021-12-30;0;0;0;0;0;0;0;0;0;0;0;0;0;0;0;0;0;0
FR;8;2021-12-31;0;0;0;0;0;0;0;0;0;0;0;0;0;0;0;0;0;0
FR;8;2022-01-01;0;0;0;0;0;0;0;0;0;0;0;0;0;0;0;0;0;0
FR;8;2022-01-02;0;0;0;0;0;0;0;0;0;0;0;0;0;0;0;0;0;0
FR;8;2022-01-03;0;0;0;0;0;0;0;0;0;0;0;0;0;0;0;0;0;0
FR;8;2022-01-04;0;0;0;0;0;0;0;0;0;0;0;0;0;0;0;0;0;0
FR;8;2022-01-05;0;0;0;0;0;0;0;0;0;0;0;0;0;0;0;0;0;0
FR;8;2022-01-06;0;0;0;0;0;0;0;0;0;0;0;0;0;0;0;0;0;0
FR;8;2022-01-07;0;0;0;0;0;0;0;0;0;0;0;0;0;0;0;0;0;0
FR;8;2022-01-08;0;0;0;0;0;0;0;0;0;0;0;0;0;0;0;0;0;0
FR;8;2022-01-09;0;0;0;0;0;0;0;0;0;0;0;0;0;0;0;0;0;0
FR;8;2022-01-10;0;0;0;0;0;0;0;0;0;0;0;0;0;0;0;0;0;0
FR;8;2022-01-11;0;0;0;0;0;0;0;0;0;0;0;0;0;0;0;0;0;0
FR;8;2022-01-12;0;0;0;0;0;0;0;0;0;0;0;0;0;0;0;0;0;0
FR;8;2022-01-13;0;0;0;0;0;0;0;0;0;0;0;0;0;0;0;0;0;0
FR;8;2022-01-14;0;0;0;0;0;0;0;0;0;0;0;0;0;0;0;0;0;0
FR;8;2022-01-15;0;0;0;0;0;0;0;0;0;0;0;0;0;0;0;0;0;0
FR;8;2022-01-16;0;0;0;0;0;0;0;0;0;0;0;0;0;0;0;0;0;0
FR;8;2022-01-17;0;0;0;0;0;0;0;0;0;0;0;0;0;0;0;0;0;0
FR;8;2022-01-18;0;0;0;0;0;0;0;0;0;0;0;0;0;0;0;0;0;0
FR;8;2022-01-19;0;0;0;0;0;0;0;0;0;0;0;0;0;0;0;0;0;0
FR;8;2022-01-20;0;0;0;0;0;0;0;0;0;0;0;0;0;0;0;0;0;0
FR;8;2022-01-21;0;0;0;0;0;0;0;0;0;0;0;0;0;0;0;0;0;0
FR;8;2022-01-22;0;0;0;0;0;0;0;0;0;0;0;0;0;0;0;0;0;0
FR;8;2022-01-23;0;0;0;0;0;0;0;0;0;0;0;0;0;0;0;0;0;0
FR;8;2022-01-24;0;0;0;0;0;0;0;0;0;0;0;0;0;0;0;0;0;0
FR;8;2022-01-25;0;0;0;0;0;0;0;0;0;0;0;0;0;0;0;0;0;0
FR;8;2022-01-26;0;0;0;0;0;0;0;0;0;0;0;0;0;0;0;0;0;0
FR;8;2022-01-27;0;0;0;0;0;0;0;0;0;0;0;0;0;0;0;0;0;0
FR;8;2022-01-28;0;0;0;0;0;0;0;0;0;0;0;0;0;0;0;0;0;0
FR;8;2022-01-29;0;0;0;0;0;0;0;0;0;0;0;0;0;0;0;0;0;0
FR;8;2022-01-30;0;0;0;0;0;0;0;0;0;0;0;0;0;0;0;0;0;0
FR;8;2022-01-31;0;0;0;0;0;0;0;0;0;0;0;0;0;0;0;0;0;0
FR;8;2022-02-01;0;0;0;0;0;0;0;0;0;0;0;0;0;0;0;0;0;0
FR;8;2022-02-02;0;0;0;0;0;0;0;0;0;0;0;0;0;0;0;0;0;0
FR;8;2022-02-03;0;0;0;0;0;0;0;0;0;0;0;0;0;0;0;0;0;0
FR;8;2022-02-04;0;0;0;0;0;0;0;0;0;0;0;0;0;0;0;0;0;0
FR;8;2022-02-05;0;0;0;0;0;0;0;0;0;0;0;0;0;0;0;0;0;0
FR;8;2022-02-06;0;0;0;0;0;0;0;0;0;0;0;0;0;0;0;0;0;0
FR;8;2022-02-07;0;0;0;0;0;0;0;0;0;0;0;0;0;0;0;0;0;0
FR;8;2022-02-08;0;0;0;0;0;0;0;0;0;0;0;0;0;0;0;0;0;0
FR;8;2022-02-09;0;0;0;0;0;0;0;0;0;0;0;0;0;0;0;0;0;0
FR;8;2022-02-10;0;0;0;0;0;0;0;0;0;0;0;0;0;0;0;0;0;0
FR;8;2022-02-11;0;0;0;0;0;0;0;0;0;0;0;0;0;0;0;0;0;0
FR;8;2022-02-12;0;0;0;0;0;0;0;0;0;0;0;0;0;0;0;0;0;0
FR;8;2022-02-13;0;0;0;0;0;0;0;0;0;0;0;0;0;0;0;0;0;0
FR;8;2022-02-14;0;0;0;0;0;0;0;0;0;0;0;0;0;0;0;0;0;0
FR;8;2022-02-15;0;0;0;0;0;0;0;0;0;0;0;0;0;0;0;0;0;0
FR;8;2022-02-16;0;0;0;0;0;0;0;0;0;0;0;0;0;0;0;0;0;0
FR;8;2022-02-17;0;0;0;0;0;0;0;0;0;0;0;0;0;0;0;0;0;0
FR;8;2022-02-18;0;0;0;0;0;0;0;0;0;0;0;0;0;0;0;0;0;0
FR;8;2022-02-19;0;0;0;0;0;0;0;0;0;0;0;0;0;0;0;0;0;0
FR;8;2022-02-20;0;0;0;0;0;0;0;0;0;0;0;0;0;0;0;0;0;0
FR;8;2022-02-21;0;0;0;0;0;0;0;0;0;0;0;0;0;0;0;0;0;0
FR;8;2022-02-22;0;0;0;0;0;0;0;0;0;0;0;0;0;0;0;0;0;0
FR;8;2022-02-23;0;0;0;0;0;0;0;0;0;0;0;0;0;0;0;0;0;0
FR;8;2022-02-24;0;0;0;0;0;0;0;0;0;0;0;0;0;0;0;0;0;0
FR;8;2022-02-25;0;0;0;0;0;0;0;0;0;0;0;0;0;0;0;0;0;0
FR;8;2022-02-26;0;0;0;0;0;0;0;0;0;0;0;0;0;0;0;0;0;0
FR;8;2022-02-27;0;0;0;0;0;0;0;0;0;0;0;0;0;0;0;0;0;0
FR;8;2022-02-28;0;0;0;0;0;0;0;0;0;0;0;0;0;0;0;0;0;0
FR;8;2022-03-01;0;0;0;0;0;0;0;0;0;0;0;0;0;0;0;0;0;0
FR;8;2022-03-02;0;0;0;0;0;0;0;0;0;0;0;0;0;0;0;0;0;0
FR;8;2022-03-03;0;0;0;0;0;0;0;0;0;0;0;0;0;0;0;0;0;0
FR;8;2022-03-04;0;0;0;0;0;0;0;0;0;0;0;0;0;0;0;0;0;0
FR;8;2022-03-05;0;0;0;0;0;0;0;0;0;0;0;0;0;0;0;0;0;0
FR;8;2022-03-06;0;0;0;0;0;0;0;0;0;0;0;0;0;0;0;0;0;0
FR;8;2022-03-07;0;0;0;0;0;0;0;0;0;0;0;0;0;0;0;0;0;0
FR;8;2022-03-08;0;0;0;0;0;0;0;0;0;0;0;0;0;0;0;0;0;0
FR;8;2022-03-09;0;0;0;0;0;0;0;0;0;0;0;0;0;0;0;0;0;0
FR;8;2022-03-10;0;0;0;0;0;0;0;0;0;0;0;0;0;0;0;0;0;0
FR;8;2022-03-11;0;0;0;0;0;0;0;0;0;0;0;0;0;0;0;0;0;0
FR;8;2022-03-12;0;0;0;0;0;0;0;0;0;0;0;0;0;0;0;0;0;0
FR;8;2022-03-13;0;0;0;0;0;0;0;0;0;0;0;0;0;0;0;0;0;0
FR;8;2022-03-14;0;0;0;0;0;0;0;0;0;0;0;0;0;0;0;0;0;0
FR;8;2022-03-15;0;0;0;0;0;0;0;0;0;0;0;0;0;0;0;0;0;0
FR;8;2022-03-16;0;0;0;0;0;0;0;0;0;0;0;0;0;0;0;0;0;0
FR;8;2022-03-17;0;0;0;0;0;0;0;0;0;0;0;0;0;0;0;0;0;0
FR;8;2022-03-18;0;0;0;0;0;0;0;0;0;0;0;0;0;0;0;0;0;0
FR;8;2022-03-19;0;0;0;0;0;0;0;0;0;0;0;0;0;0;0;0;0;0
FR;8;2022-03-20;0;0;0;0;0;0;0;0;0;0;0;0;0;0;0;0;0;0
FR;8;2022-03-21;0;0;0;0;0;0;0;0;0;0;0;0;0;0;0;0;0;0
FR;8;2022-03-22;0;0;0;0;0;0;0;0;0;0;0;0;0;0;0;0;0;0
FR;8;2022-03-23;0;0;0;0;0;0;0;0;0;0;0;0;0;0;0;0;0;0
FR;8;2022-03-24;0;0;0;0;0;0;0;0;0;0;0;0;0;0;0;0;0;0
FR;8;2022-03-25;0;0;0;0;0;0;0;0;0;0;0;0;0;0;0;0;0;0
FR;8;2022-03-26;0;0;0;0;0;0;0;0;0;0;0;0;0;0;0;0;0;0
FR;8;2022-03-27;0;0;0;0;0;0;0;0;0;0;0;0;0;0;0;0;0;0
FR;8;2022-03-28;0;0;0;0;0;0;0;0;0;0;0;0;0;0;0;0;0;0
FR;8;2022-03-29;0;0;0;0;0;0;0;0;0;0;0;0;0;0;0;0;0;0
FR;8;2022-03-30;0;0;0;0;0;0;0;0;0;0;0;0;0;0;0;0;0;0
FR;8;2022-03-31;0;0;0;0;0;0;0;0;0;0;0;0;0;0;0;0;0;0
FR;8;2022-04-01;0;0;0;0;0;0;0;0;0;0;0;0;0;0;0;0;0;0
FR;8;2022-04-02;0;0;0;0;0;0;0;0;0;0;0;0;0;0;0;0;0;0
FR;8;2022-04-03;0;0;0;0;0;0;0;0;0;0;0;0;0;0;0;0;0;0
FR;8;2022-04-04;0;0;0;0;0;0;0;0;0;0;0;0;0;0;0;0;0;0
FR;8;2022-04-05;0;0;0;0;0;0;0;0;0;0;0;0;0;0;0;0;0;0
FR;8;2022-04-06;0;0;0;0;0;0;0;0;0;0;0;0;0;0;0;0;0;0
FR;8;2022-04-07;0;0;0;0;0;0;0;0;0;0;0;0;0;0;0;0;0;0
FR;8;2022-04-08;0;0;0;0;0;0;0;0;0;0;0;0;0;0;0;0;0;0
FR;8;2022-04-09;0;0;0;0;0;0;0;0;0;0;0;0;0;0;0;0;0;0
FR;8;2022-04-10;0;0;0;0;0;0;0;0;0;0;0;0;0;0;0;0;0;0
FR;8;2022-04-11;0;0;0;0;0;0;0;0;0;0;0;0;0;0;0;0;0;0
FR;8;2022-04-12;0;0;0;0;0;0;0;0;0;0;0;0;0;0;0;0;0;0
FR;8;2022-04-13;0;0;0;0;0;0;0;0;0;0;0;0;0;0;0;0;0;0
FR;8;2022-04-14;0;0;0;0;0;0;0;0;0;0;0;0;0;0;0;0;0;0
FR;8;2022-04-15;0;0;0;0;0;0;0;0;0;0;0;0;0;0;0;0;0;0
FR;8;2022-04-16;0;0;0;0;0;0;0;0;0;0;0;0;0;0;0;0;0;0
FR;8;2022-04-17;0;0;0;0;0;0;0;0;0;0;0;0;0;0;0;0;0;0
FR;8;2022-04-18;0;0;0;0;0;0;0;0;0;0;0;0;0;0;0;0;0;0
FR;8;2022-04-19;0;0;0;0;0;0;0;0;0;0;0;0;0;0;0;0;0;0
FR;8;2022-04-20;0;0;0;0;0;0;0;0;0;0;0;0;0;0;0;0;0;0
FR;8;2022-04-21;0;0;0;0;0;0;0;0;0;0;0;0;0;0;0;0;0;0
FR;8;2022-04-22;0;0;0;0;0;0;0;0;0;0;0;0;0;0;0;0;0;0
FR;8;2022-04-23;0;0;0;0;0;0;0;0;0;0;0;0;0;0;0;0;0;0
FR;8;2022-04-24;0;0;0;0;0;0;0;0;0;0;0;0;0;0;0;0;0;0
FR;8;2022-04-25;0;0;0;0;0;0;0;0;0;0;0;0;0;0;0;0;0;0
FR;8;2022-04-26;0;0;0;0;0;0;0;0;0;0;0;0;0;0;0;0;0;0
FR;8;2022-04-27;0;0;0;0;0;0;0;0;0;0;0;0;0;0;0;0;0;0
FR;8;2022-04-28;0;0;0;0;0;0;0;0;0;0;0;0;0;0;0;0;0;0
FR;8;2022-04-29;0;0;0;0;0;0;0;0;0;0;0;0;0;0;0;0;0;0
FR;8;2022-04-30;0;0;0;0;0;0;0;0;0;0;0;0;0;0;0;0;0;0
FR;8;2022-05-01;0;0;0;0;0;0;0;0;0;0;0;0;0;0;0;0;0;0
FR;8;2022-05-02;0;0;0;0;0;0;0;0;0;0;0;0;0;0;0;0;0;0
FR;8;2022-05-03;0;0;0;0;0;0;0;0;0;0;0;0;0;0;0;0;0;0
FR;8;2022-05-04;0;0;0;0;0;0;0;0;0;0;0;0;0;0;0;0;0;0
FR;8;2022-05-05;0;0;0;0;0;0;0;0;0;0;0;0;0;0;0;0;0;0
FR;8;2022-05-06;0;0;0;0;0;0;0;0;0;0;0;0;0;0;0;0;0;0
FR;8;2022-05-07;0;0;0;0;0;0;0;0;0;0;0;0;0;0;0;0;0;0
FR;8;2022-05-08;0;0;0;0;0;0;0;0;0;0;0;0;0;0;0;0;0;0
FR;8;2022-05-09;0;0;0;0;0;0;0;0;0;0;0;0;0;0;0;0;0;0
FR;8;2022-05-10;0;0;0;0;0;0;0;0;0;0;0;0;0;0;0;0;0;0
FR;8;2022-05-11;0;0;0;0;0;0;0;0;0;0;0;0;0;0;0;0;0;0
FR;8;2022-05-12;0;0;0;0;0;0;0;0;0;0;0;0;0;0;0;0;0;0
FR;8;2022-05-13;0;0;0;0;0;0;0;0;0;0;0;0;0;0;0;0;0;0
FR;8;2022-05-14;0;0;0;0;0;0;0;0;0;0;0;0;0;0;0;0;0;0
FR;8;2022-05-15;0;0;0;0;0;0;0;0;0;0;0;0;0;0;0;0;0;0
FR;8;2022-05-16;0;0;0;0;0;0;0;0;0;0;0;0;0;0;0;0;0;0
FR;8;2022-05-17;0;0;0;0;0;0;0;0;0;0;0;0;0;0;0;0;0;0
FR;8;2022-05-18;0;0;0;0;0;0;0;0;0;0;0;0;0;0;0;0;0;0
FR;8;2022-05-19;0;0;0;0;0;0;0;0;0;0;0;0;0;0;0;0;0;0
FR;8;2022-05-20;0;0;0;0;0;0;0;0;0;0;0;0;0;0;0;0;0;0
FR;8;2022-05-21;0;0;0;0;0;0;0;0;0;0;0;0;0;0;0;0;0;0
FR;8;2022-05-22;0;0;0;0;0;0;0;0;0;0;0;0;0;0;0;0;0;0
FR;8;2022-05-23;0;0;0;0;0;0;0;0;0;0;0;0;0;0;0;0;0;0
FR;8;2022-05-24;0;0;0;0;0;0;0;0;0;0;0;0;0;0;0;0;0;0
FR;8;2022-05-25;0;0;0;0;0;0;0;0;0;0;0;0;0;0;0;0;0;0
FR;8;2022-05-26;0;0;0;0;0;0;0;0;0;0;0;0;0;0;0;0;0;0
FR;8;2022-05-27;0;0;0;0;0;0;0;0;0;0;0;0;0;0;0;0;0;0
FR;8;2022-05-28;0;0;0;0;0;0;0;0;0;0;0;0;0;0;0;0;0;0
FR;8;2022-05-29;0;0;0;0;0;0;0;0;0;0;0;0;0;0;0;0;0;0
FR;8;2022-05-30;0;0;0;0;0;0;0;0;0;0;0;0;0;0;0;0;0;0
FR;8;2022-05-31;0;0;0;0;0;0;0;0;0;0;0;0;0;0;0;0;0;0
FR;8;2022-06-01;0;0;0;0;0;0;0;0;0;0;0;0;0;0;0;0;0;0
FR;8;2022-06-02;0;0;0;0;0;0;0;0;0;0;0;0;0;0;0;0;0;0
FR;8;2022-06-03;0;0;0;0;0;0;0;0;0;0;0;0;0;0;0;0;0;0
FR;8;2022-06-04;0;0;0;0;0;0;0;0;0;0;0;0;0;0;0;0;0;0
FR;8;2022-06-05;0;0;0;0;0;0;0;0;0;0;0;0;0;0;0;0;0;0
FR;8;2022-06-06;0;0;0;0;0;0;0;0;0;0;0;0;0;0;0;0;0;0
FR;8;2022-06-07;0;0;0;0;0;0;0;0;0;0;0;0;0;0;0;0;0;0
FR;8;2022-06-08;0;0;0;0;0;0;0;0;0;0;0;0;0;0;0;0;0;0
FR;8;2022-06-09;0;0;0;0;0;0;0;0;0;0;0;0;0;0;0;0;0;0
FR;8;2022-06-10;0;0;0;0;0;0;0;0;0;0;0;0;0;0;0;0;0;0
FR;8;2022-06-11;0;0;0;0;0;0;0;0;0;0;0;0;0;0;0;0;0;0
FR;8;2022-06-12;0;0;0;0;0;0;0;0;0;0;0;0;0;0;0;0;0;0
FR;8;2022-06-13;0;0;0;0;0;0;0;0;0;0;0;0;0;0;0;0;0;0
FR;8;2022-06-14;0;0;0;0;0;0;0;0;0;0;0;0;0;0;0;0;0;0
FR;8;2022-06-15;0;0;0;0;0;0;0;0;0;0;0;0;0;0;0;0;0;0
FR;8;2022-06-16;0;0;0;0;0;0;0;0;0;0;0;0;0;0;0;0;0;0
FR;8;2022-06-17;0;0;0;0;0;0;0;0;0;0;0;0;0;0;0;0;0;0
FR;8;2022-06-18;0;0;0;0;0;0;0;0;0;0;0;0;0;0;0;0;0;0
FR;8;2022-06-19;0;0;0;0;0;0;0;0;0;0;0;0;0;0;0;0;0;0
FR;8;2022-06-20;0;0;0;0;0;0;0;0;0;0;0;0;0;0;0;0;0;0
FR;8;2022-06-21;0;0;0;0;0;0;0;0;0;0;0;0;0;0;0;0;0;0
FR;8;2022-06-22;0;0;0;0;0;0;0;0;0;0;0;0;0;0;0;0;0;0
FR;8;2022-06-23;0;0;0;0;0;0;0;0;0;0;0;0;0;0;0;0;0;0
FR;8;2022-06-24;0;0;0;0;0;0;0;0;0;0;0;0;0;0;0;0;0;0
FR;8;2022-06-25;0;0;0;0;0;0;0;0;0;0;0;0;0;0;0;0;0;0
FR;8;2022-06-26;0;0;0;0;0;0;0;0;0;0;0;0;0;0;0;0;0;0
FR;8;2022-06-27;0;0;0;0;0;0;0;0;0;0;0;0;0;0;0;0;0;0
FR;8;2022-06-28;0;0;0;0;0;0;0;0;0;0;0;0;0;0;0;0;0;0
FR;8;2022-06-29;0;0;0;0;0;0;0;0;0;0;0;0;0;0;0;0;0;0
FR;8;2022-06-30;0;0;0;0;0;0;0;0;0;0;0;0;0;0;0;0;0;0
FR;8;2022-07-01;0;0;0;0;0;0;0;0;0;0;0;0;0;0;0;0;0;0
FR;8;2022-07-02;0;0;0;0;0;0;0;0;0;0;0;0;0;0;0;0;0;0
FR;8;2022-07-03;0;0;0;0;0;0;0;0;0;0;0;0;0;0;0;0;0;0
FR;8;2022-07-04;0;0;0;0;0;0;0;0;0;0;0;0;0;0;0;0;0;0
FR;8;2022-07-05;0;0;0;0;0;0;0;0;0;0;0;0;0;0;0;0;0;0
FR;8;2022-07-06;0;0;0;0;0;0;0;0;0;0;0;0;0;0;0;0;0;0
FR;8;2022-07-07;0;0;0;0;0;0;0;0;0;0;0;0;0;0;0;0;0;0
FR;8;2022-07-08;0;0;0;0;0;0;0;0;0;0;0;0;0;0;0;0;0;0
FR;8;2022-07-09;0;0;0;0;0;0;0;0;0;0;0;0;0;0;0;0;0;0
FR;8;2022-07-10;0;0;0;0;0;0;0;0;0;0;0;0;0;0;0;0;0;0
FR;8;2022-07-11;0;0;0;0;0;0;0;0;0;0;0;0;0;0;0;0;0;0
FR;8;2022-07-12;0;0;0;0;0;0;0;0;0;0;0;0;0;0;0;0;0;0
FR;8;2022-07-13;0;0;0;0;0;0;0;0;0;0;0;0;0;0;0;0;0;0
FR;8;2022-07-14;0;0;0;0;0;0;0;0;0;0;0;0;0;0;0;0;0;0
FR;8;2022-07-15;0;0;0;0;0;0;0;0;0;0;0;0;0;0;0;0;0;0
FR;8;2022-07-16;0;0;0;0;0;0;0;0;0;0;0;0;0;0;0;0;0;0
FR;8;2022-07-17;0;0;0;0;0;0;0;0;0;0;0;0;0;0;0;0;0;0
FR;8;2022-07-18;0;0;0;0;0;0;0;0;0;0;0;0;0;0;0;0;0;0
FR;8;2022-07-19;0;0;0;0;0;0;0;0;0;0;0;0;0;0;0;0;0;0
FR;8;2022-07-20;0;0;0;0;0;0;0;0;0;0;0;0;0;0;0;0;0;0
FR;8;2022-07-21;0;0;0;0;0;0;0;0;0;0;0;0;0;0;0;0;0;0
FR;8;2022-07-22;0;0;0;0;0;0;0;0;0;0;0;0;0;0;0;0;0;0
FR;8;2022-07-23;0;0;0;0;0;0;0;0;0;0;0;0;0;0;0;0;0;0
FR;8;2022-07-24;0;0;0;0;0;0;0;0;0;0;0;0;0;0;0;0;0;0
FR;8;2022-07-25;0;0;0;0;0;0;0;0;0;0;0;0;0;0;0;0;0;0
FR;8;2022-07-26;0;0;0;0;0;0;0;0;0;0;0;0;0;0;0;0;0;0
FR;8;2022-07-27;0;0;0;0;0;0;0;0;0;0;0;0;0;0;0;0;0;0
FR;8;2022-07-28;0;0;0;0;0;0;0;0;0;0;0;0;0;0;0;0;0;0
FR;8;2022-07-29;0;0;0;0;0;0;0;0;0;0;0;0;0;0;0;0;0;0
FR;8;2022-07-30;0;0;0;0;0;0;0;0;0;0;0;0;0;0;0;0;0;0
FR;8;2022-07-31;0;0;0;0;0;0;0;0;0;0;0;0;0;0;0;0;0;0
FR;8;2022-08-01;0;0;0;0;0;0;0;0;0;0;0;0;0;0;0;0;0;0
FR;8;2022-08-02;0;0;0;0;0;0;0;0;0;0;0;0;0;0;0;0;0;0
FR;8;2022-08-03;0;0;0;0;0;0;0;0;0;0;0;0;0;0;0;0;0;0
FR;8;2022-08-04;0;0;0;0;0;0;0;0;0;0;0;0;0;0;0;0;0;0
FR;8;2022-08-05;0;0;0;0;0;0;0;0;0;0;0;0;0;0;0;0;0;0
FR;8;2022-08-06;0;0;0;0;0;0;0;0;0;0;0;0;0;0;0;0;0;0
FR;8;2022-08-07;0;0;0;0;0;0;0;0;0;0;0;0;0;0;0;0;0;0
FR;8;2022-08-08;0;0;0;0;0;0;0;0;0;0;0;0;0;0;0;0;0;0
FR;8;2022-08-09;0;0;0;0;0;0;0;0;0;0;0;0;0;0;0;0;0;0
FR;8;2022-08-10;0;0;0;0;0;0;0;0;0;0;0;0;0;0;0;0;0;0
FR;8;2022-08-11;0;0;0;0;0;0;0;0;0;0;0;0;0;0;0;0;0;0
FR;8;2022-08-12;0;0;0;0;0;0;0;0;0;0;0;0;0;0;0;0;0;0
FR;8;2022-08-13;0;0;0;0;0;0;0;0;0;0;0;0;0;0;0;0;0;0
FR;8;2022-08-14;0;0;0;0;0;0;0;0;0;0;0;0;0;0;0;0;0;0
FR;8;2022-08-15;0;0;0;0;0;0;0;0;0;0;0;0;0;0;0;0;0;0
FR;8;2022-08-16;0;0;0;0;0;0;0;0;0;0;0;0;0;0;0;0;0;0
FR;8;2022-08-17;0;0;0;0;0;0;0;0;0;0;0;0;0;0;0;0;0;0
FR;8;2022-08-18;0;0;0;0;0;0;0;0;0;0;0;0;0;0;0;0;0;0
FR;8;2022-08-19;0;0;0;0;0;0;0;0;0;0;0;0;0;0;0;0;0;0
FR;8;2022-08-20;0;0;0;0;0;0;0;0;0;0;0;0;0;0;0;0;0;0
FR;8;2022-08-21;0;0;0;0;0;0;0;0;0;0;0;0;0;0;0;0;0;0
FR;8;2022-08-22;0;0;0;0;0;0;0;0;0;0;0;0;0;0;0;0;0;0
FR;8;2022-08-23;0;0;0;0;0;0;0;0;0;0;0;0;0;0;0;0;0;0
FR;8;2022-08-24;0;0;0;0;0;0;0;0;0;0;0;0;0;0;0;0;0;0
FR;8;2022-08-25;0;0;0;0;0;0;0;0;0;0;0;0;0;0;0;0;0;0
FR;8;2022-08-26;0;0;0;0;0;0;0;0;0;0;0;0;0;0;0;0;0;0
FR;8;2022-08-27;0;0;0;0;0;0;0;0;0;0;0;0;0;0;0;0;0;0
FR;8;2022-08-28;0;0;0;0;0;0;0;0;0;0;0;0;0;0;0;0;0;0
FR;8;2022-08-29;0;0;0;0;0;0;0;0;0;0;0;0;0;0;0;0;0;0
FR;8;2022-08-30;0;0;0;0;0;0;0;0;0;0;0;0;0;0;0;0;0;0
FR;8;2022-08-31;0;0;0;0;0;0;0;0;0;0;0;0;0;0;0;0;0;0
FR;8;2022-09-01;0;0;0;0;0;0;0;0;0;0;0;0;0;0;0;0;0;0
FR;8;2022-09-02;0;0;0;0;0;0;0;0;0;0;0;0;0;0;0;0;0;0
FR;8;2022-09-03;0;0;0;0;0;0;0;0;0;0;0;0;0;0;0;0;0;0
FR;8;2022-09-04;0;0;0;0;0;0;0;0;0;0;0;0;0;0;0;0;0;0
FR;8;2022-09-05;0;0;0;0;0;0;0;0;0;0;0;0;0;0;0;0;0;0
FR;8;2022-09-06;0;0;0;0;0;0;0;0;0;0;0;0;0;0;0;0;0;0
FR;8;2022-09-07;0;0;0;0;0;0;0;0;0;0;0;0;0;0;0;0;0;0
FR;8;2022-09-08;0;0;0;0;0;0;0;0;0;0;0;0;0;0;0;0;0;0
FR;8;2022-09-09;0;0;0;0;0;0;0;0;0;0;0;0;0;0;0;0;0;0
FR;8;2022-09-10;0;0;0;0;0;0;0;0;0;0;0;0;0;0;0;0;0;0
FR;8;2022-09-11;0;0;0;0;0;0;0;0;0;0;0;0;0;0;0;0;0;0
FR;8;2022-09-12;0;0;0;0;0;0;0;0;0;0;0;0;0;0;0;0;0;0
FR;8;2022-09-13;0;0;0;0;0;0;0;0;0;0;0;0;0;0;0;0;0;0
FR;8;2022-09-14;0;0;0;0;0;0;0;0;0;0;0;0;0;0;0;0;0;0
FR;8;2022-09-15;0;0;0;0;0;0;0;0;0;0;0;0;0;0;0;0;0;0
FR;8;2022-09-16;0;0;0;0;0;0;0;0;0;0;0;0;0;0;0;0;0;0
FR;8;2022-09-17;0;0;0;0;0;0;0;0;0;0;0;0;0;0;0;0;0;0
FR;8;2022-09-18;0;0;0;0;0;0;0;0;0;0;0;0;0;0;0;0;0;0
FR;8;2022-09-19;0;0;0;0;0;0;0;0;0;0;0;0;0;0;0;0;0;0
FR;8;2022-09-20;0;0;0;0;0;0;0;0;0;0;0;0;0;0;0;0;0;0
FR;8;2022-09-21;0;0;0;0;0;0;0;0;0;0;0;0;0;0;0;0;0;0
FR;8;2022-09-22;0;0;0;0;0;0;0;0;0;0;0;0;0;0;0;0;0;0
FR;8;2022-09-23;0;0;0;0;0;0;0;0;0;0;0;0;0;0;0;0;0;0
FR;8;2022-09-24;0;0;0;0;0;0;0;0;0;0;0;0;0;0;0;0;0;0
FR;8;2022-09-25;0;0;0;0;0;0;0;0;0;0;0;0;0;0;0;0;0;0
FR;8;2022-09-26;0;0;0;0;0;0;0;0;0;0;0;0;0;0;0;0;0;0
FR;8;2022-09-27;0;0;0;0;0;0;0;0;0;0;0;0;0;0;0;0;0;0
FR;8;2022-09-28;0;0;0;0;0;0;0;0;0;0;0;0;0;0;0;0;0;0
FR;8;2022-09-29;0;0;0;0;0;0;0;0;0;0;0;0;0;0;0;0;0;0
FR;8;2022-09-30;0;0;0;0;0;0;0;0;0;0;0;0;0;0;0;0;0;0
FR;8;2022-10-01;0;0;0;0;0;0;0;0;0;0;0;0;0;0;0;0;0;0
FR;8;2022-10-02;0;0;0;0;0;0;0;0;0;0;0;0;0;0;0;0;0;0
FR;8;2022-10-03;0;0;0;0;0;0;0;0;0;0;0;0;0;0;0;0;0;0
FR;8;2022-10-04;0;0;0;0;0;0;0;0;0;0;0;0;0;0;0;0;0;0
FR;8;2022-10-05;0;0;0;0;0;0;0;0;0;0;0;0;0;0;0;0;0;0
FR;8;2022-10-06;11;17;113;861;8;83;866;1059;110;11;17;113;861;8;83;866;1059;110
FR;8;2022-10-07;73;102;842;8012;63;699;8066;9845;1073;84;119;955;8873;71;782;8932;10904;1183
FR;8;2022-10-08;36;115;610;4057;50;516;4109;5310;676;120;234;1565;12930;121;1298;13041;16214;1859
FR;8;2022-10-09;17;22;145;885;13;132;913;1234;185;137;256;1710;13815;134;1430;13954;17448;2044
FR;8;2022-10-10;120;192;1348;12724;106;1029;12965;16269;2253;257;448;3058;26539;240;2459;26919;33717;4297
FR;8;2022-10-11;184;264;2476;26927;136;2012;27198;33964;4717;441;712;5534;53466;376;4471;54117;67681;9014
FR;8;2022-10-12;158;258;1831;18236;152;1441;18472;23472;3535;599;970;7365;71702;528;5912;72589;91153;12549
FR;8;2022-10-13;208;281;2512;28077;178;1905;28441;35580;5206;807;1251;9877;99779;706;7817;101030;126733;17755
FR;8;2022-10-14;257;419;3271;36246;241;2556;36671;45576;6307;1064;1670;13148;136025;947;10373;137701;172309;24062
FR;8;2022-10-15;102;182;1203;8806;79;1002;8932;11783;1829;1166;1852;14351;144831;1026;11375;146633;184092;25891
FR;8;2022-10-16;34;54;248;1522;26;215;1557;2179;402;1200;1906;14599;146353;1052;11590;148190;186271;26293
FR;8;2022-10-17;158;311;2101;21800;174;1627;22109;28294;4536;1358;2217;16700;168153;1226;13217;170299;214565;30829
FR;8;2022-10-18;270;349;3356;37861;226;2654;38244;50786;9815;1628;2566;20056;206014;1452;15871;208543;265351;40644
FR;8;2022-10-19;200;314;2631;28300;183;2187;28619;38729;7862;1828;2880;22687;234314;1635;18058;237162;304080;48506
FR;8;2022-10-20;256;368;3577;41206;229;2653;41812;55716;11166;2084;3248;26264;275520;1864;20711;278974;359796;59672
FR;8;2022-10-21;325;489;4461;49420;276;3475;50018;66304;12713;2409;3737;30725;324940;2140;24186;328992;426100;72385
FR;8;2022-10-22;126;168;1230;10663;111;927;10850;14745;2949;2535;3905;31955;335603;2251;25113;339842;440845;75334
FR;8;2022-10-23;50;53;266;1762;48;197;1841;2610;571;2585;3958;32221;337365;2299;25310;341683;443455;75905
FR;8;2022-10-24;231;311;2475;24044;174;2074;24342;33551;7084;2816;4269;34696;361409;2473;27384;366025;477006;82989
FR;8;2022-10-25;307;415;4081;43458;257;3135;44057;61302;14007;3123;4684;38777;404867;2730;30519;410082;538308;96996
FR;8;2022-10-26;226;343;2885;28761;186;2381;29040;41471;9962;3349;5027;41662;433628;2916;32900;439122;579779;106958
FR;8;2022-10-27;276;415;3329;36200;243;2635;36676;51265;11889;3625;5442;44991;469828;3159;35535;475798;631044;118847
FR;8;2022-10-28;328;466;3829;39476;258;2864;40200;55130;11997;3953;5908;48820;509304;3417;38399;515998;686174;130844
FR;8;2022-10-29;113;165;1074;8230;94;803;8374;11861;2667;4066;6073;49894;517534;3511;39202;524372;698035;133511
FR;8;2022-10-30;40;53;210;1348;38;180;1394;2063;485;4106;6126;50104;518882;3549;39382;525766;700098;133996
FR;8;2022-10-31;196;260;1664;14542;145;1277;14806;21207;5106;4302;6386;51768;533424;3694;40659;540572;721305;139102
FR;8;2022-11-01;34;41;137;963;23;171;978;1625;473;4336;6427;51905;534387;3717;40830;541550;722930;139575
FR;8;2022-11-02;197;369;2377;23318;204;1981;23712;35061;9301;4533;6796;54282;557705;3921;42811;565262;757991;148876
FR;8;2022-11-03;311;418;3487;36969;258;2604;37612;54689;14374;4844;7214;57769;594674;4179;45415;602874;812680;163250
FR;8;2022-11-04;355;496;3783;40210;260;2976;40732;57998;14179;5199;7710;61552;634884;4439;48391;643606;870678;177429
FR;8;2022-11-05;113;185;1103;8767;119;850;8934;12889;3070;5312;7895;62655;643651;4558;49241;652540;883567;180499
FR;8;2022-11-06;45;56;224;1408;38;205;1441;2249;593;5357;7951;62879;645059;4596;49446;653981;885816;181092
FR;8;2022-11-07;231;280;2324;24843;207;1799;25432;37629;10330;5588;8231;65203;669902;4803;51245;679413;923445;191422
FR;8;2022-11-08;345;505;4340;48400;306;3266;49379;71627;18820;5933;8736;69543;718302;5109;54511;728792;995072;210242
FR;8;2022-11-09;263;370;2878;29178;212;2262;29863;44463;12254;6196;9106;72421;747480;5321;56773;758655;1039535;222496
FR;8;2022-11-10;367;537;3957;40285;306;3025;41199;60570;16206;6563;9643;76378;787765;5627;59798;799854;1100105;238702
FR;8;2022-11-11;39;62;243;1479;33;204;1525;2675;933;6602;9705;76621;789244;5660;60002;801379;1102780;239635
FR;8;2022-11-12;85;165;881;6433;79;687;6636;9894;2552;6687;9870;77502;795677;5739;60689;808015;1112674;242187
FR;8;2022-11-13;36;54;213;1110;35;173;1162;1926;585;6723;9924;77715;796787;5774;60862;809177;1114600;242772
FR;8;2022-11-14;231;307;2241;22449;168;1725;22999;35093;10294;6954;10231;79956;819236;5942;62587;832176;1149693;253066
FR;8;2022-11-15;344;427;3766;42359;261;2871;43266;64815;18544;7298;10658;83722;861595;6203;65458;875442;1214508;271610
FR;8;2022-11-16;302;350;2621;26553;218;2158;27026;41764;12495;7600;11008;86343;888148;6421;67616;902468;1256272;284105
FR;8;2022-11-17;371;430;3386;36871;292;2617;37451;56654;16487;7971;11438;89729;925019;6713;70233;939919;1312926;300592
FR;8;2022-11-18;343;466;4073;42322;287;2977;43175;63681;17425;8314;11904;93802;967341;7000;73210;983094;1376607;318017
FR;8;2022-11-19;121;180;1199;8974;118;844;9156;13833;3795;8435;12084;95001;976315;7118;74054;992250;1390440;321812
FR;8;2022-11-20;35;52;260;1585;36;217;1653;2663;788;8470;12136;95261;977900;7154;74271;993903;1393103;322600
FR;8;2022-11-21;217;303;2078;20108;178;1601;20640;32129;9821;8687;12439;97339;998008;7332;75872;1014543;1425232;332421
FR;8;2022-11-22;336;407;3472;37562;250;2671;38076;58165;17307;9023;12846;100811;1035570;7582;78543;1052619;1483397;349728
FR;8;2022-11-23;230;324;2412;24438;189;2015;24865;39212;12250;9253;13170;103223;1060008;7771;80558;1077484;1522609;361978
FR;8;2022-11-24;347;391;3373;34907;237;2581;35596;55342;17066;9600;13561;106596;1094915;8008;83139;1113080;1577951;379044
FR;8;2022-11-25;309;427;3633;37739;289;2625;38537;57851;16565;9909;13988;110229;1132654;8297;85764;1151617;1635802;395609
FR;8;2022-11-26;172;194;1177;8819;126;898;8976;13689;3784;10081;14182;111406;1141473;8423;86662;1160593;1649491;399393
FR;8;2022-11-27;45;43;227;1545;37;180;1561;2472;721;10126;14225;111633;1143018;8460;86842;1162154;1651963;400114
FR;8;2022-11-28;183;301;2308;23375;172;1703;24039;37316;11500;10309;14526;113941;1166393;8632;88545;1186193;1689279;411614
FR;8;2022-11-29;293;428;3978;44082;217;2943;44768;69150;21316;10602;14954;117919;1210475;8849;91488;1230961;1758429;432930
FR;8;2022-11-30;283;410;3376;34885;227;2544;35650;54718;16406;10885;15364;121295;1245360;9076;94032;1266611;1813147;449336
FR;8;2022-12-01;334;476;4474;49357;274;3129;50132;77677;24253;11219;15840;125769;1294717;9350;97161;1316743;1890824;473589
FR;8;2022-12-02;408;518;5437;58443;304;3740;59621;89800;26250;11627;16358;131206;1353160;9654;100901;1376364;1980624;499839
FR;8;2022-12-03;177;216;1917;16859;108;1325;17271;25839;7207;11804;16574;133123;1370019;9762;102226;1393635;2006463;507046
FR;8;2022-12-04;53;90;489;4056;59;404;4116;6288;1756;11857;16664;133612;1374075;9821;102630;1397751;2012751;508802
FR;8;2022-12-05;287;403;3847;42356;247;2515;43278;66916;20974;12144;17067;137459;1416431;10068;105145;1441029;2079667;529776
FR;8;2022-12-06;426;546;6297;74320;305;4213;75737;117937;37741;12570;17613;143756;1490751;10373;109358;1516766;2197604;567517
FR;8;2022-12-07;362;436;4907;55024;265;3242;56110;87685;28138;12932;18049;148663;1545775;10638;112600;1572876;2285289;595655
FR;8;2022-12-08;453;534;6444;75445;292;4194;77028;120467;38984;13385;18583;155107;1621220;10930;116794;1649904;2405756;634639
FR;8;2022-12-09;546;603;8018;90896;356;5211;92662;142987;44847;13931;19186;163125;1712116;11286;122005;1742566;2548743;679486
FR;8;2022-12-10;264;301;3339;31717;168;2089;32562;48736;13994;14195;19487;166464;1743833;11454;124094;1775128;2597479;693480
FR;8;2022-12-11;90;104;937;7865;66;644;8083;11892;3145;14285;19591;167401;1751698;11520;124738;1783211;2609371;696625
FR;8;2022-12-12;356;462;5856;64338;254;3727;65850;103360;33585;14641;20053;173257;1816036;11774;128465;1849061;2712731;730210
FR;8;2022-12-13;532;605;8427;99086;351;5193;101514;160107;53067;15173;20658;181684;1915122;12125;133658;1950575;2872838;783277
FR;8;2022-12-14;455;533;6360;70051;306;4209;71617;113466;37370;15628;21191;188044;1985173;12431;137867;2022192;2986304;820647
FR;8;2022-12-15;491;651;8153;91733;367;5134;93944;149235;49816;16119;21842;196197;2076906;12798;143001;2116136;3135539;870463
FR;8;2022-12-16;582;709;8871;100291;386;5706;102419;161895;53395;16701;22551;205068;2177197;13184;148707;2218555;3297434;923858
FR;8;2022-12-17;233;308;3145;30057;189;2004;30828;46767;13830;16934;22859;208213;2207254;13373;150711;2249383;3344201;937688
FR;8;2022-12-18;63;94;732;5974;49;499;6122;9296;2646;16997;22953;208945;2213228;13422;151210;2255505;3353497;940334
FR;8;2022-12-19;399;453;5344;53758;265;3367;55322;87745;28874;17396;23406;214289;2266986;13687;154577;2310827;3441242;969208
FR;8;2022-12-20;555;581;7346;76571;348;4753;78669;127101;43351;17951;23987;221635;2343557;14035;159330;2389496;3568343;1012559
FR;8;2022-12-21;423;481;4966;48785;287;3317;50072;81720;28133;18374;24468;226601;2392342;14322;162647;2439568;3650063;1040692
FR;8;2022-12-22;462;524;4585;44267;313;3185;45489;74766;25937;18836;24992;231186;2436609;14635;165832;2485057;3724829;1066629
FR;8;2022-12-23;318;389;2883;25015;252;2076;25674;42266;14399;19154;25381;234069;2461624;14887;167908;2510731;3767095;1081028
FR;8;2022-12-24;70;70;395;2551;41;295;2665;4151;1174;19224;25451;234464;2464175;14928;168203;2513396;3771246;1082202
FR;8;2022-12-25;29;29;106;546;22;83;567;913;260;19253;25480;234570;2464721;14950;168286;2513963;3772159;1082462
FR;8;2022-12-26;243;276;2158;16066;178;1500;16689;26767;8483;19496;25756;236728;2480787;15128;169786;2530652;3798926;1090945
FR;8;2022-12-27;392;453;3771;32403;263;2532;33495;55289;19115;19888;26209;240499;2513190;15391;172318;2564147;3854215;1110060
FR;8;2022-12-28;343;342;2941;24661;191;2055;25249;41744;14320;20231;26551;243440;2537851;15582;174373;2589396;3895959;1124380
FR;8;2022-12-29;299;406;3158;25511;225;2186;26463;43969;15190;20530;26957;246598;2563362;15807;176559;2615859;3939928;1139570
FR;8;2022-12-30;296;343;2444;18674;215;1702;19316;31733;10607;20826;27300;249042;2582036;16022;178261;2635175;3971661;1150177
FR;8;2022-12-31;92;117;453;2959;75;364;3102;4755;1269;20918;27417;249495;2584995;16097;178625;2638277;3976416;1151446
FR;8;2023-01-01;17;30;112;661;14;85;684;995;225;20935;27447;249607;2585656;16111;178710;2638961;3977411;1151671
FR;8;2023-01-02;266;404;2261;18207;236;1607;18669;32015;11654;21201;27851;251868;2603863;16347;180317;2657630;4009426;1163325
FR;8;2023-01-03;465;541;4248;42803;319;2912;43719;80840;33886;21666;28392;256116;2646666;16666;183229;2701349;4090266;1197211
FR;8;2023-01-04;409;473;3492;29980;291;2422;30737;58267;24921;22075;28865;259608;2676646;16957;185651;2732086;4148533;1222132
FR;8;2023-01-05;504;597;4369;41806;400;2932;42701;81993;36039;22579;29462;263977;2718452;17357;188583;2774787;4230526;1258171
FR;8;2023-01-06;512;670;5102;46729;406;3340;47742;89681;38268;23091;30132;269079;2765181;17763;191923;2822529;4320207;1296439
FR;8;2023-01-07;216;289;1703;12296;180;1198;12610;22343;8435;23307;30421;270782;2777477;17943;193121;2835139;4342550;1304874
FR;8;2023-01-08;68;105;443;2744;64;312;2839;5094;1926;23375;30526;271225;2780221;18007;193433;2837978;4347644;1306800
FR;8;2023-01-09;400;478;2617;21454;310;1840;22025;44542;20457;23775;31004;273842;2801675;18317;195273;2860003;4392186;1327257
FR;8;2023-01-10;461;619;4341;40158;384;3059;40921;84990;40627;24236;31623;278183;2841833;18701;198332;2900924;4477176;1367884
FR;8;2023-01-11;345;457;2944;24111;286;2109;24619;51460;24440;24581;32080;281127;2865944;18987;200441;2925543;4528636;1392324
FR;8;2023-01-12;409;540;3656;33157;330;2573;33778;70803;34082;24990;32620;284783;2899101;19317;203014;2959321;4599439;1426406
FR;8;2023-01-13;446;588;4045;34881;338;2858;35475;72835;34123;25436;33208;288828;2933982;19655;205872;2994796;4672274;1460529
FR;8;2023-01-14;178;228;1337;8857;123;953;9039;17175;7103;25614;33436;290165;2942839;19778;206825;3003835;4689449;1467632
FR;8;2023-01-15;63;87;329;1475;53;244;1581;3172;1335;25677;33523;290494;2944314;19831;207069;3005416;4692621;1468967
FR;8;2023-01-16;266;336;1997;15746;196;1432;16007;35194;17552;25943;33859;292491;2960060;20027;208501;3021423;4727815;1486519
FR;8;2023-01-17;360;452;3246;28163;280;2319;28669;64500;33105;26303;34311;295737;2988223;20307;210820;3050092;4792315;1519624
FR;8;2023-01-18;264;406;2186;16821;246;1665;17061;38320;19339;26567;34717;297923;3005044;20553;212485;3067153;4830635;1538963
FR;8;2023-01-19;354;413;2664;22297;251;1945;22648;51201;26236;26921;35130;300587;3027341;20804;214430;3089801;4881836;1565199
FR;8;2023-01-20;403;505;3174;24783;305;2340;25263;56531;28548;27324;35635;303761;3052124;21109;216770;3115064;4938367;1593747
FR;8;2023-01-21;147;189;1002;6113;102;731;6239;12893;5826;27471;35824;304763;3058237;21211;217501;3121303;4951260;1599573
FR;8;2023-01-22;31;51;155;833;22;137;878;1879;844;27502;35875;304918;3059070;21233;217638;3122181;4953139;1600417
FR;8;2023-01-23;213;297;1588;10610;161;1160;10831;26653;14414;27715;36172;306506;3069680;21394;218798;3133012;4979792;1614831
FR;8;2023-01-24;304;415;2405;19963;247;1792;20231;49845;27404;28019;36587;308911;3089643;21641;220590;3153243;5029637;1642235
FR;8;2023-01-25;239;376;1798;12091;229;1322;12492;29957;15877;28258;36963;310709;3101734;21870;221912;3165735;5059594;1658112
FR;8;2023-01-26;299;379;2214;16477;259;1635;16751;41473;22701;28557;37342;312923;3118211;22129;223547;3182486;5101067;1680813
FR;8;2023-01-27;311;486;2457;17846;292;1840;18080;44105;23761;28868;37828;315380;3136057;22421;225387;3200566;5145172;1704574
FR;8;2023-01-28;125;186;766;4327;123;599;4442;9719;4589;28993;38014;316146;3140384;22544;225986;3205008;5154891;1709163
FR;8;2023-01-29;26;43;86;438;28;67;470;1058;513;29019;38057;316232;3140822;22572;226053;3205478;5155949;1709676
FR;8;2023-01-30;207;313;1222;7952;185;1008;8114;20425;11054;29226;38370;317454;3148774;22757;227061;3213592;5176374;1720730
FR;8;2023-01-31;271;382;1909;13584;234;1416;13808;36213;20698;29497;38752;319363;3162358;22991;228477;3227400;5212587;1741428
FR;8;2023-02-01;245;343;1329;8013;222;1087;8134;21672;12173;29742;39095;320692;3170371;23213;229564;3235534;5234259;1753601
FR;8;2023-02-02;255;383;1566;11414;231;1274;11636;30961;17690;29997;39478;322258;3181785;23444;230838;3247170;5265220;1771291
FR;8;2023-02-03;279;446;1844;12101;284;1433;12284;32924;18827;30276;39924;324102;3193886;23728;232271;3259454;5298144;1790118
FR;8;2023-02-04;116;157;568;2953;108;460;2995;7181;3655;30392;40081;324670;3196839;23836;232731;3262449;5305325;1793773
FR;8;2023-02-05;10;53;65;224;31;60;239;571;264;30402;40134;324735;3197063;23867;232791;3262688;5305896;1794037
FR;8;2023-02-06;184;241;939;5163;169;702;5346;14992;8712;30586;40375;325674;3202226;24036;233493;3268034;5320888;1802749
FR;8;2023-02-07;234;385;1452;9399;260;1177;9537;27505;16383;30820;40760;327126;3211625;24296;234670;3277571;5348393;1819132
FR;8;2023-02-08;172;245;1017;5832;167;806;5976;16495;9432;30992;41005;328143;3217457;24463;235476;3283547;5364888;1828564
FR;8;2023-02-09;236;381;1171;7519;243;981;7706;22161;13146;31228;41386;329314;3224976;24706;236457;3291253;5387049;1841710
FR;8;2023-02-10;275;361;1394;7950;243;1155;8082;23110;13491;31503;41747;330708;3232926;24949;237612;3299335;5410159;1855201
FR;8;2023-02-11;87;145;469;2012;100;402;2088;5222;2663;31590;41892;331177;3234938;25049;238014;3301423;5415381;1857864
FR;8;2023-02-12;26;31;50;163;25;44;184;424;189;31616;41923;331227;3235101;25074;238058;3301607;5415805;1858053
FR;8;2023-02-13;129;204;667;3148;126;604;3243;9263;5279;31745;42127;331894;3238249;25200;238662;3304850;5425068;1863332
FR;8;2023-02-14;186;261;1061;5678;158;885;5829;17065;10054;31931;42388;332955;3243927;25358;239547;3310679;5442133;1873386
FR;8;2023-02-15;161;248;842;3870;141;720;4043;11796;6831;32092;42636;333797;3247797;25499;240267;3314722;5453929;1880217
FR;8;2023-02-16;168;303;994;4883;171;846;5041;14561;8424;32260;42939;334791;3252680;25670;241113;3319763;5468490;1888641
FR;8;2023-02-17;225;313;1100;5195;219;939;5419;15914;9297;32485;43252;335891;3257875;25889;242052;3325182;5484404;1897938
FR;8;2023-02-18;92;130;395;1488;85;312;1562;3894;1964;32577;43382;336286;3259363;25974;242364;3326744;5488298;1899902
FR;8;2023-02-19;22;36;43;132;31;35;135;333;159;32599;43418;336329;3259495;26005;242399;3326879;5488631;1900061
FR;8;2023-02-20;139;254;631;2660;158;585;2775;8139;4633;32738;43672;336960;3262155;26163;242984;3329654;5496770;1904694
FR;8;2023-02-21;173;306;958;4279;162;831;4469;13501;7924;32911;43978;337918;3266434;26325;243815;3334123;5510271;1912618
FR;8;2023-02-22;155;253;659;2762;168;619;2796;8588;5006;33066;44231;338577;3269196;26493;244434;3336919;5518859;1917624
FR;8;2023-02-23;149;260;822;3767;153;730;3944;11800;6847;33215;44491;339399;3272963;26646;245164;3340863;5530659;1924471
FR;8;2023-02-24;156;308;950;4094;190;822;4281;12369;7027;33371;44799;340349;3277057;26836;245986;3345144;5543028;1931498
FR;8;2023-02-25;56;99;343;1058;66;274;1112;2934;1490;33427;44898;340692;3278115;26902;246260;3346256;5545962;1932988
FR;8;2023-02-26;14;21;31;95;22;28;108;249;106;33441;44919;340723;3278210;26924;246288;3346364;5546211;1933094
FR;8;2023-02-27;90;221;502;1821;152;477;1888;6211;3709;33531;45140;341225;3280031;27076;246765;3348252;5552422;1936803
FR;8;2023-02-28;154;253;753;3325;148;715;3453;11575;7113;33685;45393;341978;3283356;27224;247480;3351705;5563997;1943916
FR;8;2023-03-01;126;193;515;1826;144;455;1977;6216;3637;33811;45586;342493;3285182;27368;247935;3353682;5570213;1947553
FR;8;2023-03-02;125;217;707;2757;130;601;2952;9676;5893;33936;45803;343200;3287939;27498;248536;3356634;5579889;1953446
FR;8;2023-03-03;180;321;890;3394;214;786;3519;11174;6558;34116;46124;344090;3291333;27712;249322;3360153;5591063;1960004
FR;8;2023-03-04;57;132;300;974;80;284;978;2615;1294;34173;46256;344390;3292307;27792;249606;3361131;5593678;1961298
FR;8;2023-03-05;12;18;20;47;14;24;47;180;98;34185;46274;344410;3292354;27806;249630;3361178;5593858;1961396
FR;8;2023-03-06;116;175;407;1302;101;388;1360;4383;2497;34301;46449;344817;3293656;27907;250018;3362538;5598241;1963893
FR;8;2023-03-07;117;208;557;2147;125;515;2221;7489;4563;34418;46657;345374;3295803;28032;250533;3364759;5605730;1968456
FR;8;2023-03-08;88;172;442;1319;106;391;1389;4668;2735;34506;46829;345816;3297122;28138;250924;3366148;5610398;1971191
FR;8;2023-03-09;115;197;549;1853;118;513;1916;6674;4075;34621;47026;346365;3298975;28256;251437;3368064;5617072;1975266
FR;8;2023-03-10;196;321;754;2377;202;677;2498;8455;5041;34817;47347;347119;3301352;28458;252114;3370562;5625527;1980307
FR;8;2023-03-11;53;108;267;729;74;230;763;2137;1092;34870;47455;347386;3302081;28532;252344;3371325;5627664;1981399
FR;8;2023-03-12;6;10;23;60;8;22;61;170;83;34876;47465;347409;3302141;28540;252366;3371386;5627834;1981482
FR;8;2023-03-13;77;135;380;967;86;339;1044;3357;1884;34953;47600;347789;3303108;28626;252705;3372430;5631191;1983366
FR;8;2023-03-14;107;209;552;1696;123;538;1770;6266;3752;35060;47809;348341;3304804;28749;253243;3374200;5637457;1987118
FR;8;2023-03-15;102;158;398;1074;112;357;1148;3937;2291;35162;47967;348739;3305878;28861;253600;3375348;5641394;1989409
FR;8;2023-03-16;99;187;497;1468;118;455;1546;5428;3234;35261;48154;349236;3307346;28979;254055;3376894;5646822;1992643
FR;8;2023-03-17;137;210;634;1815;126;548;1962;6722;3969;35398;48364;349870;3309161;29105;254603;3378856;5653544;1996612
FR;8;2023-03-18;72;105;244;522;65;232;577;1809;939;35470;48469;350114;3309683;29170;254835;3379433;5655353;1997551
FR;8;2023-03-19;3;15;20;39;15;12;42;101;45;35473;48484;350134;3309722;29185;254847;3379475;5655454;1997596
FR;8;2023-03-20;83;169;396;903;93;394;983;3439;1931;35556;48653;350530;3310625;29278;255241;3380458;5658893;1999527
FR;8;2023-03-21;124;195;560;1473;114;534;1635;5988;3575;35680;48848;351090;3312098;29392;255775;3382093;5664881;2003102
FR;8;2023-03-22;114;153;393;905;103;358;1019;3531;2032;35794;49001;351483;3313003;29495;256133;3383112;5668412;2005134
FR;8;2023-03-23;86;160;502;1243;88;446;1332;4730;2750;35880;49161;351985;3314246;29583;256579;3384444;5673142;2007884
FR;8;2023-03-24;137;250;670;1575;145;614;1735;6070;3468;36017;49411;352655;3315821;29728;257193;3386179;5679212;2011352
FR;8;2023-03-25;54;86;253;477;63;221;525;1555;745;36071;49497;352908;3316298;29791;257414;3386704;5680767;2012097
FR;8;2023-03-26;6;8;13;29;7;10;29;68;27;36077;49505;352921;3316327;29798;257424;3386733;5680835;2012124
FR;8;2023-03-27;105;165;395;772;120;378;856;3039;1684;36182;49670;353316;3317099;29918;257802;3387589;5683874;2013808
FR;8;2023-03-28;108;174;502;1384;91;468;1506;5550;3336;36290;49844;353818;3318483;30009;258270;3389095;5689424;2017144
FR;8;2023-03-29;85;151;351;768;77;340;890;3193;1812;36375;49995;354169;3319251;30086;258610;3389985;5692617;2018956
FR;9;2020-12-27;0;0;0;0;0;0;0;0;0;0;0;0;0;0;0;0;0;0
FR;9;2020-12-28;0;0;0;0;0;0;0;0;0;0;0;0;0;0;0;0;0;0
FR;9;2020-12-29;0;0;0;0;0;0;0;0;0;0;0;0;0;0;0;0;0;0
FR;9;2020-12-30;0;0;0;0;0;0;0;0;0;0;0;0;0;0;0;0;0;0
FR;9;2020-12-31;0;0;0;0;0;0;0;0;0;0;0;0;0;0;0;0;0;0
FR;9;2021-01-01;0;0;0;0;0;0;0;0;0;0;0;0;0;0;0;0;0;0
FR;9;2021-01-02;0;0;0;0;0;0;0;0;0;0;0;0;0;0;0;0;0;0
FR;9;2021-01-03;0;0;0;0;0;0;0;0;0;0;0;0;0;0;0;0;0;0
FR;9;2021-01-04;0;0;0;0;0;0;0;0;0;0;0;0;0;0;0;0;0;0
FR;9;2021-01-05;0;0;0;0;0;0;0;0;0;0;0;0;0;0;0;0;0;0
FR;9;2021-01-06;0;0;0;0;0;0;0;0;0;0;0;0;0;0;0;0;0;0
FR;9;2021-01-07;0;0;0;0;0;0;0;0;0;0;0;0;0;0;0;0;0;0
FR;9;2021-01-08;0;0;0;0;0;0;0;0;0;0;0;0;0;0;0;0;0;0
FR;9;2021-01-09;0;0;0;0;0;0;0;0;0;0;0;0;0;0;0;0;0;0
FR;9;2021-01-10;0;0;0;0;0;0;0;0;0;0;0;0;0;0;0;0;0;0
FR;9;2021-01-11;0;0;0;0;0;0;0;0;0;0;0;0;0;0;0;0;0;0
FR;9;2021-01-12;0;0;0;0;0;0;0;0;0;0;0;0;0;0;0;0;0;0
FR;9;2021-01-13;0;0;0;0;0;0;0;0;0;0;0;0;0;0;0;0;0;0
FR;9;2021-01-14;0;0;0;0;0;0;0;0;0;0;0;0;0;0;0;0;0;0
FR;9;2021-01-15;0;0;0;0;0;0;0;0;0;0;0;0;0;0;0;0;0;0
FR;9;2021-01-16;0;0;0;0;0;0;0;0;0;0;0;0;0;0;0;0;0;0
FR;9;2021-01-17;0;0;0;0;0;0;0;0;0;0;0;0;0;0;0;0;0;0
FR;9;2021-01-18;0;0;0;0;0;0;0;0;0;0;0;0;0;0;0;0;0;0
FR;9;2021-01-19;0;0;0;0;0;0;0;0;0;0;0;0;0;0;0;0;0;0
FR;9;2021-01-20;0;0;0;0;0;0;0;0;0;0;0;0;0;0;0;0;0;0
FR;9;2021-01-21;0;0;0;0;0;0;0;0;0;0;0;0;0;0;0;0;0;0
FR;9;2021-01-22;0;0;0;0;0;0;0;0;0;0;0;0;0;0;0;0;0;0
FR;9;2021-01-23;0;0;0;0;0;0;0;0;0;0;0;0;0;0;0;0;0;0
FR;9;2021-01-24;0;0;0;0;0;0;0;0;0;0;0;0;0;0;0;0;0;0
FR;9;2021-01-25;0;0;0;0;0;0;0;0;0;0;0;0;0;0;0;0;0;0
FR;9;2021-01-26;0;0;0;0;0;0;0;0;0;0;0;0;0;0;0;0;0;0
FR;9;2021-01-27;0;0;0;0;0;0;0;0;0;0;0;0;0;0;0;0;0;0
FR;9;2021-01-28;0;0;0;0;0;0;0;0;0;0;0;0;0;0;0;0;0;0
FR;9;2021-01-29;0;0;0;0;0;0;0;0;0;0;0;0;0;0;0;0;0;0
FR;9;2021-01-30;0;0;0;0;0;0;0;0;0;0;0;0;0;0;0;0;0;0
FR;9;2021-01-31;0;0;0;0;0;0;0;0;0;0;0;0;0;0;0;0;0;0
FR;9;2021-02-01;0;0;0;0;0;0;0;0;0;0;0;0;0;0;0;0;0;0
FR;9;2021-02-02;0;0;0;0;0;0;0;0;0;0;0;0;0;0;0;0;0;0
FR;9;2021-02-03;0;0;0;0;0;0;0;0;0;0;0;0;0;0;0;0;0;0
FR;9;2021-02-04;0;0;0;0;0;0;0;0;0;0;0;0;0;0;0;0;0;0
FR;9;2021-02-05;0;0;0;0;0;0;0;0;0;0;0;0;0;0;0;0;0;0
FR;9;2021-02-06;0;0;0;0;0;0;0;0;0;0;0;0;0;0;0;0;0;0
FR;9;2021-02-07;0;0;0;0;0;0;0;0;0;0;0;0;0;0;0;0;0;0
FR;9;2021-02-08;0;0;0;0;0;0;0;0;0;0;0;0;0;0;0;0;0;0
FR;9;2021-02-09;0;0;0;0;0;0;0;0;0;0;0;0;0;0;0;0;0;0
FR;9;2021-02-10;0;0;0;0;0;0;0;0;0;0;0;0;0;0;0;0;0;0
FR;9;2021-02-11;0;0;0;0;0;0;0;0;0;0;0;0;0;0;0;0;0;0
FR;9;2021-02-12;0;0;0;0;0;0;0;0;0;0;0;0;0;0;0;0;0;0
FR;9;2021-02-13;0;0;0;0;0;0;0;0;0;0;0;0;0;0;0;0;0;0
FR;9;2021-02-14;0;0;0;0;0;0;0;0;0;0;0;0;0;0;0;0;0;0
FR;9;2021-02-15;0;0;0;0;0;0;0;0;0;0;0;0;0;0;0;0;0;0
FR;9;2021-02-16;0;0;0;0;0;0;0;0;0;0;0;0;0;0;0;0;0;0
FR;9;2021-02-17;0;0;0;0;0;0;0;0;0;0;0;0;0;0;0;0;0;0
FR;9;2021-02-18;0;0;0;0;0;0;0;0;0;0;0;0;0;0;0;0;0;0
FR;9;2021-02-19;0;0;0;0;0;0;0;0;0;0;0;0;0;0;0;0;0;0
FR;9;2021-02-20;0;0;0;0;0;0;0;0;0;0;0;0;0;0;0;0;0;0
FR;9;2021-02-21;0;0;0;0;0;0;0;0;0;0;0;0;0;0;0;0;0;0
FR;9;2021-02-22;0;0;0;0;0;0;0;0;0;0;0;0;0;0;0;0;0;0
FR;9;2021-02-23;0;0;0;0;0;0;0;0;0;0;0;0;0;0;0;0;0;0
FR;9;2021-02-24;0;0;0;0;0;0;0;0;0;0;0;0;0;0;0;0;0;0
FR;9;2021-02-25;0;0;0;0;0;0;0;0;0;0;0;0;0;0;0;0;0;0
FR;9;2021-02-26;0;0;0;0;0;0;0;0;0;0;0;0;0;0;0;0;0;0
FR;9;2021-02-27;0;0;0;0;0;0;0;0;0;0;0;0;0;0;0;0;0;0
FR;9;2021-02-28;0;0;0;0;0;0;0;0;0;0;0;0;0;0;0;0;0;0
FR;9;2021-03-01;0;0;0;0;0;0;0;0;0;0;0;0;0;0;0;0;0;0
FR;9;2021-03-02;0;0;0;0;0;0;0;0;0;0;0;0;0;0;0;0;0;0
FR;9;2021-03-03;0;0;0;0;0;0;0;0;0;0;0;0;0;0;0;0;0;0
FR;9;2021-03-04;0;0;0;0;0;0;0;0;0;0;0;0;0;0;0;0;0;0
FR;9;2021-03-05;0;0;0;0;0;0;0;0;0;0;0;0;0;0;0;0;0;0
FR;9;2021-03-06;0;0;0;0;0;0;0;0;0;0;0;0;0;0;0;0;0;0
FR;9;2021-03-07;0;0;0;0;0;0;0;0;0;0;0;0;0;0;0;0;0;0
FR;9;2021-03-08;0;0;0;0;0;0;0;0;0;0;0;0;0;0;0;0;0;0
FR;9;2021-03-09;0;0;0;0;0;0;0;0;0;0;0;0;0;0;0;0;0;0
FR;9;2021-03-10;0;0;0;0;0;0;0;0;0;0;0;0;0;0;0;0;0;0
FR;9;2021-03-11;0;0;0;0;0;0;0;0;0;0;0;0;0;0;0;0;0;0
FR;9;2021-03-12;0;0;0;0;0;0;0;0;0;0;0;0;0;0;0;0;0;0
FR;9;2021-03-13;0;0;0;0;0;0;0;0;0;0;0;0;0;0;0;0;0;0
FR;9;2021-03-14;0;0;0;0;0;0;0;0;0;0;0;0;0;0;0;0;0;0
FR;9;2021-03-15;0;0;0;0;0;0;0;0;0;0;0;0;0;0;0;0;0;0
FR;9;2021-03-16;0;0;0;0;0;0;0;0;0;0;0;0;0;0;0;0;0;0
FR;9;2021-03-17;0;0;0;0;0;0;0;0;0;0;0;0;0;0;0;0;0;0
FR;9;2021-03-18;0;0;0;0;0;0;0;0;0;0;0;0;0;0;0;0;0;0
FR;9;2021-03-19;0;0;0;0;0;0;0;0;0;0;0;0;0;0;0;0;0;0
FR;9;2021-03-20;0;0;0;0;0;0;0;0;0;0;0;0;0;0;0;0;0;0
FR;9;2021-03-21;0;0;0;0;0;0;0;0;0;0;0;0;0;0;0;0;0;0
FR;9;2021-03-22;0;0;0;0;0;0;0;0;0;0;0;0;0;0;0;0;0;0
FR;9;2021-03-23;0;0;0;0;0;0;0;0;0;0;0;0;0;0;0;0;0;0
FR;9;2021-03-24;0;0;0;0;0;0;0;0;0;0;0;0;0;0;0;0;0;0
FR;9;2021-03-25;0;0;0;0;0;0;0;0;0;0;0;0;0;0;0;0;0;0
FR;9;2021-03-26;0;0;0;0;0;0;0;0;0;0;0;0;0;0;0;0;0;0
FR;9;2021-03-27;0;0;0;0;0;0;0;0;0;0;0;0;0;0;0;0;0;0
FR;9;2021-03-28;0;0;0;0;0;0;0;0;0;0;0;0;0;0;0;0;0;0
FR;9;2021-03-29;0;0;0;0;0;0;0;0;0;0;0;0;0;0;0;0;0;0
FR;9;2021-03-30;0;0;0;0;0;0;0;0;0;0;0;0;0;0;0;0;0;0
FR;9;2021-03-31;0;0;0;0;0;0;0;0;0;0;0;0;0;0;0;0;0;0
FR;9;2021-04-01;0;0;0;0;0;0;0;0;0;0;0;0;0;0;0;0;0;0
FR;9;2021-04-02;0;0;0;0;0;0;0;0;0;0;0;0;0;0;0;0;0;0
FR;9;2021-04-03;0;0;0;0;0;0;0;0;0;0;0;0;0;0;0;0;0;0
FR;9;2021-04-04;0;0;0;0;0;0;0;0;0;0;0;0;0;0;0;0;0;0
FR;9;2021-04-05;0;0;0;0;0;0;0;0;0;0;0;0;0;0;0;0;0;0
FR;9;2021-04-06;0;0;0;0;0;0;0;0;0;0;0;0;0;0;0;0;0;0
FR;9;2021-04-07;0;0;0;0;0;0;0;0;0;0;0;0;0;0;0;0;0;0
FR;9;2021-04-08;0;0;0;0;0;0;0;0;0;0;0;0;0;0;0;0;0;0
FR;9;2021-04-09;0;0;0;0;0;0;0;0;0;0;0;0;0;0;0;0;0;0
FR;9;2021-04-10;0;0;0;0;0;0;0;0;0;0;0;0;0;0;0;0;0;0
FR;9;2021-04-11;0;0;0;0;0;0;0;0;0;0;0;0;0;0;0;0;0;0
FR;9;2021-04-12;0;0;0;0;0;0;0;0;0;0;0;0;0;0;0;0;0;0
FR;9;2021-04-13;0;0;0;0;0;0;0;0;0;0;0;0;0;0;0;0;0;0
FR;9;2021-04-14;0;0;0;0;0;0;0;0;0;0;0;0;0;0;0;0;0;0
FR;9;2021-04-15;0;0;0;0;0;0;0;0;0;0;0;0;0;0;0;0;0;0
FR;9;2021-04-16;0;0;0;0;0;0;0;0;0;0;0;0;0;0;0;0;0;0
FR;9;2021-04-17;0;0;0;0;0;0;0;0;0;0;0;0;0;0;0;0;0;0
FR;9;2021-04-18;0;0;0;0;0;0;0;0;0;0;0;0;0;0;0;0;0;0
FR;9;2021-04-19;0;0;0;0;0;0;0;0;0;0;0;0;0;0;0;0;0;0
FR;9;2021-04-20;0;0;0;0;0;0;0;0;0;0;0;0;0;0;0;0;0;0
FR;9;2021-04-21;0;0;0;0;0;0;0;0;0;0;0;0;0;0;0;0;0;0
FR;9;2021-04-22;0;0;0;0;0;0;0;0;0;0;0;0;0;0;0;0;0;0
FR;9;2021-04-23;0;0;0;0;0;0;0;0;0;0;0;0;0;0;0;0;0;0
FR;9;2021-04-24;0;0;0;0;0;0;0;0;0;0;0;0;0;0;0;0;0;0
FR;9;2021-04-25;0;0;0;0;0;0;0;0;0;0;0;0;0;0;0;0;0;0
FR;9;2021-04-26;0;0;0;0;0;0;0;0;0;0;0;0;0;0;0;0;0;0
FR;9;2021-04-27;0;0;0;0;0;0;0;0;0;0;0;0;0;0;0;0;0;0
FR;9;2021-04-28;0;0;0;0;0;0;0;0;0;0;0;0;0;0;0;0;0;0
FR;9;2021-04-29;0;0;0;0;0;0;0;0;0;0;0;0;0;0;0;0;0;0
FR;9;2021-04-30;0;0;0;0;0;0;0;0;0;0;0;0;0;0;0;0;0;0
FR;9;2021-05-01;0;0;0;0;0;0;0;0;0;0;0;0;0;0;0;0;0;0
FR;9;2021-05-02;0;0;0;0;0;0;0;0;0;0;0;0;0;0;0;0;0;0
FR;9;2021-05-03;0;0;0;0;0;0;0;0;0;0;0;0;0;0;0;0;0;0
FR;9;2021-05-04;0;0;0;0;0;0;0;0;0;0;0;0;0;0;0;0;0;0
FR;9;2021-05-05;0;0;0;0;0;0;0;0;0;0;0;0;0;0;0;0;0;0
FR;9;2021-05-06;0;0;0;0;0;0;0;0;0;0;0;0;0;0;0;0;0;0
FR;9;2021-05-07;0;0;0;0;0;0;0;0;0;0;0;0;0;0;0;0;0;0
FR;9;2021-05-08;0;0;0;0;0;0;0;0;0;0;0;0;0;0;0;0;0;0
FR;9;2021-05-09;0;0;0;0;0;0;0;0;0;0;0;0;0;0;0;0;0;0
FR;9;2021-05-10;0;0;0;0;0;0;0;0;0;0;0;0;0;0;0;0;0;0
FR;9;2021-05-11;0;0;0;0;0;0;0;0;0;0;0;0;0;0;0;0;0;0
FR;9;2021-05-12;0;0;0;0;0;0;0;0;0;0;0;0;0;0;0;0;0;0
FR;9;2021-05-13;0;0;0;0;0;0;0;0;0;0;0;0;0;0;0;0;0;0
FR;9;2021-05-14;0;0;0;0;0;0;0;0;0;0;0;0;0;0;0;0;0;0
FR;9;2021-05-15;0;0;0;0;0;0;0;0;0;0;0;0;0;0;0;0;0;0
FR;9;2021-05-16;0;0;0;0;0;0;0;0;0;0;0;0;0;0;0;0;0;0
FR;9;2021-05-17;0;0;0;0;0;0;0;0;0;0;0;0;0;0;0;0;0;0
FR;9;2021-05-18;0;0;0;0;0;0;0;0;0;0;0;0;0;0;0;0;0;0
FR;9;2021-05-19;0;0;0;0;0;0;0;0;0;0;0;0;0;0;0;0;0;0
FR;9;2021-05-20;0;0;0;0;0;0;0;0;0;0;0;0;0;0;0;0;0;0
FR;9;2021-05-21;0;0;0;0;0;0;0;0;0;0;0;0;0;0;0;0;0;0
FR;9;2021-05-22;0;0;0;0;0;0;0;0;0;0;0;0;0;0;0;0;0;0
FR;9;2021-05-23;0;0;0;0;0;0;0;0;0;0;0;0;0;0;0;0;0;0
FR;9;2021-05-24;0;0;0;0;0;0;0;0;0;0;0;0;0;0;0;0;0;0
FR;9;2021-05-25;0;0;0;0;0;0;0;0;0;0;0;0;0;0;0;0;0;0
FR;9;2021-05-26;0;0;0;0;0;0;0;0;0;0;0;0;0;0;0;0;0;0
FR;9;2021-05-27;0;0;0;0;0;0;0;0;0;0;0;0;0;0;0;0;0;0
FR;9;2021-05-28;0;0;0;0;0;0;0;0;0;0;0;0;0;0;0;0;0;0
FR;9;2021-05-29;0;0;0;0;0;0;0;0;0;0;0;0;0;0;0;0;0;0
FR;9;2021-05-30;0;0;0;0;0;0;0;0;0;0;0;0;0;0;0;0;0;0
FR;9;2021-05-31;0;0;0;0;0;0;0;0;0;0;0;0;0;0;0;0;0;0
FR;9;2021-06-01;0;0;0;0;0;0;0;0;0;0;0;0;0;0;0;0;0;0
FR;9;2021-06-02;0;0;0;0;0;0;0;0;0;0;0;0;0;0;0;0;0;0
FR;9;2021-06-03;0;0;0;0;0;0;0;0;0;0;0;0;0;0;0;0;0;0
FR;9;2021-06-04;0;0;0;0;0;0;0;0;0;0;0;0;0;0;0;0;0;0
FR;9;2021-06-05;0;0;0;0;0;0;0;0;0;0;0;0;0;0;0;0;0;0
FR;9;2021-06-06;0;0;0;0;0;0;0;0;0;0;0;0;0;0;0;0;0;0
FR;9;2021-06-07;0;0;0;0;0;0;0;0;0;0;0;0;0;0;0;0;0;0
FR;9;2021-06-08;0;0;0;0;0;0;0;0;0;0;0;0;0;0;0;0;0;0
FR;9;2021-06-09;0;0;0;0;0;0;0;0;0;0;0;0;0;0;0;0;0;0
FR;9;2021-06-10;0;0;0;0;0;0;0;0;0;0;0;0;0;0;0;0;0;0
FR;9;2021-06-11;0;0;0;0;0;0;0;0;0;0;0;0;0;0;0;0;0;0
FR;9;2021-06-12;0;0;0;0;0;0;0;0;0;0;0;0;0;0;0;0;0;0
FR;9;2021-06-13;0;0;0;0;0;0;0;0;0;0;0;0;0;0;0;0;0;0
FR;9;2021-06-14;0;0;0;0;0;0;0;0;0;0;0;0;0;0;0;0;0;0
FR;9;2021-06-15;0;0;0;0;0;0;0;0;0;0;0;0;0;0;0;0;0;0
FR;9;2021-06-16;0;0;0;0;0;0;0;0;0;0;0;0;0;0;0;0;0;0
FR;9;2021-06-17;0;0;0;0;0;0;0;0;0;0;0;0;0;0;0;0;0;0
FR;9;2021-06-18;0;0;0;0;0;0;0;0;0;0;0;0;0;0;0;0;0;0
FR;9;2021-06-19;0;0;0;0;0;0;0;0;0;0;0;0;0;0;0;0;0;0
FR;9;2021-06-20;0;0;0;0;0;0;0;0;0;0;0;0;0;0;0;0;0;0
FR;9;2021-06-21;0;0;0;0;0;0;0;0;0;0;0;0;0;0;0;0;0;0
FR;9;2021-06-22;0;0;0;0;0;0;0;0;0;0;0;0;0;0;0;0;0;0
FR;9;2021-06-23;0;0;0;0;0;0;0;0;0;0;0;0;0;0;0;0;0;0
FR;9;2021-06-24;0;0;0;0;0;0;0;0;0;0;0;0;0;0;0;0;0;0
FR;9;2021-06-25;0;0;0;0;0;0;0;0;0;0;0;0;0;0;0;0;0;0
FR;9;2021-06-26;0;0;0;0;0;0;0;0;0;0;0;0;0;0;0;0;0;0
FR;9;2021-06-27;0;0;0;0;0;0;0;0;0;0;0;0;0;0;0;0;0;0
FR;9;2021-06-28;0;0;0;0;0;0;0;0;0;0;0;0;0;0;0;0;0;0
FR;9;2021-06-29;0;0;0;0;0;0;0;0;0;0;0;0;0;0;0;0;0;0
FR;9;2021-06-30;0;0;0;0;0;0;0;0;0;0;0;0;0;0;0;0;0;0
FR;9;2021-07-01;0;0;0;0;0;0;0;0;0;0;0;0;0;0;0;0;0;0
FR;9;2021-07-02;0;0;0;0;0;0;0;0;0;0;0;0;0;0;0;0;0;0
FR;9;2021-07-03;0;0;0;0;0;0;0;0;0;0;0;0;0;0;0;0;0;0
FR;9;2021-07-04;0;0;0;0;0;0;0;0;0;0;0;0;0;0;0;0;0;0
FR;9;2021-07-05;0;0;0;0;0;0;0;0;0;0;0;0;0;0;0;0;0;0
FR;9;2021-07-06;0;0;0;0;0;0;0;0;0;0;0;0;0;0;0;0;0;0
FR;9;2021-07-07;0;0;0;0;0;0;0;0;0;0;0;0;0;0;0;0;0;0
FR;9;2021-07-08;0;0;0;0;0;0;0;0;0;0;0;0;0;0;0;0;0;0
FR;9;2021-07-09;0;0;0;0;0;0;0;0;0;0;0;0;0;0;0;0;0;0
FR;9;2021-07-10;0;0;0;0;0;0;0;0;0;0;0;0;0;0;0;0;0;0
FR;9;2021-07-11;0;0;0;0;0;0;0;0;0;0;0;0;0;0;0;0;0;0
FR;9;2021-07-12;0;0;0;0;0;0;0;0;0;0;0;0;0;0;0;0;0;0
FR;9;2021-07-13;0;0;0;0;0;0;0;0;0;0;0;0;0;0;0;0;0;0
FR;9;2021-07-14;0;0;0;0;0;0;0;0;0;0;0;0;0;0;0;0;0;0
FR;9;2021-07-15;0;0;0;0;0;0;0;0;0;0;0;0;0;0;0;0;0;0
FR;9;2021-07-16;0;0;0;0;0;0;0;0;0;0;0;0;0;0;0;0;0;0
FR;9;2021-07-17;0;0;0;0;0;0;0;0;0;0;0;0;0;0;0;0;0;0
FR;9;2021-07-18;0;0;0;0;0;0;0;0;0;0;0;0;0;0;0;0;0;0
FR;9;2021-07-19;0;0;0;0;0;0;0;0;0;0;0;0;0;0;0;0;0;0
FR;9;2021-07-20;0;0;0;0;0;0;0;0;0;0;0;0;0;0;0;0;0;0
FR;9;2021-07-21;0;0;0;0;0;0;0;0;0;0;0;0;0;0;0;0;0;0
FR;9;2021-07-22;0;0;0;0;0;0;0;0;0;0;0;0;0;0;0;0;0;0
FR;9;2021-07-23;0;0;0;0;0;0;0;0;0;0;0;0;0;0;0;0;0;0
FR;9;2021-07-24;0;0;0;0;0;0;0;0;0;0;0;0;0;0;0;0;0;0
FR;9;2021-07-25;0;0;0;0;0;0;0;0;0;0;0;0;0;0;0;0;0;0
FR;9;2021-07-26;0;0;0;0;0;0;0;0;0;0;0;0;0;0;0;0;0;0
FR;9;2021-07-27;0;0;0;0;0;0;0;0;0;0;0;0;0;0;0;0;0;0
FR;9;2021-07-28;0;0;0;0;0;0;0;0;0;0;0;0;0;0;0;0;0;0
FR;9;2021-07-29;0;0;0;0;0;0;0;0;0;0;0;0;0;0;0;0;0;0
FR;9;2021-07-30;0;0;0;0;0;0;0;0;0;0;0;0;0;0;0;0;0;0
FR;9;2021-07-31;0;0;0;0;0;0;0;0;0;0;0;0;0;0;0;0;0;0
FR;9;2021-08-01;0;0;0;0;0;0;0;0;0;0;0;0;0;0;0;0;0;0
FR;9;2021-08-02;0;0;0;0;0;0;0;0;0;0;0;0;0;0;0;0;0;0
FR;9;2021-08-03;0;0;0;0;0;0;0;0;0;0;0;0;0;0;0;0;0;0
FR;9;2021-08-04;0;0;0;0;0;0;0;0;0;0;0;0;0;0;0;0;0;0
FR;9;2021-08-05;0;0;0;0;0;0;0;0;0;0;0;0;0;0;0;0;0;0
FR;9;2021-08-06;0;0;0;0;0;0;0;0;0;0;0;0;0;0;0;0;0;0
FR;9;2021-08-07;0;0;0;0;0;0;0;0;0;0;0;0;0;0;0;0;0;0
FR;9;2021-08-08;0;0;0;0;0;0;0;0;0;0;0;0;0;0;0;0;0;0
FR;9;2021-08-09;0;0;0;0;0;0;0;0;0;0;0;0;0;0;0;0;0;0
FR;9;2021-08-10;0;0;0;0;0;0;0;0;0;0;0;0;0;0;0;0;0;0
FR;9;2021-08-11;0;0;0;0;0;0;0;0;0;0;0;0;0;0;0;0;0;0
FR;9;2021-08-12;0;0;0;0;0;0;0;0;0;0;0;0;0;0;0;0;0;0
FR;9;2021-08-13;0;0;0;0;0;0;0;0;0;0;0;0;0;0;0;0;0;0
FR;9;2021-08-14;0;0;0;0;0;0;0;0;0;0;0;0;0;0;0;0;0;0
FR;9;2021-08-15;0;0;0;0;0;0;0;0;0;0;0;0;0;0;0;0;0;0
FR;9;2021-08-16;0;0;0;0;0;0;0;0;0;0;0;0;0;0;0;0;0;0
FR;9;2021-08-17;0;0;0;0;0;0;0;0;0;0;0;0;0;0;0;0;0;0
FR;9;2021-08-18;0;0;0;0;0;0;0;0;0;0;0;0;0;0;0;0;0;0
FR;9;2021-08-19;0;0;0;0;0;0;0;0;0;0;0;0;0;0;0;0;0;0
FR;9;2021-08-20;0;0;0;0;0;0;0;0;0;0;0;0;0;0;0;0;0;0
FR;9;2021-08-21;0;0;0;0;0;0;0;0;0;0;0;0;0;0;0;0;0;0
FR;9;2021-08-22;0;0;0;0;0;0;0;0;0;0;0;0;0;0;0;0;0;0
FR;9;2021-08-23;0;0;0;0;0;0;0;0;0;0;0;0;0;0;0;0;0;0
FR;9;2021-08-24;0;0;0;0;0;0;0;0;0;0;0;0;0;0;0;0;0;0
FR;9;2021-08-25;0;0;0;0;0;0;0;0;0;0;0;0;0;0;0;0;0;0
FR;9;2021-08-26;0;0;0;0;0;0;0;0;0;0;0;0;0;0;0;0;0;0
FR;9;2021-08-27;0;0;0;0;0;0;0;0;0;0;0;0;0;0;0;0;0;0
FR;9;2021-08-28;0;0;0;0;0;0;0;0;0;0;0;0;0;0;0;0;0;0
FR;9;2021-08-29;0;0;0;0;0;0;0;0;0;0;0;0;0;0;0;0;0;0
FR;9;2021-08-30;0;0;0;0;0;0;0;0;0;0;0;0;0;0;0;0;0;0
FR;9;2021-08-31;0;0;0;0;0;0;0;0;0;0;0;0;0;0;0;0;0;0
FR;9;2021-09-01;0;0;0;0;0;0;0;0;0;0;0;0;0;0;0;0;0;0
FR;9;2021-09-02;0;0;0;0;0;0;0;0;0;0;0;0;0;0;0;0;0;0
FR;9;2021-09-03;0;0;0;0;0;0;0;0;0;0;0;0;0;0;0;0;0;0
FR;9;2021-09-04;0;0;0;0;0;0;0;0;0;0;0;0;0;0;0;0;0;0
FR;9;2021-09-05;0;0;0;0;0;0;0;0;0;0;0;0;0;0;0;0;0;0
FR;9;2021-09-06;0;0;0;0;0;0;0;0;0;0;0;0;0;0;0;0;0;0
FR;9;2021-09-07;0;0;0;0;0;0;0;0;0;0;0;0;0;0;0;0;0;0
FR;9;2021-09-08;0;0;0;0;0;0;0;0;0;0;0;0;0;0;0;0;0;0
FR;9;2021-09-09;0;0;0;0;0;0;0;0;0;0;0;0;0;0;0;0;0;0
FR;9;2021-09-10;0;0;0;0;0;0;0;0;0;0;0;0;0;0;0;0;0;0
FR;9;2021-09-11;0;0;0;0;0;0;0;0;0;0;0;0;0;0;0;0;0;0
FR;9;2021-09-12;0;0;0;0;0;0;0;0;0;0;0;0;0;0;0;0;0;0
FR;9;2021-09-13;0;0;0;0;0;0;0;0;0;0;0;0;0;0;0;0;0;0
FR;9;2021-09-14;0;0;0;0;0;0;0;0;0;0;0;0;0;0;0;0;0;0
FR;9;2021-09-15;0;0;0;0;0;0;0;0;0;0;0;0;0;0;0;0;0;0
FR;9;2021-09-16;0;0;0;0;0;0;0;0;0;0;0;0;0;0;0;0;0;0
FR;9;2021-09-17;0;0;0;0;0;0;0;0;0;0;0;0;0;0;0;0;0;0
FR;9;2021-09-18;0;0;0;0;0;0;0;0;0;0;0;0;0;0;0;0;0;0
FR;9;2021-09-19;0;0;0;0;0;0;0;0;0;0;0;0;0;0;0;0;0;0
FR;9;2021-09-20;0;0;0;0;0;0;0;0;0;0;0;0;0;0;0;0;0;0
FR;9;2021-09-21;0;0;0;0;0;0;0;0;0;0;0;0;0;0;0;0;0;0
FR;9;2021-09-22;0;0;0;0;0;0;0;0;0;0;0;0;0;0;0;0;0;0
FR;9;2021-09-23;0;0;0;0;0;0;0;0;0;0;0;0;0;0;0;0;0;0
FR;9;2021-09-24;0;0;0;0;0;0;0;0;0;0;0;0;0;0;0;0;0;0
FR;9;2021-09-25;0;0;0;0;0;0;0;0;0;0;0;0;0;0;0;0;0;0
FR;9;2021-09-26;0;0;0;0;0;0;0;0;0;0;0;0;0;0;0;0;0;0
FR;9;2021-09-27;0;0;0;0;0;0;0;0;0;0;0;0;0;0;0;0;0;0
FR;9;2021-09-28;0;0;0;0;0;0;0;0;0;0;0;0;0;0;0;0;0;0
FR;9;2021-09-29;0;0;0;0;0;0;0;0;0;0;0;0;0;0;0;0;0;0
FR;9;2021-09-30;0;0;0;0;0;0;0;0;0;0;0;0;0;0;0;0;0;0
FR;9;2021-10-01;0;0;0;0;0;0;0;0;0;0;0;0;0;0;0;0;0;0
FR;9;2021-10-02;0;0;0;0;0;0;0;0;0;0;0;0;0;0;0;0;0;0
FR;9;2021-10-03;0;0;0;0;0;0;0;0;0;0;0;0;0;0;0;0;0;0
FR;9;2021-10-04;0;0;0;0;0;0;0;0;0;0;0;0;0;0;0;0;0;0
FR;9;2021-10-05;0;0;0;0;0;0;0;0;0;0;0;0;0;0;0;0;0;0
FR;9;2021-10-06;0;0;0;0;0;0;0;0;0;0;0;0;0;0;0;0;0;0
FR;9;2021-10-07;0;0;0;0;0;0;0;0;0;0;0;0;0;0;0;0;0;0
FR;9;2021-10-08;0;0;0;0;0;0;0;0;0;0;0;0;0;0;0;0;0;0
FR;9;2021-10-09;0;0;0;0;0;0;0;0;0;0;0;0;0;0;0;0;0;0
FR;9;2021-10-10;0;0;0;0;0;0;0;0;0;0;0;0;0;0;0;0;0;0
FR;9;2021-10-11;0;0;0;0;0;0;0;0;0;0;0;0;0;0;0;0;0;0
FR;9;2021-10-12;0;0;0;0;0;0;0;0;0;0;0;0;0;0;0;0;0;0
FR;9;2021-10-13;0;0;0;0;0;0;0;0;0;0;0;0;0;0;0;0;0;0
FR;9;2021-10-14;0;0;0;0;0;0;0;0;0;0;0;0;0;0;0;0;0;0
FR;9;2021-10-15;0;0;0;0;0;0;0;0;0;0;0;0;0;0;0;0;0;0
FR;9;2021-10-16;0;0;0;0;0;0;0;0;0;0;0;0;0;0;0;0;0;0
FR;9;2021-10-17;0;0;0;0;0;0;0;0;0;0;0;0;0;0;0;0;0;0
FR;9;2021-10-18;0;0;0;0;0;0;0;0;0;0;0;0;0;0;0;0;0;0
FR;9;2021-10-19;0;0;0;0;0;0;0;0;0;0;0;0;0;0;0;0;0;0
FR;9;2021-10-20;0;0;0;0;0;0;0;0;0;0;0;0;0;0;0;0;0;0
FR;9;2021-10-21;0;0;0;0;0;0;0;0;0;0;0;0;0;0;0;0;0;0
FR;9;2021-10-22;0;0;0;0;0;0;0;0;0;0;0;0;0;0;0;0;0;0
FR;9;2021-10-23;0;0;0;0;0;0;0;0;0;0;0;0;0;0;0;0;0;0
FR;9;2021-10-24;0;0;0;0;0;0;0;0;0;0;0;0;0;0;0;0;0;0
FR;9;2021-10-25;0;0;0;0;0;0;0;0;0;0;0;0;0;0;0;0;0;0
FR;9;2021-10-26;0;0;0;0;0;0;0;0;0;0;0;0;0;0;0;0;0;0
FR;9;2021-10-27;0;0;0;0;0;0;0;0;0;0;0;0;0;0;0;0;0;0
FR;9;2021-10-28;0;0;0;0;0;0;0;0;0;0;0;0;0;0;0;0;0;0
FR;9;2021-10-29;0;0;0;0;0;0;0;0;0;0;0;0;0;0;0;0;0;0
FR;9;2021-10-30;0;0;0;0;0;0;0;0;0;0;0;0;0;0;0;0;0;0
FR;9;2021-10-31;0;0;0;0;0;0;0;0;0;0;0;0;0;0;0;0;0;0
FR;9;2021-11-01;0;0;0;0;0;0;0;0;0;0;0;0;0;0;0;0;0;0
FR;9;2021-11-02;0;0;0;0;0;0;0;0;0;0;0;0;0;0;0;0;0;0
FR;9;2021-11-03;0;0;0;0;0;0;0;0;0;0;0;0;0;0;0;0;0;0
FR;9;2021-11-04;0;0;0;0;0;0;0;0;0;0;0;0;0;0;0;0;0;0
FR;9;2021-11-05;0;0;0;0;0;0;0;0;0;0;0;0;0;0;0;0;0;0
FR;9;2021-11-06;0;0;0;0;0;0;0;0;0;0;0;0;0;0;0;0;0;0
FR;9;2021-11-07;0;0;0;0;0;0;0;0;0;0;0;0;0;0;0;0;0;0
FR;9;2021-11-08;0;0;0;0;0;0;0;0;0;0;0;0;0;0;0;0;0;0
FR;9;2021-11-09;0;0;0;0;0;0;0;0;0;0;0;0;0;0;0;0;0;0
FR;9;2021-11-10;0;0;0;0;0;0;0;0;0;0;0;0;0;0;0;0;0;0
FR;9;2021-11-11;0;0;0;0;0;0;0;0;0;0;0;0;0;0;0;0;0;0
FR;9;2021-11-12;0;0;0;0;0;0;0;0;0;0;0;0;0;0;0;0;0;0
FR;9;2021-11-13;0;0;0;0;0;0;0;0;0;0;0;0;0;0;0;0;0;0
FR;9;2021-11-14;0;0;0;0;0;0;0;0;0;0;0;0;0;0;0;0;0;0
FR;9;2021-11-15;0;0;0;0;0;0;0;0;0;0;0;0;0;0;0;0;0;0
FR;9;2021-11-16;0;0;0;0;0;0;0;0;0;0;0;0;0;0;0;0;0;0
FR;9;2021-11-17;0;0;0;0;0;0;0;0;0;0;0;0;0;0;0;0;0;0
FR;9;2021-11-18;0;0;0;0;0;0;0;0;0;0;0;0;0;0;0;0;0;0
FR;9;2021-11-19;0;0;0;0;0;0;0;0;0;0;0;0;0;0;0;0;0;0
FR;9;2021-11-20;0;0;0;0;0;0;0;0;0;0;0;0;0;0;0;0;0;0
FR;9;2021-11-21;0;0;0;0;0;0;0;0;0;0;0;0;0;0;0;0;0;0
FR;9;2021-11-22;0;0;0;0;0;0;0;0;0;0;0;0;0;0;0;0;0;0
FR;9;2021-11-23;0;0;0;0;0;0;0;0;0;0;0;0;0;0;0;0;0;0
FR;9;2021-11-24;0;0;0;0;0;0;0;0;0;0;0;0;0;0;0;0;0;0
FR;9;2021-11-25;0;0;0;0;0;0;0;0;0;0;0;0;0;0;0;0;0;0
FR;9;2021-11-26;0;0;0;0;0;0;0;0;0;0;0;0;0;0;0;0;0;0
FR;9;2021-11-27;0;0;0;0;0;0;0;0;0;0;0;0;0;0;0;0;0;0
FR;9;2021-11-28;0;0;0;0;0;0;0;0;0;0;0;0;0;0;0;0;0;0
FR;9;2021-11-29;0;0;0;0;0;0;0;0;0;0;0;0;0;0;0;0;0;0
FR;9;2021-11-30;0;0;0;0;0;0;0;0;0;0;0;0;0;0;0;0;0;0
FR;9;2021-12-01;0;0;0;0;0;0;0;0;0;0;0;0;0;0;0;0;0;0
FR;9;2021-12-02;0;0;0;0;0;0;0;0;0;0;0;0;0;0;0;0;0;0
FR;9;2021-12-03;0;0;0;0;0;0;0;0;0;0;0;0;0;0;0;0;0;0
FR;9;2021-12-04;0;0;0;0;0;0;0;0;0;0;0;0;0;0;0;0;0;0
FR;9;2021-12-05;0;0;0;0;0;0;0;0;0;0;0;0;0;0;0;0;0;0
FR;9;2021-12-06;0;0;0;0;0;0;0;0;0;0;0;0;0;0;0;0;0;0
FR;9;2021-12-07;0;0;0;0;0;0;0;0;0;0;0;0;0;0;0;0;0;0
FR;9;2021-12-08;0;0;0;0;0;0;0;0;0;0;0;0;0;0;0;0;0;0
FR;9;2021-12-09;0;0;0;0;0;0;0;0;0;0;0;0;0;0;0;0;0;0
FR;9;2021-12-10;0;0;0;0;0;0;0;0;0;0;0;0;0;0;0;0;0;0
FR;9;2021-12-11;0;0;0;0;0;0;0;0;0;0;0;0;0;0;0;0;0;0
FR;9;2021-12-12;0;0;0;0;0;0;0;0;0;0;0;0;0;0;0;0;0;0
FR;9;2021-12-13;0;0;0;0;0;0;0;0;0;0;0;0;0;0;0;0;0;0
FR;9;2021-12-14;0;0;0;0;0;0;0;0;0;0;0;0;0;0;0;0;0;0
FR;9;2021-12-15;0;0;0;0;0;0;0;0;0;0;0;0;0;0;0;0;0;0
FR;9;2021-12-16;0;0;0;0;0;0;0;0;0;0;0;0;0;0;0;0;0;0
FR;9;2021-12-17;0;0;0;0;0;0;0;0;0;0;0;0;0;0;0;0;0;0
FR;9;2021-12-18;0;0;0;0;0;0;0;0;0;0;0;0;0;0;0;0;0;0
FR;9;2021-12-19;0;0;0;0;0;0;0;0;0;0;0;0;0;0;0;0;0;0
FR;9;2021-12-20;0;0;0;0;0;0;0;0;0;0;0;0;0;0;0;0;0;0
FR;9;2021-12-21;0;0;0;0;0;0;0;0;0;0;0;0;0;0;0;0;0;0
FR;9;2021-12-22;0;0;0;0;0;0;0;0;0;0;0;0;0;0;0;0;0;0
FR;9;2021-12-23;0;0;0;0;0;0;0;0;0;0;0;0;0;0;0;0;0;0
FR;9;2021-12-24;0;0;0;0;0;0;0;0;0;0;0;0;0;0;0;0;0;0
FR;9;2021-12-25;0;0;0;0;0;0;0;0;0;0;0;0;0;0;0;0;0;0
FR;9;2021-12-26;0;0;0;0;0;0;0;0;0;0;0;0;0;0;0;0;0;0
FR;9;2021-12-27;0;0;0;0;0;0;0;0;0;0;0;0;0;0;0;0;0;0
FR;9;2021-12-28;0;0;0;0;0;0;0;0;0;0;0;0;0;0;0;0;0;0
FR;9;2021-12-29;0;0;0;0;0;0;0;0;0;0;0;0;0;0;0;0;0;0
FR;9;2021-12-30;0;0;0;0;0;0;0;0;0;0;0;0;0;0;0;0;0;0
FR;9;2021-12-31;0;0;0;0;0;0;0;0;0;0;0;0;0;0;0;0;0;0
FR;9;2022-01-01;0;0;0;0;0;0;0;0;0;0;0;0;0;0;0;0;0;0
FR;9;2022-01-02;0;0;0;0;0;0;0;0;0;0;0;0;0;0;0;0;0;0
FR;9;2022-01-03;0;0;0;0;0;0;0;0;0;0;0;0;0;0;0;0;0;0
FR;9;2022-01-04;0;0;0;0;0;0;0;0;0;0;0;0;0;0;0;0;0;0
FR;9;2022-01-05;0;0;0;0;0;0;0;0;0;0;0;0;0;0;0;0;0;0
FR;9;2022-01-06;0;0;0;0;0;0;0;0;0;0;0;0;0;0;0;0;0;0
FR;9;2022-01-07;0;0;0;0;0;0;0;0;0;0;0;0;0;0;0;0;0;0
FR;9;2022-01-08;0;0;0;0;0;0;0;0;0;0;0;0;0;0;0;0;0;0
FR;9;2022-01-09;0;0;0;0;0;0;0;0;0;0;0;0;0;0;0;0;0;0
FR;9;2022-01-10;0;0;0;0;0;0;0;0;0;0;0;0;0;0;0;0;0;0
FR;9;2022-01-11;0;0;0;0;0;0;0;0;0;0;0;0;0;0;0;0;0;0
FR;9;2022-01-12;0;0;0;0;0;0;0;0;0;0;0;0;0;0;0;0;0;0
FR;9;2022-01-13;0;0;0;0;0;0;0;0;0;0;0;0;0;0;0;0;0;0
FR;9;2022-01-14;0;0;0;0;0;0;0;0;0;0;0;0;0;0;0;0;0;0
FR;9;2022-01-15;0;0;0;0;0;0;0;0;0;0;0;0;0;0;0;0;0;0
FR;9;2022-01-16;0;0;0;0;0;0;0;0;0;0;0;0;0;0;0;0;0;0
FR;9;2022-01-17;0;0;0;0;0;0;0;0;0;0;0;0;0;0;0;0;0;0
FR;9;2022-01-18;0;0;0;0;0;0;0;0;0;0;0;0;0;0;0;0;0;0
FR;9;2022-01-19;0;0;0;0;0;0;0;0;0;0;0;0;0;0;0;0;0;0
FR;9;2022-01-20;0;0;0;0;0;0;0;0;0;0;0;0;0;0;0;0;0;0
FR;9;2022-01-21;0;0;0;0;0;0;0;0;0;0;0;0;0;0;0;0;0;0
FR;9;2022-01-22;0;0;0;0;0;0;0;0;0;0;0;0;0;0;0;0;0;0
FR;9;2022-01-23;0;0;0;0;0;0;0;0;0;0;0;0;0;0;0;0;0;0
FR;9;2022-01-24;0;0;0;0;0;0;0;0;0;0;0;0;0;0;0;0;0;0
FR;9;2022-01-25;0;0;0;0;0;0;0;0;0;0;0;0;0;0;0;0;0;0
FR;9;2022-01-26;0;0;0;0;0;0;0;0;0;0;0;0;0;0;0;0;0;0
FR;9;2022-01-27;0;0;0;0;0;0;0;0;0;0;0;0;0;0;0;0;0;0
FR;9;2022-01-28;0;0;0;0;0;0;0;0;0;0;0;0;0;0;0;0;0;0
FR;9;2022-01-29;0;0;0;0;0;0;0;0;0;0;0;0;0;0;0;0;0;0
FR;9;2022-01-30;0;0;0;0;0;0;0;0;0;0;0;0;0;0;0;0;0;0
FR;9;2022-01-31;0;0;0;0;0;0;0;0;0;0;0;0;0;0;0;0;0;0
FR;9;2022-02-01;0;0;0;0;0;0;0;0;0;0;0;0;0;0;0;0;0;0
FR;9;2022-02-02;0;0;0;0;0;0;0;0;0;0;0;0;0;0;0;0;0;0
FR;9;2022-02-03;0;0;0;0;0;0;0;0;0;0;0;0;0;0;0;0;0;0
FR;9;2022-02-04;0;0;0;0;0;0;0;0;0;0;0;0;0;0;0;0;0;0
FR;9;2022-02-05;0;0;0;0;0;0;0;0;0;0;0;0;0;0;0;0;0;0
FR;9;2022-02-06;0;0;0;0;0;0;0;0;0;0;0;0;0;0;0;0;0;0
FR;9;2022-02-07;0;0;0;0;0;0;0;0;0;0;0;0;0;0;0;0;0;0
FR;9;2022-02-08;0;0;0;0;0;0;0;0;0;0;0;0;0;0;0;0;0;0
FR;9;2022-02-09;0;0;0;0;0;0;0;0;0;0;0;0;0;0;0;0;0;0
FR;9;2022-02-10;0;0;0;0;0;0;0;0;0;0;0;0;0;0;0;0;0;0
FR;9;2022-02-11;0;0;0;0;0;0;0;0;0;0;0;0;0;0;0;0;0;0
FR;9;2022-02-12;0;0;0;0;0;0;0;0;0;0;0;0;0;0;0;0;0;0
FR;9;2022-02-13;0;0;0;0;0;0;0;0;0;0;0;0;0;0;0;0;0;0
FR;9;2022-02-14;0;0;0;0;0;0;0;0;0;0;0;0;0;0;0;0;0;0
FR;9;2022-02-15;0;0;0;0;0;0;0;0;0;0;0;0;0;0;0;0;0;0
FR;9;2022-02-16;0;0;0;0;0;0;0;0;0;0;0;0;0;0;0;0;0;0
FR;9;2022-02-17;0;0;0;0;0;0;0;0;0;0;0;0;0;0;0;0;0;0
FR;9;2022-02-18;0;0;0;0;0;0;0;0;0;0;0;0;0;0;0;0;0;0
FR;9;2022-02-19;0;0;0;0;0;0;0;0;0;0;0;0;0;0;0;0;0;0
FR;9;2022-02-20;0;0;0;0;0;0;0;0;0;0;0;0;0;0;0;0;0;0
FR;9;2022-02-21;0;0;0;0;0;0;0;0;0;0;0;0;0;0;0;0;0;0
FR;9;2022-02-22;0;0;0;0;0;0;0;0;0;0;0;0;0;0;0;0;0;0
FR;9;2022-02-23;0;0;0;0;0;0;0;0;0;0;0;0;0;0;0;0;0;0
FR;9;2022-02-24;0;0;0;0;0;0;0;0;0;0;0;0;0;0;0;0;0;0
FR;9;2022-02-25;0;0;0;0;0;0;0;0;0;0;0;0;0;0;0;0;0;0
FR;9;2022-02-26;0;0;0;0;0;0;0;0;0;0;0;0;0;0;0;0;0;0
FR;9;2022-02-27;0;0;0;0;0;0;0;0;0;0;0;0;0;0;0;0;0;0
FR;9;2022-02-28;0;0;0;0;0;0;0;0;0;0;0;0;0;0;0;0;0;0
FR;9;2022-03-01;0;0;0;0;0;0;0;0;0;0;0;0;0;0;0;0;0;0
FR;9;2022-03-02;0;0;0;0;0;0;0;0;0;0;0;0;0;0;0;0;0;0
FR;9;2022-03-03;0;0;0;0;0;0;0;0;0;0;0;0;0;0;0;0;0;0
FR;9;2022-03-04;0;0;0;0;0;0;0;0;0;0;0;0;0;0;0;0;0;0
FR;9;2022-03-05;0;0;0;0;0;0;0;0;0;0;0;0;0;0;0;0;0;0
FR;9;2022-03-06;0;0;0;0;0;0;0;0;0;0;0;0;0;0;0;0;0;0
FR;9;2022-03-07;0;0;0;0;0;0;0;0;0;0;0;0;0;0;0;0;0;0
FR;9;2022-03-08;0;0;0;0;0;0;0;0;0;0;0;0;0;0;0;0;0;0
FR;9;2022-03-09;0;0;0;0;0;0;0;0;0;0;0;0;0;0;0;0;0;0
FR;9;2022-03-10;0;0;0;0;0;0;0;0;0;0;0;0;0;0;0;0;0;0
FR;9;2022-03-11;0;0;0;0;0;0;0;0;0;0;0;0;0;0;0;0;0;0
FR;9;2022-03-12;0;0;0;0;0;0;0;0;0;0;0;0;0;0;0;0;0;0
FR;9;2022-03-13;0;0;0;0;0;0;0;0;0;0;0;0;0;0;0;0;0;0
FR;9;2022-03-14;0;0;0;0;0;0;0;0;0;0;0;0;0;0;0;0;0;0
FR;9;2022-03-15;0;0;0;0;0;0;0;0;0;0;0;0;0;0;0;0;0;0
FR;9;2022-03-16;0;0;0;0;0;0;0;0;0;0;0;0;0;0;0;0;0;0
FR;9;2022-03-17;0;0;0;0;0;0;0;0;0;0;0;0;0;0;0;0;0;0
FR;9;2022-03-18;0;0;0;0;0;0;0;0;0;0;0;0;0;0;0;0;0;0
FR;9;2022-03-19;0;0;0;0;0;0;0;0;0;0;0;0;0;0;0;0;0;0
FR;9;2022-03-20;0;0;0;0;0;0;0;0;0;0;0;0;0;0;0;0;0;0
FR;9;2022-03-21;0;0;0;0;0;0;0;0;0;0;0;0;0;0;0;0;0;0
FR;9;2022-03-22;0;0;0;0;0;0;0;0;0;0;0;0;0;0;0;0;0;0
FR;9;2022-03-23;0;0;0;0;0;0;0;0;0;0;0;0;0;0;0;0;0;0
FR;9;2022-03-24;0;0;0;0;0;0;0;0;0;0;0;0;0;0;0;0;0;0
FR;9;2022-03-25;0;0;0;0;0;0;0;0;0;0;0;0;0;0;0;0;0;0
FR;9;2022-03-26;0;0;0;0;0;0;0;0;0;0;0;0;0;0;0;0;0;0
FR;9;2022-03-27;0;0;0;0;0;0;0;0;0;0;0;0;0;0;0;0;0;0
FR;9;2022-03-28;0;0;0;0;0;0;0;0;0;0;0;0;0;0;0;0;0;0
FR;9;2022-03-29;0;0;0;0;0;0;0;0;0;0;0;0;0;0;0;0;0;0
FR;9;2022-03-30;0;0;0;0;0;0;0;0;0;0;0;0;0;0;0;0;0;0
FR;9;2022-03-31;0;0;0;0;0;0;0;0;0;0;0;0;0;0;0;0;0;0
FR;9;2022-04-01;0;0;0;0;0;0;0;0;0;0;0;0;0;0;0;0;0;0
FR;9;2022-04-02;0;0;0;0;0;0;0;0;0;0;0;0;0;0;0;0;0;0
FR;9;2022-04-03;0;0;0;0;0;0;0;0;0;0;0;0;0;0;0;0;0;0
FR;9;2022-04-04;0;0;0;0;0;0;0;0;0;0;0;0;0;0;0;0;0;0
FR;9;2022-04-05;0;0;0;0;0;0;0;0;0;0;0;0;0;0;0;0;0;0
FR;9;2022-04-06;0;0;0;0;0;0;0;0;0;0;0;0;0;0;0;0;0;0
FR;9;2022-04-07;0;0;0;0;0;0;0;0;0;0;0;0;0;0;0;0;0;0
FR;9;2022-04-08;0;0;0;0;0;0;0;0;0;0;0;0;0;0;0;0;0;0
FR;9;2022-04-09;0;0;0;0;0;0;0;0;0;0;0;0;0;0;0;0;0;0
FR;9;2022-04-10;0;0;0;0;0;0;0;0;0;0;0;0;0;0;0;0;0;0
FR;9;2022-04-11;0;0;0;0;0;0;0;0;0;0;0;0;0;0;0;0;0;0
FR;9;2022-04-12;0;0;0;0;0;0;0;0;0;0;0;0;0;0;0;0;0;0
FR;9;2022-04-13;0;0;0;0;0;0;0;0;0;0;0;0;0;0;0;0;0;0
FR;9;2022-04-14;0;0;0;0;0;0;0;0;0;0;0;0;0;0;0;0;0;0
FR;9;2022-04-15;0;0;0;0;0;0;0;0;0;0;0;0;0;0;0;0;0;0
FR;9;2022-04-16;0;0;0;0;0;0;0;0;0;0;0;0;0;0;0;0;0;0
FR;9;2022-04-17;0;0;0;0;0;0;0;0;0;0;0;0;0;0;0;0;0;0
FR;9;2022-04-18;0;0;0;0;0;0;0;0;0;0;0;0;0;0;0;0;0;0
FR;9;2022-04-19;0;0;0;0;0;0;0;0;0;0;0;0;0;0;0;0;0;0
FR;9;2022-04-20;0;0;0;0;0;0;0;0;0;0;0;0;0;0;0;0;0;0
FR;9;2022-04-21;0;0;0;0;0;0;0;0;0;0;0;0;0;0;0;0;0;0
FR;9;2022-04-22;0;0;0;0;0;0;0;0;0;0;0;0;0;0;0;0;0;0
FR;9;2022-04-23;0;0;0;0;0;0;0;0;0;0;0;0;0;0;0;0;0;0
FR;9;2022-04-24;0;0;0;0;0;0;0;0;0;0;0;0;0;0;0;0;0;0
FR;9;2022-04-25;0;0;0;0;0;0;0;0;0;0;0;0;0;0;0;0;0;0
FR;9;2022-04-26;0;0;0;0;0;0;0;0;0;0;0;0;0;0;0;0;0;0
FR;9;2022-04-27;0;0;0;0;0;0;0;0;0;0;0;0;0;0;0;0;0;0
FR;9;2022-04-28;0;0;0;0;0;0;0;0;0;0;0;0;0;0;0;0;0;0
FR;9;2022-04-29;0;0;0;0;0;0;0;0;0;0;0;0;0;0;0;0;0;0
FR;9;2022-04-30;0;0;0;0;0;0;0;0;0;0;0;0;0;0;0;0;0;0
FR;9;2022-05-01;0;0;0;0;0;0;0;0;0;0;0;0;0;0;0;0;0;0
FR;9;2022-05-02;0;0;0;0;0;0;0;0;0;0;0;0;0;0;0;0;0;0
FR;9;2022-05-03;0;0;0;0;0;0;0;0;0;0;0;0;0;0;0;0;0;0
FR;9;2022-05-04;0;0;0;0;0;0;0;0;0;0;0;0;0;0;0;0;0;0
FR;9;2022-05-05;0;0;0;0;0;0;0;0;0;0;0;0;0;0;0;0;0;0
FR;9;2022-05-06;0;0;0;0;0;0;0;0;0;0;0;0;0;0;0;0;0;0
FR;9;2022-05-07;0;0;0;0;0;0;0;0;0;0;0;0;0;0;0;0;0;0
FR;9;2022-05-08;0;0;0;0;0;0;0;0;0;0;0;0;0;0;0;0;0;0
FR;9;2022-05-09;0;0;0;0;0;0;0;0;0;0;0;0;0;0;0;0;0;0
FR;9;2022-05-10;0;0;0;0;0;0;0;0;0;0;0;0;0;0;0;0;0;0
FR;9;2022-05-11;0;0;0;0;0;0;0;0;0;0;0;0;0;0;0;0;0;0
FR;9;2022-05-12;0;0;0;0;0;0;0;0;0;0;0;0;0;0;0;0;0;0
FR;9;2022-05-13;0;0;0;0;0;0;0;0;0;0;0;0;0;0;0;0;0;0
FR;9;2022-05-14;0;0;0;0;0;0;0;0;0;0;0;0;0;0;0;0;0;0
FR;9;2022-05-15;0;0;0;0;0;0;0;0;0;0;0;0;0;0;0;0;0;0
FR;9;2022-05-16;0;0;0;0;0;0;0;0;0;0;0;0;0;0;0;0;0;0
FR;9;2022-05-17;0;0;0;0;0;0;0;0;0;0;0;0;0;0;0;0;0;0
FR;9;2022-05-18;0;0;0;0;0;0;0;0;0;0;0;0;0;0;0;0;0;0
FR;9;2022-05-19;0;0;0;0;0;0;0;0;0;0;0;0;0;0;0;0;0;0
FR;9;2022-05-20;0;0;0;0;0;0;0;0;0;0;0;0;0;0;0;0;0;0
FR;9;2022-05-21;0;0;0;0;0;0;0;0;0;0;0;0;0;0;0;0;0;0
FR;9;2022-05-22;0;0;0;0;0;0;0;0;0;0;0;0;0;0;0;0;0;0
FR;9;2022-05-23;0;0;0;0;0;0;0;0;0;0;0;0;0;0;0;0;0;0
FR;9;2022-05-24;0;0;0;0;0;0;0;0;0;0;0;0;0;0;0;0;0;0
FR;9;2022-05-25;0;0;0;0;0;0;0;0;0;0;0;0;0;0;0;0;0;0
FR;9;2022-05-26;0;0;0;0;0;0;0;0;0;0;0;0;0;0;0;0;0;0
FR;9;2022-05-27;0;0;0;0;0;0;0;0;0;0;0;0;0;0;0;0;0;0
FR;9;2022-05-28;0;0;0;0;0;0;0;0;0;0;0;0;0;0;0;0;0;0
FR;9;2022-05-29;0;0;0;0;0;0;0;0;0;0;0;0;0;0;0;0;0;0
FR;9;2022-05-30;0;0;0;0;0;0;0;0;0;0;0;0;0;0;0;0;0;0
FR;9;2022-05-31;0;0;0;0;0;0;0;0;0;0;0;0;0;0;0;0;0;0
FR;9;2022-06-01;0;0;0;0;0;0;0;0;0;0;0;0;0;0;0;0;0;0
FR;9;2022-06-02;0;0;0;0;0;0;0;0;0;0;0;0;0;0;0;0;0;0
FR;9;2022-06-03;0;0;0;0;0;0;0;0;0;0;0;0;0;0;0;0;0;0
FR;9;2022-06-04;0;0;0;0;0;0;0;0;0;0;0;0;0;0;0;0;0;0
FR;9;2022-06-05;0;0;0;0;0;0;0;0;0;0;0;0;0;0;0;0;0;0
FR;9;2022-06-06;0;0;0;0;0;0;0;0;0;0;0;0;0;0;0;0;0;0
FR;9;2022-06-07;0;0;0;0;0;0;0;0;0;0;0;0;0;0;0;0;0;0
FR;9;2022-06-08;0;0;0;0;0;0;0;0;0;0;0;0;0;0;0;0;0;0
FR;9;2022-06-09;0;0;0;0;0;0;0;0;0;0;0;0;0;0;0;0;0;0
FR;9;2022-06-10;0;0;0;0;0;0;0;0;0;0;0;0;0;0;0;0;0;0
FR;9;2022-06-11;0;0;0;0;0;0;0;0;0;0;0;0;0;0;0;0;0;0
FR;9;2022-06-12;0;0;0;0;0;0;0;0;0;0;0;0;0;0;0;0;0;0
FR;9;2022-06-13;0;0;0;0;0;0;0;0;0;0;0;0;0;0;0;0;0;0
FR;9;2022-06-14;0;0;0;0;0;0;0;0;0;0;0;0;0;0;0;0;0;0
FR;9;2022-06-15;0;0;0;0;0;0;0;0;0;0;0;0;0;0;0;0;0;0
FR;9;2022-06-16;0;0;0;0;0;0;0;0;0;0;0;0;0;0;0;0;0;0
FR;9;2022-06-17;0;0;0;0;0;0;0;0;0;0;0;0;0;0;0;0;0;0
FR;9;2022-06-18;0;0;0;0;0;0;0;0;0;0;0;0;0;0;0;0;0;0
FR;9;2022-06-19;0;0;0;0;0;0;0;0;0;0;0;0;0;0;0;0;0;0
FR;9;2022-06-20;0;0;0;0;0;0;0;0;0;0;0;0;0;0;0;0;0;0
FR;9;2022-06-21;0;0;0;0;0;0;0;0;0;0;0;0;0;0;0;0;0;0
FR;9;2022-06-22;0;0;0;0;0;0;0;0;0;0;0;0;0;0;0;0;0;0
FR;9;2022-06-23;0;0;0;0;0;0;0;0;0;0;0;0;0;0;0;0;0;0
FR;9;2022-06-24;0;0;0;0;0;0;0;0;0;0;0;0;0;0;0;0;0;0
FR;9;2022-06-25;0;0;0;0;0;0;0;0;0;0;0;0;0;0;0;0;0;0
FR;9;2022-06-26;0;0;0;0;0;0;0;0;0;0;0;0;0;0;0;0;0;0
FR;9;2022-06-27;0;0;0;0;0;0;0;0;0;0;0;0;0;0;0;0;0;0
FR;9;2022-06-28;0;0;0;0;0;0;0;0;0;0;0;0;0;0;0;0;0;0
FR;9;2022-06-29;0;0;0;0;0;0;0;0;0;0;0;0;0;0;0;0;0;0
FR;9;2022-06-30;0;0;0;0;0;0;0;0;0;0;0;0;0;0;0;0;0;0
FR;9;2022-07-01;0;0;0;0;0;0;0;0;0;0;0;0;0;0;0;0;0;0
FR;9;2022-07-02;0;0;0;0;0;0;0;0;0;0;0;0;0;0;0;0;0;0
FR;9;2022-07-03;0;0;0;0;0;0;0;0;0;0;0;0;0;0;0;0;0;0
FR;9;2022-07-04;0;0;0;0;0;0;0;0;0;0;0;0;0;0;0;0;0;0
FR;9;2022-07-05;0;0;0;0;0;0;0;0;0;0;0;0;0;0;0;0;0;0
FR;9;2022-07-06;0;0;0;0;0;0;0;0;0;0;0;0;0;0;0;0;0;0
FR;9;2022-07-07;0;0;0;0;0;0;0;0;0;0;0;0;0;0;0;0;0;0
FR;9;2022-07-08;0;0;0;0;0;0;0;0;0;0;0;0;0;0;0;0;0;0
FR;9;2022-07-09;0;0;0;0;0;0;0;0;0;0;0;0;0;0;0;0;0;0
FR;9;2022-07-10;0;0;0;0;0;0;0;0;0;0;0;0;0;0;0;0;0;0
FR;9;2022-07-11;0;0;0;0;0;0;0;0;0;0;0;0;0;0;0;0;0;0
FR;9;2022-07-12;0;0;0;0;0;0;0;0;0;0;0;0;0;0;0;0;0;0
FR;9;2022-07-13;0;0;0;0;0;0;0;0;0;0;0;0;0;0;0;0;0;0
FR;9;2022-07-14;0;0;0;0;0;0;0;0;0;0;0;0;0;0;0;0;0;0
FR;9;2022-07-15;0;0;0;0;0;0;0;0;0;0;0;0;0;0;0;0;0;0
FR;9;2022-07-16;0;0;0;0;0;0;0;0;0;0;0;0;0;0;0;0;0;0
FR;9;2022-07-17;0;0;0;0;0;0;0;0;0;0;0;0;0;0;0;0;0;0
FR;9;2022-07-18;0;0;0;0;0;0;0;0;0;0;0;0;0;0;0;0;0;0
FR;9;2022-07-19;0;0;0;0;0;0;0;0;0;0;0;0;0;0;0;0;0;0
FR;9;2022-07-20;0;0;0;0;0;0;0;0;0;0;0;0;0;0;0;0;0;0
FR;9;2022-07-21;0;0;0;0;0;0;0;0;0;0;0;0;0;0;0;0;0;0
FR;9;2022-07-22;0;0;0;0;0;0;0;0;0;0;0;0;0;0;0;0;0;0
FR;9;2022-07-23;0;0;0;0;0;0;0;0;0;0;0;0;0;0;0;0;0;0
FR;9;2022-07-24;0;0;0;0;0;0;0;0;0;0;0;0;0;0;0;0;0;0
FR;9;2022-07-25;0;0;0;0;0;0;0;0;0;0;0;0;0;0;0;0;0;0
FR;9;2022-07-26;0;0;0;0;0;0;0;0;0;0;0;0;0;0;0;0;0;0
FR;9;2022-07-27;0;0;0;0;0;0;0;0;0;0;0;0;0;0;0;0;0;0
FR;9;2022-07-28;0;0;0;0;0;0;0;0;0;0;0;0;0;0;0;0;0;0
FR;9;2022-07-29;0;0;0;0;0;0;0;0;0;0;0;0;0;0;0;0;0;0
FR;9;2022-07-30;0;0;0;0;0;0;0;0;0;0;0;0;0;0;0;0;0;0
FR;9;2022-07-31;0;0;0;0;0;0;0;0;0;0;0;0;0;0;0;0;0;0
FR;9;2022-08-01;0;0;0;0;0;0;0;0;0;0;0;0;0;0;0;0;0;0
FR;9;2022-08-02;0;0;0;0;0;0;0;0;0;0;0;0;0;0;0;0;0;0
FR;9;2022-08-03;0;0;0;0;0;0;0;0;0;0;0;0;0;0;0;0;0;0
FR;9;2022-08-04;0;0;0;0;0;0;0;0;0;0;0;0;0;0;0;0;0;0
FR;9;2022-08-05;0;0;0;0;0;0;0;0;0;0;0;0;0;0;0;0;0;0
FR;9;2022-08-06;0;0;0;0;0;0;0;0;0;0;0;0;0;0;0;0;0;0
FR;9;2022-08-07;0;0;0;0;0;0;0;0;0;0;0;0;0;0;0;0;0;0
FR;9;2022-08-08;0;0;0;0;0;0;0;0;0;0;0;0;0;0;0;0;0;0
FR;9;2022-08-09;0;0;0;0;0;0;0;0;0;0;0;0;0;0;0;0;0;0
FR;9;2022-08-10;0;0;0;0;0;0;0;0;0;0;0;0;0;0;0;0;0;0
FR;9;2022-08-11;0;0;0;0;0;0;0;0;0;0;0;0;0;0;0;0;0;0
FR;9;2022-08-12;0;0;0;0;0;0;0;0;0;0;0;0;0;0;0;0;0;0
FR;9;2022-08-13;0;0;0;0;0;0;0;0;0;0;0;0;0;0;0;0;0;0
FR;9;2022-08-14;0;0;0;0;0;0;0;0;0;0;0;0;0;0;0;0;0;0
FR;9;2022-08-15;0;0;0;0;0;0;0;0;0;0;0;0;0;0;0;0;0;0
FR;9;2022-08-16;0;0;0;0;0;0;0;0;0;0;0;0;0;0;0;0;0;0
FR;9;2022-08-17;0;0;0;0;0;0;0;0;0;0;0;0;0;0;0;0;0;0
FR;9;2022-08-18;0;0;0;0;0;0;0;0;0;0;0;0;0;0;0;0;0;0
FR;9;2022-08-19;0;0;0;0;0;0;0;0;0;0;0;0;0;0;0;0;0;0
FR;9;2022-08-20;0;0;0;0;0;0;0;0;0;0;0;0;0;0;0;0;0;0
FR;9;2022-08-21;0;0;0;0;0;0;0;0;0;0;0;0;0;0;0;0;0;0
FR;9;2022-08-22;0;0;0;0;0;0;0;0;0;0;0;0;0;0;0;0;0;0
FR;9;2022-08-23;0;0;0;0;0;0;0;0;0;0;0;0;0;0;0;0;0;0
FR;9;2022-08-24;0;0;0;0;0;0;0;0;0;0;0;0;0;0;0;0;0;0
FR;9;2022-08-25;0;0;0;0;0;0;0;0;0;0;0;0;0;0;0;0;0;0
FR;9;2022-08-26;0;0;0;0;0;0;0;0;0;0;0;0;0;0;0;0;0;0
FR;9;2022-08-27;0;0;0;0;0;0;0;0;0;0;0;0;0;0;0;0;0;0
FR;9;2022-08-28;0;0;0;0;0;0;0;0;0;0;0;0;0;0;0;0;0;0
FR;9;2022-08-29;0;0;0;0;0;0;0;0;0;0;0;0;0;0;0;0;0;0
FR;9;2022-08-30;0;0;0;0;0;0;0;0;0;0;0;0;0;0;0;0;0;0
FR;9;2022-08-31;0;0;0;0;0;0;0;0;0;0;0;0;0;0;0;0;0;0
FR;9;2022-09-01;0;0;0;0;0;0;0;0;0;0;0;0;0;0;0;0;0;0
FR;9;2022-09-02;0;0;0;0;0;0;0;0;0;0;0;0;0;0;0;0;0;0
FR;9;2022-09-03;0;0;0;0;0;0;0;0;0;0;0;0;0;0;0;0;0;0
FR;9;2022-09-04;0;0;0;0;0;0;0;0;0;0;0;0;0;0;0;0;0;0
FR;9;2022-09-05;0;0;0;0;0;0;0;0;0;0;0;0;0;0;0;0;0;0
FR;9;2022-09-06;0;0;0;0;0;0;0;0;0;0;0;0;0;0;0;0;0;0
FR;9;2022-09-07;0;0;0;0;0;0;0;0;0;0;0;0;0;0;0;0;0;0
FR;9;2022-09-08;0;0;0;0;0;0;0;0;0;0;0;0;0;0;0;0;0;0
FR;9;2022-09-09;0;0;0;0;0;0;0;0;0;0;0;0;0;0;0;0;0;0
FR;9;2022-09-10;0;0;0;0;0;0;0;0;0;0;0;0;0;0;0;0;0;0
FR;9;2022-09-11;0;0;0;0;0;0;0;0;0;0;0;0;0;0;0;0;0;0
FR;9;2022-09-12;0;0;0;0;0;0;0;0;0;0;0;0;0;0;0;0;0;0
FR;9;2022-09-13;0;0;0;0;0;0;0;0;0;0;0;0;0;0;0;0;0;0
FR;9;2022-09-14;0;0;0;0;0;0;0;0;0;0;0;0;0;0;0;0;0;0
FR;9;2022-09-15;0;0;0;0;0;0;0;0;0;0;0;0;0;0;0;0;0;0
FR;9;2022-09-16;0;0;0;0;0;0;0;0;0;0;0;0;0;0;0;0;0;0
FR;9;2022-09-17;0;0;0;0;0;0;0;0;0;0;0;0;0;0;0;0;0;0
FR;9;2022-09-18;0;0;0;0;0;0;0;0;0;0;0;0;0;0;0;0;0;0
FR;9;2022-09-19;0;0;0;0;0;0;0;0;0;0;0;0;0;0;0;0;0;0
FR;9;2022-09-20;0;0;0;0;0;0;0;0;0;0;0;0;0;0;0;0;0;0
FR;9;2022-09-21;0;0;0;0;0;0;0;0;0;0;0;0;0;0;0;0;0;0
FR;9;2022-09-22;0;0;0;0;0;0;0;0;0;0;0;0;0;0;0;0;0;0
FR;9;2022-09-23;0;0;0;0;0;0;0;0;0;0;0;0;0;0;0;0;0;0
FR;9;2022-09-24;0;0;0;0;0;0;0;0;0;0;0;0;0;0;0;0;0;0
FR;9;2022-09-25;0;0;0;0;0;0;0;0;0;0;0;0;0;0;0;0;0;0
FR;9;2022-09-26;0;0;0;0;0;0;0;0;0;0;0;0;0;0;0;0;0;0
FR;9;2022-09-27;0;0;0;0;0;0;0;0;0;0;0;0;0;0;0;0;0;0
FR;9;2022-09-28;0;0;0;0;0;0;0;0;0;0;0;0;0;0;0;0;0;0
FR;9;2022-09-29;1;1;8;33;0;6;35;43;2;1;1;8;33;0;6;35;43;2
FR;9;2022-09-30;5;13;61;606;7;47;614;714;51;6;14;69;639;7;53;649;757;53
FR;9;2022-10-01;10;1;43;327;2;26;335;396;35;16;15;112;966;9;79;984;1153;88
FR;9;2022-10-02;2;1;5;50;0;4;51;66;11;18;16;117;1016;9;83;1035;1219;99
FR;9;2022-10-03;13;17;151;1714;11;129;1708;2074;234;31;33;268;2730;20;212;2743;3293;333
FR;9;2022-10-04;22;48;353;3954;18;228;4022;4704;450;53;81;621;6684;38;440;6765;7997;783
FR;9;2022-10-05;29;20;269;2998;17;203;3011;3656;433;82;101;890;9682;55;643;9776;11653;1216
FR;9;2022-10-06;23;35;400;4598;18;301;4631;5609;672;105;136;1290;14280;73;944;14407;17262;1888
FR;9;2022-10-07;29;50;499;5705;19;384;5719;7028;923;134;186;1789;19985;92;1328;20126;24290;2811
FR;9;2022-10-08;10;18;128;1090;8;86;1108;1389;191;144;204;1917;21075;100;1414;21234;25679;3002
FR;9;2022-10-09;1;7;22;197;1;29;198;277;50;145;211;1939;21272;101;1443;21432;25956;3052
FR;9;2022-10-10;11;26;207;2572;14;181;2576;3296;533;156;237;2146;23844;115;1624;24008;29252;3585
FR;9;2022-10-11;31;40;424;5043;27;312;5024;6197;851;187;277;2570;28887;142;1936;29032;35449;4436
FR;9;2022-10-12;22;26;297;2987;16;212;3044;3830;572;209;303;2867;31874;158;2148;32076;39279;5008
FR;9;2022-10-13;25;42;374;3980;16;245;4036;5027;740;234;345;3241;35854;174;2393;36112;44306;5748
FR;9;2022-10-14;27;26;381;4430;12;293;4414;5556;838;261;371;3622;40284;186;2686;40526;49862;6586
FR;9;2022-10-15;14;8;101;1052;7;79;1029;1308;198;275;379;3723;41336;193;2765;41555;51170;6784
FR;9;2022-10-16;4;1;9;132;2;12;126;168;28;279;380;3732;41468;195;2777;41681;51338;6812
FR;9;2022-10-17;4;22;165;1875;11;127;1883;2492;475;283;402;3897;43343;206;2904;43564;53830;7287
FR;9;2022-10-18;36;29;317;3430;17;237;3454;4663;963;319;431;4214;46773;223;3141;47018;58493;8250
FR;9;2022-10-19;22;19;262;2688;17;174;2717;3732;826;341;450;4476;49461;240;3315;49735;62225;9076
FR;9;2022-10-20;22;22;308;3628;8;233;3639;4813;933;363;472;4784;53089;248;3548;53374;67038;10009
FR;9;2022-10-21;14;32;327;3548;11;228;3554;4655;865;377;504;5111;56637;259;3776;56928;71693;10874
FR;9;2022-10-22;10;11;90;914;8;62;919;1193;207;387;515;5201;57551;267;3838;57847;72886;11081
FR;9;2022-10-23;2;2;17;100;2;10;105;148;33;389;517;5218;57651;269;3848;57952;73034;11114
FR;9;2022-10-24;7;17;159;1363;6;106;1434;1942;397;396;534;5377;59014;275;3954;59386;74976;11511
FR;9;2022-10-25;18;22;228;2841;16;188;2851;3938;896;414;556;5605;61855;291;4142;62237;78914;12407
FR;9;2022-10-26;14;16;169;1800;13;123;1812;2527;590;428;572;5774;63655;304;4265;64049;81441;12997
FR;9;2022-10-27;9;26;230;2303;15;173;2337;3210;689;437;598;6004;65958;319;4438;66386;84651;13686
FR;9;2022-10-28;18;27;224;2277;17;151;2303;3142;681;455;625;6228;68235;336;4589;68689;87793;14367
FR;9;2022-10-29;12;8;55;505;5;46;496;662;119;467;633;6283;68740;341;4635;69185;88455;14486
FR;9;2022-10-30;2;1;8;58;1;8;58;82;16;469;634;6291;68798;342;4643;69243;88537;14502
FR;9;2022-10-31;13;7;105;660;9;59;695;996;240;482;641;6396;69458;351;4702;69938;89533;14742
FR;9;2022-11-01;1;1;15;43;0;11;49;71;11;483;642;6411;69501;351;4713;69987;89604;14753
FR;9;2022-11-02;7;12;102;1027;4;76;1045;1577;452;490;654;6513;70528;355;4789;71032;91181;15205
FR;9;2022-11-03;17;18;157;1599;16;92;1647;2348;599;507;672;6670;72127;371;4881;72679;93529;15804
FR;9;2022-11-04;21;19;193;1751;15;120;1800;2536;611;528;691;6863;73878;386;5001;74479;96065;16415
FR;9;2022-11-05;8;10;58;403;9;39;424;573;107;536;701;6921;74281;395;5040;74903;96638;16522
FR;9;2022-11-06;5;4;5;62;6;2;61;88;25;541;705;6926;74343;401;5042;74964;96726;16547
FR;9;2022-11-07;16;19;89;942;16;110;941;1489;432;557;724;7015;75285;417;5152;75905;98215;16979
FR;9;2022-11-08;11;19;171;1827;13;137;1815;2660;703;568;743;7186;77112;430;5289;77720;100875;17682
FR;9;2022-11-09;16;16;123;1261;9;98;1322;1878;453;584;759;7309;78373;439;5387;79042;102753;18135
FR;9;2022-11-10;13;22;162;1622;14;137;1620;2280;519;597;781;7471;79995;453;5524;80662;105033;18654
FR;9;2022-11-11;1;1;13;81;1;6;83;124;35;598;782;7484;80076;454;5530;80745;105157;18689
FR;9;2022-11-12;5;8;44;259;7;19;278;395;97;603;790;7528;80335;461;5549;81023;105552;18786
FR;9;2022-11-13;2;0;4;30;0;4;31;51;16;605;790;7532;80365;461;5553;81054;105603;18802
FR;9;2022-11-14;11;12;56;713;11;44;722;1108;339;616;802;7588;81078;472;5597;81776;106711;19141
FR;9;2022-11-15;18;16;150;1346;7;103;1356;2103;638;634;818;7738;82424;479;5700;83132;108814;19779
FR;9;2022-11-16;10;5;99;979;8;58;997;1490;431;644;823;7837;83403;487;5758;84129;110304;20210
FR;9;2022-11-17;9;17;126;1086;11;78;1111;1695;501;653;840;7963;84489;498;5836;85240;111999;20711
FR;9;2022-11-18;7;16;120;1440;5;78;1455;2027;492;660;856;8083;85929;503;5914;86695;114026;21203
FR;9;2022-11-19;3;5;50;364;1;27;351;489;106;663;861;8133;86293;504;5941;87046;114515;21309
FR;9;2022-11-20;1;0;5;37;0;3;35;54;16;664;861;8138;86330;504;5944;87081;114569;21325
FR;9;2022-11-21;9;12;66;636;5;51;639;960;263;673;873;8204;86966;509;5995;87720;115529;21588
FR;9;2022-11-22;15;12;121;1037;13;74;1067;1592;449;688;885;8325;88003;522;6069;88787;117121;22037
FR;9;2022-11-23;7;10;69;733;5;33;760;1170;372;695;895;8394;88736;527;6102;89547;118291;22409
FR;9;2022-11-24;8;19;93;979;14;68;992;1472;406;703;914;8487;89715;541;6170;90539;119763;22815
FR;9;2022-11-25;8;10;107;1180;8;82;1195;1781;503;711;924;8594;90895;549;6252;91734;121544;23318
FR;9;2022-11-26;6;6;35;217;7;24;214;310;68;717;930;8629;91112;556;6276;91948;121854;23386
FR;9;2022-11-27;1;1;6;42;0;2;46;82;34;718;931;8635;91154;556;6278;91994;121936;23420
FR;9;2022-11-28;5;7;103;698;7;60;726;1135;344;723;938;8738;91852;563;6338;92720;123071;23764
FR;9;2022-11-29;6;18;142;1299;6;89;1327;1942;521;729;956;8880;93151;569;6427;94047;125013;24285
FR;9;2022-11-30;9;12;99;1032;5;76;1055;1606;470;738;968;8979;94183;574;6503;95102;126619;24755
FR;9;2022-12-01;16;14;111;1330;8;80;1315;1939;540;754;982;9090;95513;582;6583;96417;128558;25295
FR;9;2022-12-02;10;13;193;1817;10;107;1818;2631;700;764;995;9283;97330;592;6690;98235;131189;25995
FR;9;2022-12-03;7;9;79;619;5;41;632;887;208;771;1004;9362;97949;597;6731;98867;132076;26203
FR;9;2022-12-04;11;4;15;105;5;8;105;153;40;782;1008;9377;98054;602;6739;98972;132229;26243
FR;9;2022-12-05;19;24;144;1406;17;98;1421;2110;584;801;1032;9521;99460;619;6837;100393;134339;26827
FR;9;2022-12-06;30;21;264;2453;21;148;2548;3812;1097;831;1053;9785;101913;640;6985;102941;138151;27924
FR;9;2022-12-07;15;22;181;1848;20;112;1890;2825;814;846;1075;9966;103761;660;7097;104831;140976;28738
FR;9;2022-12-08;14;22;222;2404;15;125;2467;3701;1092;860;1097;10188;106165;675;7222;107298;144677;29830
FR;9;2022-12-09;14;25;287;2888;10;143;2986;4337;1200;874;1122;10475;109053;685;7365;110284;149014;31030
FR;9;2022-12-10;12;13;122;1324;5;56;1347;1819;410;886;1135;10597;110377;690;7421;111631;150833;31440
FR;9;2022-12-11;5;5;21;277;6;10;283;363;66;891;1140;10618;110654;696;7431;111914;151196;31506
FR;9;2022-12-12;17;14;215;1958;12;109;2032;2891;745;908;1154;10833;112612;708;7540;113946;154087;32251
FR;9;2022-12-13;28;23;317;3085;15;151;3221;4720;1337;936;1177;11150;115697;723;7691;117167;158807;33588
FR;9;2022-12-14;15;10;191;2335;8;94;2405;3505;989;951;1187;11341;118032;731;7785;119572;162312;34577
FR;9;2022-12-15;17;24;257;2611;13;138;2682;4069;1238;968;1211;11598;120643;744;7923;122254;166381;35815
FR;9;2022-12-16;15;29;294;3072;21;165;3155;4603;1274;983;1240;11892;123715;765;8088;125409;170984;37089
FR;9;2022-12-17;8;11;106;1192;6;50;1207;1663;402;991;1251;11998;124907;771;8138;126616;172647;37491
FR;9;2022-12-18;1;7;30;245;6;14;251;333;67;992;1258;12028;125152;777;8152;126867;172980;37558
FR;9;2022-12-19;20;21;149;1599;15;78;1631;2507;789;1012;1279;12177;126751;792;8230;128498;175487;38347
FR;9;2022-12-20;21;19;232;2306;6;115;2349;3708;1233;1033;1298;12409;129057;798;8345;130847;179195;39580
FR;9;2022-12-21;6;14;139;1501;7;66;1554;2402;775;1039;1312;12548;130558;805;8411;132401;181597;40355
FR;9;2022-12-22;18;9;136;1401;9;78;1418;2119;615;1057;1321;12684;131959;814;8489;133819;183716;40970
FR;9;2022-12-23;11;15;76;728;9;50;730;1091;305;1068;1336;12760;132687;823;8539;134549;184807;41275
FR;9;2022-12-24;1;5;13;96;4;6;98;138;34;1069;1341;12773;132783;827;8545;134647;184945;41309
FR;9;2022-12-25;1;0;5;5;0;4;6;12;2;1070;1341;12778;132788;827;8549;134653;184957;41311
FR;9;2022-12-26;17;8;64;547;11;37;554;829;235;1087;1349;12842;133335;838;8586;135207;185786;41546
FR;9;2022-12-27;12;30;97;882;14;69;917;1422;430;1099;1379;12939;134217;852;8655;136124;187208;41976
FR;9;2022-12-28;8;9;82;749;8;40;768;1185;372;1107;1388;13021;134966;860;8695;136892;188393;42348
FR;9;2022-12-29;9;14;92;720;10;51;753;1134;323;1116;1402;13113;135686;870;8746;137645;189527;42671
FR;9;2022-12-30;12;17;77;592;9;47;612;899;237;1128;1419;13190;136278;879;8793;138257;190426;42908
FR;9;2022-12-31;2;3;17;136;2;12;139;190;38;1130;1422;13207;136414;881;8805;138396;190616;42946
FR;9;2023-01-01;0;2;3;19;1;4;19;31;8;1130;1424;13210;136433;882;8809;138415;190647;42954
FR;9;2023-01-02;11;11;56;592;4;40;585;949;320;1141;1435;13266;137025;886;8849;139000;191596;43274
FR;9;2023-01-03;19;19;121;1079;19;74;1101;1939;749;1160;1454;13387;138104;905;8923;140101;193535;44023
FR;9;2023-01-04;21;18;113;846;8;73;898;1609;633;1181;1472;13500;138950;913;8996;140999;195144;44656
FR;9;2023-01-05;5;20;115;1059;11;65;1091;2048;882;1186;1492;13615;140009;924;9061;142090;197192;45538
FR;9;2023-01-06;11;17;152;1370;3;73;1388;2410;938;1197;1509;13767;141379;927;9134;143478;199602;46476
FR;9;2023-01-07;6;13;58;436;14;36;427;687;220;1203;1522;13825;141815;941;9170;143905;200289;46696
FR;9;2023-01-08;4;11;15;92;9;12;91;137;32;1207;1533;13840;141907;950;9182;143996;200426;46728
FR;9;2023-01-09;16;15;87;623;9;62;615;1275;585;1223;1548;13927;142530;959;9244;144611;201701;47313
FR;9;2023-01-10;13;12;154;979;11;74;1033;1990;871;1236;1560;14081;143509;970;9318;145644;203691;48184
FR;9;2023-01-11;19;9;74;680;10;49;689;1386;642;1255;1569;14155;144189;980;9367;146333;205077;48826
FR;9;2023-01-12;20;9;92;845;3;77;823;1688;775;1275;1578;14247;145034;983;9444;147156;206765;49601
FR;9;2023-01-13;15;19;105;881;12;73;901;1742;753;1290;1597;14352;145915;995;9517;148057;208507;50354
FR;9;2023-01-14;8;9;55;294;5;33;299;585;247;1298;1606;14407;146209;1000;9550;148356;209092;50601
FR;9;2023-01-15;1;3;15;37;0;9;41;82;32;1299;1609;14422;146246;1000;9559;148397;209174;50633
FR;9;2023-01-16;6;15;54;366;13;24;383;785;371;1305;1624;14476;146612;1013;9583;148780;209959;51004
FR;9;2023-01-17;7;9;83;563;4;49;577;1244;609;1312;1633;14559;147175;1017;9632;149357;211203;51613
FR;9;2023-01-18;8;14;37;380;6;32;397;834;398;1320;1647;14596;147555;1023;9664;149754;212037;52011
FR;9;2023-01-19;10;9;58;476;8;30;477;1079;562;1330;1656;14654;148031;1031;9694;150231;213116;52573
FR;9;2023-01-20;15;19;96;578;16;57;595;1190;534;1345;1675;14750;148609;1047;9751;150826;214306;53107
FR;9;2023-01-21;8;15;20;192;11;13;190;347;140;1353;1690;14770;148801;1058;9764;151016;214653;53247
FR;9;2023-01-22;0;0;8;20;0;5;21;42;16;1353;1690;14778;148821;1058;9769;151037;214695;53263
FR;9;2023-01-23;4;15;27;253;9;25;242;563;287;1357;1705;14805;149074;1067;9794;151279;215258;53550
FR;9;2023-01-24;11;10;70;461;9;42;484;1162;633;1368;1715;14875;149535;1076;9836;151763;216420;54183
FR;9;2023-01-25;11;20;50;325;8;48;336;799;410;1379;1735;14925;149860;1084;9884;152099;217219;54593
FR;9;2023-01-26;7;17;64;391;8;50;390;967;515;1386;1752;14989;150251;1092;9934;152489;218186;55108
FR;9;2023-01-27;4;7;59;381;3;31;397;906;462;1390;1759;15048;150632;1095;9965;152886;219092;55570
FR;9;2023-01-28;3;6;31;128;5;27;120;265;116;1393;1765;15079;150760;1100;9992;153006;219357;55686
FR;9;2023-01-29;3;0;3;18;2;1;17;40;22;1396;1765;15082;150778;1102;9993;153023;219397;55708
FR;9;2023-01-30;3;6;31;192;5;11;211;501;272;1399;1771;15113;150970;1107;10004;153234;219898;55980
FR;9;2023-01-31;14;7;38;260;9;18;264;649;359;1413;1778;15151;151230;1116;10022;153498;220547;56339
FR;9;2023-02-01;4;7;26;173;4;20;179;519;309;1417;1785;15177;151403;1120;10042;153677;221066;56648
FR;9;2023-02-02;4;6;31;252;6;23;233;665;394;1421;1791;15208;151655;1126;10065;153910;221731;57042
FR;9;2023-02-03;8;11;42;289;8;37;275;677;355;1429;1802;15250;151944;1134;10102;154185;222408;57397
FR;9;2023-02-04;6;5;10;70;7;8;68;160;84;1435;1807;15260;152014;1141;10110;154253;222568;57481
FR;9;2023-02-05;1;1;4;7;0;4;7;17;6;1436;1808;15264;152021;1141;10114;154260;222585;57487
FR;9;2023-02-06;3;5;17;81;4;15;78;229;134;1439;1813;15281;152102;1145;10129;154338;222814;57621
FR;9;2023-02-07;3;5;29;139;3;20;134;402;242;1442;1818;15310;152241;1148;10149;154472;223216;57863
FR;9;2023-02-08;4;6;25;116;3;13;125;301;160;1446;1824;15335;152357;1151;10162;154597;223517;58023
FR;9;2023-02-09;8;2;20;138;3;14;123;336;195;1454;1826;15355;152495;1154;10176;154720;223853;58218
FR;9;2023-02-10;8;8;19;149;10;11;145;309;147;1462;1834;15374;152644;1164;10187;154865;224162;58365
FR;9;2023-02-11;5;4;14;42;3;9;47;84;28;1467;1838;15388;152686;1167;10196;154912;224246;58393
FR;9;2023-02-12;0;0;0;1;0;0;1;8;7;1467;1838;15388;152687;1167;10196;154913;224254;58400
FR;9;2023-02-13;3;8;5;50;8;4;45;107;55;1470;1846;15393;152737;1175;10200;154958;224361;58455
FR;9;2023-02-14;10;10;16;66;12;13;63;225;146;1480;1856;15409;152803;1187;10213;155021;224586;58601
FR;9;2023-02-15;1;5;16;52;3;12;50;162;99;1481;1861;15425;152855;1190;10225;155071;224748;58700
FR;9;2023-02-16;4;6;19;77;1;17;78;197;93;1485;1867;15444;152932;1191;10242;155149;224945;58793
FR;9;2023-02-17;6;4;15;62;5;11;64;178;99;1491;1871;15459;152994;1196;10253;155213;225123;58892
FR;9;2023-02-18;1;5;1;30;5;3;25;58;29;1492;1876;15460;153024;1201;10256;155238;225181;58921
FR;9;2023-02-19;1;0;0;1;0;0;1;3;2;1493;1876;15460;153025;1201;10256;155239;225184;58923
FR;9;2023-02-20;2;3;9;60;2;6;60;123;55;1495;1879;15469;153085;1203;10262;155299;225307;58978
FR;9;2023-02-21;6;9;9;62;7;8;59;151;82;1501;1888;15478;153147;1210;10270;155358;225458;59060
FR;9;2023-02-22;2;4;17;69;3;13;68;201;113;1503;1892;15495;153216;1213;10283;155426;225659;59173
FR;9;2023-02-23;5;3;17;63;1;12;69;146;61;1508;1895;15512;153279;1214;10295;155495;225805;59234
FR;9;2023-02-24;6;4;13;80;5;8;83;211;114;1514;1899;15525;153359;1219;10303;155578;226016;59348
FR;9;2023-02-25;2;2;10;14;4;4;23;43;16;1516;1901;15535;153373;1223;10307;155601;226059;59364
FR;9;2023-02-26;3;1;0;4;3;1;4;5;0;1519;1902;15535;153377;1226;10308;155605;226064;59364
FR;9;2023-02-27;2;3;5;17;3;2;19;49;26;1521;1905;15540;153394;1229;10310;155624;226113;59390
FR;9;2023-02-28;7;13;18;55;11;16;58;155;76;1528;1918;15558;153449;1240;10326;155682;226268;59466
FR;9;2023-03-01;0;6;4;20;5;4;20;75;48;1528;1924;15562;153469;1245;10330;155702;226343;59514
FR;9;2023-03-02;0;1;7;31;1;2;36;80;41;1528;1925;15569;153500;1246;10332;155738;226423;59555
FR;9;2023-03-03;1;4;9;47;3;6;49;122;67;1529;1929;15578;153547;1249;10338;155787;226545;59622
FR;9;2023-03-04;1;2;7;19;1;4;25;41;10;1530;1931;15585;153566;1250;10342;155812;226586;59632
FR;9;2023-03-05;0;1;1;0;1;0;1;8;7;1530;1932;15586;153566;1251;10342;155813;226594;59639
FR;9;2023-03-06;1;6;6;8;3;6;9;35;19;1531;1938;15592;153574;1254;10348;155822;226629;59658
FR;9;2023-03-07;2;3;8;20;0;8;24;68;34;1533;1941;15600;153594;1254;10356;155846;226697;59692
FR;9;2023-03-08;2;4;10;6;4;4;13;39;20;1535;1945;15610;153600;1258;10360;155859;226736;59712
FR;9;2023-03-09;1;3;9;12;2;6;17;65;42;1536;1948;15619;153612;1260;10366;155876;226801;59754
FR;9;2023-03-10;3;3;6;20;2;4;19;58;34;1539;1951;15625;153632;1262;10370;155895;226859;59788
FR;9;2023-03-11;2;3;4;8;2;1;11;15;3;1541;1954;15629;153640;1264;10371;155906;226874;59791
FR;9;2023-03-12;0;0;0;0;0;0;0;0;0;1541;1954;15629;153640;1264;10371;155906;226874;59791
FR;9;2023-03-13;3;5;9;34;3;4;14;49;29;1544;1959;15638;153674;1267;10375;155920;226923;59820
FR;9;2023-03-14;3;3;7;27;1;6;29;79;41;1547;1962;15645;153701;1268;10381;155949;227002;59861
FR;9;2023-03-15;0;5;4;15;3;4;17;47;24;1547;1967;15649;153716;1271;10385;155966;227049;59885
FR;9;2023-03-16;0;9;7;15;5;8;15;77;52;1547;1976;15656;153731;1276;10393;155981;227126;59937
FR;9;2023-03-17;0;7;4;19;3;7;17;62;31;1547;1983;15660;153750;1279;10400;155998;227188;59968
FR;9;2023-03-18;2;2;5;13;1;4;16;48;26;1549;1985;15665;153763;1280;10404;156014;227236;59994
FR;9;2023-03-19;0;1;0;0;1;0;0;0;0;1549;1986;15665;153763;1281;10404;156014;227236;59994
FR;9;2023-03-20;3;5;1;6;4;1;7;18;10;1552;1991;15666;153769;1285;10405;156021;227254;60004
FR;9;2023-03-21;1;1;6;16;1;1;21;69;47;1553;1992;15672;153785;1286;10406;156042;227323;60051
FR;9;2023-03-22;1;2;4;19;2;2;22;78;49;1554;1994;15676;153804;1288;10408;156064;227401;60100
FR;9;2023-03-23;0;6;7;22;4;7;21;56;25;1554;2000;15683;153826;1292;10415;156085;227457;60125
FR;9;2023-03-24;2;2;5;21;2;5;23;49;18;1556;2002;15688;153847;1294;10420;156108;227506;60143
FR;9;2023-03-25;0;0;4;6;0;3;8;16;5;1556;2002;15692;153853;1294;10423;156116;227522;60148
FR;9;2023-03-26;0;1;0;0;0;1;0;2;1;1556;2003;15692;153853;1294;10424;156116;227524;60149
FR;9;2023-03-27;0;3;4;8;2;2;12;32;15;1556;2006;15696;153861;1296;10426;156128;227556;60164
FR;9;2023-03-28;4;11;5;14;11;5;12;42;21;1560;2017;15701;153875;1307;10431;156140;227598;60185
FR;9;2023-03-29;3;6;8;5;2;8;8;28;12;1563;2023;15709;153880;1309;10439;156148;227626;60197
FR;10;2020-12-27;0;0;0;0;0;0;0;0;0;0;0;0;0;0;0;0;0;0
FR;10;2020-12-28;0;0;0;0;0;0;0;0;0;0;0;0;0;0;0;0;0;0
FR;10;2020-12-29;0;0;0;0;0;0;0;0;0;0;0;0;0;0;0;0;0;0
FR;10;2020-12-30;0;0;0;0;0;0;0;0;0;0;0;0;0;0;0;0;0;0
FR;10;2020-12-31;0;0;0;0;0;0;0;0;0;0;0;0;0;0;0;0;0;0
FR;10;2021-01-01;0;0;0;0;0;0;0;0;0;0;0;0;0;0;0;0;0;0
FR;10;2021-01-02;0;0;0;0;0;0;0;0;0;0;0;0;0;0;0;0;0;0
FR;10;2021-01-03;0;0;0;0;0;0;0;0;0;0;0;0;0;0;0;0;0;0
FR;10;2021-01-04;0;0;0;0;0;0;0;0;0;0;0;0;0;0;0;0;0;0
FR;10;2021-01-05;0;0;0;0;0;0;0;0;0;0;0;0;0;0;0;0;0;0
FR;10;2021-01-06;0;0;0;0;0;0;0;0;0;0;0;0;0;0;0;0;0;0
FR;10;2021-01-07;0;0;0;0;0;0;0;0;0;0;0;0;0;0;0;0;0;0
FR;10;2021-01-08;0;0;0;0;0;0;0;0;0;0;0;0;0;0;0;0;0;0
FR;10;2021-01-09;0;0;0;0;0;0;0;0;0;0;0;0;0;0;0;0;0;0
FR;10;2021-01-10;0;0;0;0;0;0;0;0;0;0;0;0;0;0;0;0;0;0
FR;10;2021-01-11;0;0;0;0;0;0;0;0;0;0;0;0;0;0;0;0;0;0
FR;10;2021-01-12;0;0;0;0;0;0;0;0;0;0;0;0;0;0;0;0;0;0
FR;10;2021-01-13;0;0;0;0;0;0;0;0;0;0;0;0;0;0;0;0;0;0
FR;10;2021-01-14;0;0;0;0;0;0;0;0;0;0;0;0;0;0;0;0;0;0
FR;10;2021-01-15;0;0;0;0;0;0;0;0;0;0;0;0;0;0;0;0;0;0
FR;10;2021-01-16;0;0;0;0;0;0;0;0;0;0;0;0;0;0;0;0;0;0
FR;10;2021-01-17;0;0;0;0;0;0;0;0;0;0;0;0;0;0;0;0;0;0
FR;10;2021-01-18;0;0;0;0;0;0;0;0;0;0;0;0;0;0;0;0;0;0
FR;10;2021-01-19;0;0;0;0;0;0;0;0;0;0;0;0;0;0;0;0;0;0
FR;10;2021-01-20;0;0;0;0;0;0;0;0;0;0;0;0;0;0;0;0;0;0
FR;10;2021-01-21;0;0;0;0;0;0;0;0;0;0;0;0;0;0;0;0;0;0
FR;10;2021-01-22;0;0;0;0;0;0;0;0;0;0;0;0;0;0;0;0;0;0
FR;10;2021-01-23;0;0;0;0;0;0;0;0;0;0;0;0;0;0;0;0;0;0
FR;10;2021-01-24;0;0;0;0;0;0;0;0;0;0;0;0;0;0;0;0;0;0
FR;10;2021-01-25;0;0;0;0;0;0;0;0;0;0;0;0;0;0;0;0;0;0
FR;10;2021-01-26;0;0;0;0;0;0;0;0;0;0;0;0;0;0;0;0;0;0
FR;10;2021-01-27;0;0;0;0;0;0;0;0;0;0;0;0;0;0;0;0;0;0
FR;10;2021-01-28;0;0;0;0;0;0;0;0;0;0;0;0;0;0;0;0;0;0
FR;10;2021-01-29;0;0;0;0;0;0;0;0;0;0;0;0;0;0;0;0;0;0
FR;10;2021-01-30;0;0;0;0;0;0;0;0;0;0;0;0;0;0;0;0;0;0
FR;10;2021-01-31;0;0;0;0;0;0;0;0;0;0;0;0;0;0;0;0;0;0
FR;10;2021-02-01;0;0;0;0;0;0;0;0;0;0;0;0;0;0;0;0;0;0
FR;10;2021-02-02;0;0;0;0;0;0;0;0;0;0;0;0;0;0;0;0;0;0
FR;10;2021-02-03;0;0;0;0;0;0;0;0;0;0;0;0;0;0;0;0;0;0
FR;10;2021-02-04;0;0;0;0;0;0;0;0;0;0;0;0;0;0;0;0;0;0
FR;10;2021-02-05;0;0;0;0;0;0;0;0;0;0;0;0;0;0;0;0;0;0
FR;10;2021-02-06;0;0;0;0;0;0;0;0;0;0;0;0;0;0;0;0;0;0
FR;10;2021-02-07;0;0;0;0;0;0;0;0;0;0;0;0;0;0;0;0;0;0
FR;10;2021-02-08;0;0;0;0;0;0;0;0;0;0;0;0;0;0;0;0;0;0
FR;10;2021-02-09;0;0;0;0;0;0;0;0;0;0;0;0;0;0;0;0;0;0
FR;10;2021-02-10;0;0;0;0;0;0;0;0;0;0;0;0;0;0;0;0;0;0
FR;10;2021-02-11;0;0;0;0;0;0;0;0;0;0;0;0;0;0;0;0;0;0
FR;10;2021-02-12;0;0;0;0;0;0;0;0;0;0;0;0;0;0;0;0;0;0
FR;10;2021-02-13;0;0;0;0;0;0;0;0;0;0;0;0;0;0;0;0;0;0
FR;10;2021-02-14;0;0;0;0;0;0;0;0;0;0;0;0;0;0;0;0;0;0
FR;10;2021-02-15;0;0;0;0;0;0;0;0;0;0;0;0;0;0;0;0;0;0
FR;10;2021-02-16;0;0;0;0;0;0;0;0;0;0;0;0;0;0;0;0;0;0
FR;10;2021-02-17;0;0;0;0;0;0;0;0;0;0;0;0;0;0;0;0;0;0
FR;10;2021-02-18;0;0;0;0;0;0;0;0;0;0;0;0;0;0;0;0;0;0
FR;10;2021-02-19;0;0;0;0;0;0;0;0;0;0;0;0;0;0;0;0;0;0
FR;10;2021-02-20;0;0;0;0;0;0;0;0;0;0;0;0;0;0;0;0;0;0
FR;10;2021-02-21;0;0;0;0;0;0;0;0;0;0;0;0;0;0;0;0;0;0
FR;10;2021-02-22;0;0;0;0;0;0;0;0;0;0;0;0;0;0;0;0;0;0
FR;10;2021-02-23;0;0;0;0;0;0;0;0;0;0;0;0;0;0;0;0;0;0
FR;10;2021-02-24;0;0;0;0;0;0;0;0;0;0;0;0;0;0;0;0;0;0
FR;10;2021-02-25;0;0;0;0;0;0;0;0;0;0;0;0;0;0;0;0;0;0
FR;10;2021-02-26;0;0;0;0;0;0;0;0;0;0;0;0;0;0;0;0;0;0
FR;10;2021-02-27;0;0;0;0;0;0;0;0;0;0;0;0;0;0;0;0;0;0
FR;10;2021-02-28;0;0;0;0;0;0;0;0;0;0;0;0;0;0;0;0;0;0
FR;10;2021-03-01;0;0;0;0;0;0;0;0;0;0;0;0;0;0;0;0;0;0
FR;10;2021-03-02;0;0;0;0;0;0;0;0;0;0;0;0;0;0;0;0;0;0
FR;10;2021-03-03;0;0;0;0;0;0;0;0;0;0;0;0;0;0;0;0;0;0
FR;10;2021-03-04;0;0;0;0;0;0;0;0;0;0;0;0;0;0;0;0;0;0
FR;10;2021-03-05;0;0;0;0;0;0;0;0;0;0;0;0;0;0;0;0;0;0
FR;10;2021-03-06;0;0;0;0;0;0;0;0;0;0;0;0;0;0;0;0;0;0
FR;10;2021-03-07;0;0;0;0;0;0;0;0;0;0;0;0;0;0;0;0;0;0
FR;10;2021-03-08;0;0;0;0;0;0;0;0;0;0;0;0;0;0;0;0;0;0
FR;10;2021-03-09;0;0;0;0;0;0;0;0;0;0;0;0;0;0;0;0;0;0
FR;10;2021-03-10;0;0;0;0;0;0;0;0;0;0;0;0;0;0;0;0;0;0
FR;10;2021-03-11;0;0;0;0;0;0;0;0;0;0;0;0;0;0;0;0;0;0
FR;10;2021-03-12;0;0;0;0;0;0;0;0;0;0;0;0;0;0;0;0;0;0
FR;10;2021-03-13;0;0;0;0;0;0;0;0;0;0;0;0;0;0;0;0;0;0
FR;10;2021-03-14;0;0;0;0;0;0;0;0;0;0;0;0;0;0;0;0;0;0
FR;10;2021-03-15;0;0;0;0;0;0;0;0;0;0;0;0;0;0;0;0;0;0
FR;10;2021-03-16;0;0;0;0;0;0;0;0;0;0;0;0;0;0;0;0;0;0
FR;10;2021-03-17;0;0;0;0;0;0;0;0;0;0;0;0;0;0;0;0;0;0
FR;10;2021-03-18;0;0;0;0;0;0;0;0;0;0;0;0;0;0;0;0;0;0
FR;10;2021-03-19;0;0;0;0;0;0;0;0;0;0;0;0;0;0;0;0;0;0
FR;10;2021-03-20;0;0;0;0;0;0;0;0;0;0;0;0;0;0;0;0;0;0
FR;10;2021-03-21;0;0;0;0;0;0;0;0;0;0;0;0;0;0;0;0;0;0
FR;10;2021-03-22;0;0;0;0;0;0;0;0;0;0;0;0;0;0;0;0;0;0
FR;10;2021-03-23;0;0;0;0;0;0;0;0;0;0;0;0;0;0;0;0;0;0
FR;10;2021-03-24;0;0;0;0;0;0;0;0;0;0;0;0;0;0;0;0;0;0
FR;10;2021-03-25;0;0;0;0;0;0;0;0;0;0;0;0;0;0;0;0;0;0
FR;10;2021-03-26;0;0;0;0;0;0;0;0;0;0;0;0;0;0;0;0;0;0
FR;10;2021-03-27;0;0;0;0;0;0;0;0;0;0;0;0;0;0;0;0;0;0
FR;10;2021-03-28;0;0;0;0;0;0;0;0;0;0;0;0;0;0;0;0;0;0
FR;10;2021-03-29;0;0;0;0;0;0;0;0;0;0;0;0;0;0;0;0;0;0
FR;10;2021-03-30;0;0;0;0;0;0;0;0;0;0;0;0;0;0;0;0;0;0
FR;10;2021-03-31;0;0;0;0;0;0;0;0;0;0;0;0;0;0;0;0;0;0
FR;10;2021-04-01;0;0;0;0;0;0;0;0;0;0;0;0;0;0;0;0;0;0
FR;10;2021-04-02;0;0;0;0;0;0;0;0;0;0;0;0;0;0;0;0;0;0
FR;10;2021-04-03;0;0;0;0;0;0;0;0;0;0;0;0;0;0;0;0;0;0
FR;10;2021-04-04;0;0;0;0;0;0;0;0;0;0;0;0;0;0;0;0;0;0
FR;10;2021-04-05;0;0;0;0;0;0;0;0;0;0;0;0;0;0;0;0;0;0
FR;10;2021-04-06;0;0;0;0;0;0;0;0;0;0;0;0;0;0;0;0;0;0
FR;10;2021-04-07;0;0;0;0;0;0;0;0;0;0;0;0;0;0;0;0;0;0
FR;10;2021-04-08;0;0;0;0;0;0;0;0;0;0;0;0;0;0;0;0;0;0
FR;10;2021-04-09;0;0;0;0;0;0;0;0;0;0;0;0;0;0;0;0;0;0
FR;10;2021-04-10;0;0;0;0;0;0;0;0;0;0;0;0;0;0;0;0;0;0
FR;10;2021-04-11;0;0;0;0;0;0;0;0;0;0;0;0;0;0;0;0;0;0
FR;10;2021-04-12;0;0;0;0;0;0;0;0;0;0;0;0;0;0;0;0;0;0
FR;10;2021-04-13;0;0;0;0;0;0;0;0;0;0;0;0;0;0;0;0;0;0
FR;10;2021-04-14;0;0;0;0;0;0;0;0;0;0;0;0;0;0;0;0;0;0
FR;10;2021-04-15;0;0;0;0;0;0;0;0;0;0;0;0;0;0;0;0;0;0
FR;10;2021-04-16;0;0;0;0;0;0;0;0;0;0;0;0;0;0;0;0;0;0
FR;10;2021-04-17;0;0;0;0;0;0;0;0;0;0;0;0;0;0;0;0;0;0
FR;10;2021-04-18;0;0;0;0;0;0;0;0;0;0;0;0;0;0;0;0;0;0
FR;10;2021-04-19;0;0;0;0;0;0;0;0;0;0;0;0;0;0;0;0;0;0
FR;10;2021-04-20;0;0;0;0;0;0;0;0;0;0;0;0;0;0;0;0;0;0
FR;10;2021-04-21;0;0;0;0;0;0;0;0;0;0;0;0;0;0;0;0;0;0
FR;10;2021-04-22;0;0;0;0;0;0;0;0;0;0;0;0;0;0;0;0;0;0
FR;10;2021-04-23;0;0;0;0;0;0;0;0;0;0;0;0;0;0;0;0;0;0
FR;10;2021-04-24;0;0;0;0;0;0;0;0;0;0;0;0;0;0;0;0;0;0
FR;10;2021-04-25;0;0;0;0;0;0;0;0;0;0;0;0;0;0;0;0;0;0
FR;10;2021-04-26;0;0;0;0;0;0;0;0;0;0;0;0;0;0;0;0;0;0
FR;10;2021-04-27;0;0;0;0;0;0;0;0;0;0;0;0;0;0;0;0;0;0
FR;10;2021-04-28;0;0;0;0;0;0;0;0;0;0;0;0;0;0;0;0;0;0
FR;10;2021-04-29;0;0;0;0;0;0;0;0;0;0;0;0;0;0;0;0;0;0
FR;10;2021-04-30;0;0;0;0;0;0;0;0;0;0;0;0;0;0;0;0;0;0
FR;10;2021-05-01;0;0;0;0;0;0;0;0;0;0;0;0;0;0;0;0;0;0
FR;10;2021-05-02;0;0;0;0;0;0;0;0;0;0;0;0;0;0;0;0;0;0
FR;10;2021-05-03;0;0;0;0;0;0;0;0;0;0;0;0;0;0;0;0;0;0
FR;10;2021-05-04;0;0;0;0;0;0;0;0;0;0;0;0;0;0;0;0;0;0
FR;10;2021-05-05;0;0;0;0;0;0;0;0;0;0;0;0;0;0;0;0;0;0
FR;10;2021-05-06;0;0;0;0;0;0;0;0;0;0;0;0;0;0;0;0;0;0
FR;10;2021-05-07;0;0;0;0;0;0;0;0;0;0;0;0;0;0;0;0;0;0
FR;10;2021-05-08;0;0;0;0;0;0;0;0;0;0;0;0;0;0;0;0;0;0
FR;10;2021-05-09;0;0;0;0;0;0;0;0;0;0;0;0;0;0;0;0;0;0
FR;10;2021-05-10;0;0;0;0;0;0;0;0;0;0;0;0;0;0;0;0;0;0
FR;10;2021-05-11;0;0;0;0;0;0;0;0;0;0;0;0;0;0;0;0;0;0
FR;10;2021-05-12;0;0;0;0;0;0;0;0;0;0;0;0;0;0;0;0;0;0
FR;10;2021-05-13;0;0;0;0;0;0;0;0;0;0;0;0;0;0;0;0;0;0
FR;10;2021-05-14;0;0;0;0;0;0;0;0;0;0;0;0;0;0;0;0;0;0
FR;10;2021-05-15;0;0;0;0;0;0;0;0;0;0;0;0;0;0;0;0;0;0
FR;10;2021-05-16;0;0;0;0;0;0;0;0;0;0;0;0;0;0;0;0;0;0
FR;10;2021-05-17;0;0;0;0;0;0;0;0;0;0;0;0;0;0;0;0;0;0
FR;10;2021-05-18;0;0;0;0;0;0;0;0;0;0;0;0;0;0;0;0;0;0
FR;10;2021-05-19;0;0;0;0;0;0;0;0;0;0;0;0;0;0;0;0;0;0
FR;10;2021-05-20;0;0;0;0;0;0;0;0;0;0;0;0;0;0;0;0;0;0
FR;10;2021-05-21;0;0;0;0;0;0;0;0;0;0;0;0;0;0;0;0;0;0
FR;10;2021-05-22;0;0;0;0;0;0;0;0;0;0;0;0;0;0;0;0;0;0
FR;10;2021-05-23;0;0;0;0;0;0;0;0;0;0;0;0;0;0;0;0;0;0
FR;10;2021-05-24;0;0;0;0;0;0;0;0;0;0;0;0;0;0;0;0;0;0
FR;10;2021-05-25;0;0;0;0;0;0;0;0;0;0;0;0;0;0;0;0;0;0
FR;10;2021-05-26;0;0;0;0;0;0;0;0;0;0;0;0;0;0;0;0;0;0
FR;10;2021-05-27;0;0;0;0;0;0;0;0;0;0;0;0;0;0;0;0;0;0
FR;10;2021-05-28;0;0;0;0;0;0;0;0;0;0;0;0;0;0;0;0;0;0
FR;10;2021-05-29;0;0;0;0;0;0;0;0;0;0;0;0;0;0;0;0;0;0
FR;10;2021-05-30;0;0;0;0;0;0;0;0;0;0;0;0;0;0;0;0;0;0
FR;10;2021-05-31;0;0;0;0;0;0;0;0;0;0;0;0;0;0;0;0;0;0
FR;10;2021-06-01;0;0;0;0;0;0;0;0;0;0;0;0;0;0;0;0;0;0
FR;10;2021-06-02;0;0;0;0;0;0;0;0;0;0;0;0;0;0;0;0;0;0
FR;10;2021-06-03;0;0;0;0;0;0;0;0;0;0;0;0;0;0;0;0;0;0
FR;10;2021-06-04;0;0;0;0;0;0;0;0;0;0;0;0;0;0;0;0;0;0
FR;10;2021-06-05;0;0;0;0;0;0;0;0;0;0;0;0;0;0;0;0;0;0
FR;10;2021-06-06;0;0;0;0;0;0;0;0;0;0;0;0;0;0;0;0;0;0
FR;10;2021-06-07;0;0;0;0;0;0;0;0;0;0;0;0;0;0;0;0;0;0
FR;10;2021-06-08;0;0;0;0;0;0;0;0;0;0;0;0;0;0;0;0;0;0
FR;10;2021-06-09;0;0;0;0;0;0;0;0;0;0;0;0;0;0;0;0;0;0
FR;10;2021-06-10;0;0;0;0;0;0;0;0;0;0;0;0;0;0;0;0;0;0
FR;10;2021-06-11;0;0;0;0;0;0;0;0;0;0;0;0;0;0;0;0;0;0
FR;10;2021-06-12;0;0;0;0;0;0;0;0;0;0;0;0;0;0;0;0;0;0
FR;10;2021-06-13;0;0;0;0;0;0;0;0;0;0;0;0;0;0;0;0;0;0
FR;10;2021-06-14;0;0;0;0;0;0;0;0;0;0;0;0;0;0;0;0;0;0
FR;10;2021-06-15;0;0;0;0;0;0;0;0;0;0;0;0;0;0;0;0;0;0
FR;10;2021-06-16;0;0;0;0;0;0;0;0;0;0;0;0;0;0;0;0;0;0
FR;10;2021-06-17;0;0;0;0;0;0;0;0;0;0;0;0;0;0;0;0;0;0
FR;10;2021-06-18;0;0;0;0;0;0;0;0;0;0;0;0;0;0;0;0;0;0
FR;10;2021-06-19;0;0;0;0;0;0;0;0;0;0;0;0;0;0;0;0;0;0
FR;10;2021-06-20;0;0;0;0;0;0;0;0;0;0;0;0;0;0;0;0;0;0
FR;10;2021-06-21;0;0;0;0;0;0;0;0;0;0;0;0;0;0;0;0;0;0
FR;10;2021-06-22;0;0;0;0;0;0;0;0;0;0;0;0;0;0;0;0;0;0
FR;10;2021-06-23;0;0;0;0;0;0;0;0;0;0;0;0;0;0;0;0;0;0
FR;10;2021-06-24;0;0;0;0;0;0;0;0;0;0;0;0;0;0;0;0;0;0
FR;10;2021-06-25;0;0;0;0;0;0;0;0;0;0;0;0;0;0;0;0;0;0
FR;10;2021-06-26;0;0;0;0;0;0;0;0;0;0;0;0;0;0;0;0;0;0
FR;10;2021-06-27;0;0;0;0;0;0;0;0;0;0;0;0;0;0;0;0;0;0
FR;10;2021-06-28;0;0;0;0;0;0;0;0;0;0;0;0;0;0;0;0;0;0
FR;10;2021-06-29;0;0;0;0;0;0;0;0;0;0;0;0;0;0;0;0;0;0
FR;10;2021-06-30;0;0;0;0;0;0;0;0;0;0;0;0;0;0;0;0;0;0
FR;10;2021-07-01;0;0;0;0;0;0;0;0;0;0;0;0;0;0;0;0;0;0
FR;10;2021-07-02;0;0;0;0;0;0;0;0;0;0;0;0;0;0;0;0;0;0
FR;10;2021-07-03;0;0;0;0;0;0;0;0;0;0;0;0;0;0;0;0;0;0
FR;10;2021-07-04;0;0;0;0;0;0;0;0;0;0;0;0;0;0;0;0;0;0
FR;10;2021-07-05;0;0;0;0;0;0;0;0;0;0;0;0;0;0;0;0;0;0
FR;10;2021-07-06;0;0;0;0;0;0;0;0;0;0;0;0;0;0;0;0;0;0
FR;10;2021-07-07;0;0;0;0;0;0;0;0;0;0;0;0;0;0;0;0;0;0
FR;10;2021-07-08;0;0;0;0;0;0;0;0;0;0;0;0;0;0;0;0;0;0
FR;10;2021-07-09;0;0;0;0;0;0;0;0;0;0;0;0;0;0;0;0;0;0
FR;10;2021-07-10;0;0;0;0;0;0;0;0;0;0;0;0;0;0;0;0;0;0
FR;10;2021-07-11;0;0;0;0;0;0;0;0;0;0;0;0;0;0;0;0;0;0
FR;10;2021-07-12;0;0;0;0;0;0;0;0;0;0;0;0;0;0;0;0;0;0
FR;10;2021-07-13;0;0;0;0;0;0;0;0;0;0;0;0;0;0;0;0;0;0
FR;10;2021-07-14;0;0;0;0;0;0;0;0;0;0;0;0;0;0;0;0;0;0
FR;10;2021-07-15;0;0;0;0;0;0;0;0;0;0;0;0;0;0;0;0;0;0
FR;10;2021-07-16;0;0;0;0;0;0;0;0;0;0;0;0;0;0;0;0;0;0
FR;10;2021-07-17;0;0;0;0;0;0;0;0;0;0;0;0;0;0;0;0;0;0
FR;10;2021-07-18;0;0;0;0;0;0;0;0;0;0;0;0;0;0;0;0;0;0
FR;10;2021-07-19;0;0;0;0;0;0;0;0;0;0;0;0;0;0;0;0;0;0
FR;10;2021-07-20;0;0;0;0;0;0;0;0;0;0;0;0;0;0;0;0;0;0
FR;10;2021-07-21;0;0;0;0;0;0;0;0;0;0;0;0;0;0;0;0;0;0
FR;10;2021-07-22;0;0;0;0;0;0;0;0;0;0;0;0;0;0;0;0;0;0
FR;10;2021-07-23;0;0;0;0;0;0;0;0;0;0;0;0;0;0;0;0;0;0
FR;10;2021-07-24;0;0;0;0;0;0;0;0;0;0;0;0;0;0;0;0;0;0
FR;10;2021-07-25;0;0;0;0;0;0;0;0;0;0;0;0;0;0;0;0;0;0
FR;10;2021-07-26;0;0;0;0;0;0;0;0;0;0;0;0;0;0;0;0;0;0
FR;10;2021-07-27;0;0;0;0;0;0;0;0;0;0;0;0;0;0;0;0;0;0
FR;10;2021-07-28;0;0;0;0;0;0;0;0;0;0;0;0;0;0;0;0;0;0
FR;10;2021-07-29;0;0;0;0;0;0;0;0;0;0;0;0;0;0;0;0;0;0
FR;10;2021-07-30;0;0;0;0;0;0;0;0;0;0;0;0;0;0;0;0;0;0
FR;10;2021-07-31;0;0;0;0;0;0;0;0;0;0;0;0;0;0;0;0;0;0
FR;10;2021-08-01;0;0;0;0;0;0;0;0;0;0;0;0;0;0;0;0;0;0
FR;10;2021-08-02;0;0;0;0;0;0;0;0;0;0;0;0;0;0;0;0;0;0
FR;10;2021-08-03;0;0;0;0;0;0;0;0;0;0;0;0;0;0;0;0;0;0
FR;10;2021-08-04;0;0;0;0;0;0;0;0;0;0;0;0;0;0;0;0;0;0
FR;10;2021-08-05;0;0;0;0;0;0;0;0;0;0;0;0;0;0;0;0;0;0
FR;10;2021-08-06;0;0;0;0;0;0;0;0;0;0;0;0;0;0;0;0;0;0
FR;10;2021-08-07;0;0;0;0;0;0;0;0;0;0;0;0;0;0;0;0;0;0
FR;10;2021-08-08;0;0;0;0;0;0;0;0;0;0;0;0;0;0;0;0;0;0
FR;10;2021-08-09;0;0;0;0;0;0;0;0;0;0;0;0;0;0;0;0;0;0
FR;10;2021-08-10;0;0;0;0;0;0;0;0;0;0;0;0;0;0;0;0;0;0
FR;10;2021-08-11;0;0;0;0;0;0;0;0;0;0;0;0;0;0;0;0;0;0
FR;10;2021-08-12;0;0;0;0;0;0;0;0;0;0;0;0;0;0;0;0;0;0
FR;10;2021-08-13;0;0;0;0;0;0;0;0;0;0;0;0;0;0;0;0;0;0
FR;10;2021-08-14;0;0;0;0;0;0;0;0;0;0;0;0;0;0;0;0;0;0
FR;10;2021-08-15;0;0;0;0;0;0;0;0;0;0;0;0;0;0;0;0;0;0
FR;10;2021-08-16;0;0;0;0;0;0;0;0;0;0;0;0;0;0;0;0;0;0
FR;10;2021-08-17;0;0;0;0;0;0;0;0;0;0;0;0;0;0;0;0;0;0
FR;10;2021-08-18;0;0;0;0;0;0;0;0;0;0;0;0;0;0;0;0;0;0
FR;10;2021-08-19;0;0;0;0;0;0;0;0;0;0;0;0;0;0;0;0;0;0
FR;10;2021-08-20;0;0;0;0;0;0;0;0;0;0;0;0;0;0;0;0;0;0
FR;10;2021-08-21;0;0;0;0;0;0;0;0;0;0;0;0;0;0;0;0;0;0
FR;10;2021-08-22;0;0;0;0;0;0;0;0;0;0;0;0;0;0;0;0;0;0
FR;10;2021-08-23;0;0;0;0;0;0;0;0;0;0;0;0;0;0;0;0;0;0
FR;10;2021-08-24;0;0;0;0;0;0;0;0;0;0;0;0;0;0;0;0;0;0
FR;10;2021-08-25;0;0;0;0;0;0;0;0;0;0;0;0;0;0;0;0;0;0
FR;10;2021-08-26;0;0;0;0;0;0;0;0;0;0;0;0;0;0;0;0;0;0
FR;10;2021-08-27;0;0;0;0;0;0;0;0;0;0;0;0;0;0;0;0;0;0
FR;10;2021-08-28;0;0;0;0;0;0;0;0;0;0;0;0;0;0;0;0;0;0
FR;10;2021-08-29;0;0;0;0;0;0;0;0;0;0;0;0;0;0;0;0;0;0
FR;10;2021-08-30;0;0;0;0;0;0;0;0;0;0;0;0;0;0;0;0;0;0
FR;10;2021-08-31;0;0;0;0;0;0;0;0;0;0;0;0;0;0;0;0;0;0
FR;10;2021-09-01;0;0;0;0;0;0;0;0;0;0;0;0;0;0;0;0;0;0
FR;10;2021-09-02;0;0;0;0;0;0;0;0;0;0;0;0;0;0;0;0;0;0
FR;10;2021-09-03;0;0;0;0;0;0;0;0;0;0;0;0;0;0;0;0;0;0
FR;10;2021-09-04;0;0;0;0;0;0;0;0;0;0;0;0;0;0;0;0;0;0
FR;10;2021-09-05;0;0;0;0;0;0;0;0;0;0;0;0;0;0;0;0;0;0
FR;10;2021-09-06;0;0;0;0;0;0;0;0;0;0;0;0;0;0;0;0;0;0
FR;10;2021-09-07;0;0;0;0;0;0;0;0;0;0;0;0;0;0;0;0;0;0
FR;10;2021-09-08;0;0;0;0;0;0;0;0;0;0;0;0;0;0;0;0;0;0
FR;10;2021-09-09;0;0;0;0;0;0;0;0;0;0;0;0;0;0;0;0;0;0
FR;10;2021-09-10;0;0;0;0;0;0;0;0;0;0;0;0;0;0;0;0;0;0
FR;10;2021-09-11;0;0;0;0;0;0;0;0;0;0;0;0;0;0;0;0;0;0
FR;10;2021-09-12;0;0;0;0;0;0;0;0;0;0;0;0;0;0;0;0;0;0
FR;10;2021-09-13;0;0;0;0;0;0;0;0;0;0;0;0;0;0;0;0;0;0
FR;10;2021-09-14;0;0;0;0;0;0;0;0;0;0;0;0;0;0;0;0;0;0
FR;10;2021-09-15;0;0;0;0;0;0;0;0;0;0;0;0;0;0;0;0;0;0
FR;10;2021-09-16;0;0;0;0;0;0;0;0;0;0;0;0;0;0;0;0;0;0
FR;10;2021-09-17;0;0;0;0;0;0;0;0;0;0;0;0;0;0;0;0;0;0
FR;10;2021-09-18;0;0;0;0;0;0;0;0;0;0;0;0;0;0;0;0;0;0
FR;10;2021-09-19;0;0;0;0;0;0;0;0;0;0;0;0;0;0;0;0;0;0
FR;10;2021-09-20;0;0;0;0;0;0;0;0;0;0;0;0;0;0;0;0;0;0
FR;10;2021-09-21;0;0;0;0;0;0;0;0;0;0;0;0;0;0;0;0;0;0
FR;10;2021-09-22;0;0;0;0;0;0;0;0;0;0;0;0;0;0;0;0;0;0
FR;10;2021-09-23;0;0;0;0;0;0;0;0;0;0;0;0;0;0;0;0;0;0
FR;10;2021-09-24;0;0;0;0;0;0;0;0;0;0;0;0;0;0;0;0;0;0
FR;10;2021-09-25;0;0;0;0;0;0;0;0;0;0;0;0;0;0;0;0;0;0
FR;10;2021-09-26;0;0;0;0;0;0;0;0;0;0;0;0;0;0;0;0;0;0
FR;10;2021-09-27;0;0;0;0;0;0;0;0;0;0;0;0;0;0;0;0;0;0
FR;10;2021-09-28;0;0;0;0;0;0;0;0;0;0;0;0;0;0;0;0;0;0
FR;10;2021-09-29;0;0;0;0;0;0;0;0;0;0;0;0;0;0;0;0;0;0
FR;10;2021-09-30;0;0;0;0;0;0;0;0;0;0;0;0;0;0;0;0;0;0
FR;10;2021-10-01;0;0;0;0;0;0;0;0;0;0;0;0;0;0;0;0;0;0
FR;10;2021-10-02;0;0;0;0;0;0;0;0;0;0;0;0;0;0;0;0;0;0
FR;10;2021-10-03;0;0;0;0;0;0;0;0;0;0;0;0;0;0;0;0;0;0
FR;10;2021-10-04;0;0;0;0;0;0;0;0;0;0;0;0;0;0;0;0;0;0
FR;10;2021-10-05;0;0;0;0;0;0;0;0;0;0;0;0;0;0;0;0;0;0
FR;10;2021-10-06;0;0;0;0;0;0;0;0;0;0;0;0;0;0;0;0;0;0
FR;10;2021-10-07;0;0;0;0;0;0;0;0;0;0;0;0;0;0;0;0;0;0
FR;10;2021-10-08;0;0;0;0;0;0;0;0;0;0;0;0;0;0;0;0;0;0
FR;10;2021-10-09;0;0;0;0;0;0;0;0;0;0;0;0;0;0;0;0;0;0
FR;10;2021-10-10;0;0;0;0;0;0;0;0;0;0;0;0;0;0;0;0;0;0
FR;10;2021-10-11;0;0;0;0;0;0;0;0;0;0;0;0;0;0;0;0;0;0
FR;10;2021-10-12;0;0;0;0;0;0;0;0;0;0;0;0;0;0;0;0;0;0
FR;10;2021-10-13;0;0;0;0;0;0;0;0;0;0;0;0;0;0;0;0;0;0
FR;10;2021-10-14;0;0;0;0;0;0;0;0;0;0;0;0;0;0;0;0;0;0
FR;10;2021-10-15;0;0;0;0;0;0;0;0;0;0;0;0;0;0;0;0;0;0
FR;10;2021-10-16;0;0;0;0;0;0;0;0;0;0;0;0;0;0;0;0;0;0
FR;10;2021-10-17;0;0;0;0;0;0;0;0;0;0;0;0;0;0;0;0;0;0
FR;10;2021-10-18;0;0;0;0;0;0;0;0;0;0;0;0;0;0;0;0;0;0
FR;10;2021-10-19;0;0;0;0;0;0;0;0;0;0;0;0;0;0;0;0;0;0
FR;10;2021-10-20;0;0;0;0;0;0;0;0;0;0;0;0;0;0;0;0;0;0
FR;10;2021-10-21;0;0;0;0;0;0;0;0;0;0;0;0;0;0;0;0;0;0
FR;10;2021-10-22;0;0;0;0;0;0;0;0;0;0;0;0;0;0;0;0;0;0
FR;10;2021-10-23;0;0;0;0;0;0;0;0;0;0;0;0;0;0;0;0;0;0
FR;10;2021-10-24;0;0;0;0;0;0;0;0;0;0;0;0;0;0;0;0;0;0
FR;10;2021-10-25;0;0;0;0;0;0;0;0;0;0;0;0;0;0;0;0;0;0
FR;10;2021-10-26;0;0;0;0;0;0;0;0;0;0;0;0;0;0;0;0;0;0
FR;10;2021-10-27;0;0;0;0;0;0;0;0;0;0;0;0;0;0;0;0;0;0
FR;10;2021-10-28;0;0;0;0;0;0;0;0;0;0;0;0;0;0;0;0;0;0
FR;10;2021-10-29;0;0;0;0;0;0;0;0;0;0;0;0;0;0;0;0;0;0
FR;10;2021-10-30;0;0;0;0;0;0;0;0;0;0;0;0;0;0;0;0;0;0
FR;10;2021-10-31;0;0;0;0;0;0;0;0;0;0;0;0;0;0;0;0;0;0
FR;10;2021-11-01;0;0;0;0;0;0;0;0;0;0;0;0;0;0;0;0;0;0
FR;10;2021-11-02;0;0;0;0;0;0;0;0;0;0;0;0;0;0;0;0;0;0
FR;10;2021-11-03;0;0;0;0;0;0;0;0;0;0;0;0;0;0;0;0;0;0
FR;10;2021-11-04;0;0;0;0;0;0;0;0;0;0;0;0;0;0;0;0;0;0
FR;10;2021-11-05;0;0;0;0;0;0;0;0;0;0;0;0;0;0;0;0;0;0
FR;10;2021-11-06;0;0;0;0;0;0;0;0;0;0;0;0;0;0;0;0;0;0
FR;10;2021-11-07;0;0;0;0;0;0;0;0;0;0;0;0;0;0;0;0;0;0
FR;10;2021-11-08;0;0;0;0;0;0;0;0;0;0;0;0;0;0;0;0;0;0
FR;10;2021-11-09;0;0;0;0;0;0;0;0;0;0;0;0;0;0;0;0;0;0
FR;10;2021-11-10;0;0;0;0;0;0;0;0;0;0;0;0;0;0;0;0;0;0
FR;10;2021-11-11;0;0;0;0;0;0;0;0;0;0;0;0;0;0;0;0;0;0
FR;10;2021-11-12;0;0;0;0;0;0;0;0;0;0;0;0;0;0;0;0;0;0
FR;10;2021-11-13;0;0;0;0;0;0;0;0;0;0;0;0;0;0;0;0;0;0
FR;10;2021-11-14;0;0;0;0;0;0;0;0;0;0;0;0;0;0;0;0;0;0
FR;10;2021-11-15;0;0;0;0;0;0;0;0;0;0;0;0;0;0;0;0;0;0
FR;10;2021-11-16;0;0;0;0;0;0;0;0;0;0;0;0;0;0;0;0;0;0
FR;10;2021-11-17;0;0;0;0;0;0;0;0;0;0;0;0;0;0;0;0;0;0
FR;10;2021-11-18;0;0;0;0;0;0;0;0;0;0;0;0;0;0;0;0;0;0
FR;10;2021-11-19;0;0;0;0;0;0;0;0;0;0;0;0;0;0;0;0;0;0
FR;10;2021-11-20;0;0;0;0;0;0;0;0;0;0;0;0;0;0;0;0;0;0
FR;10;2021-11-21;0;0;0;0;0;0;0;0;0;0;0;0;0;0;0;0;0;0
FR;10;2021-11-22;0;0;0;0;0;0;0;0;0;0;0;0;0;0;0;0;0;0
FR;10;2021-11-23;0;0;0;0;0;0;0;0;0;0;0;0;0;0;0;0;0;0
FR;10;2021-11-24;0;0;0;0;0;0;0;0;0;0;0;0;0;0;0;0;0;0
FR;10;2021-11-25;0;0;0;0;0;0;0;0;0;0;0;0;0;0;0;0;0;0
FR;10;2021-11-26;0;0;0;0;0;0;0;0;0;0;0;0;0;0;0;0;0;0
FR;10;2021-11-27;0;0;0;0;0;0;0;0;0;0;0;0;0;0;0;0;0;0
FR;10;2021-11-28;0;0;0;0;0;0;0;0;0;0;0;0;0;0;0;0;0;0
FR;10;2021-11-29;0;0;0;0;0;0;0;0;0;0;0;0;0;0;0;0;0;0
FR;10;2021-11-30;0;0;0;0;0;0;0;0;0;0;0;0;0;0;0;0;0;0
FR;10;2021-12-01;0;0;0;0;0;0;0;0;0;0;0;0;0;0;0;0;0;0
FR;10;2021-12-02;0;0;0;0;0;0;0;0;0;0;0;0;0;0;0;0;0;0
FR;10;2021-12-03;0;0;0;0;0;0;0;0;0;0;0;0;0;0;0;0;0;0
FR;10;2021-12-04;0;0;0;0;0;0;0;0;0;0;0;0;0;0;0;0;0;0
FR;10;2021-12-05;0;0;0;0;0;0;0;0;0;0;0;0;0;0;0;0;0;0
FR;10;2021-12-06;0;0;0;0;0;0;0;0;0;0;0;0;0;0;0;0;0;0
FR;10;2021-12-07;0;0;0;0;0;0;0;0;0;0;0;0;0;0;0;0;0;0
FR;10;2021-12-08;0;0;0;0;0;0;0;0;0;0;0;0;0;0;0;0;0;0
FR;10;2021-12-09;0;0;0;0;0;0;0;0;0;0;0;0;0;0;0;0;0;0
FR;10;2021-12-10;0;0;0;0;0;0;0;0;0;0;0;0;0;0;0;0;0;0
FR;10;2021-12-11;0;0;0;0;0;0;0;0;0;0;0;0;0;0;0;0;0;0
FR;10;2021-12-12;0;0;0;0;0;0;0;0;0;0;0;0;0;0;0;0;0;0
FR;10;2021-12-13;0;0;0;0;0;0;0;0;0;0;0;0;0;0;0;0;0;0
FR;10;2021-12-14;0;0;0;0;0;0;0;0;0;0;0;0;0;0;0;0;0;0
FR;10;2021-12-15;0;0;0;0;0;0;0;0;0;0;0;0;0;0;0;0;0;0
FR;10;2021-12-16;0;0;0;0;0;0;0;0;0;0;0;0;0;0;0;0;0;0
FR;10;2021-12-17;0;0;0;0;0;0;0;0;0;0;0;0;0;0;0;0;0;0
FR;10;2021-12-18;0;0;0;0;0;0;0;0;0;0;0;0;0;0;0;0;0;0
FR;10;2021-12-19;0;0;0;0;0;0;0;0;0;0;0;0;0;0;0;0;0;0
FR;10;2021-12-20;0;0;0;0;0;0;0;0;0;0;0;0;0;0;0;0;0;0
FR;10;2021-12-21;0;0;0;0;0;0;0;0;0;0;0;0;0;0;0;0;0;0
FR;10;2021-12-22;0;0;0;0;0;0;0;0;0;0;0;0;0;0;0;0;0;0
FR;10;2021-12-23;0;0;0;0;0;0;0;0;0;0;0;0;0;0;0;0;0;0
FR;10;2021-12-24;0;0;0;0;0;0;0;0;0;0;0;0;0;0;0;0;0;0
FR;10;2021-12-25;0;0;0;0;0;0;0;0;0;0;0;0;0;0;0;0;0;0
FR;10;2021-12-26;0;0;0;0;0;0;0;0;0;0;0;0;0;0;0;0;0;0
FR;10;2021-12-27;0;0;0;0;0;0;0;0;0;0;0;0;0;0;0;0;0;0
FR;10;2021-12-28;0;0;0;0;0;0;0;0;0;0;0;0;0;0;0;0;0;0
FR;10;2021-12-29;0;0;0;0;0;0;0;0;0;0;0;0;0;0;0;0;0;0
FR;10;2021-12-30;0;0;0;0;0;0;0;0;0;0;0;0;0;0;0;0;0;0
FR;10;2021-12-31;0;0;0;0;0;0;0;0;0;0;0;0;0;0;0;0;0;0
FR;10;2022-01-01;0;0;0;0;0;0;0;0;0;0;0;0;0;0;0;0;0;0
FR;10;2022-01-02;0;0;0;0;0;0;0;0;0;0;0;0;0;0;0;0;0;0
FR;10;2022-01-03;0;0;0;0;0;0;0;0;0;0;0;0;0;0;0;0;0;0
FR;10;2022-01-04;0;0;0;0;0;0;0;0;0;0;0;0;0;0;0;0;0;0
FR;10;2022-01-05;0;0;0;0;0;0;0;0;0;0;0;0;0;0;0;0;0;0
FR;10;2022-01-06;0;0;0;0;0;0;0;0;0;0;0;0;0;0;0;0;0;0
FR;10;2022-01-07;0;0;0;0;0;0;0;0;0;0;0;0;0;0;0;0;0;0
FR;10;2022-01-08;0;0;0;0;0;0;0;0;0;0;0;0;0;0;0;0;0;0
FR;10;2022-01-09;0;0;0;0;0;0;0;0;0;0;0;0;0;0;0;0;0;0
FR;10;2022-01-10;0;0;0;0;0;0;0;0;0;0;0;0;0;0;0;0;0;0
FR;10;2022-01-11;0;0;0;0;0;0;0;0;0;0;0;0;0;0;0;0;0;0
FR;10;2022-01-12;0;0;0;0;0;0;0;0;0;0;0;0;0;0;0;0;0;0
FR;10;2022-01-13;0;0;0;0;0;0;0;0;0;0;0;0;0;0;0;0;0;0
FR;10;2022-01-14;0;0;0;0;0;0;0;0;0;0;0;0;0;0;0;0;0;0
FR;10;2022-01-15;0;0;0;0;0;0;0;0;0;0;0;0;0;0;0;0;0;0
FR;10;2022-01-16;0;0;0;0;0;0;0;0;0;0;0;0;0;0;0;0;0;0
FR;10;2022-01-17;0;0;0;0;0;0;0;0;0;0;0;0;0;0;0;0;0;0
FR;10;2022-01-18;0;0;0;0;0;0;0;0;0;0;0;0;0;0;0;0;0;0
FR;10;2022-01-19;0;0;0;0;0;0;0;0;0;0;0;0;0;0;0;0;0;0
FR;10;2022-01-20;0;0;0;0;0;0;0;0;0;0;0;0;0;0;0;0;0;0
FR;10;2022-01-21;0;0;0;0;0;0;0;0;0;0;0;0;0;0;0;0;0;0
FR;10;2022-01-22;0;0;0;0;0;0;0;0;0;0;0;0;0;0;0;0;0;0
FR;10;2022-01-23;0;0;0;0;0;0;0;0;0;0;0;0;0;0;0;0;0;0
FR;10;2022-01-24;0;0;0;0;0;0;0;0;0;0;0;0;0;0;0;0;0;0
FR;10;2022-01-25;0;0;0;0;0;0;0;0;0;0;0;0;0;0;0;0;0;0
FR;10;2022-01-26;0;0;0;0;0;0;0;0;0;0;0;0;0;0;0;0;0;0
FR;10;2022-01-27;0;0;0;0;0;0;0;0;0;0;0;0;0;0;0;0;0;0
FR;10;2022-01-28;0;0;0;0;0;0;0;0;0;0;0;0;0;0;0;0;0;0
FR;10;2022-01-29;0;0;0;0;0;0;0;0;0;0;0;0;0;0;0;0;0;0
FR;10;2022-01-30;0;0;0;0;0;0;0;0;0;0;0;0;0;0;0;0;0;0
FR;10;2022-01-31;0;0;0;0;0;0;0;0;0;0;0;0;0;0;0;0;0;0
FR;10;2022-02-01;0;0;0;0;0;0;0;0;0;0;0;0;0;0;0;0;0;0
FR;10;2022-02-02;0;0;0;0;0;0;0;0;0;0;0;0;0;0;0;0;0;0
FR;10;2022-02-03;0;0;0;0;0;0;0;0;0;0;0;0;0;0;0;0;0;0
FR;10;2022-02-04;0;0;0;0;0;0;0;0;0;0;0;0;0;0;0;0;0;0
FR;10;2022-02-05;0;0;0;0;0;0;0;0;0;0;0;0;0;0;0;0;0;0
FR;10;2022-02-06;0;0;0;0;0;0;0;0;0;0;0;0;0;0;0;0;0;0
FR;10;2022-02-07;0;0;0;0;0;0;0;0;0;0;0;0;0;0;0;0;0;0
FR;10;2022-02-08;0;0;0;0;0;0;0;0;0;0;0;0;0;0;0;0;0;0
FR;10;2022-02-09;0;0;0;0;0;0;0;0;0;0;0;0;0;0;0;0;0;0
FR;10;2022-02-10;0;0;0;0;0;0;0;0;0;0;0;0;0;0;0;0;0;0
FR;10;2022-02-11;0;0;0;0;0;0;0;0;0;0;0;0;0;0;0;0;0;0
FR;10;2022-02-12;0;0;0;0;0;0;0;0;0;0;0;0;0;0;0;0;0;0
FR;10;2022-02-13;0;0;0;0;0;0;0;0;0;0;0;0;0;0;0;0;0;0
FR;10;2022-02-14;0;0;0;0;0;0;0;0;0;0;0;0;0;0;0;0;0;0
FR;10;2022-02-15;0;0;0;0;0;0;0;0;0;0;0;0;0;0;0;0;0;0
FR;10;2022-02-16;0;0;0;0;0;0;0;0;0;0;0;0;0;0;0;0;0;0
FR;10;2022-02-17;0;0;0;0;0;0;0;0;0;0;0;0;0;0;0;0;0;0
FR;10;2022-02-18;0;0;0;0;0;0;0;0;0;0;0;0;0;0;0;0;0;0
FR;10;2022-02-19;0;0;0;0;0;0;0;0;0;0;0;0;0;0;0;0;0;0
FR;10;2022-02-20;0;0;0;0;0;0;0;0;0;0;0;0;0;0;0;0;0;0
FR;10;2022-02-21;0;0;0;0;0;0;0;0;0;0;0;0;0;0;0;0;0;0
FR;10;2022-02-22;0;0;0;0;0;0;0;0;0;0;0;0;0;0;0;0;0;0
FR;10;2022-02-23;0;0;0;0;0;0;0;0;0;0;0;0;0;0;0;0;0;0
FR;10;2022-02-24;0;0;0;0;0;0;0;0;0;0;0;0;0;0;0;0;0;0
FR;10;2022-02-25;0;0;0;0;0;0;0;0;0;0;0;0;0;0;0;0;0;0
FR;10;2022-02-26;0;0;0;0;0;0;0;0;0;0;0;0;0;0;0;0;0;0
FR;10;2022-02-27;0;0;0;0;0;0;0;0;0;0;0;0;0;0;0;0;0;0
FR;10;2022-02-28;0;0;0;0;0;0;0;0;0;0;0;0;0;0;0;0;0;0
FR;10;2022-03-01;0;0;0;0;0;0;0;0;0;0;0;0;0;0;0;0;0;0
FR;10;2022-03-02;0;0;0;0;0;0;0;0;0;0;0;0;0;0;0;0;0;0
FR;10;2022-03-03;0;0;0;0;0;0;0;0;0;0;0;0;0;0;0;0;0;0
FR;10;2022-03-04;0;0;0;0;0;0;0;0;0;0;0;0;0;0;0;0;0;0
FR;10;2022-03-05;0;0;0;0;0;0;0;0;0;0;0;0;0;0;0;0;0;0
FR;10;2022-03-06;0;0;0;0;0;0;0;0;0;0;0;0;0;0;0;0;0;0
FR;10;2022-03-07;0;0;0;0;0;0;0;0;0;0;0;0;0;0;0;0;0;0
FR;10;2022-03-08;0;0;0;0;0;0;0;0;0;0;0;0;0;0;0;0;0;0
FR;10;2022-03-09;0;0;0;0;0;0;0;0;0;0;0;0;0;0;0;0;0;0
FR;10;2022-03-10;0;0;0;0;0;0;0;0;0;0;0;0;0;0;0;0;0;0
FR;10;2022-03-11;0;0;0;0;0;0;0;0;0;0;0;0;0;0;0;0;0;0
FR;10;2022-03-12;0;0;0;0;0;0;0;0;0;0;0;0;0;0;0;0;0;0
FR;10;2022-03-13;0;0;0;0;0;0;0;0;0;0;0;0;0;0;0;0;0;0
FR;10;2022-03-14;0;0;0;0;0;0;0;0;0;0;0;0;0;0;0;0;0;0
FR;10;2022-03-15;0;0;0;0;0;0;0;0;0;0;0;0;0;0;0;0;0;0
FR;10;2022-03-16;0;0;0;0;0;0;0;0;0;0;0;0;0;0;0;0;0;0
FR;10;2022-03-17;0;0;0;0;0;0;0;0;0;0;0;0;0;0;0;0;0;0
FR;10;2022-03-18;0;0;0;0;0;0;0;0;0;0;0;0;0;0;0;0;0;0
FR;10;2022-03-19;0;0;0;0;0;0;0;0;0;0;0;0;0;0;0;0;0;0
FR;10;2022-03-20;0;0;0;0;0;0;0;0;0;0;0;0;0;0;0;0;0;0
FR;10;2022-03-21;0;0;0;0;0;0;0;0;0;0;0;0;0;0;0;0;0;0
FR;10;2022-03-22;0;0;0;0;0;0;0;0;0;0;0;0;0;0;0;0;0;0
FR;10;2022-03-23;0;0;0;0;0;0;0;0;0;0;0;0;0;0;0;0;0;0
FR;10;2022-03-24;0;0;0;0;0;0;0;0;0;0;0;0;0;0;0;0;0;0
FR;10;2022-03-25;0;0;0;0;0;0;0;0;0;0;0;0;0;0;0;0;0;0
FR;10;2022-03-26;0;0;0;0;0;0;0;0;0;0;0;0;0;0;0;0;0;0
FR;10;2022-03-27;0;0;0;0;0;0;0;0;0;0;0;0;0;0;0;0;0;0
FR;10;2022-03-28;0;0;0;0;0;0;0;0;0;0;0;0;0;0;0;0;0;0
FR;10;2022-03-29;0;0;0;0;0;0;0;0;0;0;0;0;0;0;0;0;0;0
FR;10;2022-03-30;0;0;0;0;0;0;0;0;0;0;0;0;0;0;0;0;0;0
FR;10;2022-03-31;0;0;0;0;0;0;0;0;0;0;0;0;0;0;0;0;0;0
FR;10;2022-04-01;0;0;0;0;0;0;0;0;0;0;0;0;0;0;0;0;0;0
FR;10;2022-04-02;0;0;0;0;0;0;0;0;0;0;0;0;0;0;0;0;0;0
FR;10;2022-04-03;0;0;0;0;0;0;0;0;0;0;0;0;0;0;0;0;0;0
FR;10;2022-04-04;0;0;0;0;0;0;0;0;0;0;0;0;0;0;0;0;0;0
FR;10;2022-04-05;0;0;0;0;0;0;0;0;0;0;0;0;0;0;0;0;0;0
FR;10;2022-04-06;0;0;0;0;0;0;0;0;0;0;0;0;0;0;0;0;0;0
FR;10;2022-04-07;0;0;0;0;0;0;0;0;0;0;0;0;0;0;0;0;0;0
FR;10;2022-04-08;0;0;0;0;0;0;0;0;0;0;0;0;0;0;0;0;0;0
FR;10;2022-04-09;0;0;0;0;0;0;0;0;0;0;0;0;0;0;0;0;0;0
FR;10;2022-04-10;0;0;0;0;0;0;0;0;0;0;0;0;0;0;0;0;0;0
FR;10;2022-04-11;0;0;0;0;0;0;0;0;0;0;0;0;0;0;0;0;0;0
FR;10;2022-04-12;0;0;0;0;0;0;0;0;0;0;0;0;0;0;0;0;0;0
FR;10;2022-04-13;0;0;0;0;0;0;0;0;0;0;0;0;0;0;0;0;0;0
FR;10;2022-04-14;0;0;0;0;0;0;0;0;0;0;0;0;0;0;0;0;0;0
FR;10;2022-04-15;0;0;0;0;0;0;0;0;0;0;0;0;0;0;0;0;0;0
FR;10;2022-04-16;0;0;0;0;0;0;0;0;0;0;0;0;0;0;0;0;0;0
FR;10;2022-04-17;0;0;0;0;0;0;0;0;0;0;0;0;0;0;0;0;0;0
FR;10;2022-04-18;0;0;0;0;0;0;0;0;0;0;0;0;0;0;0;0;0;0
FR;10;2022-04-19;0;0;0;0;0;0;0;0;0;0;0;0;0;0;0;0;0;0
FR;10;2022-04-20;0;0;0;0;0;0;0;0;0;0;0;0;0;0;0;0;0;0
FR;10;2022-04-21;0;0;0;0;0;0;0;0;0;0;0;0;0;0;0;0;0;0
FR;10;2022-04-22;0;0;0;0;0;0;0;0;0;0;0;0;0;0;0;0;0;0
FR;10;2022-04-23;0;0;0;0;0;0;0;0;0;0;0;0;0;0;0;0;0;0
FR;10;2022-04-24;0;0;0;0;0;0;0;0;0;0;0;0;0;0;0;0;0;0
FR;10;2022-04-25;0;0;0;0;0;0;0;0;0;0;0;0;0;0;0;0;0;0
FR;10;2022-04-26;0;0;0;0;0;0;0;0;0;0;0;0;0;0;0;0;0;0
FR;10;2022-04-27;0;0;0;0;0;0;0;0;0;0;0;0;0;0;0;0;0;0
FR;10;2022-04-28;0;0;0;0;0;0;0;0;0;0;0;0;0;0;0;0;0;0
FR;10;2022-04-29;0;0;0;0;0;0;0;0;0;0;0;0;0;0;0;0;0;0
FR;10;2022-04-30;0;0;0;0;0;0;0;0;0;0;0;0;0;0;0;0;0;0
FR;10;2022-05-01;0;0;0;0;0;0;0;0;0;0;0;0;0;0;0;0;0;0
FR;10;2022-05-02;0;0;0;0;0;0;0;0;0;0;0;0;0;0;0;0;0;0
FR;10;2022-05-03;0;0;0;0;0;0;0;0;0;0;0;0;0;0;0;0;0;0
FR;10;2022-05-04;0;0;0;0;0;0;0;0;0;0;0;0;0;0;0;0;0;0
FR;10;2022-05-05;0;0;0;0;0;0;0;0;0;0;0;0;0;0;0;0;0;0
FR;10;2022-05-06;0;0;0;0;0;0;0;0;0;0;0;0;0;0;0;0;0;0
FR;10;2022-05-07;0;0;0;0;0;0;0;0;0;0;0;0;0;0;0;0;0;0
FR;10;2022-05-08;0;0;0;0;0;0;0;0;0;0;0;0;0;0;0;0;0;0
FR;10;2022-05-09;0;0;0;0;0;0;0;0;0;0;0;0;0;0;0;0;0;0
FR;10;2022-05-10;0;0;0;0;0;0;0;0;0;0;0;0;0;0;0;0;0;0
FR;10;2022-05-11;0;0;0;0;0;0;0;0;0;0;0;0;0;0;0;0;0;0
FR;10;2022-05-12;0;0;0;0;0;0;0;0;0;0;0;0;0;0;0;0;0;0
FR;10;2022-05-13;0;0;0;0;0;0;0;0;0;0;0;0;0;0;0;0;0;0
FR;10;2022-05-14;0;0;0;0;0;0;0;0;0;0;0;0;0;0;0;0;0;0
FR;10;2022-05-15;0;0;0;0;0;0;0;0;0;0;0;0;0;0;0;0;0;0
FR;10;2022-05-16;0;0;0;0;0;0;0;0;0;0;0;0;0;0;0;0;0;0
FR;10;2022-05-17;0;0;0;0;0;0;0;0;0;0;0;0;0;0;0;0;0;0
FR;10;2022-05-18;0;0;0;0;0;0;0;0;0;0;0;0;0;0;0;0;0;0
FR;10;2022-05-19;0;0;0;0;0;0;0;0;0;0;0;0;0;0;0;0;0;0
FR;10;2022-05-20;0;0;0;0;0;0;0;0;0;0;0;0;0;0;0;0;0;0
FR;10;2022-05-21;0;0;0;0;0;0;0;0;0;0;0;0;0;0;0;0;0;0
FR;10;2022-05-22;0;0;0;0;0;0;0;0;0;0;0;0;0;0;0;0;0;0
FR;10;2022-05-23;0;0;0;0;0;0;0;0;0;0;0;0;0;0;0;0;0;0
FR;10;2022-05-24;0;0;0;0;0;0;0;0;0;0;0;0;0;0;0;0;0;0
FR;10;2022-05-25;0;0;0;0;0;0;0;0;0;0;0;0;0;0;0;0;0;0
FR;10;2022-05-26;0;0;0;0;0;0;0;0;0;0;0;0;0;0;0;0;0;0
FR;10;2022-05-27;0;0;0;0;0;0;0;0;0;0;0;0;0;0;0;0;0;0
FR;10;2022-05-28;0;0;0;0;0;0;0;0;0;0;0;0;0;0;0;0;0;0
FR;10;2022-05-29;0;0;0;0;0;0;0;0;0;0;0;0;0;0;0;0;0;0
FR;10;2022-05-30;0;0;0;0;0;0;0;0;0;0;0;0;0;0;0;0;0;0
FR;10;2022-05-31;0;0;0;0;0;0;0;0;0;0;0;0;0;0;0;0;0;0
FR;10;2022-06-01;0;0;0;0;0;0;0;0;0;0;0;0;0;0;0;0;0;0
FR;10;2022-06-02;0;0;0;0;0;0;0;0;0;0;0;0;0;0;0;0;0;0
FR;10;2022-06-03;0;0;0;0;0;0;0;0;0;0;0;0;0;0;0;0;0;0
FR;10;2022-06-04;0;0;0;0;0;0;0;0;0;0;0;0;0;0;0;0;0;0
FR;10;2022-06-05;0;0;0;0;0;0;0;0;0;0;0;0;0;0;0;0;0;0
FR;10;2022-06-06;0;0;0;0;0;0;0;0;0;0;0;0;0;0;0;0;0;0
FR;10;2022-06-07;0;0;0;0;0;0;0;0;0;0;0;0;0;0;0;0;0;0
FR;10;2022-06-08;0;0;0;0;0;0;0;0;0;0;0;0;0;0;0;0;0;0
FR;10;2022-06-09;0;0;0;0;0;0;0;0;0;0;0;0;0;0;0;0;0;0
FR;10;2022-06-10;0;0;0;0;0;0;0;0;0;0;0;0;0;0;0;0;0;0
FR;10;2022-06-11;0;0;0;0;0;0;0;0;0;0;0;0;0;0;0;0;0;0
FR;10;2022-06-12;0;0;0;0;0;0;0;0;0;0;0;0;0;0;0;0;0;0
FR;10;2022-06-13;0;0;0;0;0;0;0;0;0;0;0;0;0;0;0;0;0;0
FR;10;2022-06-14;0;0;0;0;0;0;0;0;0;0;0;0;0;0;0;0;0;0
FR;10;2022-06-15;0;0;0;0;0;0;0;0;0;0;0;0;0;0;0;0;0;0
FR;10;2022-06-16;0;0;0;0;0;0;0;0;0;0;0;0;0;0;0;0;0;0
FR;10;2022-06-17;0;0;0;0;0;0;0;0;0;0;0;0;0;0;0;0;0;0
FR;10;2022-06-18;0;0;0;0;0;0;0;0;0;0;0;0;0;0;0;0;0;0
FR;10;2022-06-19;0;0;0;0;0;0;0;0;0;0;0;0;0;0;0;0;0;0
FR;10;2022-06-20;0;0;0;0;0;0;0;0;0;0;0;0;0;0;0;0;0;0
FR;10;2022-06-21;0;0;0;0;0;0;0;0;0;0;0;0;0;0;0;0;0;0
FR;10;2022-06-22;0;0;0;0;0;0;0;0;0;0;0;0;0;0;0;0;0;0
FR;10;2022-06-23;0;0;0;0;0;0;0;0;0;0;0;0;0;0;0;0;0;0
FR;10;2022-06-24;0;0;0;0;0;0;0;0;0;0;0;0;0;0;0;0;0;0
FR;10;2022-06-25;0;0;0;0;0;0;0;0;0;0;0;0;0;0;0;0;0;0
FR;10;2022-06-26;0;0;0;0;0;0;0;0;0;0;0;0;0;0;0;0;0;0
FR;10;2022-06-27;0;0;0;0;0;0;0;0;0;0;0;0;0;0;0;0;0;0
FR;10;2022-06-28;0;0;0;0;0;0;0;0;0;0;0;0;0;0;0;0;0;0
FR;10;2022-06-29;0;0;0;0;0;0;0;0;0;0;0;0;0;0;0;0;0;0
FR;10;2022-06-30;0;0;0;0;0;0;0;0;0;0;0;0;0;0;0;0;0;0
FR;10;2022-07-01;0;0;0;0;0;0;0;0;0;0;0;0;0;0;0;0;0;0
FR;10;2022-07-02;0;0;0;0;0;0;0;0;0;0;0;0;0;0;0;0;0;0
FR;10;2022-07-03;0;0;0;0;0;0;0;0;0;0;0;0;0;0;0;0;0;0
FR;10;2022-07-04;0;0;0;0;0;0;0;0;0;0;0;0;0;0;0;0;0;0
FR;10;2022-07-05;0;0;0;0;0;0;0;0;0;0;0;0;0;0;0;0;0;0
FR;10;2022-07-06;0;0;0;0;0;0;0;0;0;0;0;0;0;0;0;0;0;0
FR;10;2022-07-07;0;0;0;0;0;0;0;0;0;0;0;0;0;0;0;0;0;0
FR;10;2022-07-08;0;0;0;0;0;0;0;0;0;0;0;0;0;0;0;0;0;0
FR;10;2022-07-09;0;0;0;0;0;0;0;0;0;0;0;0;0;0;0;0;0;0
FR;10;2022-07-10;0;0;0;0;0;0;0;0;0;0;0;0;0;0;0;0;0;0
FR;10;2022-07-11;0;0;0;0;0;0;0;0;0;0;0;0;0;0;0;0;0;0
FR;10;2022-07-12;0;0;0;0;0;0;0;0;0;0;0;0;0;0;0;0;0;0
FR;10;2022-07-13;0;0;0;0;0;0;0;0;0;0;0;0;0;0;0;0;0;0
FR;10;2022-07-14;0;0;0;0;0;0;0;0;0;0;0;0;0;0;0;0;0;0
FR;10;2022-07-15;0;0;0;0;0;0;0;0;0;0;0;0;0;0;0;0;0;0
FR;10;2022-07-16;0;0;0;0;0;0;0;0;0;0;0;0;0;0;0;0;0;0
FR;10;2022-07-17;0;0;0;0;0;0;0;0;0;0;0;0;0;0;0;0;0;0
FR;10;2022-07-18;0;0;0;0;0;0;0;0;0;0;0;0;0;0;0;0;0;0
FR;10;2022-07-19;0;0;0;0;0;0;0;0;0;0;0;0;0;0;0;0;0;0
FR;10;2022-07-20;0;0;0;0;0;0;0;0;0;0;0;0;0;0;0;0;0;0
FR;10;2022-07-21;0;0;0;0;0;0;0;0;0;0;0;0;0;0;0;0;0;0
FR;10;2022-07-22;0;0;0;0;0;0;0;0;0;0;0;0;0;0;0;0;0;0
FR;10;2022-07-23;0;0;0;0;0;0;0;0;0;0;0;0;0;0;0;0;0;0
FR;10;2022-07-24;0;0;0;0;0;0;0;0;0;0;0;0;0;0;0;0;0;0
FR;10;2022-07-25;0;0;0;0;0;0;0;0;0;0;0;0;0;0;0;0;0;0
FR;10;2022-07-26;0;0;0;0;0;0;0;0;0;0;0;0;0;0;0;0;0;0
FR;10;2022-07-27;0;0;0;0;0;0;0;0;0;0;0;0;0;0;0;0;0;0
FR;10;2022-07-28;0;0;0;0;0;0;0;0;0;0;0;0;0;0;0;0;0;0
FR;10;2022-07-29;0;0;0;0;0;0;0;0;0;0;0;0;0;0;0;0;0;0
FR;10;2022-07-30;0;0;0;0;0;0;0;0;0;0;0;0;0;0;0;0;0;0
FR;10;2022-07-31;0;0;0;0;0;0;0;0;0;0;0;0;0;0;0;0;0;0
FR;10;2022-08-01;0;0;0;0;0;0;0;0;0;0;0;0;0;0;0;0;0;0
FR;10;2022-08-02;0;0;0;0;0;0;0;0;0;0;0;0;0;0;0;0;0;0
FR;10;2022-08-03;0;0;0;0;0;0;0;0;0;0;0;0;0;0;0;0;0;0
FR;10;2022-08-04;0;0;0;0;0;0;0;0;0;0;0;0;0;0;0;0;0;0
FR;10;2022-08-05;0;0;0;0;0;0;0;0;0;0;0;0;0;0;0;0;0;0
FR;10;2022-08-06;0;0;0;0;0;0;0;0;0;0;0;0;0;0;0;0;0;0
FR;10;2022-08-07;0;0;0;0;0;0;0;0;0;0;0;0;0;0;0;0;0;0
FR;10;2022-08-08;0;0;0;0;0;0;0;0;0;0;0;0;0;0;0;0;0;0
FR;10;2022-08-09;0;0;0;0;0;0;0;0;0;0;0;0;0;0;0;0;0;0
FR;10;2022-08-10;0;0;0;0;0;0;0;0;0;0;0;0;0;0;0;0;0;0
FR;10;2022-08-11;0;0;0;0;0;0;0;0;0;0;0;0;0;0;0;0;0;0
FR;10;2022-08-12;0;0;0;0;0;0;0;0;0;0;0;0;0;0;0;0;0;0
FR;10;2022-08-13;0;0;0;0;0;0;0;0;0;0;0;0;0;0;0;0;0;0
FR;10;2022-08-14;0;0;0;0;0;0;0;0;0;0;0;0;0;0;0;0;0;0
FR;10;2022-08-15;0;0;0;0;0;0;0;0;0;0;0;0;0;0;0;0;0;0
FR;10;2022-08-16;0;0;0;0;0;0;0;0;0;0;0;0;0;0;0;0;0;0
FR;10;2022-08-17;0;0;0;0;0;0;0;0;0;0;0;0;0;0;0;0;0;0
FR;10;2022-08-18;0;0;0;0;0;0;0;0;0;0;0;0;0;0;0;0;0;0
FR;10;2022-08-19;0;0;0;0;0;0;0;0;0;0;0;0;0;0;0;0;0;0
FR;10;2022-08-20;0;0;0;0;0;0;0;0;0;0;0;0;0;0;0;0;0;0
FR;10;2022-08-21;0;0;0;0;0;0;0;0;0;0;0;0;0;0;0;0;0;0
FR;10;2022-08-22;0;0;0;0;0;0;0;0;0;0;0;0;0;0;0;0;0;0
FR;10;2022-08-23;0;0;0;0;0;0;0;0;0;0;0;0;0;0;0;0;0;0
FR;10;2022-08-24;0;0;0;0;0;0;0;0;0;0;0;0;0;0;0;0;0;0
FR;10;2022-08-25;0;0;0;0;0;0;0;0;0;0;0;0;0;0;0;0;0;0
FR;10;2022-08-26;0;0;0;0;0;0;0;0;0;0;0;0;0;0;0;0;0;0
FR;10;2022-08-27;0;0;0;0;0;0;0;0;0;0;0;0;0;0;0;0;0;0
FR;10;2022-08-28;0;0;0;0;0;0;0;0;0;0;0;0;0;0;0;0;0;0
FR;10;2022-08-29;0;0;0;0;0;0;0;0;0;0;0;0;0;0;0;0;0;0
FR;10;2022-08-30;0;0;0;0;0;0;0;0;0;0;0;0;0;0;0;0;0;0
FR;10;2022-08-31;0;0;0;0;0;0;0;0;0;0;0;0;0;0;0;0;0;0
FR;10;2022-09-01;0;0;0;0;0;0;0;0;0;0;0;0;0;0;0;0;0;0
FR;10;2022-09-02;0;0;0;0;0;0;0;0;0;0;0;0;0;0;0;0;0;0
FR;10;2022-09-03;0;0;0;0;0;0;0;0;0;0;0;0;0;0;0;0;0;0
FR;10;2022-09-04;0;0;0;0;0;0;0;0;0;0;0;0;0;0;0;0;0;0
FR;10;2022-09-05;0;0;0;0;0;0;0;0;0;0;0;0;0;0;0;0;0;0
FR;10;2022-09-06;0;0;0;0;0;0;0;0;0;0;0;0;0;0;0;0;0;0
FR;10;2022-09-07;0;0;0;0;0;0;0;0;0;0;0;0;0;0;0;0;0;0
FR;10;2022-09-08;0;0;0;0;0;0;0;0;0;0;0;0;0;0;0;0;0;0
FR;10;2022-09-09;0;0;0;0;0;0;0;0;0;0;0;0;0;0;0;0;0;0
FR;10;2022-09-10;0;0;0;0;0;0;0;0;0;0;0;0;0;0;0;0;0;0
FR;10;2022-09-11;0;0;0;0;0;0;0;0;0;0;0;0;0;0;0;0;0;0
FR;10;2022-09-12;0;0;0;0;0;0;0;0;0;0;0;0;0;0;0;0;0;0
FR;10;2022-09-13;0;0;0;0;0;0;0;0;0;0;0;0;0;0;0;0;0;0
FR;10;2022-09-14;0;0;0;0;0;0;0;0;0;0;0;0;0;0;0;0;0;0
FR;10;2022-09-15;0;0;0;0;0;0;0;0;0;0;0;0;0;0;0;0;0;0
FR;10;2022-09-16;0;0;0;0;0;0;0;0;0;0;0;0;0;0;0;0;0;0
FR;10;2022-09-17;0;0;0;0;0;0;0;0;0;0;0;0;0;0;0;0;0;0
FR;10;2022-09-18;0;0;0;0;0;0;0;0;0;0;0;0;0;0;0;0;0;0
FR;10;2022-09-19;0;0;0;0;0;0;0;0;0;0;0;0;0;0;0;0;0;0
FR;10;2022-09-20;0;0;0;0;0;0;0;0;0;0;0;0;0;0;0;0;0;0
FR;10;2022-09-21;0;0;0;0;0;0;0;0;0;0;0;0;0;0;0;0;0;0
FR;10;2022-09-22;0;0;0;0;0;0;0;0;0;0;0;0;0;0;0;0;0;0
FR;10;2022-09-23;0;0;0;0;0;0;0;0;0;0;0;0;0;0;0;0;0;0
FR;10;2022-09-24;0;0;0;0;0;0;0;0;0;0;0;0;0;0;0;0;0;0
FR;10;2022-09-25;0;0;0;0;0;0;0;0;0;0;0;0;0;0;0;0;0;0
FR;10;2022-09-26;0;0;0;0;0;0;0;0;0;0;0;0;0;0;0;0;0;0
FR;10;2022-09-27;0;0;0;0;0;0;0;0;0;0;0;0;0;0;0;0;0;0
FR;10;2022-09-28;0;0;0;0;0;0;0;0;0;0;0;0;0;0;0;0;0;0
FR;10;2022-09-29;0;0;0;0;0;0;0;0;0;0;0;0;0;0;0;0;0;0
FR;10;2022-09-30;0;0;0;0;0;0;0;0;0;0;0;0;0;0;0;0;0;0
FR;10;2022-10-01;0;0;0;0;0;0;0;0;0;0;0;0;0;0;0;0;0;0
FR;10;2022-10-02;0;0;0;0;0;0;0;0;0;0;0;0;0;0;0;0;0;0
FR;10;2022-10-03;0;0;0;0;0;0;0;0;0;0;0;0;0;0;0;0;0;0
FR;10;2022-10-04;0;0;0;0;0;0;0;0;0;0;0;0;0;0;0;0;0;0
FR;10;2022-10-05;0;0;0;0;0;0;0;0;0;0;0;0;0;0;0;0;0;0
FR;10;2022-10-06;0;0;0;0;0;0;0;0;0;0;0;0;0;0;0;0;0;0
FR;10;2022-10-07;0;0;0;0;0;0;0;0;0;0;0;0;0;0;0;0;0;0
FR;10;2022-10-08;0;0;0;0;0;0;0;0;0;0;0;0;0;0;0;0;0;0
FR;10;2022-10-09;0;0;0;0;0;0;0;0;0;0;0;0;0;0;0;0;0;0
FR;10;2022-10-10;0;0;0;0;0;0;0;0;0;0;0;0;0;0;0;0;0;0
FR;10;2022-10-11;0;0;0;0;0;0;0;0;0;0;0;0;0;0;0;0;0;0
FR;10;2022-10-12;0;0;0;0;0;0;0;0;0;0;0;0;0;0;0;0;0;0
FR;10;2022-10-13;0;0;0;0;0;0;0;0;0;0;0;0;0;0;0;0;0;0
FR;10;2022-10-14;0;0;0;0;0;0;0;0;0;0;0;0;0;0;0;0;0;0
FR;10;2022-10-15;0;0;0;0;0;0;0;0;0;0;0;0;0;0;0;0;0;0
FR;10;2022-10-16;0;0;0;0;0;0;0;0;0;0;0;0;0;0;0;0;0;0
FR;10;2022-10-17;0;0;0;0;0;0;0;0;0;0;0;0;0;0;0;0;0;0
FR;10;2022-10-18;0;0;0;0;0;0;0;0;0;0;0;0;0;0;0;0;0;0
FR;10;2022-10-19;0;0;0;0;0;0;0;0;0;0;0;0;0;0;0;0;0;0
FR;10;2022-10-20;0;0;0;0;0;0;0;0;0;0;0;0;0;0;0;0;0;0
FR;10;2022-10-21;0;0;0;0;0;0;0;0;0;0;0;0;0;0;0;0;0;0
FR;10;2022-10-22;0;0;0;0;0;0;0;0;0;0;0;0;0;0;0;0;0;0
FR;10;2022-10-23;0;0;0;0;0;0;0;0;0;0;0;0;0;0;0;0;0;0
FR;10;2022-10-24;0;0;0;0;0;0;0;0;0;0;0;0;0;0;0;0;0;0
FR;10;2022-10-25;0;0;0;0;0;0;0;0;0;0;0;0;0;0;0;0;0;0
FR;10;2022-10-26;0;0;0;0;0;0;0;0;0;0;0;0;0;0;0;0;0;0
FR;10;2022-10-27;0;0;0;0;0;0;0;0;0;0;0;0;0;0;0;0;0;0
FR;10;2022-10-28;0;0;0;0;0;0;0;0;0;0;0;0;0;0;0;0;0;0
FR;10;2022-10-29;0;0;0;0;0;0;0;0;0;0;0;0;0;0;0;0;0;0
FR;10;2022-10-30;0;0;0;0;0;0;0;0;0;0;0;0;0;0;0;0;0;0
FR;10;2022-10-31;0;0;0;0;0;0;0;0;0;0;0;0;0;0;0;0;0;0
FR;10;2022-11-01;0;0;0;0;0;0;0;0;0;0;0;0;0;0;0;0;0;0
FR;10;2022-11-02;0;0;0;0;0;0;0;0;0;0;0;0;0;0;0;0;0;0
FR;10;2022-11-03;0;0;0;0;0;0;0;0;0;0;0;0;0;0;0;0;0;0
FR;10;2022-11-04;0;0;0;0;0;0;0;0;0;0;0;0;0;0;0;0;0;0
FR;10;2022-11-05;0;0;0;0;0;0;0;0;0;0;0;0;0;0;0;0;0;0
FR;10;2022-11-06;0;0;0;0;0;0;0;0;0;0;0;0;0;0;0;0;0;0
FR;10;2022-11-07;0;0;0;0;0;0;0;0;0;0;0;0;0;0;0;0;0;0
FR;10;2022-11-08;0;0;0;0;0;0;0;0;0;0;0;0;0;0;0;0;0;0
FR;10;2022-11-09;0;0;0;0;0;0;0;0;0;0;0;0;0;0;0;0;0;0
FR;10;2022-11-10;0;0;0;0;0;0;0;0;0;0;0;0;0;0;0;0;0;0
FR;10;2022-11-11;0;0;0;0;0;0;0;0;0;0;0;0;0;0;0;0;0;0
FR;10;2022-11-12;0;0;0;0;0;0;0;0;0;0;0;0;0;0;0;0;0;0
FR;10;2022-11-13;0;0;0;0;0;0;0;0;0;0;0;0;0;0;0;0;0;0
FR;10;2022-11-14;0;0;0;0;0;0;0;0;0;0;0;0;0;0;0;0;0;0
FR;10;2022-11-15;0;0;0;0;0;0;0;0;0;0;0;0;0;0;0;0;0;0
FR;10;2022-11-16;0;0;0;0;0;0;0;0;0;0;0;0;0;0;0;0;0;0
FR;10;2022-11-17;0;0;0;0;0;0;0;0;0;0;0;0;0;0;0;0;0;0
FR;10;2022-11-18;0;0;0;0;0;0;0;0;0;0;0;0;0;0;0;0;0;0
FR;10;2022-11-19;0;0;0;0;0;0;0;0;0;0;0;0;0;0;0;0;0;0
FR;10;2022-11-20;0;0;0;0;0;0;0;0;0;0;0;0;0;0;0;0;0;0
FR;10;2022-11-21;0;0;0;0;0;0;0;0;0;0;0;0;0;0;0;0;0;0
FR;10;2022-11-22;0;0;0;0;0;0;0;0;0;0;0;0;0;0;0;0;0;0
FR;10;2022-11-23;0;0;0;0;0;0;0;0;0;0;0;0;0;0;0;0;0;0
FR;10;2022-11-24;0;0;0;0;0;0;0;0;0;0;0;0;0;0;0;0;0;0
FR;10;2022-11-25;0;0;0;0;0;0;0;0;0;0;0;0;0;0;0;0;0;0
FR;10;2022-11-26;0;0;0;0;0;0;0;0;0;0;0;0;0;0;0;0;0;0
FR;10;2022-11-27;0;0;0;0;0;0;0;0;0;0;0;0;0;0;0;0;0;0
FR;10;2022-11-28;0;0;0;0;0;0;0;0;0;0;0;0;0;0;0;0;0;0
FR;10;2022-11-29;0;0;0;0;0;0;0;0;0;0;0;0;0;0;0;0;0;0
FR;10;2022-11-30;0;0;0;0;0;0;0;0;0;0;0;0;0;0;0;0;0;0
FR;10;2022-12-01;0;0;0;0;0;0;0;0;0;0;0;0;0;0;0;0;0;0
FR;10;2022-12-02;0;0;0;0;0;0;0;0;0;0;0;0;0;0;0;0;0;0
FR;10;2022-12-03;0;0;0;0;0;0;0;0;0;0;0;0;0;0;0;0;0;0
FR;10;2022-12-04;0;0;0;0;0;0;0;0;0;0;0;0;0;0;0;0;0;0
FR;10;2022-12-05;0;0;0;0;0;0;0;0;0;0;0;0;0;0;0;0;0;0
FR;10;2022-12-06;0;0;0;0;0;0;0;0;0;0;0;0;0;0;0;0;0;0
FR;10;2022-12-07;0;0;0;0;0;0;0;0;0;0;0;0;0;0;0;0;0;0
FR;10;2022-12-08;0;0;0;0;0;0;0;0;0;0;0;0;0;0;0;0;0;0
FR;10;2022-12-09;0;0;0;0;0;0;0;0;0;0;0;0;0;0;0;0;0;0
FR;10;2022-12-10;0;0;0;0;0;0;0;0;0;0;0;0;0;0;0;0;0;0
FR;10;2022-12-11;0;0;0;0;0;0;0;0;0;0;0;0;0;0;0;0;0;0
FR;10;2022-12-12;0;0;0;0;0;0;0;0;0;0;0;0;0;0;0;0;0;0
FR;10;2022-12-13;0;0;0;0;0;0;0;0;0;0;0;0;0;0;0;0;0;0
FR;10;2022-12-14;0;0;0;0;0;0;0;0;0;0;0;0;0;0;0;0;0;0
FR;10;2022-12-15;0;0;0;0;0;0;0;0;0;0;0;0;0;0;0;0;0;0
FR;10;2022-12-16;0;0;0;0;0;0;0;0;0;0;0;0;0;0;0;0;0;0
FR;10;2022-12-17;0;0;0;0;0;0;0;0;0;0;0;0;0;0;0;0;0;0
FR;10;2022-12-18;0;0;0;0;0;0;0;0;0;0;0;0;0;0;0;0;0;0
FR;10;2022-12-19;0;0;0;0;0;0;0;0;0;0;0;0;0;0;0;0;0;0
FR;10;2022-12-20;0;0;0;0;0;0;0;0;0;0;0;0;0;0;0;0;0;0
FR;10;2022-12-21;0;0;1;0;0;1;0;0;0;0;0;1;0;0;1;0;0;0
FR;10;2022-12-22;0;0;0;1;0;0;1;0;0;0;0;1;1;0;1;1;0;0
FR;10;2022-12-23;0;0;1;14;0;2;14;0;7;0;0;2;15;0;3;15;0;7
FR;10;2022-12-24;0;0;0;3;0;0;3;0;1;0;0;2;18;0;3;18;0;8
FR;10;2022-12-25;0;0;0;0;0;0;0;0;0;0;0;2;18;0;3;18;0;8
FR;10;2022-12-26;3;1;11;35;0;8;39;0;5;3;1;13;53;0;11;57;0;13
FR;10;2022-12-27;1;1;14;35;1;11;38;0;10;4;2;27;88;1;22;95;0;23
FR;10;2022-12-28;0;0;2;15;0;1;14;0;3;4;2;29;103;1;23;109;0;26
FR;10;2022-12-29;0;0;6;48;0;1;48;0;17;4;2;35;151;1;24;157;0;43
FR;10;2022-12-30;0;1;5;33;0;8;31;0;6;4;3;40;184;1;32;188;0;49
FR;10;2022-12-31;0;0;3;12;0;4;10;0;4;4;3;43;196;1;36;198;0;53
FR;10;2023-01-01;0;0;1;6;0;0;7;0;2;4;3;44;202;1;36;205;0;55
FR;10;2023-01-02;0;4;4;37;1;6;36;0;21;4;7;48;239;2;42;241;0;76
FR;10;2023-01-03;1;2;6;63;2;5;64;0;25;5;9;54;302;4;47;305;0;101
FR;10;2023-01-04;0;1;7;52;0;6;53;0;53;5;10;61;354;4;53;358;0;154
FR;10;2023-01-05;1;2;15;74;0;11;76;0;37;6;12;76;428;4;64;434;0;191
FR;10;2023-01-06;2;3;16;107;2;13;107;0;52;8;15;92;535;6;77;541;0;243
FR;10;2023-01-07;3;1;3;41;1;3;40;0;13;11;16;95;576;7;80;581;0;256
FR;10;2023-01-08;1;0;0;9;0;0;7;0;5;12;16;95;585;7;80;588;0;261
FR;10;2023-01-09;3;2;7;67;1;7;66;0;26;15;18;102;652;8;87;654;0;287
FR;10;2023-01-10;6;1;21;118;0;13;124;0;57;21;19;123;770;8;100;778;0;344
FR;10;2023-01-11;5;4;19;77;1;16;79;0;38;26;23;142;847;9;116;857;0;382
FR;10;2023-01-12;13;1;7;77;2;3;80;0;51;39;24;149;924;11;119;937;0;433
FR;10;2023-01-13;0;6;15;122;1;8;129;0;77;39;30;164;1046;12;127;1066;0;510
FR;10;2023-01-14;2;1;8;43;0;5;47;0;3;41;31;172;1089;12;132;1113;0;513
FR;10;2023-01-15;0;0;2;10;0;1;7;0;8;41;31;174;1099;12;133;1120;0;521
FR;10;2023-01-16;0;1;11;70;1;7;73;0;68;41;32;185;1169;13;140;1193;0;589
FR;10;2023-01-17;0;7;22;109;2;11;118;0;61;41;39;207;1278;15;151;1311;0;650
FR;10;2023-01-18;2;1;13;92;1;9;104;0;15;43;40;220;1370;16;160;1415;0;665
FR;10;2023-01-19;6;6;24;142;3;22;135;0;56;49;46;244;1512;19;182;1550;0;721
FR;10;2023-01-20;2;1;11;111;0;9;106;0;73;51;47;255;1623;19;191;1656;0;794
FR;10;2023-01-21;2;1;5;26;0;5;23;0;15;53;48;260;1649;19;196;1679;0;809
FR;10;2023-01-22;0;0;0;5;0;0;5;0;0;53;48;260;1654;19;196;1684;0;809
FR;10;2023-01-23;1;2;5;62;1;5;59;0;23;54;50;265;1716;20;201;1743;0;832
FR;10;2023-01-24;6;6;27;148;2;19;152;0;75;60;56;292;1864;22;220;1895;0;907
FR;10;2023-01-25;2;1;9;81;1;5;82;0;55;62;57;301;1945;23;225;1977;0;962
FR;10;2023-01-26;4;5;33;147;1;22;159;0;52;66;62;334;2092;24;247;2136;0;1014
FR;10;2023-01-27;1;1;16;117;1;6;118;0;78;67;63;350;2209;25;253;2254;0;1092
FR;10;2023-01-28;0;1;3;18;1;1;21;0;15;67;64;353;2227;26;254;2275;0;1107
FR;10;2023-01-29;0;0;1;0;0;1;0;0;1;67;64;354;2227;26;255;2275;0;1108
FR;10;2023-01-30;2;1;11;60;1;5;63;0;40;69;65;365;2287;27;260;2338;0;1148
FR;10;2023-01-31;5;2;24;121;3;17;121;0;51;74;67;389;2408;30;277;2459;0;1199
FR;10;2023-02-01;0;2;11;49;2;10;49;0;28;74;69;400;2457;32;287;2508;0;1227
FR;10;2023-02-02;3;0;21;104;0;16;108;0;47;77;69;421;2561;32;303;2616;0;1274
FR;10;2023-02-03;6;5;18;48;4;11;51;0;64;83;74;439;2609;36;314;2667;0;1338
FR;10;2023-02-04;1;0;1;8;0;0;10;0;6;84;74;440;2617;36;314;2677;0;1344
FR;10;2023-02-05;7;1;2;3;2;1;4;0;5;91;75;442;2620;38;315;2681;0;1349
FR;10;2023-02-06;1;0;9;28;0;8;22;0;46;92;75;451;2648;38;323;2703;0;1395
FR;10;2023-02-07;2;2;2;12;1;3;12;0;13;94;77;453;2660;39;326;2715;0;1408
FR;10;2023-02-08;1;3;3;15;2;4;15;0;12;95;80;456;2675;41;330;2730;0;1420
FR;10;2023-02-09;2;1;11;91;2;7;97;0;41;97;81;467;2766;43;337;2827;0;1461
FR;10;2023-02-10;8;3;12;29;0;6;37;0;25;105;84;479;2795;43;343;2864;0;1486
FR;10;2023-02-11;1;0;2;2;0;2;2;0;1;106;84;481;2797;43;345;2866;0;1487
FR;10;2023-02-12;1;1;0;0;1;0;0;0;0;107;85;481;2797;44;345;2866;0;1487
FR;10;2023-02-13;3;1;9;15;0;7;18;0;10;110;86;490;2812;44;352;2884;0;1497
FR;10;2023-02-14;2;4;11;49;3;9;50;0;17;112;90;501;2861;47;361;2934;0;1514
FR;10;2023-02-15;7;3;2;10;2;3;8;0;8;119;93;503;2871;49;364;2942;0;1522
FR;10;2023-02-16;0;0;8;17;0;5;18;0;8;119;93;511;2888;49;369;2960;0;1530
FR;10;2023-02-17;13;5;7;28;5;2;22;0;17;132;98;518;2916;54;371;2982;0;1547
FR;10;2023-02-18;2;0;3;11;0;3;10;0;6;134;98;521;2927;54;374;2992;0;1553
FR;10;2023-02-19;0;0;0;0;0;0;0;0;0;134;98;521;2927;54;374;2992;0;1553
FR;10;2023-02-20;2;1;2;25;1;1;23;0;23;136;99;523;2952;55;375;3015;0;1576
FR;10;2023-02-21;2;3;12;27;1;6;35;0;30;138;102;535;2979;56;381;3050;0;1606
FR;10;2023-02-22;5;4;2;7;3;3;6;0;1;143;106;537;2986;59;384;3056;0;1607
FR;10;2023-02-23;3;2;17;31;2;14;37;0;12;146;108;554;3017;61;398;3093;0;1619
FR;10;2023-02-24;1;2;8;27;0;5;27;0;29;147;110;562;3044;61;403;3120;0;1648
FR;10;2023-02-25;0;0;2;3;0;2;3;0;7;147;110;564;3047;61;405;3123;0;1655
FR;10;2023-02-26;0;0;0;0;0;0;0;0;0;147;110;564;3047;61;405;3123;0;1655
FR;10;2023-02-27;3;3;3;20;4;3;21;0;15;150;113;567;3067;65;408;3144;0;1670
FR;10;2023-02-28;3;2;3;10;2;1;11;0;10;153;115;570;3077;67;409;3155;0;1680
FR;10;2023-03-01;2;4;19;12;4;18;12;0;14;155;119;589;3089;71;427;3167;0;1694
FR;10;2023-03-02;2;1;10;22;2;6;22;0;31;157;120;599;3111;73;433;3189;0;1725
FR;10;2023-03-03;7;2;5;21;0;6;20;0;18;164;122;604;3132;73;439;3209;0;1743
FR;10;2023-03-04;0;1;0;6;1;0;6;0;2;164;123;604;3138;74;439;3215;0;1745
FR;10;2023-03-05;0;0;0;1;0;0;0;0;2;164;123;604;3139;74;439;3215;0;1747
FR;10;2023-03-06;2;2;8;8;3;7;9;0;8;166;125;612;3147;77;446;3224;0;1755
FR;10;2023-03-07;2;3;0;11;1;2;11;0;8;168;128;612;3158;78;448;3235;0;1763
FR;10;2023-03-08;1;4;4;20;3;3;22;0;9;169;132;616;3178;81;451;3257;0;1772
FR;10;2023-03-09;0;3;1;9;1;2;8;0;8;169;135;617;3187;82;453;3265;0;1780
FR;10;2023-03-10;1;2;1;8;2;1;9;0;9;170;137;618;3195;84;454;3274;0;1789
FR;10;2023-03-11;2;1;5;4;0;3;7;0;2;172;138;623;3199;84;457;3281;0;1791
FR;10;2023-03-12;0;0;0;0;0;0;0;0;0;172;138;623;3199;84;457;3281;0;1791
FR;10;2023-03-13;0;2;2;3;2;2;3;0;5;172;140;625;3202;86;459;3284;0;1796
FR;10;2023-03-14;2;0;6;25;0;4;27;0;21;174;140;631;3227;86;463;3311;0;1817
FR;10;2023-03-15;0;2;3;5;1;5;4;0;6;174;142;634;3232;87;468;3315;0;1823
FR;10;2023-03-16;3;1;7;12;0;5;15;0;11;177;143;641;3244;87;473;3330;0;1834
FR;10;2023-03-17;3;5;8;18;4;4;22;0;19;180;148;649;3262;91;477;3352;0;1853
FR;10;2023-03-18;0;1;1;3;0;2;2;0;3;180;149;650;3265;91;479;3354;0;1856
FR;10;2023-03-19;6;0;0;0;0;0;0;0;0;186;149;650;3265;91;479;3354;0;1856
FR;10;2023-03-20;5;4;0;12;3;1;13;0;12;191;153;650;3277;94;480;3367;0;1868
FR;10;2023-03-21;1;2;2;7;0;3;9;0;14;192;155;652;3284;94;483;3376;0;1882
FR;10;2023-03-22;0;0;3;4;0;3;3;0;3;192;155;655;3288;94;486;3379;0;1885
FR;10;2023-03-23;9;9;4;6;9;1;8;0;13;201;164;659;3294;103;487;3387;0;1898
FR;10;2023-03-24;3;3;2;14;2;1;10;0;17;204;167;661;3308;105;488;3397;0;1915
FR;10;2023-03-25;1;3;0;4;1;3;5;0;8;205;170;661;3312;106;491;3402;0;1923
FR;10;2023-03-26;1;1;0;0;1;0;0;0;0;206;171;661;3312;107;491;3402;0;1923
FR;10;2023-03-27;0;2;3;4;2;3;2;0;16;206;173;664;3316;109;494;3404;0;1939
FR;10;2023-03-28;9;8;3;5;8;1;6;0;6;215;181;667;3321;117;495;3410;0;1945
FR;10;2023-03-29;7;7;3;2;6;4;2;0;6;222;188;670;3323;123;499;3412;0;1951
FR;11;2020-12-27;0;0;0;0;0;0;0;0;0;0;0;0;0;0;0;0;0;0
FR;11;2020-12-28;0;0;0;0;0;0;0;0;0;0;0;0;0;0;0;0;0;0
FR;11;2020-12-29;0;0;0;0;0;0;0;0;0;0;0;0;0;0;0;0;0;0
FR;11;2020-12-30;0;0;0;0;0;0;0;0;0;0;0;0;0;0;0;0;0;0
FR;11;2020-12-31;0;0;0;0;0;0;0;0;0;0;0;0;0;0;0;0;0;0
FR;11;2021-01-01;0;0;0;0;0;0;0;0;0;0;0;0;0;0;0;0;0;0
FR;11;2021-01-02;0;0;0;0;0;0;0;0;0;0;0;0;0;0;0;0;0;0
FR;11;2021-01-03;0;0;0;0;0;0;0;0;0;0;0;0;0;0;0;0;0;0
FR;11;2021-01-04;0;0;0;0;0;0;0;0;0;0;0;0;0;0;0;0;0;0
FR;11;2021-01-05;0;0;0;0;0;0;0;0;0;0;0;0;0;0;0;0;0;0
FR;11;2021-01-06;0;0;0;0;0;0;0;0;0;0;0;0;0;0;0;0;0;0
FR;11;2021-01-07;0;0;0;0;0;0;0;0;0;0;0;0;0;0;0;0;0;0
FR;11;2021-01-08;0;0;0;0;0;0;0;0;0;0;0;0;0;0;0;0;0;0
FR;11;2021-01-09;0;0;0;0;0;0;0;0;0;0;0;0;0;0;0;0;0;0
FR;11;2021-01-10;0;0;0;0;0;0;0;0;0;0;0;0;0;0;0;0;0;0
FR;11;2021-01-11;0;0;0;0;0;0;0;0;0;0;0;0;0;0;0;0;0;0
FR;11;2021-01-12;0;0;0;0;0;0;0;0;0;0;0;0;0;0;0;0;0;0
FR;11;2021-01-13;0;0;0;0;0;0;0;0;0;0;0;0;0;0;0;0;0;0
FR;11;2021-01-14;0;0;0;0;0;0;0;0;0;0;0;0;0;0;0;0;0;0
FR;11;2021-01-15;0;0;0;0;0;0;0;0;0;0;0;0;0;0;0;0;0;0
FR;11;2021-01-16;0;0;0;0;0;0;0;0;0;0;0;0;0;0;0;0;0;0
FR;11;2021-01-17;0;0;0;0;0;0;0;0;0;0;0;0;0;0;0;0;0;0
FR;11;2021-01-18;0;0;0;0;0;0;0;0;0;0;0;0;0;0;0;0;0;0
FR;11;2021-01-19;0;0;0;0;0;0;0;0;0;0;0;0;0;0;0;0;0;0
FR;11;2021-01-20;0;0;0;0;0;0;0;0;0;0;0;0;0;0;0;0;0;0
FR;11;2021-01-21;0;0;0;0;0;0;0;0;0;0;0;0;0;0;0;0;0;0
FR;11;2021-01-22;0;0;0;0;0;0;0;0;0;0;0;0;0;0;0;0;0;0
FR;11;2021-01-23;0;0;0;0;0;0;0;0;0;0;0;0;0;0;0;0;0;0
FR;11;2021-01-24;0;0;0;0;0;0;0;0;0;0;0;0;0;0;0;0;0;0
FR;11;2021-01-25;0;0;0;0;0;0;0;0;0;0;0;0;0;0;0;0;0;0
FR;11;2021-01-26;0;0;0;0;0;0;0;0;0;0;0;0;0;0;0;0;0;0
FR;11;2021-01-27;0;0;0;0;0;0;0;0;0;0;0;0;0;0;0;0;0;0
FR;11;2021-01-28;0;0;0;0;0;0;0;0;0;0;0;0;0;0;0;0;0;0
FR;11;2021-01-29;0;0;0;0;0;0;0;0;0;0;0;0;0;0;0;0;0;0
FR;11;2021-01-30;0;0;0;0;0;0;0;0;0;0;0;0;0;0;0;0;0;0
FR;11;2021-01-31;0;0;0;0;0;0;0;0;0;0;0;0;0;0;0;0;0;0
FR;11;2021-02-01;0;0;0;0;0;0;0;0;0;0;0;0;0;0;0;0;0;0
FR;11;2021-02-02;0;0;0;0;0;0;0;0;0;0;0;0;0;0;0;0;0;0
FR;11;2021-02-03;0;0;0;0;0;0;0;0;0;0;0;0;0;0;0;0;0;0
FR;11;2021-02-04;0;0;0;0;0;0;0;0;0;0;0;0;0;0;0;0;0;0
FR;11;2021-02-05;0;0;0;0;0;0;0;0;0;0;0;0;0;0;0;0;0;0
FR;11;2021-02-06;0;0;0;0;0;0;0;0;0;0;0;0;0;0;0;0;0;0
FR;11;2021-02-07;0;0;0;0;0;0;0;0;0;0;0;0;0;0;0;0;0;0
FR;11;2021-02-08;0;0;0;0;0;0;0;0;0;0;0;0;0;0;0;0;0;0
FR;11;2021-02-09;0;0;0;0;0;0;0;0;0;0;0;0;0;0;0;0;0;0
FR;11;2021-02-10;0;0;0;0;0;0;0;0;0;0;0;0;0;0;0;0;0;0
FR;11;2021-02-11;0;0;0;0;0;0;0;0;0;0;0;0;0;0;0;0;0;0
FR;11;2021-02-12;0;0;0;0;0;0;0;0;0;0;0;0;0;0;0;0;0;0
FR;11;2021-02-13;0;0;0;0;0;0;0;0;0;0;0;0;0;0;0;0;0;0
FR;11;2021-02-14;0;0;0;0;0;0;0;0;0;0;0;0;0;0;0;0;0;0
FR;11;2021-02-15;0;0;0;0;0;0;0;0;0;0;0;0;0;0;0;0;0;0
FR;11;2021-02-16;0;0;0;0;0;0;0;0;0;0;0;0;0;0;0;0;0;0
FR;11;2021-02-17;0;0;0;0;0;0;0;0;0;0;0;0;0;0;0;0;0;0
FR;11;2021-02-18;0;0;0;0;0;0;0;0;0;0;0;0;0;0;0;0;0;0
FR;11;2021-02-19;0;0;0;0;0;0;0;0;0;0;0;0;0;0;0;0;0;0
FR;11;2021-02-20;0;0;0;0;0;0;0;0;0;0;0;0;0;0;0;0;0;0
FR;11;2021-02-21;0;0;0;0;0;0;0;0;0;0;0;0;0;0;0;0;0;0
FR;11;2021-02-22;0;0;0;0;0;0;0;0;0;0;0;0;0;0;0;0;0;0
FR;11;2021-02-23;0;0;0;0;0;0;0;0;0;0;0;0;0;0;0;0;0;0
FR;11;2021-02-24;0;0;0;0;0;0;0;0;0;0;0;0;0;0;0;0;0;0
FR;11;2021-02-25;0;0;0;0;0;0;0;0;0;0;0;0;0;0;0;0;0;0
FR;11;2021-02-26;0;0;0;0;0;0;0;0;0;0;0;0;0;0;0;0;0;0
FR;11;2021-02-27;0;0;0;0;0;0;0;0;0;0;0;0;0;0;0;0;0;0
FR;11;2021-02-28;0;0;0;0;0;0;0;0;0;0;0;0;0;0;0;0;0;0
FR;11;2021-03-01;0;0;0;0;0;0;0;0;0;0;0;0;0;0;0;0;0;0
FR;11;2021-03-02;0;0;0;0;0;0;0;0;0;0;0;0;0;0;0;0;0;0
FR;11;2021-03-03;0;0;0;0;0;0;0;0;0;0;0;0;0;0;0;0;0;0
FR;11;2021-03-04;0;0;0;0;0;0;0;0;0;0;0;0;0;0;0;0;0;0
FR;11;2021-03-05;0;0;0;0;0;0;0;0;0;0;0;0;0;0;0;0;0;0
FR;11;2021-03-06;0;0;0;0;0;0;0;0;0;0;0;0;0;0;0;0;0;0
FR;11;2021-03-07;0;0;0;0;0;0;0;0;0;0;0;0;0;0;0;0;0;0
FR;11;2021-03-08;0;0;0;0;0;0;0;0;0;0;0;0;0;0;0;0;0;0
FR;11;2021-03-09;0;0;0;0;0;0;0;0;0;0;0;0;0;0;0;0;0;0
FR;11;2021-03-10;0;0;0;0;0;0;0;0;0;0;0;0;0;0;0;0;0;0
FR;11;2021-03-11;0;0;0;0;0;0;0;0;0;0;0;0;0;0;0;0;0;0
FR;11;2021-03-12;0;0;0;0;0;0;0;0;0;0;0;0;0;0;0;0;0;0
FR;11;2021-03-13;0;0;0;0;0;0;0;0;0;0;0;0;0;0;0;0;0;0
FR;11;2021-03-14;0;0;0;0;0;0;0;0;0;0;0;0;0;0;0;0;0;0
FR;11;2021-03-15;0;0;0;0;0;0;0;0;0;0;0;0;0;0;0;0;0;0
FR;11;2021-03-16;0;0;0;0;0;0;0;0;0;0;0;0;0;0;0;0;0;0
FR;11;2021-03-17;0;0;0;0;0;0;0;0;0;0;0;0;0;0;0;0;0;0
FR;11;2021-03-18;0;0;0;0;0;0;0;0;0;0;0;0;0;0;0;0;0;0
FR;11;2021-03-19;0;0;0;0;0;0;0;0;0;0;0;0;0;0;0;0;0;0
FR;11;2021-03-20;0;0;0;0;0;0;0;0;0;0;0;0;0;0;0;0;0;0
FR;11;2021-03-21;0;0;0;0;0;0;0;0;0;0;0;0;0;0;0;0;0;0
FR;11;2021-03-22;0;0;0;0;0;0;0;0;0;0;0;0;0;0;0;0;0;0
FR;11;2021-03-23;0;0;0;0;0;0;0;0;0;0;0;0;0;0;0;0;0;0
FR;11;2021-03-24;0;0;0;0;0;0;0;0;0;0;0;0;0;0;0;0;0;0
FR;11;2021-03-25;0;0;0;0;0;0;0;0;0;0;0;0;0;0;0;0;0;0
FR;11;2021-03-26;0;0;0;0;0;0;0;0;0;0;0;0;0;0;0;0;0;0
FR;11;2021-03-27;0;0;0;0;0;0;0;0;0;0;0;0;0;0;0;0;0;0
FR;11;2021-03-28;0;0;0;0;0;0;0;0;0;0;0;0;0;0;0;0;0;0
FR;11;2021-03-29;0;0;0;0;0;0;0;0;0;0;0;0;0;0;0;0;0;0
FR;11;2021-03-30;0;0;0;0;0;0;0;0;0;0;0;0;0;0;0;0;0;0
FR;11;2021-03-31;0;0;0;0;0;0;0;0;0;0;0;0;0;0;0;0;0;0
FR;11;2021-04-01;0;0;0;0;0;0;0;0;0;0;0;0;0;0;0;0;0;0
FR;11;2021-04-02;0;0;0;0;0;0;0;0;0;0;0;0;0;0;0;0;0;0
FR;11;2021-04-03;0;0;0;0;0;0;0;0;0;0;0;0;0;0;0;0;0;0
FR;11;2021-04-04;0;0;0;0;0;0;0;0;0;0;0;0;0;0;0;0;0;0
FR;11;2021-04-05;0;0;0;0;0;0;0;0;0;0;0;0;0;0;0;0;0;0
FR;11;2021-04-06;0;0;0;0;0;0;0;0;0;0;0;0;0;0;0;0;0;0
FR;11;2021-04-07;0;0;0;0;0;0;0;0;0;0;0;0;0;0;0;0;0;0
FR;11;2021-04-08;0;0;0;0;0;0;0;0;0;0;0;0;0;0;0;0;0;0
FR;11;2021-04-09;0;0;0;0;0;0;0;0;0;0;0;0;0;0;0;0;0;0
FR;11;2021-04-10;0;0;0;0;0;0;0;0;0;0;0;0;0;0;0;0;0;0
FR;11;2021-04-11;0;0;0;0;0;0;0;0;0;0;0;0;0;0;0;0;0;0
FR;11;2021-04-12;0;0;0;0;0;0;0;0;0;0;0;0;0;0;0;0;0;0
FR;11;2021-04-13;0;0;0;0;0;0;0;0;0;0;0;0;0;0;0;0;0;0
FR;11;2021-04-14;0;0;0;0;0;0;0;0;0;0;0;0;0;0;0;0;0;0
FR;11;2021-04-15;0;0;0;0;0;0;0;0;0;0;0;0;0;0;0;0;0;0
FR;11;2021-04-16;0;0;0;0;0;0;0;0;0;0;0;0;0;0;0;0;0;0
FR;11;2021-04-17;0;0;0;0;0;0;0;0;0;0;0;0;0;0;0;0;0;0
FR;11;2021-04-18;0;0;0;0;0;0;0;0;0;0;0;0;0;0;0;0;0;0
FR;11;2021-04-19;0;0;0;0;0;0;0;0;0;0;0;0;0;0;0;0;0;0
FR;11;2021-04-20;0;0;0;0;0;0;0;0;0;0;0;0;0;0;0;0;0;0
FR;11;2021-04-21;0;0;0;0;0;0;0;0;0;0;0;0;0;0;0;0;0;0
FR;11;2021-04-22;0;0;0;0;0;0;0;0;0;0;0;0;0;0;0;0;0;0
FR;11;2021-04-23;0;0;0;0;0;0;0;0;0;0;0;0;0;0;0;0;0;0
FR;11;2021-04-24;0;0;0;0;0;0;0;0;0;0;0;0;0;0;0;0;0;0
FR;11;2021-04-25;0;0;0;0;0;0;0;0;0;0;0;0;0;0;0;0;0;0
FR;11;2021-04-26;0;0;0;0;0;0;0;0;0;0;0;0;0;0;0;0;0;0
FR;11;2021-04-27;0;0;0;0;0;0;0;0;0;0;0;0;0;0;0;0;0;0
FR;11;2021-04-28;0;0;0;0;0;0;0;0;0;0;0;0;0;0;0;0;0;0
FR;11;2021-04-29;0;0;0;0;0;0;0;0;0;0;0;0;0;0;0;0;0;0
FR;11;2021-04-30;0;0;0;0;0;0;0;0;0;0;0;0;0;0;0;0;0;0
FR;11;2021-05-01;0;0;0;0;0;0;0;0;0;0;0;0;0;0;0;0;0;0
FR;11;2021-05-02;0;0;0;0;0;0;0;0;0;0;0;0;0;0;0;0;0;0
FR;11;2021-05-03;0;0;0;0;0;0;0;0;0;0;0;0;0;0;0;0;0;0
FR;11;2021-05-04;0;0;0;0;0;0;0;0;0;0;0;0;0;0;0;0;0;0
FR;11;2021-05-05;0;0;0;0;0;0;0;0;0;0;0;0;0;0;0;0;0;0
FR;11;2021-05-06;0;0;0;0;0;0;0;0;0;0;0;0;0;0;0;0;0;0
FR;11;2021-05-07;0;0;0;0;0;0;0;0;0;0;0;0;0;0;0;0;0;0
FR;11;2021-05-08;0;0;0;0;0;0;0;0;0;0;0;0;0;0;0;0;0;0
FR;11;2021-05-09;0;0;0;0;0;0;0;0;0;0;0;0;0;0;0;0;0;0
FR;11;2021-05-10;0;0;0;0;0;0;0;0;0;0;0;0;0;0;0;0;0;0
FR;11;2021-05-11;0;0;0;0;0;0;0;0;0;0;0;0;0;0;0;0;0;0
FR;11;2021-05-12;0;0;0;0;0;0;0;0;0;0;0;0;0;0;0;0;0;0
FR;11;2021-05-13;0;0;0;0;0;0;0;0;0;0;0;0;0;0;0;0;0;0
FR;11;2021-05-14;0;0;0;0;0;0;0;0;0;0;0;0;0;0;0;0;0;0
FR;11;2021-05-15;0;0;0;0;0;0;0;0;0;0;0;0;0;0;0;0;0;0
FR;11;2021-05-16;0;0;0;0;0;0;0;0;0;0;0;0;0;0;0;0;0;0
FR;11;2021-05-17;0;0;0;0;0;0;0;0;0;0;0;0;0;0;0;0;0;0
FR;11;2021-05-18;0;0;0;0;0;0;0;0;0;0;0;0;0;0;0;0;0;0
FR;11;2021-05-19;0;0;0;0;0;0;0;0;0;0;0;0;0;0;0;0;0;0
FR;11;2021-05-20;0;0;0;0;0;0;0;0;0;0;0;0;0;0;0;0;0;0
FR;11;2021-05-21;0;0;0;0;0;0;0;0;0;0;0;0;0;0;0;0;0;0
FR;11;2021-05-22;0;0;0;0;0;0;0;0;0;0;0;0;0;0;0;0;0;0
FR;11;2021-05-23;0;0;0;0;0;0;0;0;0;0;0;0;0;0;0;0;0;0
FR;11;2021-05-24;0;0;0;0;0;0;0;0;0;0;0;0;0;0;0;0;0;0
FR;11;2021-05-25;0;0;0;0;0;0;0;0;0;0;0;0;0;0;0;0;0;0
FR;11;2021-05-26;0;0;0;0;0;0;0;0;0;0;0;0;0;0;0;0;0;0
FR;11;2021-05-27;0;0;0;0;0;0;0;0;0;0;0;0;0;0;0;0;0;0
FR;11;2021-05-28;0;0;0;0;0;0;0;0;0;0;0;0;0;0;0;0;0;0
FR;11;2021-05-29;0;0;0;0;0;0;0;0;0;0;0;0;0;0;0;0;0;0
FR;11;2021-05-30;0;0;0;0;0;0;0;0;0;0;0;0;0;0;0;0;0;0
FR;11;2021-05-31;0;0;0;0;0;0;0;0;0;0;0;0;0;0;0;0;0;0
FR;11;2021-06-01;0;0;0;0;0;0;0;0;0;0;0;0;0;0;0;0;0;0
FR;11;2021-06-02;0;0;0;0;0;0;0;0;0;0;0;0;0;0;0;0;0;0
FR;11;2021-06-03;0;0;0;0;0;0;0;0;0;0;0;0;0;0;0;0;0;0
FR;11;2021-06-04;0;0;0;0;0;0;0;0;0;0;0;0;0;0;0;0;0;0
FR;11;2021-06-05;0;0;0;0;0;0;0;0;0;0;0;0;0;0;0;0;0;0
FR;11;2021-06-06;0;0;0;0;0;0;0;0;0;0;0;0;0;0;0;0;0;0
FR;11;2021-06-07;0;0;0;0;0;0;0;0;0;0;0;0;0;0;0;0;0;0
FR;11;2021-06-08;0;0;0;0;0;0;0;0;0;0;0;0;0;0;0;0;0;0
FR;11;2021-06-09;0;0;0;0;0;0;0;0;0;0;0;0;0;0;0;0;0;0
FR;11;2021-06-10;0;0;0;0;0;0;0;0;0;0;0;0;0;0;0;0;0;0
FR;11;2021-06-11;0;0;0;0;0;0;0;0;0;0;0;0;0;0;0;0;0;0
FR;11;2021-06-12;0;0;0;0;0;0;0;0;0;0;0;0;0;0;0;0;0;0
FR;11;2021-06-13;0;0;0;0;0;0;0;0;0;0;0;0;0;0;0;0;0;0
FR;11;2021-06-14;0;0;0;0;0;0;0;0;0;0;0;0;0;0;0;0;0;0
FR;11;2021-06-15;0;0;0;0;0;0;0;0;0;0;0;0;0;0;0;0;0;0
FR;11;2021-06-16;0;0;0;0;0;0;0;0;0;0;0;0;0;0;0;0;0;0
FR;11;2021-06-17;0;0;0;0;0;0;0;0;0;0;0;0;0;0;0;0;0;0
FR;11;2021-06-18;0;0;0;0;0;0;0;0;0;0;0;0;0;0;0;0;0;0
FR;11;2021-06-19;0;0;0;0;0;0;0;0;0;0;0;0;0;0;0;0;0;0
FR;11;2021-06-20;0;0;0;0;0;0;0;0;0;0;0;0;0;0;0;0;0;0
FR;11;2021-06-21;0;0;0;0;0;0;0;0;0;0;0;0;0;0;0;0;0;0
FR;11;2021-06-22;0;0;0;0;0;0;0;0;0;0;0;0;0;0;0;0;0;0
FR;11;2021-06-23;0;0;0;0;0;0;0;0;0;0;0;0;0;0;0;0;0;0
FR;11;2021-06-24;0;0;0;0;0;0;0;0;0;0;0;0;0;0;0;0;0;0
FR;11;2021-06-25;0;0;0;0;0;0;0;0;0;0;0;0;0;0;0;0;0;0
FR;11;2021-06-26;0;0;0;0;0;0;0;0;0;0;0;0;0;0;0;0;0;0
FR;11;2021-06-27;0;0;0;0;0;0;0;0;0;0;0;0;0;0;0;0;0;0
FR;11;2021-06-28;0;0;0;0;0;0;0;0;0;0;0;0;0;0;0;0;0;0
FR;11;2021-06-29;0;0;0;0;0;0;0;0;0;0;0;0;0;0;0;0;0;0
FR;11;2021-06-30;0;0;0;0;0;0;0;0;0;0;0;0;0;0;0;0;0;0
FR;11;2021-07-01;0;0;0;0;0;0;0;0;0;0;0;0;0;0;0;0;0;0
FR;11;2021-07-02;0;0;0;0;0;0;0;0;0;0;0;0;0;0;0;0;0;0
FR;11;2021-07-03;0;0;0;0;0;0;0;0;0;0;0;0;0;0;0;0;0;0
FR;11;2021-07-04;0;0;0;0;0;0;0;0;0;0;0;0;0;0;0;0;0;0
FR;11;2021-07-05;0;0;0;0;0;0;0;0;0;0;0;0;0;0;0;0;0;0
FR;11;2021-07-06;0;0;0;0;0;0;0;0;0;0;0;0;0;0;0;0;0;0
FR;11;2021-07-07;0;0;0;0;0;0;0;0;0;0;0;0;0;0;0;0;0;0
FR;11;2021-07-08;0;0;0;0;0;0;0;0;0;0;0;0;0;0;0;0;0;0
FR;11;2021-07-09;0;0;0;0;0;0;0;0;0;0;0;0;0;0;0;0;0;0
FR;11;2021-07-10;0;0;0;0;0;0;0;0;0;0;0;0;0;0;0;0;0;0
FR;11;2021-07-11;0;0;0;0;0;0;0;0;0;0;0;0;0;0;0;0;0;0
FR;11;2021-07-12;0;0;0;0;0;0;0;0;0;0;0;0;0;0;0;0;0;0
FR;11;2021-07-13;0;0;0;0;0;0;0;0;0;0;0;0;0;0;0;0;0;0
FR;11;2021-07-14;0;0;0;0;0;0;0;0;0;0;0;0;0;0;0;0;0;0
FR;11;2021-07-15;0;0;0;0;0;0;0;0;0;0;0;0;0;0;0;0;0;0
FR;11;2021-07-16;0;0;0;0;0;0;0;0;0;0;0;0;0;0;0;0;0;0
FR;11;2021-07-17;0;0;0;0;0;0;0;0;0;0;0;0;0;0;0;0;0;0
FR;11;2021-07-18;0;0;0;0;0;0;0;0;0;0;0;0;0;0;0;0;0;0
FR;11;2021-07-19;0;0;0;0;0;0;0;0;0;0;0;0;0;0;0;0;0;0
FR;11;2021-07-20;0;0;0;0;0;0;0;0;0;0;0;0;0;0;0;0;0;0
FR;11;2021-07-21;0;0;0;0;0;0;0;0;0;0;0;0;0;0;0;0;0;0
FR;11;2021-07-22;0;0;0;0;0;0;0;0;0;0;0;0;0;0;0;0;0;0
FR;11;2021-07-23;0;0;0;0;0;0;0;0;0;0;0;0;0;0;0;0;0;0
FR;11;2021-07-24;0;0;0;0;0;0;0;0;0;0;0;0;0;0;0;0;0;0
FR;11;2021-07-25;0;0;0;0;0;0;0;0;0;0;0;0;0;0;0;0;0;0
FR;11;2021-07-26;0;0;0;0;0;0;0;0;0;0;0;0;0;0;0;0;0;0
FR;11;2021-07-27;0;0;0;0;0;0;0;0;0;0;0;0;0;0;0;0;0;0
FR;11;2021-07-28;0;0;0;0;0;0;0;0;0;0;0;0;0;0;0;0;0;0
FR;11;2021-07-29;0;0;0;0;0;0;0;0;0;0;0;0;0;0;0;0;0;0
FR;11;2021-07-30;0;0;0;0;0;0;0;0;0;0;0;0;0;0;0;0;0;0
FR;11;2021-07-31;0;0;0;0;0;0;0;0;0;0;0;0;0;0;0;0;0;0
FR;11;2021-08-01;0;0;0;0;0;0;0;0;0;0;0;0;0;0;0;0;0;0
FR;11;2021-08-02;0;0;0;0;0;0;0;0;0;0;0;0;0;0;0;0;0;0
FR;11;2021-08-03;0;0;0;0;0;0;0;0;0;0;0;0;0;0;0;0;0;0
FR;11;2021-08-04;0;0;0;0;0;0;0;0;0;0;0;0;0;0;0;0;0;0
FR;11;2021-08-05;0;0;0;0;0;0;0;0;0;0;0;0;0;0;0;0;0;0
FR;11;2021-08-06;0;0;0;0;0;0;0;0;0;0;0;0;0;0;0;0;0;0
FR;11;2021-08-07;0;0;0;0;0;0;0;0;0;0;0;0;0;0;0;0;0;0
FR;11;2021-08-08;0;0;0;0;0;0;0;0;0;0;0;0;0;0;0;0;0;0
FR;11;2021-08-09;0;0;0;0;0;0;0;0;0;0;0;0;0;0;0;0;0;0
FR;11;2021-08-10;0;0;0;0;0;0;0;0;0;0;0;0;0;0;0;0;0;0
FR;11;2021-08-11;0;0;0;0;0;0;0;0;0;0;0;0;0;0;0;0;0;0
FR;11;2021-08-12;0;0;0;0;0;0;0;0;0;0;0;0;0;0;0;0;0;0
FR;11;2021-08-13;0;0;0;0;0;0;0;0;0;0;0;0;0;0;0;0;0;0
FR;11;2021-08-14;0;0;0;0;0;0;0;0;0;0;0;0;0;0;0;0;0;0
FR;11;2021-08-15;0;0;0;0;0;0;0;0;0;0;0;0;0;0;0;0;0;0
FR;11;2021-08-16;0;0;0;0;0;0;0;0;0;0;0;0;0;0;0;0;0;0
FR;11;2021-08-17;0;0;0;0;0;0;0;0;0;0;0;0;0;0;0;0;0;0
FR;11;2021-08-18;0;0;0;0;0;0;0;0;0;0;0;0;0;0;0;0;0;0
FR;11;2021-08-19;0;0;0;0;0;0;0;0;0;0;0;0;0;0;0;0;0;0
FR;11;2021-08-20;0;0;0;0;0;0;0;0;0;0;0;0;0;0;0;0;0;0
FR;11;2021-08-21;0;0;0;0;0;0;0;0;0;0;0;0;0;0;0;0;0;0
FR;11;2021-08-22;0;0;0;0;0;0;0;0;0;0;0;0;0;0;0;0;0;0
FR;11;2021-08-23;0;0;0;0;0;0;0;0;0;0;0;0;0;0;0;0;0;0
FR;11;2021-08-24;0;0;0;0;0;0;0;0;0;0;0;0;0;0;0;0;0;0
FR;11;2021-08-25;0;0;0;0;0;0;0;0;0;0;0;0;0;0;0;0;0;0
FR;11;2021-08-26;0;0;0;0;0;0;0;0;0;0;0;0;0;0;0;0;0;0
FR;11;2021-08-27;0;0;0;0;0;0;0;0;0;0;0;0;0;0;0;0;0;0
FR;11;2021-08-28;0;0;0;0;0;0;0;0;0;0;0;0;0;0;0;0;0;0
FR;11;2021-08-29;0;0;0;0;0;0;0;0;0;0;0;0;0;0;0;0;0;0
FR;11;2021-08-30;0;0;0;0;0;0;0;0;0;0;0;0;0;0;0;0;0;0
FR;11;2021-08-31;0;0;0;0;0;0;0;0;0;0;0;0;0;0;0;0;0;0
FR;11;2021-09-01;0;0;0;0;0;0;0;0;0;0;0;0;0;0;0;0;0;0
FR;11;2021-09-02;0;0;0;0;0;0;0;0;0;0;0;0;0;0;0;0;0;0
FR;11;2021-09-03;0;0;0;0;0;0;0;0;0;0;0;0;0;0;0;0;0;0
FR;11;2021-09-04;0;0;0;0;0;0;0;0;0;0;0;0;0;0;0;0;0;0
FR;11;2021-09-05;0;0;0;0;0;0;0;0;0;0;0;0;0;0;0;0;0;0
FR;11;2021-09-06;0;0;0;0;0;0;0;0;0;0;0;0;0;0;0;0;0;0
FR;11;2021-09-07;0;0;0;0;0;0;0;0;0;0;0;0;0;0;0;0;0;0
FR;11;2021-09-08;0;0;0;0;0;0;0;0;0;0;0;0;0;0;0;0;0;0
FR;11;2021-09-09;0;0;0;0;0;0;0;0;0;0;0;0;0;0;0;0;0;0
FR;11;2021-09-10;0;0;0;0;0;0;0;0;0;0;0;0;0;0;0;0;0;0
FR;11;2021-09-11;0;0;0;0;0;0;0;0;0;0;0;0;0;0;0;0;0;0
FR;11;2021-09-12;0;0;0;0;0;0;0;0;0;0;0;0;0;0;0;0;0;0
FR;11;2021-09-13;0;0;0;0;0;0;0;0;0;0;0;0;0;0;0;0;0;0
FR;11;2021-09-14;0;0;0;0;0;0;0;0;0;0;0;0;0;0;0;0;0;0
FR;11;2021-09-15;0;0;0;0;0;0;0;0;0;0;0;0;0;0;0;0;0;0
FR;11;2021-09-16;0;0;0;0;0;0;0;0;0;0;0;0;0;0;0;0;0;0
FR;11;2021-09-17;0;0;0;0;0;0;0;0;0;0;0;0;0;0;0;0;0;0
FR;11;2021-09-18;0;0;0;0;0;0;0;0;0;0;0;0;0;0;0;0;0;0
FR;11;2021-09-19;0;0;0;0;0;0;0;0;0;0;0;0;0;0;0;0;0;0
FR;11;2021-09-20;0;0;0;0;0;0;0;0;0;0;0;0;0;0;0;0;0;0
FR;11;2021-09-21;0;0;0;0;0;0;0;0;0;0;0;0;0;0;0;0;0;0
FR;11;2021-09-22;0;0;0;0;0;0;0;0;0;0;0;0;0;0;0;0;0;0
FR;11;2021-09-23;0;0;0;0;0;0;0;0;0;0;0;0;0;0;0;0;0;0
FR;11;2021-09-24;0;0;0;0;0;0;0;0;0;0;0;0;0;0;0;0;0;0
FR;11;2021-09-25;0;0;0;0;0;0;0;0;0;0;0;0;0;0;0;0;0;0
FR;11;2021-09-26;0;0;0;0;0;0;0;0;0;0;0;0;0;0;0;0;0;0
FR;11;2021-09-27;0;0;0;0;0;0;0;0;0;0;0;0;0;0;0;0;0;0
FR;11;2021-09-28;0;0;0;0;0;0;0;0;0;0;0;0;0;0;0;0;0;0
FR;11;2021-09-29;0;0;0;0;0;0;0;0;0;0;0;0;0;0;0;0;0;0
FR;11;2021-09-30;0;0;0;0;0;0;0;0;0;0;0;0;0;0;0;0;0;0
FR;11;2021-10-01;0;0;0;0;0;0;0;0;0;0;0;0;0;0;0;0;0;0
FR;11;2021-10-02;0;0;0;0;0;0;0;0;0;0;0;0;0;0;0;0;0;0
FR;11;2021-10-03;0;0;0;0;0;0;0;0;0;0;0;0;0;0;0;0;0;0
FR;11;2021-10-04;0;0;0;0;0;0;0;0;0;0;0;0;0;0;0;0;0;0
FR;11;2021-10-05;0;0;0;0;0;0;0;0;0;0;0;0;0;0;0;0;0;0
FR;11;2021-10-06;0;0;0;0;0;0;0;0;0;0;0;0;0;0;0;0;0;0
FR;11;2021-10-07;0;0;0;0;0;0;0;0;0;0;0;0;0;0;0;0;0;0
FR;11;2021-10-08;0;0;0;0;0;0;0;0;0;0;0;0;0;0;0;0;0;0
FR;11;2021-10-09;0;0;0;0;0;0;0;0;0;0;0;0;0;0;0;0;0;0
FR;11;2021-10-10;0;0;0;0;0;0;0;0;0;0;0;0;0;0;0;0;0;0
FR;11;2021-10-11;0;0;0;0;0;0;0;0;0;0;0;0;0;0;0;0;0;0
FR;11;2021-10-12;0;0;0;0;0;0;0;0;0;0;0;0;0;0;0;0;0;0
FR;11;2021-10-13;0;0;0;0;0;0;0;0;0;0;0;0;0;0;0;0;0;0
FR;11;2021-10-14;0;0;0;0;0;0;0;0;0;0;0;0;0;0;0;0;0;0
FR;11;2021-10-15;0;0;0;0;0;0;0;0;0;0;0;0;0;0;0;0;0;0
FR;11;2021-10-16;0;0;0;0;0;0;0;0;0;0;0;0;0;0;0;0;0;0
FR;11;2021-10-17;0;0;0;0;0;0;0;0;0;0;0;0;0;0;0;0;0;0
FR;11;2021-10-18;0;0;0;0;0;0;0;0;0;0;0;0;0;0;0;0;0;0
FR;11;2021-10-19;0;0;0;0;0;0;0;0;0;0;0;0;0;0;0;0;0;0
FR;11;2021-10-20;0;0;0;0;0;0;0;0;0;0;0;0;0;0;0;0;0;0
FR;11;2021-10-21;0;0;0;0;0;0;0;0;0;0;0;0;0;0;0;0;0;0
FR;11;2021-10-22;0;0;0;0;0;0;0;0;0;0;0;0;0;0;0;0;0;0
FR;11;2021-10-23;0;0;0;0;0;0;0;0;0;0;0;0;0;0;0;0;0;0
FR;11;2021-10-24;0;0;0;0;0;0;0;0;0;0;0;0;0;0;0;0;0;0
FR;11;2021-10-25;0;0;0;0;0;0;0;0;0;0;0;0;0;0;0;0;0;0
FR;11;2021-10-26;0;0;0;0;0;0;0;0;0;0;0;0;0;0;0;0;0;0
FR;11;2021-10-27;0;0;0;0;0;0;0;0;0;0;0;0;0;0;0;0;0;0
FR;11;2021-10-28;0;0;0;0;0;0;0;0;0;0;0;0;0;0;0;0;0;0
FR;11;2021-10-29;0;0;0;0;0;0;0;0;0;0;0;0;0;0;0;0;0;0
FR;11;2021-10-30;0;0;0;0;0;0;0;0;0;0;0;0;0;0;0;0;0;0
FR;11;2021-10-31;0;0;0;0;0;0;0;0;0;0;0;0;0;0;0;0;0;0
FR;11;2021-11-01;0;0;0;0;0;0;0;0;0;0;0;0;0;0;0;0;0;0
FR;11;2021-11-02;0;0;0;0;0;0;0;0;0;0;0;0;0;0;0;0;0;0
FR;11;2021-11-03;0;0;0;0;0;0;0;0;0;0;0;0;0;0;0;0;0;0
FR;11;2021-11-04;0;0;0;0;0;0;0;0;0;0;0;0;0;0;0;0;0;0
FR;11;2021-11-05;0;0;0;0;0;0;0;0;0;0;0;0;0;0;0;0;0;0
FR;11;2021-11-06;0;0;0;0;0;0;0;0;0;0;0;0;0;0;0;0;0;0
FR;11;2021-11-07;0;0;0;0;0;0;0;0;0;0;0;0;0;0;0;0;0;0
FR;11;2021-11-08;0;0;0;0;0;0;0;0;0;0;0;0;0;0;0;0;0;0
FR;11;2021-11-09;0;0;0;0;0;0;0;0;0;0;0;0;0;0;0;0;0;0
FR;11;2021-11-10;0;0;0;0;0;0;0;0;0;0;0;0;0;0;0;0;0;0
FR;11;2021-11-11;0;0;0;0;0;0;0;0;0;0;0;0;0;0;0;0;0;0
FR;11;2021-11-12;0;0;0;0;0;0;0;0;0;0;0;0;0;0;0;0;0;0
FR;11;2021-11-13;0;0;0;0;0;0;0;0;0;0;0;0;0;0;0;0;0;0
FR;11;2021-11-14;0;0;0;0;0;0;0;0;0;0;0;0;0;0;0;0;0;0
FR;11;2021-11-15;0;0;0;0;0;0;0;0;0;0;0;0;0;0;0;0;0;0
FR;11;2021-11-16;0;0;0;0;0;0;0;0;0;0;0;0;0;0;0;0;0;0
FR;11;2021-11-17;0;0;0;0;0;0;0;0;0;0;0;0;0;0;0;0;0;0
FR;11;2021-11-18;0;0;0;0;0;0;0;0;0;0;0;0;0;0;0;0;0;0
FR;11;2021-11-19;0;0;0;0;0;0;0;0;0;0;0;0;0;0;0;0;0;0
FR;11;2021-11-20;0;0;0;0;0;0;0;0;0;0;0;0;0;0;0;0;0;0
FR;11;2021-11-21;0;0;0;0;0;0;0;0;0;0;0;0;0;0;0;0;0;0
FR;11;2021-11-22;0;0;0;0;0;0;0;0;0;0;0;0;0;0;0;0;0;0
FR;11;2021-11-23;0;0;0;0;0;0;0;0;0;0;0;0;0;0;0;0;0;0
FR;11;2021-11-24;0;0;0;0;0;0;0;0;0;0;0;0;0;0;0;0;0;0
FR;11;2021-11-25;0;0;0;0;0;0;0;0;0;0;0;0;0;0;0;0;0;0
FR;11;2021-11-26;0;0;0;0;0;0;0;0;0;0;0;0;0;0;0;0;0;0
FR;11;2021-11-27;0;0;0;0;0;0;0;0;0;0;0;0;0;0;0;0;0;0
FR;11;2021-11-28;0;0;0;0;0;0;0;0;0;0;0;0;0;0;0;0;0;0
FR;11;2021-11-29;0;0;0;0;0;0;0;0;0;0;0;0;0;0;0;0;0;0
FR;11;2021-11-30;0;0;0;0;0;0;0;0;0;0;0;0;0;0;0;0;0;0
FR;11;2021-12-01;0;0;0;0;0;0;0;0;0;0;0;0;0;0;0;0;0;0
FR;11;2021-12-02;0;0;0;0;0;0;0;0;0;0;0;0;0;0;0;0;0;0
FR;11;2021-12-03;0;0;0;0;0;0;0;0;0;0;0;0;0;0;0;0;0;0
FR;11;2021-12-04;0;0;0;0;0;0;0;0;0;0;0;0;0;0;0;0;0;0
FR;11;2021-12-05;0;0;0;0;0;0;0;0;0;0;0;0;0;0;0;0;0;0
FR;11;2021-12-06;0;0;0;0;0;0;0;0;0;0;0;0;0;0;0;0;0;0
FR;11;2021-12-07;0;0;0;0;0;0;0;0;0;0;0;0;0;0;0;0;0;0
FR;11;2021-12-08;0;0;0;0;0;0;0;0;0;0;0;0;0;0;0;0;0;0
FR;11;2021-12-09;0;0;0;0;0;0;0;0;0;0;0;0;0;0;0;0;0;0
FR;11;2021-12-10;0;0;0;0;0;0;0;0;0;0;0;0;0;0;0;0;0;0
FR;11;2021-12-11;0;0;0;0;0;0;0;0;0;0;0;0;0;0;0;0;0;0
FR;11;2021-12-12;0;0;0;0;0;0;0;0;0;0;0;0;0;0;0;0;0;0
FR;11;2021-12-13;0;0;0;0;0;0;0;0;0;0;0;0;0;0;0;0;0;0
FR;11;2021-12-14;0;0;0;0;0;0;0;0;0;0;0;0;0;0;0;0;0;0
FR;11;2021-12-15;0;0;0;0;0;0;0;0;0;0;0;0;0;0;0;0;0;0
FR;11;2021-12-16;0;0;0;0;0;0;0;0;0;0;0;0;0;0;0;0;0;0
FR;11;2021-12-17;0;0;0;0;0;0;0;0;0;0;0;0;0;0;0;0;0;0
FR;11;2021-12-18;0;0;0;0;0;0;0;0;0;0;0;0;0;0;0;0;0;0
FR;11;2021-12-19;0;0;0;0;0;0;0;0;0;0;0;0;0;0;0;0;0;0
FR;11;2021-12-20;0;0;0;0;0;0;0;0;0;0;0;0;0;0;0;0;0;0
FR;11;2021-12-21;0;0;0;0;0;0;0;0;0;0;0;0;0;0;0;0;0;0
FR;11;2021-12-22;0;0;0;0;0;0;0;0;0;0;0;0;0;0;0;0;0;0
FR;11;2021-12-23;0;0;0;0;0;0;0;0;0;0;0;0;0;0;0;0;0;0
FR;11;2021-12-24;0;0;0;0;0;0;0;0;0;0;0;0;0;0;0;0;0;0
FR;11;2021-12-25;0;0;0;0;0;0;0;0;0;0;0;0;0;0;0;0;0;0
FR;11;2021-12-26;0;0;0;0;0;0;0;0;0;0;0;0;0;0;0;0;0;0
FR;11;2021-12-27;0;0;0;0;0;0;0;0;0;0;0;0;0;0;0;0;0;0
FR;11;2021-12-28;0;0;0;0;0;0;0;0;0;0;0;0;0;0;0;0;0;0
FR;11;2021-12-29;0;0;0;0;0;0;0;0;0;0;0;0;0;0;0;0;0;0
FR;11;2021-12-30;0;0;0;0;0;0;0;0;0;0;0;0;0;0;0;0;0;0
FR;11;2021-12-31;0;0;0;0;0;0;0;0;0;0;0;0;0;0;0;0;0;0
FR;11;2022-01-01;0;0;0;0;0;0;0;0;0;0;0;0;0;0;0;0;0;0
FR;11;2022-01-02;0;0;0;0;0;0;0;0;0;0;0;0;0;0;0;0;0;0
FR;11;2022-01-03;0;0;0;0;0;0;0;0;0;0;0;0;0;0;0;0;0;0
FR;11;2022-01-04;0;0;0;0;0;0;0;0;0;0;0;0;0;0;0;0;0;0
FR;11;2022-01-05;0;0;0;0;0;0;0;0;0;0;0;0;0;0;0;0;0;0
FR;11;2022-01-06;0;0;0;0;0;0;0;0;0;0;0;0;0;0;0;0;0;0
FR;11;2022-01-07;0;0;0;0;0;0;0;0;0;0;0;0;0;0;0;0;0;0
FR;11;2022-01-08;0;0;0;0;0;0;0;0;0;0;0;0;0;0;0;0;0;0
FR;11;2022-01-09;0;0;0;0;0;0;0;0;0;0;0;0;0;0;0;0;0;0
FR;11;2022-01-10;0;0;0;0;0;0;0;0;0;0;0;0;0;0;0;0;0;0
FR;11;2022-01-11;0;0;0;0;0;0;0;0;0;0;0;0;0;0;0;0;0;0
FR;11;2022-01-12;0;0;0;0;0;0;0;0;0;0;0;0;0;0;0;0;0;0
FR;11;2022-01-13;0;0;0;0;0;0;0;0;0;0;0;0;0;0;0;0;0;0
FR;11;2022-01-14;0;0;0;0;0;0;0;0;0;0;0;0;0;0;0;0;0;0
FR;11;2022-01-15;0;0;0;0;0;0;0;0;0;0;0;0;0;0;0;0;0;0
FR;11;2022-01-16;0;0;0;0;0;0;0;0;0;0;0;0;0;0;0;0;0;0
FR;11;2022-01-17;0;0;0;0;0;0;0;0;0;0;0;0;0;0;0;0;0;0
FR;11;2022-01-18;0;0;0;0;0;0;0;0;0;0;0;0;0;0;0;0;0;0
FR;11;2022-01-19;0;0;0;0;0;0;0;0;0;0;0;0;0;0;0;0;0;0
FR;11;2022-01-20;0;0;0;0;0;0;0;0;0;0;0;0;0;0;0;0;0;0
FR;11;2022-01-21;0;0;0;0;0;0;0;0;0;0;0;0;0;0;0;0;0;0
FR;11;2022-01-22;0;0;0;0;0;0;0;0;0;0;0;0;0;0;0;0;0;0
FR;11;2022-01-23;0;0;0;0;0;0;0;0;0;0;0;0;0;0;0;0;0;0
FR;11;2022-01-24;0;0;0;0;0;0;0;0;0;0;0;0;0;0;0;0;0;0
FR;11;2022-01-25;0;0;0;0;0;0;0;0;0;0;0;0;0;0;0;0;0;0
FR;11;2022-01-26;0;0;0;0;0;0;0;0;0;0;0;0;0;0;0;0;0;0
FR;11;2022-01-27;0;0;0;0;0;0;0;0;0;0;0;0;0;0;0;0;0;0
FR;11;2022-01-28;0;0;0;0;0;0;0;0;0;0;0;0;0;0;0;0;0;0
FR;11;2022-01-29;0;0;0;0;0;0;0;0;0;0;0;0;0;0;0;0;0;0
FR;11;2022-01-30;0;0;0;0;0;0;0;0;0;0;0;0;0;0;0;0;0;0
FR;11;2022-01-31;0;0;0;0;0;0;0;0;0;0;0;0;0;0;0;0;0;0
FR;11;2022-02-01;0;0;0;0;0;0;0;0;0;0;0;0;0;0;0;0;0;0
FR;11;2022-02-02;0;0;0;0;0;0;0;0;0;0;0;0;0;0;0;0;0;0
FR;11;2022-02-03;0;0;0;0;0;0;0;0;0;0;0;0;0;0;0;0;0;0
FR;11;2022-02-04;0;0;0;0;0;0;0;0;0;0;0;0;0;0;0;0;0;0
FR;11;2022-02-05;0;0;0;0;0;0;0;0;0;0;0;0;0;0;0;0;0;0
FR;11;2022-02-06;0;0;0;0;0;0;0;0;0;0;0;0;0;0;0;0;0;0
FR;11;2022-02-07;0;0;0;0;0;0;0;0;0;0;0;0;0;0;0;0;0;0
FR;11;2022-02-08;0;0;0;0;0;0;0;0;0;0;0;0;0;0;0;0;0;0
FR;11;2022-02-09;0;0;0;0;0;0;0;0;0;0;0;0;0;0;0;0;0;0
FR;11;2022-02-10;0;0;0;0;0;0;0;0;0;0;0;0;0;0;0;0;0;0
FR;11;2022-02-11;0;0;0;0;0;0;0;0;0;0;0;0;0;0;0;0;0;0
FR;11;2022-02-12;0;0;0;0;0;0;0;0;0;0;0;0;0;0;0;0;0;0
FR;11;2022-02-13;0;0;0;0;0;0;0;0;0;0;0;0;0;0;0;0;0;0
FR;11;2022-02-14;0;0;0;0;0;0;0;0;0;0;0;0;0;0;0;0;0;0
FR;11;2022-02-15;0;0;0;0;0;0;0;0;0;0;0;0;0;0;0;0;0;0
FR;11;2022-02-16;0;0;0;0;0;0;0;0;0;0;0;0;0;0;0;0;0;0
FR;11;2022-02-17;0;0;0;0;0;0;0;0;0;0;0;0;0;0;0;0;0;0
FR;11;2022-02-18;0;0;0;0;0;0;0;0;0;0;0;0;0;0;0;0;0;0
FR;11;2022-02-19;0;0;0;0;0;0;0;0;0;0;0;0;0;0;0;0;0;0
FR;11;2022-02-20;0;0;0;0;0;0;0;0;0;0;0;0;0;0;0;0;0;0
FR;11;2022-02-21;0;0;0;0;0;0;0;0;0;0;0;0;0;0;0;0;0;0
FR;11;2022-02-22;0;0;0;0;0;0;0;0;0;0;0;0;0;0;0;0;0;0
FR;11;2022-02-23;0;0;0;0;0;0;0;0;0;0;0;0;0;0;0;0;0;0
FR;11;2022-02-24;0;0;0;0;0;0;0;0;0;0;0;0;0;0;0;0;0;0
FR;11;2022-02-25;0;0;0;0;0;0;0;0;0;0;0;0;0;0;0;0;0;0
FR;11;2022-02-26;0;0;0;0;0;0;0;0;0;0;0;0;0;0;0;0;0;0
FR;11;2022-02-27;0;0;0;0;0;0;0;0;0;0;0;0;0;0;0;0;0;0
FR;11;2022-02-28;0;0;0;0;0;0;0;0;0;0;0;0;0;0;0;0;0;0
FR;11;2022-03-01;0;0;0;0;0;0;0;0;0;0;0;0;0;0;0;0;0;0
FR;11;2022-03-02;0;0;0;0;0;0;0;0;0;0;0;0;0;0;0;0;0;0
FR;11;2022-03-03;0;0;0;0;0;0;0;0;0;0;0;0;0;0;0;0;0;0
FR;11;2022-03-04;0;0;0;0;0;0;0;0;0;0;0;0;0;0;0;0;0;0
FR;11;2022-03-05;0;0;0;0;0;0;0;0;0;0;0;0;0;0;0;0;0;0
FR;11;2022-03-06;0;0;0;0;0;0;0;0;0;0;0;0;0;0;0;0;0;0
FR;11;2022-03-07;0;0;0;0;0;0;0;0;0;0;0;0;0;0;0;0;0;0
FR;11;2022-03-08;0;0;0;0;0;0;0;0;0;0;0;0;0;0;0;0;0;0
FR;11;2022-03-09;0;0;0;0;0;0;0;0;0;0;0;0;0;0;0;0;0;0
FR;11;2022-03-10;0;0;0;0;0;0;0;0;0;0;0;0;0;0;0;0;0;0
FR;11;2022-03-11;0;0;0;0;0;0;0;0;0;0;0;0;0;0;0;0;0;0
FR;11;2022-03-12;0;0;0;0;0;0;0;0;0;0;0;0;0;0;0;0;0;0
FR;11;2022-03-13;0;0;0;0;0;0;0;0;0;0;0;0;0;0;0;0;0;0
FR;11;2022-03-14;0;0;0;0;0;0;0;0;0;0;0;0;0;0;0;0;0;0
FR;11;2022-03-15;0;0;0;0;0;0;0;0;0;0;0;0;0;0;0;0;0;0
FR;11;2022-03-16;0;0;0;0;0;0;0;0;0;0;0;0;0;0;0;0;0;0
FR;11;2022-03-17;0;0;0;0;0;0;0;0;0;0;0;0;0;0;0;0;0;0
FR;11;2022-03-18;0;0;0;0;0;0;0;0;0;0;0;0;0;0;0;0;0;0
FR;11;2022-03-19;0;0;0;0;0;0;0;0;0;0;0;0;0;0;0;0;0;0
FR;11;2022-03-20;0;0;0;0;0;0;0;0;0;0;0;0;0;0;0;0;0;0
FR;11;2022-03-21;0;0;0;0;0;0;0;0;0;0;0;0;0;0;0;0;0;0
FR;11;2022-03-22;0;0;0;0;0;0;0;0;0;0;0;0;0;0;0;0;0;0
FR;11;2022-03-23;0;0;0;0;0;0;0;0;0;0;0;0;0;0;0;0;0;0
FR;11;2022-03-24;0;0;0;0;0;0;0;0;0;0;0;0;0;0;0;0;0;0
FR;11;2022-03-25;0;0;0;0;0;0;0;0;0;0;0;0;0;0;0;0;0;0
FR;11;2022-03-26;0;0;0;0;0;0;0;0;0;0;0;0;0;0;0;0;0;0
FR;11;2022-03-27;0;0;0;0;0;0;0;0;0;0;0;0;0;0;0;0;0;0
FR;11;2022-03-28;0;0;0;0;0;0;0;0;0;0;0;0;0;0;0;0;0;0
FR;11;2022-03-29;0;0;0;0;0;0;0;0;0;0;0;0;0;0;0;0;0;0
FR;11;2022-03-30;0;0;0;0;0;0;0;0;0;0;0;0;0;0;0;0;0;0
FR;11;2022-03-31;0;0;0;0;0;0;0;0;0;0;0;0;0;0;0;0;0;0
FR;11;2022-04-01;0;0;0;0;0;0;0;0;0;0;0;0;0;0;0;0;0;0
FR;11;2022-04-02;0;0;0;0;0;0;0;0;0;0;0;0;0;0;0;0;0;0
FR;11;2022-04-03;0;0;0;0;0;0;0;0;0;0;0;0;0;0;0;0;0;0
FR;11;2022-04-04;0;0;0;0;0;0;0;0;0;0;0;0;0;0;0;0;0;0
FR;11;2022-04-05;0;0;0;0;0;0;0;0;0;0;0;0;0;0;0;0;0;0
FR;11;2022-04-06;0;0;0;0;0;0;0;0;0;0;0;0;0;0;0;0;0;0
FR;11;2022-04-07;0;0;0;0;0;0;0;0;0;0;0;0;0;0;0;0;0;0
FR;11;2022-04-08;0;0;0;0;0;0;0;0;0;0;0;0;0;0;0;0;0;0
FR;11;2022-04-09;0;0;0;0;0;0;0;0;0;0;0;0;0;0;0;0;0;0
FR;11;2022-04-10;0;0;0;0;0;0;0;0;0;0;0;0;0;0;0;0;0;0
FR;11;2022-04-11;0;0;0;0;0;0;0;0;0;0;0;0;0;0;0;0;0;0
FR;11;2022-04-12;0;0;0;0;0;0;0;0;0;0;0;0;0;0;0;0;0;0
FR;11;2022-04-13;0;0;0;0;0;0;0;0;0;0;0;0;0;0;0;0;0;0
FR;11;2022-04-14;0;0;0;0;0;0;0;0;0;0;0;0;0;0;0;0;0;0
FR;11;2022-04-15;0;0;0;0;0;0;0;0;0;0;0;0;0;0;0;0;0;0
FR;11;2022-04-16;0;0;0;0;0;0;0;0;0;0;0;0;0;0;0;0;0;0
FR;11;2022-04-17;0;0;0;0;0;0;0;0;0;0;0;0;0;0;0;0;0;0
FR;11;2022-04-18;0;0;0;0;0;0;0;0;0;0;0;0;0;0;0;0;0;0
FR;11;2022-04-19;0;0;0;0;0;0;0;0;0;0;0;0;0;0;0;0;0;0
FR;11;2022-04-20;0;0;0;0;0;0;0;0;0;0;0;0;0;0;0;0;0;0
FR;11;2022-04-21;0;0;0;0;0;0;0;0;0;0;0;0;0;0;0;0;0;0
FR;11;2022-04-22;0;0;0;0;0;0;0;0;0;0;0;0;0;0;0;0;0;0
FR;11;2022-04-23;0;0;0;0;0;0;0;0;0;0;0;0;0;0;0;0;0;0
FR;11;2022-04-24;0;0;0;0;0;0;0;0;0;0;0;0;0;0;0;0;0;0
FR;11;2022-04-25;0;0;0;0;0;0;0;0;0;0;0;0;0;0;0;0;0;0
FR;11;2022-04-26;0;0;0;0;0;0;0;0;0;0;0;0;0;0;0;0;0;0
FR;11;2022-04-27;0;0;0;0;0;0;0;0;0;0;0;0;0;0;0;0;0;0
FR;11;2022-04-28;0;0;0;0;0;0;0;0;0;0;0;0;0;0;0;0;0;0
FR;11;2022-04-29;0;0;0;0;0;0;0;0;0;0;0;0;0;0;0;0;0;0
FR;11;2022-04-30;0;0;0;0;0;0;0;0;0;0;0;0;0;0;0;0;0;0
FR;11;2022-05-01;0;0;0;0;0;0;0;0;0;0;0;0;0;0;0;0;0;0
FR;11;2022-05-02;0;0;0;0;0;0;0;0;0;0;0;0;0;0;0;0;0;0
FR;11;2022-05-03;0;0;0;0;0;0;0;0;0;0;0;0;0;0;0;0;0;0
FR;11;2022-05-04;0;0;0;0;0;0;0;0;0;0;0;0;0;0;0;0;0;0
FR;11;2022-05-05;0;0;0;0;0;0;0;0;0;0;0;0;0;0;0;0;0;0
FR;11;2022-05-06;0;0;0;0;0;0;0;0;0;0;0;0;0;0;0;0;0;0
FR;11;2022-05-07;0;0;0;0;0;0;0;0;0;0;0;0;0;0;0;0;0;0
FR;11;2022-05-08;0;0;0;0;0;0;0;0;0;0;0;0;0;0;0;0;0;0
FR;11;2022-05-09;0;0;0;0;0;0;0;0;0;0;0;0;0;0;0;0;0;0
FR;11;2022-05-10;0;0;0;0;0;0;0;0;0;0;0;0;0;0;0;0;0;0
FR;11;2022-05-11;0;0;0;0;0;0;0;0;0;0;0;0;0;0;0;0;0;0
FR;11;2022-05-12;0;0;0;0;0;0;0;0;0;0;0;0;0;0;0;0;0;0
FR;11;2022-05-13;0;0;0;0;0;0;0;0;0;0;0;0;0;0;0;0;0;0
FR;11;2022-05-14;0;0;0;0;0;0;0;0;0;0;0;0;0;0;0;0;0;0
FR;11;2022-05-15;0;0;0;0;0;0;0;0;0;0;0;0;0;0;0;0;0;0
FR;11;2022-05-16;0;0;0;0;0;0;0;0;0;0;0;0;0;0;0;0;0;0
FR;11;2022-05-17;0;0;0;0;0;0;0;0;0;0;0;0;0;0;0;0;0;0
FR;11;2022-05-18;0;0;0;0;0;0;0;0;0;0;0;0;0;0;0;0;0;0
FR;11;2022-05-19;0;0;0;0;0;0;0;0;0;0;0;0;0;0;0;0;0;0
FR;11;2022-05-20;0;0;0;0;0;0;0;0;0;0;0;0;0;0;0;0;0;0
FR;11;2022-05-21;0;0;0;0;0;0;0;0;0;0;0;0;0;0;0;0;0;0
FR;11;2022-05-22;0;0;0;0;0;0;0;0;0;0;0;0;0;0;0;0;0;0
FR;11;2022-05-23;0;0;0;0;0;0;0;0;0;0;0;0;0;0;0;0;0;0
FR;11;2022-05-24;0;0;0;0;0;0;0;0;0;0;0;0;0;0;0;0;0;0
FR;11;2022-05-25;0;0;0;0;0;0;0;0;0;0;0;0;0;0;0;0;0;0
FR;11;2022-05-26;0;0;0;0;0;0;0;0;0;0;0;0;0;0;0;0;0;0
FR;11;2022-05-27;0;0;0;0;0;0;0;0;0;0;0;0;0;0;0;0;0;0
FR;11;2022-05-28;0;0;0;0;0;0;0;0;0;0;0;0;0;0;0;0;0;0
FR;11;2022-05-29;0;0;0;0;0;0;0;0;0;0;0;0;0;0;0;0;0;0
FR;11;2022-05-30;0;0;0;0;0;0;0;0;0;0;0;0;0;0;0;0;0;0
FR;11;2022-05-31;0;0;0;0;0;0;0;0;0;0;0;0;0;0;0;0;0;0
FR;11;2022-06-01;0;0;0;0;0;0;0;0;0;0;0;0;0;0;0;0;0;0
FR;11;2022-06-02;0;0;0;0;0;0;0;0;0;0;0;0;0;0;0;0;0;0
FR;11;2022-06-03;0;0;0;0;0;0;0;0;0;0;0;0;0;0;0;0;0;0
FR;11;2022-06-04;0;0;0;0;0;0;0;0;0;0;0;0;0;0;0;0;0;0
FR;11;2022-06-05;0;0;0;0;0;0;0;0;0;0;0;0;0;0;0;0;0;0
FR;11;2022-06-06;0;0;0;0;0;0;0;0;0;0;0;0;0;0;0;0;0;0
FR;11;2022-06-07;0;0;0;0;0;0;0;0;0;0;0;0;0;0;0;0;0;0
FR;11;2022-06-08;0;0;0;0;0;0;0;0;0;0;0;0;0;0;0;0;0;0
FR;11;2022-06-09;0;0;0;0;0;0;0;0;0;0;0;0;0;0;0;0;0;0
FR;11;2022-06-10;0;0;0;0;0;0;0;0;0;0;0;0;0;0;0;0;0;0
FR;11;2022-06-11;0;0;0;0;0;0;0;0;0;0;0;0;0;0;0;0;0;0
FR;11;2022-06-12;0;0;0;0;0;0;0;0;0;0;0;0;0;0;0;0;0;0
FR;11;2022-06-13;0;0;0;0;0;0;0;0;0;0;0;0;0;0;0;0;0;0
FR;11;2022-06-14;0;0;0;0;0;0;0;0;0;0;0;0;0;0;0;0;0;0
FR;11;2022-06-15;0;0;0;0;0;0;0;0;0;0;0;0;0;0;0;0;0;0
FR;11;2022-06-16;0;0;0;0;0;0;0;0;0;0;0;0;0;0;0;0;0;0
FR;11;2022-06-17;0;0;0;0;0;0;0;0;0;0;0;0;0;0;0;0;0;0
FR;11;2022-06-18;0;0;0;0;0;0;0;0;0;0;0;0;0;0;0;0;0;0
FR;11;2022-06-19;0;0;0;0;0;0;0;0;0;0;0;0;0;0;0;0;0;0
FR;11;2022-06-20;0;0;0;0;0;0;0;0;0;0;0;0;0;0;0;0;0;0
FR;11;2022-06-21;0;0;0;0;0;0;0;0;0;0;0;0;0;0;0;0;0;0
FR;11;2022-06-22;0;0;0;0;0;0;0;0;0;0;0;0;0;0;0;0;0;0
FR;11;2022-06-23;0;0;0;0;0;0;0;0;0;0;0;0;0;0;0;0;0;0
FR;11;2022-06-24;0;0;0;0;0;0;0;0;0;0;0;0;0;0;0;0;0;0
FR;11;2022-06-25;0;0;0;0;0;0;0;0;0;0;0;0;0;0;0;0;0;0
FR;11;2022-06-26;0;0;0;0;0;0;0;0;0;0;0;0;0;0;0;0;0;0
FR;11;2022-06-27;0;0;0;0;0;0;0;0;0;0;0;0;0;0;0;0;0;0
FR;11;2022-06-28;0;0;0;0;0;0;0;0;0;0;0;0;0;0;0;0;0;0
FR;11;2022-06-29;0;0;0;0;0;0;0;0;0;0;0;0;0;0;0;0;0;0
FR;11;2022-06-30;0;0;0;0;0;0;0;0;0;0;0;0;0;0;0;0;0;0
FR;11;2022-07-01;0;0;0;0;0;0;0;0;0;0;0;0;0;0;0;0;0;0
FR;11;2022-07-02;0;0;0;0;0;0;0;0;0;0;0;0;0;0;0;0;0;0
FR;11;2022-07-03;0;0;0;0;0;0;0;0;0;0;0;0;0;0;0;0;0;0
FR;11;2022-07-04;0;0;0;0;0;0;0;0;0;0;0;0;0;0;0;0;0;0
FR;11;2022-07-05;0;0;0;0;0;0;0;0;0;0;0;0;0;0;0;0;0;0
FR;11;2022-07-06;0;0;0;0;0;0;0;0;0;0;0;0;0;0;0;0;0;0
FR;11;2022-07-07;0;0;0;0;0;0;0;0;0;0;0;0;0;0;0;0;0;0
FR;11;2022-07-08;0;0;0;0;0;0;0;0;0;0;0;0;0;0;0;0;0;0
FR;11;2022-07-09;0;0;0;0;0;0;0;0;0;0;0;0;0;0;0;0;0;0
FR;11;2022-07-10;0;0;0;0;0;0;0;0;0;0;0;0;0;0;0;0;0;0
FR;11;2022-07-11;0;0;0;0;0;0;0;0;0;0;0;0;0;0;0;0;0;0
FR;11;2022-07-12;0;0;0;0;0;0;0;0;0;0;0;0;0;0;0;0;0;0
FR;11;2022-07-13;0;0;0;0;0;0;0;0;0;0;0;0;0;0;0;0;0;0
FR;11;2022-07-14;0;0;0;0;0;0;0;0;0;0;0;0;0;0;0;0;0;0
FR;11;2022-07-15;0;0;0;0;0;0;0;0;0;0;0;0;0;0;0;0;0;0
FR;11;2022-07-16;0;0;0;0;0;0;0;0;0;0;0;0;0;0;0;0;0;0
FR;11;2022-07-17;0;0;0;0;0;0;0;0;0;0;0;0;0;0;0;0;0;0
FR;11;2022-07-18;0;0;0;0;0;0;0;0;0;0;0;0;0;0;0;0;0;0
FR;11;2022-07-19;0;0;0;0;0;0;0;0;0;0;0;0;0;0;0;0;0;0
FR;11;2022-07-20;0;0;0;0;0;0;0;0;0;0;0;0;0;0;0;0;0;0
FR;11;2022-07-21;0;0;0;0;0;0;0;0;0;0;0;0;0;0;0;0;0;0
FR;11;2022-07-22;0;0;0;0;0;0;0;0;0;0;0;0;0;0;0;0;0;0
FR;11;2022-07-23;0;0;0;0;0;0;0;0;0;0;0;0;0;0;0;0;0;0
FR;11;2022-07-24;0;0;0;0;0;0;0;0;0;0;0;0;0;0;0;0;0;0
FR;11;2022-07-25;0;0;0;0;0;0;0;0;0;0;0;0;0;0;0;0;0;0
FR;11;2022-07-26;0;0;0;0;0;0;0;0;0;0;0;0;0;0;0;0;0;0
FR;11;2022-07-27;0;0;0;0;0;0;0;0;0;0;0;0;0;0;0;0;0;0
FR;11;2022-07-28;0;0;0;0;0;0;0;0;0;0;0;0;0;0;0;0;0;0
FR;11;2022-07-29;0;0;0;0;0;0;0;0;0;0;0;0;0;0;0;0;0;0
FR;11;2022-07-30;0;0;0;0;0;0;0;0;0;0;0;0;0;0;0;0;0;0
FR;11;2022-07-31;0;0;0;0;0;0;0;0;0;0;0;0;0;0;0;0;0;0
FR;11;2022-08-01;0;0;0;0;0;0;0;0;0;0;0;0;0;0;0;0;0;0
FR;11;2022-08-02;0;0;0;0;0;0;0;0;0;0;0;0;0;0;0;0;0;0
FR;11;2022-08-03;0;0;0;0;0;0;0;0;0;0;0;0;0;0;0;0;0;0
FR;11;2022-08-04;0;0;0;0;0;0;0;0;0;0;0;0;0;0;0;0;0;0
FR;11;2022-08-05;0;0;0;0;0;0;0;0;0;0;0;0;0;0;0;0;0;0
FR;11;2022-08-06;0;0;0;0;0;0;0;0;0;0;0;0;0;0;0;0;0;0
FR;11;2022-08-07;0;0;0;0;0;0;0;0;0;0;0;0;0;0;0;0;0;0
FR;11;2022-08-08;0;0;0;0;0;0;0;0;0;0;0;0;0;0;0;0;0;0
FR;11;2022-08-09;0;0;0;0;0;0;0;0;0;0;0;0;0;0;0;0;0;0
FR;11;2022-08-10;0;0;0;0;0;0;0;0;0;0;0;0;0;0;0;0;0;0
FR;11;2022-08-11;0;0;0;0;0;0;0;0;0;0;0;0;0;0;0;0;0;0
FR;11;2022-08-12;0;0;0;0;0;0;0;0;0;0;0;0;0;0;0;0;0;0
FR;11;2022-08-13;0;0;0;0;0;0;0;0;0;0;0;0;0;0;0;0;0;0
FR;11;2022-08-14;0;0;0;0;0;0;0;0;0;0;0;0;0;0;0;0;0;0
FR;11;2022-08-15;0;0;0;0;0;0;0;0;0;0;0;0;0;0;0;0;0;0
FR;11;2022-08-16;0;0;0;0;0;0;0;0;0;0;0;0;0;0;0;0;0;0
FR;11;2022-08-17;0;0;0;0;0;0;0;0;0;0;0;0;0;0;0;0;0;0
FR;11;2022-08-18;0;0;0;0;0;0;0;0;0;0;0;0;0;0;0;0;0;0
FR;11;2022-08-19;0;0;0;0;0;0;0;0;0;0;0;0;0;0;0;0;0;0
FR;11;2022-08-20;0;0;0;0;0;0;0;0;0;0;0;0;0;0;0;0;0;0
FR;11;2022-08-21;0;0;0;0;0;0;0;0;0;0;0;0;0;0;0;0;0;0
FR;11;2022-08-22;0;0;0;0;0;0;0;0;0;0;0;0;0;0;0;0;0;0
FR;11;2022-08-23;0;0;0;0;0;0;0;0;0;0;0;0;0;0;0;0;0;0
FR;11;2022-08-24;0;0;0;0;0;0;0;0;0;0;0;0;0;0;0;0;0;0
FR;11;2022-08-25;0;0;0;0;0;0;0;0;0;0;0;0;0;0;0;0;0;0
FR;11;2022-08-26;0;0;0;0;0;0;0;0;0;0;0;0;0;0;0;0;0;0
FR;11;2022-08-27;0;0;0;0;0;0;0;0;0;0;0;0;0;0;0;0;0;0
FR;11;2022-08-28;0;0;0;0;0;0;0;0;0;0;0;0;0;0;0;0;0;0
FR;11;2022-08-29;0;0;0;0;0;0;0;0;0;0;0;0;0;0;0;0;0;0
FR;11;2022-08-30;0;0;0;0;0;0;0;0;0;0;0;0;0;0;0;0;0;0
FR;11;2022-08-31;0;0;0;0;0;0;0;0;0;0;0;0;0;0;0;0;0;0
FR;11;2022-09-01;0;0;0;0;0;0;0;0;0;0;0;0;0;0;0;0;0;0
FR;11;2022-09-02;0;0;0;0;0;0;0;0;0;0;0;0;0;0;0;0;0;0
FR;11;2022-09-03;0;0;0;0;0;0;0;0;0;0;0;0;0;0;0;0;0;0
FR;11;2022-09-04;0;0;0;0;0;0;0;0;0;0;0;0;0;0;0;0;0;0
FR;11;2022-09-05;0;0;0;0;0;0;0;0;0;0;0;0;0;0;0;0;0;0
FR;11;2022-09-06;0;0;0;0;0;0;0;0;0;0;0;0;0;0;0;0;0;0
FR;11;2022-09-07;0;0;0;0;0;0;0;0;0;0;0;0;0;0;0;0;0;0
FR;11;2022-09-08;0;0;0;0;0;0;0;0;0;0;0;0;0;0;0;0;0;0
FR;11;2022-09-09;0;0;0;0;0;0;0;0;0;0;0;0;0;0;0;0;0;0
FR;11;2022-09-10;0;0;0;0;0;0;0;0;0;0;0;0;0;0;0;0;0;0
FR;11;2022-09-11;0;0;0;0;0;0;0;0;0;0;0;0;0;0;0;0;0;0
FR;11;2022-09-12;0;0;0;0;0;0;0;0;0;0;0;0;0;0;0;0;0;0
FR;11;2022-09-13;0;0;0;0;0;0;0;0;0;0;0;0;0;0;0;0;0;0
FR;11;2022-09-14;0;0;0;0;0;0;0;0;0;0;0;0;0;0;0;0;0;0
FR;11;2022-09-15;0;0;0;0;0;0;0;0;0;0;0;0;0;0;0;0;0;0
FR;11;2022-09-16;0;0;0;0;0;0;0;0;0;0;0;0;0;0;0;0;0;0
FR;11;2022-09-17;0;0;0;0;0;0;0;0;0;0;0;0;0;0;0;0;0;0
FR;11;2022-09-18;0;0;0;0;0;0;0;0;0;0;0;0;0;0;0;0;0;0
FR;11;2022-09-19;0;0;0;0;0;0;0;0;0;0;0;0;0;0;0;0;0;0
FR;11;2022-09-20;0;0;0;0;0;0;0;0;0;0;0;0;0;0;0;0;0;0
FR;11;2022-09-21;0;0;0;0;0;0;0;0;0;0;0;0;0;0;0;0;0;0
FR;11;2022-09-22;0;0;0;0;0;0;0;0;0;0;0;0;0;0;0;0;0;0
FR;11;2022-09-23;0;0;0;0;0;0;0;0;0;0;0;0;0;0;0;0;0;0
FR;11;2022-09-24;0;0;0;0;0;0;0;0;0;0;0;0;0;0;0;0;0;0
FR;11;2022-09-25;0;0;0;0;0;0;0;0;0;0;0;0;0;0;0;0;0;0
FR;11;2022-09-26;0;0;0;0;0;0;0;0;0;0;0;0;0;0;0;0;0;0
FR;11;2022-09-27;0;0;0;0;0;0;0;0;0;0;0;0;0;0;0;0;0;0
FR;11;2022-09-28;0;0;0;0;0;0;0;0;0;0;0;0;0;0;0;0;0;0
FR;11;2022-09-29;0;0;0;0;0;0;0;0;0;0;0;0;0;0;0;0;0;0
FR;11;2022-09-30;0;0;0;0;0;0;0;0;0;0;0;0;0;0;0;0;0;0
FR;11;2022-10-01;0;0;0;0;0;0;0;0;0;0;0;0;0;0;0;0;0;0
FR;11;2022-10-02;0;0;0;0;0;0;0;0;0;0;0;0;0;0;0;0;0;0
FR;11;2022-10-03;0;0;0;0;0;0;0;0;0;0;0;0;0;0;0;0;0;0
FR;11;2022-10-04;0;0;0;0;0;0;0;0;0;0;0;0;0;0;0;0;0;0
FR;11;2022-10-05;0;0;0;0;0;0;0;0;0;0;0;0;0;0;0;0;0;0
FR;11;2022-10-06;0;0;0;0;0;0;0;0;0;0;0;0;0;0;0;0;0;0
FR;11;2022-10-07;0;0;0;0;0;0;0;0;0;0;0;0;0;0;0;0;0;0
FR;11;2022-10-08;0;0;0;0;0;0;0;0;0;0;0;0;0;0;0;0;0;0
FR;11;2022-10-09;0;0;0;0;0;0;0;0;0;0;0;0;0;0;0;0;0;0
FR;11;2022-10-10;0;0;0;0;0;0;0;0;0;0;0;0;0;0;0;0;0;0
FR;11;2022-10-11;0;0;0;0;0;0;0;0;0;0;0;0;0;0;0;0;0;0
FR;11;2022-10-12;0;0;0;0;0;0;0;0;0;0;0;0;0;0;0;0;0;0
FR;11;2022-10-13;0;0;0;0;0;0;0;0;0;0;0;0;0;0;0;0;0;0
FR;11;2022-10-14;0;0;0;0;0;0;0;0;0;0;0;0;0;0;0;0;0;0
FR;11;2022-10-15;0;0;0;0;0;0;0;0;0;0;0;0;0;0;0;0;0;0
FR;11;2022-10-16;0;0;0;0;0;0;0;0;0;0;0;0;0;0;0;0;0;0
FR;11;2022-10-17;0;0;0;0;0;0;0;0;0;0;0;0;0;0;0;0;0;0
FR;11;2022-10-18;0;0;0;0;0;0;0;0;0;0;0;0;0;0;0;0;0;0
FR;11;2022-10-19;0;0;0;0;0;0;0;0;0;0;0;0;0;0;0;0;0;0
FR;11;2022-10-20;0;0;0;0;0;0;0;0;0;0;0;0;0;0;0;0;0;0
FR;11;2022-10-21;0;0;0;0;0;0;0;0;0;0;0;0;0;0;0;0;0;0
FR;11;2022-10-22;0;0;0;0;0;0;0;0;0;0;0;0;0;0;0;0;0;0
FR;11;2022-10-23;0;0;0;0;0;0;0;0;0;0;0;0;0;0;0;0;0;0
FR;11;2022-10-24;0;0;0;0;0;0;0;0;0;0;0;0;0;0;0;0;0;0
FR;11;2022-10-25;0;0;0;0;0;0;0;0;0;0;0;0;0;0;0;0;0;0
FR;11;2022-10-26;0;0;0;0;0;0;0;0;0;0;0;0;0;0;0;0;0;0
FR;11;2022-10-27;0;0;0;0;0;0;0;0;0;0;0;0;0;0;0;0;0;0
FR;11;2022-10-28;0;0;0;0;0;0;0;0;0;0;0;0;0;0;0;0;0;0
FR;11;2022-10-29;0;0;0;0;0;0;0;0;0;0;0;0;0;0;0;0;0;0
FR;11;2022-10-30;0;0;0;0;0;0;0;0;0;0;0;0;0;0;0;0;0;0
FR;11;2022-10-31;0;0;0;0;0;0;0;0;0;0;0;0;0;0;0;0;0;0
FR;11;2022-11-01;0;0;0;0;0;0;0;0;0;0;0;0;0;0;0;0;0;0
FR;11;2022-11-02;0;0;0;0;0;0;0;0;0;0;0;0;0;0;0;0;0;0
FR;11;2022-11-03;0;0;0;0;0;0;0;0;0;0;0;0;0;0;0;0;0;0
FR;11;2022-11-04;0;0;0;0;0;0;0;0;0;0;0;0;0;0;0;0;0;0
FR;11;2022-11-05;0;0;0;0;0;0;0;0;0;0;0;0;0;0;0;0;0;0
FR;11;2022-11-06;0;0;0;0;0;0;0;0;0;0;0;0;0;0;0;0;0;0
FR;11;2022-11-07;0;0;0;0;0;0;0;0;0;0;0;0;0;0;0;0;0;0
FR;11;2022-11-08;0;0;0;0;0;0;0;0;0;0;0;0;0;0;0;0;0;0
FR;11;2022-11-09;0;0;0;0;0;0;0;0;0;0;0;0;0;0;0;0;0;0
FR;11;2022-11-10;0;0;0;0;0;0;0;0;0;0;0;0;0;0;0;0;0;0
FR;11;2022-11-11;0;0;0;0;0;0;0;0;0;0;0;0;0;0;0;0;0;0
FR;11;2022-11-12;0;0;0;0;0;0;0;0;0;0;0;0;0;0;0;0;0;0
FR;11;2022-11-13;0;0;0;0;0;0;0;0;0;0;0;0;0;0;0;0;0;0
FR;11;2022-11-14;0;0;0;0;0;0;0;0;0;0;0;0;0;0;0;0;0;0
FR;11;2022-11-15;0;0;0;0;0;0;0;0;0;0;0;0;0;0;0;0;0;0
FR;11;2022-11-16;0;0;0;0;0;0;0;0;0;0;0;0;0;0;0;0;0;0
FR;11;2022-11-17;0;0;0;0;0;0;0;0;0;0;0;0;0;0;0;0;0;0
FR;11;2022-11-18;0;0;0;0;0;0;0;0;0;0;0;0;0;0;0;0;0;0
FR;11;2022-11-19;0;0;0;0;0;0;0;0;0;0;0;0;0;0;0;0;0;0
FR;11;2022-11-20;0;0;0;0;0;0;0;0;0;0;0;0;0;0;0;0;0;0
FR;11;2022-11-21;0;0;0;0;0;0;0;0;0;0;0;0;0;0;0;0;0;0
FR;11;2022-11-22;0;0;0;0;0;0;0;0;0;0;0;0;0;0;0;0;0;0
FR;11;2022-11-23;0;0;0;0;0;0;0;0;0;0;0;0;0;0;0;0;0;0
FR;11;2022-11-24;0;0;0;0;0;0;0;0;0;0;0;0;0;0;0;0;0;0
FR;11;2022-11-25;0;0;0;0;0;0;0;0;0;0;0;0;0;0;0;0;0;0
FR;11;2022-11-26;0;0;0;0;0;0;0;0;0;0;0;0;0;0;0;0;0;0
FR;11;2022-11-27;0;0;0;0;0;0;0;0;0;0;0;0;0;0;0;0;0;0
FR;11;2022-11-28;0;0;0;0;0;0;0;0;0;0;0;0;0;0;0;0;0;0
FR;11;2022-11-29;0;0;0;0;0;0;0;0;0;0;0;0;0;0;0;0;0;0
FR;11;2022-11-30;0;0;0;0;0;0;0;0;0;0;0;0;0;0;0;0;0;0
FR;11;2022-12-01;0;0;0;0;0;0;0;0;0;0;0;0;0;0;0;0;0;0
FR;11;2022-12-02;0;0;0;0;0;0;0;0;0;0;0;0;0;0;0;0;0;0
FR;11;2022-12-03;0;0;0;0;0;0;0;0;0;0;0;0;0;0;0;0;0;0
FR;11;2022-12-04;0;0;0;0;0;0;0;0;0;0;0;0;0;0;0;0;0;0
FR;11;2022-12-05;0;0;0;0;0;0;0;0;0;0;0;0;0;0;0;0;0;0
FR;11;2022-12-06;0;0;0;0;0;0;0;0;0;0;0;0;0;0;0;0;0;0
FR;11;2022-12-07;0;0;0;0;0;0;0;0;0;0;0;0;0;0;0;0;0;0
FR;11;2022-12-08;0;0;0;0;0;0;0;0;0;0;0;0;0;0;0;0;0;0
FR;11;2022-12-09;0;0;0;0;0;0;0;0;0;0;0;0;0;0;0;0;0;0
FR;11;2022-12-10;0;0;0;0;0;0;0;0;0;0;0;0;0;0;0;0;0;0
FR;11;2022-12-11;0;0;0;0;0;0;0;0;0;0;0;0;0;0;0;0;0;0
FR;11;2022-12-12;0;0;0;0;0;0;0;0;0;0;0;0;0;0;0;0;0;0
FR;11;2022-12-13;0;0;0;0;0;0;0;0;0;0;0;0;0;0;0;0;0;0
FR;11;2022-12-14;0;0;0;0;0;0;0;0;0;0;0;0;0;0;0;0;0;0
FR;11;2022-12-15;0;0;0;0;0;0;0;0;0;0;0;0;0;0;0;0;0;0
FR;11;2022-12-16;0;0;0;0;0;0;0;0;0;0;0;0;0;0;0;0;0;0
FR;11;2022-12-17;0;0;0;0;0;0;0;0;0;0;0;0;0;0;0;0;0;0
FR;11;2022-12-18;0;0;0;0;0;0;0;0;0;0;0;0;0;0;0;0;0;0
FR;11;2022-12-19;0;0;0;0;0;0;0;0;0;0;0;0;0;0;0;0;0;0
FR;11;2022-12-20;0;0;0;0;0;0;0;0;0;0;0;0;0;0;0;0;0;0
FR;11;2022-12-21;0;0;0;0;0;0;0;0;0;0;0;0;0;0;0;0;0;0
FR;11;2022-12-22;0;0;0;0;0;0;0;0;0;0;0;0;0;0;0;0;0;0
FR;11;2022-12-23;0;0;0;0;0;0;0;0;0;0;0;0;0;0;0;0;0;0
FR;11;2022-12-24;0;0;0;0;0;0;0;0;0;0;0;0;0;0;0;0;0;0
FR;11;2022-12-25;0;0;0;0;0;0;0;0;0;0;0;0;0;0;0;0;0;0
FR;11;2022-12-26;0;0;0;0;0;0;0;0;0;0;0;0;0;0;0;0;0;0
FR;11;2022-12-27;0;0;0;0;0;0;0;0;0;0;0;0;0;0;0;0;0;0
FR;11;2022-12-28;0;0;0;0;0;0;0;0;0;0;0;0;0;0;0;0;0;0
FR;11;2022-12-29;0;0;0;0;0;0;0;0;0;0;0;0;0;0;0;0;0;0
FR;11;2022-12-30;0;0;0;0;0;0;0;0;0;0;0;0;0;0;0;0;0;0
FR;11;2022-12-31;0;0;0;0;0;0;0;0;0;0;0;0;0;0;0;0;0;0
FR;11;2023-01-01;0;0;0;0;0;0;0;0;0;0;0;0;0;0;0;0;0;0
FR;11;2023-01-02;0;0;0;0;0;0;0;0;0;0;0;0;0;0;0;0;0;0
FR;11;2023-01-03;0;0;0;0;0;0;0;0;0;0;0;0;0;0;0;0;0;0
FR;11;2023-01-04;0;0;0;0;0;0;0;0;0;0;0;0;0;0;0;0;0;0
FR;11;2023-01-05;0;0;0;0;0;0;0;0;0;0;0;0;0;0;0;0;0;0
FR;11;2023-01-06;0;0;0;0;0;0;0;0;0;0;0;0;0;0;0;0;0;0
FR;11;2023-01-07;0;0;0;0;0;0;0;0;0;0;0;0;0;0;0;0;0;0
FR;11;2023-01-08;0;0;0;0;0;0;0;0;0;0;0;0;0;0;0;0;0;0
FR;11;2023-01-09;0;0;0;0;0;0;0;0;0;0;0;0;0;0;0;0;0;0
FR;11;2023-01-10;0;0;0;0;0;0;0;0;0;0;0;0;0;0;0;0;0;0
FR;11;2023-01-11;0;0;0;0;0;0;0;0;0;0;0;0;0;0;0;0;0;0
FR;11;2023-01-12;0;0;0;0;0;0;0;0;0;0;0;0;0;0;0;0;0;0
FR;11;2023-01-13;0;0;0;0;0;0;0;0;0;0;0;0;0;0;0;0;0;0
FR;11;2023-01-14;0;0;0;0;0;0;0;0;0;0;0;0;0;0;0;0;0;0
FR;11;2023-01-15;0;0;0;0;0;0;0;0;0;0;0;0;0;0;0;0;0;0
FR;11;2023-01-16;0;0;0;0;0;0;0;0;0;0;0;0;0;0;0;0;0;0
FR;11;2023-01-17;0;0;0;0;0;0;0;0;0;0;0;0;0;0;0;0;0;0
FR;11;2023-01-18;0;0;0;0;0;0;0;0;0;0;0;0;0;0;0;0;0;0
FR;11;2023-01-19;0;0;0;0;0;0;0;0;0;0;0;0;0;0;0;0;0;0
FR;11;2023-01-20;0;0;0;0;0;0;0;0;0;0;0;0;0;0;0;0;0;0
FR;11;2023-01-21;0;0;0;0;0;0;0;0;0;0;0;0;0;0;0;0;0;0
FR;11;2023-01-22;0;0;0;0;0;0;0;0;0;0;0;0;0;0;0;0;0;0
FR;11;2023-01-23;0;0;0;0;0;0;0;0;0;0;0;0;0;0;0;0;0;0
FR;11;2023-01-24;0;0;0;0;0;0;0;0;0;0;0;0;0;0;0;0;0;0
FR;11;2023-01-25;0;0;0;0;0;0;0;0;0;0;0;0;0;0;0;0;0;0
FR;11;2023-01-26;0;0;0;0;0;0;0;0;0;0;0;0;0;0;0;0;0;0
FR;11;2023-01-27;0;0;0;0;0;0;0;0;0;0;0;0;0;0;0;0;0;0
FR;11;2023-01-28;0;0;0;0;0;0;0;0;0;0;0;0;0;0;0;0;0;0
FR;11;2023-01-29;0;0;0;0;0;0;0;0;0;0;0;0;0;0;0;0;0;0
FR;11;2023-01-30;0;0;0;0;0;0;0;0;0;0;0;0;0;0;0;0;0;0
FR;11;2023-01-31;0;0;0;0;0;0;0;0;0;0;0;0;0;0;0;0;0;0
FR;11;2023-02-01;0;0;0;0;0;0;0;0;0;0;0;0;0;0;0;0;0;0
FR;11;2023-02-02;0;0;0;0;0;0;0;0;0;0;0;0;0;0;0;0;0;0
FR;11;2023-02-03;0;0;0;0;0;0;0;0;0;0;0;0;0;0;0;0;0;0
FR;11;2023-02-04;0;0;0;0;0;0;0;0;0;0;0;0;0;0;0;0;0;0
FR;11;2023-02-05;0;0;0;0;0;0;0;0;0;0;0;0;0;0;0;0;0;0
FR;11;2023-02-06;1;0;0;0;0;0;0;0;0;1;0;0;0;0;0;0;0;0
FR;11;2023-02-07;0;0;0;0;0;0;0;0;0;1;0;0;0;0;0;0;0;0
FR;11;2023-02-08;2;0;0;0;0;0;0;0;0;3;0;0;0;0;0;0;0;0
FR;11;2023-02-09;2;0;0;0;0;0;0;0;0;5;0;0;0;0;0;0;0;0
FR;11;2023-02-10;0;0;0;0;0;0;0;0;0;5;0;0;0;0;0;0;0;0
FR;11;2023-02-11;0;0;0;0;0;0;0;0;0;5;0;0;0;0;0;0;0;0
FR;11;2023-02-12;0;0;0;0;0;0;0;0;0;5;0;0;0;0;0;0;0;0
FR;11;2023-02-13;2;0;0;0;0;0;0;0;0;7;0;0;0;0;0;0;0;0
FR;11;2023-02-14;0;0;0;0;0;0;0;0;0;7;0;0;0;0;0;0;0;0
FR;11;2023-02-15;2;0;0;0;0;0;0;0;0;9;0;0;0;0;0;0;0;0
FR;11;2023-02-16;0;0;0;0;0;0;0;0;0;9;0;0;0;0;0;0;0;0
FR;11;2023-02-17;0;0;0;0;0;0;0;0;0;9;0;0;0;0;0;0;0;0
FR;11;2023-02-18;0;0;0;0;0;0;0;0;0;9;0;0;0;0;0;0;0;0
FR;11;2023-02-19;0;0;0;0;0;0;0;0;0;9;0;0;0;0;0;0;0;0
FR;11;2023-02-20;0;0;0;0;0;0;0;0;0;9;0;0;0;0;0;0;0;0
FR;11;2023-02-21;1;0;0;0;0;0;0;0;0;10;0;0;0;0;0;0;0;0
FR;11;2023-02-22;0;0;0;0;0;0;0;0;0;10;0;0;0;0;0;0;0;0
FR;11;2023-02-23;0;0;0;0;0;0;0;0;0;10;0;0;0;0;0;0;0;0
FR;11;2023-02-24;0;0;0;0;0;0;0;0;0;10;0;0;0;0;0;0;0;0
FR;11;2023-02-25;0;0;0;0;0;0;0;0;0;10;0;0;0;0;0;0;0;0
FR;11;2023-02-26;0;0;2;0;0;2;0;0;0;10;0;2;0;0;2;0;0;0
FR;11;2023-02-27;0;0;0;0;0;0;0;0;0;10;0;2;0;0;2;0;0;0
FR;11;2023-02-28;1;1;0;0;1;0;0;0;0;11;1;2;0;1;2;0;0;0
FR;11;2023-03-01;0;1;0;0;1;0;0;0;0;11;2;2;0;2;2;0;0;0
FR;11;2023-03-02;0;0;0;0;0;0;0;0;0;11;2;2;0;2;2;0;0;0
FR;11;2023-03-03;0;0;0;0;0;0;0;0;0;11;2;2;0;2;2;0;0;0
FR;11;2023-03-04;2;1;0;0;1;0;0;0;0;13;3;2;0;3;2;0;0;0
FR;11;2023-03-05;0;0;0;0;0;0;0;0;0;13;3;2;0;3;2;0;0;0
FR;11;2023-03-06;4;0;1;0;0;1;0;0;0;17;3;3;0;3;3;0;0;0
FR;11;2023-03-07;0;1;0;0;1;0;0;0;0;17;4;3;0;4;3;0;0;0
FR;11;2023-03-08;1;1;0;0;1;0;0;0;0;18;5;3;0;5;3;0;0;0
FR;11;2023-03-09;0;0;0;0;0;0;0;0;0;18;5;3;0;5;3;0;0;0
FR;11;2023-03-10;0;0;0;0;0;0;0;0;0;18;5;3;0;5;3;0;0;0
FR;11;2023-03-11;2;0;0;0;0;0;0;0;0;20;5;3;0;5;3;0;0;0
FR;11;2023-03-12;0;1;0;0;1;0;0;0;0;20;6;3;0;6;3;0;0;0
FR;11;2023-03-13;0;0;0;0;0;0;0;0;0;20;6;3;0;6;3;0;0;0
FR;11;2023-03-14;0;0;0;0;0;0;0;0;0;20;6;3;0;6;3;0;0;0
FR;11;2023-03-15;0;1;0;0;1;0;0;0;0;20;7;3;0;7;3;0;0;0
FR;11;2023-03-16;0;0;0;0;0;0;0;0;0;20;7;3;0;7;3;0;0;0
FR;11;2023-03-17;0;0;0;0;0;0;0;0;0;20;7;3;0;7;3;0;0;0
FR;11;2023-03-18;1;0;0;0;0;0;0;0;0;21;7;3;0;7;3;0;0;0
FR;11;2023-03-19;0;0;0;0;0;0;0;0;0;21;7;3;0;7;3;0;0;0
FR;11;2023-03-20;0;0;0;0;0;0;0;0;0;21;7;3;0;7;3;0;0;0
FR;11;2023-03-21;1;0;0;0;0;0;0;0;0;22;7;3;0;7;3;0;0;0
FR;11;2023-03-22;2;0;0;0;0;0;0;0;0;24;7;3;0;7;3;0;0;0
FR;11;2023-03-23;0;0;0;1;0;0;1;0;0;24;7;3;1;7;3;1;0;0
FR;11;2023-03-24;0;0;0;0;0;0;0;0;0;24;7;3;1;7;3;1;0;0
FR;11;2023-03-25;1;1;0;0;1;0;0;0;0;25;8;3;1;8;3;1;0;0
FR;11;2023-03-26;0;0;0;0;0;0;0;0;0;25;8;3;1;8;3;1;0;0
FR;11;2023-03-27;0;0;0;0;0;0;0;0;0;25;8;3;1;8;3;1;0;0
FR;11;2023-03-28;0;0;0;0;0;0;0;0;0;25;8;3;1;8;3;1;0;0
FR;11;2023-03-29;0;1;0;0;1;0;0;0;0;25;9;3;1;9;3;1;0;0
FR;12;2020-12-27;0;0;0;0;0;0;0;0;0;0;0;0;0;0;0;0;0;0
FR;12;2020-12-28;0;0;0;0;0;0;0;0;0;0;0;0;0;0;0;0;0;0
FR;12;2020-12-29;0;0;0;0;0;0;0;0;0;0;0;0;0;0;0;0;0;0
FR;12;2020-12-30;0;0;0;0;0;0;0;0;0;0;0;0;0;0;0;0;0;0
FR;12;2020-12-31;0;0;0;0;0;0;0;0;0;0;0;0;0;0;0;0;0;0
FR;12;2021-01-01;0;0;0;0;0;0;0;0;0;0;0;0;0;0;0;0;0;0
FR;12;2021-01-02;0;0;0;0;0;0;0;0;0;0;0;0;0;0;0;0;0;0
FR;12;2021-01-03;0;0;0;0;0;0;0;0;0;0;0;0;0;0;0;0;0;0
FR;12;2021-01-04;0;0;0;0;0;0;0;0;0;0;0;0;0;0;0;0;0;0
FR;12;2021-01-05;0;0;0;0;0;0;0;0;0;0;0;0;0;0;0;0;0;0
FR;12;2021-01-06;0;0;0;0;0;0;0;0;0;0;0;0;0;0;0;0;0;0
FR;12;2021-01-07;0;0;0;0;0;0;0;0;0;0;0;0;0;0;0;0;0;0
FR;12;2021-01-08;0;0;0;0;0;0;0;0;0;0;0;0;0;0;0;0;0;0
FR;12;2021-01-09;0;0;0;0;0;0;0;0;0;0;0;0;0;0;0;0;0;0
FR;12;2021-01-10;0;0;0;0;0;0;0;0;0;0;0;0;0;0;0;0;0;0
FR;12;2021-01-11;0;0;0;0;0;0;0;0;0;0;0;0;0;0;0;0;0;0
FR;12;2021-01-12;0;0;0;0;0;0;0;0;0;0;0;0;0;0;0;0;0;0
FR;12;2021-01-13;0;0;0;0;0;0;0;0;0;0;0;0;0;0;0;0;0;0
FR;12;2021-01-14;0;0;0;0;0;0;0;0;0;0;0;0;0;0;0;0;0;0
FR;12;2021-01-15;0;0;0;0;0;0;0;0;0;0;0;0;0;0;0;0;0;0
FR;12;2021-01-16;0;0;0;0;0;0;0;0;0;0;0;0;0;0;0;0;0;0
FR;12;2021-01-17;0;0;0;0;0;0;0;0;0;0;0;0;0;0;0;0;0;0
FR;12;2021-01-18;0;0;0;0;0;0;0;0;0;0;0;0;0;0;0;0;0;0
FR;12;2021-01-19;0;0;0;0;0;0;0;0;0;0;0;0;0;0;0;0;0;0
FR;12;2021-01-20;0;0;0;0;0;0;0;0;0;0;0;0;0;0;0;0;0;0
FR;12;2021-01-21;0;0;0;0;0;0;0;0;0;0;0;0;0;0;0;0;0;0
FR;12;2021-01-22;0;0;0;0;0;0;0;0;0;0;0;0;0;0;0;0;0;0
FR;12;2021-01-23;0;0;0;0;0;0;0;0;0;0;0;0;0;0;0;0;0;0
FR;12;2021-01-24;0;0;0;0;0;0;0;0;0;0;0;0;0;0;0;0;0;0
FR;12;2021-01-25;0;0;0;0;0;0;0;0;0;0;0;0;0;0;0;0;0;0
FR;12;2021-01-26;0;0;0;0;0;0;0;0;0;0;0;0;0;0;0;0;0;0
FR;12;2021-01-27;0;0;0;0;0;0;0;0;0;0;0;0;0;0;0;0;0;0
FR;12;2021-01-28;0;0;0;0;0;0;0;0;0;0;0;0;0;0;0;0;0;0
FR;12;2021-01-29;0;0;0;0;0;0;0;0;0;0;0;0;0;0;0;0;0;0
FR;12;2021-01-30;0;0;0;0;0;0;0;0;0;0;0;0;0;0;0;0;0;0
FR;12;2021-01-31;0;0;0;0;0;0;0;0;0;0;0;0;0;0;0;0;0;0
FR;12;2021-02-01;0;0;0;0;0;0;0;0;0;0;0;0;0;0;0;0;0;0
FR;12;2021-02-02;0;0;0;0;0;0;0;0;0;0;0;0;0;0;0;0;0;0
FR;12;2021-02-03;0;0;0;0;0;0;0;0;0;0;0;0;0;0;0;0;0;0
FR;12;2021-02-04;0;0;0;0;0;0;0;0;0;0;0;0;0;0;0;0;0;0
FR;12;2021-02-05;0;0;0;0;0;0;0;0;0;0;0;0;0;0;0;0;0;0
FR;12;2021-02-06;0;0;0;0;0;0;0;0;0;0;0;0;0;0;0;0;0;0
FR;12;2021-02-07;0;0;0;0;0;0;0;0;0;0;0;0;0;0;0;0;0;0
FR;12;2021-02-08;0;0;0;0;0;0;0;0;0;0;0;0;0;0;0;0;0;0
FR;12;2021-02-09;0;0;0;0;0;0;0;0;0;0;0;0;0;0;0;0;0;0
FR;12;2021-02-10;0;0;0;0;0;0;0;0;0;0;0;0;0;0;0;0;0;0
FR;12;2021-02-11;0;0;0;0;0;0;0;0;0;0;0;0;0;0;0;0;0;0
FR;12;2021-02-12;0;0;0;0;0;0;0;0;0;0;0;0;0;0;0;0;0;0
FR;12;2021-02-13;0;0;0;0;0;0;0;0;0;0;0;0;0;0;0;0;0;0
FR;12;2021-02-14;0;0;0;0;0;0;0;0;0;0;0;0;0;0;0;0;0;0
FR;12;2021-02-15;0;0;0;0;0;0;0;0;0;0;0;0;0;0;0;0;0;0
FR;12;2021-02-16;0;0;0;0;0;0;0;0;0;0;0;0;0;0;0;0;0;0
FR;12;2021-02-17;0;0;0;0;0;0;0;0;0;0;0;0;0;0;0;0;0;0
FR;12;2021-02-18;0;0;0;0;0;0;0;0;0;0;0;0;0;0;0;0;0;0
FR;12;2021-02-19;0;0;0;0;0;0;0;0;0;0;0;0;0;0;0;0;0;0
FR;12;2021-02-20;0;0;0;0;0;0;0;0;0;0;0;0;0;0;0;0;0;0
FR;12;2021-02-21;0;0;0;0;0;0;0;0;0;0;0;0;0;0;0;0;0;0
FR;12;2021-02-22;0;0;0;0;0;0;0;0;0;0;0;0;0;0;0;0;0;0
FR;12;2021-02-23;0;0;0;0;0;0;0;0;0;0;0;0;0;0;0;0;0;0
FR;12;2021-02-24;0;0;0;0;0;0;0;0;0;0;0;0;0;0;0;0;0;0
FR;12;2021-02-25;0;0;0;0;0;0;0;0;0;0;0;0;0;0;0;0;0;0
FR;12;2021-02-26;0;0;0;0;0;0;0;0;0;0;0;0;0;0;0;0;0;0
FR;12;2021-02-27;0;0;0;0;0;0;0;0;0;0;0;0;0;0;0;0;0;0
FR;12;2021-02-28;0;0;0;0;0;0;0;0;0;0;0;0;0;0;0;0;0;0
FR;12;2021-03-01;0;0;0;0;0;0;0;0;0;0;0;0;0;0;0;0;0;0
FR;12;2021-03-02;0;0;0;0;0;0;0;0;0;0;0;0;0;0;0;0;0;0
FR;12;2021-03-03;0;0;0;0;0;0;0;0;0;0;0;0;0;0;0;0;0;0
FR;12;2021-03-04;0;0;0;0;0;0;0;0;0;0;0;0;0;0;0;0;0;0
FR;12;2021-03-05;0;0;0;0;0;0;0;0;0;0;0;0;0;0;0;0;0;0
FR;12;2021-03-06;0;0;0;0;0;0;0;0;0;0;0;0;0;0;0;0;0;0
FR;12;2021-03-07;0;0;0;0;0;0;0;0;0;0;0;0;0;0;0;0;0;0
FR;12;2021-03-08;0;0;0;0;0;0;0;0;0;0;0;0;0;0;0;0;0;0
FR;12;2021-03-09;0;0;0;0;0;0;0;0;0;0;0;0;0;0;0;0;0;0
FR;12;2021-03-10;0;0;0;0;0;0;0;0;0;0;0;0;0;0;0;0;0;0
FR;12;2021-03-11;0;0;0;0;0;0;0;0;0;0;0;0;0;0;0;0;0;0
FR;12;2021-03-12;0;0;0;0;0;0;0;0;0;0;0;0;0;0;0;0;0;0
FR;12;2021-03-13;0;0;0;0;0;0;0;0;0;0;0;0;0;0;0;0;0;0
FR;12;2021-03-14;0;0;0;0;0;0;0;0;0;0;0;0;0;0;0;0;0;0
FR;12;2021-03-15;0;0;0;0;0;0;0;0;0;0;0;0;0;0;0;0;0;0
FR;12;2021-03-16;0;0;0;0;0;0;0;0;0;0;0;0;0;0;0;0;0;0
FR;12;2021-03-17;0;0;0;0;0;0;0;0;0;0;0;0;0;0;0;0;0;0
FR;12;2021-03-18;0;0;0;0;0;0;0;0;0;0;0;0;0;0;0;0;0;0
FR;12;2021-03-19;0;0;0;0;0;0;0;0;0;0;0;0;0;0;0;0;0;0
FR;12;2021-03-20;0;0;0;0;0;0;0;0;0;0;0;0;0;0;0;0;0;0
FR;12;2021-03-21;0;0;0;0;0;0;0;0;0;0;0;0;0;0;0;0;0;0
FR;12;2021-03-22;0;0;0;0;0;0;0;0;0;0;0;0;0;0;0;0;0;0
FR;12;2021-03-23;0;0;0;0;0;0;0;0;0;0;0;0;0;0;0;0;0;0
FR;12;2021-03-24;0;0;0;0;0;0;0;0;0;0;0;0;0;0;0;0;0;0
FR;12;2021-03-25;0;0;0;0;0;0;0;0;0;0;0;0;0;0;0;0;0;0
FR;12;2021-03-26;0;0;0;0;0;0;0;0;0;0;0;0;0;0;0;0;0;0
FR;12;2021-03-27;0;0;0;0;0;0;0;0;0;0;0;0;0;0;0;0;0;0
FR;12;2021-03-28;0;0;0;0;0;0;0;0;0;0;0;0;0;0;0;0;0;0
FR;12;2021-03-29;0;0;0;0;0;0;0;0;0;0;0;0;0;0;0;0;0;0
FR;12;2021-03-30;0;0;0;0;0;0;0;0;0;0;0;0;0;0;0;0;0;0
FR;12;2021-03-31;0;0;0;0;0;0;0;0;0;0;0;0;0;0;0;0;0;0
FR;12;2021-04-01;0;0;0;0;0;0;0;0;0;0;0;0;0;0;0;0;0;0
FR;12;2021-04-02;0;0;0;0;0;0;0;0;0;0;0;0;0;0;0;0;0;0
FR;12;2021-04-03;0;0;0;0;0;0;0;0;0;0;0;0;0;0;0;0;0;0
FR;12;2021-04-04;0;0;0;0;0;0;0;0;0;0;0;0;0;0;0;0;0;0
FR;12;2021-04-05;0;0;0;0;0;0;0;0;0;0;0;0;0;0;0;0;0;0
FR;12;2021-04-06;0;0;0;0;0;0;0;0;0;0;0;0;0;0;0;0;0;0
FR;12;2021-04-07;0;0;0;0;0;0;0;0;0;0;0;0;0;0;0;0;0;0
FR;12;2021-04-08;0;0;0;0;0;0;0;0;0;0;0;0;0;0;0;0;0;0
FR;12;2021-04-09;0;0;0;0;0;0;0;0;0;0;0;0;0;0;0;0;0;0
FR;12;2021-04-10;0;0;0;0;0;0;0;0;0;0;0;0;0;0;0;0;0;0
FR;12;2021-04-11;0;0;0;0;0;0;0;0;0;0;0;0;0;0;0;0;0;0
FR;12;2021-04-12;0;0;0;0;0;0;0;0;0;0;0;0;0;0;0;0;0;0
FR;12;2021-04-13;0;0;0;0;0;0;0;0;0;0;0;0;0;0;0;0;0;0
FR;12;2021-04-14;0;0;0;0;0;0;0;0;0;0;0;0;0;0;0;0;0;0
FR;12;2021-04-15;0;0;0;0;0;0;0;0;0;0;0;0;0;0;0;0;0;0
FR;12;2021-04-16;0;0;0;0;0;0;0;0;0;0;0;0;0;0;0;0;0;0
FR;12;2021-04-17;0;0;0;0;0;0;0;0;0;0;0;0;0;0;0;0;0;0
FR;12;2021-04-18;0;0;0;0;0;0;0;0;0;0;0;0;0;0;0;0;0;0
FR;12;2021-04-19;0;0;0;0;0;0;0;0;0;0;0;0;0;0;0;0;0;0
FR;12;2021-04-20;0;0;0;0;0;0;0;0;0;0;0;0;0;0;0;0;0;0
FR;12;2021-04-21;0;0;0;0;0;0;0;0;0;0;0;0;0;0;0;0;0;0
FR;12;2021-04-22;0;0;0;0;0;0;0;0;0;0;0;0;0;0;0;0;0;0
FR;12;2021-04-23;0;0;0;0;0;0;0;0;0;0;0;0;0;0;0;0;0;0
FR;12;2021-04-24;0;0;0;0;0;0;0;0;0;0;0;0;0;0;0;0;0;0
FR;12;2021-04-25;0;0;0;0;0;0;0;0;0;0;0;0;0;0;0;0;0;0
FR;12;2021-04-26;0;0;0;0;0;0;0;0;0;0;0;0;0;0;0;0;0;0
FR;12;2021-04-27;0;0;0;0;0;0;0;0;0;0;0;0;0;0;0;0;0;0
FR;12;2021-04-28;0;0;0;0;0;0;0;0;0;0;0;0;0;0;0;0;0;0
FR;12;2021-04-29;0;0;0;0;0;0;0;0;0;0;0;0;0;0;0;0;0;0
FR;12;2021-04-30;0;0;0;0;0;0;0;0;0;0;0;0;0;0;0;0;0;0
FR;12;2021-05-01;0;0;0;0;0;0;0;0;0;0;0;0;0;0;0;0;0;0
FR;12;2021-05-02;0;0;0;0;0;0;0;0;0;0;0;0;0;0;0;0;0;0
FR;12;2021-05-03;0;0;0;0;0;0;0;0;0;0;0;0;0;0;0;0;0;0
FR;12;2021-05-04;0;0;0;0;0;0;0;0;0;0;0;0;0;0;0;0;0;0
FR;12;2021-05-05;0;0;0;0;0;0;0;0;0;0;0;0;0;0;0;0;0;0
FR;12;2021-05-06;0;0;0;0;0;0;0;0;0;0;0;0;0;0;0;0;0;0
FR;12;2021-05-07;0;0;0;0;0;0;0;0;0;0;0;0;0;0;0;0;0;0
FR;12;2021-05-08;0;0;0;0;0;0;0;0;0;0;0;0;0;0;0;0;0;0
FR;12;2021-05-09;0;0;0;0;0;0;0;0;0;0;0;0;0;0;0;0;0;0
FR;12;2021-05-10;0;0;0;0;0;0;0;0;0;0;0;0;0;0;0;0;0;0
FR;12;2021-05-11;0;0;0;0;0;0;0;0;0;0;0;0;0;0;0;0;0;0
FR;12;2021-05-12;0;0;0;0;0;0;0;0;0;0;0;0;0;0;0;0;0;0
FR;12;2021-05-13;0;0;0;0;0;0;0;0;0;0;0;0;0;0;0;0;0;0
FR;12;2021-05-14;0;0;0;0;0;0;0;0;0;0;0;0;0;0;0;0;0;0
FR;12;2021-05-15;0;0;0;0;0;0;0;0;0;0;0;0;0;0;0;0;0;0
FR;12;2021-05-16;0;0;0;0;0;0;0;0;0;0;0;0;0;0;0;0;0;0
FR;12;2021-05-17;0;0;0;0;0;0;0;0;0;0;0;0;0;0;0;0;0;0
FR;12;2021-05-18;0;0;0;0;0;0;0;0;0;0;0;0;0;0;0;0;0;0
FR;12;2021-05-19;0;0;0;0;0;0;0;0;0;0;0;0;0;0;0;0;0;0
FR;12;2021-05-20;0;0;0;0;0;0;0;0;0;0;0;0;0;0;0;0;0;0
FR;12;2021-05-21;0;0;0;0;0;0;0;0;0;0;0;0;0;0;0;0;0;0
FR;12;2021-05-22;0;0;0;0;0;0;0;0;0;0;0;0;0;0;0;0;0;0
FR;12;2021-05-23;0;0;0;0;0;0;0;0;0;0;0;0;0;0;0;0;0;0
FR;12;2021-05-24;0;0;0;0;0;0;0;0;0;0;0;0;0;0;0;0;0;0
FR;12;2021-05-25;0;0;0;0;0;0;0;0;0;0;0;0;0;0;0;0;0;0
FR;12;2021-05-26;0;0;0;0;0;0;0;0;0;0;0;0;0;0;0;0;0;0
FR;12;2021-05-27;0;0;0;0;0;0;0;0;0;0;0;0;0;0;0;0;0;0
FR;12;2021-05-28;0;0;0;0;0;0;0;0;0;0;0;0;0;0;0;0;0;0
FR;12;2021-05-29;0;0;0;0;0;0;0;0;0;0;0;0;0;0;0;0;0;0
FR;12;2021-05-30;0;0;0;0;0;0;0;0;0;0;0;0;0;0;0;0;0;0
FR;12;2021-05-31;0;0;0;0;0;0;0;0;0;0;0;0;0;0;0;0;0;0
FR;12;2021-06-01;0;0;0;0;0;0;0;0;0;0;0;0;0;0;0;0;0;0
FR;12;2021-06-02;0;0;0;0;0;0;0;0;0;0;0;0;0;0;0;0;0;0
FR;12;2021-06-03;0;0;0;0;0;0;0;0;0;0;0;0;0;0;0;0;0;0
FR;12;2021-06-04;0;0;0;0;0;0;0;0;0;0;0;0;0;0;0;0;0;0
FR;12;2021-06-05;0;0;0;0;0;0;0;0;0;0;0;0;0;0;0;0;0;0
FR;12;2021-06-06;0;0;0;0;0;0;0;0;0;0;0;0;0;0;0;0;0;0
FR;12;2021-06-07;0;0;0;0;0;0;0;0;0;0;0;0;0;0;0;0;0;0
FR;12;2021-06-08;0;0;0;0;0;0;0;0;0;0;0;0;0;0;0;0;0;0
FR;12;2021-06-09;0;0;0;0;0;0;0;0;0;0;0;0;0;0;0;0;0;0
FR;12;2021-06-10;0;0;0;0;0;0;0;0;0;0;0;0;0;0;0;0;0;0
FR;12;2021-06-11;0;0;0;0;0;0;0;0;0;0;0;0;0;0;0;0;0;0
FR;12;2021-06-12;0;0;0;0;0;0;0;0;0;0;0;0;0;0;0;0;0;0
FR;12;2021-06-13;0;0;0;0;0;0;0;0;0;0;0;0;0;0;0;0;0;0
FR;12;2021-06-14;0;0;0;0;0;0;0;0;0;0;0;0;0;0;0;0;0;0
FR;12;2021-06-15;0;0;0;0;0;0;0;0;0;0;0;0;0;0;0;0;0;0
FR;12;2021-06-16;0;0;0;0;0;0;0;0;0;0;0;0;0;0;0;0;0;0
FR;12;2021-06-17;0;0;0;0;0;0;0;0;0;0;0;0;0;0;0;0;0;0
FR;12;2021-06-18;0;0;0;0;0;0;0;0;0;0;0;0;0;0;0;0;0;0
FR;12;2021-06-19;0;0;0;0;0;0;0;0;0;0;0;0;0;0;0;0;0;0
FR;12;2021-06-20;0;0;0;0;0;0;0;0;0;0;0;0;0;0;0;0;0;0
FR;12;2021-06-21;0;0;0;0;0;0;0;0;0;0;0;0;0;0;0;0;0;0
FR;12;2021-06-22;0;0;0;0;0;0;0;0;0;0;0;0;0;0;0;0;0;0
FR;12;2021-06-23;0;0;0;0;0;0;0;0;0;0;0;0;0;0;0;0;0;0
FR;12;2021-06-24;0;0;0;0;0;0;0;0;0;0;0;0;0;0;0;0;0;0
FR;12;2021-06-25;0;0;0;0;0;0;0;0;0;0;0;0;0;0;0;0;0;0
FR;12;2021-06-26;0;0;0;0;0;0;0;0;0;0;0;0;0;0;0;0;0;0
FR;12;2021-06-27;0;0;0;0;0;0;0;0;0;0;0;0;0;0;0;0;0;0
FR;12;2021-06-28;0;0;0;0;0;0;0;0;0;0;0;0;0;0;0;0;0;0
FR;12;2021-06-29;0;0;0;0;0;0;0;0;0;0;0;0;0;0;0;0;0;0
FR;12;2021-06-30;0;0;0;0;0;0;0;0;0;0;0;0;0;0;0;0;0;0
FR;12;2021-07-01;0;0;0;0;0;0;0;0;0;0;0;0;0;0;0;0;0;0
FR;12;2021-07-02;0;0;0;0;0;0;0;0;0;0;0;0;0;0;0;0;0;0
FR;12;2021-07-03;0;0;0;0;0;0;0;0;0;0;0;0;0;0;0;0;0;0
FR;12;2021-07-04;0;0;0;0;0;0;0;0;0;0;0;0;0;0;0;0;0;0
FR;12;2021-07-05;0;0;0;0;0;0;0;0;0;0;0;0;0;0;0;0;0;0
FR;12;2021-07-06;0;0;0;0;0;0;0;0;0;0;0;0;0;0;0;0;0;0
FR;12;2021-07-07;0;0;0;0;0;0;0;0;0;0;0;0;0;0;0;0;0;0
FR;12;2021-07-08;0;0;0;0;0;0;0;0;0;0;0;0;0;0;0;0;0;0
FR;12;2021-07-09;0;0;0;0;0;0;0;0;0;0;0;0;0;0;0;0;0;0
FR;12;2021-07-10;0;0;0;0;0;0;0;0;0;0;0;0;0;0;0;0;0;0
FR;12;2021-07-11;0;0;0;0;0;0;0;0;0;0;0;0;0;0;0;0;0;0
FR;12;2021-07-12;0;0;0;0;0;0;0;0;0;0;0;0;0;0;0;0;0;0
FR;12;2021-07-13;0;0;0;0;0;0;0;0;0;0;0;0;0;0;0;0;0;0
FR;12;2021-07-14;0;0;0;0;0;0;0;0;0;0;0;0;0;0;0;0;0;0
FR;12;2021-07-15;0;0;0;0;0;0;0;0;0;0;0;0;0;0;0;0;0;0
FR;12;2021-07-16;0;0;0;0;0;0;0;0;0;0;0;0;0;0;0;0;0;0
FR;12;2021-07-17;0;0;0;0;0;0;0;0;0;0;0;0;0;0;0;0;0;0
FR;12;2021-07-18;0;0;0;0;0;0;0;0;0;0;0;0;0;0;0;0;0;0
FR;12;2021-07-19;0;0;0;0;0;0;0;0;0;0;0;0;0;0;0;0;0;0
FR;12;2021-07-20;0;0;0;0;0;0;0;0;0;0;0;0;0;0;0;0;0;0
FR;12;2021-07-21;0;0;0;0;0;0;0;0;0;0;0;0;0;0;0;0;0;0
FR;12;2021-07-22;0;0;0;0;0;0;0;0;0;0;0;0;0;0;0;0;0;0
FR;12;2021-07-23;0;0;0;0;0;0;0;0;0;0;0;0;0;0;0;0;0;0
FR;12;2021-07-24;0;0;0;0;0;0;0;0;0;0;0;0;0;0;0;0;0;0
FR;12;2021-07-25;0;0;0;0;0;0;0;0;0;0;0;0;0;0;0;0;0;0
FR;12;2021-07-26;0;0;0;0;0;0;0;0;0;0;0;0;0;0;0;0;0;0
FR;12;2021-07-27;0;0;0;0;0;0;0;0;0;0;0;0;0;0;0;0;0;0
FR;12;2021-07-28;0;0;0;0;0;0;0;0;0;0;0;0;0;0;0;0;0;0
FR;12;2021-07-29;0;0;0;0;0;0;0;0;0;0;0;0;0;0;0;0;0;0
FR;12;2021-07-30;0;0;0;0;0;0;0;0;0;0;0;0;0;0;0;0;0;0
FR;12;2021-07-31;0;0;0;0;0;0;0;0;0;0;0;0;0;0;0;0;0;0
FR;12;2021-08-01;0;0;0;0;0;0;0;0;0;0;0;0;0;0;0;0;0;0
FR;12;2021-08-02;0;0;0;0;0;0;0;0;0;0;0;0;0;0;0;0;0;0
FR;12;2021-08-03;0;0;0;0;0;0;0;0;0;0;0;0;0;0;0;0;0;0
FR;12;2021-08-04;0;0;0;0;0;0;0;0;0;0;0;0;0;0;0;0;0;0
FR;12;2021-08-05;0;0;0;0;0;0;0;0;0;0;0;0;0;0;0;0;0;0
FR;12;2021-08-06;0;0;0;0;0;0;0;0;0;0;0;0;0;0;0;0;0;0
FR;12;2021-08-07;0;0;0;0;0;0;0;0;0;0;0;0;0;0;0;0;0;0
FR;12;2021-08-08;0;0;0;0;0;0;0;0;0;0;0;0;0;0;0;0;0;0
FR;12;2021-08-09;0;0;0;0;0;0;0;0;0;0;0;0;0;0;0;0;0;0
FR;12;2021-08-10;0;0;0;0;0;0;0;0;0;0;0;0;0;0;0;0;0;0
FR;12;2021-08-11;0;0;0;0;0;0;0;0;0;0;0;0;0;0;0;0;0;0
FR;12;2021-08-12;0;0;0;0;0;0;0;0;0;0;0;0;0;0;0;0;0;0
FR;12;2021-08-13;0;0;0;0;0;0;0;0;0;0;0;0;0;0;0;0;0;0
FR;12;2021-08-14;0;0;0;0;0;0;0;0;0;0;0;0;0;0;0;0;0;0
FR;12;2021-08-15;0;0;0;0;0;0;0;0;0;0;0;0;0;0;0;0;0;0
FR;12;2021-08-16;0;0;0;0;0;0;0;0;0;0;0;0;0;0;0;0;0;0
FR;12;2021-08-17;0;0;0;0;0;0;0;0;0;0;0;0;0;0;0;0;0;0
FR;12;2021-08-18;0;0;0;0;0;0;0;0;0;0;0;0;0;0;0;0;0;0
FR;12;2021-08-19;0;0;0;0;0;0;0;0;0;0;0;0;0;0;0;0;0;0
FR;12;2021-08-20;0;0;0;0;0;0;0;0;0;0;0;0;0;0;0;0;0;0
FR;12;2021-08-21;0;0;0;0;0;0;0;0;0;0;0;0;0;0;0;0;0;0
FR;12;2021-08-22;0;0;0;0;0;0;0;0;0;0;0;0;0;0;0;0;0;0
FR;12;2021-08-23;0;0;0;0;0;0;0;0;0;0;0;0;0;0;0;0;0;0
FR;12;2021-08-24;0;0;0;0;0;0;0;0;0;0;0;0;0;0;0;0;0;0
FR;12;2021-08-25;0;0;0;0;0;0;0;0;0;0;0;0;0;0;0;0;0;0
FR;12;2021-08-26;0;0;0;0;0;0;0;0;0;0;0;0;0;0;0;0;0;0
FR;12;2021-08-27;0;0;0;0;0;0;0;0;0;0;0;0;0;0;0;0;0;0
FR;12;2021-08-28;0;0;0;0;0;0;0;0;0;0;0;0;0;0;0;0;0;0
FR;12;2021-08-29;0;0;0;0;0;0;0;0;0;0;0;0;0;0;0;0;0;0
FR;12;2021-08-30;0;0;0;0;0;0;0;0;0;0;0;0;0;0;0;0;0;0
FR;12;2021-08-31;0;0;0;0;0;0;0;0;0;0;0;0;0;0;0;0;0;0
FR;12;2021-09-01;0;0;0;0;0;0;0;0;0;0;0;0;0;0;0;0;0;0
FR;12;2021-09-02;0;0;0;0;0;0;0;0;0;0;0;0;0;0;0;0;0;0
FR;12;2021-09-03;0;0;0;0;0;0;0;0;0;0;0;0;0;0;0;0;0;0
FR;12;2021-09-04;0;0;0;0;0;0;0;0;0;0;0;0;0;0;0;0;0;0
FR;12;2021-09-05;0;0;0;0;0;0;0;0;0;0;0;0;0;0;0;0;0;0
FR;12;2021-09-06;0;0;0;0;0;0;0;0;0;0;0;0;0;0;0;0;0;0
FR;12;2021-09-07;0;0;0;0;0;0;0;0;0;0;0;0;0;0;0;0;0;0
FR;12;2021-09-08;0;0;0;0;0;0;0;0;0;0;0;0;0;0;0;0;0;0
FR;12;2021-09-09;0;0;0;0;0;0;0;0;0;0;0;0;0;0;0;0;0;0
FR;12;2021-09-10;0;0;0;0;0;0;0;0;0;0;0;0;0;0;0;0;0;0
FR;12;2021-09-11;0;0;0;0;0;0;0;0;0;0;0;0;0;0;0;0;0;0
FR;12;2021-09-12;0;0;0;0;0;0;0;0;0;0;0;0;0;0;0;0;0;0
FR;12;2021-09-13;0;0;0;0;0;0;0;0;0;0;0;0;0;0;0;0;0;0
FR;12;2021-09-14;0;0;0;0;0;0;0;0;0;0;0;0;0;0;0;0;0;0
FR;12;2021-09-15;0;0;0;0;0;0;0;0;0;0;0;0;0;0;0;0;0;0
FR;12;2021-09-16;0;0;0;0;0;0;0;0;0;0;0;0;0;0;0;0;0;0
FR;12;2021-09-17;0;0;0;0;0;0;0;0;0;0;0;0;0;0;0;0;0;0
FR;12;2021-09-18;0;0;0;0;0;0;0;0;0;0;0;0;0;0;0;0;0;0
FR;12;2021-09-19;0;0;0;0;0;0;0;0;0;0;0;0;0;0;0;0;0;0
FR;12;2021-09-20;0;0;0;0;0;0;0;0;0;0;0;0;0;0;0;0;0;0
FR;12;2021-09-21;0;0;0;0;0;0;0;0;0;0;0;0;0;0;0;0;0;0
FR;12;2021-09-22;0;0;0;0;0;0;0;0;0;0;0;0;0;0;0;0;0;0
FR;12;2021-09-23;0;0;0;0;0;0;0;0;0;0;0;0;0;0;0;0;0;0
FR;12;2021-09-24;0;0;0;0;0;0;0;0;0;0;0;0;0;0;0;0;0;0
FR;12;2021-09-25;0;0;0;0;0;0;0;0;0;0;0;0;0;0;0;0;0;0
FR;12;2021-09-26;0;0;0;0;0;0;0;0;0;0;0;0;0;0;0;0;0;0
FR;12;2021-09-27;0;0;0;0;0;0;0;0;0;0;0;0;0;0;0;0;0;0
FR;12;2021-09-28;0;0;0;0;0;0;0;0;0;0;0;0;0;0;0;0;0;0
FR;12;2021-09-29;0;0;0;0;0;0;0;0;0;0;0;0;0;0;0;0;0;0
FR;12;2021-09-30;0;0;0;0;0;0;0;0;0;0;0;0;0;0;0;0;0;0
FR;12;2021-10-01;0;0;0;0;0;0;0;0;0;0;0;0;0;0;0;0;0;0
FR;12;2021-10-02;0;0;0;0;0;0;0;0;0;0;0;0;0;0;0;0;0;0
FR;12;2021-10-03;0;0;0;0;0;0;0;0;0;0;0;0;0;0;0;0;0;0
FR;12;2021-10-04;0;0;0;0;0;0;0;0;0;0;0;0;0;0;0;0;0;0
FR;12;2021-10-05;0;0;0;0;0;0;0;0;0;0;0;0;0;0;0;0;0;0
FR;12;2021-10-06;0;0;0;0;0;0;0;0;0;0;0;0;0;0;0;0;0;0
FR;12;2021-10-07;0;0;0;0;0;0;0;0;0;0;0;0;0;0;0;0;0;0
FR;12;2021-10-08;0;0;0;0;0;0;0;0;0;0;0;0;0;0;0;0;0;0
FR;12;2021-10-09;0;0;0;0;0;0;0;0;0;0;0;0;0;0;0;0;0;0
FR;12;2021-10-10;0;0;0;0;0;0;0;0;0;0;0;0;0;0;0;0;0;0
FR;12;2021-10-11;0;0;0;0;0;0;0;0;0;0;0;0;0;0;0;0;0;0
FR;12;2021-10-12;0;0;0;0;0;0;0;0;0;0;0;0;0;0;0;0;0;0
FR;12;2021-10-13;0;0;0;0;0;0;0;0;0;0;0;0;0;0;0;0;0;0
FR;12;2021-10-14;0;0;0;0;0;0;0;0;0;0;0;0;0;0;0;0;0;0
FR;12;2021-10-15;0;0;0;0;0;0;0;0;0;0;0;0;0;0;0;0;0;0
FR;12;2021-10-16;0;0;0;0;0;0;0;0;0;0;0;0;0;0;0;0;0;0
FR;12;2021-10-17;0;0;0;0;0;0;0;0;0;0;0;0;0;0;0;0;0;0
FR;12;2021-10-18;0;0;0;0;0;0;0;0;0;0;0;0;0;0;0;0;0;0
FR;12;2021-10-19;0;0;0;0;0;0;0;0;0;0;0;0;0;0;0;0;0;0
FR;12;2021-10-20;0;0;0;0;0;0;0;0;0;0;0;0;0;0;0;0;0;0
FR;12;2021-10-21;0;0;0;0;0;0;0;0;0;0;0;0;0;0;0;0;0;0
FR;12;2021-10-22;0;0;0;0;0;0;0;0;0;0;0;0;0;0;0;0;0;0
FR;12;2021-10-23;0;0;0;0;0;0;0;0;0;0;0;0;0;0;0;0;0;0
FR;12;2021-10-24;0;0;0;0;0;0;0;0;0;0;0;0;0;0;0;0;0;0
FR;12;2021-10-25;0;0;0;0;0;0;0;0;0;0;0;0;0;0;0;0;0;0
FR;12;2021-10-26;0;0;0;0;0;0;0;0;0;0;0;0;0;0;0;0;0;0
FR;12;2021-10-27;0;0;0;0;0;0;0;0;0;0;0;0;0;0;0;0;0;0
FR;12;2021-10-28;0;0;0;0;0;0;0;0;0;0;0;0;0;0;0;0;0;0
FR;12;2021-10-29;0;0;0;0;0;0;0;0;0;0;0;0;0;0;0;0;0;0
FR;12;2021-10-30;0;0;0;0;0;0;0;0;0;0;0;0;0;0;0;0;0;0
FR;12;2021-10-31;0;0;0;0;0;0;0;0;0;0;0;0;0;0;0;0;0;0
FR;12;2021-11-01;0;0;0;0;0;0;0;0;0;0;0;0;0;0;0;0;0;0
FR;12;2021-11-02;0;0;0;0;0;0;0;0;0;0;0;0;0;0;0;0;0;0
FR;12;2021-11-03;0;0;0;0;0;0;0;0;0;0;0;0;0;0;0;0;0;0
FR;12;2021-11-04;0;0;0;0;0;0;0;0;0;0;0;0;0;0;0;0;0;0
FR;12;2021-11-05;0;0;0;0;0;0;0;0;0;0;0;0;0;0;0;0;0;0
FR;12;2021-11-06;0;0;0;0;0;0;0;0;0;0;0;0;0;0;0;0;0;0
FR;12;2021-11-07;0;0;0;0;0;0;0;0;0;0;0;0;0;0;0;0;0;0
FR;12;2021-11-08;0;0;0;0;0;0;0;0;0;0;0;0;0;0;0;0;0;0
FR;12;2021-11-09;0;0;0;0;0;0;0;0;0;0;0;0;0;0;0;0;0;0
FR;12;2021-11-10;0;0;0;0;0;0;0;0;0;0;0;0;0;0;0;0;0;0
FR;12;2021-11-11;0;0;0;0;0;0;0;0;0;0;0;0;0;0;0;0;0;0
FR;12;2021-11-12;0;0;0;0;0;0;0;0;0;0;0;0;0;0;0;0;0;0
FR;12;2021-11-13;0;0;0;0;0;0;0;0;0;0;0;0;0;0;0;0;0;0
FR;12;2021-11-14;0;0;0;0;0;0;0;0;0;0;0;0;0;0;0;0;0;0
FR;12;2021-11-15;0;0;0;0;0;0;0;0;0;0;0;0;0;0;0;0;0;0
FR;12;2021-11-16;0;0;0;0;0;0;0;0;0;0;0;0;0;0;0;0;0;0
FR;12;2021-11-17;0;0;0;0;0;0;0;0;0;0;0;0;0;0;0;0;0;0
FR;12;2021-11-18;0;0;0;0;0;0;0;0;0;0;0;0;0;0;0;0;0;0
FR;12;2021-11-19;0;0;0;0;0;0;0;0;0;0;0;0;0;0;0;0;0;0
FR;12;2021-11-20;0;0;0;0;0;0;0;0;0;0;0;0;0;0;0;0;0;0
FR;12;2021-11-21;0;0;0;0;0;0;0;0;0;0;0;0;0;0;0;0;0;0
FR;12;2021-11-22;0;0;0;0;0;0;0;0;0;0;0;0;0;0;0;0;0;0
FR;12;2021-11-23;0;0;0;0;0;0;0;0;0;0;0;0;0;0;0;0;0;0
FR;12;2021-11-24;0;0;0;0;0;0;0;0;0;0;0;0;0;0;0;0;0;0
FR;12;2021-11-25;0;0;0;0;0;0;0;0;0;0;0;0;0;0;0;0;0;0
FR;12;2021-11-26;0;0;0;0;0;0;0;0;0;0;0;0;0;0;0;0;0;0
FR;12;2021-11-27;0;0;0;0;0;0;0;0;0;0;0;0;0;0;0;0;0;0
FR;12;2021-11-28;0;0;0;0;0;0;0;0;0;0;0;0;0;0;0;0;0;0
FR;12;2021-11-29;0;0;0;0;0;0;0;0;0;0;0;0;0;0;0;0;0;0
FR;12;2021-11-30;0;0;0;0;0;0;0;0;0;0;0;0;0;0;0;0;0;0
FR;12;2021-12-01;0;0;0;0;0;0;0;0;0;0;0;0;0;0;0;0;0;0
FR;12;2021-12-02;0;0;0;0;0;0;0;0;0;0;0;0;0;0;0;0;0;0
FR;12;2021-12-03;0;0;0;0;0;0;0;0;0;0;0;0;0;0;0;0;0;0
FR;12;2021-12-04;0;0;0;0;0;0;0;0;0;0;0;0;0;0;0;0;0;0
FR;12;2021-12-05;0;0;0;0;0;0;0;0;0;0;0;0;0;0;0;0;0;0
FR;12;2021-12-06;0;0;0;0;0;0;0;0;0;0;0;0;0;0;0;0;0;0
FR;12;2021-12-07;0;0;0;0;0;0;0;0;0;0;0;0;0;0;0;0;0;0
FR;12;2021-12-08;0;0;0;0;0;0;0;0;0;0;0;0;0;0;0;0;0;0
FR;12;2021-12-09;0;0;0;0;0;0;0;0;0;0;0;0;0;0;0;0;0;0
FR;12;2021-12-10;0;0;0;0;0;0;0;0;0;0;0;0;0;0;0;0;0;0
FR;12;2021-12-11;0;0;0;0;0;0;0;0;0;0;0;0;0;0;0;0;0;0
FR;12;2021-12-12;0;0;0;0;0;0;0;0;0;0;0;0;0;0;0;0;0;0
FR;12;2021-12-13;0;0;0;0;0;0;0;0;0;0;0;0;0;0;0;0;0;0
FR;12;2021-12-14;0;0;0;0;0;0;0;0;0;0;0;0;0;0;0;0;0;0
FR;12;2021-12-15;0;0;0;0;0;0;0;0;0;0;0;0;0;0;0;0;0;0
FR;12;2021-12-16;0;0;0;0;0;0;0;0;0;0;0;0;0;0;0;0;0;0
FR;12;2021-12-17;0;0;0;0;0;0;0;0;0;0;0;0;0;0;0;0;0;0
FR;12;2021-12-18;0;0;0;0;0;0;0;0;0;0;0;0;0;0;0;0;0;0
FR;12;2021-12-19;0;0;0;0;0;0;0;0;0;0;0;0;0;0;0;0;0;0
FR;12;2021-12-20;0;0;0;0;0;0;0;0;0;0;0;0;0;0;0;0;0;0
FR;12;2021-12-21;0;0;0;0;0;0;0;0;0;0;0;0;0;0;0;0;0;0
FR;12;2021-12-22;0;0;0;0;0;0;0;0;0;0;0;0;0;0;0;0;0;0
FR;12;2021-12-23;0;0;0;0;0;0;0;0;0;0;0;0;0;0;0;0;0;0
FR;12;2021-12-24;0;0;0;0;0;0;0;0;0;0;0;0;0;0;0;0;0;0
FR;12;2021-12-25;0;0;0;0;0;0;0;0;0;0;0;0;0;0;0;0;0;0
FR;12;2021-12-26;0;0;0;0;0;0;0;0;0;0;0;0;0;0;0;0;0;0
FR;12;2021-12-27;0;0;0;0;0;0;0;0;0;0;0;0;0;0;0;0;0;0
FR;12;2021-12-28;0;0;0;0;0;0;0;0;0;0;0;0;0;0;0;0;0;0
FR;12;2021-12-29;0;0;0;0;0;0;0;0;0;0;0;0;0;0;0;0;0;0
FR;12;2021-12-30;0;0;0;0;0;0;0;0;0;0;0;0;0;0;0;0;0;0
FR;12;2021-12-31;0;0;0;0;0;0;0;0;0;0;0;0;0;0;0;0;0;0
FR;12;2022-01-01;0;0;0;0;0;0;0;0;0;0;0;0;0;0;0;0;0;0
FR;12;2022-01-02;0;0;0;0;0;0;0;0;0;0;0;0;0;0;0;0;0;0
FR;12;2022-01-03;0;0;0;0;0;0;0;0;0;0;0;0;0;0;0;0;0;0
FR;12;2022-01-04;0;0;0;0;0;0;0;0;0;0;0;0;0;0;0;0;0;0
FR;12;2022-01-05;0;0;0;0;0;0;0;0;0;0;0;0;0;0;0;0;0;0
FR;12;2022-01-06;0;0;0;0;0;0;0;0;0;0;0;0;0;0;0;0;0;0
FR;12;2022-01-07;0;0;0;0;0;0;0;0;0;0;0;0;0;0;0;0;0;0
FR;12;2022-01-08;0;0;0;0;0;0;0;0;0;0;0;0;0;0;0;0;0;0
FR;12;2022-01-09;0;0;0;0;0;0;0;0;0;0;0;0;0;0;0;0;0;0
FR;12;2022-01-10;0;0;0;0;0;0;0;0;0;0;0;0;0;0;0;0;0;0
FR;12;2022-01-11;0;0;0;0;0;0;0;0;0;0;0;0;0;0;0;0;0;0
FR;12;2022-01-12;0;0;0;0;0;0;0;0;0;0;0;0;0;0;0;0;0;0
FR;12;2022-01-13;0;0;0;0;0;0;0;0;0;0;0;0;0;0;0;0;0;0
FR;12;2022-01-14;0;0;0;0;0;0;0;0;0;0;0;0;0;0;0;0;0;0
FR;12;2022-01-15;0;0;0;0;0;0;0;0;0;0;0;0;0;0;0;0;0;0
FR;12;2022-01-16;0;0;0;0;0;0;0;0;0;0;0;0;0;0;0;0;0;0
FR;12;2022-01-17;0;0;0;0;0;0;0;0;0;0;0;0;0;0;0;0;0;0
FR;12;2022-01-18;0;0;0;0;0;0;0;0;0;0;0;0;0;0;0;0;0;0
FR;12;2022-01-19;0;0;0;0;0;0;0;0;0;0;0;0;0;0;0;0;0;0
FR;12;2022-01-20;0;0;0;0;0;0;0;0;0;0;0;0;0;0;0;0;0;0
FR;12;2022-01-21;0;0;0;0;0;0;0;0;0;0;0;0;0;0;0;0;0;0
FR;12;2022-01-22;0;0;0;0;0;0;0;0;0;0;0;0;0;0;0;0;0;0
FR;12;2022-01-23;0;0;0;0;0;0;0;0;0;0;0;0;0;0;0;0;0;0
FR;12;2022-01-24;0;0;0;0;0;0;0;0;0;0;0;0;0;0;0;0;0;0
FR;12;2022-01-25;0;0;0;0;0;0;0;0;0;0;0;0;0;0;0;0;0;0
FR;12;2022-01-26;0;0;0;0;0;0;0;0;0;0;0;0;0;0;0;0;0;0
FR;12;2022-01-27;0;0;0;0;0;0;0;0;0;0;0;0;0;0;0;0;0;0
FR;12;2022-01-28;0;0;0;0;0;0;0;0;0;0;0;0;0;0;0;0;0;0
FR;12;2022-01-29;0;0;0;0;0;0;0;0;0;0;0;0;0;0;0;0;0;0
FR;12;2022-01-30;0;0;0;0;0;0;0;0;0;0;0;0;0;0;0;0;0;0
FR;12;2022-01-31;0;0;0;0;0;0;0;0;0;0;0;0;0;0;0;0;0;0
FR;12;2022-02-01;0;0;0;0;0;0;0;0;0;0;0;0;0;0;0;0;0;0
FR;12;2022-02-02;0;0;0;0;0;0;0;0;0;0;0;0;0;0;0;0;0;0
FR;12;2022-02-03;0;0;0;0;0;0;0;0;0;0;0;0;0;0;0;0;0;0
FR;12;2022-02-04;0;0;0;0;0;0;0;0;0;0;0;0;0;0;0;0;0;0
FR;12;2022-02-05;0;0;0;0;0;0;0;0;0;0;0;0;0;0;0;0;0;0
FR;12;2022-02-06;0;0;0;0;0;0;0;0;0;0;0;0;0;0;0;0;0;0
FR;12;2022-02-07;0;0;0;0;0;0;0;0;0;0;0;0;0;0;0;0;0;0
FR;12;2022-02-08;0;0;0;0;0;0;0;0;0;0;0;0;0;0;0;0;0;0
FR;12;2022-02-09;0;0;0;0;0;0;0;0;0;0;0;0;0;0;0;0;0;0
FR;12;2022-02-10;0;0;0;0;0;0;0;0;0;0;0;0;0;0;0;0;0;0
FR;12;2022-02-11;0;0;0;0;0;0;0;0;0;0;0;0;0;0;0;0;0;0
FR;12;2022-02-12;0;0;0;0;0;0;0;0;0;0;0;0;0;0;0;0;0;0
FR;12;2022-02-13;0;0;0;0;0;0;0;0;0;0;0;0;0;0;0;0;0;0
FR;12;2022-02-14;0;0;0;0;0;0;0;0;0;0;0;0;0;0;0;0;0;0
FR;12;2022-02-15;0;0;0;0;0;0;0;0;0;0;0;0;0;0;0;0;0;0
FR;12;2022-02-16;0;0;0;0;0;0;0;0;0;0;0;0;0;0;0;0;0;0
FR;12;2022-02-17;0;0;0;0;0;0;0;0;0;0;0;0;0;0;0;0;0;0
FR;12;2022-02-18;0;0;0;0;0;0;0;0;0;0;0;0;0;0;0;0;0;0
FR;12;2022-02-19;0;0;0;0;0;0;0;0;0;0;0;0;0;0;0;0;0;0
FR;12;2022-02-20;0;0;0;0;0;0;0;0;0;0;0;0;0;0;0;0;0;0
FR;12;2022-02-21;0;0;0;0;0;0;0;0;0;0;0;0;0;0;0;0;0;0
FR;12;2022-02-22;0;0;0;0;0;0;0;0;0;0;0;0;0;0;0;0;0;0
FR;12;2022-02-23;0;0;0;0;0;0;0;0;0;0;0;0;0;0;0;0;0;0
FR;12;2022-02-24;0;0;0;0;0;0;0;0;0;0;0;0;0;0;0;0;0;0
FR;12;2022-02-25;0;0;0;0;0;0;0;0;0;0;0;0;0;0;0;0;0;0
FR;12;2022-02-26;0;0;0;0;0;0;0;0;0;0;0;0;0;0;0;0;0;0
FR;12;2022-02-27;0;0;0;0;0;0;0;0;0;0;0;0;0;0;0;0;0;0
FR;12;2022-02-28;0;0;0;0;0;0;0;0;0;0;0;0;0;0;0;0;0;0
FR;12;2022-03-01;0;0;0;0;0;0;0;0;0;0;0;0;0;0;0;0;0;0
FR;12;2022-03-02;0;0;0;0;0;0;0;0;0;0;0;0;0;0;0;0;0;0
FR;12;2022-03-03;0;0;0;0;0;0;0;0;0;0;0;0;0;0;0;0;0;0
FR;12;2022-03-04;0;0;0;0;0;0;0;0;0;0;0;0;0;0;0;0;0;0
FR;12;2022-03-05;0;0;0;0;0;0;0;0;0;0;0;0;0;0;0;0;0;0
FR;12;2022-03-06;0;0;0;0;0;0;0;0;0;0;0;0;0;0;0;0;0;0
FR;12;2022-03-07;0;0;0;0;0;0;0;0;0;0;0;0;0;0;0;0;0;0
FR;12;2022-03-08;0;0;0;0;0;0;0;0;0;0;0;0;0;0;0;0;0;0
FR;12;2022-03-09;0;0;0;0;0;0;0;0;0;0;0;0;0;0;0;0;0;0
FR;12;2022-03-10;0;0;0;0;0;0;0;0;0;0;0;0;0;0;0;0;0;0
FR;12;2022-03-11;0;0;0;0;0;0;0;0;0;0;0;0;0;0;0;0;0;0
FR;12;2022-03-12;0;0;0;0;0;0;0;0;0;0;0;0;0;0;0;0;0;0
FR;12;2022-03-13;0;0;0;0;0;0;0;0;0;0;0;0;0;0;0;0;0;0
FR;12;2022-03-14;0;0;0;0;0;0;0;0;0;0;0;0;0;0;0;0;0;0
FR;12;2022-03-15;0;0;0;0;0;0;0;0;0;0;0;0;0;0;0;0;0;0
FR;12;2022-03-16;0;0;0;0;0;0;0;0;0;0;0;0;0;0;0;0;0;0
FR;12;2022-03-17;0;0;0;0;0;0;0;0;0;0;0;0;0;0;0;0;0;0
FR;12;2022-03-18;0;0;0;0;0;0;0;0;0;0;0;0;0;0;0;0;0;0
FR;12;2022-03-19;0;0;0;0;0;0;0;0;0;0;0;0;0;0;0;0;0;0
FR;12;2022-03-20;0;0;0;0;0;0;0;0;0;0;0;0;0;0;0;0;0;0
FR;12;2022-03-21;0;0;0;0;0;0;0;0;0;0;0;0;0;0;0;0;0;0
FR;12;2022-03-22;0;0;0;0;0;0;0;0;0;0;0;0;0;0;0;0;0;0
FR;12;2022-03-23;0;0;0;0;0;0;0;0;0;0;0;0;0;0;0;0;0;0
FR;12;2022-03-24;0;0;0;0;0;0;0;0;0;0;0;0;0;0;0;0;0;0
FR;12;2022-03-25;0;0;0;0;0;0;0;0;0;0;0;0;0;0;0;0;0;0
FR;12;2022-03-26;0;0;0;0;0;0;0;0;0;0;0;0;0;0;0;0;0;0
FR;12;2022-03-27;0;0;0;0;0;0;0;0;0;0;0;0;0;0;0;0;0;0
FR;12;2022-03-28;0;0;0;0;0;0;0;0;0;0;0;0;0;0;0;0;0;0
FR;12;2022-03-29;0;0;0;0;0;0;0;0;0;0;0;0;0;0;0;0;0;0
FR;12;2022-03-30;0;0;0;0;0;0;0;0;0;0;0;0;0;0;0;0;0;0
FR;12;2022-03-31;0;0;0;0;0;0;0;0;0;0;0;0;0;0;0;0;0;0
FR;12;2022-04-01;0;0;0;0;0;0;0;0;0;0;0;0;0;0;0;0;0;0
FR;12;2022-04-02;0;0;0;0;0;0;0;0;0;0;0;0;0;0;0;0;0;0
FR;12;2022-04-03;0;0;0;0;0;0;0;0;0;0;0;0;0;0;0;0;0;0
FR;12;2022-04-04;0;0;0;0;0;0;0;0;0;0;0;0;0;0;0;0;0;0
FR;12;2022-04-05;0;0;0;0;0;0;0;0;0;0;0;0;0;0;0;0;0;0
FR;12;2022-04-06;0;0;0;0;0;0;0;0;0;0;0;0;0;0;0;0;0;0
FR;12;2022-04-07;0;0;0;0;0;0;0;0;0;0;0;0;0;0;0;0;0;0
FR;12;2022-04-08;0;0;0;0;0;0;0;0;0;0;0;0;0;0;0;0;0;0
FR;12;2022-04-09;0;0;0;0;0;0;0;0;0;0;0;0;0;0;0;0;0;0
FR;12;2022-04-10;0;0;0;0;0;0;0;0;0;0;0;0;0;0;0;0;0;0
FR;12;2022-04-11;0;0;0;0;0;0;0;0;0;0;0;0;0;0;0;0;0;0
FR;12;2022-04-12;0;0;0;0;0;0;0;0;0;0;0;0;0;0;0;0;0;0
FR;12;2022-04-13;0;0;0;0;0;0;0;0;0;0;0;0;0;0;0;0;0;0
FR;12;2022-04-14;0;0;0;0;0;0;0;0;0;0;0;0;0;0;0;0;0;0
FR;12;2022-04-15;0;0;0;0;0;0;0;0;0;0;0;0;0;0;0;0;0;0
FR;12;2022-04-16;0;0;0;0;0;0;0;0;0;0;0;0;0;0;0;0;0;0
FR;12;2022-04-17;0;0;0;0;0;0;0;0;0;0;0;0;0;0;0;0;0;0
FR;12;2022-04-18;0;0;0;0;0;0;0;0;0;0;0;0;0;0;0;0;0;0
FR;12;2022-04-19;0;0;0;0;0;0;0;0;0;0;0;0;0;0;0;0;0;0
FR;12;2022-04-20;0;0;0;0;0;0;0;0;0;0;0;0;0;0;0;0;0;0
FR;12;2022-04-21;0;0;0;0;0;0;0;0;0;0;0;0;0;0;0;0;0;0
FR;12;2022-04-22;0;0;0;0;0;0;0;0;0;0;0;0;0;0;0;0;0;0
FR;12;2022-04-23;0;0;0;0;0;0;0;0;0;0;0;0;0;0;0;0;0;0
FR;12;2022-04-24;0;0;0;0;0;0;0;0;0;0;0;0;0;0;0;0;0;0
FR;12;2022-04-25;0;0;0;0;0;0;0;0;0;0;0;0;0;0;0;0;0;0
FR;12;2022-04-26;0;0;0;0;0;0;0;0;0;0;0;0;0;0;0;0;0;0
FR;12;2022-04-27;0;0;0;0;0;0;0;0;0;0;0;0;0;0;0;0;0;0
FR;12;2022-04-28;0;0;0;0;0;0;0;0;0;0;0;0;0;0;0;0;0;0
FR;12;2022-04-29;0;0;0;0;0;0;0;0;0;0;0;0;0;0;0;0;0;0
FR;12;2022-04-30;0;0;0;0;0;0;0;0;0;0;0;0;0;0;0;0;0;0
FR;12;2022-05-01;0;0;0;0;0;0;0;0;0;0;0;0;0;0;0;0;0;0
FR;12;2022-05-02;0;0;0;0;0;0;0;0;0;0;0;0;0;0;0;0;0;0
FR;12;2022-05-03;0;0;0;0;0;0;0;0;0;0;0;0;0;0;0;0;0;0
FR;12;2022-05-04;0;0;0;0;0;0;0;0;0;0;0;0;0;0;0;0;0;0
FR;12;2022-05-05;0;0;0;0;0;0;0;0;0;0;0;0;0;0;0;0;0;0
FR;12;2022-05-06;0;0;0;0;0;0;0;0;0;0;0;0;0;0;0;0;0;0
FR;12;2022-05-07;0;0;0;0;0;0;0;0;0;0;0;0;0;0;0;0;0;0
FR;12;2022-05-08;0;0;0;0;0;0;0;0;0;0;0;0;0;0;0;0;0;0
FR;12;2022-05-09;0;0;0;0;0;0;0;0;0;0;0;0;0;0;0;0;0;0
FR;12;2022-05-10;0;0;0;0;0;0;0;0;0;0;0;0;0;0;0;0;0;0
FR;12;2022-05-11;0;0;0;0;0;0;0;0;0;0;0;0;0;0;0;0;0;0
FR;12;2022-05-12;0;0;0;0;0;0;0;0;0;0;0;0;0;0;0;0;0;0
FR;12;2022-05-13;0;0;0;0;0;0;0;0;0;0;0;0;0;0;0;0;0;0
FR;12;2022-05-14;0;0;0;0;0;0;0;0;0;0;0;0;0;0;0;0;0;0
FR;12;2022-05-15;0;0;0;0;0;0;0;0;0;0;0;0;0;0;0;0;0;0
FR;12;2022-05-16;0;0;0;0;0;0;0;0;0;0;0;0;0;0;0;0;0;0
FR;12;2022-05-17;0;0;0;0;0;0;0;0;0;0;0;0;0;0;0;0;0;0
FR;12;2022-05-18;0;0;0;0;0;0;0;0;0;0;0;0;0;0;0;0;0;0
FR;12;2022-05-19;0;0;0;0;0;0;0;0;0;0;0;0;0;0;0;0;0;0
FR;12;2022-05-20;0;0;0;0;0;0;0;0;0;0;0;0;0;0;0;0;0;0
FR;12;2022-05-21;0;0;0;0;0;0;0;0;0;0;0;0;0;0;0;0;0;0
FR;12;2022-05-22;0;0;0;0;0;0;0;0;0;0;0;0;0;0;0;0;0;0
FR;12;2022-05-23;0;0;0;0;0;0;0;0;0;0;0;0;0;0;0;0;0;0
FR;12;2022-05-24;0;0;0;0;0;0;0;0;0;0;0;0;0;0;0;0;0;0
FR;12;2022-05-25;0;0;0;0;0;0;0;0;0;0;0;0;0;0;0;0;0;0
FR;12;2022-05-26;0;0;0;0;0;0;0;0;0;0;0;0;0;0;0;0;0;0
FR;12;2022-05-27;0;0;0;0;0;0;0;0;0;0;0;0;0;0;0;0;0;0
FR;12;2022-05-28;0;0;0;0;0;0;0;0;0;0;0;0;0;0;0;0;0;0
FR;12;2022-05-29;0;0;0;0;0;0;0;0;0;0;0;0;0;0;0;0;0;0
FR;12;2022-05-30;0;0;0;0;0;0;0;0;0;0;0;0;0;0;0;0;0;0
FR;12;2022-05-31;0;0;0;0;0;0;0;0;0;0;0;0;0;0;0;0;0;0
FR;12;2022-06-01;0;0;0;0;0;0;0;0;0;0;0;0;0;0;0;0;0;0
FR;12;2022-06-02;0;0;0;0;0;0;0;0;0;0;0;0;0;0;0;0;0;0
FR;12;2022-06-03;0;0;0;0;0;0;0;0;0;0;0;0;0;0;0;0;0;0
FR;12;2022-06-04;0;0;0;0;0;0;0;0;0;0;0;0;0;0;0;0;0;0
FR;12;2022-06-05;0;0;0;0;0;0;0;0;0;0;0;0;0;0;0;0;0;0
FR;12;2022-06-06;0;0;0;0;0;0;0;0;0;0;0;0;0;0;0;0;0;0
FR;12;2022-06-07;0;0;0;0;0;0;0;0;0;0;0;0;0;0;0;0;0;0
FR;12;2022-06-08;0;0;0;0;0;0;0;0;0;0;0;0;0;0;0;0;0;0
FR;12;2022-06-09;0;0;0;0;0;0;0;0;0;0;0;0;0;0;0;0;0;0
FR;12;2022-06-10;0;0;0;0;0;0;0;0;0;0;0;0;0;0;0;0;0;0
FR;12;2022-06-11;0;0;0;0;0;0;0;0;0;0;0;0;0;0;0;0;0;0
FR;12;2022-06-12;0;0;0;0;0;0;0;0;0;0;0;0;0;0;0;0;0;0
FR;12;2022-06-13;0;0;0;0;0;0;0;0;0;0;0;0;0;0;0;0;0;0
FR;12;2022-06-14;0;0;0;0;0;0;0;0;0;0;0;0;0;0;0;0;0;0
FR;12;2022-06-15;0;0;0;0;0;0;0;0;0;0;0;0;0;0;0;0;0;0
FR;12;2022-06-16;0;0;0;0;0;0;0;0;0;0;0;0;0;0;0;0;0;0
FR;12;2022-06-17;0;0;0;0;0;0;0;0;0;0;0;0;0;0;0;0;0;0
FR;12;2022-06-18;0;0;0;0;0;0;0;0;0;0;0;0;0;0;0;0;0;0
FR;12;2022-06-19;0;0;0;0;0;0;0;0;0;0;0;0;0;0;0;0;0;0
FR;12;2022-06-20;0;0;0;0;0;0;0;0;0;0;0;0;0;0;0;0;0;0
FR;12;2022-06-21;0;0;0;0;0;0;0;0;0;0;0;0;0;0;0;0;0;0
FR;12;2022-06-22;0;0;0;0;0;0;0;0;0;0;0;0;0;0;0;0;0;0
FR;12;2022-06-23;0;0;0;0;0;0;0;0;0;0;0;0;0;0;0;0;0;0
FR;12;2022-06-24;0;0;0;0;0;0;0;0;0;0;0;0;0;0;0;0;0;0
FR;12;2022-06-25;0;0;0;0;0;0;0;0;0;0;0;0;0;0;0;0;0;0
FR;12;2022-06-26;0;0;0;0;0;0;0;0;0;0;0;0;0;0;0;0;0;0
FR;12;2022-06-27;0;0;0;0;0;0;0;0;0;0;0;0;0;0;0;0;0;0
FR;12;2022-06-28;0;0;0;0;0;0;0;0;0;0;0;0;0;0;0;0;0;0
FR;12;2022-06-29;0;0;0;0;0;0;0;0;0;0;0;0;0;0;0;0;0;0
FR;12;2022-06-30;0;0;0;0;0;0;0;0;0;0;0;0;0;0;0;0;0;0
FR;12;2022-07-01;0;0;0;0;0;0;0;0;0;0;0;0;0;0;0;0;0;0
FR;12;2022-07-02;0;0;0;0;0;0;0;0;0;0;0;0;0;0;0;0;0;0
FR;12;2022-07-03;0;0;0;0;0;0;0;0;0;0;0;0;0;0;0;0;0;0
FR;12;2022-07-04;0;0;0;0;0;0;0;0;0;0;0;0;0;0;0;0;0;0
FR;12;2022-07-05;0;0;0;0;0;0;0;0;0;0;0;0;0;0;0;0;0;0
FR;12;2022-07-06;0;0;0;0;0;0;0;0;0;0;0;0;0;0;0;0;0;0
FR;12;2022-07-07;0;0;0;0;0;0;0;0;0;0;0;0;0;0;0;0;0;0
FR;12;2022-07-08;0;0;0;0;0;0;0;0;0;0;0;0;0;0;0;0;0;0
FR;12;2022-07-09;0;0;0;0;0;0;0;0;0;0;0;0;0;0;0;0;0;0
FR;12;2022-07-10;0;0;0;0;0;0;0;0;0;0;0;0;0;0;0;0;0;0
FR;12;2022-07-11;0;0;0;0;0;0;0;0;0;0;0;0;0;0;0;0;0;0
FR;12;2022-07-12;0;0;0;0;0;0;0;0;0;0;0;0;0;0;0;0;0;0
FR;12;2022-07-13;0;0;0;0;0;0;0;0;0;0;0;0;0;0;0;0;0;0
FR;12;2022-07-14;0;0;0;0;0;0;0;0;0;0;0;0;0;0;0;0;0;0
FR;12;2022-07-15;0;0;0;0;0;0;0;0;0;0;0;0;0;0;0;0;0;0
FR;12;2022-07-16;0;0;0;0;0;0;0;0;0;0;0;0;0;0;0;0;0;0
FR;12;2022-07-17;0;0;0;0;0;0;0;0;0;0;0;0;0;0;0;0;0;0
FR;12;2022-07-18;0;0;0;0;0;0;0;0;0;0;0;0;0;0;0;0;0;0
FR;12;2022-07-19;0;0;0;0;0;0;0;0;0;0;0;0;0;0;0;0;0;0
FR;12;2022-07-20;0;0;0;0;0;0;0;0;0;0;0;0;0;0;0;0;0;0
FR;12;2022-07-21;0;0;0;0;0;0;0;0;0;0;0;0;0;0;0;0;0;0
FR;12;2022-07-22;0;0;0;0;0;0;0;0;0;0;0;0;0;0;0;0;0;0
FR;12;2022-07-23;0;0;0;0;0;0;0;0;0;0;0;0;0;0;0;0;0;0
FR;12;2022-07-24;0;0;0;0;0;0;0;0;0;0;0;0;0;0;0;0;0;0
FR;12;2022-07-25;0;0;0;0;0;0;0;0;0;0;0;0;0;0;0;0;0;0
FR;12;2022-07-26;0;0;0;0;0;0;0;0;0;0;0;0;0;0;0;0;0;0
FR;12;2022-07-27;0;0;0;0;0;0;0;0;0;0;0;0;0;0;0;0;0;0
FR;12;2022-07-28;0;0;0;0;0;0;0;0;0;0;0;0;0;0;0;0;0;0
FR;12;2022-07-29;0;0;0;0;0;0;0;0;0;0;0;0;0;0;0;0;0;0
FR;12;2022-07-30;0;0;0;0;0;0;0;0;0;0;0;0;0;0;0;0;0;0
FR;12;2022-07-31;0;0;0;0;0;0;0;0;0;0;0;0;0;0;0;0;0;0
FR;12;2022-08-01;0;0;0;0;0;0;0;0;0;0;0;0;0;0;0;0;0;0
FR;12;2022-08-02;0;0;0;0;0;0;0;0;0;0;0;0;0;0;0;0;0;0
FR;12;2022-08-03;0;0;0;0;0;0;0;0;0;0;0;0;0;0;0;0;0;0
FR;12;2022-08-04;0;0;0;0;0;0;0;0;0;0;0;0;0;0;0;0;0;0
FR;12;2022-08-05;0;0;0;0;0;0;0;0;0;0;0;0;0;0;0;0;0;0
FR;12;2022-08-06;0;0;0;0;0;0;0;0;0;0;0;0;0;0;0;0;0;0
FR;12;2022-08-07;0;0;0;0;0;0;0;0;0;0;0;0;0;0;0;0;0;0
FR;12;2022-08-08;0;0;0;0;0;0;0;0;0;0;0;0;0;0;0;0;0;0
FR;12;2022-08-09;0;0;0;0;0;0;0;0;0;0;0;0;0;0;0;0;0;0
FR;12;2022-08-10;0;0;0;0;0;0;0;0;0;0;0;0;0;0;0;0;0;0
FR;12;2022-08-11;0;0;0;0;0;0;0;0;0;0;0;0;0;0;0;0;0;0
FR;12;2022-08-12;0;0;0;0;0;0;0;0;0;0;0;0;0;0;0;0;0;0
FR;12;2022-08-13;0;0;0;0;0;0;0;0;0;0;0;0;0;0;0;0;0;0
FR;12;2022-08-14;0;0;0;0;0;0;0;0;0;0;0;0;0;0;0;0;0;0
FR;12;2022-08-15;0;0;0;0;0;0;0;0;0;0;0;0;0;0;0;0;0;0
FR;12;2022-08-16;0;0;0;0;0;0;0;0;0;0;0;0;0;0;0;0;0;0
FR;12;2022-08-17;0;0;0;0;0;0;0;0;0;0;0;0;0;0;0;0;0;0
FR;12;2022-08-18;0;0;0;0;0;0;0;0;0;0;0;0;0;0;0;0;0;0
FR;12;2022-08-19;0;0;0;0;0;0;0;0;0;0;0;0;0;0;0;0;0;0
FR;12;2022-08-20;0;0;0;0;0;0;0;0;0;0;0;0;0;0;0;0;0;0
FR;12;2022-08-21;0;0;0;0;0;0;0;0;0;0;0;0;0;0;0;0;0;0
FR;12;2022-08-22;0;0;0;0;0;0;0;0;0;0;0;0;0;0;0;0;0;0
FR;12;2022-08-23;0;0;0;0;0;0;0;0;0;0;0;0;0;0;0;0;0;0
FR;12;2022-08-24;0;0;0;0;0;0;0;0;0;0;0;0;0;0;0;0;0;0
FR;12;2022-08-25;0;0;0;0;0;0;0;0;0;0;0;0;0;0;0;0;0;0
FR;12;2022-08-26;0;0;0;0;0;0;0;0;0;0;0;0;0;0;0;0;0;0
FR;12;2022-08-27;0;0;0;0;0;0;0;0;0;0;0;0;0;0;0;0;0;0
FR;12;2022-08-28;0;0;0;0;0;0;0;0;0;0;0;0;0;0;0;0;0;0
FR;12;2022-08-29;0;0;0;0;0;0;0;0;0;0;0;0;0;0;0;0;0;0
FR;12;2022-08-30;0;0;0;0;0;0;0;0;0;0;0;0;0;0;0;0;0;0
FR;12;2022-08-31;0;0;0;0;0;0;0;0;0;0;0;0;0;0;0;0;0;0
FR;12;2022-09-01;0;0;0;0;0;0;0;0;0;0;0;0;0;0;0;0;0;0
FR;12;2022-09-02;0;0;0;0;0;0;0;0;0;0;0;0;0;0;0;0;0;0
FR;12;2022-09-03;0;0;0;0;0;0;0;0;0;0;0;0;0;0;0;0;0;0
FR;12;2022-09-04;0;0;0;0;0;0;0;0;0;0;0;0;0;0;0;0;0;0
FR;12;2022-09-05;0;0;0;0;0;0;0;0;0;0;0;0;0;0;0;0;0;0
FR;12;2022-09-06;0;0;0;0;0;0;0;0;0;0;0;0;0;0;0;0;0;0
FR;12;2022-09-07;0;0;0;0;0;0;0;0;0;0;0;0;0;0;0;0;0;0
FR;12;2022-09-08;0;0;0;0;0;0;0;0;0;0;0;0;0;0;0;0;0;0
FR;12;2022-09-09;0;0;0;0;0;0;0;0;0;0;0;0;0;0;0;0;0;0
FR;12;2022-09-10;0;0;0;0;0;0;0;0;0;0;0;0;0;0;0;0;0;0
FR;12;2022-09-11;0;0;0;0;0;0;0;0;0;0;0;0;0;0;0;0;0;0
FR;12;2022-09-12;0;0;0;0;0;0;0;0;0;0;0;0;0;0;0;0;0;0
FR;12;2022-09-13;0;0;0;0;0;0;0;0;0;0;0;0;0;0;0;0;0;0
FR;12;2022-09-14;0;0;0;0;0;0;0;0;0;0;0;0;0;0;0;0;0;0
FR;12;2022-09-15;0;0;0;0;0;0;0;0;0;0;0;0;0;0;0;0;0;0
FR;12;2022-09-16;0;0;0;0;0;0;0;0;0;0;0;0;0;0;0;0;0;0
FR;12;2022-09-17;0;0;0;0;0;0;0;0;0;0;0;0;0;0;0;0;0;0
FR;12;2022-09-18;0;0;0;0;0;0;0;0;0;0;0;0;0;0;0;0;0;0
FR;12;2022-09-19;0;0;0;0;0;0;0;0;0;0;0;0;0;0;0;0;0;0
FR;12;2022-09-20;0;0;0;0;0;0;0;0;0;0;0;0;0;0;0;0;0;0
FR;12;2022-09-21;0;0;0;0;0;0;0;0;0;0;0;0;0;0;0;0;0;0
FR;12;2022-09-22;0;0;0;0;0;0;0;0;0;0;0;0;0;0;0;0;0;0
FR;12;2022-09-23;0;0;0;0;0;0;0;0;0;0;0;0;0;0;0;0;0;0
FR;12;2022-09-24;0;0;0;0;0;0;0;0;0;0;0;0;0;0;0;0;0;0
FR;12;2022-09-25;0;0;0;0;0;0;0;0;0;0;0;0;0;0;0;0;0;0
FR;12;2022-09-26;0;0;0;0;0;0;0;0;0;0;0;0;0;0;0;0;0;0
FR;12;2022-09-27;0;0;0;0;0;0;0;0;0;0;0;0;0;0;0;0;0;0
FR;12;2022-09-28;0;0;0;0;0;0;0;0;0;0;0;0;0;0;0;0;0;0
FR;12;2022-09-29;0;0;0;0;0;0;0;0;0;0;0;0;0;0;0;0;0;0
FR;12;2022-09-30;0;0;0;0;0;0;0;0;0;0;0;0;0;0;0;0;0;0
FR;12;2022-10-01;0;0;0;0;0;0;0;0;0;0;0;0;0;0;0;0;0;0
FR;12;2022-10-02;0;0;0;0;0;0;0;0;0;0;0;0;0;0;0;0;0;0
FR;12;2022-10-03;0;0;0;0;0;0;0;0;0;0;0;0;0;0;0;0;0;0
FR;12;2022-10-04;0;0;0;0;0;0;0;0;0;0;0;0;0;0;0;0;0;0
FR;12;2022-10-05;0;0;0;0;0;0;0;0;0;0;0;0;0;0;0;0;0;0
FR;12;2022-10-06;0;0;0;0;0;0;0;0;0;0;0;0;0;0;0;0;0;0
FR;12;2022-10-07;0;0;0;0;0;0;0;0;0;0;0;0;0;0;0;0;0;0
FR;12;2022-10-08;0;0;0;0;0;0;0;0;0;0;0;0;0;0;0;0;0;0
FR;12;2022-10-09;0;0;0;0;0;0;0;0;0;0;0;0;0;0;0;0;0;0
FR;12;2022-10-10;0;0;0;0;0;0;0;0;0;0;0;0;0;0;0;0;0;0
FR;12;2022-10-11;0;0;0;0;0;0;0;0;0;0;0;0;0;0;0;0;0;0
FR;12;2022-10-12;0;0;0;0;0;0;0;0;0;0;0;0;0;0;0;0;0;0
FR;12;2022-10-13;0;0;0;0;0;0;0;0;0;0;0;0;0;0;0;0;0;0
FR;12;2022-10-14;0;0;0;0;0;0;0;0;0;0;0;0;0;0;0;0;0;0
FR;12;2022-10-15;0;0;0;0;0;0;0;0;0;0;0;0;0;0;0;0;0;0
FR;12;2022-10-16;0;0;0;0;0;0;0;0;0;0;0;0;0;0;0;0;0;0
FR;12;2022-10-17;0;0;0;0;0;0;0;0;0;0;0;0;0;0;0;0;0;0
FR;12;2022-10-18;0;0;0;0;0;0;0;0;0;0;0;0;0;0;0;0;0;0
FR;12;2022-10-19;0;0;0;0;0;0;0;0;0;0;0;0;0;0;0;0;0;0
FR;12;2022-10-20;0;0;0;0;0;0;0;0;0;0;0;0;0;0;0;0;0;0
FR;12;2022-10-21;0;0;0;0;0;0;0;0;0;0;0;0;0;0;0;0;0;0
FR;12;2022-10-22;0;0;0;0;0;0;0;0;0;0;0;0;0;0;0;0;0;0
FR;12;2022-10-23;0;0;0;0;0;0;0;0;0;0;0;0;0;0;0;0;0;0
FR;12;2022-10-24;0;0;0;0;0;0;0;0;0;0;0;0;0;0;0;0;0;0
FR;12;2022-10-25;0;0;0;0;0;0;0;0;0;0;0;0;0;0;0;0;0;0
FR;12;2022-10-26;0;0;0;0;0;0;0;0;0;0;0;0;0;0;0;0;0;0
FR;12;2022-10-27;0;0;0;0;0;0;0;0;0;0;0;0;0;0;0;0;0;0
FR;12;2022-10-28;0;0;0;0;0;0;0;0;0;0;0;0;0;0;0;0;0;0
FR;12;2022-10-29;0;0;0;0;0;0;0;0;0;0;0;0;0;0;0;0;0;0
FR;12;2022-10-30;0;0;0;0;0;0;0;0;0;0;0;0;0;0;0;0;0;0
FR;12;2022-10-31;0;0;0;0;0;0;0;0;0;0;0;0;0;0;0;0;0;0
FR;12;2022-11-01;0;0;0;0;0;0;0;0;0;0;0;0;0;0;0;0;0;0
FR;12;2022-11-02;0;0;0;0;0;0;0;0;0;0;0;0;0;0;0;0;0;0
FR;12;2022-11-03;0;0;0;0;0;0;0;0;0;0;0;0;0;0;0;0;0;0
FR;12;2022-11-04;0;0;0;0;0;0;0;0;0;0;0;0;0;0;0;0;0;0
FR;12;2022-11-05;0;0;0;0;0;0;0;0;0;0;0;0;0;0;0;0;0;0
FR;12;2022-11-06;0;0;0;0;0;0;0;0;0;0;0;0;0;0;0;0;0;0
FR;12;2022-11-07;0;0;0;0;0;0;0;0;0;0;0;0;0;0;0;0;0;0
FR;12;2022-11-08;0;0;0;0;0;0;0;0;0;0;0;0;0;0;0;0;0;0
FR;12;2022-11-09;0;0;0;0;0;0;0;0;0;0;0;0;0;0;0;0;0;0
FR;12;2022-11-10;0;0;0;0;0;0;0;0;0;0;0;0;0;0;0;0;0;0
FR;12;2022-11-11;0;0;0;0;0;0;0;0;0;0;0;0;0;0;0;0;0;0
FR;12;2022-11-12;0;0;0;0;0;0;0;0;0;0;0;0;0;0;0;0;0;0
FR;12;2022-11-13;0;0;0;0;0;0;0;0;0;0;0;0;0;0;0;0;0;0
FR;12;2022-11-14;0;0;0;0;0;0;0;0;0;0;0;0;0;0;0;0;0;0
FR;12;2022-11-15;0;0;0;0;0;0;0;0;0;0;0;0;0;0;0;0;0;0
FR;12;2022-11-16;0;0;0;0;0;0;0;0;0;0;0;0;0;0;0;0;0;0
FR;12;2022-11-17;0;0;0;0;0;0;0;0;0;0;0;0;0;0;0;0;0;0
FR;12;2022-11-18;0;0;0;0;0;0;0;0;0;0;0;0;0;0;0;0;0;0
FR;12;2022-11-19;0;0;0;0;0;0;0;0;0;0;0;0;0;0;0;0;0;0
FR;12;2022-11-20;0;0;0;0;0;0;0;0;0;0;0;0;0;0;0;0;0;0
FR;12;2022-11-21;0;0;0;0;0;0;0;0;0;0;0;0;0;0;0;0;0;0
FR;12;2022-11-22;0;0;0;0;0;0;0;0;0;0;0;0;0;0;0;0;0;0
FR;12;2022-11-23;0;0;0;0;0;0;0;0;0;0;0;0;0;0;0;0;0;0
FR;12;2022-11-24;0;0;0;0;0;0;0;0;0;0;0;0;0;0;0;0;0;0
FR;12;2022-11-25;0;0;0;0;0;0;0;0;0;0;0;0;0;0;0;0;0;0
FR;12;2022-11-26;0;0;0;0;0;0;0;0;0;0;0;0;0;0;0;0;0;0
FR;12;2022-11-27;0;0;0;0;0;0;0;0;0;0;0;0;0;0;0;0;0;0
FR;12;2022-11-28;0;0;0;0;0;0;0;0;0;0;0;0;0;0;0;0;0;0
FR;12;2022-11-29;0;0;0;0;0;0;0;0;0;0;0;0;0;0;0;0;0;0
FR;12;2022-11-30;0;0;0;0;0;0;0;0;0;0;0;0;0;0;0;0;0;0
FR;12;2022-12-01;0;0;0;0;0;0;0;0;0;0;0;0;0;0;0;0;0;0
FR;12;2022-12-02;0;0;0;0;0;0;0;0;0;0;0;0;0;0;0;0;0;0
FR;12;2022-12-03;0;0;0;0;0;0;0;0;0;0;0;0;0;0;0;0;0;0
FR;12;2022-12-04;0;0;0;0;0;0;0;0;0;0;0;0;0;0;0;0;0;0
FR;12;2022-12-05;0;0;0;0;0;0;0;0;0;0;0;0;0;0;0;0;0;0
FR;12;2022-12-06;0;0;0;0;0;0;0;0;0;0;0;0;0;0;0;0;0;0
FR;12;2022-12-07;0;0;0;0;0;0;0;0;0;0;0;0;0;0;0;0;0;0
FR;12;2022-12-08;0;0;0;0;0;0;0;0;0;0;0;0;0;0;0;0;0;0
FR;12;2022-12-09;0;0;0;0;0;0;0;0;0;0;0;0;0;0;0;0;0;0
FR;12;2022-12-10;0;0;0;0;0;0;0;0;0;0;0;0;0;0;0;0;0;0
FR;12;2022-12-11;0;0;0;0;0;0;0;0;0;0;0;0;0;0;0;0;0;0
FR;12;2022-12-12;0;0;0;0;0;0;0;0;0;0;0;0;0;0;0;0;0;0
FR;12;2022-12-13;0;0;0;0;0;0;0;0;0;0;0;0;0;0;0;0;0;0
FR;12;2022-12-14;0;0;0;0;0;0;0;0;0;0;0;0;0;0;0;0;0;0
FR;12;2022-12-15;0;0;0;0;0;0;0;0;0;0;0;0;0;0;0;0;0;0
FR;12;2022-12-16;0;0;0;0;0;0;0;0;0;0;0;0;0;0;0;0;0;0
FR;12;2022-12-17;0;0;0;0;0;0;0;0;0;0;0;0;0;0;0;0;0;0
FR;12;2022-12-18;0;0;0;0;0;0;0;0;0;0;0;0;0;0;0;0;0;0
FR;12;2022-12-19;0;0;0;0;0;0;0;0;0;0;0;0;0;0;0;0;0;0
FR;12;2022-12-20;0;0;0;0;0;0;0;0;0;0;0;0;0;0;0;0;0;0
FR;12;2022-12-21;0;0;0;0;0;0;0;0;0;0;0;0;0;0;0;0;0;0
FR;12;2022-12-22;0;0;0;0;0;0;0;0;0;0;0;0;0;0;0;0;0;0
FR;12;2022-12-23;0;0;0;0;0;0;0;0;0;0;0;0;0;0;0;0;0;0
FR;12;2022-12-24;0;0;0;0;0;0;0;0;0;0;0;0;0;0;0;0;0;0
FR;12;2022-12-25;0;0;0;0;0;0;0;0;0;0;0;0;0;0;0;0;0;0
FR;12;2022-12-26;0;0;0;0;0;0;0;0;0;0;0;0;0;0;0;0;0;0
FR;12;2022-12-27;0;0;0;0;0;0;0;0;0;0;0;0;0;0;0;0;0;0
FR;12;2022-12-28;0;0;0;0;0;0;0;0;0;0;0;0;0;0;0;0;0;0
FR;12;2022-12-29;0;0;0;0;0;0;0;0;0;0;0;0;0;0;0;0;0;0
FR;12;2022-12-30;0;0;0;0;0;0;0;0;0;0;0;0;0;0;0;0;0;0
FR;12;2022-12-31;0;0;0;0;0;0;0;0;0;0;0;0;0;0;0;0;0;0
FR;12;2023-01-01;0;0;0;0;0;0;0;0;0;0;0;0;0;0;0;0;0;0
FR;12;2023-01-02;0;0;0;0;0;0;0;0;0;0;0;0;0;0;0;0;0;0
FR;12;2023-01-03;0;0;0;0;0;0;0;0;0;0;0;0;0;0;0;0;0;0
FR;12;2023-01-04;0;0;0;0;0;0;0;0;0;0;0;0;0;0;0;0;0;0
FR;12;2023-01-05;0;0;0;0;0;0;0;0;0;0;0;0;0;0;0;0;0;0
FR;12;2023-01-06;0;0;0;0;0;0;0;0;0;0;0;0;0;0;0;0;0;0
FR;12;2023-01-07;0;0;0;0;0;0;0;0;0;0;0;0;0;0;0;0;0;0
FR;12;2023-01-08;0;0;0;0;0;0;0;0;0;0;0;0;0;0;0;0;0;0
FR;12;2023-01-09;0;0;0;0;0;0;0;0;0;0;0;0;0;0;0;0;0;0
FR;12;2023-01-10;0;0;0;0;0;0;0;0;0;0;0;0;0;0;0;0;0;0
FR;12;2023-01-11;0;0;0;0;0;0;0;0;0;0;0;0;0;0;0;0;0;0
FR;12;2023-01-12;0;0;0;0;0;0;0;0;0;0;0;0;0;0;0;0;0;0
FR;12;2023-01-13;0;0;0;0;0;0;0;0;0;0;0;0;0;0;0;0;0;0
FR;12;2023-01-14;0;0;0;0;0;0;0;0;0;0;0;0;0;0;0;0;0;0
FR;12;2023-01-15;0;0;0;0;0;0;0;0;0;0;0;0;0;0;0;0;0;0
FR;12;2023-01-16;0;0;0;0;0;0;0;0;0;0;0;0;0;0;0;0;0;0
FR;12;2023-01-17;0;0;0;0;0;0;0;0;0;0;0;0;0;0;0;0;0;0
FR;12;2023-01-18;0;0;0;0;0;0;0;0;0;0;0;0;0;0;0;0;0;0
FR;12;2023-01-19;0;0;0;0;0;0;0;0;0;0;0;0;0;0;0;0;0;0
FR;12;2023-01-20;0;0;0;0;0;0;0;0;0;0;0;0;0;0;0;0;0;0
FR;12;2023-01-21;0;0;0;0;0;0;0;0;0;0;0;0;0;0;0;0;0;0
FR;12;2023-01-22;0;0;0;0;0;0;0;0;0;0;0;0;0;0;0;0;0;0
FR;12;2023-01-23;0;0;0;0;0;0;0;0;0;0;0;0;0;0;0;0;0;0
FR;12;2023-01-24;0;0;0;0;0;0;0;0;0;0;0;0;0;0;0;0;0;0
FR;12;2023-01-25;0;0;0;0;0;0;0;0;0;0;0;0;0;0;0;0;0;0
FR;12;2023-01-26;0;0;0;0;0;0;0;0;0;0;0;0;0;0;0;0;0;0
FR;12;2023-01-27;0;0;0;0;0;0;0;0;0;0;0;0;0;0;0;0;0;0
FR;12;2023-01-28;0;0;0;0;0;0;0;0;0;0;0;0;0;0;0;0;0;0
FR;12;2023-01-29;0;0;0;0;0;0;0;0;0;0;0;0;0;0;0;0;0;0
FR;12;2023-01-30;0;0;0;0;0;0;0;0;0;0;0;0;0;0;0;0;0;0
FR;12;2023-01-31;0;0;0;0;0;0;0;0;0;0;0;0;0;0;0;0;0;0
FR;12;2023-02-01;0;0;0;0;0;0;0;0;0;0;0;0;0;0;0;0;0;0
FR;12;2023-02-02;0;0;0;1;0;0;0;2;2;0;0;0;1;0;0;0;2;2
FR;12;2023-02-03;0;1;6;57;0;4;58;141;77;0;1;6;58;0;4;58;143;79
FR;12;2023-02-04;1;3;6;51;1;5;52;110;52;1;4;12;109;1;9;110;253;131
FR;12;2023-02-05;0;0;0;0;0;0;0;1;1;1;4;12;109;1;9;110;254;132
FR;12;2023-02-06;3;2;13;63;0;11;69;154;69;4;6;25;172;1;20;179;408;201
FR;12;2023-02-07;2;7;18;95;4;13;98;237;121;6;13;43;267;5;33;277;645;322
FR;12;2023-02-08;1;3;10;62;1;10;69;170;89;7;16;53;329;6;43;346;815;411
FR;12;2023-02-09;5;3;12;73;2;13;76;246;154;12;19;65;402;8;56;422;1061;565
FR;12;2023-02-10;4;2;22;140;4;12;150;327;162;16;21;87;542;12;68;572;1388;727
FR;12;2023-02-11;0;2;8;59;1;3;58;123;60;16;23;95;601;13;71;630;1511;787
FR;12;2023-02-12;0;0;0;3;0;0;3;7;3;16;23;95;604;13;71;633;1518;790
FR;12;2023-02-13;0;0;17;78;0;8;85;217;114;16;23;112;682;13;79;718;1735;904
FR;12;2023-02-14;3;5;17;96;5;14;99;229;108;19;28;129;778;18;93;817;1964;1012
FR;12;2023-02-15;3;5;19;85;0;13;86;236;132;22;33;148;863;18;106;903;2200;1144
FR;12;2023-02-16;5;3;16;107;3;13;103;247;129;27;36;164;970;21;119;1006;2447;1273
FR;12;2023-02-17;2;4;12;115;3;11;110;280;153;29;40;176;1085;24;130;1116;2727;1426
FR;12;2023-02-18;1;4;10;51;2;12;52;102;36;30;44;186;1136;26;142;1168;2829;1462
FR;12;2023-02-19;0;0;0;2;0;0;1;2;1;30;44;186;1138;26;142;1169;2831;1463
FR;12;2023-02-20;10;2;11;65;6;11;69;218;131;40;46;197;1203;32;153;1238;3049;1594
FR;12;2023-02-21;6;6;19;98;4;14;94;280;167;46;52;216;1301;36;167;1332;3329;1761
FR;12;2023-02-22;2;4;19;74;2;20;78;231;125;48;56;235;1375;38;187;1410;3560;1886
FR;12;2023-02-23;4;3;20;88;2;16;87;265;155;52;59;255;1463;40;203;1497;3825;2041
FR;12;2023-02-24;3;7;20;135;3;17;142;360;189;55;66;275;1598;43;220;1639;4185;2230
FR;12;2023-02-25;7;1;19;92;1;10;106;200;77;62;67;294;1690;44;230;1745;4385;2307
FR;12;2023-02-26;0;0;0;0;0;0;0;2;2;62;67;294;1690;44;230;1745;4387;2309
FR;12;2023-02-27;6;10;20;92;8;16;95;270;156;68;77;314;1782;52;246;1840;4657;2465
FR;12;2023-02-28;6;9;21;125;0;23;128;385;227;74;86;335;1907;52;269;1968;5042;2692
FR;12;2023-03-01;4;7;23;78;2;18;91;292;175;78;93;358;1985;54;287;2059;5334;2867
FR;12;2023-03-02;9;9;21;110;6;18;117;304;163;87;102;379;2095;60;305;2176;5638;3030
FR;12;2023-03-03;10;8;45;142;7;39;148;418;220;97;110;424;2237;67;344;2324;6056;3250
FR;12;2023-03-04;3;2;12;55;0;10;53;119;49;100;112;436;2292;67;354;2377;6175;3299
FR;12;2023-03-05;0;1;1;2;1;1;2;8;5;100;113;437;2294;68;355;2379;6183;3304
FR;12;2023-03-06;4;5;26;74;2;19;82;267;157;104;118;463;2368;70;374;2461;6450;3461
FR;12;2023-03-07;6;10;29;130;9;24;132;356;191;110;128;492;2498;79;398;2593;6806;3652
FR;12;2023-03-08;4;7;27;71;5;22;77;249;137;114;135;519;2569;84;420;2670;7055;3789
FR;12;2023-03-09;3;8;18;91;4;22;85;323;197;117;143;537;2660;88;442;2755;7378;3986
FR;12;2023-03-10;11;7;23;137;9;23;133;367;208;128;150;560;2797;97;465;2888;7745;4194
FR;12;2023-03-11;1;4;15;45;4;9;50;132;72;129;154;575;2842;101;474;2938;7877;4266
FR;12;2023-03-12;0;2;0;2;0;2;1;5;2;129;156;575;2844;101;476;2939;7882;4268
FR;12;2023-03-13;3;4;32;101;1;28;103;293;155;132;160;607;2945;102;504;3042;8175;4423
FR;12;2023-03-14;2;7;16;85;2;15;83;322;210;134;167;623;3030;104;519;3125;8497;4633
FR;12;2023-03-15;1;4;20;66;2;19;69;225;124;135;171;643;3096;106;538;3194;8722;4757
FR;12;2023-03-16;4;5;20;99;5;13;115;298;156;139;176;663;3195;111;551;3309;9020;4913
FR;12;2023-03-17;3;11;30;112;4;28;113;388;224;142;187;693;3307;115;579;3422;9408;5137
FR;12;2023-03-18;1;4;20;50;4;16;56;137;61;143;191;713;3357;119;595;3478;9545;5198
FR;12;2023-03-19;0;0;0;6;0;0;5;10;5;143;191;713;3363;119;595;3483;9555;5203
FR;12;2023-03-20;9;7;27;87;6;23;90;258;134;152;198;740;3450;125;618;3573;9813;5337
FR;12;2023-03-21;2;7;42;81;3;36;93;355;209;154;205;782;3531;128;654;3666;10168;5546
FR;12;2023-03-22;6;4;36;50;4;29;58;239;137;160;209;818;3581;132;683;3724;10407;5683
FR;12;2023-03-23;3;8;26;80;5;25;82;264;147;163;217;844;3661;137;708;3806;10671;5830
FR;12;2023-03-24;6;2;24;97;3;22;106;344;203;169;219;868;3758;140;730;3912;11015;6033
FR;12;2023-03-25;7;8;24;61;3;14;74;157;58;176;227;892;3819;143;744;3986;11172;6091
FR;12;2023-03-26;0;1;0;1;1;0;1;7;6;176;228;892;3820;144;744;3987;11179;6097
FR;12;2023-03-27;5;10;27;77;7;23;84;282;159;181;238;919;3897;151;767;4071;11461;6256
FR;12;2023-03-28;2;5;29;95;1;26;91;342;204;183;243;948;3992;152;793;4162;11803;6460
FR;12;2023-03-29;4;6;18;51;3;20;54;198;104;187;249;966;4043;155;813;4216;12001;6564
FR;0;2020-12-27;616;0;0;0;55;0;0;0;0;616;0;0;0;55;0;0;0;0
FR;0;2020-12-28;707;1;0;0;44;0;0;0;0;1323;1;0;0;99;0;0;0;0
FR;0;2020-12-29;389;0;0;0;19;0;0;0;0;1712;1;0;0;118;0;0;0;0
FR;0;2020-12-30;455;0;0;0;19;0;0;0;0;2167;1;0;0;137;0;0;0;0
FR;0;2020-12-31;450;1;0;0;21;0;0;0;0;2617;2;0;0;158;0;0;0;0
FR;0;2021-01-01;1193;2;0;0;66;0;0;0;0;3810;4;0;0;224;0;0;0;0
FR;0;2021-01-02;369;4;0;0;29;0;0;0;0;4179;8;0;0;253;0;0;0;0
FR;0;2021-01-03;418;0;0;0;23;0;0;0;0;4597;8;0;0;276;0;0;0;0
FR;0;2021-01-04;2145;5;0;0;51;0;0;0;0;6742;13;0;0;327;0;0;0;0
FR;0;2021-01-05;7778;6;0;0;128;0;0;0;0;14520;19;0;0;455;0;0;0;0
FR;0;2021-01-06;12479;23;0;0;128;0;0;0;0;26999;42;0;0;583;0;0;0;0
FR;0;2021-01-07;29480;24;0;0;159;0;0;0;0;56479;66;0;0;742;0;0;0;0
FR;0;2021-01-08;37170;35;0;0;204;0;0;0;0;93649;101;0;0;946;0;0;0;0
FR;0;2021-01-09;11220;9;0;0;77;0;0;0;0;104869;110;0;0;1023;0;0;0;0
FR;0;2021-01-10;6017;8;0;0;28;0;0;0;0;110886;118;0;0;1051;0;0;0;0
FR;0;2021-01-11;39956;39;0;0;232;0;0;0;0;150842;157;0;0;1283;0;0;0;0
FR;0;2021-01-12;62162;30;0;0;298;0;0;0;0;213004;187;0;0;1581;0;0;0;0
FR;0;2021-01-13;65147;62;0;0;433;0;0;0;0;278151;249;0;0;2014;0;0;0;0
FR;0;2021-01-14;83107;261;0;0;1171;0;0;0;0;361258;510;0;0;3185;0;0;0;0
FR;0;2021-01-15;69036;101;0;0;556;0;0;0;0;430294;611;0;0;3741;0;0;0;0
FR;0;2021-01-16;20219;73;0;0;183;0;0;0;0;450513;684;0;0;3924;0;0;0;0
FR;0;2021-01-17;10993;54;0;0;137;0;0;0;0;461506;738;0;0;4061;0;0;0;0
FR;0;2021-01-18;85923;179;0;0;614;0;0;0;0;547429;917;0;0;4675;0;0;0;0
FR;0;2021-01-19;130616;211;0;0;868;0;0;0;0;678045;1128;0;0;5543;0;0;0;0
FR;0;2021-01-20;137576;196;0;0;837;0;0;0;0;815621;1324;0;0;6380;0;0;0;0
FR;0;2021-01-21;158430;205;0;0;951;0;0;0;0;974051;1529;0;0;7331;0;0;0;0
FR;0;2021-01-22;121090;258;0;0;845;0;0;0;0;1095141;1787;0;0;8176;0;0;0;0
FR;0;2021-01-23;38492;86;0;0;223;0;0;0;0;1133633;1873;0;0;8399;0;0;0;0
FR;0;2021-01-24;9752;130;0;0;195;0;0;0;0;1143385;2003;0;0;8594;0;0;0;0
FR;0;2021-01-25;78256;1457;0;0;1808;0;0;0;0;1221641;3460;0;0;10402;0;0;0;0
FR;0;2021-01-26;100401;3708;1;0;4185;0;0;0;0;1322042;7168;1;0;14587;0;0;0;0
FR;0;2021-01-27;107266;6444;0;0;7160;0;0;0;0;1429308;13612;1;0;21747;0;0;0;0
FR;0;2021-01-28;124384;16416;0;0;17240;0;0;0;0;1553692;30028;1;0;38987;0;0;0;0
FR;0;2021-01-29;92201;18806;0;0;19383;0;0;0;0;1645893;48834;1;0;58370;0;0;0;0
FR;0;2021-01-30;29128;4535;0;0;4672;0;0;0;0;1675021;53369;1;0;63042;0;0;0;0
FR;0;2021-01-31;5240;1900;0;0;1945;0;0;0;0;1680261;55269;1;0;64987;0;0;0;0
FR;0;2021-02-01;53160;23048;0;0;23321;0;0;0;0;1733421;78317;1;0;88308;0;0;0;0
FR;0;2021-02-02;72335;38207;0;0;38699;0;0;0;0;1805756;116524;1;0;127007;0;0;0;0
FR;0;2021-02-03;72328;40248;0;0;40754;0;0;0;0;1878084;156772;1;0;167761;0;0;0;0
FR;0;2021-02-04;82096;55123;0;0;55719;0;0;0;0;1960180;211895;1;0;223480;0;0;0;0
FR;0;2021-02-05;68252;48243;0;0;48681;0;0;0;0;2028432;260138;1;0;272161;0;0;0;0
FR;0;2021-02-06;22952;11435;0;0;11674;0;0;0;0;2051384;271573;1;0;283835;0;0;0;0
FR;0;2021-02-07;5195;6073;0;0;6199;0;0;0;0;2056579;277646;1;0;290034;0;0;0;0
FR;0;2021-02-08;46855;48795;0;0;49283;0;0;0;0;2103434;326441;1;0;339317;0;0;0;0
FR;0;2021-02-09;66048;78449;0;0;79546;0;0;0;0;2169482;404890;1;0;418863;0;0;0;0
FR;0;2021-02-10;71049;83501;0;0;84799;0;0;0;0;2240531;488391;1;0;503662;0;0;0;0
FR;0;2021-02-11;87308;105649;0;0;107597;0;0;0;0;2327839;594040;1;0;611259;0;0;0;0
FR;0;2021-02-12;79355;76088;0;0;77835;0;0;0;0;2407194;670128;1;0;689094;0;0;0;0
FR;0;2021-02-13;22391;19535;0;0;19902;0;0;0;0;2429585;689663;1;0;708996;0;0;0;0
FR;0;2021-02-14;5080;7334;0;0;7462;0;0;0;0;2434665;696997;1;0;716458;0;0;0;0
FR;0;2021-02-15;38132;76794;0;0;77816;0;0;0;0;2472797;773791;1;0;794274;0;0;0;0
FR;0;2021-02-16;50420;99688;0;0;101038;0;0;0;0;2523217;873479;1;0;895312;0;0;0;0
FR;0;2021-02-17;50557;106932;20;0;108381;0;0;0;0;2573774;980411;21;0;1003693;0;0;0;0
FR;0;2021-02-18;69814;123725;0;0;125774;0;0;0;0;2643588;1104136;21;0;1129467;0;0;0;0
FR;0;2021-02-19;65093;92332;1;0;94222;0;0;0;0;2708681;1196468;22;0;1223689;0;0;0;0
FR;0;2021-02-20;18602;28547;0;0;28918;0;0;0;0;2727283;1225015;22;0;1252607;0;0;0;0
FR;0;2021-02-21;3335;6041;0;0;6146;0;0;0;0;2730618;1231056;22;0;1258753;0;0;0;0
FR;0;2021-02-22;37512;73175;2;0;74189;0;0;0;0;2768130;1304231;24;0;1332942;0;0;0;0
FR;0;2021-02-23;53803;85295;1;0;86818;0;0;0;0;2821933;1389526;25;0;1419760;0;0;0;0
FR;0;2021-02-24;60039;82931;1;0;84512;0;0;0;0;2881972;1472457;26;0;1504272;0;0;0;0
FR;0;2021-02-25;100611;91204;1;0;94202;0;0;0;0;2982583;1563661;27;0;1598474;0;0;0;0
FR;0;2021-02-26;113491;70755;1;0;73905;0;0;0;0;3096074;1634416;28;0;1672379;0;0;0;0
FR;0;2021-02-27;52131;22440;1;0;23685;0;0;0;0;3148205;1656856;29;0;1696064;0;0;0;0
FR;0;2021-02-28;6209;4121;2;0;4319;0;0;0;0;3154414;1660977;31;0;1700383;0;0;0;0
FR;0;2021-03-01;65945;54065;1;0;55936;0;0;0;0;3220359;1715042;32;0;1756319;0;0;0;0
FR;0;2021-03-02;101415;67172;3;0;70218;0;0;0;0;3321774;1782214;35;0;1826537;0;0;0;0
FR;0;2021-03-03;116565;65476;0;0;69166;0;0;0;0;3438339;1847690;35;0;1895703;0;0;0;0
FR;0;2021-03-04;163662;72627;3;0;78198;0;0;0;0;3602001;1920317;38;0;1973901;0;0;0;0
FR;0;2021-03-05;200962;62701;3;0;69434;0;0;0;0;3802963;1983018;41;0;2043335;0;0;0;0
FR;0;2021-03-06;207992;17483;3;0;22785;0;0;0;0;4010955;2000501;44;0;2066120;0;0;0;0
FR;0;2021-03-07;121293;3974;1;0;7268;0;0;0;0;4132248;2004475;45;0;2073388;0;0;0;0
FR;0;2021-03-08;107180;49557;2;0;53045;0;0;0;0;4239428;2054032;47;0;2126433;0;0;0;0
FR;0;2021-03-09;172487;56020;2;0;61514;0;0;0;0;4411915;2110052;49;0;2187947;0;0;0;0
FR;0;2021-03-10;179042;57054;5;0;62729;0;0;0;0;4590957;2167106;54;0;2250676;0;0;0;0
FR;0;2021-03-11;242933;64022;2;0;72119;0;0;0;0;4833890;2231128;56;0;2322795;0;0;0;0
FR;0;2021-03-12;294876;53369;1;0;62825;0;0;0;0;5128766;2284497;57;0;2385620;0;0;0;0
FR;0;2021-03-13;231444;15263;1;0;21241;0;0;0;0;5360210;2299760;58;0;2406861;0;0;0;0
FR;0;2021-03-14;63364;3044;1;0;5080;0;0;0;0;5423574;2302804;59;0;2411941;0;0;0;0
FR;0;2021-03-15;158699;31500;3;0;36155;0;0;0;0;5582273;2334304;62;0;2448096;0;0;0;0
FR;0;2021-03-16;141598;38816;6;0;42967;0;0;0;0;5723871;2373120;68;0;2491063;0;0;0;0
FR;0;2021-03-17;150519;37567;4;0;42334;0;0;0;0;5874390;2410687;72;0;2533397;0;0;0;0
FR;0;2021-03-18;167869;44324;5;0;49891;0;0;0;0;6042259;2455011;77;0;2583288;0;0;0;0
FR;0;2021-03-19;230056;36747;2;0;44104;0;0;0;0;6272315;2491758;79;0;2627392;0;0;0;0
FR;0;2021-03-20;166719;11385;1;0;16010;0;0;0;0;6439034;2503143;80;0;2643402;0;0;0;0
FR;0;2021-03-21;49957;2133;1;0;3891;0;0;0;0;6488991;2505276;81;0;2647293;0;0;0;0
FR;0;2021-03-22;170085;33520;2;0;39023;0;0;0;0;6659076;2538796;83;0;2686316;0;0;0;0
FR;0;2021-03-23;250440;42374;1;0;50220;0;0;0;0;6909516;2581170;84;0;2736536;0;0;0;0
FR;0;2021-03-24;256951;43591;0;0;51690;0;0;0;0;7166467;2624761;84;0;2788226;0;0;0;0
FR;0;2021-03-25;341875;45288;5;0;56292;0;0;0;0;7508342;2670049;89;0;2844518;0;0;0;0
FR;0;2021-03-26;358849;41801;5;1;53559;0;0;0;0;7867191;2711850;94;1;2898077;0;0;0;0
FR;0;2021-03-27;195297;16953;1;0;23397;0;0;0;0;8062488;2728803;95;1;2921474;0;0;0;0
FR;0;2021-03-28;59358;4587;3;0;6652;0;0;0;0;8121846;2733390;98;1;2928126;0;0;0;0
FR;0;2021-03-29;203028;53397;4;0;60161;0;0;0;0;8324874;2786787;102;1;2988287;0;0;0;0
FR;0;2021-03-30;285547;70037;5;0;80449;0;0;0;0;8610421;2856824;107;1;3068736;0;0;0;0
FR;0;2021-03-31;263082;74055;4;0;84727;0;0;0;0;8873503;2930879;111;1;3153463;0;0;0;0
FR;0;2021-04-01;315584;92811;11;0;106393;0;0;0;0;9189087;3023690;122;1;3259856;0;0;0;0
FR;0;2021-04-02;281384;94822;7;0;106653;0;0;0;0;9470471;3118512;129;1;3366509;0;0;0;0
FR;0;2021-04-03;141097;62597;6;0;67858;0;0;0;0;9611568;3181109;135;1;3434367;0;0;0;0
FR;0;2021-04-04;46552;19021;2;0;21074;0;0;0;0;9658120;3200130;137;1;3455441;0;0;0;0
FR;0;2021-04-05;63372;10402;11;0;13059;0;0;0;0;9721492;3210532;148;1;3468500;0;0;0;0
FR;0;2021-04-06;217273;113132;17;0;121997;0;0;0;0;9938765;3323664;165;1;3590497;0;0;0;0
FR;0;2021-04-07;260323;115278;17;0;126631;0;0;0;0;10199088;3438942;182;1;3717128;0;0;0;0
FR;0;2021-04-08;337915;123216;15;0;138845;0;0;0;0;10537003;3562158;197;1;3855973;0;0;0;0
FR;0;2021-04-09;410240;116887;49;0;134295;0;0;0;0;10947243;3679045;246;1;3990268;0;0;0;0
FR;0;2021-04-10;212665;82872;15;0;91263;0;0;0;0;11159908;3761917;261;1;4081531;0;0;0;0
FR;0;2021-04-11;56162;34179;7;0;36705;0;0;0;0;11216070;3796096;268;1;4118236;0;0;0;0
FR;0;2021-04-12;237128;115832;46;0;125441;0;0;0;0;11453198;3911928;314;1;4243677;0;0;0;0
FR;0;2021-04-13;309555;144162;98;1;157126;0;0;0;0;11762753;4056090;412;2;4400803;0;0;0;0
FR;0;2021-04-14;294604;139851;215;0;153231;0;0;0;0;12057357;4195941;627;2;4554034;0;0;0;0
FR;0;2021-04-15;337201;150529;340;0;166070;0;0;0;0;12394558;4346470;967;2;4720104;0;0;0;0
FR;0;2021-04-16;339364;147058;354;0;161716;0;0;0;0;12733922;4493528;1321;2;4881820;0;0;0;0
FR;0;2021-04-17;188689;89983;109;0;97682;0;0;0;0;12922611;4583511;1430;2;4979502;0;0;0;0
FR;0;2021-04-18;51643;35459;48;0;37882;0;0;0;0;12974254;4618970;1478;2;5017384;0;0;0;0
FR;0;2021-04-19;205750;138293;456;0;147452;0;0;0;0;13180004;4757263;1934;2;5164836;0;0;0;0
FR;0;2021-04-20;254494;172039;569;0;183700;0;0;0;0;13434498;4929302;2503;2;5348536;0;0;0;0
FR;0;2021-04-21;253346;170236;836;0;182261;0;0;0;0;13687844;5099538;3339;2;5530797;0;0;0;0
FR;0;2021-04-22;287631;190446;820;0;205042;0;0;0;0;13975475;5289984;4159;2;5735839;0;0;0;0
FR;0;2021-04-23;297686;184735;747;0;203491;0;0;0;0;14273161;5474719;4906;2;5939330;0;0;0;0
FR;0;2021-04-24;190482;112059;252;0;122513;0;0;0;0;14463643;5586778;5158;2;6061843;0;0;0;0
FR;0;2021-04-25;69577;38862;51;0;42593;0;0;0;0;14533220;5625640;5209;2;6104436;0;0;0;0
FR;0;2021-04-26;221007;158705;564;0;171906;0;0;0;0;14754227;5784345;5773;2;6276342;0;0;0;0
FR;0;2021-04-27;284657;188051;941;0;211367;0;0;0;0;15038884;5972396;6714;2;6487709;0;0;0;0
FR;0;2021-04-28;299580;184740;1427;1;209819;1;0;0;0;15338464;6157136;8141;3;6697528;1;0;0;0
FR;0;2021-04-29;357215;198305;1281;0;233392;0;0;0;0;15695679;6355441;9422;3;6930920;1;0;0;0
FR;0;2021-04-30;372268;186144;1124;1;225485;0;0;0;0;16067947;6541585;10546;4;7156405;1;0;0;0
FR;0;2021-05-01;167681;52537;179;0;63783;0;0;0;0;16235628;6594122;10725;4;7220188;1;0;0;0
FR;0;2021-05-02;91771;37865;83;0;43594;0;0;0;0;16327399;6631987;10808;4;7263782;1;0;0;0
FR;0;2021-05-03;288983;165150;843;0;185676;0;0;0;0;16616382;6797137;11651;4;7449458;1;0;0;0
FR;0;2021-05-04;315761;225633;1237;0;251808;0;0;0;0;16932143;7022770;12888;4;7701266;1;0;0;0
FR;0;2021-05-05;327316;226664;1316;0;251746;0;0;0;0;17259459;7249434;14204;4;7953012;1;0;0;0
FR;0;2021-05-06;379625;241283;1634;0;275534;0;0;0;0;17639084;7490717;15838;4;8228546;1;0;0;0
FR;0;2021-05-07;372839;258908;1224;0;299969;0;0;0;0;18011923;7749625;17062;4;8528515;1;0;0;0
FR;0;2021-05-08;222191;71499;300;0;86709;0;0;0;0;18234114;7821124;17362;4;8615224;1;0;0;0
FR;0;2021-05-09;129734;44505;243;0;53143;0;0;0;0;18363848;7865629;17605;4;8668367;1;0;0;0
FR;0;2021-05-10;313435;229733;1239;0;255516;0;0;0;0;18677283;8095362;18844;4;8923883;1;0;0;0
FR;0;2021-05-11;403986;258441;1566;0;296871;0;0;0;0;19081269;8353803;20410;4;9220754;1;0;0;0
FR;0;2021-05-12;434217;233894;1544;0;270183;0;0;0;0;19515486;8587697;21954;4;9490937;1;0;0;0
FR;0;2021-05-13;338642;56437;432;0;77930;0;0;0;0;19854128;8644134;22386;4;9568867;1;0;0;0
FR;0;2021-05-14;454193;167503;1130;0;203114;0;0;0;0;20308321;8811637;23516;4;9771981;1;0;0;0
FR;0;2021-05-15;375018;94402;445;0;120802;0;0;0;0;20683339;8906039;23961;4;9892783;1;0;0;0
FR;0;2021-05-16;202777;20691;168;0;34092;0;0;0;0;20886116;8926730;24129;4;9926875;1;0;0;0
FR;0;2021-05-17;376165;148881;1555;0;178671;0;0;0;0;21262281;9075611;25684;4;10105546;1;0;0;0
FR;0;2021-05-18;460230;154151;1991;0;193306;0;0;0;0;21722511;9229762;27675;4;10298852;1;0;0;0
FR;0;2021-05-19;467473;142542;2466;0;179810;0;0;0;0;22189984;9372304;30141;4;10478662;1;0;0;0
FR;0;2021-05-20;507607;160252;2340;0;204213;0;0;0;0;22697591;9532556;32481;4;10682875;1;0;0;0
FR;0;2021-05-21;489738;175263;1997;0;221815;0;0;0;0;23187329;9707819;34478;4;10904690;1;0;0;0
FR;0;2021-05-22;347227;80249;670;0;108681;0;0;0;0;23534556;9788068;35148;4;11013371;1;0;0;0
FR;0;2021-05-23;161718;14213;246;0;26682;0;0;0;0;23696274;9802281;35394;4;11040053;1;0;0;0
FR;0;2021-05-24;263223;33108;604;0;52946;0;0;0;0;23959497;9835389;35998;4;11092999;1;0;0;0
FR;0;2021-05-25;400319;190474;2357;1;227041;0;0;0;0;24359816;10025863;38355;5;11320040;1;0;0;0
FR;0;2021-05-26;413521;191268;2227;0;229319;0;0;0;0;24773337;10217131;40582;5;11549359;1;0;0;0
FR;0;2021-05-27;449882;220113;2163;0;267260;0;0;0;0;25223219;10437244;42745;5;11816619;1;0;0;0
FR;0;2021-05-28;429615;261172;1895;0;319273;0;0;0;0;25652834;10698416;44640;5;12135892;1;0;0;0
FR;0;2021-05-29;299011;150533;586;0;183390;0;0;0;0;25951845;10848949;45226;5;12319282;1;0;0;0
FR;0;2021-05-30;107156;32505;164;0;42089;0;0;0;0;26059001;10881454;45390;5;12361371;1;0;0;0
FR;0;2021-05-31;358084;203500;1474;1;241784;1;0;0;0;26417085;11084954;46864;6;12603155;2;0;0;0
FR;0;2021-06-01;431146;251295;1969;1;302939;1;0;0;0;26848231;11336249;48833;7;12906094;3;0;0;0
FR;0;2021-06-02;420180;232803;1986;0;280191;0;0;0;0;27268411;11569052;50819;7;13186285;3;0;0;0
FR;0;2021-06-03;465711;257774;1826;0;312550;0;0;0;0;27734122;11826826;52645;7;13498835;3;0;0;0
FR;0;2021-06-04;456307;305898;1735;1;363310;1;0;0;0;28190429;12132724;54380;8;13862145;4;0;0;0
FR;0;2021-06-05;304840;189570;653;0;222796;0;0;0;0;28495269;12322294;55033;8;14084941;4;0;0;0
FR;0;2021-06-06;133342;49018;227;0;61159;0;0;0;0;28628611;12371312;55260;8;14146100;4;0;0;0
FR;0;2021-06-07;340026;261520;1529;0;298612;0;0;0;0;28968637;12632832;56789;8;14444712;4;0;0;0
FR;0;2021-06-08;393962;291408;1806;0;338279;0;0;0;0;29362599;12924240;58595;8;14782991;4;0;0;0
FR;0;2021-06-09;384967;273784;1734;0;318182;0;0;0;0;29747566;13198024;60329;8;15101173;4;0;0;0
FR;0;2021-06-10;404259;286291;1728;1;335746;0;0;0;0;30151825;13484315;62057;9;15436919;4;0;0;0
FR;0;2021-06-11;386728;356529;1468;1;406975;0;0;0;0;30538553;13840844;63525;10;15843894;4;0;0;0
FR;0;2021-06-12;283298;210994;497;0;243142;0;0;0;0;30821851;14051838;64022;10;16087036;4;0;0;0
FR;0;2021-06-13;104908;73842;204;0;84835;0;0;0;0;30926759;14125680;64226;10;16171871;4;0;0;0
FR;0;2021-06-14;240885;354049;1429;1;383241;0;0;0;0;31167644;14479729;65655;11;16555112;4;0;0;0
FR;0;2021-06-15;308232;384332;1574;1;423109;0;0;0;0;31475876;14864061;67229;12;16978221;4;0;0;0
FR;0;2021-06-16;314027;357599;1419;1;395363;0;0;0;0;31789903;15221660;68648;13;17373584;4;0;0;0
FR;0;2021-06-17;317738;373161;1432;1;414359;0;0;0;0;32107641;15594821;70080;14;17787943;4;0;0;0
FR;0;2021-06-18;321785;442594;1341;1;486003;0;0;0;0;32429426;16037415;71421;15;18273946;4;0;0;0
FR;0;2021-06-19;224368;274027;449;0;301221;0;0;0;0;32653794;16311442;71870;15;18575167;4;0;0;0
FR;0;2021-06-20;74459;102289;131;0;111485;0;0;0;0;32728253;16413731;72001;15;18686652;4;0;0;0
FR;0;2021-06-21;195818;401756;1038;1;427722;1;0;0;0;32924071;16815487;73039;16;19114374;5;0;0;0
FR;0;2021-06-22;223243;467809;1266;10;500475;1;0;0;0;33147314;17283296;74305;26;19614849;6;0;0;0
FR;0;2021-06-23;234084;440143;1198;1;474253;1;0;0;0;33381398;17723439;75503;27;20089102;7;0;0;0
FR;0;2021-06-24;241908;409735;1359;0;447227;0;0;0;0;33623306;18133174;76862;27;20536329;7;0;0;0
FR;0;2021-06-25;227675;523086;1404;0;562083;0;0;0;0;33850981;18656260;78266;27;21098412;7;0;0;0
FR;0;2021-06-26;153295;371096;589;1;395906;0;0;0;0;34004276;19027356;78855;28;21494318;7;0;0;0
FR;0;2021-06-27;55924;155945;169;1;164855;0;0;0;0;34060200;19183301;79024;29;21659173;7;0;0;0
FR;0;2021-06-28;154813;452525;1178;0;478123;0;0;0;0;34215013;19635826;80202;29;22137296;7;0;0;0
FR;0;2021-06-29;182747;507832;2124;0;539208;0;0;0;0;34397760;20143658;82326;29;22676504;7;0;0;0
FR;0;2021-06-30;204046;485244;2016;21;519514;2;0;0;0;34601806;20628902;84342;50;23196018;9;0;0;0
FR;0;2021-07-01;231462;458547;2226;5;498490;0;0;0;0;34833268;21087449;86568;55;23694508;9;0;0;0
FR;0;2021-07-02;228709;520026;2120;5;562341;2;0;0;0;35061977;21607475;88688;60;24256849;11;0;0;0
FR;0;2021-07-03;142057;368764;908;3;395252;1;0;0;0;35204034;21976239;89596;63;24652101;12;0;0;0
FR;0;2021-07-04;56764;141006;265;0;150697;0;0;0;0;35260798;22117245;89861;63;24802798;12;0;0;0
FR;0;2021-07-05;168551;418650;1668;8;448594;0;0;0;0;35429349;22535895;91529;71;25251392;12;0;0;0
FR;0;2021-07-06;196811;474519;1830;45;511112;8;0;0;0;35626160;23010414;93359;116;25762504;20;0;0;0
FR;0;2021-07-07;213254;438957;1881;25;477415;2;0;0;0;35839414;23449371;95240;141;26239919;22;0;0;0
FR;0;2021-07-08;231679;424137;2090;20;468069;2;0;0;0;36071093;23873508;97330;161;26707988;24;0;0;0
FR;0;2021-07-09;228642;511065;2185;4;557356;1;0;0;0;36299735;24384573;99515;165;27265344;25;0;0;0
FR;0;2021-07-10;148636;339924;986;1;368862;0;0;0;0;36448371;24724497;100501;166;27634206;25;0;0;0
FR;0;2021-07-11;60218;110049;284;0;120965;0;0;0;0;36508589;24834546;100785;166;27755171;25;0;0;0
FR;0;2021-07-12;169442;477691;1766;4;512422;0;0;0;0;36678031;25312237;102551;170;28267593;25;0;0;0
FR;0;2021-07-13;287308;526594;2050;8;585625;0;0;0;0;36965339;25838831;104601;178;28853218;25;0;0;0
FR;0;2021-07-14;181122;157333;435;0;186645;0;0;0;0;37146461;25996164;105036;178;29039863;25;0;0;0
FR;0;2021-07-15;347131;501600;2100;1;571566;0;0;0;0;37493592;26497764;107136;179;29611429;25;0;0;0
FR;0;2021-07-16;380123;494960;2023;3;574135;1;0;0;0;37873715;26992724;109159;182;30185564;26;0;0;0
FR;0;2021-07-17;259756;319637;877;1;368600;0;0;0;0;38133471;27312361;110036;183;30554164;26;0;0;0
FR;0;2021-07-18;109746;114565;310;0;133004;0;0;0;0;38243217;27426926;110346;183;30687168;26;0;0;0
FR;0;2021-07-19;285527;423876;1631;3;478888;0;0;0;0;38528744;27850802;111977;186;31166056;26;0;0;0
FR;0;2021-07-20;376943;451203;1725;0;523536;0;0;0;0;38905687;28302005;113702;186;31689592;26;0;0;0
FR;0;2021-07-21;395843;406838;1550;4;481828;1;0;0;0;39301530;28708843;115252;190;32171420;27;0;0;0
FR;0;2021-07-22;441091;387300;1715;4;471778;2;0;0;0;39742621;29096143;116967;194;32643198;29;0;0;0
FR;0;2021-07-23;440352;421951;1883;4;509914;1;0;0;0;40182973;29518094;118850;198;33153112;30;0;0;0
FR;0;2021-07-24;285263;269309;804;1;321988;0;0;0;0;40468236;29787403;119654;199;33475100;30;0;0;0
FR;0;2021-07-25;121127;79917;234;0;100272;0;0;0;0;40589363;29867320;119888;199;33575372;30;0;0;0
FR;0;2021-07-26;347452;322132;1614;3;384689;1;0;0;0;40936815;30189452;121502;202;33960061;31;0;0;0
FR;0;2021-07-27;464118;319255;1698;4;400407;1;0;0;0;41400933;30508707;123200;206;34360468;32;0;0;0
FR;0;2021-07-28;459481;289366;1637;4;366981;1;0;0;0;41860414;30798073;124837;210;34727449;33;0;0;0
FR;0;2021-07-29;489865;276104;1797;2;356979;0;0;0;0;42350279;31074177;126634;212;35084428;33;0;0;0
FR;0;2021-07-30;461860;302335;1942;5;380825;1;0;0;0;42812139;31376512;128576;217;35465253;34;0;0;0
FR;0;2021-07-31;285424;185020;916;1;231508;0;0;0;0;43097563;31561532;129492;218;35696761;34;0;0;0
FR;0;2021-08-01;112047;49910;257;0;65689;0;0;0;0;43209610;31611442;129749;218;35762450;34;0;0;0
FR;0;2021-08-02;341675;234022;1603;2;284718;0;0;0;0;43551285;31845464;131352;220;36047168;34;0;0;0
FR;0;2021-08-03;398644;244430;1729;2;304504;1;0;0;0;43949929;32089894;133081;222;36351672;35;0;0;0
FR;0;2021-08-04;384887;209505;1594;6;265631;3;0;0;0;44334816;32299399;134675;228;36617303;38;0;0;0
FR;0;2021-08-05;366204;228342;1711;0;281718;0;0;0;0;44701020;32527741;136386;228;36899021;38;0;0;0
FR;0;2021-08-06;359754;271206;1835;4;326591;0;0;0;0;45060774;32798947;138221;232;37225612;38;0;0;0
FR;0;2021-08-07;213151;178319;756;5;210050;1;0;0;0;45273925;32977266;138977;237;37435662;39;0;0;0
FR;0;2021-08-08;74212;63190;276;0;73624;0;0;0;0;45348137;33040456;139253;237;37509286;39;0;0;0
FR;0;2021-08-09;258779;258577;1549;4;297494;2;0;0;0;45606916;33299033;140802;241;37806780;41;0;0;0
FR;0;2021-08-10;306898;277040;1662;2;323428;0;0;0;0;45913814;33576073;142464;243;38130208;41;0;0;0
FR;0;2021-08-11;279768;259529;1442;5;301602;0;0;0;0;46193582;33835602;143906;248;38431810;41;0;0;0
FR;0;2021-08-12;271573;278014;1668;3;320272;0;0;0;0;46465155;34113616;145574;251;38752082;41;0;0;0
FR;0;2021-08-13;252179;278117;1594;3;316954;2;0;0;0;46717334;34391733;147168;254;39069036;43;0;0;0
FR;0;2021-08-14;145365;197055;740;0;218978;0;0;0;0;46862699;34588788;147908;254;39288014;43;0;0;0
FR;0;2021-08-15;39403;50088;218;1;55670;0;0;0;0;46902102;34638876;148126;255;39343684;43;0;0;0
FR;0;2021-08-16;186196;317463;1543;0;345379;0;0;0;0;47088298;34956339;149669;255;39689063;43;0;0;0
FR;0;2021-08-17;215720;335798;1638;7;368832;0;0;0;0;47304018;35292137;151307;262;40057895;43;0;0;0
FR;0;2021-08-18;199080;324366;1599;7;354532;3;0;0;0;47503098;35616503;152906;269;40412427;46;0;0;0
FR;0;2021-08-19;192049;325390;1642;1;355950;0;0;0;0;47695147;35941893;154548;270;40768377;46;0;0;0
FR;0;2021-08-20;186492;366183;1823;3;396613;2;0;0;0;47881639;36308076;156371;273;41164990;48;0;0;0
FR;0;2021-08-21;104809;238128;709;0;254559;0;0;0;0;47986448;36546204;157080;273;41419549;48;0;0;0
FR;0;2021-08-22;31949;87208;256;1;92161;1;0;0;0;48018397;36633412;157336;274;41511710;49;0;0;0
FR;0;2021-08-23;140998;356993;1561;3;379585;0;0;0;0;48159395;36990405;158897;277;41891295;49;0;0;0
FR;0;2021-08-24;162521;376579;1850;5;402830;0;0;0;0;48321916;37366984;160747;282;42294125;49;0;0;0
FR;0;2021-08-25;151163;350716;2038;8;375403;2;0;0;0;48473079;37717700;162785;290;42669528;51;0;0;0
FR;0;2021-08-26;142897;342767;2563;10;367560;0;0;0;0;48615976;38060467;165348;300;43037088;51;0;0;0
FR;0;2021-08-27;148456;388240;2791;11;414880;1;0;0;0;48764432;38448707;168139;311;43451968;52;0;0;0
FR;0;2021-08-28;90681;249638;1407;0;264963;0;0;0;0;48855113;38698345;169546;311;43716931;52;0;0;0
FR;0;2021-08-29;27325;83351;518;1;88267;0;0;0;0;48882438;38781696;170064;312;43805198;52;0;0;0
FR;0;2021-08-30;117433;324586;4714;6;342393;5848;0;0;0;48999871;39106282;174778;318;44147591;5900;0;0;0
FR;0;2021-08-31;128830;334450;10189;19;353927;11770;2;0;0;49128701;39440732;184967;337;44501518;17670;2;0;0
FR;0;2021-09-01;136168;285658;22436;8;302403;24413;1;0;0;49264869;39726390;207403;345;44803921;42083;3;0;0
FR;0;2021-09-02;114652;247195;26525;20;262093;29012;0;0;0;49379521;39973585;233928;365;45066014;71095;3;0;0
FR;0;2021-09-03;118327;292654;29968;24;309312;33075;1;0;0;49497848;40266239;263896;389;45375326;104170;4;0;0
FR;0;2021-09-04;89892;217795;12587;12;230493;14157;7;0;0;49587740;40484034;276483;401;45605819;118327;11;0;0
FR;0;2021-09-05;21365;44795;4397;2;48278;4716;0;0;0;49609105;40528829;280880;403;45654097;123043;11;0;0
FR;0;2021-09-06;75700;180485;31957;16;190664;34304;2;0;0;49684805;40709314;312837;419;45844761;157347;13;0;0
FR;0;2021-09-07;80318;181183;33250;43;191043;36321;2;0;0;49765123;40890497;346087;462;46035804;193668;15;0;0
FR;0;2021-09-08;91012;206086;29666;28;216572;32570;4;0;0;49856135;41096583;375753;490;46252376;226238;19;0;0
FR;0;2021-09-09;76983;165306;33084;27;174110;36702;5;0;0;49933118;41261889;408837;517;46426486;262940;24;0;0
FR;0;2021-09-10;96048;203813;35743;28;214894;40788;7;0;0;50029166;41465702;444580;545;46641380;303728;31;0;0
FR;0;2021-09-11;67168;169337;12141;19;178187;14412;0;0;0;50096334;41635039;456721;564;46819567;318140;31;0;0
FR;0;2021-09-12;12829;32095;2783;1;34139;3192;2;0;0;50109163;41667134;459504;565;46853706;321332;33;0;0
FR;0;2021-09-13;64580;126159;41249;35;134177;44265;17;0;0;50173743;41793293;500753;600;46987883;365597;50;0;0
FR;0;2021-09-14;73502;129007;56391;80;135756;62444;43;0;0;50247245;41922300;557144;680;47123639;428041;93;0;0
FR;0;2021-09-15;76664;167730;55670;58;174674;54848;77;0;0;50323909;42090030;612814;738;47298313;482889;170;0;0
FR;0;2021-09-16;63895;114506;60099;82;117881;60173;65;0;0;50387804;42204536;672913;820;47416194;543062;235;0;0
FR;0;2021-09-17;75092;156853;53867;71;159730;57362;68;0;0;50462896;42361389;726780;891;47575924;600424;303;0;0
FR;0;2021-09-18;48245;139635;15602;25;144318;17320;20;0;0;50511141;42501024;742382;916;47720242;617744;323;0;0
FR;0;2021-09-19;7908;23649;2442;1;24879;2618;1;0;0;50519049;42524673;744824;917;47745121;620362;324;0;0
FR;0;2021-09-20;44580;93751;50087;72;96242;50347;34;0;0;50563629;42618424;794911;989;47841363;670709;358;0;0
FR;0;2021-09-21;45917;98366;62772;77;98384;63505;79;0;0;50609546;42716790;857683;1066;47939747;734214;437;0;0
FR;0;2021-09-22;48707;142391;55384;82;144837;55484;47;0;0;50658253;42859181;913067;1148;48084584;789698;484;0;0
FR;0;2021-09-23;43294;92064;62408;95;91274;63589;86;0;0;50701547;42951245;975475;1243;48175858;853287;570;0;0
FR;0;2021-09-24;52323;133298;54569;107;132396;59229;78;0;0;50753870;43084543;1030044;1350;48308254;912516;648;0;0
FR;0;2021-09-25;35226;115661;16276;36;118649;18314;22;0;0;50789096;43200204;1046320;1386;48426903;930830;670;0;0
FR;0;2021-09-26;5561;17805;2273;5;18691;2332;5;0;0;50794657;43218009;1048593;1391;48445594;933162;675;0;0
FR;0;2021-09-27;33986;76896;47205;97;78781;48190;81;0;1;50828643;43294905;1095798;1488;48524375;981352;756;0;1
FR;0;2021-09-28;36525;75243;54983;90;74329;56597;47;0;0;50865168;43370148;1150781;1578;48598704;1037949;803;0;1
FR;0;2021-09-29;44426;100689;53375;112;102847;54912;41;0;0;50909594;43470837;1204156;1690;48701551;1092861;844;0;1
FR;0;2021-09-30;36350;72976;57044;96;71480;59608;58;0;0;50945944;43543813;1261200;1786;48773031;1152469;902;0;1
FR;0;2021-10-01;61718;102859;57835;108;101410;64019;23;0;0;51007662;43646672;1319035;1894;48874441;1216488;925;0;1
FR;0;2021-10-02;39470;78457;20965;39;81735;23385;12;0;0;51047132;43725129;1340000;1933;48956176;1239873;937;0;1
FR;0;2021-10-03;5289;10493;2536;4;11258;2543;4;0;0;51052421;43735622;1342536;1937;48967434;1242416;941;0;1
FR;0;2021-10-04;35205;58501;52635;84;59503;54856;37;0;0;51087626;43794123;1395171;2021;49026937;1297272;978;0;1
FR;0;2021-10-05;33937;64375;61031;135;62106;65119;48;0;0;51121563;43858498;1456202;2156;49089043;1362391;1026;0;1
FR;0;2021-10-06;42727;79300;65763;112;80174;68383;29;0;0;51164290;43937798;1521965;2268;49169217;1430774;1055;0;1
FR;0;2021-10-07;30574;62283;65446;88;59500;68895;38;0;0;51194864;44000081;1587411;2356;49228717;1499669;1093;0;1
FR;0;2021-10-08;49486;91946;77773;111;89888;84808;39;0;0;51244350;44092027;1665184;2467;49318605;1584477;1132;0;1
FR;0;2021-10-09;33677;60949;31549;35;64142;33933;17;0;0;51278027;44152976;1696733;2502;49382747;1618410;1149;0;1
FR;0;2021-10-10;4723;7422;3199;9;7940;3475;2;0;0;51282750;44160398;1699932;2511;49390687;1621885;1151;0;1
FR;0;2021-10-11;30734;49888;61049;105;50604;64117;47;0;0;51313484;44210286;1760981;2616;49441291;1686002;1198;0;1
FR;0;2021-10-12;31649;54491;70635;141;51319;76049;27;0;0;51345133;44264777;1831616;2757;49492610;1762051;1225;0;1
FR;0;2021-10-13;40167;62848;74443;137;62800;79395;29;0;1;51385300;44327625;1906059;2894;49555410;1841446;1254;0;2
FR;0;2021-10-14;30364;52873;68779;116;49697;73866;34;0;0;51415664;44380498;1974838;3010;49605107;1915312;1288;0;2
FR;0;2021-10-15;44958;75234;93253;191;70330;103054;26;0;0;51460622;44455732;2068091;3201;49675437;2018366;1314;0;2
FR;0;2021-10-16;31335;44088;36701;45;46705;39654;15;0;0;51491957;44499820;2104792;3246;49722142;2058020;1329;0;2
FR;0;2021-10-17;3898;5227;3603;2;5674;3674;4;0;0;51495855;44505047;2108395;3248;49727816;2061694;1333;0;2
FR;0;2021-10-18;29216;42340;67518;134;42556;71379;27;0;0;51525071;44547387;2175913;3382;49770372;2133073;1360;0;2
FR;0;2021-10-19;27197;45546;76430;140;43208;81675;45;0;0;51552268;44592933;2252343;3522;49813580;2214748;1405;0;2
FR;0;2021-10-20;35346;52404;96959;181;51810;101578;45;0;0;51587614;44645337;2349302;3703;49865390;2316326;1450;0;2
FR;0;2021-10-21;26166;45171;83997;112;41967;89195;30;0;0;51613780;44690508;2433299;3815;49907357;2405521;1480;0;2
FR;0;2021-10-22;38450;62486;104928;200;59351;112655;61;0;0;51652230;44752994;2538227;4015;49966708;2518176;1541;0;2
FR;0;2021-10-23;27034;41203;45467;57;42428;48638;14;0;0;51679264;44794197;2583694;4072;50009136;2566814;1555;0;2
FR;0;2021-10-24;2946;4765;3685;6;5016;3922;1;0;0;51682210;44798962;2587379;4078;50014152;2570736;1556;0;2
FR;0;2021-10-25;26109;36206;82347;144;35479;86681;38;0;0;51708319;44835168;2669726;4222;50049631;2657417;1594;0;2
FR;0;2021-10-26;23770;34991;87278;166;32159;92408;34;0;0;51732089;44870159;2757004;4388;50081790;2749825;1628;0;2
FR;0;2021-10-27;30116;46302;109033;257;44042;114751;48;0;0;51762205;44916461;2866037;4645;50125832;2864576;1676;0;2
FR;0;2021-10-28;23609;34928;88743;153;31195;94540;35;0;0;51785814;44951389;2954780;4798;50157027;2959116;1711;0;2
FR;0;2021-10-29;31589;51452;117348;206;46503;125434;52;0;0;51817403;45002841;3072128;5004;50203530;3084550;1763;0;2
FR;0;2021-10-30;20577;33241;50360;76;32924;53429;20;0;0;51837980;45036082;3122488;5080;50236454;3137979;1783;0;2
FR;0;2021-10-31;2519;3732;3595;3;3844;3881;3;0;0;51840499;45039814;3126083;5083;50240298;3141860;1786;0;2
FR;0;2021-11-01;8541;4869;3223;3;5021;3585;10;0;0;51849040;45044683;3129306;5086;50245319;3145445;1796;0;2
FR;0;2021-11-02;26386;40098;93612;156;36236;99674;44;0;1;51875426;45084781;3222918;5242;50281555;3245119;1840;0;3
FR;0;2021-11-03;30132;47900;118932;222;43554;125909;64;0;0;51905558;45132681;3341850;5464;50325109;3371028;1904;0;3
FR;0;2021-11-04;23823;37459;107601;217;31574;114481;46;0;0;51929381;45170140;3449451;5681;50356683;3485509;1950;0;3
FR;0;2021-11-05;32414;52934;141678;236;44647;151469;53;0;0;51961795;45223074;3591129;5917;50401330;3636978;2003;0;3
FR;0;2021-11-06;21555;34550;64912;123;32385;68354;26;0;0;51983350;45257624;3656041;6040;50433715;3705332;2029;0;3
FR;0;2021-11-07;2429;4154;5209;6;4000;5598;7;0;0;51985779;45261778;3661250;6046;50437715;3710930;2036;0;3
FR;0;2021-11-08;20633;37737;127235;227;30949;134360;50;0;0;52006412;45299515;3788485;6273;50468664;3845290;2086;0;3
FR;0;2021-11-09;22444;44648;161740;339;32854;172357;65;0;0;52028856;45344163;3950225;6612;50501518;4017647;2151;0;3
FR;0;2021-11-10;31619;54879;187069;447;44022;198892;91;0;0;52060475;45399042;4137294;7059;50545540;4216539;2242;0;3
FR;0;2021-11-11;4749;6743;12998;28;5904;13981;17;0;0;52065224;45405785;4150292;7087;50551444;4230520;2259;0;3
FR;0;2021-11-12;29100;55057;183839;252;41723;197506;86;0;0;52094324;45460842;4334131;7339;50593167;4428026;2345;0;3
FR;0;2021-11-13;20356;32597;80730;118;28227;86354;44;0;0;52114680;45493439;4414861;7457;50621394;4514380;2389;0;3
FR;0;2021-11-14;2367;3855;7183;6;3362;7847;9;0;0;52117047;45497294;4422044;7463;50624756;4522227;2398;0;3
FR;0;2021-11-15;20524;38551;160910;314;27785;171650;77;0;0;52137571;45535845;4582954;7777;50652541;4693877;2475;0;3
FR;0;2021-11-16;23674;43830;200490;394;27706;215189;115;0;1;52161245;45579675;4783444;8171;50680247;4909066;2590;0;4
FR;0;2021-11-17;30544;50238;199905;406;36449;212970;98;0;0;52191789;45629913;4983349;8577;50716696;5122036;2688;0;4
FR;0;2021-11-18;23458;45683;191753;469;29392;205741;94;0;0;52215247;45675596;5175102;9046;50746088;5327777;2782;0;4
FR;0;2021-11-19;33696;61271;243292;551;39910;262311;148;0;0;52248943;45736867;5418394;9597;50785998;5590088;2930;0;4
FR;0;2021-11-20;25426;36658;102192;207;29264;109768;43;0;0;52274369;45773525;5520586;9804;50815262;5699856;2973;0;4
FR;0;2021-11-21;2665;4441;9682;19;3441;10607;19;0;0;52277034;45777966;5530268;9823;50818703;5710463;2992;0;4
FR;0;2021-11-22;22824;33112;180438;472;18915;194922;90;0;0;52299858;45811078;5710706;10295;50837618;5905385;3082;0;4
FR;0;2021-11-23;25735;45460;229494;549;24114;247985;85;0;0;52325593;45856538;5940200;10844;50861732;6153370;3167;0;4
FR;0;2021-11-24;31821;53594;224909;715;34476;243363;80;0;0;52357414;45910132;6165109;11559;50896208;6396733;3247;0;4
FR;0;2021-11-25;25654;49131;256028;739;25047;277938;112;0;0;52383068;45959263;6421137;12298;50921255;6674671;3359;0;4
FR;0;2021-11-26;33255;74665;379566;867;37391;414798;172;0;0;52416323;46033928;6800703;13165;50958646;7089469;3531;0;4
FR;0;2021-11-27;23508;49553;214978;391;28444;236784;135;0;0;52439831;46083481;7015681;13556;50987090;7326253;3666;0;4
FR;0;2021-11-28;3528;10443;56786;66;4055;63333;42;0;0;52443359;46093924;7072467;13622;50991145;7389586;3708;0;4
FR;0;2021-11-29;19448;54061;341571;864;23084;371912;178;0;0;52462807;46147985;7414038;14486;51014229;7761498;3886;0;4
FR;0;2021-11-30;24788;71792;457490;988;26796;500928;291;0;0;52487595;46219777;7871528;15474;51041025;8262426;4177;0;4
FR;0;2021-12-01;27398;75421;469222;1162;31307;511447;304;0;0;52514993;46295198;8340750;16636;51072332;8773873;4481;0;4
FR;0;2021-12-02;22130;71466;527254;1282;20997;575058;309;0;0;52537123;46366664;8868004;17918;51093329;9348931;4790;0;4
FR;0;2021-12-03;25582;92773;596536;1421;34333;651329;342;0;0;52562705;46459437;9464540;19339;51127662;10000260;5132;0;4
FR;0;2021-12-04;18343;60288;336313;692;25664;369888;197;0;0;52581048;46519725;9800853;20031;51153326;10370148;5329;0;4
FR;0;2021-12-05;4158;16085;95819;157;4855;107048;92;0;0;52585206;46535810;9896672;20188;51158181;10477196;5421;0;4
FR;0;2021-12-06;28452;72665;493293;1175;25223;540115;384;0;0;52613658;46608475;10389965;21363;51183404;11017311;5805;0;4
FR;0;2021-12-07;23568;91193;645579;1774;28509;706594;416;0;0;52637226;46699668;11035544;23137;51211913;11723905;6221;0;4
FR;0;2021-12-08;25523;91859;591827;1875;34930;647695;440;0;0;52662749;46791527;11627371;25012;51246843;12371600;6661;0;4
FR;0;2021-12-09;24088;94027;663367;2179;28971;726814;463;0;0;52686837;46885554;12290738;27191;51275814;13098414;7124;0;4
FR;0;2021-12-10;28080;110828;736216;2075;37933;806389;471;0;1;52714917;46996382;13026954;29266;51313747;13904803;7595;0;5
FR;0;2021-12-11;20253;76036;435253;990;29933;480480;343;0;0;52735170;47072418;13462207;30256;51343680;14385283;7938;0;5
FR;0;2021-12-12;5684;23103;142362;262;6384;159233;108;0;0;52740854;47095521;13604569;30518;51350064;14544516;8046;0;5
FR;0;2021-12-13;21371;90684;587850;1699;29636;649470;397;0;0;52762225;47186205;14192419;32217;51379700;15193986;8443;0;5
FR;0;2021-12-14;27991;118212;765815;2657;35407;847797;700;0;1;52790216;47304417;14958234;34874;51415107;16041783;9143;0;6
FR;0;2021-12-15;28460;114140;694531;2267;39495;769314;503;0;1;52818676;47418557;15652765;37141;51454602;16811097;9646;0;7
FR;0;2021-12-16;28061;115568;764264;2559;35084;844684;516;0;0;52846737;47534125;16417029;39700;51489686;17655781;10162;0;7
FR;0;2021-12-17;31666;128221;808037;2713;43320;892191;612;0;0;52878403;47662346;17225066;42413;51533006;18547972;10774;0;7
FR;0;2021-12-18;24944;81479;470063;1179;30045;522271;353;0;0;52903347;47743825;17695129;43592;51563051;19070243;11127;0;7
FR;0;2021-12-19;8770;28508;169449;376;7833;191059;143;0;0;52912117;47772333;17864578;43968;51570884;19261302;11270;0;7
FR;0;2021-12-20;31785;97027;591628;1789;33822;658845;503;0;0;52943902;47869360;18456206;45757;51604706;19920147;11773;0;7
FR;0;2021-12-21;39480;111846;682564;2391;38753;759695;607;0;0;52983382;47981206;19138770;48148;51643459;20679842;12380;0;7
FR;0;2021-12-22;39566;99117;575906;2169;37085;642225;687;0;2;53022948;48080323;19714676;50317;51680544;21322067;13067;0;9
FR;0;2021-12-23;33789;79327;441112;1659;30100;494449;589;0;0;53056737;48159650;20155788;51976;51710644;21816516;13656;0;9
FR;0;2021-12-24;10700;26011;111061;398;11637;126676;236;0;1;53067437;48185661;20266849;52374;51722281;21943192;13892;0;10
FR;0;2021-12-25;778;3568;7603;25;2045;9025;72;0;0;53068215;48189229;20274452;52399;51724326;21952217;13964;0;10
FR;0;2021-12-26;4699;11880;52126;142;4739;60170;170;0;0;53072914;48201109;20326578;52541;51729065;22012387;14134;0;10
FR;0;2021-12-27;30511;83914;453630;1364;33020;509278;665;0;0;53103425;48285023;20780208;53905;51762085;22521665;14799;0;10
FR;0;2021-12-28;38368;98789;564240;1769;35082;632333;1558;0;2;53141793;48383812;21344448;55674;51797167;23153998;16357;0;12
FR;0;2021-12-29;39882;88139;501288;1687;33086;561055;1738;0;1;53181675;48471951;21845736;57361;51830253;23715053;18095;0;13
FR;0;2021-12-30;35928;75052;421074;1520;29497;471183;1880;0;0;53217603;48547003;22266810;58881;51859750;24186236;19975;0;13
FR;0;2021-12-31;12053;25073;116895;405;11265;131678;740;0;0;53229656;48572076;22383705;59286;51871015;24317914;20715;0;13
FR;0;2022-01-01;1590;3213;8533;37;1804;9941;103;0;0;53231246;48575289;22392238;59323;51872819;24327855;20818;0;13
FR;0;2022-01-02;6123;13009;58438;126;5107;66973;408;0;0;53237369;48588298;22450676;59449;51877926;24394828;21226;0;13
FR;0;2022-01-03;39505;90140;494907;1597;36876;551789;2650;0;1;53276874;48678438;22945583;61046;51914802;24946617;23876;0;14
FR;0;2022-01-04;42263;110979;641481;2309;40643;714489;3836;0;3;53319137;48789417;23587064;63355;51955445;25661106;27712;0;17
FR;0;2022-01-05;61219;103585;569279;1984;43797;634317;3428;0;2;53380356;48893002;24156343;65339;51999242;26295423;31140;0;19
FR;0;2022-01-06;44318;110303;639066;2702;40219;711587;4557;0;2;53424674;49003305;24795409;68041;52039461;27007010;35697;0;21
FR;0;2022-01-07;50842;123283;711076;2811;46837;790566;4995;0;2;53475516;49126588;25506485;70852;52086298;27797576;40692;0;23
FR;0;2022-01-08;45014;80264;423843;1213;35045;472910;2444;0;3;53520530;49206852;25930328;72065;52121343;28270486;43136;0;26
FR;0;2022-01-09;15614;26598;128585;300;11485;145665;830;0;0;53536144;49233450;26058913;72365;52132828;28416151;43966;0;26
FR;0;2022-01-10;35420;93255;469403;1816;43022;522792;3722;0;1;53571564;49326705;26528316;74181;52175850;28938943;47688;0;27
FR;0;2022-01-11;41947;100437;548341;2310;42399;608589;5219;0;2;53613511;49427142;27076657;76491;52218249;29547532;52907;0;29
FR;0;2022-01-12;60421;95682;452750;1969;49480;504414;4497;0;8;53673932;49522824;27529407;78460;52267729;30051946;57404;0;37
FR;0;2022-01-13;38273;92510;487419;2084;40546;541101;5467;0;8;53712205;49615334;28016826;80544;52308275;30593047;62871;0;45
FR;0;2022-01-14;42587;103295;568669;2286;43502;629058;6463;0;2;53754792;49718629;28585495;82830;52351777;31222105;69334;0;47
FR;0;2022-01-15;39434;65878;340166;985;31446;377578;3296;0;1;53794226;49784507;28925661;83815;52383223;31599683;72630;0;48
FR;0;2022-01-16;11415;19196;87447;216;9019;99404;764;0;0;53805641;49803703;29013108;84031;52392242;31699087;73394;0;48
FR;0;2022-01-17;24756;59984;320333;1384;28040;354173;3960;0;4;53830397;49863687;29333441;85415;52420282;32053260;77354;0;52
FR;0;2022-01-18;28333;68683;361145;1801;32020;397590;5771;0;1;53858730;49932370;29694586;87216;52452302;32450850;83125;0;53
FR;0;2022-01-19;43231;67012;281352;1452;40387;311092;4392;0;5;53901961;49999382;29975938;88668;52492689;32761942;87517;0;58
FR;0;2022-01-20;23680;59587;299069;1750;29559;328538;5636;0;4;53925641;50058969;30275007;90418;52522248;33090480;93153;0;62
FR;0;2022-01-21;28212;68768;366412;2086;33075;401218;6580;0;3;53953853;50127737;30641419;92504;52555323;33491698;99733;0;65
FR;0;2022-01-22;27629;47973;218810;840;27304;241794;2838;0;2;53981482;50175710;30860229;93344;52582627;33733492;102571;0;67
FR;0;2022-01-23;6741;12965;48694;173;7503;55171;591;0;1;53988223;50188675;30908923;93517;52590130;33788663;103162;0;68
FR;0;2022-01-24;16286;47436;217356;1149;25400;239355;4102;0;3;54004509;50236111;31126279;94666;52615530;34028018;107264;0;71
FR;0;2022-01-25;19031;54313;243099;1548;28804;267096;6068;0;5;54023540;50290424;31369378;96214;52644334;34295114;113332;0;76
FR;0;2022-01-26;28148;60550;209318;1298;41368;229544;4478;0;3;54051688;50350974;31578696;97512;52685702;34524658;117810;0;79
FR;0;2022-01-27;16337;46483;207675;1287;26151;226060;5693;0;4;54068025;50397457;31786371;98799;52711853;34750718;123503;0;83
FR;0;2022-01-28;21592;78647;290087;1574;44968;321346;7411;0;4;54089617;50476104;32076458;100373;52756821;35072064;130914;0;87
FR;0;2022-01-29;18424;52849;184144;689;32750;204578;3255;0;2;54108041;50528953;32260602;101062;52789571;35276642;134169;0;89
FR;0;2022-01-30;4476;14466;39151;124;9132;45057;637;0;1;54112517;50543419;32299753;101186;52798703;35321699;134806;0;90
FR;0;2022-01-31;11261;43906;148218;742;26131;164722;4231;0;5;54123778;50587325;32447971;101928;52824834;35486421;139037;0;95
FR;0;2022-02-01;13647;48295;174141;1144;27329;191333;7037;0;1;54137425;50635620;32622112;103072;52852163;35677754;146074;0;96
FR;0;2022-02-02;20672;66295;171559;1034;46160;190080;5970;0;10;54158097;50701915;32793671;104106;52898323;35867834;152044;0;106
FR;0;2022-02-03;11750;44787;157585;990;25343;173288;6933;0;6;54169847;50746702;32951256;105096;52923666;36041122;158977;0;112
FR;0;2022-02-04;14643;67905;239263;1267;37530;264082;9153;0;6;54184490;50814607;33190519;106363;52961196;36305204;168130;0;118
FR;0;2022-02-05;12903;51443;153565;523;31979;172297;3784;0;3;54197393;50866050;33344084;106886;52993175;36477501;171914;0;121
FR;0;2022-02-06;2726;12168;28898;102;7289;33830;662;0;0;54200119;50878218;33372982;106988;53000464;36511331;172576;0;121
FR;0;2022-02-07;9616;46620;156904;594;24513;176304;5294;0;6;54209735;50924838;33529886;107582;53024977;36687635;177870;0;127
FR;0;2022-02-08;9814;43101;166660;870;20967;184455;7054;0;6;54219549;50967939;33696546;108452;53045944;36872090;184924;0;133
FR;0;2022-02-09;14439;58261;172360;876;35359;193069;5788;0;9;54233988;51026200;33868906;109328;53081303;37065159;190712;0;142
FR;0;2022-02-10;8726;39221;150244;881;18696;166722;6503;0;2;54242714;51065421;34019150;110209;53099999;37231881;197215;0;144
FR;0;2022-02-11;10864;55695;218522;1101;25838;243116;8322;0;3;54253578;51121116;34237672;111310;53125837;37474997;205537;0;147
FR;0;2022-02-12;8409;40970;134739;465;22637;151767;3509;0;4;54261987;51162086;34372411;111775;53148474;37626764;209046;0;151
FR;0;2022-02-13;1940;8605;26568;86;4411;30930;544;0;3;54263927;51170691;34398979;111861;53152885;37657694;209590;0;154
FR;0;2022-02-14;6995;35259;148390;487;14672;166386;4789;0;5;54270922;51205950;34547369;112348;53167557;37824080;214379;0;159
FR;0;2022-02-15;7072;36235;147002;751;16005;162588;6848;0;3;54277994;51242185;34694371;113099;53183562;37986668;221227;0;162
FR;0;2022-02-16;9416;42992;132549;722;25984;146768;5727;0;6;54287410;51285177;34826920;113821;53209546;38133436;226954;0;168
FR;0;2022-02-17;5581;24344;87317;587;13144;94891;5408;0;5;54292991;51309521;34914237;114408;53222690;38228327;232362;0;173
FR;0;2022-02-18;7002;33591;119672;807;18763;129337;7416;0;2;54299993;51343112;35033909;115215;53241453;38357664;239778;0;175
FR;0;2022-02-19;5371;24557;70030;371;15909;77340;3020;0;2;54305364;51367669;35103939;115586;53257362;38435004;242798;0;177
FR;0;2022-02-20;1149;4660;12175;39;2915;13956;460;0;1;54306513;51372329;35116114;115625;53260277;38448960;243258;0;178
FR;0;2022-02-21;4100;17896;61958;351;10173;67188;4059;0;2;54310613;51390225;35178072;115976;53270450;38516148;247317;0;180
FR;0;2022-02-22;4467;18667;60840;577;11268;64481;5255;0;1;54315080;51408892;35238912;116553;53281718;38580629;252572;0;181
FR;0;2022-02-23;6593;27365;66510;593;19633;71909;4595;0;3;54321673;51436257;35305422;117146;53301351;38652538;257167;0;184
FR;0;2022-02-24;3851;15562;50435;519;9521;53259;4531;0;2;54325524;51451819;35355857;117665;53310872;38705797;261698;0;186
FR;0;2022-02-25;5287;24297;76370;804;15273;80102;7336;0;7;54330811;51476116;35432227;118469;53326145;38785899;269034;0;193
FR;0;2022-02-26;3995;17772;47421;359;12174;51488;3083;0;3;54334806;51493888;35479648;118828;53338319;38837387;272117;0;196
FR;0;2022-02-27;881;3011;8040;47;1980;8949;531;0;0;54335687;51496899;35487688;118875;53340299;38846336;272648;0;196
FR;0;2022-02-28;3126;12561;40495;359;7595;42928;3858;0;0;54338813;51509460;35528183;119234;53347894;38889264;276506;0;196
FR;0;2022-03-01;4012;12615;44203;437;7640;44875;5518;0;6;54342825;51522075;35572386;119671;53355534;38934139;282024;0;202
FR;0;2022-03-02;5338;17818;47153;447;12878;49085;4930;0;2;54348163;51539893;35619539;120118;53368412;38983224;286954;0;204
FR;0;2022-03-03;2829;9358;29903;371;6256;30026;4050;0;2;54350992;51549251;35649442;120489;53374668;39013250;291004;0;206
FR;0;2022-03-04;3229;12514;40343;669;8512;39492;6235;0;4;54354221;51561765;35689785;121158;53383180;39052742;297239;0;210
FR;0;2022-03-05;3074;9290;24963;314;7132;25127;3135;0;1;54357295;51571055;35714748;121472;53390312;39077869;300374;0;211
FR;0;2022-03-06;521;1408;3198;43;1031;3441;379;0;0;54357816;51572463;35717946;121515;53391343;39081310;300753;0;211
FR;0;2022-03-07;2484;5636;18437;315;3853;17709;3307;0;4;54360300;51578099;35736383;121830;53395196;39099019;304060;0;215
FR;0;2022-03-08;2153;6080;19453;363;4334;17926;4093;0;3;54362453;51584179;35755836;122193;53399530;39116945;308153;0;218
FR;0;2022-03-09;3582;10549;22199;408;8776;21295;4041;0;4;54366035;51594728;35778035;122601;53408306;39138240;312194;0;222
FR;0;2022-03-10;1832;5843;17009;345;4390;15835;3408;0;3;54367867;51600571;35795044;122946;53412696;39154075;315602;0;225
FR;0;2022-03-11;2422;7562;24511;545;5441;22277;5481;0;2;54370289;51608133;35819555;123491;53418137;39176352;321083;0;227
FR;0;2022-03-12;2698;6778;17168;309;5495;16522;3137;0;2;54372987;51614911;35836723;123800;53423632;39192874;324220;0;229
FR;0;2022-03-13;406;794;2323;149;603;2272;537;0;0;54373393;51615705;35839046;123949;53424235;39195146;324757;0;229
FR;0;2022-03-14;1560;4275;14989;4412;2810;13842;7295;0;8;54374953;51619980;35854035;128361;53427045;39208988;332052;0;237
FR;0;2022-03-15;1751;6294;16387;7556;4809;14618;11036;0;9;54376704;51626274;35870422;135917;53431854;39223606;343088;0;246
FR;0;2022-03-16;3036;7413;19435;13141;6214;18113;16297;0;8;54379740;51633687;35889857;149058;53438068;39241719;359385;0;254
FR;0;2022-03-17;1461;3987;13157;10846;2807;11997;13314;0;9;54381201;51637674;35903014;159904;53440875;39253716;372699;0;263
FR;0;2022-03-18;2268;5757;20018;18307;4099;18114;22039;0;15;54383469;51643431;35923032;178211;53444974;39271830;394738;0;278
FR;0;2022-03-19;2294;4805;13116;9406;4142;12420;11409;0;6;54385763;51648236;35936148;187617;53449116;39284250;406147;0;284
FR;0;2022-03-20;301;737;1920;1074;529;1933;1340;0;2;54386064;51648973;35938068;188691;53449645;39286183;407487;0;286
FR;0;2022-03-21;1395;3222;12733;14951;2157;11959;16910;0;11;54387459;51652195;35950801;203642;53451802;39298142;424397;0;297
FR;0;2022-03-22;1557;3741;13807;20553;2580;12562;22845;0;5;54389016;51655936;35964608;224195;53454382;39310704;447242;0;302
FR;0;2022-03-23;2689;6295;17739;23151;5226;17247;25268;0;40;54391705;51662231;35982347;247346;53459608;39327951;472510;0;342
FR;0;2022-03-24;1410;3160;11600;17619;2248;10685;19394;0;23;54393115;51665391;35993947;264965;53461856;39338636;491904;0;365
FR;0;2022-03-25;2089;5159;18579;27775;3690;16917;30809;0;31;54395204;51670550;36012526;292740;53465546;39355553;522713;0;396
FR;0;2022-03-26;2232;4417;12080;12678;3866;11520;14400;0;26;54397436;51674967;36024606;305418;53469412;39367073;537113;0;422
FR;0;2022-03-27;363;693;1908;1483;515;1942;1740;0;1;54397799;51675660;36026514;306901;53469927;39369015;538853;0;423
FR;0;2022-03-28;1468;3082;11132;17490;2120;10620;19070;0;16;54399267;51678742;36037646;324391;53472047;39379635;557923;0;439
FR;0;2022-03-29;1453;3283;12913;27585;2098;12055;29284;0;34;54400720;51682025;36050559;351976;53474145;39391690;587207;0;473
FR;0;2022-03-30;2854;5584;15689;27435;4768;15089;29341;0;21;54403574;51687609;36066248;379411;53478913;39406779;616548;0;494
FR;0;2022-03-31;1615;3577;12991;25037;2561;12330;26647;0;43;54405189;51691186;36079239;404448;53481474;39419109;643195;0;537
FR;0;2022-04-01;2686;4588;20083;30897;2973;18725;33490;0;61;54407875;51695774;36099322;435345;53484447;39437834;676685;0;598
FR;0;2022-04-02;1532;2649;9053;10135;2009;8727;11297;0;29;54409407;51698423;36108375;445480;53486456;39446561;687982;0;627
FR;0;2022-04-03;294;516;1562;1171;360;1580;1382;0;2;54409701;51698939;36109937;446651;53486816;39448141;689364;0;629
FR;0;2022-04-04;4527;3024;12384;19129;2045;11593;20601;0;35;54414228;51701963;36122321;465780;53488861;39459734;709965;0;664
FR;0;2022-04-05;2606;3174;14353;34150;2051;13206;35768;0;85;54416834;51705137;36136674;499930;53490912;39472940;745733;0;749
FR;0;2022-04-06;2611;3964;13542;26544;3030;12817;28013;0;72;54419445;51709101;36150216;526474;53493942;39485757;773746;0;821
FR;0;2022-04-07;1989;3151;13684;33815;2000;12896;35173;0;76;54421434;51712252;36163900;560289;53495942;39498653;808919;0;897
FR;0;2022-04-08;2310;4342;19236;44014;2673;17861;46367;0;89;54423744;51716594;36183136;604303;53498615;39516514;855286;0;986
FR;0;2022-04-09;1373;2682;9315;13568;1904;8869;14800;0;30;54425117;51719276;36192451;617871;53500519;39525383;870086;0;1016
FR;0;2022-04-10;295;756;1985;2017;554;2007;2279;0;7;54425412;51720032;36194436;619888;53501073;39527390;872365;0;1023
FR;0;2022-04-11;1350;2623;11876;23933;1643;11484;25205;0;74;54426762;51722655;36206312;643821;53502716;39538874;897570;0;1097
FR;0;2022-04-12;1728;3080;14022;40927;1963;13395;41816;0;127;54428490;51725735;36220334;684748;53504679;39552269;939386;0;1224
FR;0;2022-04-13;1978;3722;13415;33118;2720;13036;34087;0;96;54430468;51729457;36233749;717866;53507399;39565305;973473;0;1320
FR;0;2022-04-14;1501;2983;13215;36351;1911;13073;37020;0;105;54431969;51732440;36246964;754217;53509310;39578378;1010493;0;1425
FR;0;2022-04-15;1874;3835;15646;35584;2578;14925;37236;0;115;54433843;51736275;36262610;789801;53511888;39593303;1047729;0;1540
FR;0;2022-04-16;1045;1834;6400;8553;1263;6263;9435;0;40;54434888;51738109;36269010;798354;53513151;39599566;1057164;0;1580
FR;0;2022-04-17;195;339;993;1174;223;1036;1242;0;7;54435083;51738448;36270003;799528;53513374;39600602;1058406;0;1587
FR;0;2022-04-18;200;546;2768;1072;344;2787;1287;0;5;54435283;51738994;36272771;800600;53513718;39603389;1059693;0;1592
FR;0;2022-04-19;1546;3030;12919;29690;1878;12479;30737;0;78;54436829;51742024;36285690;830290;53515596;39615868;1090430;0;1670
FR;0;2022-04-20;2007;3497;13307;29071;2611;12995;30087;0;96;54438836;51745521;36298997;859361;53518207;39628863;1120517;0;1766
FR;0;2022-04-21;1515;2854;12553;35210;1824;12647;35783;0;117;54440351;51748375;36311550;894571;53520031;39641510;1156300;0;1883
FR;0;2022-04-22;1880;3626;16479;37625;2402;15838;39164;0;131;54442231;51752001;36328029;932196;53522433;39657348;1195464;0;2014
FR;0;2022-04-23;1151;2069;7391;10659;1479;7242;11444;0;38;54443382;51754070;36335420;942855;53523912;39664590;1206908;0;2052
FR;0;2022-04-24;250;467;1478;1592;326;1414;1850;0;7;54443632;51754537;36336898;944447;53524238;39666004;1208758;0;2059
FR;0;2022-04-25;1307;2534;10686;21073;1613;10491;22095;0;79;54444939;51757071;36347584;965520;53525851;39676495;1230853;0;2138
FR;0;2022-04-26;1627;3008;13671;38664;1967;13114;39461;0;181;54446566;51760079;36361255;1004184;53527818;39689609;1270314;0;2319
FR;0;2022-04-27;1964;3065;11539;31086;2280;11596;31504;0;131;54448530;51763144;36372794;1035270;53530098;39701205;1301818;0;2450
FR;0;2022-04-28;1570;2775;12530;36261;1856;12271;36578;0;139;54450100;51765919;36385324;1071531;53531954;39713476;1338396;0;2589
FR;0;2022-04-29;2010;4834;15561;37281;3638;14937;38752;0;164;54452110;51770753;36400885;1108812;53535592;39728413;1377148;0;2753
FR;0;2022-04-30;1225;4669;6929;9717;4163;6758;10608;0;44;54453335;51775422;36407814;1118529;53539755;39735171;1387756;0;2797
FR;0;2022-05-01;220;325;916;1000;229;911;1141;0;6;54453555;51775747;36408730;1119529;53539984;39736082;1388897;0;2803
FR;0;2022-05-02;2351;2958;11156;18179;2054;10990;19023;0;69;54455906;51778705;36419886;1137708;53542038;39747072;1407920;0;2872
FR;0;2022-05-03;2064;3268;13726;34702;2129;13567;35623;0;163;54457970;51781973;36433612;1172410;53544167;39760639;1443543;0;3035
FR;0;2022-05-04;1923;3300;12187;25651;2300;12303;26202;0;110;54459893;51785273;36445799;1198061;53546467;39772942;1469745;0;3145
FR;0;2022-05-05;1792;3037;13068;33602;2015;12914;34270;0;180;54461685;51788310;36458867;1231663;53548482;39785856;1504015;0;3325
FR;0;2022-05-06;2217;3662;15354;36807;2321;14864;38269;0;182;54463902;51791972;36474221;1268470;53550803;39800720;1542284;0;3507
FR;0;2022-05-07;1210;1783;6464;9614;1255;6456;10339;0;48;54465112;51793755;36480685;1278084;53552058;39807176;1552623;0;3555
FR;0;2022-05-08;267;400;1175;1548;288;1236;1654;0;8;54465379;51794155;36481860;1279632;53552346;39808412;1554277;0;3563
FR;0;2022-05-09;1403;2306;9929;20259;1413;9799;21176;0;102;54466782;51796461;36491789;1299891;53553759;39818211;1575453;0;3665
FR;0;2022-05-10;1800;3432;13572;38999;2296;13128;40026;0;200;54468582;51799893;36505361;1338890;53556055;39831339;1615479;0;3865
FR;0;2022-05-11;2005;3019;10753;27942;2323;10699;28445;0;146;54470587;51802912;36516114;1366832;53558378;39842038;1643924;0;4011
FR;0;2022-05-12;1594;2743;11382;35736;1812;11054;36498;0;211;54472181;51805655;36527496;1402568;53560190;39853092;1680422;0;4222
FR;0;2022-05-13;1983;3222;13761;37981;2064;13350;39246;0;162;54474164;51808877;36541257;1440549;53562254;39866442;1719668;0;4384
FR;0;2022-05-14;1149;1641;5938;10778;1198;5801;11366;0;57;54475313;51810518;36547195;1451327;53563452;39872243;1731034;0;4441
FR;0;2022-05-15;283;479;1278;1440;302;1361;1593;0;6;54475596;51810997;36548473;1452767;53563754;39873604;1732627;0;4447
FR;0;2022-05-16;1196;2047;8692;21070;1247;8699;21597;0;128;54476792;51813044;36557165;1473837;53565001;39882303;1754224;0;4575
FR;0;2022-05-17;1591;2605;11827;37881;1670;11403;38723;0;180;54478383;51815649;36568992;1511718;53566671;39893706;1792947;0;4755
FR;0;2022-05-18;1816;2653;9693;27166;1955;9667;27784;0;109;54480199;51818302;36578685;1538884;53568626;39903373;1820731;0;4864
FR;0;2022-05-19;1448;2660;10579;35840;1634;10719;36031;0;162;54481647;51820962;36589264;1574724;53570260;39914092;1856762;0;5026
FR;0;2022-05-20;1876;3118;13425;39369;2079;12913;40388;0;168;54483523;51824080;36602689;1614093;53572339;39927005;1897150;0;5194
FR;0;2022-05-21;1159;1718;5662;9897;1313;5533;10534;0;45;54484682;51825798;36608351;1623990;53573652;39932538;1907684;0;5239
FR;0;2022-05-22;241;341;1030;1439;263;1016;1583;0;10;54484923;51826139;36609381;1625429;53573915;39933554;1909267;0;5249
FR;0;2022-05-23;1177;2126;8880;20374;1409;8831;21029;0;86;54486100;51828265;36618261;1645803;53575324;39942385;1930296;0;5335
FR;0;2022-05-24;1541;2760;11367;38881;1737;11239;39510;0;190;54487641;51831025;36629628;1684684;53577061;39953624;1969806;0;5525
FR;0;2022-05-25;1814;2836;9343;24846;2074;9481;25322;0;116;54489455;51833861;36638971;1709530;53579135;39963105;1995128;0;5641
FR;0;2022-05-26;216;430;1665;1201;293;1676;1344;0;26;54489671;51834291;36640636;1710731;53579428;39964781;1996472;0;5667
FR;0;2022-05-27;1390;2477;9265;21291;1670;9005;22325;0;94;54491061;51836768;36649901;1732022;53581098;39973786;2018797;0;5761
FR;0;2022-05-28;669;1272;3919;6795;852;3968;7204;0;38;54491730;51838040;36653820;1738817;53581950;39977754;2026001;0;5799
FR;0;2022-05-29;157;315;752;921;200;773;1033;0;4;54491887;51838355;36654572;1739738;53582150;39978527;2027034;0;5803
FR;0;2022-05-30;1026;1967;6995;19296;1247;7013;19808;0;91;54492913;51840322;36661567;1759034;53583397;39985540;2046842;0;5894
FR;0;2022-05-31;1488;2520;9823;35664;1647;9645;36295;0;171;54494401;51842842;36671390;1794698;53585044;39995185;2083137;0;6065
FR;0;2022-06-01;1749;3106;11029;24538;2252;10896;25491;0;122;54496150;51845948;36682419;1819236;53587296;40006081;2108628;0;6187
FR;0;2022-06-02;1480;2615;11303;35570;1715;10859;36515;0;174;54497630;51848563;36693722;1854806;53589011;40016940;2145143;0;6361
FR;0;2022-06-03;1727;3082;13425;38729;2051;12790;39999;0;176;54499357;51851645;36707147;1893535;53591062;40029730;2185142;0;6537
FR;0;2022-06-04;975;1516;5046;9113;1076;5117;9649;0;73;54500332;51853161;36712193;1902648;53592138;40034847;2194791;0;6610
FR;0;2022-06-05;180;335;875;1108;205;886;1230;0;4;54500512;51853496;36713068;1903756;53592343;40035733;2196021;0;6614
FR;0;2022-06-06;869;1254;2124;1329;1078;2141;1510;0;13;54501381;51854750;36715192;1905085;53593421;40037874;2197531;0;6627
FR;0;2022-06-07;1496;2713;9855;35597;1792;9433;36824;0;153;54502877;51857463;36725047;1940682;53595213;40047307;2234355;0;6780
FR;0;2022-06-08;1583;2697;9178;28788;1940;9021;29754;0;112;54504460;51860160;36734225;1969470;53597153;40056328;2264109;0;6892
FR;0;2022-06-09;1296;2441;10618;39499;1554;10263;40274;0;167;54505756;51862601;36744843;2008969;53598707;40066591;2304383;0;7059
FR;0;2022-06-10;1629;3192;13103;44828;2158;12665;46153;0;223;54507385;51865793;36757946;2053797;53600865;40079256;2350536;0;7282
FR;0;2022-06-11;962;1738;5432;11627;1124;5465;12212;0;55;54508347;51867531;36763378;2065424;53601989;40084721;2362748;0;7337
FR;0;2022-06-12;201;445;1079;1765;255;1142;1866;0;11;54508548;51867976;36764457;2067189;53602244;40085863;2364614;0;7348
FR;0;2022-06-13;1122;2069;7439;23183;1343;7269;24099;0;90;54509670;51870045;36771896;2090372;53603587;40093132;2388713;0;7438
FR;0;2022-06-14;1346;2549;10448;44948;1598;9804;46144;0;200;54511016;51872594;36782344;2135320;53605185;40102936;2434857;0;7638
FR;0;2022-06-15;1526;2463;9325;30907;1931;8964;31597;0;179;54512542;51875057;36791669;2166227;53607116;40111900;2466454;0;7817
FR;0;2022-06-16;1188;2041;9917;39931;1276;9326;40952;0;201;54513730;51877098;36801586;2206158;53608392;40121226;2507406;0;8018
FR;0;2022-06-17;1492;2859;12512;46699;1788;11919;47935;0;240;54515222;51879957;36814098;2252857;53610180;40133145;2555341;0;8258
FR;0;2022-06-18;856;1527;4566;11125;1038;4501;11719;0;67;54516078;51881484;36818664;2263982;53611218;40137646;2567060;0;8325
FR;0;2022-06-19;183;363;1059;1615;208;1131;1701;0;14;54516261;51881847;36819723;2265597;53611426;40138777;2568761;0;8339
FR;0;2022-06-20;1027;1924;8908;26079;1200;8569;27020;0;156;54517288;51883771;36828631;2291676;53612626;40147346;2595781;0;8495
FR;0;2022-06-21;1327;2403;10309;49897;1541;9338;51281;0;264;54518615;51886174;36838940;2341573;53614167;40156684;2647062;0;8759
FR;0;2022-06-22;1397;2515;8920;39065;1804;8430;40007;0;256;54520012;51888689;36847860;2380638;53615971;40165114;2687069;0;9015
FR;0;2022-06-23;1229;2369;10679;55110;1364;9886;56242;0;320;54521241;51891058;36858539;2435748;53617335;40175000;2743311;0;9335
FR;0;2022-06-24;1493;2996;13646;69187;1751;12307;71006;0;405;54522734;51894054;36872185;2504935;53619086;40187307;2814317;0;9740
FR;0;2022-06-25;939;1781;6237;19921;1112;5990;20776;0;177;54523673;51895835;36878422;2524856;53620198;40193297;2835093;0;9917
FR;0;2022-06-26;229;459;1953;3688;259;1818;3966;0;39;54523902;51896294;36880375;2528544;53620457;40195115;2839059;0;9956
FR;0;2022-06-27;1133;2026;10493;48488;1178;9636;49756;0;339;54525035;51898320;36890868;2577032;53621635;40204751;2888815;0;10295
FR;0;2022-06-28;1463;2816;14672;91397;1584;13090;93167;0;623;54526498;51901136;36905540;2668429;53623219;40217841;2981982;0;10918
FR;0;2022-06-29;1712;2832;12292;71896;1845;11240;73037;0;548;54528210;51903968;36917832;2740325;53625064;40229081;3055019;0;11466
FR;0;2022-06-30;1537;2735;14395;95167;1659;12476;97185;0;724;54529747;51906703;36932227;2835492;53626723;40241557;3152204;0;12190
FR;0;2022-07-01;2015;3805;21507;115936;2308;18858;118586;0;954;54531762;51910508;36953734;2951428;53629031;40260415;3270790;0;13144
FR;0;2022-07-02;1088;1859;8528;35754;1108;7704;36876;0;342;54532850;51912367;36962262;2987182;53630139;40268119;3307666;0;13486
FR;0;2022-07-03;293;539;2095;6455;319;1898;6804;0;79;54533143;51912906;36964357;2993637;53630458;40270017;3314470;0;13565
FR;0;2022-07-04;1940;3470;14716;79231;2334;12995;81303;0;639;54535083;51916376;36979073;3072868;53632792;40283012;3395773;0;14204
FR;0;2022-07-05;1795;3170;18835;133263;1802;16017;135554;0;1146;54536878;51919546;36997908;3206131;53634594;40299029;3531327;0;15350
FR;0;2022-07-06;1843;2788;15856;99602;1849;13649;101170;0;900;54538721;51922334;37013764;3305733;53636443;40312678;3632497;0;16250
FR;0;2022-07-07;1712;2873;18008;126039;1713;14788;128366;0;1179;54540433;51925207;37031772;3431772;53638156;40327466;3760863;0;17429
FR;0;2022-07-08;1894;3153;20752;137088;1857;16765;140081;0;1347;54542327;51928360;37052524;3568860;53640013;40344231;3900944;0;18776
FR;0;2022-07-09;868;1464;7743;37926;883;6690;38769;0;426;54543195;51929824;37060267;3606786;53640896;40350921;3939713;0;19202
FR;0;2022-07-10;270;686;2346;7004;440;2125;7395;0;94;54543465;51930510;37062613;3613790;53641336;40353046;3947108;0;19296
FR;0;2022-07-11;1456;2480;15020;88286;1402;12514;90474;0;801;54544921;51932990;37077633;3702076;53642738;40365560;4037582;0;20097
FR;0;2022-07-12;1842;3119;20537;143973;1716;16732;146678;0;1604;54546763;51936109;37098170;3846049;53644454;40382292;4184260;0;21701
FR;0;2022-07-13;1781;2751;15696;94543;1661;13277;96402;0;1080;54548544;51938860;37113866;3940592;53646115;40395569;4280662;0;22781
FR;0;2022-07-14;186;370;1956;5540;220;1835;5707;0;82;54548730;51939230;37115822;3946132;53646335;40397404;4286369;0;22863
FR;0;2022-07-15;1486;2575;15115;84464;1441;12598;86623;0;1035;54550216;51941805;37130937;4030596;53647776;40410002;4372992;0;23898
FR;0;2022-07-16;627;1192;5950;24982;698;5156;25674;0;327;54550843;51942997;37136887;4055578;53648474;40415158;4398666;0;24225
FR;0;2022-07-17;182;395;1738;4666;218;1570;4938;0;66;54551025;51943392;37138625;4060244;53648692;40416728;4403604;0;24291
FR;0;2022-07-18;1132;2249;11828;61809;1339;9978;63672;0;780;54552157;51945641;37150453;4122053;53650031;40426706;4467276;0;25071
FR;0;2022-07-19;1421;2354;15474;103710;1395;12295;105899;0;1459;54553578;51947995;37165927;4225763;53651426;40439001;4573175;0;26530
FR;0;2022-07-20;1426;2301;12966;77586;1471;10739;79173;0;1051;54555004;51950296;37178893;4303349;53652897;40449740;4652348;0;27581
FR;0;2022-07-21;1287;2171;13097;88243;1371;10499;89728;0;1316;54556291;51952467;37191990;4391592;53654268;40460239;4742076;0;28897
FR;0;2022-07-22;1431;2487;14823;89536;1465;11974;91416;0;1347;54557722;51954954;37206813;4481128;53655733;40472213;4833492;0;30244
FR;0;2022-07-23;684;1310;5534;22482;821;4857;23080;0;411;54558406;51956264;37212347;4503610;53656554;40477070;4856572;0;30655
FR;0;2022-07-24;185;353;1400;3905;204;1242;4132;0;72;54558591;51956617;37213747;4507515;53656758;40478312;4860704;0;30727
FR;0;2022-07-25;1060;1795;9493;48080;1147;7845;49517;0;737;54559651;51958412;37223240;4555595;53657905;40486157;4910221;0;31464
FR;0;2022-07-26;1300;2211;13306;85437;1320;10828;87134;0;1311;54560951;51960623;37236546;4641032;53659225;40496985;4997355;0;32775
FR;0;2022-07-27;1226;2007;10236;61318;1340;8530;62522;0;971;54562177;51962630;37246782;4702350;53660565;40505515;5059877;0;33746
FR;0;2022-07-28;1093;1863;10313;64403;1259;8224;65634;0;1046;54563270;51964493;37257095;4766753;53661824;40513739;5125511;0;34792
FR;0;2022-07-29;1282;2078;11011;65898;1387;8765;67328;0;1140;54564552;51966571;37268106;4832651;53663211;40522504;5192839;0;35932
FR;0;2022-07-30;503;866;3523;15283;604;2973;15666;0;303;54565055;51967437;37271629;4847934;53663815;40525477;5208505;0;36235
FR;0;2022-07-31;154;289;929;2439;185;788;2588;0;49;54565209;51967726;37272558;4850373;53664000;40526265;5211093;0;36284
FR;0;2022-08-01;982;1663;7598;30237;1256;6396;31311;0;549;54566191;51969389;37280156;4880610;53665256;40532661;5242404;0;36833
FR;0;2022-08-02;1052;1650;8580;56119;1154;6894;56807;0;1170;54567243;51971039;37288736;4936729;53666410;40539555;5299211;0;38003
FR;0;2022-08-03;852;1265;6429;38681;902;5149;39419;0;702;54568095;51972304;37295165;4975410;53667312;40544704;5338630;0;38705
FR;0;2022-08-04;741;1186;6574;43161;782;5307;43725;0;917;54568836;51973490;37301739;5018571;53668094;40550011;5382355;0;39622
FR;0;2022-08-05;857;1364;7099;44969;972;5681;45629;0;993;54569693;51974854;37308838;5063540;53669066;40555692;5427984;0;40615
FR;0;2022-08-06;341;556;2101;9367;397;1759;9567;0;228;54570034;51975410;37310939;5072907;53669463;40557451;5437551;0;40843
FR;0;2022-08-07;104;160;536;1626;117;453;1702;0;38;54570138;51975570;37311475;5074533;53669580;40557904;5439253;0;40881
FR;0;2022-08-08;641;1160;4029;22108;915;3292;22543;0;490;54570779;51976730;37315504;5096641;53670495;40561196;5461796;0;41371
FR;0;2022-08-09;746;1167;5972;39955;852;4803;40446;0;844;54571525;51977897;37321476;5136596;53671347;40565999;5502242;0;42215
FR;0;2022-08-10;667;1285;4655;28058;1000;3796;28392;0;652;54572192;51979182;37326131;5164654;53672347;40569795;5530634;0;42867
FR;0;2022-08-11;638;1027;4491;29251;739;3711;29587;0;676;54572830;51980209;37330622;5193905;53673086;40573506;5560221;0;43543
FR;0;2022-08-12;843;1163;4748;28219;849;3919;28656;0;704;54573673;51981372;37335370;5222124;53673935;40577425;5588877;0;44247
FR;0;2022-08-13;331;427;1295;5260;324;1120;5419;0;121;54574004;51981799;37336665;5227384;53674259;40578545;5594296;0;44368
FR;0;2022-08-14;74;121;289;923;104;247;995;0;25;54574078;51981920;37336954;5228307;53674363;40578792;5595291;0;44393
FR;0;2022-08-15;116;231;610;564;197;558;618;0;19;54574194;51982151;37337564;5228871;53674560;40579350;5595909;0;44412
FR;0;2022-08-16;644;1078;3961;22176;840;3355;22369;0;615;54574838;51983229;37341525;5251047;53675400;40582705;5618278;0;45027
FR;0;2022-08-17;651;1038;3890;22897;813;3294;23142;0;620;54575489;51984267;37345415;5273944;53676213;40585999;5641420;0;45647
FR;0;2022-08-18;636;1000;4123;26308;803;3261;26541;0;673;54576125;51985267;37349538;5300252;53677016;40589260;5667961;0;46320
FR;0;2022-08-19;605;1166;4493;27259;874;3694;27565;0;766;54576730;51986433;37354031;5327511;53677890;40592954;5695526;0;47086
FR;0;2022-08-20;310;503;1356;5569;401;1171;5728;0;146;54577040;51986936;37355387;5333080;53678291;40594125;5701254;0;47232
FR;0;2022-08-21;97;135;305;1009;96;267;1044;0;27;54577137;51987071;37355692;5334089;53678387;40594392;5702298;0;47259
FR;0;2022-08-22;584;1001;3273;15358;780;2797;15688;0;425;54577721;51988072;37358965;5349447;53679167;40597189;5717986;0;47684
FR;0;2022-08-23;730;1179;4297;29002;852;3610;29089;0;870;54578451;51989251;37363262;5378449;53680019;40600799;5747075;0;48554
FR;0;2022-08-24;669;938;3495;19539;784;2858;19728;0;608;54579120;51990189;37366757;5397988;53680803;40603657;5766803;0;49162
FR;0;2022-08-25;627;1021;3945;23402;729;3293;23666;0;673;54579747;51991210;37370702;5421390;53681532;40606950;5790469;0;49835
FR;0;2022-08-26;858;1266;4478;25884;958;3671;26257;0;777;54580605;51992476;37375180;5447274;53682490;40610621;5816726;0;50612
FR;0;2022-08-27;297;500;1379;5467;362;1244;5531;0;194;54580902;51992976;37376559;5452741;53682852;40611865;5822257;0;50806
FR;0;2022-08-28;125;163;303;920;117;288;965;0;38;54581027;51993139;37376862;5453661;53682969;40612153;5823222;0;50844
FR;0;2022-08-29;620;966;3073;14657;766;2611;14963;0;433;54581647;51994105;37379935;5468318;53683735;40614764;5838185;0;51277
FR;0;2022-08-30;853;1224;4796;28544;900;3914;28874;0;823;54582500;51995329;37384731;5496862;53684635;40618678;5867059;0;52100
FR;0;2022-08-31;696;958;3205;17642;744;2716;17906;0;508;54583196;51996287;37387936;5514504;53685379;40621394;5884965;0;52608
FR;0;2022-09-01;748;996;4480;22490;707;3827;22765;0;623;54583944;51997283;37392416;5536994;53686086;40625221;5907730;0;53231
FR;0;2022-09-02;901;1153;5043;28611;840;4256;28905;0;914;54584845;51998436;37397459;5565605;53686926;40629477;5936635;0;54145
FR;0;2022-09-03;418;571;1919;6086;425;1666;6323;0;181;54585263;51999007;37399378;5571691;53687351;40631143;5942958;0;54326
FR;0;2022-09-04;134;150;351;876;85;347;945;0;24;54585397;51999157;37399729;5572567;53687436;40631490;5943903;0;54350
FR;0;2022-09-05;736;894;3176;16065;714;2657;16378;0;523;54586133;52000051;37402905;5588632;53688150;40634147;5960281;0;54873
FR;0;2022-09-06;899;1049;4739;31851;679;3872;32080;0;1040;54587032;52001100;37407644;5620483;53688829;40638019;5992361;0;55913
FR;0;2022-09-07;708;786;2998;16821;568;2479;16970;0;573;54587740;52001886;37410642;5637304;53689397;40640498;6009331;0;56486
FR;0;2022-09-08;632;860;3810;24864;595;3142;24955;0;818;54588372;52002746;37414452;5662168;53689992;40643640;6034286;0;57304
FR;0;2022-09-09;845;1022;4445;27660;662;3686;27837;0;951;54589217;52003768;37418897;5689828;53690654;40647326;6062123;0;58255
FR;0;2022-09-10;403;640;1738;5711;465;1538;5917;0;207;54589620;52004408;37420635;5695539;53691119;40648864;6068040;0;58462
FR;0;2022-09-11;124;131;324;657;93;307;716;0;17;54589744;52004539;37420959;5696196;53691212;40649171;6068756;0;58479
FR;0;2022-09-12;518;647;2690;13296;464;2295;13589;0;478;54590262;52005186;37423649;5709492;53691676;40651466;6082345;0;58957
FR;0;2022-09-13;663;869;3996;26516;558;3486;26396;0;875;54590925;52006055;37427645;5736008;53692234;40654952;6108741;0;59832
FR;0;2022-09-14;703;801;2968;16181;593;2485;16414;0;573;54591628;52006856;37430613;5752189;53692827;40657437;6125155;0;60405
FR;0;2022-09-15;577;841;3475;23585;594;2963;23654;0;728;54592205;52007697;37434088;5775774;53693421;40660400;6148809;0;61133
FR;0;2022-09-16;798;1047;4143;25915;732;3486;26137;0;932;54593003;52008744;37438231;5801689;53694153;40663886;6174946;0;62065
FR;0;2022-09-17;393;513;1454;6146;391;1284;6238;0;242;54593396;52009257;37439685;5807835;53694544;40665170;6181184;0;62307
FR;0;2022-09-18;117;144;323;961;123;291;1016;0;36;54593513;52009401;37440008;5808796;53694667;40665461;6182200;0;62343
FR;0;2022-09-19;481;648;2260;13218;450;1934;13401;0;436;54593994;52010049;37442268;5822014;53695117;40667395;6195601;0;62779
FR;0;2022-09-20;645;898;3788;26462;653;3155;26516;0;893;54594639;52010947;37446056;5848476;53695770;40670550;6222117;0;63672
FR;0;2022-09-21;588;775;2740;16259;579;2355;16250;0;586;54595227;52011722;37448796;5864735;53696349;40672905;6238367;0;64258
FR;0;2022-09-22;599;846;3423;23594;569;2796;23818;0;774;54595826;52012568;37452219;5888329;53696918;40675701;6262185;0;65032
FR;0;2022-09-23;838;1051;4495;28721;773;3763;28893;0;1020;54596664;52013619;37456714;5917050;53697691;40679464;6291078;0;66052
FR;0;2022-09-24;425;614;1644;6894;474;1418;7078;0;306;54597089;52014233;37458358;5923944;53698165;40680882;6298156;0;66358
FR;0;2022-09-25;99;194;336;1101;148;307;1143;0;37;54597188;52014427;37458694;5925045;53698313;40681189;6299299;0;66395
FR;0;2022-09-26;438;713;2299;13540;482;2019;13645;0;435;54597626;52015140;37460993;5938585;53698795;40683208;6312944;0;66830
FR;0;2022-09-27;612;844;3627;25944;614;2910;26099;0;959;54598238;52015984;37464620;5964529;53699409;40686118;6339043;0;67789
FR;0;2022-09-28;635;828;2557;15403;635;2305;15516;0;622;54598873;52016812;37467177;5979932;53700044;40688423;6354559;0;68411
FR;0;2022-09-29;564;768;3132;21051;544;2646;21079;43;810;54599437;52017580;37470309;6000983;53700588;40691069;6375638;43;69221
FR;0;2022-09-30;787;1120;3955;25563;838;3301;25830;714;1052;54600224;52018700;37474264;6026546;53701426;40694370;6401468;757;70273
FR;0;2022-10-01;431;619;2009;5975;467;1737;6212;396;318;54600655;52019319;37476273;6032521;53701893;40696107;6407680;1153;70591
FR;0;2022-10-02;63;136;218;639;97;215;665;66;42;54600718;52019455;37476491;6033160;53701990;40696322;6408345;1219;70633
FR;0;2022-10-03;560;899;2468;12053;732;2194;12231;2074;745;54601278;52020354;37478959;6045213;53702722;40698516;6420576;3293;71378
FR;0;2022-10-04;671;830;3394;23508;576;2785;23685;4704;1585;54601949;52021184;37482353;6068721;53703298;40701301;6444261;7997;72963
FR;0;2022-10-05;579;852;2447;14606;630;2162;14747;3656;1210;54602528;52022036;37484800;6083327;53703928;40703463;6459008;11653;74173
FR;0;2022-10-06;543;740;3088;21688;542;2520;21898;6668;1909;54603071;52022776;37487888;6105015;53704470;40705983;6480906;18321;76082
FR;0;2022-10-07;730;1008;4127;30308;737;3476;30397;16873;3204;54603801;52023784;37492015;6135323;53705207;40709459;6511303;35194;79286
FR;0;2022-10-08;350;521;1651;8432;383;1410;8601;6699;1170;54604151;52024305;37493666;6143755;53705590;40710869;6519904;41893;80456
FR;0;2022-10-09;109;138;337;1587;112;312;1650;1511;297;54604260;52024443;37494003;6145342;53705702;40711181;6521554;43404;80753
FR;0;2022-10-10;491;810;2928;20538;626;2508;20869;19565;3272;54604751;52025253;37496931;6165880;53706328;40713689;6542423;62969;84025
FR;0;2022-10-11;585;812;4268;40321;552;3571;40665;40161;6380;54605336;52026065;37501199;6206201;53706880;40717260;6583088;103130;90405
FR;0;2022-10-12;587;854;3266;26756;636;2773;27086;27302;4691;54605923;52026919;37504465;6232957;53707516;40720033;6610174;130432;95096
FR;0;2022-10-13;619;813;4016;38463;603;3137;38922;40607;6607;54606542;52027732;37508481;6271420;53708119;40723170;6649096;171039;101703
FR;0;2022-10-14;758;1067;4869;47665;778;3953;48140;51132;7863;54607300;52028799;37513350;6319085;53708897;40727123;6697236;222171;109566
FR;0;2022-10-15;363;575;1867;11851;414;1629;11965;13091;2274;54607663;52029374;37515217;6330936;53709311;40728752;6709201;235262;111840
FR;0;2022-10-16;92;134;372;1967;84;356;2012;2347;479;54607755;52029508;37515589;6332903;53709395;40729108;6711213;237609;112319
FR;0;2022-10-17;437;707;3042;26460;492;2481;26834;30786;5410;54608192;52030215;37518631;6359363;53709887;40731589;6738047;268395;117729
FR;0;2022-10-18;601;735;4704;46101;532;3762;46664;55449;11701;54608793;52030950;37523335;6405464;53710419;40735351;6784711;323844;129430
FR;0;2022-10-19;564;817;3641;34375;622;3073;34743;42461;9251;54609357;52031767;37526976;6439839;53711041;40738424;6819454;366305;138681
FR;0;2022-10-20;613;800;4842;49461;586;3729;50119;60529;12935;54609970;52032567;37531818;6489300;53711627;40742153;6869573;426834;151616
FR;0;2022-10-21;690;992;5710;57041;707;4519;57710;70959;14296;54610660;52033559;37537528;6546341;53712334;40746672;6927283;497793;165912
FR;0;2022-10-22;334;412;1654;12948;332;1320;13106;15938;3386;54610994;52033971;37539182;6559289;53712666;40747992;6940389;513731;169298
FR;0;2022-10-23;96;107;350;2064;102;266;2166;2758;631;54611090;52034078;37539532;6561353;53712768;40748258;6942555;516489;169929
FR;0;2022-10-24;551;597;3137;27134;422;2687;27562;35493;7809;54611641;52034675;37542669;6588487;53713190;40750945;6970117;551982;177738
FR;0;2022-10-25;596;724;4870;49108;535;3800;49782;65240;15447;54612237;52035399;37547539;6637595;53713725;40754745;7019899;617222;193185
FR;0;2022-10-26;532;644;3474;32622;482;2900;32928;43998;11022;54612769;52036043;37551013;6670217;53714207;40757645;7052827;661220;204207
FR;0;2022-10-27;591;695;4080;40795;496;3347;41272;54475;13137;54613360;52036738;37555093;6711012;53714703;40760992;7094099;715695;217344
FR;0;2022-10-28;703;865;4609;44186;628;3504;45006;58272;13184;54614063;52037603;37559702;6755198;53715331;40764496;7139105;773967;230528
FR;0;2022-10-29;260;356;1328;9494;254;1082;9627;12523;3012;54614323;52037959;37561030;6764692;53715585;40765578;7148732;786490;233540
FR;0;2022-10-30;87;117;287;1598;93;249;1646;2145;540;54614410;52038076;37561317;6766290;53715678;40765827;7150378;788635;234080
FR;0;2022-10-31;382;486;2074;16061;355;1626;16425;22203;5503;54614792;52038562;37563391;6782351;53716033;40767453;7166803;810838;239583
FR;0;2022-11-01;96;188;928;1123;146;961;1166;1696;503;54614888;52038750;37564319;6783474;53716179;40768414;7167969;812534;240086
FR;0;2022-11-02;513;671;3037;25401;501;2582;25877;36638;10132;54615401;52039421;37567356;6808875;53716680;40770996;7193846;849172;250218
FR;0;2022-11-03;645;700;4114;40064;533;3118;40796;57037;15377;54616046;52040121;37571470;6848939;53717213;40774114;7234642;906209;265595
FR;0;2022-11-04;657;829;4425;43659;575;3518;44278;60534;15248;54616703;52040950;37575895;6892598;53717788;40777632;7278920;966743;280843
FR;0;2022-11-05;255;362;1450;9715;285;1166;9924;13462;3294;54616958;52041312;37577345;6902313;53718073;40778798;7288844;980205;284137
FR;0;2022-11-06;94;116;263;1602;99;246;1631;2337;653;54617052;52041428;37577608;6903915;53718172;40779044;7290475;982542;284790
FR;0;2022-11-07;490;569;2759;26762;482;2244;27396;39118;11004;54617542;52041997;37580367;6930677;53718654;40781288;7317871;1021660;295794
FR;0;2022-11-08;617;805;5003;51978;592;3839;52982;74287;20078;54618159;52042802;37585370;6982655;53719246;40785127;7370853;1095947;315872
FR;0;2022-11-09;516;685;3360;31606;507;2688;32382;46341;13216;54618675;52043487;37588730;7014261;53719753;40787815;7403235;1142288;329088
FR;0;2022-11-10;623;923;4574;43673;673;3624;44574;62850;17354;54619298;52044410;37593304;7057934;53720426;40791439;7447809;1205138;346442
FR;0;2022-11-11;79;116;370;1664;85;312;1727;2799;1012;54619377;52044526;37593674;7059598;53720511;40791751;7449536;1207937;347454
FR;0;2022-11-12;211;346;1195;7102;255;978;7337;10289;2765;54619588;52044872;37594869;7066700;53720766;40792729;7456873;1218226;350219
FR;0;2022-11-13;69;115;249;1208;94;213;1262;1977;627;54619657;52044987;37595118;7067908;53720860;40792942;7458135;1220203;350846
FR;0;2022-11-14;441;529;2581;23992;377;2058;24625;36201;10889;54620098;52045516;37597699;7091900;53721237;40795000;7482760;1256404;361735
FR;0;2022-11-15;608;857;4327;45054;682;3370;46002;66918;19627;54620706;52046373;37602026;7136954;53721919;40798370;7528762;1323322;381362
FR;0;2022-11-16;552;664;3071;28593;535;2578;29129;43254;13312;54621258;52047037;37605097;7165547;53722454;40800948;7557891;1366576;394674
FR;0;2022-11-17;566;684;3825;39249;531;2985;39856;58349;17402;54621824;52047721;37608922;7204796;53722985;40803933;7597747;1424925;412076
FR;0;2022-11-18;621;782;4606;45140;596;3456;46048;65708;18345;54622445;52048503;37613528;7249936;53723581;40807389;7643795;1490633;430421
FR;0;2022-11-19;270;343;1502;9806;275;1097;10001;14322;4009;54622715;52048846;37615030;7259742;53723856;40808486;7653796;1504955;434430
FR;0;2022-11-20;79;178;304;1698;160;261;1772;2717;859;54622794;52049024;37615334;7261440;53724016;40808747;7655568;1507672;435289
FR;0;2022-11-21;437;513;2424;21431;351;1954;22002;33089;10320;54623231;52049537;37617758;7282871;53724367;40810701;7677570;1540761;445609
FR;0;2022-11-22;537;608;4026;39824;435;3165;40394;59757;18234;54623768;52050145;37621784;7322695;53724802;40813866;7717964;1600518;463843
FR;0;2022-11-23;471;562;2755;26026;408;2321;26515;40382;12880;54624239;52050707;37624539;7348721;53725210;40816187;7744479;1640900;476723
FR;0;2022-11-24;510;606;3767;37152;429;2963;37865;56814;17929;54624749;52051313;37628306;7385873;53725639;40819150;7782344;1697714;494652
FR;0;2022-11-25;577;727;4187;40148;580;3148;40991;59632;17474;54625326;52052040;37632493;7426021;53726219;40822298;7823335;1757346;512126
FR;0;2022-11-26;301;338;1335;9371;262;1064;9512;13999;3971;54625627;52052378;37633828;7435392;53726481;40823362;7832847;1771345;516097
FR;0;2022-11-27;77;87;265;1661;71;225;1689;2554;805;54625704;52052465;37634093;7437053;53726552;40823587;7834536;1773899;516902
FR;0;2022-11-28;417;481;2636;24795;361;1981;25534;38451;12192;54626121;52052946;37636729;7461848;53726913;40825568;7860070;1812350;529094
FR;0;2022-11-29;499;607;4401;46524;377;3291;47252;71092;22311;54626620;52053553;37641130;7508372;53727290;40828859;7907322;1883442;551405
FR;0;2022-11-30;508;693;3738;36925;495;2896;37732;56324;17227;54627128;52054246;37644868;7545297;53727785;40831755;7945054;1939766;568632
FR;0;2022-12-01;533;680;5315;51861;459;3910;52666;79616;25205;54627661;52054926;37650183;7597158;53728244;40835665;7997720;2019382;593837
FR;0;2022-12-02;643;747;6172;61535;532;4381;62767;92431;27449;54628304;52055673;37656355;7658693;53728776;40840046;8060487;2111813;621286
FR;0;2022-12-03;304;342;2286;18050;222;1626;18479;26726;7618;54628608;52056015;37658641;7676743;53728998;40841672;8078966;2138539;628904
FR;0;2022-12-04;96;124;524;4305;91;434;4356;6441;1856;54628704;52056139;37659165;7681048;53729089;40842106;8083322;2144980;630760
FR;0;2022-12-05;467;593;4307;44696;430;2918;45662;69026;21898;54629171;52056732;37663472;7725744;53729519;40845024;8128984;2214006;652658
FR;0;2022-12-06;630;741;6850;78296;481;4654;79815;121749;39598;54629801;52057473;37670322;7804040;53730000;40849678;8208799;2335755;692256
FR;0;2022-12-07;556;639;5359;58157;474;3605;59304;90510;29569;54630357;52058112;37675681;7862197;53730474;40853283;8268103;2426265;721825
FR;0;2022-12-08;608;713;6986;79668;453;4590;81362;124168;40870;54630965;52058825;37682667;7941865;53730927;40857873;8349465;2550433;762695
FR;0;2022-12-09;782;841;8678;95680;554;5732;97571;147324;46791;54631747;52059666;37691345;8037545;53731481;40863605;8447036;2697757;809486
FR;0;2022-12-10;409;439;3825;33957;283;2481;34853;50555;14712;54632156;52060105;37695170;8071502;53731764;40866086;8481889;2748312;824198
FR;0;2022-12-11;132;141;993;8362;101;687;8567;12255;3276;54632288;52060246;37696163;8079864;53731865;40866773;8490456;2760567;827474
FR;0;2022-12-12;520;588;6378;67473;379;4133;69067;106251;34815;54632808;52060834;37702541;8147337;53732244;40870906;8559523;2866818;862289
FR;0;2022-12-13;702;777;9048;103581;485;5630;106157;164827;55050;54633510;52061611;37711589;8250918;53732729;40876536;8665680;3031645;917339
FR;0;2022-12-14;591;707;6820;73340;470;4551;75005;116971;38760;54634101;52062318;37718409;8324258;53733199;40881087;8740685;3148616;956099
FR;0;2022-12-15;658;858;8885;95916;549;5710;98231;153304;51772;54634759;52063176;37727294;8420174;53733748;40886797;8838916;3301920;1007871
FR;0;2022-12-16;827;972;9775;104802;647;6459;107041;166498;55321;54635586;52064148;37737069;8524976;53734395;40893256;8945957;3468418;1063192
FR;0;2022-12-17;344;427;3503;31788;290;2295;32580;48430;14449;54635930;52064575;37740572;8556764;53734685;40895551;8978537;3516848;1077641
FR;0;2022-12-18;93;127;788;6333;80;541;6483;9629;2752;54636023;52064702;37741360;8563097;53734765;40896092;8985020;3526477;1080393
FR;0;2022-12-19;590;615;5754;56210;431;3681;57842;90252;30083;54636613;52065317;37747114;8619307;53735196;40899773;9042862;3616729;1110476
FR;0;2022-12-20;740;790;7950;79842;526;5244;81989;130809;45055;54637353;52066107;37755064;8699149;53735722;40905017;9124851;3747538;1155531
FR;0;2022-12-21;594;623;5332;50956;433;3580;52302;84122;29309;54637947;52066730;37760396;8750105;53736155;40908597;9177153;3831660;1184840
FR;0;2022-12-22;643;664;4912;46274;461;3433;47513;76885;26899;54638590;52067394;37765308;8796379;53736616;40912030;9224666;3908545;1211739
FR;0;2022-12-23;474;583;3441;26201;419;2603;26872;43357;14900;54639064;52067977;37768749;8822580;53737035;40914633;9251538;3951902;1226639
FR;0;2022-12-24;105;108;446;2708;80;337;2832;4289;1231;54639169;52068085;37769195;8825288;53737115;40914970;9254370;3956191;1227870
FR;0;2022-12-25;34;41;134;566;33;105;592;925;273;54639203;52068126;37769329;8825854;53737148;40915075;9254962;3957116;1228143
FR;0;2022-12-26;368;391;2500;16921;291;1822;17561;27596;8822;54639571;52068517;37771829;8842775;53737439;40916897;9272523;3984712;1236965
FR;0;2022-12-27;539;661;4213;33720;444;2952;34867;56711;19739;54640110;52069178;37776042;8876495;53737883;40919849;9307390;4041423;1256704
FR;0;2022-12-28;476;517;3240;25716;351;2315;26337;42929;14830;54640586;52069695;37779282;8902211;53738234;40922164;9333727;4084352;1271534
FR;0;2022-12-29;432;539;3423;26587;352;2407;27594;45103;15658;54641018;52070234;37782705;8928798;53738586;40924571;9361321;4129455;1287192
FR;0;2022-12-30;455;504;2628;19573;358;1864;20245;32632;10998;54641473;52070738;37785333;8948371;53738944;40926435;9381566;4162087;1298190
FR;0;2022-12-31;137;156;508;3184;120;413;3328;4945;1338;54641610;52070894;37785841;8951555;53739064;40926848;9384894;4167032;1299528
FR;0;2023-01-01;25;44;177;711;26;149;737;1026;246;54641635;52070938;37786018;8952266;53739090;40926997;9385631;4168058;1299774
FR;0;2023-01-02;385;548;2999;19029;374;2314;19508;32964;12061;54642020;52071486;37789017;8971295;53739464;40929311;9405139;4201022;1311835
FR;0;2023-01-03;660;674;4754;44186;451;3365;45131;82779;34819;54642680;52072160;37793771;9015481;53739915;40932676;9450270;4283801;1346654
FR;0;2023-01-04;538;590;3870;31099;399;2762;31915;59876;25819;54643218;52072750;37797641;9046580;53740314;40935438;9482185;4343677;1372473
FR;0;2023-01-05;664;744;4682;43302;546;3185;44236;84041;37175;54643882;52073494;37802323;9089882;53740860;40938623;9526421;4427718;1409648
FR;0;2023-01-06;742;856;5521;48570;577;3661;49629;92091;39512;54644624;52074350;37807844;9138452;53741437;40942284;9576050;4519809;1449160
FR;0;2023-01-07;346;411;1948;12931;298;1414;13252;23030;8766;54644970;52074761;37809792;9151383;53741735;40943698;9589302;4542839;1457926
FR;0;2023-01-08;104;143;494;2918;99;356;3014;5231;1992;54645074;52074904;37810286;9154301;53741834;40944054;9592316;4548070;1459918
FR;0;2023-01-09;578;628;2858;22323;449;2062;22906;45817;21205;54645652;52075532;37813144;9176624;53742283;40946116;9615222;4593887;1481123
FR;0;2023-01-10;613;767;4804;41552;530;3434;42381;86980;41762;54646265;52076299;37817948;9218176;53742813;40949550;9657603;4680867;1522885
FR;0;2023-01-11;498;589;3137;25090;427;2280;25620;52846;25231;54646763;52076888;37821085;9243266;53743240;40951830;9683223;4733713;1548116
FR;0;2023-01-12;588;680;3980;34339;457;2881;34963;72491;35097;54647351;52077568;37825065;9277605;53743697;40954711;9718186;4806204;1583213
FR;0;2023-01-13;733;790;4370;36219;545;3143;36866;74577;35175;54648084;52078358;37829435;9313824;53744242;40957854;9755052;4880781;1618388
FR;0;2023-01-14;353;344;1583;9307;236;1194;9499;17760;7416;54648437;52078702;37831018;9323131;53744478;40959048;9764551;4898541;1625804
FR;0;2023-01-15;100;123;378;1566;79;290;1677;3254;1404;54648537;52078825;37831396;9324697;53744557;40959338;9766228;4901795;1627208
FR;0;2023-01-16;421;475;2382;16344;328;1788;16606;35979;18094;54648958;52079300;37833778;9341041;53744885;40961126;9782834;4937774;1645302
FR;0;2023-01-17;503;591;3534;29060;406;2562;29621;65744;33908;54649461;52079891;37837312;9370101;53745291;40963688;9812455;5003518;1679210
FR;0;2023-01-18;469;558;2361;17447;405;1832;17757;39154;19874;54649930;52080449;37839673;9387548;53745696;40965520;9830212;5042672;1699084
FR;0;2023-01-19;506;521;2867;23062;356;2130;23410;52280;27002;54650436;52080970;37842540;9410610;53746052;40967650;9853622;5094952;1726086
FR;0;2023-01-20;630;696;3466;25788;496;2622;26271;57721;29390;54651066;52081666;37846006;9436398;53746548;40970272;9879893;5152673;1755476
FR;0;2023-01-21;261;305;1141;6422;220;880;6531;13240;6017;54651327;52081971;37847147;9442820;53746768;40971152;9886424;5165913;1761493
FR;0;2023-01-22;47;63;178;880;32;154;930;1921;874;54651374;52082034;37847325;9443700;53746800;40971306;9887354;5167834;1762367
FR;0;2023-01-23;321;411;1739;11038;269;1302;11264;27216;14813;54651695;52082445;37849064;9454738;53747069;40972608;9898618;5195050;1777180
FR;0;2023-01-24;475;527;2592;20713;371;1941;21023;51007;28305;54652170;52082972;37851656;9475451;53747440;40974549;9919641;5246057;1805485
FR;0;2023-01-25;406;553;1951;12612;395;1481;13041;30756;16452;54652576;52083525;37853607;9488063;53747835;40976030;9932682;5276813;1821937
FR;0;2023-01-26;435;525;2382;17185;379;1786;17495;42440;23387;54653011;52084050;37855989;9505248;53748214;40977816;9950177;5319253;1845324
FR;0;2023-01-27;526;660;2654;18518;486;2015;18765;45011;24531;54653537;52084710;37858643;9523766;53748700;40979831;9968942;5364264;1869855
FR;0;2023-01-28;237;290;866;4521;234;691;4640;9984;4749;54653774;52085000;37859509;9528287;53748934;40980522;9973582;5374248;1874604
FR;0;2023-01-29;42;72;124;466;55;102;504;1098;548;54653816;52085072;37859633;9528753;53748989;40980624;9974086;5375346;1875152
FR;0;2023-01-30;365;449;1341;8283;321;1109;8475;20926;11426;54654181;52085521;37860974;9537036;53749310;40981733;9982561;5396272;1886578
FR;0;2023-01-31;425;489;2045;14110;331;1530;14350;36862;21255;54654606;52086010;37863019;9551146;53749641;40983263;9996911;5433134;1907833
FR;0;2023-02-01;405;523;1719;8345;396;1467;8502;22191;12591;54655011;52086533;37864738;9559491;53750037;40984730;10005413;5455325;1920424
FR;0;2023-02-02;367;499;1721;11881;341;1426;12090;31628;18235;54655378;52087032;37866459;9571372;53750378;40986156;10017503;5486953;1938659
FR;0;2023-02-03;478;645;2057;12623;480;1640;12802;33742;19438;54655856;52087677;37868516;9583995;53750858;40987796;10030305;5520695;1958097
FR;0;2023-02-04;195;276;672;3135;237;564;3180;7451;3823;54656051;52087953;37869188;9587130;53751095;40988360;10033485;5528146;1961920
FR;0;2023-02-05;25;65;89;245;42;87;261;589;284;54656076;52088018;37869277;9587375;53751137;40988447;10033746;5528735;1962204
FR;0;2023-02-06;307;353;1098;5416;284;863;5600;15375;9050;54656383;52088371;37870375;9592791;53751421;40989310;10039346;5544110;1971254
FR;0;2023-02-07;348;495;1602;9728;365;1315;9882;28144;16877;54656731;52088866;37871977;9602519;53751786;40990625;10049228;5572254;1988131
FR;0;2023-02-08;298;384;1128;6059;302;915;6224;16966;9746;54657029;52089250;37873105;9608578;53752088;40991540;10055452;5589220;1997877
FR;0;2023-02-09;339;471;1298;7889;342;1107;8073;22743;13620;54657368;52089721;37874403;9616467;53752430;40992647;10063525;5611963;2011497
FR;0;2023-02-10;462;546;1511;8354;431;1271;8499;23746;13950;54657830;52090267;37875914;9624821;53752861;40993918;10072024;5635709;2025447
FR;0;2023-02-11;167;221;582;2146;178;512;2233;5429;2768;54657997;52090488;37876496;9626967;53753039;40994430;10074257;5641138;2028215
FR;0;2023-02-12;38;42;60;175;41;54;197;439;208;54658035;52090530;37876556;9627142;53753080;40994484;10074454;5641577;2028423
FR;0;2023-02-13;227;320;742;3332;244;675;3429;9587;5490;54658262;52090850;37877298;9630474;53753324;40995159;10077883;5651164;2033913
FR;0;2023-02-14;291;370;1181;5953;270;1004;6103;17519;10402;54658553;52091220;37878479;9636427;53753594;40996163;10083986;5668683;2044315
FR;0;2023-02-15;285;391;956;4072;288;831;4250;12194;7155;54658838;52091611;37879435;9640499;53753882;40996994;10088236;5680877;2051470
FR;0;2023-02-16;261;398;1149;5169;263;1003;5329;15005;8733;54659099;52092009;37880584;9645668;53754145;40997997;10093565;5695882;2060203
FR;0;2023-02-17;366;465;1304;5474;374;1142;5697;16372;9622;54659465;52092474;37881888;9651142;53754519;40999139;10099262;5712254;2069825
FR;0;2023-02-18;159;216;563;1624;170;492;1694;4054;2045;54659624;52092690;37882451;9652766;53754689;40999631;10100956;5716308;2071870
FR;0;2023-02-19;37;38;48;139;36;39;141;338;167;54659661;52092728;37882499;9652905;53754725;40999670;10101097;5716646;2072037
FR;0;2023-02-20;244;337;709;2841;251;666;2961;8480;4860;54659905;52093065;37883208;9655746;53754976;41000336;10104058;5725126;2076897
FR;0;2023-02-21;266;412;1065;4521;267;928;4713;13932;8244;54660171;52093477;37884273;9660267;53755243;41001264;10108771;5739058;2085141
FR;0;2023-02-22;242;370;734;2936;281;698;2973;9020;5272;54660413;52093847;37885007;9663203;53755524;41001962;10111744;5748078;2090413
FR;0;2023-02-23;223;361;931;3987;247;837;4172;12211;7133;54660636;52094208;37885938;9667190;53755771;41002799;10115916;5760289;2097546
FR;0;2023-02-24;286;465;1032;4392;344;902;4589;12940;7411;54660922;52094673;37886970;9671582;53756115;41003701;10120505;5773229;2104957
FR;0;2023-02-25;122;164;444;1192;142;361;1271;3177;1616;54661044;52094837;37887414;9672774;53756257;41004062;10121776;5776406;2106573
FR;0;2023-02-26;20;27;34;101;27;35;113;256;111;54661064;52094864;37887448;9672875;53756284;41004097;10121889;5776662;2106684
FR;0;2023-02-27;205;325;594;1986;250;576;2056;6530;3927;54661269;52095189;37888042;9674861;53756534;41004673;10123945;5783192;2110611
FR;0;2023-02-28;260;362;833;3568;244;803;3707;12115;7460;54661529;52095551;37888875;9678429;53756778;41005476;10127652;5795307;2118071
FR;0;2023-03-01;217;331;755;1991;273;688;2168;6583;3917;54661746;52095882;37889630;9680420;53757051;41006164;10129820;5801890;2121988
FR;0;2023-03-02;213;310;831;2968;222;710;3190;10060;6188;54661959;52096192;37890461;9683388;53757273;41006874;10133010;5811950;2128176
FR;0;2023-03-03;320;454;1016;3663;345;907;3798;11714;6915;54662279;52096646;37891477;9687051;53757618;41007781;10136808;5823664;2135091
FR;0;2023-03-04;127;214;379;1077;156;363;1089;2775;1368;54662406;52096860;37891856;9688128;53757774;41008144;10137897;5826439;2136459
FR;0;2023-03-05;23;25;24;50;22;27;51;196;112;54662429;52096885;37891880;9688178;53757796;41008171;10137948;5826635;2136571
FR;0;2023-03-06;221;264;522;1409;188;505;1482;4685;2698;54662650;52097149;37892402;9689587;53757984;41008676;10139430;5831320;2139269
FR;0;2023-03-07;184;309;641;2350;215;597;2439;7913;4873;54662834;52097458;37893043;9691937;53758199;41009273;10141869;5839233;2144142
FR;0;2023-03-08;155;279;514;1431;214;454;1521;4956;2909;54662989;52097737;37893557;9693368;53758413;41009727;10143390;5844189;2147051
FR;0;2023-03-09;162;274;620;1988;183;591;2059;7062;4349;54663151;52098011;37894177;9695356;53758596;41010318;10145449;5851251;2151400
FR;0;2023-03-10;317;439;864;2591;324;787;2714;8880;5325;54663468;52098450;37895041;9697947;53758920;41011105;10148163;5860131;2156725
FR;0;2023-03-11;123;167;312;790;126;271;840;2284;1175;54663591;52098617;37895353;9698737;53759046;41011376;10149003;5862415;2157900
FR;0;2023-03-12;10;23;26;62;22;26;63;175;85;54663601;52098640;37895379;9698799;53759068;41011402;10149066;5862590;2157985
FR;0;2023-03-13;136;209;462;1123;154;418;1181;3699;2093;54663737;52098849;37895841;9699922;53759222;41011820;10150247;5866289;2160078
FR;0;2023-03-14;190;275;629;1855;187;620;1932;6667;4054;54663927;52099124;37896470;9701777;53759409;41012440;10152179;5872956;2164132
FR;0;2023-03-15;156;236;464;1180;191;435;1258;4209;2465;54664083;52099360;37896934;9702957;53759600;41012875;10153437;5877165;2166597
FR;0;2023-03-16;172;254;567;1612;184;519;1713;5803;3473;54664255;52099614;37897501;9704569;53759784;41013394;10155150;5882968;2170070
FR;0;2023-03-17;274;339;717;1992;254;633;2148;7172;4277;54664529;52099953;37898218;9706561;53760038;41014027;10157298;5890140;2174347
FR;0;2023-03-18;117;145;279;591;97;270;656;1994;1035;54664646;52100098;37898497;9707152;53760135;41014297;10157954;5892134;2175382
FR;0;2023-03-19;20;18;21;47;19;12;50;111;50;54664666;52100116;37898518;9707199;53760154;41014309;10158004;5892245;2175432
FR;0;2023-03-20;143;242;438;1026;157;440;1113;3715;2099;54664809;52100358;37898956;9708225;53760311;41014749;10159117;5895960;2177531
FR;0;2023-03-21;205;264;632;1593;184;597;1780;6412;3872;54665014;52100622;37899588;9709818;53760495;41015346;10160897;5902372;2181403
FR;0;2023-03-22;190;238;467;1008;186;438;1127;3848;2238;54665204;52100860;37900055;9710826;53760681;41015784;10162024;5906220;2183641
FR;0;2023-03-23;158;236;563;1376;161;507;1469;5050;2981;54665362;52101096;37900618;9712202;53760842;41016291;10163493;5911270;2186622
FR;0;2023-03-24;231;352;726;1725;253;674;1894;6463;3726;54665593;52101448;37901344;9713927;53761095;41016965;10165387;5917733;2190348
FR;0;2023-03-25;119;151;293;558;120;256;625;1728;821;54665712;52101599;37901637;9714485;53761215;41017221;10166012;5919461;2191169
FR;0;2023-03-26;9;14;16;30;9;15;32;77;36;54665721;52101613;37901653;9714515;53761224;41017236;10166044;5919538;2191205
FR;0;2023-03-27;219;245;482;873;197;466;967;3353;1886;54665940;52101858;37902135;9715388;53761421;41017702;10167011;5922891;2193091
FR;0;2023-03-28;180;234;553;1519;158;516;1635;5934;3600;54666120;52102092;37902688;9716907;53761579;41018218;10168646;5928825;2196691
FR;0;2023-03-29;162;224;412;851;141;413;977;3419;1945;54666282;52102316;37903100;9717758;53761720;41018631;10169623;5932244;2198636
