fra;vaccin;jour;n_dose1;n_dose2;n_dose3;n_dose4;n_rappel;n_cum_dose1;n_cum_dose2;n_cum_dose3;n_cum_dose4;n_cum_rappel
FR;1;2020-12-27;602;0;0;0;0;602;0;0;0;0
FR;1;2020-12-28;669;1;0;0;0;1271;1;0;0;0
FR;1;2020-12-29;374;0;0;0;0;1645;1;0;0;0
FR;1;2020-12-30;440;0;0;0;0;2085;1;0;0;0
FR;1;2020-12-31;436;1;0;0;0;2521;2;0;0;0
FR;1;2021-01-01;1137;2;0;0;0;3658;4;0;0;0
FR;1;2021-01-02;358;3;0;0;0;4016;7;0;0;0
FR;1;2021-01-03;402;0;0;0;0;4418;7;0;0;0
FR;1;2021-01-04;2092;2;0;0;0;6510;9;0;0;0
FR;1;2021-01-05;7712;3;0;0;0;14222;12;0;0;0
FR;1;2021-01-06;12447;13;0;0;0;26669;25;0;0;0
FR;1;2021-01-07;29448;9;0;0;0;56117;34;0;0;0
FR;1;2021-01-08;37121;12;0;0;0;93238;46;0;0;0
FR;1;2021-01-09;11209;4;0;0;0;104447;50;0;0;0
FR;1;2021-01-10;5996;3;0;0;0;110443;53;0;0;0
FR;1;2021-01-11;39925;17;0;0;0;150368;70;0;0;0
FR;1;2021-01-12;62126;16;0;0;0;212494;86;0;0;0
FR;1;2021-01-13;65110;30;0;0;0;277604;116;0;0;0
FR;1;2021-01-14;81437;87;0;0;0;359041;203;0;0;0
FR;1;2021-01-15;68596;34;0;0;0;427637;237;0;0;0
FR;1;2021-01-16;19893;69;0;0;0;447530;306;0;0;0
FR;1;2021-01-17;10896;47;0;0;0;458426;353;0;0;0
FR;1;2021-01-18;82811;162;0;0;0;541237;515;0;0;0
FR;1;2021-01-19;125899;174;0;0;0;667136;689;0;0;0
FR;1;2021-01-20;132391;167;0;0;0;799527;856;0;0;0
FR;1;2021-01-21;153041;161;0;0;0;952568;1017;0;0;0
FR;1;2021-01-22;115929;200;0;0;0;1068497;1217;0;0;0
FR;1;2021-01-23;36601;64;0;0;0;1105098;1281;0;0;0
FR;1;2021-01-24;9580;73;0;0;0;1114678;1354;0;0;0
FR;1;2021-01-25;74412;1268;0;0;0;1189090;2622;0;0;0
FR;1;2021-01-26;96446;3292;1;0;0;1285536;5914;1;0;0
FR;1;2021-01-27;103625;5932;0;0;0;1389161;11846;1;0;0
FR;1;2021-01-28;120583;15055;0;0;0;1509744;26901;1;0;0
FR;1;2021-01-29;88880;17738;0;0;0;1598624;44639;1;0;0
FR;1;2021-01-30;27984;4315;0;0;0;1626608;48954;1;0;0
FR;1;2021-01-31;5183;1740;0;0;0;1631791;50694;1;0;0
FR;1;2021-02-01;49708;21531;0;0;0;1681499;72225;1;0;0
FR;1;2021-02-02;67792;35772;0;0;0;1749291;107997;1;0;0
FR;1;2021-02-03;67073;38114;0;0;0;1816364;146111;1;0;0
FR;1;2021-02-04;77118;51596;0;0;0;1893482;197707;1;0;0
FR;1;2021-02-05;63406;46121;0;0;0;1956888;243828;1;0;0
FR;1;2021-02-06;19407;10762;0;0;0;1976295;254590;1;0;0
FR;1;2021-02-07;3658;5313;0;0;0;1979953;259903;1;0;0
FR;1;2021-02-08;36482;46873;0;0;0;2016435;306776;1;0;0
FR;1;2021-02-09;50790;74549;0;0;0;2067225;381325;1;0;0
FR;1;2021-02-10;52047;79407;0;0;0;2119272;460732;1;0;0
FR;1;2021-02-11;63351;101298;0;0;0;2182623;562030;1;0;0
FR;1;2021-02-12;55839;74775;0;0;0;2238462;636805;1;0;0
FR;1;2021-02-13;15451;19264;0;0;0;2253913;656069;1;0;0
FR;1;2021-02-14;3744;7280;0;0;0;2257657;663349;1;0;0
FR;1;2021-02-15;24128;73514;0;0;0;2281785;736863;1;0;0
FR;1;2021-02-16;32754;96489;0;0;0;2314539;833352;1;0;0
FR;1;2021-02-17;35098;100187;1;0;0;2349637;933539;2;0;0
FR;1;2021-02-18;49425;115521;0;0;0;2399062;1049060;2;0;0
FR;1;2021-02-19;45367;86698;1;0;0;2444429;1135758;3;0;0
FR;1;2021-02-20;13376;27073;0;0;0;2457805;1162831;3;0;0
FR;1;2021-02-21;2454;6186;0;0;0;2460259;1169017;3;0;0
FR;1;2021-02-22;24707;69442;2;0;0;2484966;1238459;5;0;0
FR;1;2021-02-23;37415;80732;1;0;0;2522381;1319191;6;0;0
FR;1;2021-02-24;40673;78303;1;0;0;2563054;1397494;7;0;0
FR;1;2021-02-25;50133;88022;1;0;0;2613187;1485516;8;0;0
FR;1;2021-02-26;47189;67582;1;0;0;2660376;1553098;9;0;0
FR;1;2021-02-27;15667;21097;0;0;0;2676043;1574195;9;0;0
FR;1;2021-02-28;3553;4228;1;0;0;2679596;1578423;10;0;0
FR;1;2021-03-01;40147;49537;1;0;0;2719743;1627960;11;0;0
FR;1;2021-03-02;55959;61884;2;0;0;2775702;1689844;13;0;0
FR;1;2021-03-03;61206;60598;0;0;0;2836908;1750442;13;0;0
FR;1;2021-03-04;72972;66237;3;0;0;2909880;1816679;16;0;0
FR;1;2021-03-05;74736;58964;3;0;0;2984616;1875643;19;0;0
FR;1;2021-03-06;82434;15968;2;0;0;3067050;1891611;21;0;0
FR;1;2021-03-07;63703;4911;1;0;0;3130753;1896522;22;0;0
FR;1;2021-03-08;60141;41951;2;0;0;3190894;1938473;24;0;0
FR;1;2021-03-09;85970;47943;1;0;0;3276864;1986416;25;0;0
FR;1;2021-03-10;90876;47932;5;0;0;3367740;2034348;30;0;0
FR;1;2021-03-11;105037;54227;1;0;0;3472777;2088575;31;0;0
FR;1;2021-03-12;104088;45042;1;0;0;3576865;2133617;32;0;0
FR;1;2021-03-13;89182;12704;1;0;0;3666047;2146321;33;0;0
FR;1;2021-03-14;44446;2862;1;0;0;3710493;2149183;34;0;0
FR;1;2021-03-15;95475;28601;3;0;0;3805968;2177784;37;0;0
FR;1;2021-03-16;123570;34435;5;0;0;3929538;2212219;42;0;0
FR;1;2021-03-17;129280;34169;4;0;0;4058818;2246388;46;0;0
FR;1;2021-03-18;142858;39550;5;0;0;4201676;2285938;51;0;0
FR;1;2021-03-19;136216;32514;2;0;0;4337892;2318452;53;0;0
FR;1;2021-03-20;75974;9970;1;0;0;4413866;2328422;54;0;0
FR;1;2021-03-21;26495;2338;1;0;0;4440361;2330760;55;0;0
FR;1;2021-03-22;114720;30790;2;0;0;4555081;2361550;57;0;0
FR;1;2021-03-23;142992;38105;1;0;0;4698073;2399655;58;0;0
FR;1;2021-03-24;141970;38554;0;0;0;4840043;2438209;58;0;0
FR;1;2021-03-25;164973;39596;4;0;0;5005016;2477805;62;0;0
FR;1;2021-03-26;166363;37511;4;1;0;5171379;2515316;66;1;0
FR;1;2021-03-27;110866;15306;1;0;0;5282245;2530622;67;1;0
FR;1;2021-03-28;42293;3895;3;0;0;5324538;2534517;70;1;0
FR;1;2021-03-29;129789;49600;4;0;0;5454327;2584117;74;1;0
FR;1;2021-03-30;167691;63514;4;0;0;5622018;2647631;78;1;0
FR;1;2021-03-31;170893;67280;4;0;0;5792911;2714911;82;1;0
FR;1;2021-04-01;194733;80754;11;0;0;5987644;2795665;93;1;0
FR;1;2021-04-02;164417;84996;7;0;0;6152061;2880661;100;1;0
FR;1;2021-04-03;88226;58046;5;0;0;6240287;2938707;105;1;0
FR;1;2021-04-04;33593;17689;0;0;0;6273880;2956396;105;1;0
FR;1;2021-04-05;46377;9959;11;0;0;6320257;2966355;116;1;0
FR;1;2021-04-06;160264;102291;17;0;0;6480521;3068646;133;1;0
FR;1;2021-04-07;196936;108216;16;0;0;6677457;3176862;149;1;0
FR;1;2021-04-08;222055;112818;13;0;0;6899512;3289680;162;1;0
FR;1;2021-04-09;214502;107395;21;0;0;7114014;3397075;183;1;0
FR;1;2021-04-10;117152;73269;14;0;0;7231166;3470344;197;1;0
FR;1;2021-04-11;40873;30131;6;0;0;7272039;3500475;203;1;0
FR;1;2021-04-12;168419;103886;45;0;0;7440458;3604361;248;1;0
FR;1;2021-04-13;203757;127971;97;1;0;7644215;3732332;345;2;0
FR;1;2021-04-14;208551;122664;206;0;0;7852766;3854996;551;2;0
FR;1;2021-04-15;221608;127053;311;0;0;8074374;3982049;862;2;0
FR;1;2021-04-16;206007;125180;308;0;0;8280381;4107229;1170;2;0
FR;1;2021-04-17;122063;67257;103;0;0;8402444;4174486;1273;2;0
FR;1;2021-04-18;35953;20932;41;0;0;8438397;4195418;1314;2;0
FR;1;2021-04-19;163710;121699;430;0;0;8602107;4317117;1744;2;0
FR;1;2021-04-20;189360;148903;531;0;0;8791467;4466020;2275;2;0
FR;1;2021-04-21;193933;146940;758;0;0;8985400;4612960;3033;2;0
FR;1;2021-04-22;208982;163151;777;0;0;9194382;4776111;3810;2;0
FR;1;2021-04-23;198913;157047;671;0;0;9393295;4933158;4481;2;0
FR;1;2021-04-24;126304;95487;148;0;0;9519599;5028645;4629;2;0
FR;1;2021-04-25;53619;30024;46;0;0;9573218;5058669;4675;2;0
FR;1;2021-04-26;181088;138370;539;0;0;9754306;5197039;5214;2;0
FR;1;2021-04-27;221321;161900;900;0;0;9975627;5358939;6114;2;0
FR;1;2021-04-28;238241;155085;1310;1;1;10213868;5514024;7424;3;1
FR;1;2021-04-29;270228;160432;1208;0;0;10484096;5674456;8632;3;1
FR;1;2021-04-30;271932;148125;1069;0;0;10756028;5822581;9701;3;1
FR;1;2021-05-01;141121;40621;172;0;0;10897149;5863202;9873;3;1
FR;1;2021-05-02;81521;28094;81;0;0;10978670;5891296;9954;3;1
FR;1;2021-05-03;250733;145199;800;0;0;11229403;6036495;10754;3;1
FR;1;2021-05-04;265815;186892;1197;0;0;11495218;6223387;11951;3;1
FR;1;2021-05-05;283813;184775;1265;0;0;11779031;6408162;13216;3;1
FR;1;2021-05-06;309894;183263;1499;0;0;12088925;6591425;14715;3;1
FR;1;2021-05-07;284040;195656;1125;0;0;12372965;6787081;15840;3;1
FR;1;2021-05-08;191636;48708;284;0;0;12564601;6835789;16124;3;1
FR;1;2021-05-09;114044;35837;236;0;0;12678645;6871626;16360;3;1
FR;1;2021-05-10;258151;194031;1183;0;0;12936796;7065657;17543;3;1
FR;1;2021-05-11;318826;210973;1462;0;0;13255622;7276630;19005;3;1
FR;1;2021-05-12;356566;185711;1399;0;0;13612188;7462341;20404;3;1
FR;1;2021-05-13;283407;47712;399;0;0;13895595;7510053;20803;3;1
FR;1;2021-05-14;370437;128565;990;0;0;14266032;7638618;21793;3;1
FR;1;2021-05-15;298049;66094;402;0;0;14564081;7704712;22195;3;1
FR;1;2021-05-16;157751;15530;158;0;0;14721832;7720242;22353;3;1
FR;1;2021-05-17;318890;116294;1436;0;0;15040722;7836536;23789;3;1
FR;1;2021-05-18;383272;111194;1795;0;0;15423994;7947730;25584;3;1
FR;1;2021-05-19;395208;102544;2176;0;0;15819202;8050274;27760;3;1
FR;1;2021-05-20;421753;96095;2042;0;0;16240955;8146369;29802;3;1
FR;1;2021-05-21;399764;97173;1756;0;0;16640719;8243542;31558;3;1
FR;1;2021-05-22;275648;42009;602;0;0;16916367;8285551;32160;3;1
FR;1;2021-05-23;122996;11139;224;0;0;17039363;8296690;32384;3;1
FR;1;2021-05-24;243983;26219;566;0;0;17283346;8322909;32950;3;1
FR;1;2021-05-25;366176;131618;2108;1;0;17649522;8454527;35058;4;1
FR;1;2021-05-26;380768;125897;1988;0;0;18030290;8580424;37046;4;1
FR;1;2021-05-27;406099;128032;1974;0;0;18436389;8708456;39020;4;1
FR;1;2021-05-28;365974;145274;1698;0;0;18802363;8853730;40718;4;1
FR;1;2021-05-29;253804;80834;525;0;0;19056167;8934564;41243;4;1
FR;1;2021-05-30;100958;22544;157;0;0;19157125;8957108;41400;4;1
FR;1;2021-05-31;314267;148751;1280;1;1;19471392;9105859;42680;5;2
FR;1;2021-06-01;361522;166400;1724;1;1;19832914;9272259;44404;6;3
FR;1;2021-06-02;364816;153174;1791;0;0;20197730;9425433;46195;6;3
FR;1;2021-06-03;390743;147567;1647;0;0;20588473;9573000;47842;6;3
FR;1;2021-06-04;363644;175489;1492;1;1;20952117;9748489;49334;7;4
FR;1;2021-06-05;258463;112640;596;0;0;21210580;9861129;49930;7;4
FR;1;2021-06-06;126751;37549;215;0;0;21337331;9898678;50145;7;4
FR;1;2021-06-07;300268;207760;1362;0;0;21637599;10106438;51507;7;4
FR;1;2021-06-08;330553;220731;1637;0;0;21968152;10327169;53144;7;4
FR;1;2021-06-09;336400;212167;1607;0;0;22304552;10539336;54751;7;4
FR;1;2021-06-10;343699;201793;1608;0;0;22648251;10741129;56359;7;4
FR;1;2021-06-11;311732;235228;1293;0;0;22959983;10976357;57652;7;4
FR;1;2021-06-12;244032;150649;431;0;0;23204015;11127006;58083;7;4
FR;1;2021-06-13;100320;61002;188;0;0;23304335;11188008;58271;7;4
FR;1;2021-06-14;207678;288721;1317;1;0;23512013;11476729;59588;8;4
FR;1;2021-06-15;256718;282070;1391;1;0;23768731;11758799;60979;9;4
FR;1;2021-06-16;273530;270605;1262;1;0;24042261;12029404;62241;10;4
FR;1;2021-06-17;268103;244767;1231;1;0;24310364;12274171;63472;11;4
FR;1;2021-06-18;260428;295648;1149;1;0;24570792;12569819;64621;12;4
FR;1;2021-06-19;193414;209483;387;0;0;24764206;12779302;65008;12;4
FR;1;2021-06-20;69655;89154;117;0;0;24833861;12868456;65125;12;4
FR;1;2021-06-21;172200;319813;929;1;1;25006061;13188269;66054;13;5
FR;1;2021-06-22;185688;347848;1098;10;2;25191749;13536117;67152;23;7
FR;1;2021-06-23;204053;339467;1048;0;0;25395802;13875584;68200;23;7
FR;1;2021-06-24;203408;282092;1167;0;0;25599210;14157676;69367;23;7
FR;1;2021-06-25;182501;371838;1196;0;0;25781711;14529514;70563;23;7
FR;1;2021-06-26;131349;278335;503;0;0;25913060;14807849;71066;23;7
FR;1;2021-06-27;52374;122904;145;0;0;25965434;14930753;71211;23;7
FR;1;2021-06-28;136514;368147;1058;0;0;26101948;15298900;72269;23;7
FR;1;2021-06-29;154756;390746;1849;0;0;26256704;15689646;74118;23;7
FR;1;2021-06-30;179912;379824;1663;4;2;26436616;16069470;75781;27;9
FR;1;2021-07-01;201288;332203;1886;5;1;26637904;16401673;77667;32;10
FR;1;2021-07-02;193574;367654;1764;5;3;26831478;16769327;79431;37;13
FR;1;2021-07-03;124387;280453;704;3;1;26955865;17049780;80135;40;14
FR;1;2021-07-04;53909;113687;244;0;0;27009774;17163467;80379;40;14
FR;1;2021-07-05;153699;356019;1500;8;2;27163473;17519486;81879;48;16
FR;1;2021-07-06;173337;382512;1601;45;8;27336810;17901998;83480;93;24
FR;1;2021-07-07;190631;362565;1657;24;5;27527441;18264563;85137;117;29
FR;1;2021-07-08;201396;323108;1825;20;7;27728837;18587671;86962;137;36
FR;1;2021-07-09;189728;387663;1851;3;2;27918565;18975334;88813;140;38
FR;1;2021-07-10;129877;281140;814;1;1;28048442;19256474;89627;141;39
FR;1;2021-07-11;57629;102503;261;0;0;28106071;19358977;89888;141;39
FR;1;2021-07-12;149480;417018;1580;4;0;28255551;19775995;91468;145;39
FR;1;2021-07-13;234093;439488;1805;8;2;28489644;20215483;93273;153;41
FR;1;2021-07-14;171751;151529;417;0;0;28661395;20367012;93690;153;41
FR;1;2021-07-15;279489;424786;1856;1;0;28940884;20791798;95546;154;41
FR;1;2021-07-16;290276;401200;1710;3;1;29231160;21192998;97256;157;42
FR;1;2021-07-17;217283;282108;754;1;0;29448443;21475106;98010;158;42
FR;1;2021-07-18;101966;107301;288;0;0;29550409;21582407;98298;158;42
FR;1;2021-07-19;238080;379112;1495;3;0;29788489;21961519;99793;161;42
FR;1;2021-07-20;305595;380694;1468;0;0;30094084;22342213;101261;161;42
FR;1;2021-07-21;333139;353384;1412;4;2;30427223;22695597;102673;165;44
FR;1;2021-07-22;364533;319228;1501;3;2;30791756;23014825;104174;168;46
FR;1;2021-07-23;349234;343584;1586;4;2;31140990;23358409;105760;172;48
FR;1;2021-07-24;238915;240974;696;1;0;31379905;23599383;106456;173;48
FR;1;2021-07-25;112752;76059;219;0;0;31492657;23675442;106675;173;48
FR;1;2021-07-26;299027;290026;1496;2;2;31791684;23965468;108171;175;50
FR;1;2021-07-27;385713;268690;1457;4;2;32177397;24234158;109628;179;52
FR;1;2021-07-28;390102;251433;1460;4;2;32567499;24485591;111088;183;54
FR;1;2021-07-29;406027;228230;1538;2;1;32973526;24713821;112626;185;55
FR;1;2021-07-30;370605;246958;1632;4;1;33344131;24960779;114258;189;56
FR;1;2021-07-31;243355;165124;793;1;0;33587486;25125903;115051;190;56
FR;1;2021-08-01;105526;47232;233;0;0;33693012;25173135;115284;190;56
FR;1;2021-08-02;297047;213208;1475;2;0;33990059;25386343;116759;192;56
FR;1;2021-08-03;331186;209173;1547;2;1;34321245;25595516;118306;194;57
FR;1;2021-08-04;327868;184334;1437;5;3;34649113;25779850;119743;199;60
FR;1;2021-08-05;301126;193537;1482;0;0;34950239;25973387;121225;199;60
FR;1;2021-08-06;290855;224496;1558;3;1;35241094;26197883;122783;202;61
FR;1;2021-08-07;182600;158820;654;4;3;35423694;26356703;123437;206;64
FR;1;2021-08-08;68835;59124;247;0;0;35492529;26415827;123684;206;64
FR;1;2021-08-09;222639;235860;1438;4;3;35715168;26651687;125122;210;67
FR;1;2021-08-10;252525;240589;1487;2;1;35967693;26892276;126609;212;68
FR;1;2021-08-11;236068;232338;1271;5;1;36203761;27124614;127880;217;69
FR;1;2021-08-12;220644;240242;1484;3;1;36424405;27364856;129364;220;70
FR;1;2021-08-13;201630;238572;1356;2;2;36626035;27603428;130720;222;72
FR;1;2021-08-14;122820;174149;645;0;0;36748855;27777577;131365;222;72
FR;1;2021-08-15;34663;46124;198;1;0;36783518;27823701;131563;223;72
FR;1;2021-08-16;156845;289823;1421;0;0;36940363;28113524;132984;223;72
FR;1;2021-08-17;171508;291551;1420;5;1;37111871;28405075;134404;228;73
FR;1;2021-08-18;161333;286985;1389;6;3;37273204;28692060;135793;234;76
FR;1;2021-08-19;148831;277740;1397;1;0;37422035;28969800;137190;235;76
FR;1;2021-08-20;140430;309155;1526;2;2;37562465;29278955;138716;237;78
FR;1;2021-08-21;84243;213250;586;0;0;37646708;29492205;139302;237;78
FR;1;2021-08-22;28545;82690;230;0;0;37675253;29574895;139532;237;78
FR;1;2021-08-23;118595;321167;1421;2;1;37793848;29896062;140953;239;79
FR;1;2021-08-24;126598;319892;1602;5;1;37920446;30215954;142555;244;80
FR;1;2021-08-25;121464;306589;1776;8;3;38041910;30522543;144331;252;83
FR;1;2021-08-26;106536;286213;2157;10;1;38148446;30808756;146488;262;84
FR;1;2021-08-27;107598;321685;2300;9;3;38256044;31130441;148788;271;87
FR;1;2021-08-28;70973;220713;1100;0;0;38327017;31351154;149888;271;87
FR;1;2021-08-29;24135;78152;467;1;0;38351152;31429306;150355;272;87
FR;1;2021-08-30;96811;286517;4307;6;5116;38447963;31715823;154662;278;5203
FR;1;2021-08-31;98033;276437;9285;15;10163;38545996;31992260;163947;293;15366
FR;1;2021-09-01;112014;245339;21105;7;22077;38658010;32237599;185052;300;37443
FR;1;2021-09-02;84781;198017;24524;11;25442;38742791;32435616;209576;311;62885
FR;1;2021-09-03;82337;227599;26946;20;27972;38825128;32663215;236522;331;90857
FR;1;2021-09-04;71569;189714;11137;11;11656;38896697;32852929;247659;342;102513
FR;1;2021-09-05;18598;41186;4121;2;4292;38915295;32894115;251780;344;106805
FR;1;2021-09-06;59481;151616;30173;15;31144;38974776;33045731;281953;359;137949
FR;1;2021-09-07;57223;139719;30203;27;31121;39031999;33185450;312156;386;169070
FR;1;2021-09-08;71237;173877;26916;20;27863;39103236;33359327;339072;406;196933
FR;1;2021-09-09;54246;124574;28600;23;29649;39157482;33483901;367672;429;226582
FR;1;2021-09-10;65839;152095;30431;22;31566;39223321;33635996;398103;451;258148
FR;1;2021-09-11;52339;146615;9727;14;10306;39275660;33782611;407830;465;268454
FR;1;2021-09-12;10772;29242;2482;1;2635;39286432;33811853;410312;466;271089
FR;1;2021-09-13;51337;104598;38729;28;39927;39337769;33916451;449041;494;311016
FR;1;2021-09-14;53206;96065;51255;65;52905;39390975;34012516;500296;559;363921
FR;1;2021-09-15;60361;139303;50463;55;46966;39451336;34151819;550759;614;410887
FR;1;2021-09-16;46539;81446;53293;71;49482;39497875;34233265;604052;685;460369
FR;1;2021-09-17;53129;109378;45047;61;42642;39551004;34342643;649099;746;503011
FR;1;2021-09-18;37839;118485;11790;19;11258;39588843;34461128;660889;765;514269
FR;1;2021-09-19;6492;21035;2037;1;1973;39595335;34482163;662926;766;516242
FR;1;2021-09-20;36433;74922;46175;66;44089;39631768;34557085;709101;832;560331
FR;1;2021-09-21;34125;68139;56232;71;52620;39665893;34625224;765333;903;612951
FR;1;2021-09-22;38755;118535;49833;76;46819;39704648;34743759;815166;979;659770
FR;1;2021-09-23;31933;62857;54465;85;50829;39736581;34806616;869631;1064;710599
FR;1;2021-09-24;36729;90108;43642;91;41877;39773310;34896724;913273;1155;752476
FR;1;2021-09-25;27628;96619;12298;27;12164;39800938;34993343;925571;1182;764640
FR;1;2021-09-26;4359;15199;1770;5;1693;39805297;35008542;927341;1187;766333
FR;1;2021-09-27;27314;60232;42888;89;41569;39832611;35068774;970229;1276;807902
FR;1;2021-09-28;26850;49449;47160;75;44387;39859461;35118223;1017389;1351;852289
FR;1;2021-09-29;35831;80389;47246;87;45528;39895292;35198612;1064635;1438;897817
FR;1;2021-09-30;26014;46797;47495;80;45373;39921306;35245409;1112130;1518;943190
FR;1;2021-10-01;47144;65054;44862;83;44415;39968450;35310463;1156992;1601;987605
FR;1;2021-10-02;32338;62367;16107;32;16297;40000788;35372830;1173099;1633;1003902
FR;1;2021-10-03;4324;8574;2031;3;2024;40005112;35381404;1175130;1636;1005926
FR;1;2021-10-04;28776;44428;47088;79;46901;40033888;35425832;1222218;1715;1052827
FR;1;2021-10-05;24259;41624;49832;116;49185;40058147;35467456;1272050;1831;1102012
FR;1;2021-10-06;34426;61349;57441;102;57130;40092573;35528805;1329491;1933;1159142
FR;1;2021-10-07;20951;39826;52994;75;51812;40113524;35568631;1382485;2008;1210954
FR;1;2021-10-08;34961;59590;60361;83;61057;40148485;35628221;1442846;2091;1272011
FR;1;2021-10-09;27425;47980;25476;30;25975;40175910;35676201;1468322;2121;1297986
FR;1;2021-10-10;3653;5788;2746;7;2847;40179563;35681989;1471068;2128;1300833
FR;1;2021-10-11;24704;38168;54561;88;55169;40204267;35720157;1525629;2216;1356002
FR;1;2021-10-12;23153;36559;58022;126;59084;40227420;35756716;1583651;2342;1415086
FR;1;2021-10-13;32816;47794;64145;124;65615;40260236;35804510;1647796;2466;1480701
FR;1;2021-10-14;21607;34772;53727;103;54293;40281843;35839282;1701523;2569;1534994
FR;1;2021-10-15;32558;48817;72303;165;74921;40314401;35888099;1773826;2734;1609915
FR;1;2021-10-16;25963;35274;34857;44;36391;40340364;35923373;1808683;2778;1646306
FR;1;2021-10-17;3096;4065;3407;2;3318;40343460;35927438;1812090;2780;1649624
FR;1;2021-10-18;23564;34915;66806;131;69647;40367024;35962353;1878896;2911;1719271
FR;1;2021-10-19;20598;34599;75631;135;79520;40387622;35996952;1954527;3046;1798791
FR;1;2021-10-20;29799;44204;96143;177;99767;40417421;36041156;2050670;3223;1898558
FR;1;2021-10-21;19623;35085;83124;107;86983;40437044;36076241;2133794;3330;1985541
FR;1;2021-10-22;29537;47644;103702;196;109573;40466581;36123885;2237496;3526;2095114
FR;1;2021-10-23;23007;35156;44849;57;47350;40489588;36159041;2282345;3583;2142464
FR;1;2021-10-24;2374;3880;3579;6;3732;40491962;36162921;2285924;3589;2146196
FR;1;2021-10-25;22393;30830;81993;143;85758;40514355;36193751;2367917;3732;2231954
FR;1;2021-10-26;19298;27710;86059;162;90274;40533653;36221461;2453976;3894;2322228
FR;1;2021-10-27;26136;39667;107761;252;112605;40559789;36261128;2561737;4146;2434833
FR;1;2021-10-28;18631;27067;86893;150;91583;40578420;36288195;2648630;4296;2526416
FR;1;2021-10-29;25881;40190;114785;200;121520;40604301;36328385;2763415;4496;2647936
FR;1;2021-10-30;17675;28634;49339;75;51913;40621976;36357019;2812754;4571;2699849
FR;1;2021-10-31;2055;3197;3443;2;3677;40624031;36360216;2816197;4573;2703526
FR;1;2021-11-01;7717;4215;3021;3;3264;40631748;36364431;2819218;4576;2706790
FR;1;2021-11-02;21861;33205;92346;157;97693;40653609;36397636;2911564;4733;2804483
FR;1;2021-11-03;26295;41540;117445;215;123798;40679904;36439176;3029009;4948;2928281
FR;1;2021-11-04;19490;30297;105734;213;111824;40699394;36469473;3134743;5161;3040105
FR;1;2021-11-05;26916;42235;138720;228;147297;40726310;36511708;3273463;5389;3187402
FR;1;2021-11-06;18815;29819;63443;123;66413;40745125;36541527;3336906;5512;3253815
FR;1;2021-11-07;1791;3341;4959;6;5298;40746916;36544868;3341865;5518;3259113
FR;1;2021-11-08;17689;32304;125921;224;132480;40764605;36577172;3467786;5742;3391593
FR;1;2021-11-09;19253;37706;159222;335;168932;40783858;36614878;3627008;6077;3560525
FR;1;2021-11-10;28684;49204;181821;440;192368;40812542;36664082;3808829;6517;3752893
FR;1;2021-11-11;3813;5938;12194;26;13002;40816355;36670020;3821023;6543;3765895
FR;1;2021-11-12;25934;46856;174747;244;186343;40842289;36716876;3995770;6787;3952238
FR;1;2021-11-13;18694;29238;76802;111;81736;40860983;36746114;4072572;6898;4033974
FR;1;2021-11-14;2028;3314;6812;5;7383;40863011;36749428;4079384;6903;4041357
FR;1;2021-11-15;18615;34875;156346;303;166109;40881626;36784303;4235730;7206;4207466
FR;1;2021-11-16;21105;37921;192007;377;204783;40902731;36822224;4427737;7583;4412249
FR;1;2021-11-17;28504;45718;193145;399;204922;40931235;36867942;4620882;7982;4617171
FR;1;2021-11-18;21058;38934;182383;457;194357;40952293;36906876;4803265;8439;4811528
FR;1;2021-11-19;30774;53361;230143;529;246554;40983067;36960237;5033408;8968;5058082
FR;1;2021-11-20;23708;33322;96941;201;103581;41006775;36993559;5130349;9169;5161663
FR;1;2021-11-21;2313;4011;9096;18;9967;41009088;36997570;5139445;9187;5171630
FR;1;2021-11-22;21354;30496;175801;465;189316;41030442;37028066;5315246;9652;5360946
FR;1;2021-11-23;23875;41157;221094;539;237791;41054317;37069223;5536340;10191;5598737
FR;1;2021-11-24;30261;49778;217259;703;234384;41084578;37119001;5753599;10894;5833121
FR;1;2021-11-25;23490;43950;244355;718;263902;41108068;37162951;5997954;11612;6097023
FR;1;2021-11-26;30589;66528;356681;833;388356;41138657;37229479;6354635;12445;6485379
FR;1;2021-11-27;21788;45385;202553;371;222534;41160445;37274864;6557188;12816;6707913
FR;1;2021-11-28;3137;9676;54756;63;61032;41163582;37284540;6611944;12879;6768945
FR;1;2021-11-29;17857;49530;326273;840;354260;41181439;37334070;6938217;13719;7123205
FR;1;2021-11-30;22744;64954;431030;951;470597;41204183;37399024;7369247;14670;7593802
FR;1;2021-12-01;24922;69374;442743;1130;481589;41229105;37468398;7811990;15800;8075391
FR;1;2021-12-02;19984;64480;489249;1227;532691;41249089;37532878;8301239;17027;8608082
FR;1;2021-12-03;22840;81854;542604;1307;591596;41271929;37614732;8843843;18334;9199678
FR;1;2021-12-04;16371;53936;299028;652;328860;41288300;37668668;9142871;18986;9528538
FR;1;2021-12-05;3622;13917;81495;143;91054;41291922;37682585;9224366;19129;9619592
FR;1;2021-12-06;21226;62802;415311;1065;455037;41313148;37745387;9639677;20194;10074629
FR;1;2021-12-07;19805;75847;522813;1531;572427;41332953;37821234;10162490;21725;10647056
FR;1;2021-12-08;21565;75880;458221;1543;501925;41354518;37897114;10620711;23268;11148981
FR;1;2021-12-09;19398;74115;492762;1625;540618;41373916;37971229;11113473;24893;11689599
FR;1;2021-12-10;23088;87639;547266;1586;599845;41397004;38058868;11660739;26479;12289444
FR;1;2021-12-11;16516;59024;302680;747;335427;41413520;38117892;11963419;27226;12624871
FR;1;2021-12-12;4344;16025;83179;179;94073;41417864;38133917;12046598;27405;12718944
FR;1;2021-12-13;15558;63816;366828;1093;406171;41433422;38197733;12413426;28498;13125115
FR;1;2021-12-14;20539;80350;464543;1742;515019;41453961;38278083;12877969;30240;13640134
FR;1;2021-12-15;21431;77540;408923;1307;452998;41475392;38355623;13286892;31547;14093132
FR;1;2021-12-16;19970;77381;451681;1574;500452;41495362;38433004;13738573;33121;14593584
FR;1;2021-12-17;22542;86720;479792;1733;530933;41517904;38519724;14218365;34854;15124517
FR;1;2021-12-18;17583;54750;257560;730;288475;41535487;38574474;14475925;35584;15412992
FR;1;2021-12-19;5537;17120;79132;194;90732;41541024;38591594;14555057;35778;15503724
FR;1;2021-12-20;20821;63206;316109;1081;355183;41561845;38654800;14871166;36859;15858907
FR;1;2021-12-21;26108;73237;372620;1421;417971;41587953;38728037;15243786;38280;16276878
FR;1;2021-12-22;24906;66011;310509;1215;349485;41612859;38794048;15554295;39495;16626363
FR;1;2021-12-23;21238;52354;241396;954;272980;41634097;38846402;15795691;40449;16899343
FR;1;2021-12-24;7102;18262;67109;256;77031;41641199;38864664;15862800;40705;16976374
FR;1;2021-12-25;502;2767;5569;15;6530;41641701;38867431;15868369;40720;16982904
FR;1;2021-12-26;2749;7598;26922;70;31449;41644450;38875029;15895291;40790;17014353
FR;1;2021-12-27;18226;53567;235018;707;265691;41662676;38928596;16130309;41497;17280044
FR;1;2021-12-28;23253;62036;291954;1025;330143;41685929;38990632;16422263;42522;17610187
FR;1;2021-12-29;22196;55556;254920;918;288137;41708125;39046188;16677183;43440;17898324
FR;1;2021-12-30;21224;46377;212097;857;239565;41729349;39092565;16889280;44297;18137889
FR;1;2021-12-31;7460;16633;61835;229;70361;41736809;39109198;16951115;44526;18208250
FR;1;2022-01-01;996;2483;5645;29;6577;41737805;39111681;16956760;44555;18214827
FR;1;2022-01-02;3044;8067;28873;50;33525;41740849;39119748;16985633;44605;18248352
FR;1;2022-01-03;20395;53958;228119;786;257534;41761244;39173706;17213752;45391;18505886
FR;1;2022-01-04;25204;64883;299156;1235;337204;41786448;39238589;17512908;46626;18843090
FR;1;2022-01-05;29825;63982;274770;1097;310119;41816273;39302571;17787678;47723;19153209
FR;1;2022-01-06;26630;65996;306802;1396;346431;41842903;39368567;18094480;49119;19499640
FR;1;2022-01-07;31421;74726;349757;1534;393855;41874324;39443293;18444237;50653;19893495
FR;1;2022-01-08;23354;51392;222464;695;251098;41897678;39494685;18666701;51348;20144593
FR;1;2022-01-09;7075;17185;66011;163;76146;41904753;39511870;18732712;51511;20220739
FR;1;2022-01-10;21548;56635;236696;952;267144;41926301;39568505;18969408;52463;20487883
FR;1;2022-01-11;26515;63237;282199;1277;317749;41952816;39631742;19251607;53740;20805632
FR;1;2022-01-12;28759;62315;246151;1103;277924;41981575;39694057;19497758;54843;21083556
FR;1;2022-01-13;24511;59997;262714;1253;296059;42006086;39754054;19760472;56096;21379615
FR;1;2022-01-14;27815;66568;313903;1366;351186;42033901;39820622;20074375;57462;21730801
FR;1;2022-01-15;19267;44369;199274;619;223849;42053168;39864991;20273649;58081;21954650
FR;1;2022-01-16;5135;12992;51495;135;59574;42058303;39877983;20325144;58216;22014224
FR;1;2022-01-17;16761;39734;184778;780;206816;42075064;39917717;20509922;58996;22221040
FR;1;2022-01-18;19244;45793;212354;1151;236983;42094308;39963510;20722276;60147;22458023
FR;1;2022-01-19;20182;43959;176045;896;197180;42114490;40007469;20898321;61043;22655203
FR;1;2022-01-20;16624;40445;183588;1137;204683;42131114;40047914;21081909;62180;22859886
FR;1;2022-01-21;19755;46957;228889;1406;253302;42150869;40094871;21310798;63586;23113188
FR;1;2022-01-22;13826;33303;144470;578;161365;42164695;40128174;21455268;64164;23274553
FR;1;2022-01-23;3346;8798;33402;130;38321;42168041;40136972;21488670;64294;23312874
FR;1;2022-01-24;11743;32772;142157;706;158243;42179784;40169744;21630827;65000;23471117
FR;1;2022-01-25;14103;38152;163338;1048;181526;42193887;40207896;21794165;66048;23652643
FR;1;2022-01-26;14834;37448;150199;931;166261;42208721;40245344;21944364;66979;23818904
FR;1;2022-01-27;12292;32994;143396;884;157879;42221013;40278338;22087760;67863;23976783
FR;1;2022-01-28;16251;54013;198254;1144;222443;42237264;40332351;22286014;69007;24199226
FR;1;2022-01-29;10257;35446;135176;522;151544;42247521;40367797;22421190;69529;24350770
FR;1;2022-01-30;2474;9297;29666;86;34462;42249995;40377094;22450856;69615;24385232
FR;1;2022-01-31;8730;32358;104303;530;117395;42258725;40409452;22555159;70145;24502627
FR;1;2022-02-01;10260;36292;127023;863;141231;42268985;40445744;22682182;71008;24643858
FR;1;2022-02-02;11548;41177;130302;780;145845;42280533;40486921;22812484;71788;24789703
FR;1;2022-02-03;8776;33460;116958;780;130353;42289309;40520381;22929442;72568;24920056
FR;1;2022-02-04;11420;48117;172524;965;192781;42300729;40568498;23101966;73533;25112837
FR;1;2022-02-05;7889;33907;117556;391;133057;42308618;40602405;23219522;73924;25245894
FR;1;2022-02-06;1690;8046;22734;85;26906;42310308;40610451;23242256;74009;25272800
FR;1;2022-02-07;7149;35406;119046;452;134969;42317457;40645857;23361302;74461;25407769
FR;1;2022-02-08;7574;31610;125604;694;140579;42325031;40677467;23486906;75155;25548348
FR;1;2022-02-09;8469;36233;135207;695;152427;42333500;40713700;23622113;75850;25700775
FR;1;2022-02-10;6587;29390;116300;674;130065;42340087;40743090;23738413;76524;25830840
FR;1;2022-02-11;8568;41380;165079;875;185290;42348655;40784470;23903492;77399;26016130
FR;1;2022-02-12;5294;27536;106671;378;120845;42353949;40812006;24010163;77777;26136975
FR;1;2022-02-13;1223;5700;21706;65;25318;42355172;40817706;24031869;77842;26162293
FR;1;2022-02-14;5381;27086;118036;388;133059;42360553;40844792;24149905;78230;26295352
FR;1;2022-02-15;5591;28159;118853;609;132450;42366144;40872951;24268758;78839;26427802
FR;1;2022-02-16;5654;28217;110379;595;122986;42371798;40901168;24379137;79434;26550788
FR;1;2022-02-17;4417;19323;73101;486;80178;42376215;40920491;24452238;79920;26630966
FR;1;2022-02-18;5533;26527;99153;668;108102;42381748;40947018;24551391;80588;26739068
FR;1;2022-02-19;3532;17087;59459;304;66034;42385280;40964105;24610850;80892;26805102
FR;1;2022-02-20;784;3225;10690;35;12313;42386064;40967330;24621540;80927;26817415
FR;1;2022-02-21;3363;14476;52792;286;57639;42389427;40981806;24674332;81213;26875054
FR;1;2022-02-22;3719;15382;51870;499;55596;42393146;40997188;24726202;81712;26930650
FR;1;2022-02-23;4163;17646;57449;508;62548;42397309;41014834;24783651;82220;26993198
FR;1;2022-02-24;3244;12782;43574;436;46356;42400553;41027616;24827225;82656;27039554
FR;1;2022-02-25;4406;19478;64847;695;68710;42404959;41047094;24892072;83351;27108264
FR;1;2022-02-26;2678;12690;41350;308;45103;42407637;41059784;24933422;83659;27153367
FR;1;2022-02-27;639;2170;7116;42;7981;42408276;41061954;24940538;83701;27161348
FR;1;2022-02-28;2565;10223;34925;301;37349;42410841;41072177;24975463;84002;27198697
FR;1;2022-03-01;2774;10411;38647;389;39570;42413615;41082588;25014110;84391;27238267
FR;1;2022-03-02;3449;11901;41812;390;43864;42417064;41094489;25055922;84781;27282131
FR;1;2022-03-03;2315;7607;26121;320;26433;42419379;41102096;25082043;85101;27308564
FR;1;2022-03-04;2656;10244;35392;576;34870;42422035;41112340;25117435;85677;27343434
FR;1;2022-03-05;1741;6293;21945;278;22332;42423776;41118633;25139380;85955;27365766
FR;1;2022-03-06;350;938;2914;37;3112;42424126;41119571;25142294;85992;27368878
FR;1;2022-03-07;1408;4574;16408;245;15866;42425534;41124145;25158702;86237;27384744
FR;1;2022-03-08;1540;5102;17131;307;15952;42427074;41129247;25175833;86544;27400696
FR;1;2022-03-09;1873;6482;19778;367;19124;42428947;41135729;25195611;86911;27419820
FR;1;2022-03-10;1305;4445;15202;305;14218;42430252;41140174;25210813;87216;27434038
FR;1;2022-03-11;1694;6160;21684;482;19831;42431946;41146334;25232497;87698;27453869
FR;1;2022-03-12;1226;4596;15351;276;14897;42433172;41150930;25247848;87974;27468766
FR;1;2022-03-13;240;604;2104;115;2052;42433412;41151534;25249952;88089;27470818
FR;1;2022-03-14;1075;3566;13366;3874;12489;42434487;41155100;25263318;91963;27483307
FR;1;2022-03-15;1261;3849;14524;6861;13004;42435748;41158949;25277842;98824;27496311
FR;1;2022-03-16;1605;4769;17340;11513;16393;42437353;41163718;25295182;110337;27512704
FR;1;2022-03-17;1096;3182;11681;9637;10776;42438449;41166900;25306863;119974;27523480
FR;1;2022-03-18;1666;4721;17919;16486;16348;42440115;41171621;25324782;136460;27539828
FR;1;2022-03-19;1112;3194;11881;8451;11347;42441227;41174815;25336663;144911;27551175
FR;1;2022-03-20;218;535;1718;1007;1751;42441445;41175350;25338381;145918;27552926
FR;1;2022-03-21;1040;2689;11474;13442;10819;42442485;41178039;25349855;159360;27563745
FR;1;2022-03-22;1192;3073;12222;18682;11211;42443677;41181112;25362077;178042;27574956
FR;1;2022-03-23;1466;4174;15970;20091;15649;42445143;41185286;25378047;198133;27590605
FR;1;2022-03-24;1069;2526;10357;16013;9609;42446212;41187812;25388404;214146;27600214
FR;1;2022-03-25;1499;4057;16681;25280;15324;42447711;41191869;25405085;239426;27615538
FR;1;2022-03-26;1097;2903;10838;11430;10495;42448808;41194772;25415923;250856;27626033
FR;1;2022-03-27;228;537;1728;1378;1780;42449036;41195309;25417651;252234;27627813
FR;1;2022-03-28;1035;2358;9932;15861;9553;42450071;41197667;25427583;268095;27637366
FR;1;2022-03-29;1111;2702;11521;25060;10888;42451182;41200369;25439104;293155;27648254
FR;1;2022-03-30;1595;3465;14119;24144;13650;42452777;41203834;25453223;317299;27661904
FR;1;2022-03-31;1262;2619;11623;22549;11127;42454039;41206453;25464846;339848;27673031
FR;1;2022-04-01;1661;3760;18402;28456;17247;42455700;41210213;25483248;368304;27690278
FR;1;2022-04-02;887;1853;8175;9206;7923;42456587;41212066;25491423;377510;27698201
FR;1;2022-04-03;187;366;1428;1056;1429;42456774;41212432;25492851;378566;27699630
FR;1;2022-04-04;1081;2160;11278;17629;10651;42457855;41214592;25504129;396195;27710281
FR;1;2022-04-05;1252;2493;12931;31097;11948;42459107;41217085;25517060;427292;27722229
FR;1;2022-04-06;1321;2713;12110;23767;11524;42460428;41219798;25529170;451059;27733753
FR;1;2022-04-07;1135;2493;12268;30913;11727;42461563;41222291;25541438;481972;27745480
FR;1;2022-04-08;1559;3465;17483;40401;16397;42463122;41225756;25558921;522373;27761877
FR;1;2022-04-09;803;1971;8382;12474;8076;42463925;41227727;25567303;534847;27769953
FR;1;2022-04-10;186;459;1821;1831;1853;42464111;41228186;25569124;536678;27771806
FR;1;2022-04-11;951;2104;10924;22114;10635;42465062;41230290;25580048;558792;27782441
FR;1;2022-04-12;1196;2385;12734;37838;12227;42466258;41232675;25592782;596630;27794668
FR;1;2022-04-13;1164;2600;12194;30336;11905;42467422;41235275;25604976;626966;27806573
FR;1;2022-04-14;1170;2292;11985;33259;11969;42468592;41237567;25616961;660225;27818542
FR;1;2022-04-15;1419;2784;14301;32975;13675;42470011;41240351;25631262;693200;27832217
FR;1;2022-04-16;650;1388;5819;7971;5740;42470661;41241739;25637081;701171;27837957
FR;1;2022-04-17;149;271;928;1103;970;42470810;41242010;25638009;702274;27838927
FR;1;2022-04-18;122;381;2608;974;2633;42470932;41242391;25640617;703248;27841560
FR;1;2022-04-19;1185;2489;11717;27684;11396;42472117;41244880;25652334;730932;27852956
FR;1;2022-04-20;1260;2515;12084;26661;11905;42473377;41247395;25664418;757593;27864861
FR;1;2022-04-21;1205;2339;11434;32862;11588;42474582;41249734;25675852;790455;27876449
FR;1;2022-04-22;1475;2942;15142;35340;14728;42476057;41252676;25690994;825795;27891177
FR;1;2022-04-23;746;1555;6709;9871;6612;42476803;41254231;25697703;835666;27897789
FR;1;2022-04-24;187;355;1368;1510;1320;42476990;41254586;25699071;837176;27899109
FR;1;2022-04-25;989;2045;9810;19544;9697;42477979;41256631;25708881;856720;27908806
FR;1;2022-04-26;1292;2573;12541;36322;12135;42479271;41259204;25721422;893042;27920941
FR;1;2022-04-27;1274;2348;10560;28814;10693;42480545;41261552;25731982;921856;27931634
FR;1;2022-04-28;1243;2286;11474;33818;11293;42481788;41263838;25743456;955674;27942927
FR;1;2022-04-29;1565;2899;14269;35131;13694;42483353;41266737;25757725;990805;27956621
FR;1;2022-04-30;804;1432;6358;9109;6192;42484157;41268169;25764083;999914;27962813
FR;1;2022-05-01;150;262;809;914;803;42484307;41268431;25764892;1000828;27963616
FR;1;2022-05-02;899;1823;10197;16606;10065;42485206;41270254;25775089;1017434;27973681
FR;1;2022-05-03;1361;2496;12405;32456;12308;42486567;41272750;25787494;1049890;27985989
FR;1;2022-05-04;1268;2393;10852;23464;10995;42487835;41275143;25798346;1073354;27996984
FR;1;2022-05-05;1320;2335;11534;31281;11371;42489155;41277478;25809880;1104635;28008355
FR;1;2022-05-06;1653;3096;14029;34568;13581;42490808;41280574;25823909;1139203;28021936
FR;1;2022-05-07;823;1448;5911;9057;5942;42491631;41282022;25829820;1148260;28027878
FR;1;2022-05-08;179;316;1044;1447;1105;42491810;41282338;25830864;1149707;28028983
FR;1;2022-05-09;1006;1839;9100;18955;9007;42492816;41284177;25839964;1168662;28037990
FR;1;2022-05-10;1339;2473;12262;36541;11866;42494155;41286650;25852226;1205203;28049856
FR;1;2022-05-11;1359;2172;9730;25660;9638;42495514;41288822;25861956;1230863;28059494
FR;1;2022-05-12;1237;2202;10233;32958;9887;42496751;41291024;25872189;1263821;28069381
FR;1;2022-05-13;1552;2681;12589;35347;12241;42498303;41293705;25884778;1299168;28081622
FR;1;2022-05-14;752;1273;5348;10126;5222;42499055;41294978;25890126;1309294;28086844
FR;1;2022-05-15;205;364;1141;1333;1208;42499260;41295342;25891267;1310627;28088052
FR;1;2022-05-16;915;1655;7812;19770;7843;42500175;41296997;25899079;1330397;28095895
FR;1;2022-05-17;1223;2168;10864;35543;10464;42501398;41299165;25909943;1365940;28106359
FR;1;2022-05-18;1225;1970;8562;25314;8518;42502623;41301135;25918505;1391254;28114877
FR;1;2022-05-19;1130;2242;9528;33093;9524;42503753;41303377;25928033;1424347;28124401
FR;1;2022-05-20;1517;2598;12107;37170;11702;42505270;41305975;25940140;1461517;28136103
FR;1;2022-05-21;751;1313;4891;9215;4835;42506021;41307288;25945031;1470732;28140938
FR;1;2022-05-22;179;270;924;1319;918;42506200;41307558;25945955;1472051;28141856
FR;1;2022-05-23;898;1664;7411;18937;7364;42507098;41309222;25953366;1490988;28149220
FR;1;2022-05-24;1228;2302;9962;36292;9829;42508326;41311524;25963328;1527280;28159049
FR;1;2022-05-25;1213;2156;8310;23141;8453;42509539;41313680;25971638;1550421;28167502
FR;1;2022-05-26;135;245;920;1051;940;42509674;41313925;25972558;1551472;28168442
FR;1;2022-05-27;1037;1991;7769;20245;7566;42510711;41315916;25980327;1571717;28176008
FR;1;2022-05-28;458;991;3366;6494;3416;42511169;41316907;25983693;1578211;28179424
FR;1;2022-05-29;108;240;671;852;676;42511277;41317147;25984364;1579063;28180100
FR;1;2022-05-30;777;1612;5913;18156;5933;42512054;41318759;25990277;1597219;28186033
FR;1;2022-05-31;1212;2069;8927;33722;8822;42513266;41320828;25999204;1630941;28194855
FR;1;2022-06-01;1093;1985;7120;22541;7049;42514359;41322813;26006324;1653482;28201904
FR;1;2022-06-02;1094;2010;8262;33082;7891;42515453;41324823;26014586;1686564;28209795
FR;1;2022-06-03;1292;2470;9705;36281;9321;42516745;41327293;26024291;1722845;28219116
FR;1;2022-06-04;624;1158;3925;8448;4016;42517369;41328451;26028216;1731293;28223132
FR;1;2022-06-05;103;244;708;924;726;42517472;41328695;26028924;1732217;28223858
FR;1;2022-06-06;99;199;692;983;685;42517571;41328894;26029616;1733200;28224543
FR;1;2022-06-07;1000;1997;7996;32726;7675;42518571;41330891;26037612;1765926;28232218
FR;2;2020-12-27;0;0;0;0;0;0;0;0;0;0
FR;2;2020-12-28;0;0;0;0;0;0;0;0;0;0
FR;2;2020-12-29;0;0;0;0;0;0;0;0;0;0
FR;2;2020-12-30;0;0;0;0;0;0;0;0;0;0
FR;2;2020-12-31;0;0;0;0;0;0;0;0;0;0
FR;2;2021-01-01;0;0;0;0;0;0;0;0;0;0
FR;2;2021-01-02;0;0;0;0;0;0;0;0;0;0
FR;2;2021-01-03;0;0;0;0;0;0;0;0;0;0
FR;2;2021-01-04;0;0;0;0;0;0;0;0;0;0
FR;2;2021-01-05;0;0;0;0;0;0;0;0;0;0
FR;2;2021-01-06;0;0;0;0;0;0;0;0;0;0
FR;2;2021-01-07;0;0;0;0;0;0;0;0;0;0
FR;2;2021-01-08;0;0;0;0;0;0;0;0;0;0
FR;2;2021-01-09;0;0;0;0;0;0;0;0;0;0
FR;2;2021-01-10;0;0;0;0;0;0;0;0;0;0
FR;2;2021-01-11;0;0;0;0;0;0;0;0;0;0
FR;2;2021-01-12;0;0;0;0;0;0;0;0;0;0
FR;2;2021-01-13;0;0;0;0;0;0;0;0;0;0
FR;2;2021-01-14;1685;0;0;0;0;1685;0;0;0;0
FR;2;2021-01-15;396;0;0;0;0;2081;0;0;0;0
FR;2;2021-01-16;315;0;0;0;0;2396;0;0;0;0
FR;2;2021-01-17;81;0;0;0;0;2477;0;0;0;0
FR;2;2021-01-18;3073;2;0;0;0;5550;2;0;0;0
FR;2;2021-01-19;4677;0;0;0;0;10227;2;0;0;0
FR;2;2021-01-20;5135;4;0;0;0;15362;6;0;0;0
FR;2;2021-01-21;5338;9;0;0;0;20700;15;0;0;0
FR;2;2021-01-22;5115;8;0;0;0;25815;23;0;0;0
FR;2;2021-01-23;1866;0;0;0;0;27681;23;0;0;0
FR;2;2021-01-24;160;1;0;0;0;27841;24;0;0;0
FR;2;2021-01-25;3811;3;0;0;0;31652;27;0;0;0
FR;2;2021-01-26;3919;1;0;0;0;35571;28;0;0;0
FR;2;2021-01-27;3598;2;0;0;0;39169;30;0;0;0
FR;2;2021-01-28;3748;7;0;0;0;42917;37;0;0;0
FR;2;2021-01-29;3292;2;0;0;0;46209;39;0;0;0
FR;2;2021-01-30;1130;1;0;0;0;47339;40;0;0;0
FR;2;2021-01-31;45;1;0;0;0;47384;41;0;0;0
FR;2;2021-02-01;3400;3;0;0;0;50784;44;0;0;0
FR;2;2021-02-02;4489;10;0;0;0;55273;54;0;0;0
FR;2;2021-02-03;5218;6;0;0;0;60491;60;0;0;0
FR;2;2021-02-04;4931;10;0;0;0;65422;70;0;0;0
FR;2;2021-02-05;4810;13;0;0;0;70232;83;0;0;0
FR;2;2021-02-06;2040;12;0;0;0;72272;95;0;0;0
FR;2;2021-02-07;101;4;0;0;0;72373;99;0;0;0
FR;2;2021-02-08;7553;20;0;0;0;79926;119;0;0;0
FR;2;2021-02-09;8420;28;0;0;0;88346;147;0;0;0
FR;2;2021-02-10;9338;58;0;0;0;97684;205;0;0;0
FR;2;2021-02-11;10280;99;0;0;0;107964;304;0;0;0
FR;2;2021-02-12;10054;261;0;0;0;118018;565;0;0;0
FR;2;2021-02-13;3118;226;0;0;0;121136;791;0;0;0
FR;2;2021-02-14;355;8;0;0;0;121491;799;0;0;0
FR;2;2021-02-15;3454;3099;0;0;0;124945;3898;0;0;0
FR;2;2021-02-16;5066;4033;0;0;0;130011;7931;0;0;0
FR;2;2021-02-17;4253;4470;0;0;0;134264;12401;0;0;0
FR;2;2021-02-18;5400;5120;0;0;0;139664;17521;0;0;0
FR;2;2021-02-19;5324;4404;0;0;0;144988;21925;0;0;0
FR;2;2021-02-20;1869;1508;0;0;0;146857;23433;0;0;0
FR;2;2021-02-21;242;88;0;0;0;147099;23521;0;0;0
FR;2;2021-02-22;3612;3751;0;0;0;150711;27272;0;0;0
FR;2;2021-02-23;4952;3691;0;0;0;155663;30963;0;0;0
FR;2;2021-02-24;5010;3495;0;0;0;160673;34458;0;0;0
FR;2;2021-02-25;5483;3455;0;0;0;166156;37913;0;0;0
FR;2;2021-02-26;4361;3148;0;0;0;170517;41061;0;0;0
FR;2;2021-02-27;1623;1052;0;0;0;172140;42113;0;0;0
FR;2;2021-02-28;177;29;0;0;0;172317;42142;0;0;0
FR;2;2021-03-01;5178;3725;0;0;0;177495;45867;0;0;0
FR;2;2021-03-02;6528;4730;0;0;0;184023;50597;0;0;0
FR;2;2021-03-03;6534;4923;0;0;0;190557;55520;0;0;0
FR;2;2021-03-04;8398;4065;0;0;0;198955;59585;0;0;0
FR;2;2021-03-05;8028;4061;0;0;0;206983;63646;0;0;0
FR;2;2021-03-06;4783;1684;0;0;0;211766;65330;0;0;0
FR;2;2021-03-07;2372;30;0;0;0;214138;65360;0;0;0
FR;2;2021-03-08;4164;8333;0;0;0;218302;73693;0;0;0
FR;2;2021-03-09;7486;8500;1;0;0;225788;82193;1;0;0
FR;2;2021-03-10;7099;9141;0;0;0;232887;91334;1;0;0
FR;2;2021-03-11;9372;9243;1;0;0;242259;100577;2;0;0
FR;2;2021-03-12;7972;8225;0;0;0;250231;108802;2;0;0
FR;2;2021-03-13;10046;2559;0;0;0;260277;111361;2;0;0
FR;2;2021-03-14;4838;403;0;0;0;265115;111764;2;0;0
FR;2;2021-03-15;10906;3488;0;0;0;276021;115252;2;0;0
FR;2;2021-03-16;16761;4647;1;0;0;292782;119899;3;0;0
FR;2;2021-03-17;20226;3973;0;0;0;313008;123872;3;0;0
FR;2;2021-03-18;23365;4974;0;0;0;336373;128846;3;0;0
FR;2;2021-03-19;23303;4580;0;0;0;359676;133426;3;0;0
FR;2;2021-03-20;25443;1548;0;0;0;385119;134974;3;0;0
FR;2;2021-03-21;17669;150;0;0;0;402788;135124;3;0;0
FR;2;2021-03-22;17782;3143;0;0;0;420570;138267;3;0;0
FR;2;2021-03-23;22687;4200;0;0;0;443257;142467;3;0;0
FR;2;2021-03-24;23955;5019;0;0;0;467212;147486;3;0;0
FR;2;2021-03-25;26740;5140;1;0;0;493952;152626;4;0;0
FR;2;2021-03-26;26977;4238;0;0;0;520929;156864;4;0;0
FR;2;2021-03-27;15918;1330;0;0;0;536847;158194;4;0;0
FR;2;2021-03-28;10561;120;0;0;0;547408;158314;4;0;0
FR;2;2021-03-29;18987;4290;0;0;0;566395;162604;4;0;0
FR;2;2021-03-30;24576;6028;0;0;0;590971;168632;4;0;0
FR;2;2021-03-31;28553;5925;0;0;0;619524;174557;4;0;0
FR;2;2021-04-01;34544;8502;1;0;0;654068;183059;5;0;0
FR;2;2021-04-02;29976;7671;0;0;0;684044;190730;5;0;0
FR;2;2021-04-03;16953;3800;0;0;0;700997;194530;5;0;0
FR;2;2021-04-04;9305;1026;2;0;0;710302;195556;7;0;0
FR;2;2021-04-05;12444;805;0;0;0;722746;196361;7;0;0
FR;2;2021-04-06;27144;7041;0;0;0;749890;203402;7;0;0
FR;2;2021-04-07;30927;7145;1;0;0;780817;210547;8;0;0
FR;2;2021-04-08;36880;8740;1;0;0;817697;219287;9;0;0
FR;2;2021-04-09;33835;8533;28;0;0;851532;227820;37;0;0
FR;2;2021-04-10;19678;9036;1;0;0;871210;236856;38;0;0
FR;2;2021-04-11;7941;4254;1;0;0;879151;241110;39;0;0
FR;2;2021-04-12;17121;11132;0;0;0;896272;252242;39;0;0
FR;2;2021-04-13;19448;16189;1;0;0;915720;268431;40;0;0
FR;2;2021-04-14;18060;16310;7;0;0;933780;284741;47;0;0
FR;2;2021-04-15;22188;21015;27;0;0;955968;305756;74;0;0
FR;2;2021-04-16;20705;20166;45;0;0;976673;325922;119;0;0
FR;2;2021-04-17;13253;22433;5;0;0;989926;348355;124;0;0
FR;2;2021-04-18;5907;14393;6;0;0;995833;362748;130;0;0
FR;2;2021-04-19;16831;16276;24;0;0;1012664;379024;154;0;0
FR;2;2021-04-20;19319;21590;38;0;0;1031983;400614;192;0;0
FR;2;2021-04-21;20282;21712;76;0;0;1052265;422326;268;0;0
FR;2;2021-04-22;23810;24867;41;0;0;1076075;447193;309;0;0
FR;2;2021-04-23;24516;25355;76;0;0;1100591;472548;385;0;0
FR;2;2021-04-24;25301;15086;104;0;0;1125892;487634;489;0;0
FR;2;2021-04-25;9594;8601;5;0;0;1135486;496235;494;0;0
FR;2;2021-04-26;17157;17266;21;0;0;1152643;513501;515;0;0
FR;2;2021-04-27;19240;24222;40;0;0;1171883;537723;555;0;0
FR;2;2021-04-28;22333;26222;112;0;0;1194216;563945;667;0;0
FR;2;2021-04-29;25467;30154;69;0;0;1219683;594099;736;0;0
FR;2;2021-04-30;25528;27743;49;1;0;1245211;621842;785;1;0
FR;2;2021-05-01;14983;9873;6;0;0;1260194;631715;791;1;0
FR;2;2021-05-02;6635;9174;2;0;0;1266829;640889;793;1;0
FR;2;2021-05-03;20012;19237;40;0;0;1286841;660126;833;1;0
FR;2;2021-05-04;18280;29052;33;0;0;1305121;689178;866;1;0
FR;2;2021-05-05;18361;29390;48;0;0;1323482;718568;914;1;0
FR;2;2021-05-06;23540;35250;131;0;0;1347022;753818;1045;1;0
FR;2;2021-05-07;25324;33199;97;0;0;1372346;787017;1142;1;0
FR;2;2021-05-08;21337;9854;14;0;0;1393683;796871;1156;1;0
FR;2;2021-05-09;13162;7835;7;0;0;1406845;804706;1163;1;0
FR;2;2021-05-10;32937;22105;49;0;0;1439782;826811;1212;1;0
FR;2;2021-05-11;43595;21019;101;0;0;1483377;847830;1313;1;0
FR;2;2021-05-12;50041;19832;143;0;0;1533418;867662;1456;1;0
FR;2;2021-05-13;51289;5740;31;0;0;1584707;873402;1487;1;0
FR;2;2021-05-14;61344;12909;132;0;0;1646051;886311;1619;1;0
FR;2;2021-05-15;65925;7137;39;0;0;1711976;893448;1658;1;0
FR;2;2021-05-16;43581;2567;10;0;0;1755557;896015;1668;1;0
FR;2;2021-05-17;44742;12569;114;0;0;1800299;908584;1782;1;0
FR;2;2021-05-18;54634;12239;191;0;0;1854933;920823;1973;1;0
FR;2;2021-05-19;57164;10590;281;0;0;1912097;931413;2254;1;0
FR;2;2021-05-20;63432;10833;287;0;0;1975529;942246;2541;1;0
FR;2;2021-05-21;64289;11638;230;0;0;2039818;953884;2771;1;0
FR;2;2021-05-22;61479;4507;65;0;0;2101297;958391;2836;1;0
FR;2;2021-05-23;37531;571;22;0;0;2138828;958962;2858;1;0
FR;2;2021-05-24;17236;2037;34;0;0;2156064;960999;2892;1;0
FR;2;2021-05-25;21104;12221;240;0;0;2177168;973220;3132;1;0
FR;2;2021-05-26;19933;11459;229;0;0;2197101;984679;3361;1;0
FR;2;2021-05-27;22994;12662;182;0;0;2220095;997341;3543;1;0
FR;2;2021-05-28;29389;14952;190;0;0;2249484;1012293;3733;1;0
FR;2;2021-05-29;30418;8180;57;0;0;2279902;1020473;3790;1;0
FR;2;2021-05-30;4646;1817;6;0;0;2284548;1022290;3796;1;0
FR;2;2021-05-31;28586;18713;183;0;0;2313134;1041003;3979;1;0
FR;2;2021-06-01;45712;19999;224;0;0;2358846;1061002;4203;1;0
FR;2;2021-06-02;37465;19287;182;0;0;2396311;1080289;4385;1;0
FR;2;2021-06-03;51270;23312;161;0;0;2447581;1103601;4546;1;0
FR;2;2021-06-04;65509;24051;215;0;0;2513090;1127652;4761;1;0
FR;2;2021-06-05;34598;24036;51;0;0;2547688;1151688;4812;1;0
FR;2;2021-06-06;4953;6199;10;0;0;2552641;1157887;4822;1;0
FR;2;2021-06-07;28167;23041;146;0;0;2580808;1180928;4968;1;0
FR;2;2021-06-08;46369;22919;143;0;0;2627177;1203847;5111;1;0
FR;2;2021-06-09;34285;20908;107;0;0;2661462;1224755;5218;1;0
FR;2;2021-06-10;42635;19130;95;1;0;2704097;1243885;5313;2;0
FR;2;2021-06-11;55289;25221;134;0;0;2759386;1269106;5447;2;0
FR;2;2021-06-12;30559;19774;53;0;0;2789945;1288880;5500;2;0
FR;2;2021-06-13;3329;9186;13;0;0;2793274;1298066;5513;2;0
FR;2;2021-06-14;25295;24155;92;0;0;2818569;1322221;5605;2;0
FR;2;2021-06-15;39034;22843;154;0;0;2857603;1345064;5759;2;0
FR;2;2021-06-16;30159;21436;134;0;0;2887762;1366500;5893;2;0
FR;2;2021-06-17;36905;25854;150;0;0;2924667;1392354;6043;2;0
FR;2;2021-06-18;46845;28816;122;0;0;2971512;1421170;6165;2;0
FR;2;2021-06-19;24524;24893;39;0;0;2996036;1446063;6204;2;0
FR;2;2021-06-20;3740;10065;10;0;0;2999776;1456128;6214;2;0
FR;2;2021-06-21;17522;42840;87;0;0;3017298;1498968;6301;2;0
FR;2;2021-06-22;28357;49565;110;0;0;3045655;1548533;6411;2;0
FR;2;2021-06-23;21788;49562;107;1;1;3067443;1598095;6518;3;1
FR;2;2021-06-24;28375;50279;133;0;0;3095818;1648374;6651;3;1
FR;2;2021-06-25;33399;60399;127;0;0;3129217;1708773;6778;3;1
FR;2;2021-06-26;16378;59249;54;1;0;3145595;1768022;6832;4;1
FR;2;2021-06-27;2564;29321;22;1;0;3148159;1797343;6854;5;1
FR;2;2021-06-28;12637;54339;83;0;0;3160796;1851682;6937;5;1
FR;2;2021-06-29;19841;59887;178;0;0;3180637;1911569;7115;5;1
FR;2;2021-06-30;16322;57884;252;17;0;3196959;1969453;7367;22;1
FR;2;2021-07-01;20484;59891;227;0;0;3217443;2029344;7594;22;1
FR;2;2021-07-02;24071;62138;184;0;0;3241514;2091482;7778;22;1
FR;2;2021-07-03;12112;57081;153;0;0;3253626;2148563;7931;22;1
FR;2;2021-07-04;1957;23310;18;0;0;3255583;2171873;7949;22;1
FR;2;2021-07-05;9171;29368;106;0;0;3264754;2201241;8055;22;1
FR;2;2021-07-06;14575;36207;135;0;0;3279329;2237448;8190;22;1
FR;2;2021-07-07;14403;33671;139;0;0;3293732;2271119;8329;22;1
FR;2;2021-07-08;19714;40299;162;0;0;3313446;2311418;8491;22;1
FR;2;2021-07-09;27094;54281;202;1;0;3340540;2365699;8693;23;1
FR;2;2021-07-10;13384;33666;107;0;0;3353924;2399365;8800;23;1
FR;2;2021-07-11;1805;4352;16;0;0;3355729;2403717;8816;23;1
FR;2;2021-07-12;12963;37273;118;0;0;3368692;2440990;8934;23;1
FR;2;2021-07-13;37111;53217;150;0;0;3405803;2494207;9084;23;1
FR;2;2021-07-14;6609;3560;15;0;0;3412412;2497767;9099;23;1
FR;2;2021-07-15;47233;47025;156;0;0;3459645;2544792;9255;23;1
FR;2;2021-07-16;64306;55810;187;0;0;3523951;2600602;9442;23;1
FR;2;2021-07-17;31593;23931;96;0;0;3555544;2624533;9538;23;1
FR;2;2021-07-18;6086;4881;19;0;0;3561630;2629414;9557;23;1
FR;2;2021-07-19;32990;28681;94;0;0;3594620;2658095;9651;23;1
FR;2;2021-07-20;51989;44566;155;0;0;3646609;2702661;9806;23;1
FR;2;2021-07-21;45244;34754;93;0;0;3691853;2737415;9899;23;1
FR;2;2021-07-22;56272;41094;128;1;0;3748125;2778509;10027;24;1
FR;2;2021-07-23;68277;49076;170;0;0;3816402;2827585;10197;24;1
FR;2;2021-07-24;36168;21595;82;0;0;3852570;2849180;10279;24;1
FR;2;2021-07-25;6744;2650;10;0;0;3859314;2851830;10289;24;1
FR;2;2021-07-26;36298;22445;91;1;0;3895612;2874275;10380;25;1
FR;2;2021-07-27;62361;34617;180;0;0;3957973;2908892;10560;25;1
FR;2;2021-07-28;55300;26451;132;0;0;4013273;2935343;10692;25;1
FR;2;2021-07-29;68459;32793;189;0;0;4081732;2968136;10881;25;1
FR;2;2021-07-30;74435;37768;222;1;1;4156167;3005904;11103;26;2
FR;2;2021-07-31;34753;16193;104;0;0;4190920;3022097;11207;26;2
FR;2;2021-08-01;5398;2275;19;0;0;4196318;3024372;11226;26;2
FR;2;2021-08-02;35865;16200;101;0;0;4232183;3040572;11327;26;2
FR;2;2021-08-03;55966;28291;142;0;0;4288149;3068863;11469;26;2
FR;2;2021-08-04;46625;20861;128;1;0;4334774;3089724;11597;27;2
FR;2;2021-08-05;54621;31588;215;0;0;4389395;3121312;11812;27;2
FR;2;2021-08-06;58082;42388;242;1;0;4447477;3163700;12054;28;2
FR;2;2021-08-07;25139;17602;89;0;0;4472616;3181302;12143;28;2
FR;2;2021-08-08;3833;3667;21;0;0;4476449;3184969;12164;28;2
FR;2;2021-08-09;29304;21126;91;0;0;4505753;3206095;12255;28;2
FR;2;2021-08-10;44989;33514;154;0;0;4550742;3239609;12409;28;2
FR;2;2021-08-11;35265;25175;151;0;0;4586007;3264784;12560;28;2
FR;2;2021-08-12;41894;35734;162;0;0;4627901;3300518;12722;28;2
FR;2;2021-08-13;42588;37078;218;0;0;4670489;3337596;12940;28;2
FR;2;2021-08-14;18509;22248;93;0;0;4688998;3359844;13033;28;2
FR;2;2021-08-15;3822;3810;17;0;0;4692820;3363654;13050;28;2
FR;2;2021-08-16;25079;27200;110;0;0;4717899;3390854;13160;28;2
FR;2;2021-08-17;38251;43482;205;2;0;4756150;3434336;13365;30;2
FR;2;2021-08-18;32246;36366;195;1;1;4788396;3470702;13560;31;3
FR;2;2021-08-19;37429;46587;224;0;0;4825825;3517289;13784;31;3
FR;2;2021-08-20;40558;55608;269;1;0;4866383;3572897;14053;32;3
FR;2;2021-08-21;18117;24307;115;0;0;4884500;3597204;14168;32;3
FR;2;2021-08-22;2904;4320;22;1;1;4887404;3601524;14190;33;4
FR;2;2021-08-23;19240;35160;131;1;0;4906644;3636684;14321;34;4
FR;2;2021-08-24;31940;56034;235;0;0;4938584;3692718;14556;34;4
FR;2;2021-08-25;25926;43431;250;0;0;4964510;3736149;14806;34;4
FR;2;2021-08-26;32350;55793;387;0;0;4996860;3791942;15193;34;4
FR;2;2021-08-27;36994;65597;478;2;0;5033854;3857539;15671;36;4
FR;2;2021-08-28;17814;28490;300;0;0;5051668;3886029;15971;36;4
FR;2;2021-08-29;2654;5033;47;0;0;5054322;3891062;16018;36;4
FR;2;2021-08-30;18411;37743;399;0;754;5072733;3928805;16417;36;758
FR;2;2021-08-31;28076;57498;886;4;1547;5100809;3986303;17303;40;2305
FR;2;2021-09-01;21591;39844;1308;0;2094;5122400;4026147;18611;40;4399
FR;2;2021-09-02;25480;48615;1962;2;3298;5147880;4074762;20573;42;7697
FR;2;2021-09-03;33405;64486;2988;3;4831;5181285;4139248;23561;45;12528
FR;2;2021-09-04;16827;27703;1442;1;2358;5198112;4166951;25003;46;14886
FR;2;2021-09-05;2261;3608;265;0;412;5200373;4170559;25268;46;15298
FR;2;2021-09-06;14038;28730;1769;1;2929;5214411;4199289;27037;47;18227
FR;2;2021-09-07;21103;41064;3020;13;4862;5235514;4240353;30057;60;23089
FR;2;2021-09-08;17241;31934;2732;6;4469;5252755;4272287;32789;66;27558
FR;2;2021-09-09;20974;40427;4432;3;6753;5273729;4312714;37221;69;34311
FR;2;2021-09-10;28197;51164;5282;4;8831;5301926;4363878;42503;73;43142
FR;2;2021-09-11;13653;22358;2403;5;3940;5315579;4386236;44906;78;47082
FR;2;2021-09-12;1822;2787;284;0;505;5317401;4389023;45190;78;47587
FR;2;2021-09-13;11656;21442;2470;4;4012;5329057;4410465;47660;82;51599
FR;2;2021-09-14;18567;32775;5084;13;9047;5347624;4443240;52744;95;60646
FR;2;2021-09-15;14910;28281;5164;3;7777;5362534;4471521;57908;98;68423
FR;2;2021-09-16;16074;32767;6735;14;10529;5378608;4504288;64643;112;78952
FR;2;2021-09-17;20911;47097;8777;10;14581;5399519;4551385;73420;122;93533
FR;2;2021-09-18;9854;20922;3804;6;6020;5409373;4572307;77224;128;99553
FR;2;2021-09-19;1164;2647;395;0;643;5410537;4574954;77619;128;100196
FR;2;2021-09-20;7492;18778;3851;7;6153;5418029;4593732;81470;135;106349
FR;2;2021-09-21;11207;30003;6494;5;10739;5429236;4623735;87964;140;117088
FR;2;2021-09-22;9406;23540;5491;7;8514;5438642;4647275;93455;147;125602
FR;2;2021-09-23;10723;28875;7879;9;12635;5449365;4676150;101334;156;138237
FR;2;2021-09-24;15066;42870;10874;18;17198;5464431;4719020;112208;174;155435
FR;2;2021-09-25;7256;18746;3963;10;6085;5471687;4737766;116171;184;161520
FR;2;2021-09-26;1079;2556;494;0;631;5472766;4740322;116665;184;162151
FR;2;2021-09-27;6313;16453;4286;8;6551;5479079;4756775;120951;192;168702
FR;2;2021-09-28;9238;25550;7768;13;12074;5488317;4782325;128719;205;180776
FR;2;2021-09-29;8080;20204;6066;25;9263;5496397;4802529;134785;230;190039
FR;2;2021-09-30;9862;25795;9503;16;14080;5506259;4828324;144288;246;204119
FR;2;2021-10-01;13968;35641;12913;25;19235;5520227;4863965;157201;271;223354
FR;2;2021-10-02;6873;15879;4845;6;7009;5527100;4879844;162046;277;230363
FR;2;2021-10-03;841;1932;492;1;511;5527941;4881776;162538;278;230874
FR;2;2021-10-04;5819;13931;5516;5;7861;5533760;4895707;168054;283;238735
FR;2;2021-10-05;9052;22545;11121;19;15716;5542812;4918252;179175;302;254451
FR;2;2021-10-06;7781;17738;8239;11;11070;5550593;4935990;187414;313;265521
FR;2;2021-10-07;9195;22181;12378;15;16836;5559788;4958171;199792;328;282357
FR;2;2021-10-08;13423;32058;17346;27;23538;5573211;4990229;217138;355;305895
FR;2;2021-10-09;5996;12829;6041;6;7881;5579207;5003058;223179;361;313776
FR;2;2021-10-10;883;1632;436;2;630;5580090;5004690;223615;363;314406
FR;2;2021-10-11;5605;11594;6454;17;8832;5585695;5016284;230069;380;323238
FR;2;2021-10-12;8033;17753;12538;13;16730;5593728;5034037;242607;393;339968
FR;2;2021-10-13;6944;14848;10245;11;13607;5600672;5048885;252852;404;353575
FR;2;2021-10-14;8309;17939;14990;13;19447;5608981;5066824;267842;417;373022
FR;2;2021-10-15;11846;26281;20902;26;27945;5620827;5093105;288744;443;400967
FR;2;2021-10-16;5137;8726;1816;0;3205;5625964;5101831;290560;443;404172
FR;2;2021-10-17;651;1185;184;0;373;5626615;5103016;290744;443;404545
FR;2;2021-10-18;4559;7420;661;2;1673;5631174;5110436;291405;445;406218
FR;2;2021-10-19;6235;9888;729;5;2049;5637409;5120324;292134;450;408267
FR;2;2021-10-20;5163;8093;756;3;1685;5642572;5128417;292890;453;409952
FR;2;2021-10-21;6089;9969;779;5;2101;5648661;5138386;293669;458;412053
FR;2;2021-10-22;8447;14582;1147;4;2879;5657108;5152968;294816;462;414932
FR;2;2021-10-23;3840;6000;584;0;1234;5660948;5158968;295400;462;416166
FR;2;2021-10-24;494;888;100;0;203;5661442;5159856;295500;462;416369
FR;2;2021-10-25;3357;5367;303;1;825;5664799;5165223;295803;463;417194
FR;2;2021-10-26;4175;7257;1125;4;2004;5668974;5172480;296928;467;419198
FR;2;2021-10-27;3673;6630;1193;5;1998;5672647;5179110;298121;472;421196
FR;2;2021-10-28;4596;7695;1728;3;2747;5677243;5186805;299849;475;423943
FR;2;2021-10-29;5408;11075;2433;4;3669;5682651;5197880;302282;479;427612
FR;2;2021-10-30;2748;4438;973;1;1428;5685399;5202318;303255;480;429040
FR;2;2021-10-31;363;533;139;1;187;5685762;5202851;303394;481;429227
FR;2;2021-11-01;423;552;175;0;267;5686185;5203403;303569;481;429494
FR;2;2021-11-02;3287;6757;1179;0;1757;5689472;5210160;304748;481;431251
FR;2;2021-11-03;3338;6249;1383;2;1966;5692810;5216409;306131;483;433217
FR;2;2021-11-04;3985;7098;1762;4;2492;5696795;5223507;307893;487;435709
FR;2;2021-11-05;5227;10508;2864;5;3943;5702022;5234015;310757;492;439652
FR;2;2021-11-06;2594;4668;1397;0;1809;5704616;5238683;312154;492;441461
FR;2;2021-11-07;507;865;218;0;287;5705123;5239548;312372;492;441748
FR;2;2021-11-08;2578;5362;1201;3;1676;5707701;5244910;313573;495;443424
FR;2;2021-11-09;2750;6948;2395;6;3175;5710451;5251858;315968;501;446599
FR;2;2021-11-10;2587;5712;5094;6;6274;5713038;5257570;321062;507;452873
FR;2;2021-11-11;436;747;732;2;914;5713474;5258317;321794;509;453787
FR;2;2021-11-12;2951;8114;8965;8;10903;5716425;5266431;330759;517;464690
FR;2;2021-11-13;1534;3380;3865;7;4528;5717959;5269811;334624;524;469218
FR;2;2021-11-14;254;604;349;1;486;5718213;5270415;334973;525;469704
FR;2;2021-11-15;1622;3688;4435;9;5320;5719835;5274103;339408;534;475024
FR;2;2021-11-16;2184;5947;8297;14;10076;5722019;5280050;347705;548;485100
FR;2;2021-11-17;1739;4554;6619;8;7831;5723758;5284604;354324;556;492931
FR;2;2021-11-18;2189;5949;9170;11;10995;5725947;5290553;363494;567;503926
FR;2;2021-11-19;2697;7803;12959;19;15467;5728644;5298356;376453;586;519393
FR;2;2021-11-20;1563;3339;5171;5;6078;5730207;5301695;381624;591;525471
FR;2;2021-11-21;246;520;540;0;663;5730453;5302215;382164;591;526134
FR;2;2021-11-22;1275;2624;4469;5;5400;5731728;5304839;386633;596;531534
FR;2;2021-11-23;1614;4307;8188;9;9894;5733342;5309146;394821;605;541428
FR;2;2021-11-24;1418;3792;7463;14;8722;5734760;5312938;402284;619;550150
FR;2;2021-11-25;1812;4895;11450;21;13650;5736572;5317833;413734;640;563800
FR;2;2021-11-26;2538;7780;22656;31;26068;5739110;5325613;436390;671;589868
FR;2;2021-11-27;1497;4137;12256;18;13996;5740607;5329750;448646;689;603864
FR;2;2021-11-28;291;841;1967;3;2291;5740898;5330591;450613;692;606155
FR;2;2021-11-29;1444;4381;15073;23;17243;5742342;5334972;465686;715;623398
FR;2;2021-11-30;1910;6753;26221;36;29979;5744252;5341725;491907;751;653377
FR;2;2021-12-01;1906;6090;26185;29;29506;5746158;5347815;518092;780;682883
FR;2;2021-12-02;1908;6824;37684;52;41927;5748066;5354639;555776;832;724810
FR;2;2021-12-03;2550;10109;53587;112;59312;5750616;5364748;609363;944;784122
FR;2;2021-12-04;1849;6302;37091;38;40768;5752465;5371050;646454;982;824890
FR;2;2021-12-05;458;2262;14252;14;15989;5752923;5373312;660706;996;840879
FR;2;2021-12-06;2466;9895;77681;109;84728;5755389;5383207;738387;1105;925607
FR;2;2021-12-07;3446;15333;122411;238;133699;5758835;5398540;860798;1343;1059306
FR;2;2021-12-08;3718;16061;133171;330;145375;5762553;5414601;993969;1673;1204681
FR;2;2021-12-09;4544;19634;170149;554;185508;5767097;5434235;1164118;2227;1390189
FR;2;2021-12-10;4672;22809;188609;490;206042;5771769;5457044;1352727;2717;1596231
FR;2;2021-12-11;3682;16623;132423;239;144855;5775451;5473667;1485150;2956;1741086
FR;2;2021-12-12;1257;7128;59082;83;65130;5776708;5480795;1544232;3039;1806216
FR;2;2021-12-13;5525;26871;220656;604;242945;5782233;5507666;1764888;3643;2049161
FR;2;2021-12-14;7018;37522;300717;910;332182;5789251;5545188;2065605;4553;2381343
FR;2;2021-12-15;6557;36235;285173;955;315767;5795808;5581423;2350778;5508;2697110
FR;2;2021-12-16;7761;37930;312104;981;343692;5803569;5619353;2662882;6489;3040802
FR;2;2021-12-17;8682;41247;327831;976;360909;5812251;5660600;2990713;7465;3401711
FR;2;2021-12-18;6515;26561;212319;448;233618;5818766;5687161;3203032;7913;3635329
FR;2;2021-12-19;2600;11486;90202;183;100375;5821366;5698647;3293234;8096;3735704
FR;2;2021-12-20;9547;33611;275159;706;303336;5830913;5732258;3568393;8802;4039040
FR;2;2021-12-21;11556;38326;309593;969;341380;5842469;5770584;3877986;9771;4380420
FR;2;2021-12-22;10458;32850;265083;952;292465;5852927;5803434;4143069;10723;4672885
FR;2;2021-12-23;9429;26712;199462;700;221264;5862356;5830146;4342531;11423;4894149
FR;2;2021-12-24;2781;7502;43845;140;49561;5865137;5837648;4386376;11563;4943710
FR;2;2021-12-25;201;699;2000;10;2494;5865338;5838347;4388376;11573;4946204
FR;2;2021-12-26;1322;4211;25148;71;28675;5866660;5842558;4413524;11644;4974879
FR;2;2021-12-27;8076;29939;218381;659;243304;5874736;5872497;4631905;12303;5218183
FR;2;2021-12-28;9840;36340;272065;741;301951;5884576;5908837;4903970;13044;5520134
FR;2;2021-12-29;9495;32288;246109;766;272680;5894071;5941125;5150079;13810;5792814
FR;2;2021-12-30;9454;28139;208811;662;231464;5903525;5969264;5358890;14472;6024278
FR;2;2021-12-31;3007;8369;54980;177;61232;5906532;5977633;5413870;14649;6085510
FR;2;2022-01-01;227;690;2849;7;3344;5906759;5978323;5416719;14656;6088854
FR;2;2022-01-02;1504;4860;29507;75;33396;5908263;5983183;5446226;14731;6122250
FR;2;2022-01-03;9585;35373;266503;806;293861;5917848;6018556;5712729;15537;6416111
FR;2;2022-01-04;12844;45377;342068;1067;376954;5930692;6063933;6054797;16604;6793065
FR;2;2022-01-05;11268;38669;294153;886;323809;5941960;6102602;6348950;17490;7116874
FR;2;2022-01-06;13647;43498;331929;1299;364707;5955607;6146100;6680879;18789;7481581
FR;2;2022-01-07;14219;47640;361080;1270;396410;5969826;6193740;7041959;20059;7877991
FR;2;2022-01-08;7947;28148;201257;515;221687;5977773;6221888;7243216;20574;8099678
FR;2;2022-01-09;2749;8995;62519;137;69523;5980522;6230883;7305735;20711;8169201
FR;2;2022-01-10;10088;31927;232450;858;255040;5990610;6262810;7538185;21569;8424241
FR;2;2022-01-11;11470;36255;265883;1030;290574;6002080;6299065;7804068;22599;8714815
FR;2;2022-01-12;8757;29819;206302;862;226162;6010837;6328884;8010370;23461;8940977
FR;2;2022-01-13;9387;31352;224465;831;244815;6020224;6360236;8234835;24292;9185792
FR;2;2022-01-14;9743;35655;254517;920;277675;6029967;6395891;8489352;25212;9463467
FR;2;2022-01-15;5356;19462;140769;363;153637;6035323;6415353;8630121;25575;9617104
FR;2;2022-01-16;1512;5520;35871;80;39847;6036835;6420873;8665992;25655;9656951
FR;2;2022-01-17;5545;19296;135386;601;147246;6042380;6440169;8801378;26256;9804197
FR;2;2022-01-18;6418;21524;148610;648;160468;6048798;6461693;8949988;26904;9964665
FR;2;2022-01-19;4389;16363;105082;552;113703;6053187;6478056;9055070;27456;10078368
FR;2;2022-01-20;4867;17597;115278;603;123674;6058054;6495653;9170348;28059;10202042
FR;2;2022-01-21;5195;20062;137323;678;147741;6063249;6515715;9307671;28737;10349783
FR;2;2022-01-22;3027;10962;74256;259;80325;6066276;6526677;9381927;28996;10430108
FR;2;2022-01-23;723;2733;15237;41;16836;6066999;6529410;9397164;29037;10446944
FR;2;2022-01-24;3293;12822;75058;430;81019;6070292;6542232;9472222;29467;10527963
FR;2;2022-01-25;3571;14442;79612;496;85449;6073863;6556674;9551834;29963;10613412
FR;2;2022-01-26;2515;10666;58961;363;62989;6076378;6567340;9610795;30326;10676401
FR;2;2022-01-27;2681;11291;64170;388;67909;6079059;6578631;9674965;30714;10744310
FR;2;2022-01-28;3543;18375;91711;430;98962;6082602;6597006;9766676;31144;10843272
FR;2;2022-01-29;1894;9249;48840;164;52924;6084496;6606255;9815516;31308;10896196
FR;2;2022-01-30;464;2240;9452;38;10605;6084960;6608495;9824968;31346;10906801
FR;2;2022-01-31;1887;9585;43818;208;47339;6086847;6618080;9868786;31554;10954140
FR;2;2022-02-01;1911;10048;47020;279;50101;6088758;6628128;9915806;31833;11004241
FR;2;2022-02-02;1607;9030;41102;251;44173;6090365;6637158;9956908;32084;11048414
FR;2;2022-02-03;1723;8943;40510;204;42910;6092088;6646101;9997418;32288;11091324
FR;2;2022-02-04;2152;15211;66627;297;71345;6094240;6661312;10064045;32585;11162669
FR;2;2022-02-05;1360;8537;35940;131;39235;6095600;6669849;10099985;32716;11201904
FR;2;2022-02-06;274;1776;6124;16;6898;6095874;6671625;10106109;32732;11208802
FR;2;2022-02-07;1350;9602;37747;134;41305;6097224;6681227;10143856;32866;11250107
FR;2;2022-02-08;1299;9814;40928;173;43713;6098523;6691041;10184784;33039;11293820
FR;2;2022-02-09;1160;8819;37033;174;40452;6099683;6699860;10221817;33213;11334272
FR;2;2022-02-10;1024;7985;33832;204;36500;6100707;6707845;10255649;33417;11370772
FR;2;2022-02-11;1388;12078;53338;222;57684;6102095;6719923;10308987;33639;11428456
FR;2;2022-02-12;749;6532;27986;83;30805;6102844;6726455;10336973;33722;11459261
FR;2;2022-02-13;200;1336;4833;20;5574;6103044;6727791;10341806;33742;11464835
FR;2;2022-02-14;835;6727;30264;89;33227;6103879;6734518;10372070;33831;11498062
FR;2;2022-02-15;772;6450;28044;141;29982;6104651;6740968;10400114;33972;11528044
FR;2;2022-02-16;655;5352;22052;123;23616;6105306;6746320;10422166;34095;11551660
FR;2;2022-02-17;515;3775;14144;98;14609;6105821;6750095;10436310;34193;11566269
FR;2;2022-02-18;721;5362;20429;134;21125;6106542;6755457;10456739;34327;11587394
FR;2;2022-02-19;430;3048;10527;66;11241;6106972;6758505;10467266;34393;11598635
FR;2;2022-02-20;101;512;1456;3;1604;6107073;6759017;10468722;34396;11600239
FR;2;2022-02-21;421;2682;9117;65;9493;6107494;6761699;10477839;34461;11609732
FR;2;2022-02-22;389;2565;8888;76;8792;6107883;6764264;10486727;34537;11618524
FR;2;2022-02-23;432;2600;8987;82;9265;6108315;6766864;10495714;34619;11627789
FR;2;2022-02-24;314;2029;6798;81;6826;6108629;6768893;10502512;34700;11634615
FR;2;2022-02-25;455;3194;11414;108;11277;6109084;6772087;10513926;34808;11645892
FR;2;2022-02-26;294;1891;6035;49;6340;6109378;6773978;10519961;34857;11652232
FR;2;2022-02-27;75;312;905;5;948;6109453;6774290;10520866;34862;11653180
FR;2;2022-02-28;330;1682;5523;53;5531;6109783;6775972;10526389;34915;11658711
FR;2;2022-03-01;275;1559;5475;44;5191;6110058;6777531;10531864;34959;11663902
FR;2;2022-03-02;296;1431;5243;45;5084;6110354;6778962;10537107;35004;11668986
FR;2;2022-03-03;225;1102;3704;42;3479;6110579;6780064;10540811;35046;11672465
FR;2;2022-03-04;241;1463;4853;73;4498;6110820;6781527;10545664;35119;11676963
FR;2;2022-03-05;172;903;2973;32;2716;6110992;6782430;10548637;35151;11679679
FR;2;2022-03-06;40;182;278;5;318;6111032;6782612;10548915;35156;11679997
FR;2;2022-03-07;155;654;1982;69;1773;6111187;6783266;10550897;35225;11681770
FR;2;2022-03-08;143;653;2270;51;1902;6111330;6783919;10553167;35276;11683672
FR;2;2022-03-09;152;696;2341;37;2042;6111482;6784615;10555508;35313;11685714
FR;2;2022-03-10;120;598;1688;35;1461;6111602;6785213;10557196;35348;11687175
FR;2;2022-03-11;169;754;2767;57;2366;6111771;6785967;10559963;35405;11689541
FR;2;2022-03-12;144;482;1784;27;1553;6111915;6786449;10561747;35432;11691094
FR;2;2022-03-13;25;75;201;29;202;6111940;6786524;10561948;35461;11691296
FR;2;2022-03-14;125;465;1561;529;1290;6112065;6786989;10563509;35990;11692586
FR;2;2022-03-15;138;417;1706;688;1322;6112203;6787406;10565215;36678;11693908
FR;2;2022-03-16;141;465;2011;1611;1589;6112344;6787871;10567226;38289;11695497
FR;2;2022-03-17;93;412;1405;1193;1142;6112437;6788283;10568631;39482;11696639
FR;2;2022-03-18;144;490;2018;1787;1660;6112581;6788773;10570649;41269;11698299
FR;2;2022-03-19;108;319;1209;940;1014;6112689;6789092;10571858;42209;11699313
FR;2;2022-03-20;12;76;190;59;166;6112701;6789168;10572048;42268;11699479
FR;2;2022-03-21;96;301;1210;1481;1074;6112797;6789469;10573258;43749;11700553
FR;2;2022-03-22;117;383;1528;1828;1290;6112914;6789852;10574786;45577;11701843
FR;2;2022-03-23;139;350;1667;3032;1458;6113053;6790202;10576453;48609;11703301
FR;2;2022-03-24;116;290;1181;1546;997;6113169;6790492;10577634;50155;11704298
FR;2;2022-03-25;119;360;1803;2449;1473;6113288;6790852;10579437;52604;11705771
FR;2;2022-03-26;76;246;1202;1220;952;6113364;6791098;10580639;53824;11706723
FR;2;2022-03-27;19;36;152;100;131;6113383;6791134;10580791;53924;11706854
FR;2;2022-03-28;94;287;1133;1588;993;6113477;6791421;10581924;55512;11707847
FR;2;2022-03-29;106;257;1324;2462;1104;6113583;6791678;10583248;57974;11708951
FR;2;2022-03-30;91;312;1483;3183;1316;6113674;6791990;10584731;61157;11710267
FR;2;2022-03-31;103;281;1269;2327;1083;6113777;6792271;10586000;63484;11711350
FR;2;2022-04-01;120;316;1563;2341;1315;6113897;6792587;10587563;65825;11712665
FR;2;2022-04-02;72;160;845;889;737;6113969;6792747;10588408;66714;11713402
FR;2;2022-04-03;16;53;128;112;142;6113985;6792800;10588536;66826;11713544
FR;2;2022-04-04;108;227;985;1434;792;6114093;6793027;10589521;68260;11714336
FR;2;2022-04-05;142;286;1309;2871;1137;6114235;6793313;10590830;71131;11715473
FR;2;2022-04-06;88;246;1303;2500;1115;6114323;6793559;10592133;73631;11716588
FR;2;2022-04-07;119;214;1295;2681;1034;6114442;6793773;10593428;76312;11717622
FR;2;2022-04-08;123;328;1622;3207;1319;6114565;6794101;10595050;79519;11718941
FR;2;2022-04-09;90;218;899;1045;731;6114655;6794319;10595949;80564;11719672
FR;2;2022-04-10;37;46;143;161;118;6114692;6794365;10596092;80725;11719790
FR;2;2022-04-11;85;184;880;1518;771;6114777;6794549;10596972;82243;11720561
FR;2;2022-04-12;176;260;1176;2730;1054;6114953;6794809;10598148;84973;11721615
FR;2;2022-04-13;141;224;1114;2420;973;6115094;6795033;10599262;87393;11722588
FR;2;2022-04-14;114;217;1082;2665;910;6115208;6795250;10600344;90058;11723498
FR;2;2022-04-15;111;244;1190;2254;1046;6115319;6795494;10601534;92312;11724544
FR;2;2022-04-16;64;108;540;545;452;6115383;6795602;10602074;92857;11724996
FR;2;2022-04-17;15;26;57;53;53;6115398;6795628;10602131;92910;11725049
FR;2;2022-04-18;11;35;118;65;113;6115409;6795663;10602249;92975;11725162
FR;2;2022-04-19;108;235;1114;1703;945;6115517;6795898;10603363;94678;11726107
FR;2;2022-04-20;95;237;1091;2102;919;6115612;6796135;10604454;96780;11727026
FR;2;2022-04-21;110;229;972;1827;829;6115722;6796364;10605426;98607;11727855
FR;2;2022-04-22;96;268;1240;2080;1021;6115818;6796632;10606666;100687;11728876
FR;2;2022-04-23;66;154;644;762;573;6115884;6796786;10607310;101449;11729449
FR;2;2022-04-24;12;28;100;68;78;6115896;6796814;10607410;101517;11729527
FR;2;2022-04-25;103;201;819;1312;708;6115999;6797015;10608229;102829;11730235
FR;2;2022-04-26;109;183;1034;1937;872;6116108;6797198;10609263;104766;11731107
FR;2;2022-04-27;95;177;855;1682;758;6116203;6797375;10610118;106448;11731865
FR;2;2022-04-28;90;212;945;1891;840;6116293;6797587;10611063;108339;11732705
FR;2;2022-04-29;76;279;1124;1687;1034;6116369;6797866;10612187;110026;11733739
FR;2;2022-04-30;65;125;468;535;427;6116434;6797991;10612655;110561;11734166
FR;2;2022-05-01;17;23;80;46;81;6116451;6798014;10612735;110607;11734247
FR;2;2022-05-02;112;211;750;1204;648;6116563;6798225;10613485;111811;11734895
FR;2;2022-05-03;147;223;984;1728;922;6116710;6798448;10614469;113539;11735817
FR;2;2022-05-04;87;218;909;1788;851;6116797;6798666;10615378;115327;11736668
FR;2;2022-05-05;123;191;835;1673;749;6116920;6798857;10616213;117000;11737417
FR;2;2022-05-06;130;234;1087;1845;999;6117050;6799091;10617300;118845;11738416
FR;2;2022-05-07;40;96;463;504;400;6117090;6799187;10617763;119349;11738816
FR;2;2022-05-08;45;52;105;70;99;6117135;6799239;10617868;119419;11738915
FR;2;2022-05-09;100;171;643;981;596;6117235;6799410;10618511;120400;11739511
FR;2;2022-05-10;112;233;923;1765;874;6117347;6799643;10619434;122165;11740385
FR;2;2022-05-11;96;162;801;1831;780;6117443;6799805;10620235;123996;11741165
FR;2;2022-05-12;108;166;827;2072;788;6117551;6799971;10621062;126068;11741953
FR;2;2022-05-13;94;226;952;2081;884;6117645;6800197;10622014;128149;11742837
FR;2;2022-05-14;75;116;438;551;396;6117720;6800313;10622452;128700;11743233
FR;2;2022-05-15;24;34;91;86;102;6117744;6800347;10622543;128786;11743335
FR;2;2022-05-16;102;167;579;921;518;6117846;6800514;10623122;129707;11743853
FR;2;2022-05-17;95;181;678;1665;649;6117941;6800695;10623800;131372;11744502
FR;2;2022-05-18;80;178;621;1404;628;6118021;6800873;10624421;132776;11745130
FR;2;2022-05-19;68;157;692;1755;725;6118089;6801030;10625113;134531;11745855
FR;2;2022-05-20;98;174;845;1632;751;6118187;6801204;10625958;136163;11746606
FR;2;2022-05-21;44;94;389;509;331;6118231;6801298;10626347;136672;11746937
FR;2;2022-05-22;8;21;66;37;56;6118239;6801319;10626413;136709;11746993
FR;2;2022-05-23;80;125;454;900;442;6118319;6801444;10626867;137609;11747435
FR;2;2022-05-24;82;158;607;1521;588;6118401;6801602;10627474;139130;11748023
FR;2;2022-05-25;67;135;522;1134;474;6118468;6801737;10627996;140264;11748497
FR;2;2022-05-26;7;23;59;41;63;6118475;6801760;10628055;140305;11748560
FR;2;2022-05-27;43;111;424;791;404;6118518;6801871;10628479;141096;11748964
FR;2;2022-05-28;26;60;209;236;214;6118544;6801931;10628688;141332;11749178
FR;2;2022-05-29;10;31;43;20;51;6118554;6801962;10628731;141352;11749229
FR;2;2022-05-30;65;98;380;684;357;6118619;6802060;10629111;142036;11749586
FR;2;2022-05-31;71;128;534;1214;483;6118690;6802188;10629645;143250;11750069
FR;2;2022-06-01;53;133;431;1015;418;6118743;6802321;10630076;144265;11750487
FR;2;2022-06-02;82;151;495;1327;472;6118825;6802472;10630571;145592;11750959
FR;2;2022-06-03;60;142;539;1514;496;6118885;6802614;10631110;147106;11751455
FR;2;2022-06-04;52;85;247;429;229;6118937;6802699;10631357;147535;11751684
FR;2;2022-06-05;10;15;57;57;43;6118947;6802714;10631414;147592;11751727
FR;2;2022-06-06;10;10;39;72;41;6118957;6802724;10631453;147664;11751768
FR;2;2022-06-07;92;191;575;1327;473;6119049;6802915;10632028;148991;11752241
FR;3;2020-12-27;0;0;0;0;0;0;0;0;0;0
FR;3;2020-12-28;0;0;0;0;0;0;0;0;0;0
FR;3;2020-12-29;0;0;0;0;0;0;0;0;0;0
FR;3;2020-12-30;0;0;0;0;0;0;0;0;0;0
FR;3;2020-12-31;0;0;0;0;0;0;0;0;0;0
FR;3;2021-01-01;0;0;0;0;0;0;0;0;0;0
FR;3;2021-01-02;0;0;0;0;0;0;0;0;0;0
FR;3;2021-01-03;0;0;0;0;0;0;0;0;0;0
FR;3;2021-01-04;0;0;0;0;0;0;0;0;0;0
FR;3;2021-01-05;0;0;0;0;0;0;0;0;0;0
FR;3;2021-01-06;0;0;0;0;0;0;0;0;0;0
FR;3;2021-01-07;0;0;0;0;0;0;0;0;0;0
FR;3;2021-01-08;0;0;0;0;0;0;0;0;0;0
FR;3;2021-01-09;0;0;0;0;0;0;0;0;0;0
FR;3;2021-01-10;0;0;0;0;0;0;0;0;0;0
FR;3;2021-01-11;0;0;0;0;0;0;0;0;0;0
FR;3;2021-01-12;0;0;0;0;0;0;0;0;0;0
FR;3;2021-01-13;0;0;0;0;0;0;0;0;0;0
FR;3;2021-01-14;0;0;0;0;0;0;0;0;0;0
FR;3;2021-01-15;0;0;0;0;0;0;0;0;0;0
FR;3;2021-01-16;0;0;0;0;0;0;0;0;0;0
FR;3;2021-01-17;0;0;0;0;0;0;0;0;0;0
FR;3;2021-01-18;0;0;0;0;0;0;0;0;0;0
FR;3;2021-01-19;0;0;0;0;0;0;0;0;0;0
FR;3;2021-01-20;0;0;0;0;0;0;0;0;0;0
FR;3;2021-01-21;0;0;0;0;0;0;0;0;0;0
FR;3;2021-01-22;0;0;0;0;0;0;0;0;0;0
FR;3;2021-01-23;0;0;0;0;0;0;0;0;0;0
FR;3;2021-01-24;0;0;0;0;0;0;0;0;0;0
FR;3;2021-01-25;0;0;0;0;0;0;0;0;0;0
FR;3;2021-01-26;0;0;0;0;0;0;0;0;0;0
FR;3;2021-01-27;0;0;0;0;0;0;0;0;0;0
FR;3;2021-01-28;0;0;0;0;0;0;0;0;0;0
FR;3;2021-01-29;0;0;0;0;0;0;0;0;0;0
FR;3;2021-01-30;0;0;0;0;0;0;0;0;0;0
FR;3;2021-01-31;0;0;0;0;0;0;0;0;0;0
FR;3;2021-02-01;0;0;0;0;0;0;0;0;0;0
FR;3;2021-02-02;0;0;0;0;0;0;0;0;0;0
FR;3;2021-02-03;0;0;0;0;0;0;0;0;0;0
FR;3;2021-02-04;0;0;0;0;0;0;0;0;0;0
FR;3;2021-02-05;0;0;0;0;0;0;0;0;0;0
FR;3;2021-02-06;1657;0;0;0;0;1657;0;0;0;0
FR;3;2021-02-07;1423;0;0;0;0;3080;0;0;0;0
FR;3;2021-02-08;2784;1;0;0;0;5864;1;0;0;0
FR;3;2021-02-09;6782;0;0;0;0;12646;1;0;0;0
FR;3;2021-02-10;9604;0;0;0;0;22250;1;0;0;0
FR;3;2021-02-11;13611;0;0;0;0;35861;1;0;0;0
FR;3;2021-02-12;13399;0;0;0;0;49260;1;0;0;0
FR;3;2021-02-13;3784;1;0;0;0;53044;2;0;0;0
FR;3;2021-02-14;972;0;0;0;0;54016;2;0;0;0
FR;3;2021-02-15;10487;0;0;0;0;64503;2;0;0;0
FR;3;2021-02-16;12544;1;0;0;0;77047;3;0;0;0
FR;3;2021-02-17;11151;0;0;0;0;88198;3;0;0;0
FR;3;2021-02-18;14935;2;0;0;0;103133;5;0;0;0
FR;3;2021-02-19;14359;1;0;0;0;117492;6;0;0;0
FR;3;2021-02-20;3329;0;0;0;0;120821;6;0;0;0
FR;3;2021-02-21;618;0;0;0;0;121439;6;0;0;0
FR;3;2021-02-22;9163;0;0;0;0;130602;6;0;0;0
FR;3;2021-02-23;11395;1;0;0;0;141997;7;0;0;0
FR;3;2021-02-24;14299;1;0;0;0;156296;8;0;0;0
FR;3;2021-02-25;44929;1;0;0;0;201225;9;0;0;0
FR;3;2021-02-26;61882;3;0;0;0;263107;12;0;0;0
FR;3;2021-02-27;34801;5;0;0;0;297908;17;0;0;0
FR;3;2021-02-28;2463;0;0;0;0;300371;17;0;0;0
FR;3;2021-03-01;20513;10;0;0;0;320884;27;0;0;0
FR;3;2021-03-02;38862;18;0;0;0;359746;45;0;0;0
FR;3;2021-03-03;48732;15;0;0;0;408478;60;0;0;0
FR;3;2021-03-04;82218;20;0;0;0;490696;80;0;0;0
FR;3;2021-03-05;118123;40;0;0;0;608819;120;0;0;0
FR;3;2021-03-06;120712;56;1;0;0;729531;176;1;0;0
FR;3;2021-03-07;55175;27;0;0;0;784706;203;1;0;0
FR;3;2021-03-08;42809;25;0;0;0;827515;228;1;0;0
FR;3;2021-03-09;78967;43;0;0;0;906482;271;1;0;0
FR;3;2021-03-10;80968;47;0;0;0;987450;318;1;0;0
FR;3;2021-03-11;128425;56;0;0;0;1115875;374;1;0;0
FR;3;2021-03-12;182720;91;0;0;0;1298595;465;1;0;0
FR;3;2021-03-13;132145;63;0;0;0;1430740;528;1;0;0
FR;3;2021-03-14;14054;4;0;0;0;1444794;532;1;0;0
FR;3;2021-03-15;52225;48;0;0;0;1497019;580;1;0;0
FR;3;2021-03-16;1209;25;0;0;0;1498228;605;1;0;0
FR;3;2021-03-17;942;30;0;0;0;1499170;635;1;0;0
FR;3;2021-03-18;1565;13;0;0;0;1500735;648;1;0;0
FR;3;2021-03-19;70450;48;0;0;0;1571185;696;1;0;0
FR;3;2021-03-20;65226;45;0;0;0;1636411;741;1;0;0
FR;3;2021-03-21;5756;6;0;0;0;1642167;747;1;0;0
FR;3;2021-03-22;37496;39;0;0;0;1679663;786;1;0;0
FR;3;2021-03-23;84651;61;0;0;0;1764314;847;1;0;0
FR;3;2021-03-24;90935;93;0;0;0;1855249;940;1;0;0
FR;3;2021-03-25;150046;128;0;0;0;2005295;1068;1;0;0
FR;3;2021-03-26;165414;152;0;0;0;2170709;1220;1;0;0
FR;3;2021-03-27;68456;102;0;0;0;2239165;1322;1;0;0
FR;3;2021-03-28;6469;19;0;0;0;2245634;1341;1;0;0
FR;3;2021-03-29;54160;73;0;0;0;2299794;1414;1;0;0
FR;3;2021-03-30;93160;100;0;0;0;2392954;1514;1;0;0
FR;3;2021-03-31;63524;99;0;0;0;2456478;1613;1;0;0
FR;3;2021-04-01;86120;106;0;0;0;2542598;1719;1;0;0
FR;3;2021-04-02;86892;153;0;0;0;2629490;1872;1;0;0
FR;3;2021-04-03;35872;115;0;0;0;2665362;1987;1;0;0
FR;3;2021-04-04;3571;18;0;0;0;2668933;2005;1;0;0
FR;3;2021-04-05;4487;28;0;0;0;2673420;2033;1;0;0
FR;3;2021-04-06;29744;84;0;0;0;2703164;2117;1;0;0
FR;3;2021-04-07;32337;79;0;0;0;2735501;2196;1;0;0
FR;3;2021-04-08;78808;242;0;0;0;2814309;2438;1;0;0
FR;3;2021-04-09;161746;416;0;0;0;2976055;2854;1;0;0
FR;3;2021-04-10;75755;331;0;0;0;3051810;3185;1;0;0
FR;3;2021-04-11;7309;45;0;0;0;3059119;3230;1;0;0
FR;3;2021-04-12;51467;207;0;0;0;3110586;3437;1;0;0
FR;3;2021-04-13;86219;318;0;0;0;3196805;3755;1;0;0
FR;3;2021-04-14;67833;345;0;0;0;3264638;4100;1;0;0
FR;3;2021-04-15;93219;371;0;0;0;3357857;4471;1;0;0
FR;3;2021-04-16;112517;582;0;0;0;3470374;5053;1;0;0
FR;3;2021-04-17;53311;325;1;0;0;3523685;5378;2;0;0
FR;3;2021-04-18;9744;35;0;0;0;3533429;5413;2;0;0
FR;3;2021-04-19;25104;243;0;0;0;3558533;5656;2;0;0
FR;3;2021-04-20;45671;400;0;0;0;3604204;6056;2;0;0
FR;3;2021-04-21;38967;468;0;0;0;3643171;6524;2;0;0
FR;3;2021-04-22;54703;789;0;0;0;3697874;7313;2;0;0
FR;3;2021-04-23;70485;1023;0;0;0;3768359;8336;2;0;0
FR;3;2021-04-24;37240;1002;0;0;0;3805599;9338;2;0;0
FR;3;2021-04-25;6204;156;0;0;0;3811803;9494;2;0;0
FR;3;2021-04-26;19783;657;0;0;0;3831586;10151;2;0;0
FR;3;2021-04-27;34471;1265;0;0;0;3866057;11416;2;0;0
FR;3;2021-04-28;28967;1942;0;0;0;3895024;13358;2;0;0
FR;3;2021-04-29;45377;5967;0;0;0;3940401;19325;2;0;0
FR;3;2021-04-30;55452;8941;1;0;0;3995853;28266;3;0;0
FR;3;2021-05-01;9510;1978;0;0;0;4005363;30244;3;0;0
FR;3;2021-05-02;3070;488;0;0;0;4008433;30732;3;0;0
FR;3;2021-05-03;13059;3886;0;0;0;4021492;34618;3;0;0
FR;3;2021-05-04;23109;8413;0;0;0;4044601;43031;3;0;0
FR;3;2021-05-05;18754;10626;0;0;0;4063355;53657;3;0;0
FR;3;2021-05-06;34620;20920;0;0;0;4097975;74577;3;0;0
FR;3;2021-05-07;44202;28465;0;0;0;4142177;103042;3;0;0
FR;3;2021-05-08;6785;8954;0;0;0;4148962;111996;3;0;0
FR;3;2021-05-09;1793;2656;0;0;0;4150755;114652;3;0;0
FR;3;2021-05-10;14989;12623;0;0;0;4165744;127275;3;0;0
FR;3;2021-05-11;27093;25819;0;0;0;4192837;153094;3;0;0
FR;3;2021-05-12;17266;27546;0;0;0;4210103;180640;3;0;0
FR;3;2021-05-13;2277;3475;0;0;0;4212380;184115;3;0;0
FR;3;2021-05-14;14513;25787;0;0;0;4226893;209902;3;0;0
FR;3;2021-05-15;7230;20808;0;0;0;4234123;230710;3;0;0
FR;3;2021-05-16;975;2676;0;0;0;4235098;233386;3;0;0
FR;3;2021-05-17;7962;19956;0;0;0;4243060;253342;3;0;0
FR;3;2021-05-18;13410;29696;0;0;0;4256470;283038;3;0;0
FR;3;2021-05-19;9263;31476;0;0;0;4265733;314514;3;0;0
FR;3;2021-05-20;12801;53269;3;0;0;4278534;367783;6;0;0
FR;3;2021-05-21;12759;65592;2;0;0;4291293;433375;8;0;0
FR;3;2021-05-22;4960;33348;1;0;0;4296253;466723;9;0;0
FR;3;2021-05-23;649;2666;0;0;0;4296902;469389;9;0;0
FR;3;2021-05-24;879;4910;0;0;0;4297781;474299;9;0;0
FR;3;2021-05-25;5301;45341;1;0;0;4303082;519640;10;0;0
FR;3;2021-05-26;4972;51162;1;0;0;4308054;570802;11;0;0
FR;3;2021-05-27;6325;77984;3;0;0;4314379;648786;14;0;0
FR;3;2021-05-28;7542;99185;2;0;0;4321921;747971;16;0;0
FR;3;2021-05-29;3345;60371;1;0;0;4325266;808342;17;0;0
FR;3;2021-05-30;547;8208;0;0;0;4325813;816550;17;0;0
FR;3;2021-05-31;2439;35834;3;0;0;4328252;852384;20;0;0
FR;3;2021-06-01;3401;64725;10;0;0;4331653;917109;30;0;0
FR;3;2021-06-02;2727;58336;6;0;0;4334380;975445;36;0;0
FR;3;2021-06-03;3492;87480;10;0;0;4337872;1062925;46;0;0
FR;3;2021-06-04;4111;105117;22;0;0;4341983;1168042;68;0;0
FR;3;2021-06-05;1979;52247;4;0;0;4343962;1220289;72;0;0
FR;3;2021-06-06;505;5385;1;0;0;4344467;1225674;73;0;0
FR;3;2021-06-07;1472;31067;11;0;0;4345939;1256741;84;0;0
FR;3;2021-06-08;2047;47235;18;0;0;4347986;1303976;102;0;0
FR;3;2021-06-09;1788;42274;13;0;0;4349774;1346250;115;0;0
FR;3;2021-06-10;2243;67826;17;0;0;4352017;1414076;132;0;0
FR;3;2021-06-11;2471;96683;34;0;0;4354488;1510759;166;0;0
FR;3;2021-06-12;1175;40829;6;0;0;4355663;1551588;172;0;0
FR;3;2021-06-13;279;3787;3;0;0;4355942;1555375;175;0;0
FR;3;2021-06-14;1039;42585;17;0;0;4356981;1597960;192;0;0
FR;3;2021-06-15;1364;80576;20;0;0;4358345;1678536;212;0;0
FR;3;2021-06-16;1255;65673;20;0;0;4359600;1744209;232;0;0
FR;3;2021-06-17;1660;101819;41;0;0;4361260;1846028;273;0;0
FR;3;2021-06-18;1868;117934;61;0;0;4363128;1963962;334;0;0
FR;3;2021-06-19;801;39391;22;0;0;4363929;2003353;356;0;0
FR;3;2021-06-20;158;3369;0;0;0;4364087;2006722;356;0;0
FR;3;2021-06-21;768;39231;16;0;0;4364855;2045953;372;0;0
FR;3;2021-06-22;1061;69952;52;0;0;4365916;2115905;424;0;0
FR;3;2021-06-23;942;50819;39;0;0;4366858;2166724;463;0;0
FR;3;2021-06-24;1306;77152;48;0;0;4368164;2243876;511;0;0
FR;3;2021-06-25;1401;89976;73;0;0;4369565;2333852;584;0;0
FR;3;2021-06-26;625;33128;29;0;0;4370190;2366980;613;0;0
FR;3;2021-06-27;166;3983;1;0;0;4370356;2370963;614;0;0
FR;3;2021-06-28;648;30388;27;0;0;4371004;2401351;641;0;0
FR;3;2021-06-29;854;56164;95;0;0;4371858;2457515;736;0;0
FR;3;2021-06-30;901;45078;93;0;0;4372759;2502593;829;0;0
FR;3;2021-07-01;1161;65682;108;0;0;4373920;2568275;937;0;0
FR;3;2021-07-02;1299;90368;170;0;0;4375219;2658643;1107;0;0
FR;3;2021-07-03;600;31179;52;0;0;4375819;2689822;1159;0;0
FR;3;2021-07-04;142;4256;3;0;0;4375961;2694078;1162;0;0
FR;3;2021-07-05;608;33891;60;0;0;4376569;2727969;1222;0;0
FR;3;2021-07-06;957;56038;88;0;0;4377526;2784007;1310;0;0
FR;3;2021-07-07;870;43042;79;0;0;4378396;2827049;1389;0;0
FR;3;2021-07-08;1123;60730;99;0;0;4379519;2887779;1488;0;0
FR;3;2021-07-09;1258;68799;128;0;0;4380777;2956578;1616;0;0
FR;3;2021-07-10;642;25063;59;0;0;4381419;2981641;1675;0;0
FR;3;2021-07-11;128;3283;4;0;0;4381547;2984924;1679;0;0
FR;3;2021-07-12;660;23874;59;0;0;4382207;3008798;1738;0;0
FR;3;2021-07-13;1645;34713;90;0;0;4383852;3043511;1828;0;0
FR;3;2021-07-14;261;2616;2;0;0;4384113;3046127;1830;0;0
FR;3;2021-07-15;1934;30646;85;0;0;4386047;3076773;1915;0;0
FR;3;2021-07-16;2520;38854;122;0;0;4388567;3115627;2037;0;0
FR;3;2021-07-17;1046;13747;26;0;0;4389613;3129374;2063;0;0
FR;3;2021-07-18;262;2600;3;0;0;4389875;3131974;2066;0;0
FR;3;2021-07-19;1274;17184;37;0;0;4391149;3149158;2103;0;0
FR;3;2021-07-20;1823;27118;98;0;0;4392972;3176276;2201;0;0
FR;3;2021-07-21;1648;19713;44;0;0;4394620;3195989;2245;0;0
FR;3;2021-07-22;1849;27744;83;0;0;4396469;3223733;2328;0;0
FR;3;2021-07-23;2212;30439;117;0;0;4398681;3254172;2445;0;0
FR;3;2021-07-24;822;7006;25;0;0;4399503;3261178;2470;0;0
FR;3;2021-07-25;210;1338;1;0;0;4399713;3262516;2471;0;0
FR;3;2021-07-26;921;10694;28;0;0;4400634;3273210;2499;0;0
FR;3;2021-07-27;1166;16938;56;0;0;4401800;3290148;2555;0;0
FR;3;2021-07-28;988;12098;40;0;0;4402788;3302246;2595;0;0
FR;3;2021-07-29;1126;15841;63;0;0;4403914;3318087;2658;0;0
FR;3;2021-07-30;1126;18086;79;0;0;4405040;3336173;2737;0;0
FR;3;2021-07-31;406;3744;15;0;0;4405446;3339917;2752;0;0
FR;3;2021-08-01;113;486;1;0;0;4405559;3340403;2753;0;0
FR;3;2021-08-02;419;5150;22;0;0;4405978;3345553;2775;0;0
FR;3;2021-08-03;488;7578;27;0;0;4406466;3353131;2802;0;0
FR;3;2021-08-04;435;4882;26;0;0;4406901;3358013;2828;0;0
FR;3;2021-08-05;429;3734;12;0;0;4407330;3361747;2840;0;0
FR;3;2021-08-06;453;4784;30;0;0;4407783;3366531;2870;0;0
FR;3;2021-08-07;214;1922;11;0;0;4407997;3368453;2881;0;0
FR;3;2021-08-08;249;431;2;0;0;4408246;3368884;2883;0;0
FR;3;2021-08-09;313;2495;11;0;0;4408559;3371379;2894;0;0
FR;3;2021-08-10;363;3871;15;0;0;4408922;3375250;2909;0;0
FR;3;2021-08-11;285;2722;15;0;0;4409207;3377972;2924;0;0
FR;3;2021-08-12;276;2635;12;0;0;4409483;3380607;2936;0;0
FR;3;2021-08-13;277;2262;16;0;0;4409760;3382869;2952;0;0
FR;3;2021-08-14;169;916;1;0;0;4409929;3383785;2953;0;0
FR;3;2021-08-15;55;172;0;0;0;4409984;3383957;2953;0;0
FR;3;2021-08-16;123;1084;8;0;0;4410107;3385041;2961;0;0
FR;3;2021-08-17;187;1501;8;0;0;4410294;3386542;2969;0;0
FR;3;2021-08-18;200;1368;10;0;0;4410494;3387910;2979;0;0
FR;3;2021-08-19;165;1411;10;0;0;4410659;3389321;2989;0;0
FR;3;2021-08-20;166;1630;16;0;0;4410825;3390951;3005;0;0
FR;3;2021-08-21;93;586;2;0;0;4410918;3391537;3007;0;0
FR;3;2021-08-22;40;188;1;0;0;4410958;3391725;3008;0;0
FR;3;2021-08-23;140;930;7;0;0;4411098;3392655;3015;0;0
FR;3;2021-08-24;124;968;10;0;0;4411222;3393623;3025;0;0
FR;3;2021-08-25;136;842;2;0;0;4411358;3394465;3027;0;0
FR;3;2021-08-26;170;870;9;0;0;4411528;3395335;3036;0;0
FR;3;2021-08-27;172;967;9;0;0;4411700;3396302;3045;0;0
FR;3;2021-08-28;98;371;4;0;0;4411798;3396673;3049;0;0
FR;3;2021-08-29;128;133;1;0;0;4411926;3396806;3050;0;0
FR;3;2021-08-30;99;600;0;0;134;4412025;3397406;3050;0;134
FR;3;2021-08-31;128;711;7;0;152;4412153;3398117;3057;0;286
FR;3;2021-09-01;113;477;5;0;122;4412266;3398594;3062;0;408
FR;3;2021-09-02;100;633;22;0;119;4412366;3399227;3084;0;527
FR;3;2021-09-03;115;585;17;0;128;4412481;3399812;3101;0;655
FR;3;2021-09-04;53;302;3;0;58;4412534;3400114;3104;0;713
FR;3;2021-09-05;51;68;5;0;28;4412585;3400182;3109;0;741
FR;3;2021-09-06;113;394;4;0;144;4412698;3400576;3113;0;885
FR;3;2021-09-07;123;472;14;0;128;4412821;3401048;3127;0;1013
FR;3;2021-09-08;118;371;2;0;103;4412939;3401419;3129;0;1116
FR;3;2021-09-09;93;397;8;0;114;4413032;3401816;3137;0;1230
FR;3;2021-09-10;100;420;3;0;103;4413132;3402236;3140;0;1333
FR;3;2021-09-11;75;239;4;0;66;4413207;3402475;3144;0;1399
FR;3;2021-09-12;36;48;1;0;17;4413243;3402523;3145;0;1416
FR;3;2021-09-13;70;319;7;0;108;4413313;3402842;3152;0;1524
FR;3;2021-09-14;71;292;6;0;106;4413384;3403134;3158;0;1630
FR;3;2021-09-15;59;263;3;0;6;4413443;3403397;3161;0;1636
FR;3;2021-09-16;60;336;5;0;5;4413503;3403733;3166;0;1641
FR;3;2021-09-17;51;347;3;0;7;4413554;3404080;3169;0;1648
FR;3;2021-09-18;36;173;1;0;1;4413590;3404253;3170;0;1649
FR;3;2021-09-19;27;32;2;0;1;4413617;3404285;3172;0;1650
FR;3;2021-09-20;79;210;0;0;1;4413696;3404495;3172;0;1651
FR;3;2021-09-21;58;287;6;0;7;4413754;3404782;3178;0;1658
FR;3;2021-09-22;63;228;6;0;7;4413817;3405010;3184;0;1665
FR;3;2021-09-23;36;272;11;0;7;4413853;3405282;3195;0;1672
FR;3;2021-09-24;25;325;12;0;19;4413878;3405607;3207;0;1691
FR;3;2021-09-25;29;148;3;0;3;4413907;3405755;3210;0;1694
FR;3;2021-09-26;15;55;1;0;1;4413922;3405810;3211;0;1695
FR;3;2021-09-27;39;293;3;0;5;4413961;3406103;3214;0;1700
FR;3;2021-09-28;49;256;6;0;10;4414010;3406359;3220;0;1710
FR;3;2021-09-29;35;223;10;0;13;4414045;3406582;3230;0;1723
FR;3;2021-09-30;38;201;8;0;10;4414083;3406783;3238;0;1733
FR;3;2021-10-01;17;168;6;0;7;4414100;3406951;3244;0;1740
FR;3;2021-10-02;14;90;0;0;0;4414114;3407041;3244;0;1740
FR;3;2021-10-03;18;20;1;0;2;4414132;3407061;3245;0;1742
FR;3;2021-10-04;30;161;4;0;4;4414162;3407222;3249;0;1746
FR;3;2021-10-05;16;154;10;0;13;4414178;3407376;3259;0;1759
FR;3;2021-10-06;31;157;8;0;9;4414209;3407533;3267;0;1768
FR;3;2021-10-07;18;141;6;0;6;4414227;3407674;3273;0;1774
FR;3;2021-10-08;22;146;10;0;9;4414249;3407820;3283;0;1783
FR;3;2021-10-09;12;72;1;0;1;4414261;3407892;3284;0;1784
FR;3;2021-10-10;12;16;2;0;2;4414273;3407908;3286;0;1786
FR;3;2021-10-11;15;123;4;0;5;4414288;3408031;3290;0;1791
FR;3;2021-10-12;17;114;5;0;5;4414305;3408145;3295;0;1796
FR;3;2021-10-13;23;121;7;0;5;4414328;3408266;3302;0;1801
FR;3;2021-10-14;16;162;3;0;4;4414344;3408428;3305;0;1805
FR;3;2021-10-15;21;157;8;0;11;4414365;3408585;3313;0;1816
FR;3;2021-10-16;11;78;6;0;8;4414376;3408663;3319;0;1824
FR;3;2021-10-17;11;24;0;0;0;4414387;3408687;3319;0;1824
FR;3;2021-10-18;17;128;2;0;1;4414404;3408815;3321;0;1825
FR;3;2021-10-19;16;124;19;0;21;4414420;3408939;3340;0;1846
FR;3;2021-10-20;22;129;5;0;6;4414442;3409068;3345;0;1852
FR;3;2021-10-21;25;136;17;0;13;4414467;3409204;3362;0;1865
FR;3;2021-10-22;20;127;16;0;20;4414487;3409331;3378;0;1885
FR;3;2021-10-23;12;58;2;0;1;4414499;3409389;3380;0;1886
FR;3;2021-10-24;7;31;0;0;0;4414506;3409420;3380;0;1886
FR;3;2021-10-25;22;151;7;0;7;4414528;3409571;3387;0;1893
FR;3;2021-10-26;18;113;22;0;19;4414546;3409684;3409;0;1912
FR;3;2021-10-27;17;117;9;0;9;4414563;3409801;3418;0;1921
FR;3;2021-10-28;20;126;33;0;36;4414583;3409927;3451;0;1957
FR;3;2021-10-29;10;123;64;0;54;4414593;3410050;3515;0;2011
FR;3;2021-10-30;8;65;11;1;10;4414601;3410115;3526;1;2021
FR;3;2021-10-31;6;22;1;0;1;4414607;3410137;3527;1;2022
FR;3;2021-11-01;7;22;2;0;1;4414614;3410159;3529;1;2023
FR;3;2021-11-02;9;107;8;0;10;4414623;3410266;3537;1;2033
FR;3;2021-11-03;19;118;10;0;10;4414642;3410384;3547;1;2043
FR;3;2021-11-04;18;96;4;0;3;4414660;3410480;3551;1;2046
FR;3;2021-11-05;17;141;8;1;5;4414677;3410621;3559;2;2051
FR;3;2021-11-06;7;66;3;0;3;4414684;3410687;3562;2;2054
FR;3;2021-11-07;6;21;1;0;1;4414690;3410708;3563;2;2055
FR;3;2021-11-08;11;140;7;0;5;4414701;3410848;3570;2;2060
FR;3;2021-11-09;12;151;5;0;5;4414713;3410999;3575;2;2065
FR;3;2021-11-10;12;179;14;0;15;4414725;3411178;3589;2;2080
FR;3;2021-11-11;8;51;3;0;3;4414733;3411229;3592;2;2083
FR;3;2021-11-12;10;153;6;0;4;4414743;3411382;3598;2;2087
FR;3;2021-11-13;7;76;8;0;10;4414750;3411458;3606;2;2097
FR;3;2021-11-14;2;21;0;0;0;4414752;3411479;3606;2;2097
FR;3;2021-11-15;4;191;10;0;10;4414756;3411670;3616;2;2107
FR;3;2021-11-16;3;165;11;0;10;4414759;3411835;3627;2;2117
FR;3;2021-11-17;6;178;10;0;7;4414765;3412013;3637;2;2124
FR;3;2021-11-18;13;175;10;0;11;4414778;3412188;3647;2;2135
FR;3;2021-11-19;9;223;22;0;27;4414787;3412411;3669;2;2162
FR;3;2021-11-20;6;114;5;0;5;4414793;3412525;3674;2;2167
FR;3;2021-11-21;3;26;3;0;3;4414796;3412551;3677;2;2170
FR;3;2021-11-22;10;232;10;0;10;4414806;3412783;3687;2;2180
FR;3;2021-11-23;6;231;15;0;14;4414812;3413014;3702;2;2194
FR;3;2021-11-24;5;237;9;0;17;4414817;3413251;3711;2;2211
FR;3;2021-11-25;9;280;11;0;10;4414826;3413531;3722;2;2221
FR;3;2021-11-26;6;355;35;0;32;4414832;3413886;3757;2;2253
FR;3;2021-11-27;8;172;20;0;21;4414840;3414058;3777;2;2274
FR;3;2021-11-28;3;64;7;0;7;4414843;3414122;3784;2;2281
FR;3;2021-11-29;4;315;19;0;20;4414847;3414437;3803;2;2301
FR;3;2021-11-30;5;409;26;0;29;4414852;3414846;3829;2;2330
FR;3;2021-12-01;18;456;32;0;33;4414870;3415302;3861;2;2363
FR;3;2021-12-02;9;478;33;0;36;4414879;3415780;3894;2;2399
FR;3;2021-12-03;3;557;37;0;38;4414882;3416337;3931;2;2437
FR;3;2021-12-04;3;278;26;0;28;4414885;3416615;3957;2;2465
FR;3;2021-12-05;1;80;5;0;5;4414886;3416695;3962;2;2470
FR;3;2021-12-06;5;502;14;0;16;4414891;3417197;3976;2;2486
FR;3;2021-12-07;4;603;20;0;24;4414895;3417800;3996;2;2510
FR;3;2021-12-08;4;534;29;0;30;4414899;3418334;4025;2;2540
FR;3;2021-12-09;3;582;17;0;22;4414902;3418916;4042;2;2562
FR;3;2021-12-10;9;621;29;0;25;4414911;3419537;4071;2;2587
FR;3;2021-12-11;4;384;10;0;9;4414915;3419921;4081;2;2596
FR;3;2021-12-12;1;120;3;0;3;4414916;3420041;4084;2;2599
FR;3;2021-12-13;2;594;19;0;21;4414918;3420635;4103;2;2620
FR;3;2021-12-14;7;749;18;0;21;4414925;3421384;4121;2;2641
FR;3;2021-12-15;9;713;17;0;21;4414934;3422097;4138;2;2662
FR;3;2021-12-16;9;722;19;0;18;4414943;3422819;4157;2;2680
FR;3;2021-12-17;4;790;18;0;19;4414947;3423609;4175;2;2699
FR;3;2021-12-18;4;409;4;0;5;4414951;3424018;4179;2;2704
FR;3;2021-12-19;3;207;2;0;2;4414954;3424225;4181;2;2706
FR;3;2021-12-20;8;716;23;0;28;4414962;3424941;4204;2;2734
FR;3;2021-12-21;3;800;10;0;13;4414965;3425741;4214;2;2747
FR;3;2021-12-22;6;755;9;0;10;4414971;3426496;4223;2;2757
FR;3;2021-12-23;1;646;9;0;8;4414972;3427142;4232;2;2765
FR;3;2021-12-24;2;271;3;0;6;4414974;3427413;4235;2;2771
FR;3;2021-12-25;0;25;0;0;0;4414974;3427438;4235;2;2771
FR;3;2021-12-26;0;94;1;0;1;4414974;3427532;4236;2;2772
FR;3;2021-12-27;7;538;17;0;19;4414981;3428070;4253;2;2791
FR;3;2021-12-28;1;687;6;0;5;4414982;3428757;4259;2;2796
FR;3;2021-12-29;4;571;14;0;16;4414986;3429328;4273;2;2812
FR;3;2021-12-30;1;599;7;0;10;4414987;3429927;4280;2;2822
FR;3;2021-12-31;0;205;5;0;7;4414987;3430132;4285;2;2829
FR;3;2022-01-01;0;27;0;0;2;4414987;3430159;4285;2;2831
FR;3;2022-01-02;0;82;0;0;0;4414987;3430241;4285;2;2831
FR;3;2022-01-03;3;564;17;0;20;4414990;3430805;4302;2;2851
FR;3;2022-01-04;6;623;9;0;8;4414996;3431428;4311;2;2859
FR;3;2022-01-05;4;550;10;0;14;4415000;3431978;4321;2;2873
FR;3;2022-01-06;5;546;9;0;12;4415005;3432524;4330;2;2885
FR;3;2022-01-07;2;572;11;0;13;4415007;3433096;4341;2;2898
FR;3;2022-01-08;2;283;4;0;5;4415009;3433379;4345;2;2903
FR;3;2022-01-09;0;118;0;0;0;4415009;3433497;4345;2;2903
FR;3;2022-01-10;2;479;12;0;12;4415011;3433976;4357;2;2915
FR;3;2022-01-11;2;529;1;0;1;4415013;3434505;4358;2;2916
FR;3;2022-01-12;2;445;9;0;10;4415015;3434950;4367;2;2926
FR;3;2022-01-13;3;423;11;0;12;4415018;3435373;4378;2;2938
FR;3;2022-01-14;3;473;10;0;13;4415021;3435846;4388;2;2951
FR;3;2022-01-15;0;298;2;0;3;4415021;3436144;4390;2;2954
FR;3;2022-01-16;0;116;1;0;1;4415021;3436260;4391;2;2955
FR;3;2022-01-17;2;349;8;0;10;4415023;3436609;4399;2;2965
FR;3;2022-01-18;2;411;1;0;2;4415025;3437020;4400;2;2967
FR;3;2022-01-19;1;349;5;0;10;4415026;3437369;4405;2;2977
FR;3;2022-01-20;1;377;5;0;3;4415027;3437746;4410;2;2980
FR;3;2022-01-21;3;372;5;0;7;4415030;3438118;4415;2;2987
FR;3;2022-01-22;2;231;1;0;2;4415032;3438349;4416;2;2989
FR;3;2022-01-23;0;82;0;0;1;4415032;3438431;4416;2;2990
FR;3;2022-01-24;2;347;1;0;6;4415034;3438778;4417;2;2996
FR;3;2022-01-25;0;191;0;0;0;4415034;3438969;4417;2;2996
FR;3;2022-01-26;0;88;0;0;0;4415034;3439057;4417;2;2996
FR;3;2022-01-27;0;58;0;0;0;4415034;3439115;4417;2;2996
FR;3;2022-01-28;0;133;0;0;0;4415034;3439248;4417;2;2996
FR;3;2022-01-29;0;110;0;0;0;4415034;3439358;4417;2;2996
FR;3;2022-01-30;0;51;0;0;0;4415034;3439409;4417;2;2996
FR;3;2022-01-31;0;97;0;0;0;4415034;3439506;4417;2;2996
FR;3;2022-02-01;0;108;0;0;1;4415034;3439614;4417;2;2997
FR;3;2022-02-02;0;95;0;0;0;4415034;3439709;4417;2;2997
FR;3;2022-02-03;0;101;0;0;0;4415034;3439810;4417;2;2997
FR;3;2022-02-04;0;124;0;0;0;4415034;3439934;4417;2;2997
FR;3;2022-02-05;0;73;0;0;0;4415034;3440007;4417;2;2997
FR;3;2022-02-06;0;11;0;0;0;4415034;3440018;4417;2;2997
FR;3;2022-02-07;0;89;0;0;1;4415034;3440107;4417;2;2998
FR;3;2022-02-08;0;0;0;0;0;4415034;3440107;4417;2;2998
FR;3;2022-02-09;0;0;0;0;0;4415034;3440107;4417;2;2998
FR;3;2022-02-10;0;0;0;0;0;4415034;3440107;4417;2;2998
FR;3;2022-02-11;0;0;0;0;0;4415034;3440107;4417;2;2998
FR;3;2022-02-12;0;0;0;0;0;4415034;3440107;4417;2;2998
FR;3;2022-02-13;0;0;0;0;0;4415034;3440107;4417;2;2998
FR;3;2022-02-14;0;0;0;0;0;4415034;3440107;4417;2;2998
FR;3;2022-02-15;0;0;0;0;0;4415034;3440107;4417;2;2998
FR;3;2022-02-16;0;0;0;0;0;4415034;3440107;4417;2;2998
FR;3;2022-02-17;0;0;0;0;0;4415034;3440107;4417;2;2998
FR;3;2022-02-18;0;0;0;0;0;4415034;3440107;4417;2;2998
FR;3;2022-02-19;0;0;0;0;0;4415034;3440107;4417;2;2998
FR;3;2022-02-20;0;0;0;0;0;4415034;3440107;4417;2;2998
FR;3;2022-02-21;2;0;0;0;0;4415036;3440107;4417;2;2998
FR;3;2022-02-22;0;0;0;0;0;4415036;3440107;4417;2;2998
FR;3;2022-02-23;0;0;0;0;0;4415036;3440107;4417;2;2998
FR;3;2022-02-24;0;0;0;0;0;4415036;3440107;4417;2;2998
FR;3;2022-02-25;0;0;0;0;0;4415036;3440107;4417;2;2998
FR;3;2022-02-26;0;0;0;0;0;4415036;3440107;4417;2;2998
FR;3;2022-02-27;0;0;0;0;0;4415036;3440107;4417;2;2998
FR;3;2022-02-28;1;0;0;0;0;4415037;3440107;4417;2;2998
FR;3;2022-03-01;1;0;0;0;0;4415038;3440107;4417;2;2998
FR;3;2022-03-02;0;0;0;0;0;4415038;3440107;4417;2;2998
FR;3;2022-03-03;0;0;0;0;0;4415038;3440107;4417;2;2998
FR;3;2022-03-04;0;0;0;0;0;4415038;3440107;4417;2;2998
FR;3;2022-03-05;0;0;0;0;0;4415038;3440107;4417;2;2998
FR;3;2022-03-06;1;0;0;0;0;4415039;3440107;4417;2;2998
FR;3;2022-03-07;0;0;0;0;0;4415039;3440107;4417;2;2998
FR;3;2022-03-08;1;0;0;0;0;4415040;3440107;4417;2;2998
FR;3;2022-03-09;0;0;0;0;0;4415040;3440107;4417;2;2998
FR;3;2022-03-10;0;0;0;0;0;4415040;3440107;4417;2;2998
FR;3;2022-03-11;0;0;0;0;0;4415040;3440107;4417;2;2998
FR;3;2022-03-12;0;0;0;0;0;4415040;3440107;4417;2;2998
FR;3;2022-03-13;0;0;0;0;0;4415040;3440107;4417;2;2998
FR;3;2022-03-14;0;0;0;0;0;4415040;3440107;4417;2;2998
FR;3;2022-03-15;0;0;0;0;0;4415040;3440107;4417;2;2998
FR;3;2022-03-16;0;0;0;0;0;4415040;3440107;4417;2;2998
FR;3;2022-03-17;0;0;0;0;0;4415040;3440107;4417;2;2998
FR;3;2022-03-18;0;0;0;0;0;4415040;3440107;4417;2;2998
FR;3;2022-03-19;0;0;0;0;0;4415040;3440107;4417;2;2998
FR;3;2022-03-20;1;0;0;0;0;4415041;3440107;4417;2;2998
FR;3;2022-03-21;0;0;0;0;0;4415041;3440107;4417;2;2998
FR;3;2022-03-22;0;0;0;0;0;4415041;3440107;4417;2;2998
FR;3;2022-03-23;1;0;0;0;0;4415042;3440107;4417;2;2998
FR;3;2022-03-24;0;0;0;0;0;4415042;3440107;4417;2;2998
FR;3;2022-03-25;1;0;0;0;0;4415043;3440107;4417;2;2998
FR;3;2022-03-26;0;0;0;0;0;4415043;3440107;4417;2;2998
FR;3;2022-03-27;0;0;0;0;0;4415043;3440107;4417;2;2998
FR;3;2022-03-28;0;0;0;0;0;4415043;3440107;4417;2;2998
FR;3;2022-03-29;0;0;0;0;0;4415043;3440107;4417;2;2998
FR;3;2022-03-30;0;0;0;0;0;4415043;3440107;4417;2;2998
FR;3;2022-03-31;0;0;0;0;0;4415043;3440107;4417;2;2998
FR;3;2022-04-01;0;0;0;0;0;4415043;3440107;4417;2;2998
FR;3;2022-04-02;0;0;0;0;0;4415043;3440107;4417;2;2998
FR;3;2022-04-03;0;0;0;0;0;4415043;3440107;4417;2;2998
FR;3;2022-04-04;0;0;0;0;0;4415043;3440107;4417;2;2998
FR;3;2022-04-05;0;0;0;0;0;4415043;3440107;4417;2;2998
FR;3;2022-04-06;0;0;0;0;0;4415043;3440107;4417;2;2998
FR;3;2022-04-07;0;0;0;0;0;4415043;3440107;4417;2;2998
FR;3;2022-04-08;0;0;0;0;0;4415043;3440107;4417;2;2998
FR;3;2022-04-09;0;0;0;0;0;4415043;3440107;4417;2;2998
FR;3;2022-04-10;0;0;0;0;0;4415043;3440107;4417;2;2998
FR;3;2022-04-11;0;0;0;0;0;4415043;3440107;4417;2;2998
FR;3;2022-04-12;0;0;0;0;0;4415043;3440107;4417;2;2998
FR;3;2022-04-13;0;0;0;0;0;4415043;3440107;4417;2;2998
FR;3;2022-04-14;0;0;0;0;0;4415043;3440107;4417;2;2998
FR;3;2022-04-15;1;0;0;0;0;4415044;3440107;4417;2;2998
FR;3;2022-04-16;0;0;0;0;0;4415044;3440107;4417;2;2998
FR;3;2022-04-17;0;0;0;0;0;4415044;3440107;4417;2;2998
FR;3;2022-04-18;0;0;0;0;0;4415044;3440107;4417;2;2998
FR;3;2022-04-19;0;0;0;0;0;4415044;3440107;4417;2;2998
FR;3;2022-04-20;0;0;0;0;0;4415044;3440107;4417;2;2998
FR;3;2022-04-21;0;0;0;0;0;4415044;3440107;4417;2;2998
FR;3;2022-04-22;0;0;0;0;0;4415044;3440107;4417;2;2998
FR;3;2022-04-23;0;0;0;0;0;4415044;3440107;4417;2;2998
FR;3;2022-04-24;0;0;0;0;0;4415044;3440107;4417;2;2998
FR;3;2022-04-25;0;0;0;0;0;4415044;3440107;4417;2;2998
FR;3;2022-04-26;0;0;0;0;0;4415044;3440107;4417;2;2998
FR;3;2022-04-27;0;0;0;0;0;4415044;3440107;4417;2;2998
FR;3;2022-04-28;0;0;0;0;0;4415044;3440107;4417;2;2998
FR;3;2022-04-29;0;0;0;0;0;4415044;3440107;4417;2;2998
FR;3;2022-04-30;0;0;0;0;0;4415044;3440107;4417;2;2998
FR;3;2022-05-01;0;0;0;0;0;4415044;3440107;4417;2;2998
FR;3;2022-05-02;0;0;0;0;0;4415044;3440107;4417;2;2998
FR;3;2022-05-03;0;0;0;0;0;4415044;3440107;4417;2;2998
FR;3;2022-05-04;0;0;0;0;0;4415044;3440107;4417;2;2998
FR;3;2022-05-05;0;0;0;0;0;4415044;3440107;4417;2;2998
FR;3;2022-05-06;0;0;0;0;0;4415044;3440107;4417;2;2998
FR;3;2022-05-07;0;0;0;0;0;4415044;3440107;4417;2;2998
FR;3;2022-05-08;0;0;0;0;0;4415044;3440107;4417;2;2998
FR;3;2022-05-09;0;0;0;0;0;4415044;3440107;4417;2;2998
FR;3;2022-05-10;0;0;0;0;0;4415044;3440107;4417;2;2998
FR;3;2022-05-11;0;0;0;0;0;4415044;3440107;4417;2;2998
FR;3;2022-05-12;0;0;0;0;0;4415044;3440107;4417;2;2998
FR;3;2022-05-13;0;0;0;0;0;4415044;3440107;4417;2;2998
FR;3;2022-05-14;1;0;0;0;0;4415045;3440107;4417;2;2998
FR;3;2022-05-15;0;0;0;0;0;4415045;3440107;4417;2;2998
FR;3;2022-05-16;0;0;0;0;0;4415045;3440107;4417;2;2998
FR;3;2022-05-17;0;0;0;0;0;4415045;3440107;4417;2;2998
FR;3;2022-05-18;0;0;0;0;0;4415045;3440107;4417;2;2998
FR;3;2022-05-19;0;0;0;0;0;4415045;3440107;4417;2;2998
FR;3;2022-05-20;0;0;0;0;0;4415045;3440107;4417;2;2998
FR;3;2022-05-21;0;0;0;0;0;4415045;3440107;4417;2;2998
FR;3;2022-05-22;0;0;0;0;0;4415045;3440107;4417;2;2998
FR;3;2022-05-23;0;0;0;0;0;4415045;3440107;4417;2;2998
FR;3;2022-05-24;0;0;0;0;0;4415045;3440107;4417;2;2998
FR;3;2022-05-25;0;0;0;0;0;4415045;3440107;4417;2;2998
FR;3;2022-05-26;0;0;0;0;0;4415045;3440107;4417;2;2998
FR;3;2022-05-27;0;0;0;0;0;4415045;3440107;4417;2;2998
FR;3;2022-05-28;0;0;0;0;0;4415045;3440107;4417;2;2998
FR;3;2022-05-29;0;0;0;0;0;4415045;3440107;4417;2;2998
FR;3;2022-05-30;0;0;0;0;0;4415045;3440107;4417;2;2998
FR;3;2022-05-31;0;0;0;0;0;4415045;3440107;4417;2;2998
FR;3;2022-06-01;0;0;0;0;0;4415045;3440107;4417;2;2998
FR;3;2022-06-02;0;0;0;0;0;4415045;3440107;4417;2;2998
FR;3;2022-06-03;0;0;0;0;0;4415045;3440107;4417;2;2998
FR;3;2022-06-04;0;0;0;0;0;4415045;3440107;4417;2;2998
FR;3;2022-06-05;0;0;0;0;0;4415045;3440107;4417;2;2998
FR;3;2022-06-06;0;0;0;0;0;4415045;3440107;4417;2;2998
FR;3;2022-06-07;0;0;0;0;0;4415045;3440107;4417;2;2998
FR;4;2020-12-27;0;0;0;0;0;0;0;0;0;0
FR;4;2020-12-28;0;0;0;0;0;0;0;0;0;0
FR;4;2020-12-29;0;0;0;0;0;0;0;0;0;0
FR;4;2020-12-30;0;0;0;0;0;0;0;0;0;0
FR;4;2020-12-31;0;0;0;0;0;0;0;0;0;0
FR;4;2021-01-01;0;0;0;0;0;0;0;0;0;0
FR;4;2021-01-02;0;0;0;0;0;0;0;0;0;0
FR;4;2021-01-03;0;0;0;0;0;0;0;0;0;0
FR;4;2021-01-04;0;0;0;0;0;0;0;0;0;0
FR;4;2021-01-05;0;0;0;0;0;0;0;0;0;0
FR;4;2021-01-06;0;0;0;0;0;0;0;0;0;0
FR;4;2021-01-07;0;0;0;0;0;0;0;0;0;0
FR;4;2021-01-08;0;0;0;0;0;0;0;0;0;0
FR;4;2021-01-09;0;0;0;0;0;0;0;0;0;0
FR;4;2021-01-10;0;0;0;0;0;0;0;0;0;0
FR;4;2021-01-11;0;0;0;0;0;0;0;0;0;0
FR;4;2021-01-12;0;0;0;0;0;0;0;0;0;0
FR;4;2021-01-13;0;0;0;0;0;0;0;0;0;0
FR;4;2021-01-14;0;0;0;0;0;0;0;0;0;0
FR;4;2021-01-15;0;0;0;0;0;0;0;0;0;0
FR;4;2021-01-16;0;0;0;0;0;0;0;0;0;0
FR;4;2021-01-17;0;0;0;0;0;0;0;0;0;0
FR;4;2021-01-18;0;0;0;0;0;0;0;0;0;0
FR;4;2021-01-19;0;0;0;0;0;0;0;0;0;0
FR;4;2021-01-20;0;0;0;0;0;0;0;0;0;0
FR;4;2021-01-21;0;0;0;0;0;0;0;0;0;0
FR;4;2021-01-22;0;0;0;0;0;0;0;0;0;0
FR;4;2021-01-23;0;0;0;0;0;0;0;0;0;0
FR;4;2021-01-24;0;0;0;0;0;0;0;0;0;0
FR;4;2021-01-25;0;0;0;0;0;0;0;0;0;0
FR;4;2021-01-26;0;0;0;0;0;0;0;0;0;0
FR;4;2021-01-27;0;0;0;0;0;0;0;0;0;0
FR;4;2021-01-28;0;0;0;0;0;0;0;0;0;0
FR;4;2021-01-29;0;0;0;0;0;0;0;0;0;0
FR;4;2021-01-30;0;0;0;0;0;0;0;0;0;0
FR;4;2021-01-31;0;0;0;0;0;0;0;0;0;0
FR;4;2021-02-01;0;0;0;0;0;0;0;0;0;0
FR;4;2021-02-02;0;0;0;0;0;0;0;0;0;0
FR;4;2021-02-03;0;0;0;0;0;0;0;0;0;0
FR;4;2021-02-04;0;0;0;0;0;0;0;0;0;0
FR;4;2021-02-05;0;0;0;0;0;0;0;0;0;0
FR;4;2021-02-06;0;0;0;0;0;0;0;0;0;0
FR;4;2021-02-07;0;0;0;0;0;0;0;0;0;0
FR;4;2021-02-08;0;0;0;0;0;0;0;0;0;0
FR;4;2021-02-09;0;0;0;0;0;0;0;0;0;0
FR;4;2021-02-10;0;0;0;0;0;0;0;0;0;0
FR;4;2021-02-11;0;0;0;0;0;0;0;0;0;0
FR;4;2021-02-12;0;0;0;0;0;0;0;0;0;0
FR;4;2021-02-13;0;0;0;0;0;0;0;0;0;0
FR;4;2021-02-14;0;0;0;0;0;0;0;0;0;0
FR;4;2021-02-15;0;0;0;0;0;0;0;0;0;0
FR;4;2021-02-16;0;0;0;0;0;0;0;0;0;0
FR;4;2021-02-17;0;0;0;0;0;0;0;0;0;0
FR;4;2021-02-18;0;0;0;0;0;0;0;0;0;0
FR;4;2021-02-19;0;0;0;0;0;0;0;0;0;0
FR;4;2021-02-20;0;0;0;0;0;0;0;0;0;0
FR;4;2021-02-21;0;0;0;0;0;0;0;0;0;0
FR;4;2021-02-22;0;0;0;0;0;0;0;0;0;0
FR;4;2021-02-23;0;0;0;0;0;0;0;0;0;0
FR;4;2021-02-24;0;0;0;0;0;0;0;0;0;0
FR;4;2021-02-25;0;0;0;0;0;0;0;0;0;0
FR;4;2021-02-26;0;0;0;0;0;0;0;0;0;0
FR;4;2021-02-27;0;0;0;0;0;0;0;0;0;0
FR;4;2021-02-28;0;0;0;0;0;0;0;0;0;0
FR;4;2021-03-01;0;0;0;0;0;0;0;0;0;0
FR;4;2021-03-02;0;0;0;0;0;0;0;0;0;0
FR;4;2021-03-03;0;0;0;0;0;0;0;0;0;0
FR;4;2021-03-04;0;0;0;0;0;0;0;0;0;0
FR;4;2021-03-05;0;0;0;0;0;0;0;0;0;0
FR;4;2021-03-06;0;0;0;0;0;0;0;0;0;0
FR;4;2021-03-07;0;0;0;0;0;0;0;0;0;0
FR;4;2021-03-08;0;0;0;0;0;0;0;0;0;0
FR;4;2021-03-09;0;0;0;0;0;0;0;0;0;0
FR;4;2021-03-10;0;0;0;0;0;0;0;0;0;0
FR;4;2021-03-11;0;0;0;0;0;0;0;0;0;0
FR;4;2021-03-12;0;0;0;0;0;0;0;0;0;0
FR;4;2021-03-13;0;0;0;0;0;0;0;0;0;0
FR;4;2021-03-14;0;0;0;0;0;0;0;0;0;0
FR;4;2021-03-15;0;0;0;0;0;0;0;0;0;0
FR;4;2021-03-16;0;0;0;0;0;0;0;0;0;0
FR;4;2021-03-17;0;0;0;0;0;0;0;0;0;0
FR;4;2021-03-18;0;0;0;0;0;0;0;0;0;0
FR;4;2021-03-19;0;0;0;0;0;0;0;0;0;0
FR;4;2021-03-20;0;0;0;0;0;0;0;0;0;0
FR;4;2021-03-21;0;0;0;0;0;0;0;0;0;0
FR;4;2021-03-22;0;0;0;0;0;0;0;0;0;0
FR;4;2021-03-23;0;0;0;0;0;0;0;0;0;0
FR;4;2021-03-24;0;0;0;0;0;0;0;0;0;0
FR;4;2021-03-25;0;0;0;0;0;0;0;0;0;0
FR;4;2021-03-26;0;0;0;0;0;0;0;0;0;0
FR;4;2021-03-27;0;0;0;0;0;0;0;0;0;0
FR;4;2021-03-28;0;0;0;0;0;0;0;0;0;0
FR;4;2021-03-29;0;0;0;0;0;0;0;0;0;0
FR;4;2021-03-30;0;0;0;0;0;0;0;0;0;0
FR;4;2021-03-31;0;0;0;0;0;0;0;0;0;0
FR;4;2021-04-01;0;0;0;0;0;0;0;0;0;0
FR;4;2021-04-02;0;0;0;0;0;0;0;0;0;0
FR;4;2021-04-03;0;0;0;0;0;0;0;0;0;0
FR;4;2021-04-04;0;0;0;0;0;0;0;0;0;0
FR;4;2021-04-05;0;0;0;0;0;0;0;0;0;0
FR;4;2021-04-06;0;0;0;0;0;0;0;0;0;0
FR;4;2021-04-07;0;0;0;0;0;0;0;0;0;0
FR;4;2021-04-08;0;0;0;0;0;0;0;0;0;0
FR;4;2021-04-09;0;0;0;0;0;0;0;0;0;0
FR;4;2021-04-10;0;0;0;0;0;0;0;0;0;0
FR;4;2021-04-11;0;0;0;0;0;0;0;0;0;0
FR;4;2021-04-12;0;0;0;0;0;0;0;0;0;0
FR;4;2021-04-13;0;0;0;0;0;0;0;0;0;0
FR;4;2021-04-14;0;0;0;0;0;0;0;0;0;0
FR;4;2021-04-15;0;0;0;0;0;0;0;0;0;0
FR;4;2021-04-16;0;0;0;0;0;0;0;0;0;0
FR;4;2021-04-17;0;0;0;0;0;0;0;0;0;0
FR;4;2021-04-18;0;0;0;0;0;0;0;0;0;0
FR;4;2021-04-19;0;0;0;0;0;0;0;0;0;0
FR;4;2021-04-20;0;0;0;0;0;0;0;0;0;0
FR;4;2021-04-21;0;0;0;0;0;0;0;0;0;0
FR;4;2021-04-22;0;0;0;0;0;0;0;0;0;0
FR;4;2021-04-23;4008;0;0;0;0;4008;0;0;0;0
FR;4;2021-04-24;1569;0;0;0;0;5577;0;0;0;0
FR;4;2021-04-25;125;0;0;0;0;5702;0;0;0;0
FR;4;2021-04-26;2869;1;0;0;0;8571;1;0;0;0
FR;4;2021-04-27;9519;3;0;0;0;18090;4;0;0;0
FR;4;2021-04-28;9904;6;0;0;0;27994;10;0;0;0
FR;4;2021-04-29;15991;8;0;0;0;43985;18;0;0;0
FR;4;2021-04-30;19230;10;0;0;0;63215;28;0;0;0
FR;4;2021-05-01;1994;6;0;0;0;65209;34;0;0;0
FR;4;2021-05-02;482;0;0;0;0;65691;34;0;0;0
FR;4;2021-05-03;5058;2;0;0;0;70749;36;0;0;0
FR;4;2021-05-04;8397;10;0;0;0;79146;46;0;0;0
FR;4;2021-05-05;6182;7;0;0;0;85328;53;0;0;0
FR;4;2021-05-06;11378;11;0;0;0;96706;64;0;0;0
FR;4;2021-05-07;19121;9;0;0;0;115827;73;0;0;0
FR;4;2021-05-08;2377;6;0;0;0;118204;79;0;0;0
FR;4;2021-05-09;685;3;0;0;0;118889;82;0;0;0
FR;4;2021-05-10;7240;5;1;0;0;126129;87;1;0;0
FR;4;2021-05-11;14314;12;0;0;0;140443;99;1;0;0
FR;4;2021-05-12;10163;15;0;0;0;150606;114;1;0;0
FR;4;2021-05-13;1579;3;0;0;0;152185;117;1;0;0
FR;4;2021-05-14;7760;6;0;0;0;159945;123;1;0;0
FR;4;2021-05-15;3717;8;1;0;0;163662;131;2;0;0
FR;4;2021-05-16;417;1;0;0;0;164079;132;2;0;0
FR;4;2021-05-17;4476;6;0;0;0;168555;138;2;0;0
FR;4;2021-05-18;8751;10;0;0;0;177306;148;2;0;0
FR;4;2021-05-19;5690;7;0;0;0;182996;155;2;0;0
FR;4;2021-05-20;9479;7;0;0;0;192475;162;2;0;0
FR;4;2021-05-21;12791;30;0;0;0;205266;192;2;0;0
FR;4;2021-05-22;5056;15;0;0;0;210322;207;2;0;0
FR;4;2021-05-23;494;4;0;0;0;210816;211;2;0;0
FR;4;2021-05-24;1054;7;0;0;0;211870;218;2;0;0
FR;4;2021-05-25;7620;16;0;0;0;219490;234;2;0;0
FR;4;2021-05-26;7724;16;0;0;0;227214;250;2;0;0
FR;4;2021-05-27;14328;35;0;0;0;241542;285;2;0;0
FR;4;2021-05-28;26583;82;1;0;0;268125;367;3;0;0
FR;4;2021-05-29;11380;18;0;0;0;279505;385;3;0;0
FR;4;2021-05-30;971;6;0;0;0;280476;391;3;0;0
FR;4;2021-05-31;12688;21;0;0;0;293164;412;3;0;0
FR;4;2021-06-01;20249;46;1;0;0;313413;458;4;0;0
FR;4;2021-06-02;14519;33;0;0;0;327932;491;4;0;0
FR;4;2021-06-03;19411;24;1;0;0;347343;515;5;0;0
FR;4;2021-06-04;22510;47;0;0;0;369853;562;5;0;0
FR;4;2021-06-05;9712;32;0;0;0;379565;594;5;0;0
FR;4;2021-06-06;1039;1;0;0;0;380604;595;5;0;0
FR;4;2021-06-07;9224;19;0;0;0;389828;614;5;0;0
FR;4;2021-06-08;14607;31;0;0;0;404435;645;5;0;0
FR;4;2021-06-09;12203;25;0;0;0;416638;670;5;0;0
FR;4;2021-06-10;15398;30;0;0;0;432036;700;5;0;0
FR;4;2021-06-11;16979;56;0;0;0;449015;756;5;0;0
FR;4;2021-06-12;7444;27;0;0;0;456459;783;5;0;0
FR;4;2021-06-13;907;2;0;0;0;457366;785;5;0;0
FR;4;2021-06-14;6645;25;0;0;0;464011;810;5;0;0
FR;4;2021-06-15;10883;37;0;0;0;474894;847;5;0;0
FR;4;2021-06-16;8904;15;0;0;0;483798;862;5;0;0
FR;4;2021-06-17;10897;36;0;0;0;494695;898;5;0;0
FR;4;2021-06-18;12420;45;0;0;0;507115;943;5;0;0
FR;4;2021-06-19;5567;25;0;0;0;512682;968;5;0;0
FR;4;2021-06-20;819;5;0;0;0;513501;973;5;0;0
FR;4;2021-06-21;5081;20;0;0;0;518582;993;5;0;0
FR;4;2021-06-22;7905;28;2;0;0;526487;1021;7;0;0
FR;4;2021-06-23;7093;40;2;0;0;533580;1061;9;0;0
FR;4;2021-06-24;8647;46;1;0;0;542227;1107;10;0;0
FR;4;2021-06-25;10172;39;2;0;0;552399;1146;12;0;0
FR;4;2021-06-26;4840;21;0;0;0;557239;1167;12;0;0
FR;4;2021-06-27;760;3;0;0;0;557999;1170;12;0;0
FR;4;2021-06-28;4822;16;1;0;0;562821;1186;13;0;0
FR;4;2021-06-29;7098;27;2;0;0;569919;1213;15;0;0
FR;4;2021-06-30;6708;39;2;0;0;576627;1252;17;0;0
FR;4;2021-07-01;8192;40;0;0;0;584819;1292;17;0;0
FR;4;2021-07-02;9412;52;1;0;0;594231;1344;18;0;0
FR;4;2021-07-03;4844;19;0;0;0;599075;1363;18;0;0
FR;4;2021-07-04;686;5;0;0;0;599761;1368;18;0;0
FR;4;2021-07-05;4766;19;2;0;0;604527;1387;20;0;0
FR;4;2021-07-06;7717;28;4;0;0;612244;1415;24;0;0
FR;4;2021-07-07;7069;34;2;0;0;619313;1449;26;0;0
FR;4;2021-07-08;9219;40;2;0;0;628532;1489;28;0;0
FR;4;2021-07-09;10276;34;1;0;0;638808;1523;29;0;0
FR;4;2021-07-10;4634;14;2;0;0;643442;1537;31;0;0
FR;4;2021-07-11;582;4;1;0;0;644024;1541;32;0;0
FR;4;2021-07-12;5868;29;0;0;0;649892;1570;32;0;0
FR;4;2021-07-13;14230;29;0;0;0;664122;1599;32;0;0
FR;4;2021-07-14;2283;14;0;0;0;666405;1613;32;0;0
FR;4;2021-07-15;18232;36;0;0;0;684637;1649;32;0;0
FR;4;2021-07-16;22815;70;2;0;0;707452;1719;34;0;0
FR;4;2021-07-17;9735;20;0;0;0;717187;1739;34;0;0
FR;4;2021-07-18;1354;4;0;0;0;718541;1743;34;0;0
FR;4;2021-07-19;12980;28;1;0;0;731521;1771;35;0;0
FR;4;2021-07-20;17334;26;1;0;0;748855;1797;36;0;0
FR;4;2021-07-21;15606;33;0;0;0;764461;1830;36;0;0
FR;4;2021-07-22;18238;44;2;0;0;782699;1874;38;0;0
FR;4;2021-07-23;20405;57;7;0;0;803104;1931;45;0;0
FR;4;2021-07-24;9282;32;0;0;0;812386;1963;45;0;0
FR;4;2021-07-25;1350;8;0;0;0;813736;1971;45;0;0
FR;4;2021-07-26;11031;20;0;0;0;824767;1991;45;0;0
FR;4;2021-07-27;14662;35;3;0;0;839429;2026;48;0;0
FR;4;2021-07-28;12923;26;2;0;0;852352;2052;50;0;0
FR;4;2021-07-29;14080;54;4;0;0;866432;2106;54;0;0
FR;4;2021-07-30;15480;45;2;0;0;881912;2151;56;0;0
FR;4;2021-07-31;6832;14;2;0;0;888744;2165;58;0;0
FR;4;2021-08-01;905;1;0;0;0;889649;2166;58;0;0
FR;4;2021-08-02;7905;29;0;0;0;897554;2195;58;0;0
FR;4;2021-08-03;10789;32;2;0;0;908343;2227;60;0;0
FR;4;2021-08-04;9734;29;0;0;0;918077;2256;60;0;0
FR;4;2021-08-05;9814;41;0;0;0;927891;2297;60;0;0
FR;4;2021-08-06;10185;30;3;0;0;938076;2327;63;0;0
FR;4;2021-08-07;5090;30;1;0;0;943166;2357;64;0;0
FR;4;2021-08-08;1217;13;0;0;0;944383;2370;64;0;0
FR;4;2021-08-09;6334;31;0;0;0;950717;2401;64;0;0
FR;4;2021-08-10;8742;18;0;0;0;959459;2419;64;0;0
FR;4;2021-08-11;7931;33;4;0;0;967390;2452;68;0;0
FR;4;2021-08-12;8580;29;1;0;0;975970;2481;69;0;0
FR;4;2021-08-13;7548;24;0;1;0;983518;2505;69;1;0
FR;4;2021-08-14;3787;20;0;0;0;987305;2525;69;1;0
FR;4;2021-08-15;769;5;0;0;0;988074;2530;69;1;0
FR;4;2021-08-16;4002;16;0;0;0;992076;2546;69;1;0
FR;4;2021-08-17;5617;17;1;0;0;997693;2563;70;1;0
FR;4;2021-08-18;5165;34;0;0;0;1002858;2597;70;1;0
FR;4;2021-08-19;5476;33;3;0;0;1008334;2630;73;1;0
FR;4;2021-08-20;5210;24;1;0;0;1013544;2654;74;1;0
FR;4;2021-08-21;2307;21;1;0;0;1015851;2675;75;1;0
FR;4;2021-08-22;401;2;0;0;0;1016252;2677;75;1;0
FR;4;2021-08-23;2925;19;1;0;0;1019177;2696;76;1;0
FR;4;2021-08-24;3745;15;0;0;0;1022922;2711;76;1;0
FR;4;2021-08-25;3538;25;0;0;0;1026460;2736;76;1;0
FR;4;2021-08-26;3702;20;2;0;0;1030162;2756;78;1;0
FR;4;2021-08-27;3606;31;2;0;0;1033768;2787;80;1;0
FR;4;2021-08-28;1725;9;1;0;0;1035493;2796;81;1;0
FR;4;2021-08-29;387;7;1;0;0;1035880;2803;82;1;0
FR;4;2021-08-30;2009;24;0;0;14;1037889;2827;82;1;14
FR;4;2021-08-31;2481;20;0;0;13;1040370;2847;82;1;27
FR;4;2021-09-01;2078;38;1;0;21;1042448;2885;83;1;48
FR;4;2021-09-02;2301;31;4;0;18;1044749;2916;87;1;66
FR;4;2021-09-03;2357;44;5;0;32;1047106;2960;92;1;98
FR;4;2021-09-04;1373;17;0;0;8;1048479;2977;92;1;106
FR;4;2021-09-05;431;2;0;0;2;1048910;2979;92;1;108
FR;4;2021-09-06;1706;60;0;0;21;1050616;3039;92;1;129
FR;4;2021-09-07;1675;18;1;0;9;1052291;3057;93;1;138
FR;4;2021-09-08;1280;27;3;1;20;1053571;3084;96;2;158
FR;4;2021-09-09;1385;23;2;0;9;1054956;3107;98;2;167
FR;4;2021-09-10;1517;31;2;0;23;1056473;3138;100;2;190
FR;4;2021-09-11;738;11;0;0;3;1057211;3149;100;2;193
FR;4;2021-09-12;168;4;0;0;2;1057379;3153;100;2;195
FR;4;2021-09-13;1316;22;1;0;16;1058695;3175;101;2;211
FR;4;2021-09-14;1497;9;2;0;6;1060192;3184;103;2;217
FR;4;2021-09-15;1092;27;1;0;24;1061284;3211;104;2;241
FR;4;2021-09-16;1098;22;2;0;15;1062382;3233;106;2;256
FR;4;2021-09-17;890;21;1;0;12;1063272;3254;107;2;268
FR;4;2021-09-18;462;6;1;0;5;1063734;3260;108;2;273
FR;4;2021-09-19;181;3;0;0;2;1063915;3263;108;2;275
FR;4;2021-09-20;448;19;0;0;13;1064363;3282;108;2;288
FR;4;2021-09-21;423;11;0;0;7;1064786;3293;108;2;295
FR;4;2021-09-22;372;19;2;0;13;1065158;3312;110;2;308
FR;4;2021-09-23;477;16;1;0;15;1065635;3328;111;2;323
FR;4;2021-09-24;409;13;2;0;9;1066044;3341;113;2;332
FR;4;2021-09-25;281;9;1;0;4;1066325;3350;114;2;336
FR;4;2021-09-26;73;2;0;0;1;1066398;3352;114;2;337
FR;4;2021-09-27;261;10;1;0;8;1066659;3362;115;2;345
FR;4;2021-09-28;315;8;0;0;8;1066974;3370;115;2;353
FR;4;2021-09-29;372;18;1;0;12;1067346;3388;116;2;365
FR;4;2021-09-30;359;40;0;0;21;1067705;3428;116;2;386
FR;4;2021-10-01;407;49;0;0;43;1068112;3477;116;2;429
FR;4;2021-10-02;195;22;1;0;13;1068307;3499;117;2;442
FR;4;2021-10-03;85;1;0;0;0;1068392;3500;117;2;442
FR;4;2021-10-04;355;19;1;0;15;1068747;3519;118;2;457
FR;4;2021-10-05;276;19;2;0;15;1069023;3538;120;2;472
FR;4;2021-10-06;243;21;1;0;17;1069266;3559;121;2;489
FR;4;2021-10-07;257;25;2;0;13;1069523;3584;123;2;502
FR;4;2021-10-08;353;23;2;0;19;1069876;3607;125;2;521
FR;4;2021-10-09;193;6;6;0;7;1070069;3613;131;2;528
FR;4;2021-10-10;95;3;2;0;3;1070164;3616;133;2;531
FR;4;2021-10-11;246;15;1;0;14;1070410;3631;134;2;545
FR;4;2021-10-12;205;14;0;0;13;1070615;3645;134;2;558
FR;4;2021-10-13;218;27;1;0;24;1070833;3672;135;2;582
FR;4;2021-10-14;307;22;4;0;16;1071140;3694;139;2;598
FR;4;2021-10-15;321;24;5;0;25;1071461;3718;144;2;623
FR;4;2021-10-16;166;6;2;0;6;1071627;3724;146;2;629
FR;4;2021-10-17;70;2;0;0;1;1071697;3726;146;2;630
FR;4;2021-10-18;278;16;1;0;12;1071975;3742;147;2;642
FR;4;2021-10-19;210;14;2;0;15;1072185;3756;149;2;657
FR;4;2021-10-20;225;27;4;0;15;1072410;3783;153;2;672
FR;4;2021-10-21;235;17;0;0;13;1072645;3800;153;2;685
FR;4;2021-10-22;211;25;2;0;20;1072856;3825;155;2;705
FR;4;2021-10-23;115;16;1;0;15;1072971;3841;156;2;720
FR;4;2021-10-24;38;4;0;0;1;1073009;3845;156;2;721
FR;4;2021-10-25;210;7;2;0;9;1073219;3852;158;2;730
FR;4;2021-10-26;196;14;0;0;12;1073415;3866;158;2;742
FR;4;2021-10-27;192;11;4;0;11;1073607;3877;162;2;753
FR;4;2021-10-28;182;18;4;0;21;1073789;3895;166;2;774
FR;4;2021-10-29;220;15;2;0;13;1074009;3910;168;2;787
FR;4;2021-10-30;102;2;1;0;2;1074111;3912;169;2;789
FR;4;2021-10-31;56;3;2;0;3;1074167;3915;171;2;792
FR;4;2021-11-01;75;27;4;0;24;1074242;3942;175;2;816
FR;4;2021-11-02;156;20;2;0;21;1074398;3962;177;2;837
FR;4;2021-11-03;127;20;8;1;18;1074525;3982;185;3;855
FR;4;2021-11-04;176;15;1;0;12;1074701;3997;186;3;867
FR;4;2021-11-05;126;17;1;0;16;1074827;4014;187;3;883
FR;4;2021-11-06;77;6;1;0;6;1074904;4020;188;3;889
FR;4;2021-11-07;76;2;2;0;4;1074980;4022;190;3;893
FR;4;2021-11-08;158;20;1;0;20;1075138;4042;191;3;913
FR;4;2021-11-09;151;14;3;0;16;1075289;4056;194;3;929
FR;4;2021-11-10;114;29;6;0;31;1075403;4085;200;3;960
FR;4;2021-11-11;86;10;0;0;10;1075489;4095;200;3;970
FR;4;2021-11-12;99;19;2;0;18;1075588;4114;202;3;988
FR;4;2021-11-13;73;15;2;0;14;1075661;4129;204;3;1002
FR;4;2021-11-14;53;5;3;0;7;1075714;4134;207;3;1009
FR;4;2021-11-15;97;26;2;0;24;1075811;4160;209;3;1033
FR;4;2021-11-16;101;12;2;0;14;1075912;4172;211;3;1047
FR;4;2021-11-17;116;29;4;0;29;1076028;4201;215;3;1076
FR;4;2021-11-18;99;34;12;0;41;1076127;4235;227;3;1117
FR;4;2021-11-19;79;19;3;0;20;1076206;4254;230;3;1137
FR;4;2021-11-20;75;8;1;0;8;1076281;4262;231;3;1145
FR;4;2021-11-21;61;7;2;0;9;1076342;4269;233;3;1154
FR;4;2021-11-22;101;27;6;0;29;1076443;4296;239;3;1183
FR;4;2021-11-23;74;29;5;0;26;1076517;4325;244;3;1209
FR;4;2021-11-24;85;23;9;0;22;1076602;4348;253;3;1231
FR;4;2021-11-25;84;28;14;0;30;1076686;4376;267;3;1261
FR;4;2021-11-26;81;43;12;0;45;1076767;4419;279;3;1306
FR;4;2021-11-27;35;22;15;0;25;1076802;4441;294;3;1331
FR;4;2021-11-28;48;8;0;0;7;1076850;4449;294;3;1338
FR;4;2021-11-29;86;31;15;0;39;1076936;4480;309;3;1377
FR;4;2021-11-30;72;36;12;0;40;1077008;4516;321;3;1417
FR;4;2021-12-01;79;59;19;0;66;1077087;4575;340;3;1483
FR;4;2021-12-02;98;47;19;0;52;1077185;4622;359;3;1535
FR;4;2021-12-03;98;36;15;0;44;1077283;4658;374;3;1579
FR;4;2021-12-04;70;31;18;0;44;1077353;4689;392;3;1623
FR;4;2021-12-05;61;5;1;0;6;1077414;4694;393;3;1629
FR;4;2021-12-06;98;45;20;0;59;1077512;4739;413;3;1688
FR;4;2021-12-07;77;34;9;0;34;1077589;4773;422;3;1722
FR;4;2021-12-08;67;29;16;0;35;1077656;4802;438;3;1757
FR;4;2021-12-09;61;32;10;0;38;1077717;4834;448;3;1795
FR;4;2021-12-10;60;62;21;0;66;1077777;4896;469;3;1861
FR;4;2021-12-11;24;34;7;0;34;1077801;4930;476;3;1895
FR;4;2021-12-12;23;10;3;0;13;1077824;4940;479;3;1908
FR;4;2021-12-13;68;38;13;0;47;1077892;4978;492;3;1955
FR;4;2021-12-14;56;43;15;0;52;1077948;5021;507;3;2007
FR;4;2021-12-15;59;63;28;0;83;1078007;5084;535;3;2090
FR;4;2021-12-16;31;44;18;0;56;1078038;5128;553;3;2146
FR;4;2021-12-17;39;55;12;0;60;1078077;5183;565;3;2206
FR;4;2021-12-18;48;29;2;0;30;1078125;5212;567;3;2236
FR;4;2021-12-19;15;4;1;0;4;1078140;5216;568;3;2240
FR;4;2021-12-20;36;38;10;0;41;1078176;5254;578;3;2281
FR;4;2021-12-21;26;30;15;0;36;1078202;5284;593;3;2317
FR;4;2021-12-22;36;36;10;0;37;1078238;5320;603;3;2354
FR;4;2021-12-23;39;43;8;0;47;1078277;5363;611;3;2401
FR;4;2021-12-24;23;25;10;0;29;1078300;5388;621;3;2430
FR;4;2021-12-25;6;3;3;0;4;1078306;5391;624;3;2434
FR;4;2021-12-26;4;3;1;0;2;1078310;5394;625;3;2436
FR;4;2021-12-27;27;41;8;0;42;1078337;5435;633;3;2478
FR;4;2021-12-28;24;28;7;0;29;1078361;5463;640;3;2507
FR;4;2021-12-29;48;24;10;0;28;1078409;5487;650;3;2535
FR;4;2021-12-30;41;16;12;0;19;1078450;5503;662;3;2554
FR;4;2021-12-31;18;5;8;0;10;1078468;5508;670;3;2564
FR;4;2022-01-01;5;4;4;0;6;1078473;5512;674;3;2570
FR;4;2022-01-02;40;4;15;0;18;1078513;5516;689;3;2588
FR;4;2022-01-03;38;52;20;1;57;1078551;5568;709;4;2645
FR;4;2022-01-04;31;26;13;0;29;1078582;5594;722;4;2674
FR;4;2022-01-05;46;21;16;0;22;1078628;5615;738;4;2696
FR;4;2022-01-06;43;20;21;0;33;1078671;5635;759;4;2729
FR;4;2022-01-07;28;19;15;0;19;1078699;5654;774;4;2748
FR;4;2022-01-08;8;5;10;0;12;1078707;5659;784;4;2760
FR;4;2022-01-09;17;2;2;0;3;1078724;5661;786;4;2763
FR;4;2022-01-10;39;22;16;0;33;1078763;5683;802;4;2796
FR;4;2022-01-11;23;30;12;0;34;1078786;5713;814;4;2830
FR;4;2022-01-12;31;20;12;0;21;1078817;5733;826;4;2851
FR;4;2022-01-13;48;19;26;0;36;1078865;5752;852;4;2887
FR;4;2022-01-14;22;28;13;0;31;1078887;5780;865;4;2918
FR;4;2022-01-15;10;6;7;0;11;1078897;5786;872;4;2929
FR;4;2022-01-16;9;9;11;0;19;1078906;5795;883;4;2948
FR;4;2022-01-17;23;18;12;0;24;1078929;5813;895;4;2972
FR;4;2022-01-18;16;13;7;0;17;1078945;5826;902;4;2989
FR;4;2022-01-19;29;23;9;0;30;1078974;5849;911;4;3019
FR;4;2022-01-20;31;34;11;0;37;1079005;5883;922;4;3056
FR;4;2022-01-21;9;12;18;1;15;1079014;5895;940;5;3071
FR;4;2022-01-22;30;9;2;0;9;1079044;5904;942;5;3080
FR;4;2022-01-23;6;2;4;0;6;1079050;5906;946;5;3086
FR;4;2022-01-24;14;21;8;0;27;1079064;5927;954;5;3113
FR;4;2022-01-25;20;30;8;1;34;1079084;5957;962;6;3147
FR;4;2022-01-26;19;15;6;1;16;1079103;5972;968;7;3163
FR;4;2022-01-27;19;18;6;0;22;1079122;5990;974;7;3185
FR;4;2022-01-28;12;23;7;0;25;1079134;6013;981;7;3210
FR;4;2022-01-29;15;6;4;0;9;1079149;6019;985;7;3219
FR;4;2022-01-30;16;2;0;0;2;1079165;6021;985;7;3221
FR;4;2022-01-31;19;27;6;0;29;1079184;6048;991;7;3250
FR;4;2022-02-01;9;19;11;0;19;1079193;6067;1002;7;3269
FR;4;2022-02-02;16;11;10;2;16;1079209;6078;1012;9;3285
FR;4;2022-02-03;12;22;9;0;25;1079221;6100;1021;9;3310
FR;4;2022-02-04;6;5;7;0;9;1079227;6105;1028;9;3319
FR;4;2022-02-05;6;14;1;0;13;1079233;6119;1029;9;3332
FR;4;2022-02-06;5;2;2;0;3;1079238;6121;1031;9;3335
FR;4;2022-02-07;13;19;6;0;18;1079251;6140;1037;9;3353
FR;4;2022-02-08;15;19;13;1;20;1079266;6159;1050;10;3373
FR;4;2022-02-09;14;10;7;0;13;1079280;6169;1057;10;3386
FR;4;2022-02-10;18;23;9;0;24;1079298;6192;1066;10;3410
FR;4;2022-02-11;18;14;8;0;19;1079316;6206;1074;10;3429
FR;4;2022-02-12;23;6;1;0;5;1079339;6212;1075;10;3434
FR;4;2022-02-13;7;3;3;0;6;1079346;6215;1078;10;3440
FR;4;2022-02-14;18;10;7;0;13;1079364;6225;1085;10;3453
FR;4;2022-02-15;16;7;1;0;7;1079380;6232;1086;10;3460
FR;4;2022-02-16;11;9;10;0;15;1079391;6241;1096;10;3475
FR;4;2022-02-17;10;4;4;0;6;1079401;6245;1100;10;3481
FR;4;2022-02-18;17;13;6;0;17;1079418;6258;1106;10;3498
FR;4;2022-02-19;16;2;2;0;4;1079434;6260;1108;10;3502
FR;4;2022-02-20;7;2;0;0;1;1079441;6262;1108;10;3503
FR;4;2022-02-21;22;3;3;0;4;1079463;6265;1111;10;3507
FR;4;2022-02-22;8;4;8;0;8;1079471;6269;1119;10;3515
FR;4;2022-02-23;16;6;9;0;9;1079487;6275;1128;10;3524
FR;4;2022-02-24;9;4;2;0;4;1079496;6279;1130;10;3528
FR;4;2022-02-25;15;5;7;0;6;1079511;6284;1137;10;3534
FR;4;2022-02-26;26;3;0;0;3;1079537;6287;1137;10;3537
FR;4;2022-02-27;9;0;1;0;1;1079546;6287;1138;10;3538
FR;4;2022-02-28;14;3;2;0;3;1079560;6290;1140;10;3541
FR;4;2022-03-01;6;2;7;0;3;1079566;6292;1147;10;3544
FR;4;2022-03-02;10;2;3;0;4;1079576;6294;1150;10;3548
FR;4;2022-03-03;15;5;1;0;4;1079591;6299;1151;10;3552
FR;4;2022-03-04;6;7;2;1;5;1079597;6306;1153;11;3557
FR;4;2022-03-05;9;2;0;0;2;1079606;6308;1153;11;3559
FR;4;2022-03-06;4;0;1;0;1;1079610;6308;1154;11;3560
FR;4;2022-03-07;10;4;1;0;3;1079620;6312;1155;11;3563
FR;4;2022-03-08;13;2;0;0;2;1079633;6314;1155;11;3565
FR;4;2022-03-09;7;3;2;0;4;1079640;6317;1157;11;3569
FR;4;2022-03-10;5;1;5;0;2;1079645;6318;1162;11;3571
FR;4;2022-03-11;8;2;5;0;1;1079653;6320;1167;11;3572
FR;4;2022-03-12;9;2;0;0;0;1079662;6322;1167;11;3572
FR;4;2022-03-13;5;0;1;0;1;1079667;6322;1168;11;3573
FR;4;2022-03-14;4;1;0;0;1;1079671;6323;1168;11;3574
FR;4;2022-03-15;5;3;1;0;1;1079676;6326;1169;11;3575
FR;4;2022-03-16;6;3;3;0;3;1079682;6329;1172;11;3578
FR;4;2022-03-17;2;4;1;0;5;1079684;6333;1173;11;3583
FR;4;2022-03-18;7;3;0;0;3;1079691;6336;1173;11;3586
FR;4;2022-03-19;1;1;0;0;1;1079692;6337;1173;11;3587
FR;4;2022-03-20;2;0;2;0;1;1079694;6337;1175;11;3588
FR;4;2022-03-21;5;3;0;0;3;1079699;6340;1175;11;3591
FR;4;2022-03-22;3;2;1;0;2;1079702;6342;1176;11;3593
FR;4;2022-03-23;6;4;4;0;7;1079708;6346;1180;11;3600
FR;4;2022-03-24;2;4;3;1;5;1079710;6350;1183;12;3605
FR;4;2022-03-25;3;1;2;0;1;1079713;6351;1185;12;3606
FR;4;2022-03-26;5;5;0;0;5;1079718;6356;1185;12;3611
FR;4;2022-03-27;1;0;1;0;0;1079719;6356;1186;12;3611
FR;4;2022-03-28;4;1;3;0;3;1079723;6357;1189;12;3614
FR;4;2022-03-29;7;0;4;1;0;1079730;6357;1193;13;3614
FR;4;2022-03-30;1;4;0;0;4;1079731;6361;1193;13;3618
FR;4;2022-03-31;1;3;1;1;3;1079732;6364;1194;14;3621
FR;4;2022-04-01;13;3;5;0;6;1079745;6367;1199;14;3627
FR;4;2022-04-02;4;4;0;0;3;1079749;6371;1199;14;3630
FR;4;2022-04-03;0;0;0;0;0;1079749;6371;1199;14;3630
FR;4;2022-04-04;3;3;4;0;3;1079752;6374;1203;14;3633
FR;4;2022-04-05;3;4;1;1;2;1079755;6378;1204;15;3635
FR;4;2022-04-06;3;0;0;0;0;1079758;6378;1204;15;3635
FR;4;2022-04-07;3;2;1;2;3;1079761;6380;1205;17;3638
FR;4;2022-04-08;4;1;1;0;1;1079765;6381;1206;17;3639
FR;4;2022-04-09;0;0;1;1;1;1079765;6381;1207;18;3640
FR;4;2022-04-10;1;2;0;0;2;1079766;6383;1207;18;3642
FR;4;2022-04-11;3;2;4;0;4;1079769;6385;1211;18;3646
FR;4;2022-04-12;2;1;4;0;2;1079771;6386;1215;18;3648
FR;4;2022-04-13;3;6;1;0;7;1079774;6392;1216;18;3655
FR;4;2022-04-14;5;3;0;1;2;1079779;6395;1216;19;3657
FR;4;2022-04-15;2;7;1;0;8;1079781;6402;1217;19;3665
FR;4;2022-04-16;1;0;0;0;0;1079782;6402;1217;19;3665
FR;4;2022-04-17;1;1;0;0;1;1079783;6403;1217;19;3666
FR;4;2022-04-18;1;2;4;0;2;1079784;6405;1221;19;3668
FR;4;2022-04-19;2;0;1;0;0;1079786;6405;1222;19;3668
FR;4;2022-04-20;13;3;1;0;2;1079799;6408;1223;19;3670
FR;4;2022-04-21;5;1;0;0;1;1079804;6409;1223;19;3671
FR;4;2022-04-22;1;0;1;0;0;1079805;6409;1224;19;3671
FR;4;2022-04-23;1;3;2;0;5;1079806;6412;1226;19;3676
FR;4;2022-04-24;0;2;0;0;2;1079806;6414;1226;19;3678
FR;4;2022-04-25;3;4;3;0;7;1079809;6418;1229;19;3685
FR;4;2022-04-26;3;4;1;0;4;1079812;6422;1230;19;3689
FR;4;2022-04-27;4;0;0;0;0;1079816;6422;1230;19;3689
FR;4;2022-04-28;2;5;5;0;6;1079818;6427;1235;19;3695
FR;4;2022-04-29;3;2;0;0;1;1079821;6429;1235;19;3696
FR;4;2022-04-30;0;1;1;0;2;1079821;6430;1236;19;3698
FR;4;2022-05-01;0;0;0;0;0;1079821;6430;1236;19;3698
FR;4;2022-05-02;4;8;5;0;10;1079825;6438;1241;19;3708
FR;4;2022-05-03;0;2;1;0;2;1079825;6440;1242;19;3710
FR;4;2022-05-04;4;4;1;0;4;1079829;6444;1243;19;3714
FR;4;2022-05-05;2;1;1;0;1;1079831;6445;1244;19;3715
FR;4;2022-05-06;2;0;0;0;0;1079833;6445;1244;19;3715
FR;4;2022-05-07;0;0;0;0;0;1079833;6445;1244;19;3715
FR;4;2022-05-08;1;1;0;0;1;1079834;6446;1244;19;3716
FR;4;2022-05-09;5;0;0;0;0;1079839;6446;1244;19;3716
FR;4;2022-05-10;0;0;0;2;2;1079839;6446;1244;21;3718
FR;4;2022-05-11;2;1;0;0;1;1079841;6447;1244;21;3719
FR;4;2022-05-12;5;1;1;1;2;1079846;6448;1245;22;3721
FR;4;2022-05-13;0;0;2;0;2;1079846;6448;1247;22;3723
FR;4;2022-05-14;0;2;0;0;2;1079846;6450;1247;22;3725
FR;4;2022-05-15;1;2;0;0;0;1079847;6452;1247;22;3725
FR;4;2022-05-16;5;2;1;0;2;1079852;6454;1248;22;3727
FR;4;2022-05-17;3;1;1;0;2;1079855;6455;1249;22;3729
FR;4;2022-05-18;0;1;0;0;1;1079855;6456;1249;22;3730
FR;4;2022-05-19;2;1;2;0;2;1079857;6457;1251;22;3732
FR;4;2022-05-20;1;0;3;0;0;1079858;6457;1254;22;3732
FR;4;2022-05-21;2;0;1;0;1;1079860;6457;1255;22;3733
FR;4;2022-05-22;0;0;1;0;1;1079860;6457;1256;22;3734
FR;4;2022-05-23;0;0;2;0;0;1079860;6457;1258;22;3734
FR;4;2022-05-24;1;1;0;0;1;1079861;6458;1258;22;3735
FR;4;2022-05-25;1;1;0;0;0;1079862;6459;1258;22;3735
FR;4;2022-05-26;1;0;0;0;0;1079863;6459;1258;22;3735
FR;4;2022-05-27;0;0;0;0;0;1079863;6459;1258;22;3735
FR;4;2022-05-28;0;0;0;0;0;1079863;6459;1258;22;3735
FR;4;2022-05-29;0;0;0;0;0;1079863;6459;1258;22;3735
FR;4;2022-05-30;1;0;1;0;1;1079864;6459;1259;22;3736
FR;4;2022-05-31;2;0;0;0;0;1079866;6459;1259;22;3736
FR;4;2022-06-01;0;0;0;0;0;1079866;6459;1259;22;3736
FR;4;2022-06-02;0;0;0;0;0;1079866;6459;1259;22;3736
FR;4;2022-06-03;0;0;0;0;0;1079866;6459;1259;22;3736
FR;4;2022-06-04;0;0;0;0;0;1079866;6459;1259;22;3736
FR;4;2022-06-05;0;0;0;0;0;1079866;6459;1259;22;3736
FR;4;2022-06-06;1;0;0;0;0;1079867;6459;1259;22;3736
FR;4;2022-06-07;2;0;0;0;0;1079869;6459;1259;22;3736
FR;5;2020-12-27;0;0;0;0;0;0;0;0;0;0
FR;5;2020-12-28;0;0;0;0;0;0;0;0;0;0
FR;5;2020-12-29;0;0;0;0;0;0;0;0;0;0
FR;5;2020-12-30;0;0;0;0;0;0;0;0;0;0
FR;5;2020-12-31;0;0;0;0;0;0;0;0;0;0
FR;5;2021-01-01;0;0;0;0;0;0;0;0;0;0
FR;5;2021-01-02;0;0;0;0;0;0;0;0;0;0
FR;5;2021-01-03;0;0;0;0;0;0;0;0;0;0
FR;5;2021-01-04;0;0;0;0;0;0;0;0;0;0
FR;5;2021-01-05;0;0;0;0;0;0;0;0;0;0
FR;5;2021-01-06;0;0;0;0;0;0;0;0;0;0
FR;5;2021-01-07;0;0;0;0;0;0;0;0;0;0
FR;5;2021-01-08;0;0;0;0;0;0;0;0;0;0
FR;5;2021-01-09;0;0;0;0;0;0;0;0;0;0
FR;5;2021-01-10;0;0;0;0;0;0;0;0;0;0
FR;5;2021-01-11;0;0;0;0;0;0;0;0;0;0
FR;5;2021-01-12;0;0;0;0;0;0;0;0;0;0
FR;5;2021-01-13;0;0;0;0;0;0;0;0;0;0
FR;5;2021-01-14;0;0;0;0;0;0;0;0;0;0
FR;5;2021-01-15;0;0;0;0;0;0;0;0;0;0
FR;5;2021-01-16;0;0;0;0;0;0;0;0;0;0
FR;5;2021-01-17;0;0;0;0;0;0;0;0;0;0
FR;5;2021-01-18;0;0;0;0;0;0;0;0;0;0
FR;5;2021-01-19;0;0;0;0;0;0;0;0;0;0
FR;5;2021-01-20;0;0;0;0;0;0;0;0;0;0
FR;5;2021-01-21;0;0;0;0;0;0;0;0;0;0
FR;5;2021-01-22;0;0;0;0;0;0;0;0;0;0
FR;5;2021-01-23;0;0;0;0;0;0;0;0;0;0
FR;5;2021-01-24;0;0;0;0;0;0;0;0;0;0
FR;5;2021-01-25;0;0;0;0;0;0;0;0;0;0
FR;5;2021-01-26;0;0;0;0;0;0;0;0;0;0
FR;5;2021-01-27;0;0;0;0;0;0;0;0;0;0
FR;5;2021-01-28;0;0;0;0;0;0;0;0;0;0
FR;5;2021-01-29;0;0;0;0;0;0;0;0;0;0
FR;5;2021-01-30;0;0;0;0;0;0;0;0;0;0
FR;5;2021-01-31;0;0;0;0;0;0;0;0;0;0
FR;5;2021-02-01;0;0;0;0;0;0;0;0;0;0
FR;5;2021-02-02;0;0;0;0;0;0;0;0;0;0
FR;5;2021-02-03;0;0;0;0;0;0;0;0;0;0
FR;5;2021-02-04;0;0;0;0;0;0;0;0;0;0
FR;5;2021-02-05;0;0;0;0;0;0;0;0;0;0
FR;5;2021-02-06;0;0;0;0;0;0;0;0;0;0
FR;5;2021-02-07;0;0;0;0;0;0;0;0;0;0
FR;5;2021-02-08;0;0;0;0;0;0;0;0;0;0
FR;5;2021-02-09;0;0;0;0;0;0;0;0;0;0
FR;5;2021-02-10;0;0;0;0;0;0;0;0;0;0
FR;5;2021-02-11;0;0;0;0;0;0;0;0;0;0
FR;5;2021-02-12;0;0;0;0;0;0;0;0;0;0
FR;5;2021-02-13;0;0;0;0;0;0;0;0;0;0
FR;5;2021-02-14;0;0;0;0;0;0;0;0;0;0
FR;5;2021-02-15;0;0;0;0;0;0;0;0;0;0
FR;5;2021-02-16;0;0;0;0;0;0;0;0;0;0
FR;5;2021-02-17;0;0;0;0;0;0;0;0;0;0
FR;5;2021-02-18;0;0;0;0;0;0;0;0;0;0
FR;5;2021-02-19;0;0;0;0;0;0;0;0;0;0
FR;5;2021-02-20;0;0;0;0;0;0;0;0;0;0
FR;5;2021-02-21;0;0;0;0;0;0;0;0;0;0
FR;5;2021-02-22;0;0;0;0;0;0;0;0;0;0
FR;5;2021-02-23;0;0;0;0;0;0;0;0;0;0
FR;5;2021-02-24;0;0;0;0;0;0;0;0;0;0
FR;5;2021-02-25;0;0;0;0;0;0;0;0;0;0
FR;5;2021-02-26;0;0;0;0;0;0;0;0;0;0
FR;5;2021-02-27;0;0;0;0;0;0;0;0;0;0
FR;5;2021-02-28;0;0;0;0;0;0;0;0;0;0
FR;5;2021-03-01;0;0;0;0;0;0;0;0;0;0
FR;5;2021-03-02;0;0;0;0;0;0;0;0;0;0
FR;5;2021-03-03;0;0;0;0;0;0;0;0;0;0
FR;5;2021-03-04;0;0;0;0;0;0;0;0;0;0
FR;5;2021-03-05;0;0;0;0;0;0;0;0;0;0
FR;5;2021-03-06;0;0;0;0;0;0;0;0;0;0
FR;5;2021-03-07;0;0;0;0;0;0;0;0;0;0
FR;5;2021-03-08;0;0;0;0;0;0;0;0;0;0
FR;5;2021-03-09;0;0;0;0;0;0;0;0;0;0
FR;5;2021-03-10;0;0;0;0;0;0;0;0;0;0
FR;5;2021-03-11;0;0;0;0;0;0;0;0;0;0
FR;5;2021-03-12;0;0;0;0;0;0;0;0;0;0
FR;5;2021-03-13;0;0;0;0;0;0;0;0;0;0
FR;5;2021-03-14;0;0;0;0;0;0;0;0;0;0
FR;5;2021-03-15;0;0;0;0;0;0;0;0;0;0
FR;5;2021-03-16;0;0;0;0;0;0;0;0;0;0
FR;5;2021-03-17;0;0;0;0;0;0;0;0;0;0
FR;5;2021-03-18;0;0;0;0;0;0;0;0;0;0
FR;5;2021-03-19;0;0;0;0;0;0;0;0;0;0
FR;5;2021-03-20;0;0;0;0;0;0;0;0;0;0
FR;5;2021-03-21;0;0;0;0;0;0;0;0;0;0
FR;5;2021-03-22;0;0;0;0;0;0;0;0;0;0
FR;5;2021-03-23;0;0;0;0;0;0;0;0;0;0
FR;5;2021-03-24;0;0;0;0;0;0;0;0;0;0
FR;5;2021-03-25;0;0;0;0;0;0;0;0;0;0
FR;5;2021-03-26;0;0;0;0;0;0;0;0;0;0
FR;5;2021-03-27;0;0;0;0;0;0;0;0;0;0
FR;5;2021-03-28;0;0;0;0;0;0;0;0;0;0
FR;5;2021-03-29;0;0;0;0;0;0;0;0;0;0
FR;5;2021-03-30;0;0;0;0;0;0;0;0;0;0
FR;5;2021-03-31;0;0;0;0;0;0;0;0;0;0
FR;5;2021-04-01;0;0;0;0;0;0;0;0;0;0
FR;5;2021-04-02;0;0;0;0;0;0;0;0;0;0
FR;5;2021-04-03;0;0;0;0;0;0;0;0;0;0
FR;5;2021-04-04;0;0;0;0;0;0;0;0;0;0
FR;5;2021-04-05;0;0;0;0;0;0;0;0;0;0
FR;5;2021-04-06;0;0;0;0;0;0;0;0;0;0
FR;5;2021-04-07;0;0;0;0;0;0;0;0;0;0
FR;5;2021-04-08;0;0;0;0;0;0;0;0;0;0
FR;5;2021-04-09;0;0;0;0;0;0;0;0;0;0
FR;5;2021-04-10;0;0;0;0;0;0;0;0;0;0
FR;5;2021-04-11;0;0;0;0;0;0;0;0;0;0
FR;5;2021-04-12;0;0;0;0;0;0;0;0;0;0
FR;5;2021-04-13;0;0;0;0;0;0;0;0;0;0
FR;5;2021-04-14;0;0;0;0;0;0;0;0;0;0
FR;5;2021-04-15;0;0;0;0;0;0;0;0;0;0
FR;5;2021-04-16;0;0;0;0;0;0;0;0;0;0
FR;5;2021-04-17;0;0;0;0;0;0;0;0;0;0
FR;5;2021-04-18;0;0;0;0;0;0;0;0;0;0
FR;5;2021-04-19;0;0;0;0;0;0;0;0;0;0
FR;5;2021-04-20;0;0;0;0;0;0;0;0;0;0
FR;5;2021-04-21;0;0;0;0;0;0;0;0;0;0
FR;5;2021-04-22;0;0;0;0;0;0;0;0;0;0
FR;5;2021-04-23;0;0;0;0;0;0;0;0;0;0
FR;5;2021-04-24;0;0;0;0;0;0;0;0;0;0
FR;5;2021-04-25;0;0;0;0;0;0;0;0;0;0
FR;5;2021-04-26;0;0;0;0;0;0;0;0;0;0
FR;5;2021-04-27;0;0;0;0;0;0;0;0;0;0
FR;5;2021-04-28;0;0;0;0;0;0;0;0;0;0
FR;5;2021-04-29;0;0;0;0;0;0;0;0;0;0
FR;5;2021-04-30;0;0;0;0;0;0;0;0;0;0
FR;5;2021-05-01;0;0;0;0;0;0;0;0;0;0
FR;5;2021-05-02;0;0;0;0;0;0;0;0;0;0
FR;5;2021-05-03;0;0;0;0;0;0;0;0;0;0
FR;5;2021-05-04;0;0;0;0;0;0;0;0;0;0
FR;5;2021-05-05;0;0;0;0;0;0;0;0;0;0
FR;5;2021-05-06;0;0;0;0;0;0;0;0;0;0
FR;5;2021-05-07;0;0;0;0;0;0;0;0;0;0
FR;5;2021-05-08;0;0;0;0;0;0;0;0;0;0
FR;5;2021-05-09;0;0;0;0;0;0;0;0;0;0
FR;5;2021-05-10;0;0;0;0;0;0;0;0;0;0
FR;5;2021-05-11;0;0;0;0;0;0;0;0;0;0
FR;5;2021-05-12;0;0;0;0;0;0;0;0;0;0
FR;5;2021-05-13;0;0;0;0;0;0;0;0;0;0
FR;5;2021-05-14;0;0;0;0;0;0;0;0;0;0
FR;5;2021-05-15;0;0;0;0;0;0;0;0;0;0
FR;5;2021-05-16;0;0;0;0;0;0;0;0;0;0
FR;5;2021-05-17;0;0;0;0;0;0;0;0;0;0
FR;5;2021-05-18;0;0;0;0;0;0;0;0;0;0
FR;5;2021-05-19;0;0;0;0;0;0;0;0;0;0
FR;5;2021-05-20;0;0;0;0;0;0;0;0;0;0
FR;5;2021-05-21;0;0;0;0;0;0;0;0;0;0
FR;5;2021-05-22;0;0;0;0;0;0;0;0;0;0
FR;5;2021-05-23;0;0;0;0;0;0;0;0;0;0
FR;5;2021-05-24;0;0;0;0;0;0;0;0;0;0
FR;5;2021-05-25;0;0;0;0;0;0;0;0;0;0
FR;5;2021-05-26;0;0;0;0;0;0;0;0;0;0
FR;5;2021-05-27;0;0;0;0;0;0;0;0;0;0
FR;5;2021-05-28;0;0;0;0;0;0;0;0;0;0
FR;5;2021-05-29;0;0;0;0;0;0;0;0;0;0
FR;5;2021-05-30;0;0;0;0;0;0;0;0;0;0
FR;5;2021-05-31;0;0;0;0;0;0;0;0;0;0
FR;5;2021-06-01;0;0;0;0;0;0;0;0;0;0
FR;5;2021-06-02;0;0;0;0;0;0;0;0;0;0
FR;5;2021-06-03;0;0;0;0;0;0;0;0;0;0
FR;5;2021-06-04;0;0;0;0;0;0;0;0;0;0
FR;5;2021-06-05;0;0;0;0;0;0;0;0;0;0
FR;5;2021-06-06;0;0;0;0;0;0;0;0;0;0
FR;5;2021-06-07;0;0;0;0;0;0;0;0;0;0
FR;5;2021-06-08;0;0;0;0;0;0;0;0;0;0
FR;5;2021-06-09;0;0;0;0;0;0;0;0;0;0
FR;5;2021-06-10;0;0;0;0;0;0;0;0;0;0
FR;5;2021-06-11;0;0;0;0;0;0;0;0;0;0
FR;5;2021-06-12;0;0;0;0;0;0;0;0;0;0
FR;5;2021-06-13;0;0;0;0;0;0;0;0;0;0
FR;5;2021-06-14;0;0;0;0;0;0;0;0;0;0
FR;5;2021-06-15;0;0;0;0;0;0;0;0;0;0
FR;5;2021-06-16;0;0;0;0;0;0;0;0;0;0
FR;5;2021-06-17;0;0;0;0;0;0;0;0;0;0
FR;5;2021-06-18;0;0;0;0;0;0;0;0;0;0
FR;5;2021-06-19;0;0;0;0;0;0;0;0;0;0
FR;5;2021-06-20;0;0;0;0;0;0;0;0;0;0
FR;5;2021-06-21;0;0;0;0;0;0;0;0;0;0
FR;5;2021-06-22;0;0;0;0;0;0;0;0;0;0
FR;5;2021-06-23;0;0;0;0;0;0;0;0;0;0
FR;5;2021-06-24;0;0;0;0;0;0;0;0;0;0
FR;5;2021-06-25;0;0;0;0;0;0;0;0;0;0
FR;5;2021-06-26;0;0;0;0;0;0;0;0;0;0
FR;5;2021-06-27;0;0;0;0;0;0;0;0;0;0
FR;5;2021-06-28;0;0;0;0;0;0;0;0;0;0
FR;5;2021-06-29;0;0;0;0;0;0;0;0;0;0
FR;5;2021-06-30;0;0;0;0;0;0;0;0;0;0
FR;5;2021-07-01;0;0;0;0;0;0;0;0;0;0
FR;5;2021-07-02;0;0;0;0;0;0;0;0;0;0
FR;5;2021-07-03;0;0;0;0;0;0;0;0;0;0
FR;5;2021-07-04;0;0;0;0;0;0;0;0;0;0
FR;5;2021-07-05;0;0;0;0;0;0;0;0;0;0
FR;5;2021-07-06;0;0;0;0;0;0;0;0;0;0
FR;5;2021-07-07;0;0;0;0;0;0;0;0;0;0
FR;5;2021-07-08;0;0;0;0;0;0;0;0;0;0
FR;5;2021-07-09;0;0;0;0;0;0;0;0;0;0
FR;5;2021-07-10;0;0;0;0;0;0;0;0;0;0
FR;5;2021-07-11;0;0;0;0;0;0;0;0;0;0
FR;5;2021-07-12;0;0;0;0;0;0;0;0;0;0
FR;5;2021-07-13;0;0;0;0;0;0;0;0;0;0
FR;5;2021-07-14;0;0;0;0;0;0;0;0;0;0
FR;5;2021-07-15;0;0;0;0;0;0;0;0;0;0
FR;5;2021-07-16;0;0;0;0;0;0;0;0;0;0
FR;5;2021-07-17;0;0;0;0;0;0;0;0;0;0
FR;5;2021-07-18;0;0;0;0;0;0;0;0;0;0
FR;5;2021-07-19;0;0;0;0;0;0;0;0;0;0
FR;5;2021-07-20;0;0;0;0;0;0;0;0;0;0
FR;5;2021-07-21;0;0;0;0;0;0;0;0;0;0
FR;5;2021-07-22;0;0;0;0;0;0;0;0;0;0
FR;5;2021-07-23;0;0;0;0;0;0;0;0;0;0
FR;5;2021-07-24;0;0;0;0;0;0;0;0;0;0
FR;5;2021-07-25;0;0;0;0;0;0;0;0;0;0
FR;5;2021-07-26;0;0;0;0;0;0;0;0;0;0
FR;5;2021-07-27;0;0;0;0;0;0;0;0;0;0
FR;5;2021-07-28;0;0;0;0;0;0;0;0;0;0
FR;5;2021-07-29;0;0;0;0;0;0;0;0;0;0
FR;5;2021-07-30;0;0;0;0;0;0;0;0;0;0
FR;5;2021-07-31;0;0;0;0;0;0;0;0;0;0
FR;5;2021-08-01;0;0;0;0;0;0;0;0;0;0
FR;5;2021-08-02;0;0;0;0;0;0;0;0;0;0
FR;5;2021-08-03;0;0;0;0;0;0;0;0;0;0
FR;5;2021-08-04;0;0;0;0;0;0;0;0;0;0
FR;5;2021-08-05;0;0;0;0;0;0;0;0;0;0
FR;5;2021-08-06;0;0;0;0;0;0;0;0;0;0
FR;5;2021-08-07;0;0;0;0;0;0;0;0;0;0
FR;5;2021-08-08;0;0;0;0;0;0;0;0;0;0
FR;5;2021-08-09;0;0;0;0;0;0;0;0;0;0
FR;5;2021-08-10;0;0;0;0;0;0;0;0;0;0
FR;5;2021-08-11;0;0;0;0;0;0;0;0;0;0
FR;5;2021-08-12;0;0;0;0;0;0;0;0;0;0
FR;5;2021-08-13;0;0;0;0;0;0;0;0;0;0
FR;5;2021-08-14;0;0;0;0;0;0;0;0;0;0
FR;5;2021-08-15;0;0;0;0;0;0;0;0;0;0
FR;5;2021-08-16;0;0;0;0;0;0;0;0;0;0
FR;5;2021-08-17;0;0;0;0;0;0;0;0;0;0
FR;5;2021-08-18;0;0;0;0;0;0;0;0;0;0
FR;5;2021-08-19;0;0;0;0;0;0;0;0;0;0
FR;5;2021-08-20;0;0;0;0;0;0;0;0;0;0
FR;5;2021-08-21;0;0;0;0;0;0;0;0;0;0
FR;5;2021-08-22;0;0;0;0;0;0;0;0;0;0
FR;5;2021-08-23;0;0;0;0;0;0;0;0;0;0
FR;5;2021-08-24;0;0;0;0;0;0;0;0;0;0
FR;5;2021-08-25;0;0;0;0;0;0;0;0;0;0
FR;5;2021-08-26;0;0;0;0;0;0;0;0;0;0
FR;5;2021-08-27;0;0;0;0;0;0;0;0;0;0
FR;5;2021-08-28;0;0;0;0;0;0;0;0;0;0
FR;5;2021-08-29;0;0;0;0;0;0;0;0;0;0
FR;5;2021-08-30;0;0;0;0;0;0;0;0;0;0
FR;5;2021-08-31;0;0;0;0;0;0;0;0;0;0
FR;5;2021-09-01;0;0;0;0;0;0;0;0;0;0
FR;5;2021-09-02;0;0;0;0;0;0;0;0;0;0
FR;5;2021-09-03;0;0;0;0;0;0;0;0;0;0
FR;5;2021-09-04;0;0;0;0;0;0;0;0;0;0
FR;5;2021-09-05;0;0;0;0;0;0;0;0;0;0
FR;5;2021-09-06;0;0;0;0;0;0;0;0;0;0
FR;5;2021-09-07;0;0;0;0;0;0;0;0;0;0
FR;5;2021-09-08;0;0;0;0;0;0;0;0;0;0
FR;5;2021-09-09;0;0;0;0;0;0;0;0;0;0
FR;5;2021-09-10;0;0;0;0;0;0;0;0;0;0
FR;5;2021-09-11;0;0;0;0;0;0;0;0;0;0
FR;5;2021-09-12;0;0;0;0;0;0;0;0;0;0
FR;5;2021-09-13;0;0;0;0;0;0;0;0;0;0
FR;5;2021-09-14;0;0;0;0;0;0;0;0;0;0
FR;5;2021-09-15;0;0;0;0;0;0;0;0;0;0
FR;5;2021-09-16;0;0;0;0;0;0;0;0;0;0
FR;5;2021-09-17;0;0;0;0;0;0;0;0;0;0
FR;5;2021-09-18;0;0;0;0;0;0;0;0;0;0
FR;5;2021-09-19;0;0;0;0;0;0;0;0;0;0
FR;5;2021-09-20;0;0;0;0;0;0;0;0;0;0
FR;5;2021-09-21;0;0;0;0;0;0;0;0;0;0
FR;5;2021-09-22;0;0;0;0;0;0;0;0;0;0
FR;5;2021-09-23;0;0;0;0;0;0;0;0;0;0
FR;5;2021-09-24;0;0;0;0;0;0;0;0;0;0
FR;5;2021-09-25;0;0;0;0;0;0;0;0;0;0
FR;5;2021-09-26;0;0;0;0;0;0;0;0;0;0
FR;5;2021-09-27;0;0;0;0;0;0;0;0;0;0
FR;5;2021-09-28;0;0;0;0;0;0;0;0;0;0
FR;5;2021-09-29;0;0;0;0;0;0;0;0;0;0
FR;5;2021-09-30;0;0;0;0;0;0;0;0;0;0
FR;5;2021-10-01;0;0;0;0;0;0;0;0;0;0
FR;5;2021-10-02;0;0;0;0;0;0;0;0;0;0
FR;5;2021-10-03;0;0;0;0;0;0;0;0;0;0
FR;5;2021-10-04;0;0;0;0;0;0;0;0;0;0
FR;5;2021-10-05;0;0;0;0;0;0;0;0;0;0
FR;5;2021-10-06;0;0;0;0;0;0;0;0;0;0
FR;5;2021-10-07;0;0;0;0;0;0;0;0;0;0
FR;5;2021-10-08;0;0;0;0;0;0;0;0;0;0
FR;5;2021-10-09;0;0;0;0;0;0;0;0;0;0
FR;5;2021-10-10;0;0;0;0;0;0;0;0;0;0
FR;5;2021-10-11;0;0;0;0;0;0;0;0;0;0
FR;5;2021-10-12;0;0;0;0;0;0;0;0;0;0
FR;5;2021-10-13;0;0;0;0;0;0;0;0;0;0
FR;5;2021-10-14;0;0;0;0;0;0;0;0;0;0
FR;5;2021-10-15;0;0;0;0;0;0;0;0;0;0
FR;5;2021-10-16;0;0;0;0;0;0;0;0;0;0
FR;5;2021-10-17;0;0;0;0;0;0;0;0;0;0
FR;5;2021-10-18;0;0;0;0;0;0;0;0;0;0
FR;5;2021-10-19;0;0;0;0;0;0;0;0;0;0
FR;5;2021-10-20;0;0;0;0;0;0;0;0;0;0
FR;5;2021-10-21;0;0;0;0;0;0;0;0;0;0
FR;5;2021-10-22;0;0;0;0;0;0;0;0;0;0
FR;5;2021-10-23;0;0;0;0;0;0;0;0;0;0
FR;5;2021-10-24;0;0;0;0;0;0;0;0;0;0
FR;5;2021-10-25;0;0;0;0;0;0;0;0;0;0
FR;5;2021-10-26;0;0;0;0;0;0;0;0;0;0
FR;5;2021-10-27;0;0;0;0;0;0;0;0;0;0
FR;5;2021-10-28;0;0;0;0;0;0;0;0;0;0
FR;5;2021-10-29;0;0;0;0;0;0;0;0;0;0
FR;5;2021-10-30;0;0;0;0;0;0;0;0;0;0
FR;5;2021-10-31;0;0;0;0;0;0;0;0;0;0
FR;5;2021-11-01;0;0;0;0;0;0;0;0;0;0
FR;5;2021-11-02;0;0;0;0;0;0;0;0;0;0
FR;5;2021-11-03;0;0;0;0;0;0;0;0;0;0
FR;5;2021-11-04;0;0;0;0;0;0;0;0;0;0
FR;5;2021-11-05;0;0;0;0;0;0;0;0;0;0
FR;5;2021-11-06;0;0;0;0;0;0;0;0;0;0
FR;5;2021-11-07;0;0;0;0;0;0;0;0;0;0
FR;5;2021-11-08;0;0;0;0;0;0;0;0;0;0
FR;5;2021-11-09;0;0;0;0;0;0;0;0;0;0
FR;5;2021-11-10;0;0;0;0;0;0;0;0;0;0
FR;5;2021-11-11;0;0;0;0;0;0;0;0;0;0
FR;5;2021-11-12;0;0;0;0;0;0;0;0;0;0
FR;5;2021-11-13;0;0;0;0;0;0;0;0;0;0
FR;5;2021-11-14;0;0;0;0;0;0;0;0;0;0
FR;5;2021-11-15;0;0;0;0;0;0;0;0;0;0
FR;5;2021-11-16;0;0;0;0;0;0;0;0;0;0
FR;5;2021-11-17;0;0;0;0;0;0;0;0;0;0
FR;5;2021-11-18;0;0;0;0;0;0;0;0;0;0
FR;5;2021-11-19;0;0;0;0;0;0;0;0;0;0
FR;5;2021-11-20;0;0;0;0;0;0;0;0;0;0
FR;5;2021-11-21;0;0;0;0;0;0;0;0;0;0
FR;5;2021-11-22;0;0;0;0;0;0;0;0;0;0
FR;5;2021-11-23;0;0;0;0;0;0;0;0;0;0
FR;5;2021-11-24;0;0;0;0;0;0;0;0;0;0
FR;5;2021-11-25;0;0;0;0;0;0;0;0;0;0
FR;5;2021-11-26;0;0;0;0;0;0;0;0;0;0
FR;5;2021-11-27;0;0;0;0;0;0;0;0;0;0
FR;5;2021-11-28;0;0;0;0;0;0;0;0;0;0
FR;5;2021-11-29;0;0;0;0;0;0;0;0;0;0
FR;5;2021-11-30;0;0;0;0;0;0;0;0;0;0
FR;5;2021-12-01;0;0;0;0;0;0;0;0;0;0
FR;5;2021-12-02;0;0;0;0;0;0;0;0;0;0
FR;5;2021-12-03;0;0;0;0;0;0;0;0;0;0
FR;5;2021-12-04;0;0;0;0;0;0;0;0;0;0
FR;5;2021-12-05;0;0;0;0;0;0;0;0;0;0
FR;5;2021-12-06;0;0;0;0;0;0;0;0;0;0
FR;5;2021-12-07;0;0;0;0;0;0;0;0;0;0
FR;5;2021-12-08;0;0;0;0;0;0;0;0;0;0
FR;5;2021-12-09;0;0;0;0;0;0;0;0;0;0
FR;5;2021-12-10;0;0;0;0;0;0;0;0;0;0
FR;5;2021-12-11;0;0;0;0;0;0;0;0;0;0
FR;5;2021-12-12;0;0;0;0;0;0;0;0;0;0
FR;5;2021-12-13;0;0;0;0;0;0;0;0;0;0
FR;5;2021-12-14;29;45;77;0;88;29;45;77;0;88
FR;5;2021-12-15;196;44;37;0;49;225;89;114;0;137
FR;5;2021-12-16;180;21;44;0;48;405;110;158;0;185
FR;5;2021-12-17;310;16;72;0;74;715;126;230;0;259
FR;5;2021-12-18;765;24;22;0;29;1480;150;252;0;288
FR;5;2021-12-19;586;15;15;0;17;2066;165;267;0;305
FR;5;2021-12-20;1223;31;35;0;38;3289;196;302;0;343
FR;5;2021-12-21;1535;22;54;1;60;4824;218;356;1;403
FR;5;2021-12-22;4069;40;37;0;46;8893;258;393;1;449
FR;5;2021-12-23;3042;16;21;0;25;11935;274;414;1;474
FR;5;2021-12-24;759;18;9;0;15;12694;292;423;1;489
FR;5;2021-12-25;61;5;1;0;2;12755;297;424;1;491
FR;5;2021-12-26;623;6;3;0;4;13378;303;427;1;495
FR;5;2021-12-27;4080;25;21;0;23;17458;328;448;1;518
FR;5;2021-12-28;5202;23;41;1;43;22660;351;489;2;561
FR;5;2021-12-29;8104;34;66;2;69;30764;385;555;4;630
FR;5;2021-12-30;5172;18;33;0;39;35936;403;588;4;669
FR;5;2021-12-31;1553;8;10;0;11;37489;411;598;4;680
FR;5;2022-01-01;185;2;2;0;3;37674;413;600;4;683
FR;5;2022-01-02;1489;1;1;0;1;39163;414;601;4;684
FR;5;2022-01-03;3059;36;33;0;32;42222;450;634;4;716
FR;5;2022-01-04;3034;39;33;0;42;45256;489;667;4;758
FR;5;2022-01-05;19323;203;97;1;108;64579;692;764;5;866
FR;5;2022-01-06;3742;133;122;0;142;68321;825;886;5;1008
FR;5;2022-01-07;5007;200;48;2;56;73328;1025;934;7;1064
FR;5;2022-01-08;13654;514;45;0;52;86982;1539;979;7;1116
FR;5;2022-01-09;5755;399;15;0;20;92737;1938;994;7;1136
FR;5;2022-01-10;3453;326;25;0;29;96190;2264;1019;7;1165
FR;5;2022-01-11;3668;284;38;0;41;99858;2548;1057;7;1206
FR;5;2022-01-12;22653;3003;90;0;113;122511;5551;1147;7;1319
FR;5;2022-01-13;4035;622;30;0;32;126546;6173;1177;7;1351
FR;5;2022-01-14;4843;581;44;0;51;131389;6754;1221;7;1402
FR;5;2022-01-15;14681;1746;38;3;49;146070;8500;1259;10;1451
FR;5;2022-01-16;4727;666;3;0;5;150797;9166;1262;10;1456
FR;5;2022-01-17;2294;715;26;0;29;153091;9881;1288;10;1485
FR;5;2022-01-18;2430;870;30;0;40;155521;10751;1318;10;1525
FR;5;2022-01-19;18481;6422;74;2;142;174002;17173;1392;12;1667
FR;5;2022-01-20;1920;1067;25;0;34;175922;18240;1417;12;1701
FR;5;2022-01-21;3076;1371;47;1;59;178998;19611;1464;13;1760
FR;5;2022-01-22;10721;3454;33;1;43;189719;23065;1497;14;1803
FR;5;2022-01-23;2629;1415;5;0;9;192348;24480;1502;14;1812
FR;5;2022-01-24;1159;1340;19;0;23;193507;25820;1521;14;1835
FR;5;2022-01-25;1219;1548;19;2;29;194726;27368;1540;16;1864
FR;5;2022-01-26;10751;12025;50;1;89;205477;39393;1590;17;1953
FR;5;2022-01-27;1291;1693;10;0;17;206768;41086;1600;17;1970
FR;5;2022-01-28;1695;3347;16;0;19;208463;44433;1616;17;1989
FR;5;2022-01-29;6237;8040;68;0;96;214700;52473;1684;17;2085
FR;5;2022-01-30;1509;2950;5;0;18;216209;55423;1689;17;2103
FR;5;2022-01-31;588;1773;23;0;24;216797;57196;1712;17;2127
FR;5;2022-02-01;712;1703;10;0;15;217509;58899;1722;17;2142
FR;5;2022-02-02;6957;15654;52;0;94;224466;74553;1774;17;2236
FR;5;2022-02-03;490;1690;14;0;13;224956;76243;1788;17;2249
FR;5;2022-02-04;943;3001;19;0;31;225899;79244;1807;17;2280
FR;5;2022-02-05;3532;8916;23;0;37;229431;88160;1830;17;2317
FR;5;2022-02-06;737;2397;10;0;19;230168;90557;1840;17;2336
FR;5;2022-02-07;883;1595;22;0;24;231051;92152;1862;17;2360
FR;5;2022-02-08;722;1285;18;0;20;231773;93437;1880;17;2380
FR;5;2022-02-09;4535;12876;44;0;76;236308;106313;1924;17;2456
FR;5;2022-02-10;646;1059;14;0;15;236954;107372;1938;17;2471
FR;5;2022-02-11;793;2026;16;0;21;237747;109398;1954;17;2492
FR;5;2022-02-12;2285;6811;33;0;53;240032;116209;1987;17;2545
FR;5;2022-02-13;465;1540;8;0;8;240497;117749;1995;17;2553
FR;5;2022-02-14;678;1288;10;0;13;241175;119037;2005;17;2566
FR;5;2022-02-15;482;885;9;0;14;241657;119922;2014;17;2580
FR;5;2022-02-16;2980;9123;41;1;58;244637;129045;2055;18;2638
FR;5;2022-02-17;435;805;6;0;7;245072;129850;2061;18;2645
FR;5;2022-02-18;650;1407;13;0;17;245722;131257;2074;18;2662
FR;5;2022-02-19;1371;4315;16;0;28;247093;135572;2090;18;2690
FR;5;2022-02-20;247;879;6;0;8;247340;136451;2096;18;2698
FR;5;2022-02-21;221;607;2;0;4;247561;137058;2098;18;2702
FR;5;2022-02-22;259;545;17;0;17;247820;137603;2115;18;2719
FR;5;2022-02-23;1908;6924;22;1;42;249728;144527;2137;19;2761
FR;5;2022-02-24;182;374;5;1;6;249910;144901;2142;20;2767
FR;5;2022-02-25;336;949;13;0;12;250246;145850;2155;20;2779
FR;5;2022-02-26;972;3069;10;0;14;251218;148919;2165;20;2793
FR;5;2022-02-27;147;506;0;0;3;251365;149425;2165;20;2796
FR;5;2022-02-28;161;369;1;0;1;251526;149794;2166;20;2797
FR;5;2022-03-01;128;279;6;0;7;251654;150073;2172;20;2804
FR;5;2022-03-02;1240;4150;28;3;40;252894;154223;2200;23;2844
FR;5;2022-03-03;121;250;6;0;9;253015;154473;2206;23;2853
FR;5;2022-03-04;193;488;13;0;14;253208;154961;2219;23;2867
FR;5;2022-03-05;676;1990;8;0;16;253884;156951;2227;23;2883
FR;5;2022-03-06;108;260;0;0;0;253992;157211;2227;23;2883
FR;5;2022-03-07;71;228;5;0;3;254063;157439;2232;23;2886
FR;5;2022-03-08;46;130;7;1;7;254109;157569;2239;24;2893
FR;5;2022-03-09;909;3076;24;0;36;255018;160645;2263;24;2929
FR;5;2022-03-10;82;200;8;0;11;255100;160845;2271;24;2940
FR;5;2022-03-11;147;369;13;1;15;255247;161214;2284;25;2955
FR;5;2022-03-12;758;1613;13;1;30;256005;162827;2297;26;2985
FR;5;2022-03-13;76;100;0;0;0;256081;162927;2297;26;2985
FR;5;2022-03-14;67;118;7;1;7;256148;163045;2304;27;2992
FR;5;2022-03-15;83;99;3;0;6;256231;163144;2307;27;2998
FR;5;2022-03-16;883;1825;15;3;36;257114;164969;2322;30;3034
FR;5;2022-03-17;66;123;8;4;10;257180;165092;2330;34;3044
FR;5;2022-03-18;172;318;13;4;18;257352;165410;2343;38;3062
FR;5;2022-03-19;750;1162;12;5;33;258102;166572;2355;43;3095
FR;5;2022-03-20;45;93;1;0;1;258147;166665;2356;43;3096
FR;5;2022-03-21;71;120;10;6;15;258218;166785;2366;49;3111
FR;5;2022-03-22;56;119;8;8;9;258274;166904;2374;57;3120
FR;5;2022-03-23;804;1461;14;8;36;259078;168365;2388;65;3156
FR;5;2022-03-24;68;93;8;7;7;259146;168458;2396;72;3163
FR;5;2022-03-25;222;290;14;8;18;259368;168748;2410;80;3181
FR;5;2022-03-26;706;853;12;5;26;260074;169601;2422;85;3207
FR;5;2022-03-27;74;78;0;0;3;260148;169679;2422;85;3210
FR;5;2022-03-28;81;91;1;2;3;260229;169770;2423;87;3213
FR;5;2022-03-29;71;82;10;4;12;260300;169852;2433;91;3225
FR;5;2022-03-30;820;1115;16;13;29;261120;170967;2449;104;3254
FR;5;2022-03-31;102;124;1;4;6;261222;171091;2450;108;3260
FR;5;2022-04-01;107;86;7;12;11;261329;171177;2457;120;3271
FR;5;2022-04-02;329;349;3;3;15;261658;171526;2460;123;3286
FR;5;2022-04-03;54;59;1;0;1;261712;171585;2461;123;3287
FR;5;2022-04-04;38;57;4;1;8;261750;171642;2465;124;3295
FR;5;2022-04-05;51;60;6;7;9;261801;171702;2471;131;3304
FR;5;2022-04-06;421;439;7;15;16;262222;172141;2478;146;3320
FR;5;2022-04-07;45;68;5;7;7;262267;172209;2483;153;3327
FR;5;2022-04-08;133;110;12;14;15;262400;172319;2495;167;3342
FR;5;2022-04-09;308;323;2;5;17;262708;172642;2497;172;3359
FR;5;2022-04-10;43;31;2;0;2;262751;172673;2499;172;3361
FR;5;2022-04-11;50;60;3;2;4;262801;172733;2502;174;3365
FR;5;2022-04-12;57;54;3;3;5;262858;172787;2505;177;3370
FR;5;2022-04-13;382;413;3;8;16;263240;173200;2508;185;3386
FR;5;2022-04-14;47;48;5;5;9;263287;173248;2513;190;3395
FR;5;2022-04-15;91;109;3;5;5;263378;173357;2516;195;3400
FR;5;2022-04-16;188;184;2;1;13;263566;173541;2518;196;3413
FR;5;2022-04-17;12;10;1;0;1;263578;173551;2519;196;3414
FR;5;2022-04-18;8;9;2;0;2;263586;173560;2521;196;3416
FR;5;2022-04-19;73;70;6;1;6;263659;173630;2527;197;3422
FR;5;2022-04-20;360;349;9;6;12;264019;173979;2536;203;3434
FR;5;2022-04-21;42;64;9;10;12;264061;174043;2545;213;3446
FR;5;2022-04-22;113;96;5;4;5;264174;174139;2550;217;3451
FR;5;2022-04-23;209;192;3;2;10;264383;174331;2553;219;3461
FR;5;2022-04-24;37;35;0;0;3;264420;174366;2553;219;3464
FR;5;2022-04-25;67;65;1;1;4;264487;174431;2554;220;3468
FR;5;2022-04-26;60;61;2;1;5;264547;174492;2556;221;3473
FR;5;2022-04-27;335;316;2;7;14;264882;174808;2558;228;3487
FR;5;2022-04-28;75;54;4;5;8;264957;174862;2562;233;3495
FR;5;2022-04-29;117;82;5;18;12;265074;174944;2567;251;3507
FR;5;2022-04-30;182;115;2;3;10;265256;175059;2569;254;3517
FR;5;2022-05-01;11;7;0;0;0;265267;175066;2569;254;3517
FR;5;2022-05-02;49;27;4;5;2;265316;175093;2573;259;3519
FR;5;2022-05-03;83;55;2;5;11;265399;175148;2575;264;3530
FR;5;2022-05-04;277;204;1;2;7;265676;175352;2576;266;3537
FR;5;2022-05-05;62;32;2;4;4;265738;175384;2578;270;3541
FR;5;2022-05-06;104;64;2;3;5;265842;175448;2580;273;3546
FR;5;2022-05-07;171;115;3;10;13;266013;175563;2583;283;3559
FR;5;2022-05-08;7;8;0;0;2;266020;175571;2583;283;3561
FR;5;2022-05-09;44;32;15;3;16;266064;175603;2598;286;3577
FR;5;2022-05-10;54;49;3;4;5;266118;175652;2601;290;3582
FR;5;2022-05-11;324;236;12;7;21;266442;175888;2613;297;3603
FR;5;2022-05-12;46;34;1;3;2;266488;175922;2614;300;3605
FR;5;2022-05-13;108;83;3;8;9;266596;176005;2617;308;3614
FR;5;2022-05-14;206;129;0;1;8;266802;176134;2617;309;3622
FR;5;2022-05-15;22;7;2;0;1;266824;176141;2619;309;3623
FR;5;2022-05-16;51;33;4;5;4;266875;176174;2623;314;3627
FR;5;2022-05-17;72;40;5;0;2;266947;176214;2628;314;3629
FR;5;2022-05-18;288;214;4;4;8;267235;176428;2632;318;3637
FR;5;2022-05-19;44;35;4;3;2;267279;176463;2636;321;3639
FR;5;2022-05-20;74;62;2;4;1;267353;176525;2638;325;3640
FR;5;2022-05-21;241;166;2;3;17;267594;176691;2640;328;3657
FR;5;2022-05-22;20;14;2;5;2;267614;176705;2642;333;3659
FR;5;2022-05-23;42;24;4;3;6;267656;176729;2646;336;3665
FR;5;2022-05-24;45;45;3;2;5;267701;176774;2649;338;3670
FR;5;2022-05-25;326;253;4;0;15;268027;177027;2653;338;3685
FR;5;2022-05-26;15;5;0;1;2;268042;177032;2653;339;3687
FR;5;2022-05-27;97;54;4;4;9;268139;177086;2657;343;3696
FR;5;2022-05-28;95;73;5;3;10;268234;177159;2662;346;3706
FR;5;2022-05-29;14;14;1;0;2;268248;177173;2663;346;3708
FR;5;2022-05-30;55;39;2;1;2;268303;177212;2665;347;3710
FR;5;2022-05-31;55;42;1;8;1;268358;177254;2666;355;3711
FR;5;2022-06-01;247;237;8;2;23;268605;177491;2674;357;3734
FR;5;2022-06-02;55;60;4;0;7;268660;177551;2678;357;3741
FR;5;2022-06-03;76;69;3;4;8;268736;177620;2681;361;3749
FR;5;2022-06-04;155;106;2;1;9;268891;177726;2683;362;3758
FR;5;2022-06-05;16;10;0;0;1;268907;177736;2683;362;3759
FR;5;2022-06-06;13;9;0;0;0;268920;177745;2683;362;3759
FR;5;2022-06-07;47;56;0;1;1;268967;177801;2683;363;3760
FR;6;2020-12-27;0;0;0;0;0;0;0;0;0;0
FR;6;2020-12-28;0;0;0;0;0;0;0;0;0;0
FR;6;2020-12-29;0;0;0;0;0;0;0;0;0;0
FR;6;2020-12-30;0;0;0;0;0;0;0;0;0;0
FR;6;2020-12-31;0;0;0;0;0;0;0;0;0;0
FR;6;2021-01-01;0;0;0;0;0;0;0;0;0;0
FR;6;2021-01-02;0;0;0;0;0;0;0;0;0;0
FR;6;2021-01-03;0;0;0;0;0;0;0;0;0;0
FR;6;2021-01-04;0;0;0;0;0;0;0;0;0;0
FR;6;2021-01-05;0;0;0;0;0;0;0;0;0;0
FR;6;2021-01-06;0;0;0;0;0;0;0;0;0;0
FR;6;2021-01-07;0;0;0;0;0;0;0;0;0;0
FR;6;2021-01-08;0;0;0;0;0;0;0;0;0;0
FR;6;2021-01-09;0;0;0;0;0;0;0;0;0;0
FR;6;2021-01-10;0;0;0;0;0;0;0;0;0;0
FR;6;2021-01-11;0;0;0;0;0;0;0;0;0;0
FR;6;2021-01-12;0;0;0;0;0;0;0;0;0;0
FR;6;2021-01-13;0;0;0;0;0;0;0;0;0;0
FR;6;2021-01-14;0;0;0;0;0;0;0;0;0;0
FR;6;2021-01-15;0;0;0;0;0;0;0;0;0;0
FR;6;2021-01-16;0;0;0;0;0;0;0;0;0;0
FR;6;2021-01-17;0;0;0;0;0;0;0;0;0;0
FR;6;2021-01-18;0;0;0;0;0;0;0;0;0;0
FR;6;2021-01-19;0;0;0;0;0;0;0;0;0;0
FR;6;2021-01-20;0;0;0;0;0;0;0;0;0;0
FR;6;2021-01-21;0;0;0;0;0;0;0;0;0;0
FR;6;2021-01-22;0;0;0;0;0;0;0;0;0;0
FR;6;2021-01-23;0;0;0;0;0;0;0;0;0;0
FR;6;2021-01-24;0;0;0;0;0;0;0;0;0;0
FR;6;2021-01-25;0;0;0;0;0;0;0;0;0;0
FR;6;2021-01-26;0;0;0;0;0;0;0;0;0;0
FR;6;2021-01-27;0;0;0;0;0;0;0;0;0;0
FR;6;2021-01-28;0;0;0;0;0;0;0;0;0;0
FR;6;2021-01-29;0;0;0;0;0;0;0;0;0;0
FR;6;2021-01-30;0;0;0;0;0;0;0;0;0;0
FR;6;2021-01-31;0;0;0;0;0;0;0;0;0;0
FR;6;2021-02-01;0;0;0;0;0;0;0;0;0;0
FR;6;2021-02-02;0;0;0;0;0;0;0;0;0;0
FR;6;2021-02-03;0;0;0;0;0;0;0;0;0;0
FR;6;2021-02-04;0;0;0;0;0;0;0;0;0;0
FR;6;2021-02-05;0;0;0;0;0;0;0;0;0;0
FR;6;2021-02-06;0;0;0;0;0;0;0;0;0;0
FR;6;2021-02-07;0;0;0;0;0;0;0;0;0;0
FR;6;2021-02-08;0;0;0;0;0;0;0;0;0;0
FR;6;2021-02-09;0;0;0;0;0;0;0;0;0;0
FR;6;2021-02-10;0;0;0;0;0;0;0;0;0;0
FR;6;2021-02-11;0;0;0;0;0;0;0;0;0;0
FR;6;2021-02-12;0;0;0;0;0;0;0;0;0;0
FR;6;2021-02-13;0;0;0;0;0;0;0;0;0;0
FR;6;2021-02-14;0;0;0;0;0;0;0;0;0;0
FR;6;2021-02-15;0;0;0;0;0;0;0;0;0;0
FR;6;2021-02-16;0;0;0;0;0;0;0;0;0;0
FR;6;2021-02-17;0;0;0;0;0;0;0;0;0;0
FR;6;2021-02-18;0;0;0;0;0;0;0;0;0;0
FR;6;2021-02-19;0;0;0;0;0;0;0;0;0;0
FR;6;2021-02-20;0;0;0;0;0;0;0;0;0;0
FR;6;2021-02-21;0;0;0;0;0;0;0;0;0;0
FR;6;2021-02-22;0;0;0;0;0;0;0;0;0;0
FR;6;2021-02-23;0;0;0;0;0;0;0;0;0;0
FR;6;2021-02-24;0;0;0;0;0;0;0;0;0;0
FR;6;2021-02-25;0;0;0;0;0;0;0;0;0;0
FR;6;2021-02-26;0;0;0;0;0;0;0;0;0;0
FR;6;2021-02-27;0;0;0;0;0;0;0;0;0;0
FR;6;2021-02-28;0;0;0;0;0;0;0;0;0;0
FR;6;2021-03-01;0;0;0;0;0;0;0;0;0;0
FR;6;2021-03-02;0;0;0;0;0;0;0;0;0;0
FR;6;2021-03-03;0;0;0;0;0;0;0;0;0;0
FR;6;2021-03-04;0;0;0;0;0;0;0;0;0;0
FR;6;2021-03-05;0;0;0;0;0;0;0;0;0;0
FR;6;2021-03-06;0;0;0;0;0;0;0;0;0;0
FR;6;2021-03-07;0;0;0;0;0;0;0;0;0;0
FR;6;2021-03-08;0;0;0;0;0;0;0;0;0;0
FR;6;2021-03-09;0;0;0;0;0;0;0;0;0;0
FR;6;2021-03-10;0;0;0;0;0;0;0;0;0;0
FR;6;2021-03-11;0;0;0;0;0;0;0;0;0;0
FR;6;2021-03-12;0;0;0;0;0;0;0;0;0;0
FR;6;2021-03-13;0;0;0;0;0;0;0;0;0;0
FR;6;2021-03-14;0;0;0;0;0;0;0;0;0;0
FR;6;2021-03-15;0;0;0;0;0;0;0;0;0;0
FR;6;2021-03-16;0;0;0;0;0;0;0;0;0;0
FR;6;2021-03-17;0;0;0;0;0;0;0;0;0;0
FR;6;2021-03-18;0;0;0;0;0;0;0;0;0;0
FR;6;2021-03-19;0;0;0;0;0;0;0;0;0;0
FR;6;2021-03-20;0;0;0;0;0;0;0;0;0;0
FR;6;2021-03-21;0;0;0;0;0;0;0;0;0;0
FR;6;2021-03-22;0;0;0;0;0;0;0;0;0;0
FR;6;2021-03-23;0;0;0;0;0;0;0;0;0;0
FR;6;2021-03-24;0;0;0;0;0;0;0;0;0;0
FR;6;2021-03-25;0;0;0;0;0;0;0;0;0;0
FR;6;2021-03-26;0;0;0;0;0;0;0;0;0;0
FR;6;2021-03-27;0;0;0;0;0;0;0;0;0;0
FR;6;2021-03-28;0;0;0;0;0;0;0;0;0;0
FR;6;2021-03-29;0;0;0;0;0;0;0;0;0;0
FR;6;2021-03-30;0;0;0;0;0;0;0;0;0;0
FR;6;2021-03-31;0;0;0;0;0;0;0;0;0;0
FR;6;2021-04-01;0;0;0;0;0;0;0;0;0;0
FR;6;2021-04-02;0;0;0;0;0;0;0;0;0;0
FR;6;2021-04-03;0;0;0;0;0;0;0;0;0;0
FR;6;2021-04-04;0;0;0;0;0;0;0;0;0;0
FR;6;2021-04-05;0;0;0;0;0;0;0;0;0;0
FR;6;2021-04-06;0;0;0;0;0;0;0;0;0;0
FR;6;2021-04-07;0;0;0;0;0;0;0;0;0;0
FR;6;2021-04-08;0;0;0;0;0;0;0;0;0;0
FR;6;2021-04-09;0;0;0;0;0;0;0;0;0;0
FR;6;2021-04-10;0;0;0;0;0;0;0;0;0;0
FR;6;2021-04-11;0;0;0;0;0;0;0;0;0;0
FR;6;2021-04-12;0;0;0;0;0;0;0;0;0;0
FR;6;2021-04-13;0;0;0;0;0;0;0;0;0;0
FR;6;2021-04-14;0;0;0;0;0;0;0;0;0;0
FR;6;2021-04-15;0;0;0;0;0;0;0;0;0;0
FR;6;2021-04-16;0;0;0;0;0;0;0;0;0;0
FR;6;2021-04-17;0;0;0;0;0;0;0;0;0;0
FR;6;2021-04-18;0;0;0;0;0;0;0;0;0;0
FR;6;2021-04-19;0;0;0;0;0;0;0;0;0;0
FR;6;2021-04-20;0;0;0;0;0;0;0;0;0;0
FR;6;2021-04-21;0;0;0;0;0;0;0;0;0;0
FR;6;2021-04-22;0;0;0;0;0;0;0;0;0;0
FR;6;2021-04-23;0;0;0;0;0;0;0;0;0;0
FR;6;2021-04-24;0;0;0;0;0;0;0;0;0;0
FR;6;2021-04-25;0;0;0;0;0;0;0;0;0;0
FR;6;2021-04-26;0;0;0;0;0;0;0;0;0;0
FR;6;2021-04-27;0;0;0;0;0;0;0;0;0;0
FR;6;2021-04-28;0;0;0;0;0;0;0;0;0;0
FR;6;2021-04-29;0;0;0;0;0;0;0;0;0;0
FR;6;2021-04-30;0;0;0;0;0;0;0;0;0;0
FR;6;2021-05-01;0;0;0;0;0;0;0;0;0;0
FR;6;2021-05-02;0;0;0;0;0;0;0;0;0;0
FR;6;2021-05-03;0;0;0;0;0;0;0;0;0;0
FR;6;2021-05-04;0;0;0;0;0;0;0;0;0;0
FR;6;2021-05-05;0;0;0;0;0;0;0;0;0;0
FR;6;2021-05-06;0;0;0;0;0;0;0;0;0;0
FR;6;2021-05-07;0;0;0;0;0;0;0;0;0;0
FR;6;2021-05-08;0;0;0;0;0;0;0;0;0;0
FR;6;2021-05-09;0;0;0;0;0;0;0;0;0;0
FR;6;2021-05-10;0;0;0;0;0;0;0;0;0;0
FR;6;2021-05-11;0;0;0;0;0;0;0;0;0;0
FR;6;2021-05-12;0;0;0;0;0;0;0;0;0;0
FR;6;2021-05-13;0;0;0;0;0;0;0;0;0;0
FR;6;2021-05-14;0;0;0;0;0;0;0;0;0;0
FR;6;2021-05-15;0;0;0;0;0;0;0;0;0;0
FR;6;2021-05-16;0;0;0;0;0;0;0;0;0;0
FR;6;2021-05-17;0;0;0;0;0;0;0;0;0;0
FR;6;2021-05-18;0;0;0;0;0;0;0;0;0;0
FR;6;2021-05-19;0;0;0;0;0;0;0;0;0;0
FR;6;2021-05-20;0;0;0;0;0;0;0;0;0;0
FR;6;2021-05-21;0;0;0;0;0;0;0;0;0;0
FR;6;2021-05-22;0;0;0;0;0;0;0;0;0;0
FR;6;2021-05-23;0;0;0;0;0;0;0;0;0;0
FR;6;2021-05-24;0;0;0;0;0;0;0;0;0;0
FR;6;2021-05-25;0;0;0;0;0;0;0;0;0;0
FR;6;2021-05-26;0;0;0;0;0;0;0;0;0;0
FR;6;2021-05-27;0;0;0;0;0;0;0;0;0;0
FR;6;2021-05-28;0;0;0;0;0;0;0;0;0;0
FR;6;2021-05-29;0;0;0;0;0;0;0;0;0;0
FR;6;2021-05-30;0;0;0;0;0;0;0;0;0;0
FR;6;2021-05-31;0;0;0;0;0;0;0;0;0;0
FR;6;2021-06-01;0;0;0;0;0;0;0;0;0;0
FR;6;2021-06-02;0;0;0;0;0;0;0;0;0;0
FR;6;2021-06-03;0;0;0;0;0;0;0;0;0;0
FR;6;2021-06-04;0;0;0;0;0;0;0;0;0;0
FR;6;2021-06-05;0;0;0;0;0;0;0;0;0;0
FR;6;2021-06-06;0;0;0;0;0;0;0;0;0;0
FR;6;2021-06-07;0;0;0;0;0;0;0;0;0;0
FR;6;2021-06-08;0;0;0;0;0;0;0;0;0;0
FR;6;2021-06-09;0;0;0;0;0;0;0;0;0;0
FR;6;2021-06-10;0;0;0;0;0;0;0;0;0;0
FR;6;2021-06-11;0;0;0;0;0;0;0;0;0;0
FR;6;2021-06-12;0;0;0;0;0;0;0;0;0;0
FR;6;2021-06-13;0;0;0;0;0;0;0;0;0;0
FR;6;2021-06-14;0;0;0;0;0;0;0;0;0;0
FR;6;2021-06-15;0;0;0;0;0;0;0;0;0;0
FR;6;2021-06-16;0;0;0;0;0;0;0;0;0;0
FR;6;2021-06-17;0;0;0;0;0;0;0;0;0;0
FR;6;2021-06-18;0;0;0;0;0;0;0;0;0;0
FR;6;2021-06-19;0;0;0;0;0;0;0;0;0;0
FR;6;2021-06-20;0;0;0;0;0;0;0;0;0;0
FR;6;2021-06-21;0;0;0;0;0;0;0;0;0;0
FR;6;2021-06-22;0;0;0;0;0;0;0;0;0;0
FR;6;2021-06-23;0;0;0;0;0;0;0;0;0;0
FR;6;2021-06-24;0;0;0;0;0;0;0;0;0;0
FR;6;2021-06-25;0;0;0;0;0;0;0;0;0;0
FR;6;2021-06-26;0;0;0;0;0;0;0;0;0;0
FR;6;2021-06-27;0;0;0;0;0;0;0;0;0;0
FR;6;2021-06-28;0;0;0;0;0;0;0;0;0;0
FR;6;2021-06-29;0;0;0;0;0;0;0;0;0;0
FR;6;2021-06-30;0;0;0;0;0;0;0;0;0;0
FR;6;2021-07-01;0;0;0;0;0;0;0;0;0;0
FR;6;2021-07-02;0;0;0;0;0;0;0;0;0;0
FR;6;2021-07-03;0;0;0;0;0;0;0;0;0;0
FR;6;2021-07-04;0;0;0;0;0;0;0;0;0;0
FR;6;2021-07-05;0;0;0;0;0;0;0;0;0;0
FR;6;2021-07-06;0;0;0;0;0;0;0;0;0;0
FR;6;2021-07-07;0;0;0;0;0;0;0;0;0;0
FR;6;2021-07-08;0;0;0;0;0;0;0;0;0;0
FR;6;2021-07-09;0;0;0;0;0;0;0;0;0;0
FR;6;2021-07-10;0;0;0;0;0;0;0;0;0;0
FR;6;2021-07-11;0;0;0;0;0;0;0;0;0;0
FR;6;2021-07-12;0;0;0;0;0;0;0;0;0;0
FR;6;2021-07-13;0;0;0;0;0;0;0;0;0;0
FR;6;2021-07-14;0;0;0;0;0;0;0;0;0;0
FR;6;2021-07-15;0;0;0;0;0;0;0;0;0;0
FR;6;2021-07-16;0;0;0;0;0;0;0;0;0;0
FR;6;2021-07-17;0;0;0;0;0;0;0;0;0;0
FR;6;2021-07-18;0;0;0;0;0;0;0;0;0;0
FR;6;2021-07-19;0;0;0;0;0;0;0;0;0;0
FR;6;2021-07-20;0;0;0;0;0;0;0;0;0;0
FR;6;2021-07-21;0;0;0;0;0;0;0;0;0;0
FR;6;2021-07-22;0;0;0;0;0;0;0;0;0;0
FR;6;2021-07-23;0;0;0;0;0;0;0;0;0;0
FR;6;2021-07-24;0;0;0;0;0;0;0;0;0;0
FR;6;2021-07-25;0;0;0;0;0;0;0;0;0;0
FR;6;2021-07-26;0;0;0;0;0;0;0;0;0;0
FR;6;2021-07-27;0;0;0;0;0;0;0;0;0;0
FR;6;2021-07-28;0;0;0;0;0;0;0;0;0;0
FR;6;2021-07-29;0;0;0;0;0;0;0;0;0;0
FR;6;2021-07-30;0;0;0;0;0;0;0;0;0;0
FR;6;2021-07-31;0;0;0;0;0;0;0;0;0;0
FR;6;2021-08-01;0;0;0;0;0;0;0;0;0;0
FR;6;2021-08-02;0;0;0;0;0;0;0;0;0;0
FR;6;2021-08-03;0;0;0;0;0;0;0;0;0;0
FR;6;2021-08-04;0;0;0;0;0;0;0;0;0;0
FR;6;2021-08-05;0;0;0;0;0;0;0;0;0;0
FR;6;2021-08-06;0;0;0;0;0;0;0;0;0;0
FR;6;2021-08-07;0;0;0;0;0;0;0;0;0;0
FR;6;2021-08-08;0;0;0;0;0;0;0;0;0;0
FR;6;2021-08-09;0;0;0;0;0;0;0;0;0;0
FR;6;2021-08-10;0;0;0;0;0;0;0;0;0;0
FR;6;2021-08-11;0;0;0;0;0;0;0;0;0;0
FR;6;2021-08-12;0;0;0;0;0;0;0;0;0;0
FR;6;2021-08-13;0;0;0;0;0;0;0;0;0;0
FR;6;2021-08-14;0;0;0;0;0;0;0;0;0;0
FR;6;2021-08-15;0;0;0;0;0;0;0;0;0;0
FR;6;2021-08-16;0;0;0;0;0;0;0;0;0;0
FR;6;2021-08-17;0;0;0;0;0;0;0;0;0;0
FR;6;2021-08-18;0;0;0;0;0;0;0;0;0;0
FR;6;2021-08-19;0;0;0;0;0;0;0;0;0;0
FR;6;2021-08-20;0;0;0;0;0;0;0;0;0;0
FR;6;2021-08-21;0;0;0;0;0;0;0;0;0;0
FR;6;2021-08-22;0;0;0;0;0;0;0;0;0;0
FR;6;2021-08-23;0;0;0;0;0;0;0;0;0;0
FR;6;2021-08-24;0;0;0;0;0;0;0;0;0;0
FR;6;2021-08-25;0;0;0;0;0;0;0;0;0;0
FR;6;2021-08-26;0;0;0;0;0;0;0;0;0;0
FR;6;2021-08-27;0;0;0;0;0;0;0;0;0;0
FR;6;2021-08-28;0;0;0;0;0;0;0;0;0;0
FR;6;2021-08-29;0;0;0;0;0;0;0;0;0;0
FR;6;2021-08-30;0;0;0;0;0;0;0;0;0;0
FR;6;2021-08-31;0;0;0;0;0;0;0;0;0;0
FR;6;2021-09-01;0;0;0;0;0;0;0;0;0;0
FR;6;2021-09-02;0;0;0;0;0;0;0;0;0;0
FR;6;2021-09-03;0;0;0;0;0;0;0;0;0;0
FR;6;2021-09-04;0;0;0;0;0;0;0;0;0;0
FR;6;2021-09-05;0;0;0;0;0;0;0;0;0;0
FR;6;2021-09-06;0;0;0;0;0;0;0;0;0;0
FR;6;2021-09-07;0;0;0;0;0;0;0;0;0;0
FR;6;2021-09-08;0;0;0;0;0;0;0;0;0;0
FR;6;2021-09-09;0;0;0;0;0;0;0;0;0;0
FR;6;2021-09-10;0;0;0;0;0;0;0;0;0;0
FR;6;2021-09-11;0;0;0;0;0;0;0;0;0;0
FR;6;2021-09-12;0;0;0;0;0;0;0;0;0;0
FR;6;2021-09-13;0;0;0;0;0;0;0;0;0;0
FR;6;2021-09-14;0;0;0;0;0;0;0;0;0;0
FR;6;2021-09-15;0;0;0;0;0;0;0;0;0;0
FR;6;2021-09-16;0;0;0;0;0;0;0;0;0;0
FR;6;2021-09-17;0;0;0;0;0;0;0;0;0;0
FR;6;2021-09-18;0;0;0;0;0;0;0;0;0;0
FR;6;2021-09-19;0;0;0;0;0;0;0;0;0;0
FR;6;2021-09-20;0;0;0;0;0;0;0;0;0;0
FR;6;2021-09-21;0;0;0;0;0;0;0;0;0;0
FR;6;2021-09-22;0;0;0;0;0;0;0;0;0;0
FR;6;2021-09-23;0;0;0;0;0;0;0;0;0;0
FR;6;2021-09-24;0;0;0;0;0;0;0;0;0;0
FR;6;2021-09-25;0;0;0;0;0;0;0;0;0;0
FR;6;2021-09-26;0;0;0;0;0;0;0;0;0;0
FR;6;2021-09-27;0;0;0;0;0;0;0;0;0;0
FR;6;2021-09-28;0;0;0;0;0;0;0;0;0;0
FR;6;2021-09-29;0;0;0;0;0;0;0;0;0;0
FR;6;2021-09-30;0;0;0;0;0;0;0;0;0;0
FR;6;2021-10-01;0;0;0;0;0;0;0;0;0;0
FR;6;2021-10-02;0;0;0;0;0;0;0;0;0;0
FR;6;2021-10-03;0;0;0;0;0;0;0;0;0;0
FR;6;2021-10-04;0;0;0;0;0;0;0;0;0;0
FR;6;2021-10-05;0;0;0;0;0;0;0;0;0;0
FR;6;2021-10-06;0;0;0;0;0;0;0;0;0;0
FR;6;2021-10-07;0;0;0;0;0;0;0;0;0;0
FR;6;2021-10-08;0;0;0;0;0;0;0;0;0;0
FR;6;2021-10-09;0;0;0;0;0;0;0;0;0;0
FR;6;2021-10-10;0;0;0;0;0;0;0;0;0;0
FR;6;2021-10-11;0;0;0;0;0;0;0;0;0;0
FR;6;2021-10-12;0;0;0;0;0;0;0;0;0;0
FR;6;2021-10-13;0;0;0;0;0;0;0;0;0;0
FR;6;2021-10-14;0;0;0;0;0;0;0;0;0;0
FR;6;2021-10-15;0;0;0;0;0;0;0;0;0;0
FR;6;2021-10-16;0;0;0;0;0;0;0;0;0;0
FR;6;2021-10-17;0;0;0;0;0;0;0;0;0;0
FR;6;2021-10-18;0;0;0;0;0;0;0;0;0;0
FR;6;2021-10-19;0;0;0;0;0;0;0;0;0;0
FR;6;2021-10-20;0;0;0;0;0;0;0;0;0;0
FR;6;2021-10-21;0;0;0;0;0;0;0;0;0;0
FR;6;2021-10-22;0;0;0;0;0;0;0;0;0;0
FR;6;2021-10-23;0;0;0;0;0;0;0;0;0;0
FR;6;2021-10-24;0;0;0;0;0;0;0;0;0;0
FR;6;2021-10-25;0;0;0;0;0;0;0;0;0;0
FR;6;2021-10-26;0;0;0;0;0;0;0;0;0;0
FR;6;2021-10-27;0;0;0;0;0;0;0;0;0;0
FR;6;2021-10-28;0;0;0;0;0;0;0;0;0;0
FR;6;2021-10-29;0;0;0;0;0;0;0;0;0;0
FR;6;2021-10-30;0;0;0;0;0;0;0;0;0;0
FR;6;2021-10-31;0;0;0;0;0;0;0;0;0;0
FR;6;2021-11-01;0;0;0;0;0;0;0;0;0;0
FR;6;2021-11-02;0;0;0;0;0;0;0;0;0;0
FR;6;2021-11-03;0;0;0;0;0;0;0;0;0;0
FR;6;2021-11-04;0;0;0;0;0;0;0;0;0;0
FR;6;2021-11-05;0;0;0;0;0;0;0;0;0;0
FR;6;2021-11-06;0;0;0;0;0;0;0;0;0;0
FR;6;2021-11-07;0;0;0;0;0;0;0;0;0;0
FR;6;2021-11-08;0;0;0;0;0;0;0;0;0;0
FR;6;2021-11-09;0;0;0;0;0;0;0;0;0;0
FR;6;2021-11-10;0;0;0;0;0;0;0;0;0;0
FR;6;2021-11-11;0;0;0;0;0;0;0;0;0;0
FR;6;2021-11-12;0;0;0;0;0;0;0;0;0;0
FR;6;2021-11-13;0;0;0;0;0;0;0;0;0;0
FR;6;2021-11-14;0;0;0;0;0;0;0;0;0;0
FR;6;2021-11-15;0;0;0;0;0;0;0;0;0;0
FR;6;2021-11-16;0;0;0;0;0;0;0;0;0;0
FR;6;2021-11-17;0;0;0;0;0;0;0;0;0;0
FR;6;2021-11-18;0;0;0;0;0;0;0;0;0;0
FR;6;2021-11-19;0;0;0;0;0;0;0;0;0;0
FR;6;2021-11-20;0;0;0;0;0;0;0;0;0;0
FR;6;2021-11-21;0;0;0;0;0;0;0;0;0;0
FR;6;2021-11-22;0;0;0;0;0;0;0;0;0;0
FR;6;2021-11-23;0;0;0;0;0;0;0;0;0;0
FR;6;2021-11-24;0;0;0;0;0;0;0;0;0;0
FR;6;2021-11-25;0;0;0;0;0;0;0;0;0;0
FR;6;2021-11-26;0;0;0;0;0;0;0;0;0;0
FR;6;2021-11-27;0;0;0;0;0;0;0;0;0;0
FR;6;2021-11-28;0;0;0;0;0;0;0;0;0;0
FR;6;2021-11-29;0;0;0;0;0;0;0;0;0;0
FR;6;2021-11-30;0;0;0;0;0;0;0;0;0;0
FR;6;2021-12-01;0;0;0;0;0;0;0;0;0;0
FR;6;2021-12-02;0;0;0;0;0;0;0;0;0;0
FR;6;2021-12-03;0;0;0;0;0;0;0;0;0;0
FR;6;2021-12-04;0;0;0;0;0;0;0;0;0;0
FR;6;2021-12-05;0;0;0;0;0;0;0;0;0;0
FR;6;2021-12-06;0;0;0;0;0;0;0;0;0;0
FR;6;2021-12-07;0;0;0;0;0;0;0;0;0;0
FR;6;2021-12-08;0;0;0;0;0;0;0;0;0;0
FR;6;2021-12-09;0;0;0;0;0;0;0;0;0;0
FR;6;2021-12-10;0;0;0;0;0;0;0;0;0;0
FR;6;2021-12-11;0;0;0;0;0;0;0;0;0;0
FR;6;2021-12-12;0;0;0;0;0;0;0;0;0;0
FR;6;2021-12-13;0;0;0;0;0;0;0;0;0;0
FR;6;2021-12-14;0;0;0;0;0;0;0;0;0;0
FR;6;2021-12-15;0;0;0;0;0;0;0;0;0;0
FR;6;2021-12-16;0;0;0;0;0;0;0;0;0;0
FR;6;2021-12-17;0;0;0;0;0;0;0;0;0;0
FR;6;2021-12-18;0;0;0;0;0;0;0;0;0;0
FR;6;2021-12-19;0;0;0;0;0;0;0;0;0;0
FR;6;2021-12-20;0;0;0;0;0;0;0;0;0;0
FR;6;2021-12-21;0;0;0;0;0;0;0;0;0;0
FR;6;2021-12-22;0;0;0;0;0;0;0;0;0;0
FR;6;2021-12-23;0;0;0;0;0;0;0;0;0;0
FR;6;2021-12-24;0;0;0;0;0;0;0;0;0;0
FR;6;2021-12-25;0;0;0;0;0;0;0;0;0;0
FR;6;2021-12-26;0;0;0;0;0;0;0;0;0;0
FR;6;2021-12-27;0;0;0;0;0;0;0;0;0;0
FR;6;2021-12-28;0;0;0;0;0;0;0;0;0;0
FR;6;2021-12-29;0;0;0;0;0;0;0;0;0;0
FR;6;2021-12-30;0;0;0;0;0;0;0;0;0;0
FR;6;2021-12-31;0;0;0;0;0;0;0;0;0;0
FR;6;2022-01-01;0;0;0;0;0;0;0;0;0;0
FR;6;2022-01-02;0;0;0;0;0;0;0;0;0;0
FR;6;2022-01-03;0;0;0;0;0;0;0;0;0;0
FR;6;2022-01-04;0;0;0;0;0;0;0;0;0;0
FR;6;2022-01-05;0;0;0;0;0;0;0;0;0;0
FR;6;2022-01-06;0;0;0;0;0;0;0;0;0;0
FR;6;2022-01-07;0;0;0;0;0;0;0;0;0;0
FR;6;2022-01-08;0;0;0;0;0;0;0;0;0;0
FR;6;2022-01-09;0;0;0;0;0;0;0;0;0;0
FR;6;2022-01-10;0;0;0;0;0;0;0;0;0;0
FR;6;2022-01-11;0;0;0;0;0;0;0;0;0;0
FR;6;2022-01-12;0;0;0;0;0;0;0;0;0;0
FR;6;2022-01-13;0;0;0;0;0;0;0;0;0;0
FR;6;2022-01-14;0;0;0;0;0;0;0;0;0;0
FR;6;2022-01-15;0;0;0;0;0;0;0;0;0;0
FR;6;2022-01-16;0;0;0;0;0;0;0;0;0;0
FR;6;2022-01-17;0;0;0;0;0;0;0;0;0;0
FR;6;2022-01-18;0;0;0;0;0;0;0;0;0;0
FR;6;2022-01-19;0;0;0;0;0;0;0;0;0;0
FR;6;2022-01-20;0;0;0;0;0;0;0;0;0;0
FR;6;2022-01-21;0;0;0;0;0;0;0;0;0;0
FR;6;2022-01-22;0;0;0;0;0;0;0;0;0;0
FR;6;2022-01-23;0;0;0;0;0;0;0;0;0;0
FR;6;2022-01-24;0;0;0;0;0;0;0;0;0;0
FR;6;2022-01-25;0;0;0;0;0;0;0;0;0;0
FR;6;2022-01-26;0;0;0;0;0;0;0;0;0;0
FR;6;2022-01-27;0;0;0;0;0;0;0;0;0;0
FR;6;2022-01-28;0;0;0;0;0;0;0;0;0;0
FR;6;2022-01-29;0;0;0;0;0;0;0;0;0;0
FR;6;2022-01-30;0;0;0;0;0;0;0;0;0;0
FR;6;2022-01-31;0;0;0;0;0;0;0;0;0;0
FR;6;2022-02-01;0;0;0;0;0;0;0;0;0;0
FR;6;2022-02-02;0;0;0;0;0;0;0;0;0;0
FR;6;2022-02-03;0;0;0;0;0;0;0;0;0;0
FR;6;2022-02-04;0;0;0;0;0;0;0;0;0;0
FR;6;2022-02-05;0;0;0;0;0;0;0;0;0;0
FR;6;2022-02-06;0;0;0;0;0;0;0;0;0;0
FR;6;2022-02-07;0;0;0;0;0;0;0;0;0;0
FR;6;2022-02-08;0;0;0;0;0;0;0;0;0;0
FR;6;2022-02-09;0;0;0;0;0;0;0;0;0;0
FR;6;2022-02-10;0;0;0;0;0;0;0;0;0;0
FR;6;2022-02-11;0;0;0;0;0;0;0;0;0;0
FR;6;2022-02-12;0;0;0;0;0;0;0;0;0;0
FR;6;2022-02-13;0;0;0;0;0;0;0;0;0;0
FR;6;2022-02-14;0;0;0;0;0;0;0;0;0;0
FR;6;2022-02-15;0;0;0;0;0;0;0;0;0;0
FR;6;2022-02-16;0;0;0;0;0;0;0;0;0;0
FR;6;2022-02-17;0;0;0;0;0;0;0;0;0;0
FR;6;2022-02-18;0;0;0;0;0;0;0;0;0;0
FR;6;2022-02-19;0;0;0;0;0;0;0;0;0;0
FR;6;2022-02-20;0;0;0;0;0;0;0;0;0;0
FR;6;2022-02-21;0;0;0;0;0;0;0;0;0;0
FR;6;2022-02-22;0;0;0;0;0;0;0;0;0;0
FR;6;2022-02-23;0;0;0;0;0;0;0;0;0;0
FR;6;2022-02-24;0;0;0;0;0;0;0;0;0;0
FR;6;2022-02-25;0;0;0;0;0;0;0;0;0;0
FR;6;2022-02-26;1;0;0;0;0;1;0;0;0;0
FR;6;2022-02-27;0;0;0;0;0;1;0;0;0;0
FR;6;2022-02-28;0;0;0;0;0;1;0;0;0;0
FR;6;2022-03-01;3;0;0;0;0;4;0;0;0;0
FR;6;2022-03-02;97;9;2;0;7;101;9;2;0;7
FR;6;2022-03-03;0;0;0;0;0;101;9;2;0;7
FR;6;2022-03-04;91;4;0;0;4;192;13;2;0;11
FR;6;2022-03-05;391;23;2;0;14;583;36;4;0;25
FR;6;2022-03-06;7;1;0;0;0;590;37;4;0;25
FR;6;2022-03-07;337;19;0;0;13;927;56;4;0;38
FR;6;2022-03-08;230;14;0;0;5;1157;70;4;0;43
FR;6;2022-03-09;519;29;2;0;21;1676;99;6;0;64
FR;6;2022-03-10;206;19;0;1;12;1882;118;6;1;76
FR;6;2022-03-11;328;21;6;0;21;2210;139;12;1;97
FR;6;2022-03-12;518;25;1;0;20;2728;164;13;1;117
FR;6;2022-03-13;40;2;0;0;1;2768;166;13;1;118
FR;6;2022-03-14;201;4;2;0;3;2969;170;15;1;121
FR;6;2022-03-15;112;11;2;0;9;3081;181;17;1;130
FR;6;2022-03-16;310;17;1;1;14;3391;198;18;2;144
FR;6;2022-03-17;117;6;1;2;4;3508;204;19;4;148
FR;6;2022-03-18;214;11;0;0;6;3722;215;19;4;154
FR;6;2022-03-19;307;19;2;0;9;4029;234;21;4;163
FR;6;2022-03-20;15;5;0;0;1;4044;239;21;4;164
FR;6;2022-03-21;132;23;1;0;4;4176;262;22;4;168
FR;6;2022-03-22;97;15;0;0;4;4273;277;22;4;172
FR;6;2022-03-23;226;108;3;0;14;4499;385;25;4;186
FR;6;2022-03-24;100;15;1;3;4;4599;400;26;7;190
FR;6;2022-03-25;203;141;2;1;15;4802;541;28;8;205
FR;6;2022-03-26;332;295;7;1;19;5134;836;35;9;224
FR;6;2022-03-27;32;30;1;0;1;5166;866;36;9;225
FR;6;2022-03-28;200;208;8;1;17;5366;1074;44;10;242
FR;6;2022-03-29;126;189;12;2;12;5492;1263;56;12;254
FR;6;2022-03-30;305;476;10;2;22;5797;1739;66;14;276
FR;6;2022-03-31;124;140;10;0;14;5921;1879;76;14;290
FR;6;2022-04-01;195;150;11;2;23;6116;2029;87;16;313
FR;6;2022-04-02;205;241;9;1;13;6321;2270;96;17;326
FR;6;2022-04-03;17;21;0;0;1;6338;2291;96;17;327
FR;6;2022-04-04;132;114;6;1;9;6470;2405;102;18;336
FR;6;2022-04-05;145;88;15;1;11;6615;2493;117;19;347
FR;6;2022-04-06;204;245;22;26;27;6819;2738;139;45;374
FR;6;2022-04-07;127;96;15;5;17;6946;2834;154;50;391
FR;6;2022-04-08;199;170;16;3;17;7145;3004;170;53;408
FR;6;2022-04-09;145;139;6;12;13;7290;3143;176;65;421
FR;6;2022-04-10;10;20;3;0;1;7300;3163;179;65;422
FR;6;2022-04-11;101;106;4;0;5;7401;3269;183;65;427
FR;6;2022-04-12;135;75;5;8;10;7536;3344;188;73;437
FR;6;2022-04-13;160;175;7;5;13;7696;3519;195;78;450
FR;6;2022-04-14;100;103;5;10;8;7796;3622;200;88;458
FR;6;2022-04-15;160;148;11;7;19;7956;3770;211;95;477
FR;6;2022-04-16;127;132;5;0;14;8083;3902;216;95;491
FR;6;2022-04-17;8;9;4;0;4;8091;3911;220;95;495
FR;6;2022-04-18;8;15;3;0;4;8099;3926;223;95;499
FR;6;2022-04-19;97;112;4;3;3;8196;4038;227;98;502
FR;6;2022-04-20;173;227;8;7;15;8369;4265;235;105;517
FR;6;2022-04-21;111;93;8;4;11;8480;4358;243;109;528
FR;6;2022-04-22;138;160;13;12;13;8618;4518;256;121;541
FR;6;2022-04-23;104;129;1;1;7;8722;4647;257;122;548
FR;6;2022-04-24;5;21;1;0;0;8727;4668;258;122;548
FR;6;2022-04-25;90;128;3;8;11;8817;4796;261;130;559
FR;6;2022-04-26;101;128;18;2;16;8918;4924;279;132;575
FR;6;2022-04-27;197;159;21;1;27;9115;5083;300;133;602
FR;6;2022-04-28;109;87;7;1;8;9224;5170;307;134;610
FR;6;2022-04-29;191;168;16;2;20;9415;5338;323;136;630
FR;6;2022-04-30;131;125;7;1;24;9546;5463;330;137;654
FR;6;2022-05-01;7;6;0;0;0;9553;5469;330;137;654
FR;6;2022-05-02;94;65;3;4;3;9647;5534;333;141;657
FR;6;2022-05-03;136;92;11;2;7;9783;5626;344;143;664
FR;6;2022-05-04;166;118;25;12;29;9949;5744;369;155;693
FR;6;2022-05-05;101;70;8;3;12;10050;5814;377;158;705
FR;6;2022-05-06;152;110;10;9;16;10202;5924;387;167;721
FR;6;2022-05-07;138;93;13;3;23;10340;6017;400;170;744
FR;6;2022-05-08;20;8;6;5;7;10360;6025;406;175;751
FR;6;2022-05-09;86;73;9;7;13;10446;6098;415;182;764
FR;6;2022-05-10;111;80;15;7;12;10557;6178;430;189;776
FR;6;2022-05-11;129;120;11;14;20;10686;6298;441;203;796
FR;6;2022-05-12;105;75;6;5;13;10791;6373;447;208;809
FR;6;2022-05-13;154;95;17;21;20;10945;6468;464;229;829
FR;6;2022-05-14;81;60;6;7;15;11026;6528;470;236;844
FR;6;2022-05-15;12;7;0;0;0;11038;6535;470;236;844
FR;6;2022-05-16;64;54;6;2;12;11102;6589;476;238;856
FR;6;2022-05-17;123;77;5;7;11;11225;6666;481;245;867
FR;6;2022-05-18;130;116;5;1;13;11355;6782;486;246;880
FR;6;2022-05-19;124;57;6;8;9;11479;6839;492;254;889
FR;6;2022-05-20;127;115;13;3;18;11606;6954;505;257;907
FR;6;2022-05-21;90;67;14;3;12;11696;7021;519;260;919
FR;6;2022-05-22;19;12;5;0;4;11715;7033;524;260;923
FR;6;2022-05-23;73;72;3;2;6;11788;7105;527;262;929
FR;6;2022-05-24;116;98;8;2;16;11904;7203;535;264;945
FR;6;2022-05-25;139;128;6;3;11;12043;7331;541;267;956
FR;6;2022-05-26;7;9;3;0;9;12050;7340;544;267;965
FR;6;2022-05-27;127;105;15;11;18;12177;7445;559;278;983
FR;6;2022-05-28;51;73;1;5;8;12228;7518;560;283;991
FR;6;2022-05-29;8;10;0;0;1;12236;7528;560;283;992
FR;6;2022-05-30;69;69;7;4;4;12305;7597;567;287;996
FR;6;2022-05-31;87;101;10;2;14;12392;7698;577;289;1010
FR;6;2022-06-01;94;87;10;1;11;12486;7785;587;290;1021
FR;6;2022-06-02;88;60;6;3;9;12574;7845;593;293;1030
FR;6;2022-06-03;123;102;13;7;21;12697;7947;606;300;1051
FR;6;2022-06-04;61;51;10;0;12;12758;7998;616;300;1063
FR;6;2022-06-05;16;15;2;1;4;12774;8013;618;301;1067
FR;6;2022-06-06;8;6;0;0;0;12782;8019;618;301;1067
FR;6;2022-06-07;77;86;3;4;6;12859;8105;621;305;1073
FR;0;2020-12-27;602;0;0;0;0;602;0;0;0;0
FR;0;2020-12-28;669;1;0;0;0;1271;1;0;0;0
FR;0;2020-12-29;374;0;0;0;0;1645;1;0;0;0
FR;0;2020-12-30;440;0;0;0;0;2085;1;0;0;0
FR;0;2020-12-31;436;1;0;0;0;2521;2;0;0;0
FR;0;2021-01-01;1137;2;0;0;0;3658;4;0;0;0
FR;0;2021-01-02;358;3;0;0;0;4016;7;0;0;0
FR;0;2021-01-03;402;0;0;0;0;4418;7;0;0;0
FR;0;2021-01-04;2092;2;0;0;0;6510;9;0;0;0
FR;0;2021-01-05;7712;3;0;0;0;14222;12;0;0;0
FR;0;2021-01-06;12447;13;0;0;0;26669;25;0;0;0
FR;0;2021-01-07;29448;9;0;0;0;56117;34;0;0;0
FR;0;2021-01-08;37121;12;0;0;0;93238;46;0;0;0
FR;0;2021-01-09;11209;4;0;0;0;104447;50;0;0;0
FR;0;2021-01-10;5996;3;0;0;0;110443;53;0;0;0
FR;0;2021-01-11;39925;17;0;0;0;150368;70;0;0;0
FR;0;2021-01-12;62126;16;0;0;0;212494;86;0;0;0
FR;0;2021-01-13;65110;30;0;0;0;277604;116;0;0;0
FR;0;2021-01-14;83122;87;0;0;0;360726;203;0;0;0
FR;0;2021-01-15;68992;34;0;0;0;429718;237;0;0;0
FR;0;2021-01-16;20208;69;0;0;0;449926;306;0;0;0
FR;0;2021-01-17;10977;47;0;0;0;460903;353;0;0;0
FR;0;2021-01-18;85884;164;0;0;0;546787;517;0;0;0
FR;0;2021-01-19;130576;174;0;0;0;677363;691;0;0;0
FR;0;2021-01-20;137526;171;0;0;0;814889;862;0;0;0
FR;0;2021-01-21;158379;170;0;0;0;973268;1032;0;0;0
FR;0;2021-01-22;121044;208;0;0;0;1094312;1240;0;0;0
FR;0;2021-01-23;38467;64;0;0;0;1132779;1304;0;0;0
FR;0;2021-01-24;9740;74;0;0;0;1142519;1378;0;0;0
FR;0;2021-01-25;78223;1271;0;0;0;1220742;2649;0;0;0
FR;0;2021-01-26;100365;3293;1;0;0;1321107;5942;1;0;0
FR;0;2021-01-27;107223;5934;0;0;0;1428330;11876;1;0;0
FR;0;2021-01-28;124331;15062;0;0;0;1552661;26938;1;0;0
FR;0;2021-01-29;92172;17740;0;0;0;1644833;44678;1;0;0
FR;0;2021-01-30;29114;4316;0;0;0;1673947;48994;1;0;0
FR;0;2021-01-31;5228;1741;0;0;0;1679175;50735;1;0;0
FR;0;2021-02-01;53108;21534;0;0;0;1732283;72269;1;0;0
FR;0;2021-02-02;72281;35782;0;0;0;1804564;108051;1;0;0
FR;0;2021-02-03;72291;38120;0;0;0;1876855;146171;1;0;0
FR;0;2021-02-04;82049;51606;0;0;0;1958904;197777;1;0;0
FR;0;2021-02-05;68216;46134;0;0;0;2027120;243911;1;0;0
FR;0;2021-02-06;23104;10774;0;0;0;2050224;254685;1;0;0
FR;0;2021-02-07;5182;5317;0;0;0;2055406;260002;1;0;0
FR;0;2021-02-08;46819;46894;0;0;0;2102225;306896;1;0;0
FR;0;2021-02-09;65992;74577;0;0;0;2168217;381473;1;0;0
FR;0;2021-02-10;70989;79465;0;0;0;2239206;460938;1;0;0
FR;0;2021-02-11;87242;101397;0;0;0;2326448;562335;1;0;0
FR;0;2021-02-12;79292;75036;0;0;0;2405740;637371;1;0;0
FR;0;2021-02-13;22353;19491;0;0;0;2428093;656862;1;0;0
FR;0;2021-02-14;5071;7288;0;0;0;2433164;664150;1;0;0
FR;0;2021-02-15;38069;76613;0;0;0;2471233;740763;1;0;0
FR;0;2021-02-16;50364;100523;0;0;0;2521597;841286;1;0;0
FR;0;2021-02-17;50502;104657;1;0;0;2572099;945943;2;0;0
FR;0;2021-02-18;69760;120643;0;0;0;2641859;1066586;2;0;0
FR;0;2021-02-19;65050;91103;1;0;0;2706909;1157689;3;0;0
FR;0;2021-02-20;18574;28581;0;0;0;2725483;1186270;3;0;0
FR;0;2021-02-21;3314;6274;0;0;0;2728797;1192544;3;0;0
FR;0;2021-02-22;37482;73193;2;0;0;2766279;1265737;5;0;0
FR;0;2021-02-23;53762;84424;1;0;0;2820041;1350161;6;0;0
FR;0;2021-02-24;59982;81799;1;0;0;2880023;1431960;7;0;0
FR;0;2021-02-25;100545;91478;1;0;0;2980568;1523438;8;0;0
FR;0;2021-02-26;113432;70733;1;0;0;3094000;1594171;9;0;0
FR;0;2021-02-27;52091;22154;0;0;0;3146091;1616325;9;0;0
FR;0;2021-02-28;6193;4257;1;0;0;3152284;1620582;10;0;0
FR;0;2021-03-01;65838;53272;1;0;0;3218122;1673854;11;0;0
FR;0;2021-03-02;101349;66632;2;0;0;3319471;1740486;13;0;0
FR;0;2021-03-03;116472;65536;0;0;0;3435943;1806022;13;0;0
FR;0;2021-03-04;163588;70322;3;0;0;3599531;1876344;16;0;0
FR;0;2021-03-05;200887;63065;3;0;0;3800418;1939409;19;0;0
FR;0;2021-03-06;207929;17708;3;0;0;4008347;1957117;22;0;0
FR;0;2021-03-07;121250;4968;1;0;0;4129597;1962085;23;0;0
FR;0;2021-03-08;107114;50309;2;0;0;4236711;2012394;25;0;0
FR;0;2021-03-09;172423;56486;2;0;0;4409134;2068880;27;0;0
FR;0;2021-03-10;178943;57120;5;0;0;4588077;2126000;32;0;0
FR;0;2021-03-11;242834;63526;2;0;0;4830911;2189526;34;0;0
FR;0;2021-03-12;294780;53358;1;0;0;5125691;2242884;35;0;0
FR;0;2021-03-13;231374;15326;1;0;0;5357065;2258210;36;0;0
FR;0;2021-03-14;63338;3269;1;0;0;5420403;2261479;37;0;0
FR;0;2021-03-15;158606;32137;3;0;0;5579009;2293616;40;0;0
FR;0;2021-03-16;141540;39107;6;0;0;5720549;2332723;46;0;0
FR;0;2021-03-17;150448;38172;4;0;0;5870997;2370895;50;0;0
FR;0;2021-03-18;167788;44537;5;0;0;6038785;2415432;55;0;0
FR;0;2021-03-19;229969;37142;2;0;0;6268754;2452574;57;0;0
FR;0;2021-03-20;166643;11563;1;0;0;6435397;2464137;58;0;0
FR;0;2021-03-21;49920;2494;1;0;0;6485317;2466631;59;0;0
FR;0;2021-03-22;169998;33972;2;0;0;6655315;2500603;61;0;0
FR;0;2021-03-23;250330;42366;1;0;0;6905645;2542969;62;0;0
FR;0;2021-03-24;256860;43666;0;0;0;7162505;2586635;62;0;0
FR;0;2021-03-25;341759;44864;5;0;0;7504264;2631499;67;0;0
FR;0;2021-03-26;358754;41901;4;1;0;7863018;2673400;71;1;0
FR;0;2021-03-27;195240;16738;1;0;0;8058258;2690138;72;1;0
FR;0;2021-03-28;59323;4034;3;0;0;8117581;2694172;75;1;0
FR;0;2021-03-29;202936;53963;4;0;0;8320517;2748135;79;1;0
FR;0;2021-03-30;285427;69642;4;0;0;8605944;2817777;83;1;0
FR;0;2021-03-31;262970;73304;4;0;0;8868914;2891081;87;1;0
FR;0;2021-04-01;315397;89362;12;0;0;9184311;2980443;99;1;0
FR;0;2021-04-02;281285;92820;7;0;0;9465596;3073263;106;1;0
FR;0;2021-04-03;141051;61961;5;0;0;9606647;3135224;111;1;0
FR;0;2021-04-04;46469;18733;2;0;0;9653116;3153957;113;1;0
FR;0;2021-04-05;63308;10792;11;0;0;9716424;3164749;124;1;0
FR;0;2021-04-06;217152;109416;17;0;0;9933576;3274165;141;1;0
FR;0;2021-04-07;260200;115440;17;0;0;10193776;3389605;158;1;0
FR;0;2021-04-08;337743;121800;14;0;0;10531519;3511405;172;1;0
FR;0;2021-04-09;410083;116345;49;0;0;10941602;3627750;221;1;0
FR;0;2021-04-10;212585;82636;15;0;0;11154187;3710386;236;1;0
FR;0;2021-04-11;56123;34430;7;0;0;11210310;3744816;243;1;0
FR;0;2021-04-12;237007;115225;45;0;0;11447317;3860041;288;1;0
FR;0;2021-04-13;309424;144478;98;1;0;11756741;4004519;386;2;0
FR;0;2021-04-14;294444;139319;213;0;0;12051185;4143838;599;2;0
FR;0;2021-04-15;337015;148439;338;0;0;12388200;4292277;937;2;0
FR;0;2021-04-16;339229;145928;353;0;0;12727429;4438205;1290;2;0
FR;0;2021-04-17;188627;90015;109;0;0;12916056;4528220;1399;2;0
FR;0;2021-04-18;51604;35360;47;0;0;12967660;4563580;1446;2;0
FR;0;2021-04-19;205645;138218;454;0;0;13173305;4701798;1900;2;0
FR;0;2021-04-20;254350;170893;569;0;0;13427655;4872691;2469;2;0
FR;0;2021-04-21;253182;169120;834;0;0;13680837;5041811;3303;2;0
FR;0;2021-04-22;287495;188807;818;0;0;13968332;5230618;4121;2;0
FR;0;2021-04-23;297922;183425;747;0;0;14266254;5414043;4868;2;0
FR;0;2021-04-24;190414;111575;252;0;0;14456668;5525618;5120;2;0
FR;0;2021-04-25;69542;38781;51;0;0;14526210;5564399;5171;2;0
FR;0;2021-04-26;220897;156294;560;0;0;14747107;5720693;5731;2;0
FR;0;2021-04-27;284551;187390;940;0;0;15031658;5908083;6671;2;0
FR;0;2021-04-28;299445;183255;1422;1;1;15331103;6091338;8093;3;1
FR;0;2021-04-29;357063;196561;1277;0;0;15688166;6287899;9370;3;1
FR;0;2021-04-30;372142;184819;1119;1;0;16060308;6472718;10489;4;1
FR;0;2021-05-01;167608;52478;178;0;0;16227916;6525196;10667;4;1
FR;0;2021-05-02;91708;37756;83;0;0;16319624;6562952;10750;4;1
FR;0;2021-05-03;288862;168324;840;0;0;16608486;6731276;11590;4;1
FR;0;2021-05-04;315601;224367;1230;0;0;16924087;6955643;12820;4;1
FR;0;2021-05-05;327110;224798;1313;0;0;17251197;7180441;14133;4;1
FR;0;2021-05-06;379432;239444;1630;0;0;17630629;7419885;15763;4;1
FR;0;2021-05-07;372687;257330;1222;0;0;18003316;7677215;16985;4;1
FR;0;2021-05-08;222135;67522;298;0;0;18225451;7744737;17283;4;1
FR;0;2021-05-09;129684;46331;243;0;0;18355135;7791068;17526;4;1
FR;0;2021-05-10;313317;228764;1233;0;0;18668452;8019832;18759;4;1
FR;0;2021-05-11;403828;257823;1563;0;0;19072280;8277655;20322;4;1
FR;0;2021-05-12;434036;233104;1542;0;0;19506316;8510759;21864;4;1
FR;0;2021-05-13;338552;56930;430;0;0;19844868;8567689;22294;4;1
FR;0;2021-05-14;454054;167267;1122;0;0;20298922;8734956;23416;4;1
FR;0;2021-05-15;374921;94047;442;0;0;20673843;8829003;23858;4;1
FR;0;2021-05-16;202724;20774;168;0;0;20876567;8849777;24026;4;1
FR;0;2021-05-17;376070;148825;1550;0;0;21252637;8998602;25576;4;1
FR;0;2021-05-18;460067;153139;1986;0;0;21712704;9151741;27562;4;1
FR;0;2021-05-19;467325;144617;2457;0;0;22180029;9296358;30019;4;1
FR;0;2021-05-20;507465;160204;2332;0;0;22687494;9456562;32351;4;1
FR;0;2021-05-21;489603;174433;1988;0;0;23177097;9630995;34339;4;1
FR;0;2021-05-22;347143;79879;668;0;0;23524240;9710874;35007;4;1
FR;0;2021-05-23;161670;14380;246;0;0;23685910;9725254;35253;4;1
FR;0;2021-05-24;263152;33173;600;0;0;23949062;9758427;35853;4;1
FR;0;2021-05-25;400201;189196;2349;1;0;24349263;9947623;38202;5;1
FR;0;2021-05-26;413397;188534;2218;0;0;24762660;10136157;40420;5;1
FR;0;2021-05-27;449746;218714;2159;0;0;25212406;10354871;42579;5;1
FR;0;2021-05-28;429488;259493;1891;0;0;25641894;10614364;44470;5;1
FR;0;2021-05-29;298947;149403;583;0;0;25940841;10763767;45053;5;1
FR;0;2021-05-30;107122;32575;163;0;0;26047963;10796342;45216;5;1
FR;0;2021-05-31;357980;203319;1466;1;1;26405943;10999661;46682;6;2
FR;0;2021-06-01;430884;251170;1959;1;1;26836827;11250831;48641;7;3
FR;0;2021-06-02;419527;230830;1979;0;0;27256354;11481661;50620;7;3
FR;0;2021-06-03;464916;258383;1819;0;0;27721270;11740044;52439;7;3
FR;0;2021-06-04;455774;304704;1729;1;1;28177044;12044748;54168;8;4
FR;0;2021-06-05;304752;188955;651;0;0;28481796;12233703;54819;8;4
FR;0;2021-06-06;133248;49134;226;0;0;28615044;12282837;55045;8;4
FR;0;2021-06-07;339131;261887;1519;0;0;28954175;12544724;56564;8;4
FR;0;2021-06-08;393576;290916;1798;0;0;29347751;12835640;58362;8;4
FR;0;2021-06-09;384676;275374;1727;0;0;29732427;13111014;60089;8;4
FR;0;2021-06-10;403975;288779;1720;1;0;30136402;13399793;61809;9;4
FR;0;2021-06-11;386471;357188;1461;0;0;30522873;13756981;63270;9;4
FR;0;2021-06-12;283210;211279;490;0;0;30806083;13968260;63760;9;4
FR;0;2021-06-13;104835;73977;204;0;0;30910918;14042237;63964;9;4
FR;0;2021-06-14;240657;355486;1426;1;0;31151575;14397723;65390;10;4
FR;0;2021-06-15;307999;385526;1565;1;0;31459574;14783249;66955;11;4
FR;0;2021-06-16;313848;357729;1416;1;0;31773422;15140978;68371;12;4
FR;0;2021-06-17;317565;372476;1422;1;0;32090987;15513454;69793;13;4
FR;0;2021-06-18;321561;442443;1332;1;0;32412548;15955897;71125;14;4
FR;0;2021-06-19;224306;273792;448;0;0;32636854;16229689;71573;14;4
FR;0;2021-06-20;74372;102593;127;0;0;32711226;16332282;71700;14;4
FR;0;2021-06-21;195571;401904;1032;1;1;32906797;16734186;72732;15;5
FR;0;2021-06-22;223011;467393;1262;10;2;33129808;17201579;73994;25;7
FR;0;2021-06-23;233876;439888;1196;1;1;33363684;17641467;75190;26;8
FR;0;2021-06-24;241736;409569;1349;0;0;33605420;18051036;76539;26;8
FR;0;2021-06-25;227473;522252;1398;0;0;33832893;18573288;77937;26;8
FR;0;2021-06-26;153192;370733;586;1;0;33986085;18944021;78523;27;8
FR;0;2021-06-27;55864;156211;168;1;0;34041949;19100232;78691;28;8
FR;0;2021-06-28;154621;452890;1169;0;0;34196570;19553122;79860;28;8
FR;0;2021-06-29;182549;506824;2124;0;0;34379119;20059946;81984;28;8
FR;0;2021-06-30;203843;482825;2010;21;2;34582962;20542771;83994;49;10
FR;0;2021-07-01;231125;457816;2221;5;1;34814087;21000587;86215;54;11
FR;0;2021-07-02;228356;520212;2119;5;3;35042443;21520799;88334;59;14
FR;0;2021-07-03;141943;368732;909;3;1;35184386;21889531;89243;62;15
FR;0;2021-07-04;56694;141258;265;0;0;35241080;22030789;89508;62;15
FR;0;2021-07-05;168244;419297;1668;8;2;35409324;22450086;91176;70;17
FR;0;2021-07-06;196586;474785;1828;45;8;35605910;22924871;93004;115;25
FR;0;2021-07-07;212973;439312;1877;24;5;35818883;23364183;94881;139;30
FR;0;2021-07-08;231452;424177;2088;20;7;36050335;23788360;96969;159;37
FR;0;2021-07-09;228356;510777;2182;4;2;36278691;24299137;99151;163;39
FR;0;2021-07-10;148537;339883;982;1;1;36427228;24639020;100133;164;40
FR;0;2021-07-11;60144;110142;282;0;0;36487372;24749162;100415;164;40
FR;0;2021-07-12;168971;478194;1757;4;0;36656343;25227356;102172;168;40
FR;0;2021-07-13;287079;527447;2045;8;2;36943422;25754803;104217;176;42
FR;0;2021-07-14;180904;157719;434;0;0;37124326;25912522;104651;176;42
FR;0;2021-07-15;346888;502493;2097;1;0;37471214;26415015;106748;177;42
FR;0;2021-07-16;379917;495934;2021;3;1;37851131;26910949;108769;180;43
FR;0;2021-07-17;259657;319806;876;1;0;38110788;27230755;109645;181;43
FR;0;2021-07-18;109668;114786;310;0;0;38220456;27345541;109955;181;43
FR;0;2021-07-19;285324;425005;1627;3;0;38505780;27770546;111582;184;43
FR;0;2021-07-20;376741;452404;1722;0;0;38882521;28222950;113304;184;43
FR;0;2021-07-21;395637;407884;1549;4;2;39278158;28630834;114853;188;45
FR;0;2021-07-22;440892;388110;1714;4;2;39719050;29018944;116567;192;47
FR;0;2021-07-23;440128;423156;1880;4;2;40159178;29442100;118447;196;49
FR;0;2021-07-24;285187;269607;803;1;0;40444365;29711707;119250;197;49
FR;0;2021-07-25;121056;80055;230;0;0;40565421;29791762;119480;197;49
FR;0;2021-07-26;347277;323185;1615;3;2;40912698;30114947;121095;200;51
FR;0;2021-07-27;463902;320280;1696;4;2;41376600;30435227;122791;204;53
FR;0;2021-07-28;459313;290008;1634;4;2;41835913;30725235;124425;208;55
FR;0;2021-07-29;489692;276918;1794;2;1;42325605;31002153;126219;210;56
FR;0;2021-07-30;461646;302857;1935;5;2;42787251;31305010;128154;215;58
FR;0;2021-07-31;285346;185075;914;1;0;43072597;31490085;129068;216;58
FR;0;2021-08-01;111942;49994;253;0;0;43184539;31540079;129321;216;58
FR;0;2021-08-02;341236;234587;1598;2;0;43525775;31774666;130919;218;58
FR;0;2021-08-03;398429;245074;1718;2;1;43924204;32019740;132637;220;59
FR;0;2021-08-04;384662;210106;1591;6;3;44308866;32229846;134228;226;62
FR;0;2021-08-05;365990;228900;1709;0;0;44674856;32458746;135937;226;62
FR;0;2021-08-06;359575;271698;1833;4;1;45034431;32730444;137770;230;63
FR;0;2021-08-07;213043;178374;755;4;3;45247474;32908818;138525;234;66
FR;0;2021-08-08;74134;63235;270;0;0;45321608;32972053;138795;234;66
FR;0;2021-08-09;258590;259512;1540;4;3;45580198;33231565;140335;238;69
FR;0;2021-08-10;306619;277992;1656;2;1;45886817;33509557;141991;240;70
FR;0;2021-08-11;279549;260268;1441;5;1;46166366;33769825;143432;245;71
FR;0;2021-08-12;271394;278640;1659;3;1;46437760;34048465;145091;248;72
FR;0;2021-08-13;252043;277936;1590;3;2;46689803;34326401;146681;251;74
FR;0;2021-08-14;145285;197333;739;0;0;46835088;34523734;147420;251;74
FR;0;2021-08-15;39309;50111;215;1;0;46874397;34573845;147635;252;74
FR;0;2021-08-16;186049;318123;1539;0;0;47060446;34891968;149174;252;74
FR;0;2021-08-17;215563;336551;1634;7;1;47276009;35228519;150808;259;75
FR;0;2021-08-18;198944;324753;1594;7;4;47474953;35553272;152402;266;79
FR;0;2021-08-19;191901;325771;1634;1;0;47666854;35879043;154036;267;79
FR;0;2021-08-20;186364;366417;1812;3;2;47853218;36245460;155848;270;81
FR;0;2021-08-21;104760;238164;704;0;0;47957978;36483624;156552;270;81
FR;0;2021-08-22;31890;87200;253;1;1;47989868;36570824;156805;271;82
FR;0;2021-08-23;140900;357276;1560;3;1;48130768;36928100;158365;274;83
FR;0;2021-08-24;162407;376909;1847;5;1;48293175;37305009;160212;279;84
FR;0;2021-08-25;151064;350887;2028;8;3;48444239;37655896;162240;287;87
FR;0;2021-08-26;142758;342896;2555;10;1;48586997;37998792;164795;297;88
FR;0;2021-08-27;148370;388280;2789;11;3;48735367;38387072;167584;308;91
FR;0;2021-08-28;90610;249583;1405;0;0;48825977;38636655;168989;308;91
FR;0;2021-08-29;27304;83325;516;1;0;48853281;38719980;169505;309;91
FR;0;2021-08-30;117330;324884;4706;6;6018;48970611;39044864;174211;315;6109
FR;0;2021-08-31;128718;334666;10178;19;11875;49099329;39379530;184389;334;17984
FR;0;2021-09-01;135796;285698;22419;7;24314;49235125;39665228;206808;341;42298
FR;0;2021-09-02;112662;247296;26512;13;28877;49347787;39912524;233320;354;71175
FR;0;2021-09-03;118214;292714;29956;23;32963;49466001;40205238;263276;377;104138
FR;0;2021-09-04;89822;217736;12582;12;14080;49555823;40422974;275858;389;118218
FR;0;2021-09-05;21341;44864;4391;2;4734;49577164;40467838;280249;391;122952
FR;0;2021-09-06;75338;180800;31946;16;34238;49652502;40648638;312195;407;157190
FR;0;2021-09-07;80124;181273;33238;40;36120;49732626;40829911;345433;447;193310
FR;0;2021-09-08;89876;206209;29653;27;32455;49822502;41036120;375086;474;225765
FR;0;2021-09-09;76698;165421;33042;26;36525;49899200;41201541;408128;500;262290
FR;0;2021-09-10;95653;203710;35718;26;40523;49994853;41405251;443846;526;302813
FR;0;2021-09-11;66805;169223;12134;19;14315;50061658;41574474;455980;545;317128
FR;0;2021-09-12;12798;32081;2767;1;3159;50074456;41606555;458747;546;320287
FR;0;2021-09-13;64379;126381;41207;32;44063;50138835;41732936;499954;578;364350
FR;0;2021-09-14;73341;129141;56347;78;62064;50212176;41862077;556301;656;426414
FR;0;2021-09-15;76422;167874;55631;58;54773;50288598;42029951;611932;714;481187
FR;0;2021-09-16;63771;114571;60035;85;60031;50352369;42144522;671967;799;541218
FR;0;2021-09-17;74981;156843;53828;71;57242;50427350;42301365;725795;870;598460
FR;0;2021-09-18;48191;139586;15596;25;17284;50475541;42440951;741391;895;615744
FR;0;2021-09-19;7864;23717;2434;1;2619;50483405;42464668;743825;896;618363
FR;0;2021-09-20;44452;93929;50026;73;50256;50527857;42558597;793851;969;668619
FR;0;2021-09-21;45813;98440;62732;76;63373;50573670;42657037;856583;1045;731992
FR;0;2021-09-22;48596;142322;55332;83;55353;50622266;42799359;911915;1128;787345
FR;0;2021-09-23;43169;92020;62356;94;63486;50665435;42891379;974271;1222;850831
FR;0;2021-09-24;52229;133316;54530;109;59103;50717664;43024695;1028801;1331;909934
FR;0;2021-09-25;35194;115522;16265;37;18256;50752858;43140217;1045066;1368;928190
FR;0;2021-09-26;5526;17812;2265;5;2326;50758384;43158029;1047331;1373;930516
FR;0;2021-09-27;33927;76988;47178;97;48133;50792311;43235017;1094509;1470;978649
FR;0;2021-09-28;36452;75263;54934;88;56479;50828763;43310280;1149443;1558;1035128
FR;0;2021-09-29;44318;100834;53323;112;54816;50873081;43411114;1202766;1670;1089944
FR;0;2021-09-30;36273;72833;57006;96;59484;50909354;43483947;1259772;1766;1149428
FR;0;2021-10-01;61536;100912;57781;108;63700;50970890;43584859;1317553;1874;1213128
FR;0;2021-10-02;39420;78358;20953;38;23319;51010310;43663217;1338506;1912;1236447
FR;0;2021-10-03;5268;10527;2524;4;2537;51015578;43673744;1341030;1916;1238984
FR;0;2021-10-04;34980;58539;52609;84;54781;51050558;43732283;1393639;2000;1293765
FR;0;2021-10-05;33603;64342;60965;135;64929;51084161;43796625;1454604;2135;1358694
FR;0;2021-10-06;42481;79265;65689;113;68226;51126642;43875890;1520293;2248;1426920
FR;0;2021-10-07;30421;62173;65380;90;68667;51157063;43938063;1585673;2338;1495587
FR;0;2021-10-08;48759;91817;77719;110;84623;51205822;44029880;1663392;2448;1580210
FR;0;2021-10-09;33626;60887;31524;36;33864;51239448;44090767;1694916;2484;1614074
FR;0;2021-10-10;4643;7439;3186;9;3482;51244091;44098206;1698102;2493;1617556
FR;0;2021-10-11;30570;49900;61020;105;64020;51274661;44148106;1759122;2598;1681576
FR;0;2021-10-12;31408;54440;70565;139;75832;51306069;44202546;1829687;2737;1757408
FR;0;2021-10-13;40001;62790;74398;135;79251;51346070;44265336;1904085;2872;1836659
FR;0;2021-10-14;30239;52895;68724;116;73760;51376309;44318231;1972809;2988;1910419
FR;0;2021-10-15;44746;75279;93218;191;102902;51421055;44393510;2066027;3179;2013321
FR;0;2021-10-16;31277;44084;36681;44;39610;51452332;44437594;2102708;3223;2052931
FR;0;2021-10-17;3828;5276;3591;2;3692;51456160;44442870;2106299;3225;2056623
FR;0;2021-10-18;28418;42479;67470;133;71333;51484578;44485349;2173769;3358;2127956
FR;0;2021-10-19;27059;44625;76381;140;81605;51511637;44529974;2250150;3498;2209561
FR;0;2021-10-20;35209;52453;96908;180;101473;51546846;44582427;2347058;3678;2311034
FR;0;2021-10-21;25972;45207;83920;112;89110;51572818;44627634;2430978;3790;2400144
FR;0;2021-10-22;38215;62378;104867;200;112492;51611033;44690012;2535845;3990;2512636
FR;0;2021-10-23;26974;41230;45436;57;48600;51638007;44731242;2581281;4047;2561236
FR;0;2021-10-24;2913;4803;3679;6;3936;51640920;44736045;2584960;4053;2565172
FR;0;2021-10-25;25982;36355;82305;144;86599;51666902;44772400;2667265;4197;2651771
FR;0;2021-10-26;23687;35094;87206;166;92309;51690589;44807494;2754471;4363;2744080
FR;0;2021-10-27;30018;46425;108967;257;114623;51720607;44853919;2863438;4620;2858703
FR;0;2021-10-28;23429;34906;88658;153;94387;51744036;44888825;2952096;4773;2953090
FR;0;2021-10-29;31519;51403;117284;204;125256;51775555;44940228;3069380;4977;3078346
FR;0;2021-10-30;20533;33139;50324;77;53353;51796088;44973367;3119704;5054;3131699
FR;0;2021-10-31;2480;3755;3585;3;3868;51798568;44977122;3123289;5057;3135567
FR;0;2021-11-01;8222;4816;3202;3;3556;51806790;44981938;3126491;5060;3139123
FR;0;2021-11-02;25313;40089;93535;157;99481;51832103;45022027;3220026;5217;3238604
FR;0;2021-11-03;29779;47927;118846;218;125792;51861882;45069954;3338872;5435;3364396
FR;0;2021-11-04;23669;37506;107501;217;114331;51885551;45107460;3446373;5652;3478727
FR;0;2021-11-05;32286;52901;141593;234;151261;51917837;45160361;3587966;5886;3629988
FR;0;2021-11-06;21493;34559;64844;123;68231;51939330;45194920;3652810;6009;3698219
FR;0;2021-11-07;2380;4229;5180;6;5590;51941710;45199149;3657990;6015;3703809
FR;0;2021-11-08;20436;37826;127130;227;134181;51962146;45236975;3785120;6242;3837990
FR;0;2021-11-09;22166;44819;161625;341;172128;51984312;45281794;3946745;6583;4010118
FR;0;2021-11-10;31397;55124;186935;446;198688;52015709;45336918;4133680;7029;4208806
FR;0;2021-11-11;4343;6746;12929;28;13929;52020052;45343664;4146609;7057;4222735
FR;0;2021-11-12;28994;55142;183720;252;197268;52049046;45398806;4330329;7309;4420003
FR;0;2021-11-13;20308;32709;80677;118;86288;52069354;45431515;4411006;7427;4506291
FR;0;2021-11-14;2337;3944;7164;6;7876;52071691;45435459;4418170;7433;4514167
FR;0;2021-11-15;20338;38780;160793;312;171463;52092029;45474239;4578963;7745;4685630
FR;0;2021-11-16;23393;44045;200317;391;214883;52115422;45518284;4779280;8136;4900513
FR;0;2021-11-17;30365;50479;199778;407;212789;52145787;45568763;4979058;8543;5113302
FR;0;2021-11-18;23359;45092;191575;468;205404;52169146;45613855;5170633;9011;5318706
FR;0;2021-11-19;33559;61406;243127;548;262068;52202705;45675261;5413760;9559;5580774
FR;0;2021-11-20;25352;36783;102118;206;109672;52228057;45712044;5515878;9765;5690446
FR;0;2021-11-21;2623;4564;9641;18;10642;52230680;45716608;5525519;9783;5701088
FR;0;2021-11-22;22740;33379;180286;470;194755;52253420;45749987;5705805;10253;5895843
FR;0;2021-11-23;25569;45724;229302;548;247725;52278989;45795711;5935107;10801;6143568
FR;0;2021-11-24;31769;53830;224740;717;243145;52310758;45849541;6159847;11518;6386713
FR;0;2021-11-25;25395;49153;255830;739;277592;52336153;45898694;6415677;12257;6664305
FR;0;2021-11-26;33214;74706;379384;864;414501;52369367;45973400;6795061;13121;7078806
FR;0;2021-11-27;23328;49716;214844;389;236576;52392695;46023116;7009905;13510;7315382
FR;0;2021-11-28;3479;10589;56730;66;63337;52396174;46033705;7066635;13576;7378719
FR;0;2021-11-29;19391;54257;341380;863;371562;52415565;46087962;7408015;14439;7750281
FR;0;2021-11-30;24731;72152;457289;987;500645;52440296;46160114;7865304;15426;8250926
FR;0;2021-12-01;26925;75979;468979;1159;511194;52467221;46236093;8334283;16585;8762120
FR;0;2021-12-02;21999;71829;526985;1279;574706;52489220;46307922;8861268;17864;9336826
FR;0;2021-12-03;25491;92556;596243;1419;650990;52514711;46400478;9457511;19283;9987816
FR;0;2021-12-04;18293;60547;336163;690;369700;52533004;46461025;9793674;19973;10357516
FR;0;2021-12-05;4142;16264;95753;157;107054;52537146;46477289;9889427;20130;10464570
FR;0;2021-12-06;23795;73244;493026;1174;539840;52560941;46550533;10382453;21304;11004410
FR;0;2021-12-07;23332;91817;645253;1769;706184;52584273;46642350;11027706;23073;11710594
FR;0;2021-12-08;25354;92504;591437;1873;647365;52609627;46734854;11619143;24946;12357959
FR;0;2021-12-09;24006;94363;662938;2179;726186;52633633;46829217;12282081;27125;13084145
FR;0;2021-12-10;27829;111131;735925;2076;805978;52661462;46940348;13018006;29201;13890123
FR;0;2021-12-11;20226;76065;435120;986;480325;52681688;47016413;13453126;30187;14370448
FR;0;2021-12-12;5625;23283;142267;262;159219;52687313;47039696;13595393;30449;14529667
FR;0;2021-12-13;21153;91319;587516;1697;649184;52708466;47131015;14182909;32146;15178851
FR;0;2021-12-14;27649;118709;765370;2652;847362;52736115;47249724;14948279;34798;16026213
FR;0;2021-12-15;28252;114595;694178;2262;768918;52764367;47364319;15642457;37060;16795131
FR;0;2021-12-16;27951;116098;763866;2555;844266;52792318;47480417;16406323;39615;17639397
FR;0;2021-12-17;31577;128828;807725;2709;891995;52823895;47609245;17214048;42324;18531392
FR;0;2021-12-18;24915;81773;469907;1178;522157;52848810;47691018;17683955;43502;19053549
FR;0;2021-12-19;8741;28832;169352;377;191130;52857551;47719850;17853307;43879;19244679
FR;0;2021-12-20;31635;97602;591336;1787;658626;52889186;47817452;18444643;45666;19903305
FR;0;2021-12-21;39228;112415;682292;2391;759460;52928414;47929867;19126935;48057;20662765
FR;0;2021-12-22;39475;99692;575648;2167;642043;52967889;48029559;19702583;50224;21304808
FR;0;2021-12-23;33749;79771;440896;1654;494324;53001638;48109330;20143479;51878;21799132
FR;0;2021-12-24;10667;26078;110976;396;126642;53012305;48135408;20254455;52274;21925774
FR;0;2021-12-25;770;3499;7573;25;9030;53013075;48138907;20262028;52299;21934804
FR;0;2021-12-26;4698;11912;52075;141;60131;53017773;48150819;20314103;52440;21994935
FR;0;2021-12-27;30416;84110;453445;1366;509079;53048189;48234929;20767548;53806;22504014
FR;0;2021-12-28;38320;99114;564073;1767;632171;53086509;48334043;21331621;55573;23136185
FR;0;2021-12-29;39847;88473;501119;1686;560930;53126356;48422516;21832740;57259;23697115
FR;0;2021-12-30;35892;75149;420960;1519;471097;53162248;48497665;22253700;58778;24168212
FR;0;2021-12-31;12038;25220;116838;406;131621;53174286;48522885;22370538;59184;24299833
FR;0;2022-01-01;1413;3206;8500;36;9932;53175699;48526091;22379038;59220;24309765
FR;0;2022-01-02;6077;13014;58396;125;66940;53181776;48539105;22437434;59345;24376705
FR;0;2022-01-03;33080;89983;494692;1593;551504;53214856;48629088;22932126;60938;24928209
FR;0;2022-01-04;41119;110948;641279;2302;714237;53255975;48740036;23573405;63240;25642446
FR;0;2022-01-05;60466;103425;569046;1984;634072;53316441;48843461;24142451;65224;26276518
FR;0;2022-01-06;44067;110193;638883;2695;711325;53360508;48953654;24781334;67919;26987843
FR;0;2022-01-07;50677;123157;710911;2806;790353;53411185;49076811;25492245;70725;27778196
FR;0;2022-01-08;44965;80342;423780;1210;472854;53456150;49157153;25916025;71935;28251050
FR;0;2022-01-09;15596;26699;128547;300;145692;53471746;49183852;26044572;72235;28396742
FR;0;2022-01-10;35130;89389;469199;1810;522258;53506876;49273241;26513771;74045;28919000
FR;0;2022-01-11;41678;100335;548133;2307;608399;53548554;49373576;27061904;76352;29527399
FR;0;2022-01-12;60202;95602;452564;1965;504230;53608756;49469178;27514468;78317;30031629
FR;0;2022-01-13;37984;92413;487246;2084;540954;53646740;49561591;28001714;80401;30572583
FR;0;2022-01-14;42426;103305;568487;2286;628956;53689166;49664896;28570201;82687;31201539
FR;0;2022-01-15;39314;65881;340090;985;377549;53728480;49730777;28910291;83672;31579088
FR;0;2022-01-16;11383;19303;87381;215;99446;53739863;49750080;28997672;83887;31678534
FR;0;2022-01-17;24625;60112;320210;1381;354125;53764488;49810192;29317882;85268;32032659
FR;0;2022-01-18;28110;68611;361002;1799;397510;53792598;49878803;29678884;87067;32430169
FR;0;2022-01-19;43082;67116;281215;1450;311065;53835680;49945919;29960099;88517;32741234
FR;0;2022-01-20;23443;59520;298907;1740;328431;53859123;50005439;30259006;90257;33069665
FR;0;2022-01-21;28038;68774;366282;2086;401124;53887161;50074213;30625288;92343;33470789
FR;0;2022-01-22;27606;47959;218762;838;241744;53914767;50122172;30844050;93181;33712533
FR;0;2022-01-23;6704;13030;48648;171;55173;53921471;50135202;30892698;93352;33767706
FR;0;2022-01-24;16211;47302;217243;1136;239318;53937682;50182504;31109941;94488;34007024
FR;0;2022-01-25;18913;54363;242977;1547;267038;53956595;50236867;31352918;96035;34274062
FR;0;2022-01-26;28119;60242;209216;1296;229355;53984714;50297109;31562134;97331;34503417
FR;0;2022-01-27;16283;46054;207582;1272;225827;54000997;50343163;31769716;98603;34729244
FR;0;2022-01-28;21501;75891;289988;1574;321449;54022498;50419054;32059704;100177;35050693
FR;0;2022-01-29;18403;52851;184088;686;204573;54040901;50471905;32243792;100863;35255266
FR;0;2022-01-30;4463;14540;39123;124;45087;54045364;50486445;32282915;100987;35300353
FR;0;2022-01-31;11224;43840;148150;738;164787;54056588;50530285;32431065;101725;35465140
FR;0;2022-02-01;12892;48170;174064;1142;191367;54069480;50578455;32605129;102867;35656507
FR;0;2022-02-02;20128;65967;171466;1033;190128;54089608;50644422;32776595;103900;35846635
FR;0;2022-02-03;11001;44216;157491;984;173301;54100609;50688638;32934086;104884;36019936
FR;0;2022-02-04;14521;66458;239177;1262;264166;54115130;50755096;33173263;106146;36284102
FR;0;2022-02-05;12787;51447;153520;522;172342;54127917;50806543;33326783;106668;36456444
FR;0;2022-02-06;2706;12232;28870;101;33826;54130623;50818775;33355653;106769;36490270
FR;0;2022-02-07;9395;46711;156821;586;176317;54140018;50865486;33512474;107355;36666587
FR;0;2022-02-08;9610;42728;166563;868;184332;54149628;50908214;33679037;108223;36850919
FR;0;2022-02-09;14178;57938;172291;869;192968;54163806;50966152;33851328;109092;37043887
FR;0;2022-02-10;8275;38457;150155;878;166604;54172081;51004609;34001483;109970;37210491
FR;0;2022-02-11;10767;55498;218441;1097;243014;54182848;51060107;34219924;111067;37453505
FR;0;2022-02-12;8351;40885;134691;461;151708;54191199;51100992;34354615;111528;37605213
FR;0;2022-02-13;1895;8579;26550;85;30906;54193094;51109571;34381165;111613;37636119
FR;0;2022-02-14;6912;35111;148317;477;166312;54200006;51144682;34529482;112090;37802431
FR;0;2022-02-15;6861;35501;146907;750;162453;54206867;51180183;34676389;112840;37964884
FR;0;2022-02-16;9300;42701;132482;719;146675;54216167;51222884;34808871;113559;38111559
FR;0;2022-02-17;5377;23907;87255;584;94800;54221544;51246791;34896126;114143;38206359
FR;0;2022-02-18;6921;33309;119601;802;129261;54228465;51280100;35015727;114945;38335620
FR;0;2022-02-19;5349;24452;70004;370;77307;54233814;51304552;35085731;115315;38412927
FR;0;2022-02-20;1139;4618;12152;38;13926;54234953;51309170;35097883;115353;38426853
FR;0;2022-02-21;4029;17768;61914;351;67140;54238982;51326938;35159797;115704;38493993
FR;0;2022-02-22;4375;18496;60783;575;64413;54243357;51345434;35220580;116279;38558406
FR;0;2022-02-23;6519;27176;66467;591;71864;54249876;51372610;35287047;116870;38630270
FR;0;2022-02-24;3749;15189;50379;518;53192;54253625;51387799;35337426;117388;38683462
FR;0;2022-02-25;5212;23626;76281;803;80005;54258837;51411425;35413707;118191;38763467
FR;0;2022-02-26;3971;17653;47395;357;51460;54262808;51429078;35461102;118548;38814927
FR;0;2022-02-27;870;2988;8022;47;8933;54263678;51432066;35469124;118595;38823860
FR;0;2022-02-28;3071;12277;40451;354;42884;54266749;51444343;35509575;118949;38866744
FR;0;2022-03-01;3187;12251;44135;433;44771;54269936;51456594;35553710;119382;38911515
FR;0;2022-03-02;5092;17493;47088;438;48999;54275028;51474087;35600798;119820;38960514
FR;0;2022-03-03;2676;8964;29832;362;29925;54277704;51483051;35630630;120182;38990439
FR;0;2022-03-04;3187;12206;40260;650;39391;54280891;51495257;35670890;120832;39029830
FR;0;2022-03-05;2989;9211;24928;310;25080;54283880;51504468;35695818;121142;39054910
FR;0;2022-03-06;510;1381;3193;42;3431;54284390;51505849;35699011;121184;39058341
FR;0;2022-03-07;1981;5479;18396;314;17658;54286371;51511328;35717407;121498;39075999
FR;0;2022-03-08;1973;5901;19408;359;17868;54288344;51517229;35736815;121857;39093867
FR;0;2022-03-09;3460;10286;22147;404;21227;54291804;51527515;35758962;122261;39115094
FR;0;2022-03-10;1718;5263;16903;341;15704;54293522;51532778;35775865;122602;39130798
FR;0;2022-03-11;2346;7306;24475;540;22234;54295868;51540084;35800340;123142;39153032
FR;0;2022-03-12;2655;6718;17149;304;16500;54298523;51546802;35817489;123446;39169532
FR;0;2022-03-13;386;781;2306;144;2256;54298909;51547583;35819795;123590;39171788
FR;0;2022-03-14;1472;4154;14936;4404;13790;54300381;51551737;35834731;127994;39185578
FR;0;2022-03-15;1599;4379;16236;7549;14342;54301980;51556116;35850967;135543;39199920
FR;0;2022-03-16;2945;7079;19370;13128;18035;54304925;51563195;35870337;148671;39217955
FR;0;2022-03-17;1374;3727;13096;10836;11937;54306299;51566922;35883433;159507;39229892
FR;0;2022-03-18;2203;5543;19950;18277;18035;54308502;51572465;35903383;177784;39247927
FR;0;2022-03-19;2278;4695;13104;9396;12404;54310780;51577160;35916487;187180;39260331
FR;0;2022-03-20;293;709;1911;1066;1920;54311073;51577869;35918398;188246;39262251
FR;0;2022-03-21;1344;3136;12695;14929;11915;54312417;51581005;35931093;203175;39274166
FR;0;2022-03-22;1465;3592;13759;20518;12516;54313882;51584597;35944852;223693;39286682
FR;0;2022-03-23;2642;6097;17658;23131;17164;54316524;51590694;35962510;246824;39303846
FR;0;2022-03-24;1355;2928;11550;17570;10622;54317879;51593622;35974060;264394;39314468
FR;0;2022-03-25;2047;4849;18502;27738;16831;54319926;51598471;35992562;292132;39331299
FR;0;2022-03-26;2216;4302;12059;12656;11497;54322142;51602773;36004621;304788;39342796
FR;0;2022-03-27;354;681;1882;1478;1915;54322496;51603454;36006503;306266;39344711
FR;0;2022-03-28;1414;2945;11077;17452;10569;54323910;51606399;36017580;323718;39355280
FR;0;2022-03-29;1421;3230;12871;27529;12016;54325331;51609629;36030451;351247;39367296
FR;0;2022-03-30;2812;5372;15628;27342;15021;54328143;51615001;36046079;378589;39382317
FR;0;2022-03-31;1592;3167;12904;24881;12233;54329735;51618168;36058983;403470;39394550
FR;0;2022-04-01;2096;4315;19988;30811;18602;54331831;51622483;36078971;434281;39413152
FR;0;2022-04-02;1497;2607;9032;10099;8691;54333328;51625090;36088003;444380;39421843
FR;0;2022-04-03;274;499;1557;1168;1573;54333602;51625589;36089560;445548;39423416
FR;0;2022-04-04;1362;2561;12277;19065;11463;54334964;51628150;36101837;464613;39434879
FR;0;2022-04-05;1593;2931;14262;33977;13107;54336557;51631081;36116099;498590;39447986
FR;0;2022-04-06;2037;3643;13442;26308;12682;54338594;51634724;36129541;524898;39460668
FR;0;2022-04-07;1429;2873;13584;33608;12788;54340023;51637597;36143125;558506;39473456
FR;0;2022-04-08;2018;4074;19134;43625;17749;54342041;51641671;36162259;602131;39491205
FR;0;2022-04-09;1346;2651;9290;13537;8838;54343387;51644322;36171549;615668;39500043
FR;0;2022-04-10;277;558;1969;1992;1976;54343664;51644880;36173518;617660;39502019
FR;0;2022-04-11;1190;2456;11815;23634;11419;54344854;51647336;36185333;641294;39513438
FR;0;2022-04-12;1566;2775;13922;40579;13298;54346420;51650111;36199255;681873;39526736
FR;0;2022-04-13;1850;3418;13319;32769;12914;54348270;51653529;36212574;714642;39539650
FR;0;2022-04-14;1436;2663;13077;35940;12898;54349706;51656192;36225651;750582;39552548
FR;0;2022-04-15;1784;3292;15506;35241;14753;54351490;51659484;36241157;785823;39567301
FR;0;2022-04-16;1030;1812;6366;8517;6219;54352520;51661296;36247523;794340;39573520
FR;0;2022-04-17;185;317;990;1156;1029;54352705;51661613;36248513;795496;39574549
FR;0;2022-04-18;150;442;2735;1039;2754;54352855;51662055;36251248;796535;39577303
FR;0;2022-04-19;1465;2906;12842;29391;12350;54354320;51664961;36264090;825926;39589653
FR;0;2022-04-20;1901;3331;13193;28776;12853;54356221;51668292;36277283;854702;39602506
FR;0;2022-04-21;1473;2726;12423;34703;12441;54357694;51671018;36289706;889405;39614947
FR;0;2022-04-22;1823;3466;16401;37436;15767;54359517;51674484;36306107;926841;39630714
FR;0;2022-04-23;1126;2033;7359;10636;7207;54360643;51676517;36313466;937477;39637921
FR;0;2022-04-24;241;441;1469;1578;1403;54360884;51676958;36314935;939055;39639324
FR;0;2022-04-25;1252;2443;10636;20865;10427;54362136;51679401;36325571;959920;39649751
FR;0;2022-04-26;1565;2949;13596;38262;13032;54363701;51682350;36339167;998182;39662783
FR;0;2022-04-27;1905;3000;11438;30504;11492;54365606;51685350;36350605;1028686;39674275
FR;0;2022-04-28;1519;2644;12435;35715;12155;54367125;51687994;36363040;1064401;39686430
FR;0;2022-04-29;1952;3430;15414;36838;14761;54369077;51691424;36378454;1101239;39701191
FR;0;2022-04-30;1182;1798;6836;9648;6655;54370259;51693222;36385290;1110887;39707846
FR;0;2022-05-01;185;298;889;960;884;54370444;51693520;36386179;1111847;39708730
FR;0;2022-05-02;1158;2134;10959;17819;10728;54371602;51695654;36397138;1129666;39719458
FR;0;2022-05-03;1727;2868;13403;34191;13250;54373329;51698522;36410541;1163857;39732708
FR;0;2022-05-04;1802;2937;11788;25266;11886;54375131;51701459;36422329;1189123;39744594
FR;0;2022-05-05;1608;2629;12380;32961;12137;54376739;51704088;36434709;1222084;39756731
FR;0;2022-05-06;2041;3504;15128;36425;14601;54378780;51707592;36449837;1258509;39771332
FR;0;2022-05-07;1172;1752;6390;9574;6378;54379952;51709344;36456227;1268083;39777710
FR;0;2022-05-08;252;385;1155;1522;1214;54380204;51709729;36457382;1269605;39778924
FR;0;2022-05-09;1241;2115;9767;19946;9632;54381445;51711844;36467149;1289551;39788556
FR;0;2022-05-10;1616;2835;13203;38319;12759;54383061;51714679;36480352;1327870;39801315
FR;0;2022-05-11;1910;2691;10554;27512;10460;54384971;51717370;36490906;1355382;39811775
FR;0;2022-05-12;1501;2478;11068;35039;10692;54386472;51719848;36501974;1390421;39822467
FR;0;2022-05-13;1908;3085;13563;37457;13156;54388380;51722933;36515537;1427878;39835623
FR;0;2022-05-14;1115;1580;5792;10685;5643;54389495;51724513;36521329;1438563;39841266
FR;0;2022-05-15;264;414;1234;1419;1311;54389759;51724927;36522563;1439982;39842577
FR;0;2022-05-16;1137;1911;8402;20698;8379;54390896;51726838;36530965;1460680;39850956
FR;0;2022-05-17;1516;2467;11553;37215;11128;54392412;51729305;36542518;1497895;39862084
FR;0;2022-05-18;1723;2479;9192;26723;9168;54394135;51731784;36551710;1524618;39871252
FR;0;2022-05-19;1368;2492;10232;34859;10262;54395503;51734276;36561942;1559477;39881514
FR;0;2022-05-20;1817;2949;12970;38809;12472;54397320;51737225;36574912;1598286;39893986
FR;0;2022-05-21;1128;1640;5297;9730;5196;54398448;51738865;36580209;1608016;39899182
FR;0;2022-05-22;226;317;998;1361;981;54398674;51739182;36581207;1609377;39900163
FR;0;2022-05-23;1093;1885;7874;19842;7818;54399767;51741067;36589081;1629219;39907981
FR;0;2022-05-24;1472;2604;10580;37817;10439;54401239;51743671;36599661;1667036;39918420
FR;0;2022-05-25;1746;2673;8842;24278;8953;54402985;51746344;36608503;1691314;39927373
FR;0;2022-05-26;165;282;982;1093;1014;54403150;51746626;36609485;1692407;39928387
FR;0;2022-05-27;1304;2261;8212;21051;7997;54404454;51748887;36617697;1713458;39936384
FR;0;2022-05-28;630;1197;3581;6738;3648;54405084;51750084;36621278;1720196;39940032
FR;0;2022-05-29;140;295;715;872;730;54405224;51750379;36621993;1721068;39940762
FR;0;2022-05-30;967;1818;6303;18845;6297;54406191;51752197;36628296;1739913;39947059
FR;0;2022-05-31;1427;2340;9472;34946;9320;54407618;51754537;36637768;1774859;39956379
FR;0;2022-06-01;1487;2442;7569;23559;7501;54409105;51756979;36645337;1798418;39963880
FR;0;2022-06-02;1319;2281;8767;34412;8379;54410424;51759260;36654104;1832830;39972259
FR;0;2022-06-03;1551;2783;10260;37806;9846;54411975;51762043;36664364;1870636;39982105
FR;0;2022-06-04;892;1400;4184;8878;4266;54412867;51763443;36668548;1879514;39986371
FR;0;2022-06-05;145;284;767;982;774;54413012;51763727;36669315;1880496;39987145
FR;0;2022-06-06;131;224;731;1055;726;54413143;51763951;36670046;1881551;39987871
FR;0;2022-06-07;1218;2330;8574;34058;8155;54414361;51766281;36678620;1915609;39996026
