fra;vaccin;jour;n_dose1;n_dose2;n_dose3;n_dose4;n_rappel;n_cum_dose1;n_cum_dose2;n_cum_dose3;n_cum_dose4;n_cum_rappel
FR;1;2020-12-27;609;0;0;0;0;609;0;0;0;0
FR;1;2020-12-28;682;1;0;0;0;1291;1;0;0;0
FR;1;2020-12-29;384;0;0;0;0;1675;1;0;0;0
FR;1;2020-12-30;443;0;0;0;0;2118;1;0;0;0
FR;1;2020-12-31;439;1;0;0;0;2557;2;0;0;0
FR;1;2021-01-01;1154;2;0;0;0;3711;4;0;0;0
FR;1;2021-01-02;362;3;0;0;0;4073;7;0;0;0
FR;1;2021-01-03;404;0;0;0;0;4477;7;0;0;0
FR;1;2021-01-04;2103;4;0;0;0;6580;11;0;0;0
FR;1;2021-01-05;7748;3;0;0;0;14328;14;0;0;0
FR;1;2021-01-06;12455;16;0;0;0;26783;30;0;0;0
FR;1;2021-01-07;29461;16;0;0;0;56244;46;0;0;0
FR;1;2021-01-08;37141;17;0;0;0;93385;63;0;0;0
FR;1;2021-01-09;11212;7;0;0;0;104597;70;0;0;0
FR;1;2021-01-10;6005;7;0;0;0;110602;77;0;0;0
FR;1;2021-01-11;39934;21;0;0;0;150536;98;0;0;0
FR;1;2021-01-12;62138;19;0;0;0;212674;117;0;0;0
FR;1;2021-01-13;65116;41;0;0;0;277790;158;0;0;0
FR;1;2021-01-14;81449;143;0;0;0;359239;301;0;0;0
FR;1;2021-01-15;68608;54;0;0;0;427847;355;0;0;0
FR;1;2021-01-16;19899;72;0;0;0;447746;427;0;0;0
FR;1;2021-01-17;10902;51;0;0;0;458648;478;0;0;0
FR;1;2021-01-18;82826;166;0;0;0;541474;644;0;0;0
FR;1;2021-01-19;125915;186;0;0;0;667389;830;0;0;0
FR;1;2021-01-20;132408;182;0;0;0;799797;1012;0;0;0
FR;1;2021-01-21;153055;172;0;0;0;952852;1184;0;0;0
FR;1;2021-01-22;115942;219;0;0;0;1068794;1403;0;0;0
FR;1;2021-01-23;36607;68;0;0;0;1105401;1471;0;0;0
FR;1;2021-01-24;9583;98;0;0;0;1114984;1569;0;0;0
FR;1;2021-01-25;74423;1330;0;0;0;1189407;2899;0;0;0
FR;1;2021-01-26;96454;3467;1;0;0;1285861;6366;1;0;0
FR;1;2021-01-27;103638;6090;0;0;0;1389499;12456;1;0;0
FR;1;2021-01-28;120600;15508;0;0;0;1510099;27964;1;0;0
FR;1;2021-01-29;88891;18102;0;0;0;1598990;46066;1;0;0
FR;1;2021-01-30;27991;4398;0;0;0;1626981;50464;1;0;0
FR;1;2021-01-31;5188;1807;0;0;0;1632169;52271;1;0;0
FR;1;2021-02-01;49721;21954;0;0;0;1681890;74225;1;0;0
FR;1;2021-02-02;67813;36647;0;0;0;1749703;110872;1;0;0
FR;1;2021-02-03;67084;38846;0;0;0;1816787;149718;1;0;0
FR;1;2021-02-04;77138;52903;0;0;0;1893925;202621;1;0;0
FR;1;2021-02-05;63415;46775;0;0;0;1957340;249396;1;0;0
FR;1;2021-02-06;19419;11022;0;0;0;1976759;260418;1;0;0
FR;1;2021-02-07;3663;5569;0;0;0;1980422;265987;1;0;0
FR;1;2021-02-08;36494;47532;0;0;0;2016916;313519;1;0;0
FR;1;2021-02-09;50797;75984;0;0;0;2067713;389503;1;0;0
FR;1;2021-02-10;52065;80661;0;0;0;2119778;470164;1;0;0
FR;1;2021-02-11;63372;102923;0;0;0;2183150;573087;1;0;0
FR;1;2021-02-12;55859;75173;0;0;0;2239009;648260;1;0;0
FR;1;2021-02-13;15463;19348;0;0;0;2254472;667608;1;0;0
FR;1;2021-02-14;3746;7362;0;0;0;2258218;674970;1;0;0
FR;1;2021-02-15;24141;73721;0;0;0;2282359;748691;1;0;0
FR;1;2021-02-16;32774;96466;0;0;0;2315133;845157;1;0;0
FR;1;2021-02-17;35118;101110;20;0;0;2350251;946267;21;0;0
FR;1;2021-02-18;49443;116612;0;0;0;2399694;1062879;21;0;0
FR;1;2021-02-19;45378;87229;1;0;0;2445072;1150108;22;0;0
FR;1;2021-02-20;13387;27177;0;0;0;2458459;1177285;22;0;0
FR;1;2021-02-21;2456;6108;0;0;0;2460915;1183393;22;0;0
FR;1;2021-02-22;24717;69588;2;0;0;2485632;1252981;24;0;0
FR;1;2021-02-23;37428;81249;1;0;0;2523060;1334230;25;0;0
FR;1;2021-02-24;40697;78799;1;0;0;2563757;1413029;26;0;0
FR;1;2021-02-25;50158;87964;1;0;0;2613915;1500993;27;0;0
FR;1;2021-02-26;47213;67611;1;0;0;2661128;1568604;28;0;0
FR;1;2021-02-27;15674;21241;1;0;0;2676802;1589845;29;0;0
FR;1;2021-02-28;3557;4191;2;0;0;2680359;1594036;31;0;0
FR;1;2021-03-01;40181;49981;1;0;0;2720540;1644017;32;0;0
FR;1;2021-03-02;55975;62224;3;0;0;2776515;1706241;35;0;0
FR;1;2021-03-03;61240;60490;0;0;0;2837755;1766731;35;0;0
FR;1;2021-03-04;72994;67260;3;0;0;2910749;1833991;38;0;0
FR;1;2021-03-05;74762;58769;3;0;0;2985511;1892760;41;0;0
FR;1;2021-03-06;82456;15885;2;0;0;3067967;1908645;43;0;0
FR;1;2021-03-07;63724;4547;1;0;0;3131691;1913192;44;0;0
FR;1;2021-03-08;60166;41653;2;0;0;3191857;1954845;46;0;0
FR;1;2021-03-09;85987;47758;1;0;0;3277844;2002603;47;0;0
FR;1;2021-03-10;90907;47955;5;0;0;3368751;2050558;52;0;0
FR;1;2021-03-11;105073;54493;1;0;0;3473824;2105051;53;0;0
FR;1;2021-03-12;104117;45034;1;0;0;3577941;2150085;54;0;0
FR;1;2021-03-13;89198;12624;1;0;0;3667139;2162709;55;0;0
FR;1;2021-03-14;44454;2807;1;0;0;3711593;2165516;56;0;0
FR;1;2021-03-15;95508;28417;3;0;0;3807101;2193933;59;0;0
FR;1;2021-03-16;123586;34305;5;0;0;3930687;2228238;64;0;0
FR;1;2021-03-17;129301;33881;4;0;0;4059988;2262119;68;0;0
FR;1;2021-03-18;142891;39381;5;0;0;4202879;2301500;73;0;0
FR;1;2021-03-19;136235;32347;2;0;0;4339114;2333847;75;0;0
FR;1;2021-03-20;75997;9864;1;0;0;4415111;2343711;76;0;0
FR;1;2021-03-21;26511;2155;1;0;0;4441622;2345866;77;0;0
FR;1;2021-03-22;114755;30635;2;0;0;4556377;2376501;79;0;0
FR;1;2021-03-23;143028;38051;1;0;0;4699405;2414552;80;0;0
FR;1;2021-03-24;141997;38518;0;0;0;4841402;2453070;80;0;0
FR;1;2021-03-25;164996;39681;4;0;0;5006398;2492751;84;0;0
FR;1;2021-03-26;166390;37526;5;1;0;5172788;2530277;89;1;0
FR;1;2021-03-27;110878;15417;1;0;0;5283666;2545694;90;1;0
FR;1;2021-03-28;42302;4191;3;0;0;5325968;2549885;93;1;0
FR;1;2021-03-29;129812;49301;4;0;0;5455780;2599186;97;1;0
FR;1;2021-03-30;167714;63712;5;0;0;5623494;2662898;102;1;0
FR;1;2021-03-31;170933;67593;4;0;0;5794427;2730491;106;1;0
FR;1;2021-04-01;194787;82439;10;0;0;5989214;2812930;116;1;0
FR;1;2021-04-02;164443;85947;7;0;0;6153657;2898877;123;1;0
FR;1;2021-04-03;88244;58115;6;0;0;6241901;2956992;129;1;0
FR;1;2021-04-04;33650;17718;0;0;0;6275551;2974710;129;1;0
FR;1;2021-04-05;46402;9806;11;0;0;6321953;2984516;140;1;0
FR;1;2021-04-06;160304;103800;17;0;0;6482257;3088316;157;1;0
FR;1;2021-04-07;196977;108084;16;0;0;6679234;3196400;173;1;0
FR;1;2021-04-08;222117;113413;13;0;0;6901351;3309813;186;1;0
FR;1;2021-04-09;214549;107813;21;0;0;7115900;3417626;207;1;0
FR;1;2021-04-10;117174;73228;14;0;0;7233074;3490854;221;1;0
FR;1;2021-04-11;40888;30015;6;0;0;7273962;3520869;227;1;0
FR;1;2021-04-12;168463;104290;46;0;0;7442425;3625159;273;1;0
FR;1;2021-04-13;203797;127943;97;1;0;7646222;3753102;370;2;0
FR;1;2021-04-14;208610;122742;207;0;0;7854832;3875844;577;2;0
FR;1;2021-04-15;221666;127673;311;0;0;8076498;4003517;888;2;0
FR;1;2021-04-16;206049;125354;308;0;0;8282547;4128871;1196;2;0
FR;1;2021-04-17;122081;67141;103;0;0;8404628;4196012;1299;2;0
FR;1;2021-04-18;35962;20947;41;0;0;8440590;4216959;1340;2;0
FR;1;2021-04-19;163737;121614;432;0;0;8604327;4338573;1772;2;0
FR;1;2021-04-20;189412;149269;531;0;0;8793739;4487842;2303;2;0
FR;1;2021-04-21;193989;147185;759;0;0;8987728;4635027;3062;2;0
FR;1;2021-04-22;209025;163695;777;0;0;9196753;4798722;3839;2;0
FR;1;2021-04-23;198946;157402;671;0;0;9395699;4956124;4510;2;0
FR;1;2021-04-24;126326;95626;148;0;0;9522025;5051750;4658;2;0
FR;1;2021-04-25;53627;30041;46;0;0;9575652;5081791;4704;2;0
FR;1;2021-04-26;181133;139203;542;0;0;9756785;5220994;5246;2;0
FR;1;2021-04-27;221357;162190;900;0;0;9978142;5383184;6146;2;0
FR;1;2021-04-28;238287;155547;1314;1;1;10216429;5538731;7460;3;1
FR;1;2021-04-29;270276;160899;1208;0;0;10486705;5699630;8668;3;1
FR;1;2021-04-30;271976;148460;1071;0;0;10758681;5848090;9739;3;1
FR;1;2021-05-01;141141;40610;173;0;0;10899822;5888700;9912;3;1
FR;1;2021-05-02;81541;28132;81;0;0;10981363;5916832;9993;3;1
FR;1;2021-05-03;250767;144109;802;0;0;11232130;6060941;10795;3;1
FR;1;2021-05-04;265863;187334;1199;0;0;11497993;6248275;11994;3;1
FR;1;2021-05-05;283865;185395;1266;0;0;11781858;6433670;13260;3;1
FR;1;2021-05-06;309951;183792;1501;0;0;12091809;6617462;14761;3;1
FR;1;2021-05-07;284087;196045;1125;0;0;12375896;6813507;15886;3;1
FR;1;2021-05-08;191654;49953;285;0;0;12567550;6863460;16171;3;1
FR;1;2021-05-09;114053;35198;236;0;0;12681603;6898658;16407;3;1
FR;1;2021-05-10;258200;194411;1185;0;0;12939803;7093069;17592;3;1
FR;1;2021-05-11;318872;210975;1464;0;0;13258675;7304044;19056;3;1
FR;1;2021-05-12;356615;185855;1399;0;0;13615290;7489899;20455;3;1
FR;1;2021-05-13;283436;47538;400;0;0;13898726;7537437;20855;3;1
FR;1;2021-05-14;370483;128516;994;0;0;14269209;7665953;21849;3;1
FR;1;2021-05-15;298082;66131;403;0;0;14567291;7732084;22252;3;1
FR;1;2021-05-16;157769;15488;158;0;0;14725060;7747572;22410;3;1
FR;1;2021-05-17;318921;116183;1439;0;0;15043981;7863755;23849;3;1
FR;1;2021-05-18;383313;111353;1797;0;0;15427294;7975108;25646;3;1
FR;1;2021-05-19;395251;102126;2179;0;0;15822545;8077234;27825;3;1
FR;1;2021-05-20;421789;95894;2045;0;0;16244334;8173128;29870;3;1
FR;1;2021-05-21;399795;97231;1763;0;0;16644129;8270359;31633;3;1
FR;1;2021-05-22;275680;41920;602;0;0;16919809;8312279;32235;3;1
FR;1;2021-05-23;123009;11047;224;0;0;17042818;8323326;32459;3;1
FR;1;2021-05-24;244004;26259;569;0;0;17286822;8349585;33028;3;1
FR;1;2021-05-25;366219;131576;2110;1;0;17653041;8481161;35138;4;1
FR;1;2021-05-26;380810;126445;1991;0;0;18033851;8607606;37129;4;1
FR;1;2021-05-27;406130;128085;1976;0;0;18439981;8735691;39105;4;1
FR;1;2021-05-28;366017;145398;1699;0;0;18805998;8881089;40804;4;1
FR;1;2021-05-29;253821;80927;527;0;0;19059819;8962016;41331;4;1
FR;1;2021-05-30;100974;22572;157;0;0;19160793;8984588;41488;4;1
FR;1;2021-05-31;314308;148908;1281;1;1;19475101;9133496;42769;5;2
FR;1;2021-06-01;361607;166534;1727;1;1;19836708;9300030;44496;6;3
FR;1;2021-06-02;365362;153631;1796;0;0;20202070;9453661;46292;6;3
FR;1;2021-06-03;391396;147536;1651;0;0;20593466;9601197;47943;6;3
FR;1;2021-06-04;364083;175607;1495;1;1;20957549;9776804;49438;7;4
FR;1;2021-06-05;258502;112672;596;0;0;21216051;9889476;50034;7;4
FR;1;2021-06-06;126796;37539;215;0;0;21342847;9927015;50249;7;4
FR;1;2021-06-07;300964;207806;1365;0;0;21643811;10134821;51614;7;4
FR;1;2021-06-08;330789;220755;1642;0;0;21974600;10355576;53256;7;4
FR;1;2021-06-09;336554;211782;1609;0;0;22311154;10567358;54865;7;4
FR;1;2021-06-10;343863;201366;1612;0;0;22655017;10768724;56477;7;4
FR;1;2021-06-11;311870;234939;1299;0;0;22966887;11003663;57776;7;4
FR;1;2021-06-12;244068;150618;435;0;0;23210955;11154281;58211;7;4
FR;1;2021-06-13;100363;60997;188;0;0;23311318;11215278;58399;7;4
FR;1;2021-06-14;207829;288149;1317;1;0;23519147;11503427;59716;8;4
FR;1;2021-06-15;256834;281714;1394;1;0;23775981;11785141;61110;9;4
FR;1;2021-06-16;273639;270548;1263;1;0;24049620;12055689;62373;10;4
FR;1;2021-06-17;268193;244810;1235;1;0;24317813;12300499;63608;11;4
FR;1;2021-06-18;260585;295490;1152;1;0;24578398;12595989;64760;12;4
FR;1;2021-06-19;193444;209497;388;0;0;24771842;12805486;65148;12;4
FR;1;2021-06-20;69701;89122;120;0;0;24841543;12894608;65268;12;4
FR;1;2021-06-21;172353;319762;933;1;1;25013896;13214370;66201;13;5
FR;1;2021-06-22;185851;347840;1100;10;2;25199747;13562210;67301;23;7
FR;1;2021-06-23;204184;339535;1049;0;0;25403931;13901745;68350;23;7
FR;1;2021-06-24;203514;282032;1173;0;0;25607445;14183777;69523;23;7
FR;1;2021-06-25;182649;371783;1197;0;0;25790094;14555560;70720;23;7
FR;1;2021-06-26;131380;278383;504;0;0;25921474;14833943;71224;23;7
FR;1;2021-06-27;52399;122901;145;0;0;25973873;14956844;71369;23;7
FR;1;2021-06-28;136644;368192;1064;0;0;26110517;15325036;72433;23;7
FR;1;2021-06-29;154875;390880;1849;0;0;26265392;15715916;74282;23;7
FR;1;2021-06-30;180042;381749;1666;4;2;26445434;16097665;75948;27;9
FR;1;2021-07-01;201467;332282;1887;5;1;26646901;16429947;77835;32;10
FR;1;2021-07-02;193823;367504;1765;5;2;26840724;16797451;79600;37;12
FR;1;2021-07-03;124473;280428;704;3;1;26965197;17077879;80304;40;13
FR;1;2021-07-04;53947;113688;244;0;0;27019144;17191567;80548;40;13
FR;1;2021-07-05;153933;355956;1500;8;2;27173077;17547523;82048;48;15
FR;1;2021-07-06;173484;382394;1602;45;8;27346561;17929917;83650;93;23
FR;1;2021-07-07;190786;362468;1657;25;4;27537347;18292385;85307;118;27
FR;1;2021-07-08;201551;323087;1826;20;6;27738898;18615472;87133;138;33
FR;1;2021-07-09;189941;387814;1853;3;2;27928839;19003286;88986;141;35
FR;1;2021-07-10;129933;281170;815;1;1;28058772;19284456;89801;142;36
FR;1;2021-07-11;57672;102526;262;0;0;28116444;19386982;90063;142;36
FR;1;2021-07-12;149789;416965;1583;4;0;28266233;19803947;91646;146;36
FR;1;2021-07-13;234250;439293;1806;8;1;28500483;20243240;93452;154;37
FR;1;2021-07-14;171889;151440;418;0;0;28672372;20394680;93870;154;37
FR;1;2021-07-15;279657;424547;1858;1;0;28952029;20819227;95728;155;37
FR;1;2021-07-16;290404;400935;1711;3;1;29242433;21220162;97439;158;38
FR;1;2021-07-17;217335;282049;754;1;0;29459768;21502211;98193;159;38
FR;1;2021-07-18;101998;107242;288;0;0;29561766;21609453;98481;159;38
FR;1;2021-07-19;238194;378801;1497;3;0;29799960;21988254;99978;162;38
FR;1;2021-07-20;305726;380353;1469;0;0;30105686;22368607;101447;162;38
FR;1;2021-07-21;333250;353098;1412;4;2;30438936;22721705;102859;166;40
FR;1;2021-07-22;364646;318945;1502;3;2;30803582;23040650;104361;169;42
FR;1;2021-07-23;349388;343290;1588;4;1;31152970;23383940;105949;173;43
FR;1;2021-07-24;238953;240851;697;1;0;31391923;23624791;106646;174;43
FR;1;2021-07-25;112794;76027;223;0;0;31504717;23700818;106869;174;43
FR;1;2021-07-26;299138;289701;1495;2;2;31803855;23990519;108364;176;45
FR;1;2021-07-27;385819;268295;1458;4;2;32189674;24258814;109822;180;47
FR;1;2021-07-28;390188;251171;1461;4;2;32579862;24509985;111283;184;49
FR;1;2021-07-29;406121;227968;1540;2;0;32985983;24737953;112823;186;49
FR;1;2021-07-30;370726;246782;1638;4;1;33356709;24984735;114461;190;50
FR;1;2021-07-31;243375;165130;793;1;0;33600084;25149865;115254;191;50
FR;1;2021-08-01;105563;47218;232;0;0;33705647;25197083;115486;191;50
FR;1;2021-08-02;297158;213050;1479;2;0;34002805;25410133;116965;193;50
FR;1;2021-08-03;331313;208929;1551;2;1;34334118;25619062;118516;195;51
FR;1;2021-08-04;328009;184149;1438;5;3;34662127;25803211;119954;200;54
FR;1;2021-08-05;301269;193351;1482;0;0;34963396;25996562;121436;200;54
FR;1;2021-08-06;290962;224348;1560;3;1;35254358;26220910;122996;203;55
FR;1;2021-08-07;182654;158805;654;4;3;35437012;26379715;123650;207;58
FR;1;2021-08-08;68887;59116;252;0;0;35505899;26438831;123902;207;58
FR;1;2021-08-09;222764;235573;1444;4;3;35728663;26674404;125346;211;61
FR;1;2021-08-10;252675;240243;1489;2;1;35981338;26914647;126835;213;62
FR;1;2021-08-11;236165;232029;1271;5;1;36217503;27146676;128106;218;63
FR;1;2021-08-12;220731;240019;1487;3;1;36438234;27386695;129593;221;64
FR;1;2021-08-13;201677;238606;1358;2;2;36639911;27625301;130951;223;66
FR;1;2021-08-14;122836;174072;646;0;0;36762747;27799373;131597;223;66
FR;1;2021-08-15;34674;46128;199;1;0;36797421;27845501;131796;224;66
FR;1;2021-08-16;156905;289628;1422;0;0;36954326;28135129;133218;224;66
FR;1;2021-08-17;171559;291280;1422;5;1;37125885;28426409;134640;229;67
FR;1;2021-08-18;161382;286863;1392;6;3;37287267;28713272;136032;235;70
FR;1;2021-08-19;148891;277595;1401;1;0;37436158;28990867;137433;236;70
FR;1;2021-08-20;140473;309098;1531;2;2;37576631;29299965;138964;238;72
FR;1;2021-08-21;84259;213213;586;0;0;37660890;29513178;139550;238;72
FR;1;2021-08-22;28552;82698;232;0;0;37689442;29595876;139782;238;72
FR;1;2021-08-23;118617;321066;1422;2;1;37808059;29916942;141204;240;73
FR;1;2021-08-24;126621;319816;1602;5;1;37934680;30236758;142806;245;74
FR;1;2021-08-25;121493;306516;1779;8;2;38056173;30543274;144585;253;76
FR;1;2021-08-26;106579;286132;2161;10;0;38162752;30829406;146746;263;76
FR;1;2021-08-27;107618;321682;2301;9;3;38270370;31151088;149047;272;79
FR;1;2021-08-28;71003;220700;1099;0;0;38341373;31371788;150146;272;79
FR;1;2021-08-29;24142;78190;469;1;0;38365515;31449978;150615;273;79
FR;1;2021-08-30;96856;286453;4312;6;5081;38462371;31736431;154927;279;5160
FR;1;2021-08-31;98053;276320;9291;15;10122;38560424;32012751;164218;294;15282
FR;1;2021-09-01;112197;245339;21113;7;22127;38672621;32258090;185331;301;37409
FR;1;2021-09-02;86406;197976;24525;18;25487;38759027;32456066;209856;319;62896
FR;1;2021-09-03;82386;227580;26952;21;28016;38841413;32683646;236808;340;90912
FR;1;2021-09-04;71613;189733;11140;11;11681;38913026;32873379;247948;351;102593
FR;1;2021-09-05;18608;41156;4124;2;4280;38931634;32914535;252072;353;106873
FR;1;2021-09-06;59526;151518;30177;15;31190;38991160;33066053;282249;368;138063
FR;1;2021-09-07;57366;139701;30207;30;31206;39048526;33205754;312456;398;169269
FR;1;2021-09-08;72311;173829;26922;22;27917;39120837;33379583;339378;420;197186
FR;1;2021-09-09;54434;124508;28618;24;29685;39175271;33504091;367996;444;226871
FR;1;2021-09-10;66160;152105;30443;24;31622;39241431;33656196;398439;468;258493
FR;1;2021-09-11;52663;146623;9730;14;10337;39294094;33802819;408169;482;268830
FR;1;2021-09-12;10791;29273;2484;1;2644;39304885;33832092;410653;483;271474
FR;1;2021-09-13;51467;104488;38743;30;40004;39356352;33936580;449396;513;311478
FR;1;2021-09-14;53294;96041;51267;66;53062;39409646;34032621;500663;579;364540
FR;1;2021-09-15;60509;139290;50483;55;47023;39470155;34171911;551146;634;411563
FR;1;2021-09-16;46591;81424;53321;71;49528;39516746;34253335;604467;705;461091
FR;1;2021-09-17;53176;109362;45062;61;42663;39569922;34362697;649529;766;503754
FR;1;2021-09-18;37855;118501;11796;19;11269;39607777;34481198;661325;785;515023
FR;1;2021-09-19;6505;21040;2038;1;1979;39614282;34502238;663363;786;517002
FR;1;2021-09-20;36485;74893;46220;65;44160;39650767;34577131;709583;851;561162
FR;1;2021-09-21;34165;68148;56253;70;52676;39684932;34645279;765836;921;613838
FR;1;2021-09-22;38810;118615;49867;76;46870;39723742;34763894;815703;997;660708
FR;1;2021-09-23;31991;62892;54490;85;50881;39755733;34826786;870193;1082;711589
FR;1;2021-09-24;36762;90096;43653;89;41917;39792495;34916882;913846;1171;753506
FR;1;2021-09-25;27641;96683;12303;27;12176;39820136;35013565;926149;1198;765682
FR;1;2021-09-26;4373;15191;1772;5;1695;39824509;35028756;927921;1203;767377
FR;1;2021-09-27;27335;60229;42901;89;41608;39851844;35088985;970822;1292;808985
FR;1;2021-09-28;26880;49469;47186;75;44436;39878724;35138454;1018008;1367;853421
FR;1;2021-09-29;35889;80375;47263;87;45566;39914613;35218829;1065271;1454;898987
FR;1;2021-09-30;26038;46872;47516;80;45426;39940651;35265701;1112787;1534;944413
FR;1;2021-10-01;47274;66556;44880;83;44566;39987925;35332257;1157667;1617;988979
FR;1;2021-10-02;32367;62406;16112;32;16314;40020292;35394663;1173779;1649;1005293
FR;1;2021-10-03;4339;8562;2036;3;2031;40024631;35403225;1175815;1652;1007324
FR;1;2021-10-04;28916;44454;47094;79;46941;40053547;35447679;1222909;1731;1054265
FR;1;2021-10-05;24502;41633;49866;116;49246;40078049;35489312;1272775;1847;1103511
FR;1;2021-10-06;34622;61401;57488;102;57204;40112671;35550713;1330263;1949;1160715
FR;1;2021-10-07;21031;39904;53030;75;51944;40133702;35590617;1383293;2024;1212659
FR;1;2021-10-08;35632;59658;60384;83;61114;40169334;35650275;1443677;2107;1273773
FR;1;2021-10-09;27442;48012;25490;29;26006;40196776;35698287;1469167;2136;1299779
FR;1;2021-10-10;3709;5807;2752;7;2859;40200485;35704094;1471919;2143;1302638
FR;1;2021-10-11;24818;38235;54578;88;55235;40225303;35742329;1526497;2231;1357873
FR;1;2021-10-12;23326;36581;58054;127;59163;40248629;35778910;1584551;2358;1417036
FR;1;2021-10-13;32904;47838;64162;124;65663;40281533;35826748;1648713;2482;1482699
FR;1;2021-10-14;21663;34786;53751;103;54330;40303196;35861534;1702464;2585;1537029
FR;1;2021-10-15;32691;48807;72317;165;74969;40335887;35910341;1774781;2750;1611998
FR;1;2021-10-16;25982;35302;34863;44;36407;40361869;35945643;1809644;2794;1648405
FR;1;2021-10-17;3106;4051;3409;2;3311;40364975;35949694;1813053;2796;1651716
FR;1;2021-10-18;24055;34901;66824;131;69696;40389030;35984595;1879877;2927;1721412
FR;1;2021-10-19;20680;35614;75648;135;79538;40409710;36020209;1955525;3062;1800950
FR;1;2021-10-20;29866;44233;96168;178;99816;40439576;36064442;2051693;3240;1900766
FR;1;2021-10-21;19746;35087;83157;107;87013;40459322;36099529;2134850;3347;1987779
FR;1;2021-10-22;29719;47766;103723;196;109660;40489041;36147295;2238573;3543;2097439
FR;1;2021-10-23;23026;35154;44866;57;47375;40512067;36182449;2283439;3600;2144814
FR;1;2021-10-24;2379;3854;3581;6;3724;40514446;36186303;2287020;3606;2148538
FR;1;2021-10-25;22411;30766;82010;143;85788;40536857;36217069;2369030;3749;2234326
FR;1;2021-10-26;19325;27678;86090;162;90310;40556182;36244747;2455120;3911;2324636
FR;1;2021-10-27;26184;39668;107791;252;112670;40582366;36284415;2562911;4163;2437306
FR;1;2021-10-28;18775;27135;86930;150;91660;40601141;36311550;2649841;4313;2528966
FR;1;2021-10-29;25919;40280;114814;200;121599;40627060;36351830;2764655;4513;2650565
FR;1;2021-10-30;17689;28716;49358;74;51937;40644749;36380546;2814013;4587;2702502
FR;1;2021-10-31;2059;3179;3447;2;3683;40646808;36383725;2817460;4589;2706185
FR;1;2021-11-01;7890;4266;3027;3;3283;40654698;36387991;2820487;4592;2709468
FR;1;2021-11-02;22530;33254;92380;156;97784;40677228;36421245;2912867;4748;2807252
FR;1;2021-11-03;26574;41614;117481;215;123846;40703802;36462859;3030348;4963;2931098
FR;1;2021-11-04;19584;30337;105793;213;111907;40723386;36493196;3136141;5176;3043005
FR;1;2021-11-05;26983;42345;138756;229;147388;40750369;36535541;3274897;5405;3190393
FR;1;2021-11-06;18833;29834;63477;123;66478;40769202;36565375;3338374;5528;3256871
FR;1;2021-11-07;1807;3300;4971;6;5300;40771009;36568675;3343345;5534;3262171
FR;1;2021-11-08;17833;32302;125977;224;132595;40788842;36600977;3469322;5758;3394766
FR;1;2021-11-09;19474;37678;159273;334;169040;40808316;36638655;3628595;6092;3563806
FR;1;2021-11-10;28844;49168;181870;440;192457;40837160;36687823;3810465;6532;3756263
FR;1;2021-11-11;4105;5952;12218;26;13021;40841265;36693775;3822683;6558;3769284
FR;1;2021-11-12;25997;46895;174791;244;186430;40867262;36740670;3997474;6802;3955714
FR;1;2021-11-13;18724;29209;76816;111;81760;40885986;36769879;4074290;6913;4037474
FR;1;2021-11-14;2038;3265;6817;5;7360;40888024;36773144;4081107;6918;4044834
FR;1;2021-11-15;18745;34837;156389;304;166202;40906769;36807981;4237496;7222;4211036
FR;1;2021-11-16;21332;37926;192089;378;204920;40928101;36845907;4429585;7600;4415956
FR;1;2021-11-17;28621;45659;193198;398;204995;40956722;36891566;4622783;7998;4620951
FR;1;2021-11-18;21118;39393;182463;458;194494;40977840;36930959;4805246;8456;4815445
FR;1;2021-11-19;30870;53432;230213;530;246658;41008710;36984391;5035459;8986;5062103
FR;1;2021-11-20;23751;33274;96971;201;103622;41032461;37017665;5132430;9187;5165725
FR;1;2021-11-21;2326;3966;9106;19;9959;41034787;37021631;5141536;9206;5175684
FR;1;2021-11-22;21398;30453;175875;465;189408;41056185;37052084;5317411;9671;5365092
FR;1;2021-11-23;24008;41102;221154;540;237879;41080193;37093186;5538565;10211;5602971
FR;1;2021-11-24;30282;49777;217304;701;234451;41110475;37142963;5755869;10912;5837422
FR;1;2021-11-25;23701;44040;244439;719;264056;41134176;37187003;6000308;11631;6101478
FR;1;2021-11-26;30614;66790;356763;833;388478;41164790;37253793;6357071;12464;6489956
FR;1;2021-11-27;21921;45391;202596;371;222599;41186711;37299184;6559667;12835;6712555
FR;1;2021-11-28;3162;9624;54778;63;61020;41189873;37308808;6614445;12898;6773575
FR;1;2021-11-29;17874;49536;326333;839;354382;41207747;37358344;6940778;13737;7127957
FR;1;2021-11-30;22780;64967;431105;952;470716;41230527;37423311;7371883;14689;7598673
FR;1;2021-12-01;25305;69354;442833;1129;481706;41255832;37492665;7814716;15818;8080379
FR;1;2021-12-02;20054;64607;489334;1228;532821;41275886;37557272;8304050;17046;8613200
FR;1;2021-12-03;22884;82373;542707;1309;591743;41298770;37639645;8846757;18355;9204943
FR;1;2021-12-04;16389;53971;299062;652;328907;41315159;37693616;9145819;19007;9533850
FR;1;2021-12-05;3632;13884;81517;143;91057;41318791;37707500;9227336;19150;9624907
FR;1;2021-12-06;25380;62681;415396;1064;455111;41344171;37770181;9642732;20214;10080018
FR;1;2021-12-07;19979;75703;522909;1535;572508;41364150;37845884;10165641;21749;10652526
FR;1;2021-12-08;21680;75807;458332;1544;502044;41385830;37921691;10623973;23293;11154570
FR;1;2021-12-09;19436;74078;492868;1626;540758;41405266;37995769;11116841;24919;11695328
FR;1;2021-12-10;23297;87794;547349;1585;599964;41428563;38083563;11664190;26504;12295292
FR;1;2021-12-11;16532;59202;302718;748;335465;41445095;38142765;11966908;27252;12630757
FR;1;2021-12-12;4346;15986;83202;179;94058;41449441;38158751;12050110;27431;12724815
FR;1;2021-12-13;15743;63761;366909;1094;406232;41465184;38222512;12417019;28525;13131047
FR;1;2021-12-14;20808;80403;464656;1745;515110;41485992;38302915;12881675;30270;13646157
FR;1;2021-12-15;21586;77547;409023;1309;453093;41507578;38380462;13290698;31579;14099250
FR;1;2021-12-16;20028;77389;451794;1578;500560;41527606;38457851;13742492;33157;14599810
FR;1;2021-12-17;22600;86750;479883;1733;530962;41550206;38544601;14222375;34890;15130772
FR;1;2021-12-18;17599;54715;257593;730;288492;41567805;38599316;14479968;35620;15419264
FR;1;2021-12-19;5549;17065;79159;194;90719;41573354;38616381;14559127;35814;15509983
FR;1;2021-12-20;20900;63201;316193;1080;355266;41594254;38679582;14875320;36894;15865249
FR;1;2021-12-21;26320;73171;372696;1421;418039;41620574;38752753;15248016;38315;16283288
FR;1;2021-12-22;24947;65991;310587;1216;349572;41645521;38818744;15558603;39531;16632860
FR;1;2021-12-23;21259;52375;241453;954;273030;41666780;38871119;15800056;40485;16905890
FR;1;2021-12-24;7118;18365;67142;258;77063;41673898;38889484;15867198;40743;16982953
FR;1;2021-12-25;506;2853;5579;15;6533;41674404;38892337;15872777;40758;16989486
FR;1;2021-12-26;2748;7589;26934;71;31453;41677152;38899926;15899711;40829;17020939
FR;1;2021-12-27;18254;53609;235084;705;265741;41695406;38953535;16134795;41534;17286680
FR;1;2021-12-28;23291;62061;292010;1026;330199;41718697;39015596;16426805;42560;17616879
FR;1;2021-12-29;22206;55593;254966;919;288187;41740903;39071189;16681771;43479;17905066
FR;1;2021-12-30;21235;46586;212140;858;239614;41762138;39117775;16893911;44337;18144680
FR;1;2021-12-31;7463;16605;61859;229;70398;41769601;39134380;16955770;44566;18215078
FR;1;2022-01-01;1056;2488;5655;30;6582;41770657;39136868;16961425;44596;18221660
FR;1;2022-01-02;3058;8058;28886;50;33526;41773715;39144926;16990311;44646;18255186
FR;1;2022-01-03;23164;54265;228209;786;257670;41796879;39199191;17218520;45432;18512856
FR;1;2022-01-04;25826;65058;299217;1238;337265;41822705;39264249;17517737;46670;18850121
FR;1;2022-01-05;30199;64264;274835;1096;310193;41852904;39328513;17792572;47766;19160314
FR;1;2022-01-06;26769;66276;306861;1398;346512;41879673;39394789;18099433;49164;19506826
FR;1;2022-01-07;31544;75036;349813;1535;393953;41911217;39469825;18449246;50699;19900779
FR;1;2022-01-08;23381;51402;222478;698;251101;41934598;39521227;18671724;51397;20151880
FR;1;2022-01-09;7077;17145;66020;163;76142;41941675;39538372;18737744;51560;20228022
FR;1;2022-01-10;21722;60733;236757;954;267600;41963397;39599105;18974501;52514;20495622
FR;1;2022-01-11;26678;63530;282251;1277;317796;41990075;39662635;19256752;53791;20813418
FR;1;2022-01-12;28880;62502;246219;1104;278005;42018955;39725137;19502971;54895;21091423
FR;1;2022-01-13;24718;60191;262768;1252;296115;42043673;39785328;19765739;56147;21387538
FR;1;2022-01-14;27937;66683;313963;1366;351218;42071610;39852011;20079702;57513;21738756
FR;1;2022-01-15;19328;44386;199296;619;223861;42090938;39896397;20278998;58132;21962617
FR;1;2022-01-16;5145;12954;51516;135;59567;42096083;39909351;20330514;58267;22022184
FR;1;2022-01-17;16841;39762;184809;780;206851;42112924;39949113;20515323;59047;22229035
FR;1;2022-01-18;19419;45941;212392;1153;237012;42132343;39995054;20727715;60200;22466047
FR;1;2022-01-19;20283;44002;176079;897;197184;42152626;40039056;20903794;61097;22663231
FR;1;2022-01-20;16770;40585;183646;1136;204717;42169396;40079641;21087440;62233;22867948
FR;1;2022-01-21;19893;47105;228935;1405;253329;42189289;40126746;21316375;63638;23121277
FR;1;2022-01-22;13835;33351;144487;578;161384;42203124;40160097;21460862;64216;23282661
FR;1;2022-01-23;3349;8774;33421;131;38325;42206473;40168871;21494283;64347;23320986
FR;1;2022-01-24;11792;32989;142186;708;158239;42218265;40201860;21636469;65055;23479225
FR;1;2022-01-25;14197;38246;163367;1048;181542;42232462;40240106;21799836;66103;23660767
FR;1;2022-01-26;14858;37658;150234;932;166327;42247320;40277764;21950070;67035;23827094
FR;1;2022-01-27;12327;33208;143439;886;157957;42259647;40310972;22093509;67921;23985051
FR;1;2022-01-28;16306;55955;198296;1145;222434;42275953;40366927;22291805;69066;24207485
FR;1;2022-01-29;10263;35436;135193;524;151532;42286216;40402363;22426998;69590;24359017
FR;1;2022-01-30;2480;9272;29679;86;34469;42288696;40411635;22456677;69676;24393486
FR;1;2022-01-31;8751;32408;104332;531;117396;42297447;40444043;22561009;70207;24510882
FR;1;2022-02-01;10793;36470;127048;863;141251;42308240;40480513;22688057;71070;24652133
FR;1;2022-02-02;11826;41551;130335;782;145857;42320066;40522064;22818392;71852;24797990
FR;1;2022-02-03;9197;33959;116995;784;130359;42329263;40556023;22935387;72636;24928349
FR;1;2022-02-04;11506;48185;172567;966;192784;42340769;40604208;23107954;73602;25121133
FR;1;2022-02-05;7985;33956;117572;391;133057;42348754;40638164;23225526;73993;25254190
FR;1;2022-02-06;1696;8016;22749;85;26914;42350450;40646180;23248275;74078;25281104
FR;1;2022-02-07;7277;35448;119076;453;134978;42357727;40681628;23367351;74531;25416082
FR;1;2022-02-08;7680;31885;125628;693;140614;42365407;40713513;23492979;75224;25556696
FR;1;2022-02-09;8599;36468;135238;696;152478;42374006;40749981;23628217;75920;25709174
FR;1;2022-02-10;6964;29823;116353;674;130136;42380970;40779804;23744570;76594;25839310
FR;1;2022-02-11;8650;41495;165110;877;185331;42389620;40821299;23909680;77471;26024641
FR;1;2022-02-12;5316;27580;106690;378;120869;42394936;40848879;24016370;77849;26145510
FR;1;2022-02-13;1227;5712;21714;65;25329;42396163;40854591;24038084;77914;26170839
FR;1;2022-02-14;5442;27180;118067;392;133093;42401605;40881771;24156151;78306;26303932
FR;1;2022-02-15;5729;28787;118901;610;132529;42407334;40910558;24275052;78916;26436461
FR;1;2022-02-16;5728;28427;110406;596;123037;42413062;40938985;24385458;79512;26559498
FR;1;2022-02-17;4594;19678;73119;487;80217;42417656;40958663;24458577;79999;26639715
FR;1;2022-02-18;5597;26744;99177;670;108136;42423253;40985407;24557754;80669;26747851
FR;1;2022-02-19;3547;17163;59472;304;66051;42426800;41002570;24617226;80973;26813902
FR;1;2022-02-20;787;3249;10700;36;12327;42427587;41005819;24627926;81009;26826229
FR;1;2022-02-21;3419;14580;52813;286;57663;42431006;41020399;24680739;81295;26883892
FR;1;2022-02-22;3782;15509;51889;499;55622;42434788;41035908;24732628;81794;26939514
FR;1;2022-02-23;4215;17784;57466;508;62568;42439003;41053692;24790094;82302;27002082
FR;1;2022-02-24;3332;13034;43607;435;46397;42442335;41066726;24833701;82737;27048479
FR;1;2022-02-25;4465;19784;64895;695;68767;42446800;41086510;24898596;83432;27117246
FR;1;2022-02-26;2689;12794;41360;310;45113;42449489;41099304;24939956;83742;27162359
FR;1;2022-02-27;644;2182;7124;42;7989;42450133;41101486;24947080;83784;27170348
FR;1;2022-02-28;2610;10448;34942;305;37368;42452743;41111934;24982022;84089;27207716
FR;1;2022-03-01;3342;10677;38684;390;39632;42456085;41122611;25020706;84479;27247348
FR;1;2022-03-02;3621;12124;41838;395;43907;42459706;41134735;25062544;84874;27291255
FR;1;2022-03-03;2423;7919;26164;325;26497;42462129;41142654;25088708;85199;27317752
FR;1;2022-03-04;2677;10392;35417;590;34911;42464806;41153046;25124125;85789;27352663
FR;1;2022-03-05;1814;6338;21959;278;22354;42466620;41159384;25146084;86067;27375017
FR;1;2022-03-06;353;950;2914;38;3117;42466973;41160334;25148998;86105;27378134
FR;1;2022-03-07;1684;4688;16426;245;15892;42468657;41165022;25165424;86350;27394026
FR;1;2022-03-08;1637;5226;17155;307;15981;42470294;41170248;25182579;86657;27410007
FR;1;2022-03-09;1928;6649;19803;368;19161;42472222;41176897;25202382;87025;27429168
FR;1;2022-03-10;1351;4744;15265;306;14302;42473573;41181641;25217647;87331;27443470
FR;1;2022-03-11;1743;6376;21697;481;19847;42475316;41188017;25239344;87812;27463317
FR;1;2022-03-12;1227;4645;15359;280;14908;42476543;41192662;25254703;88092;27478225
FR;1;2022-03-13;242;607;2116;118;2063;42476785;41193269;25256819;88210;27480288
FR;1;2022-03-14;1125;3654;13393;3878;12515;42477910;41196923;25270212;92088;27492803
FR;1;2022-03-15;1338;5241;14640;6862;13235;42479248;41202164;25284852;98950;27506038
FR;1;2022-03-16;1646;4965;17379;11515;16437;42480894;41207129;25302231;110465;27522475
FR;1;2022-03-17;1136;3395;11708;9643;10808;42482030;41210524;25313939;120108;27533283
FR;1;2022-03-18;1715;4910;17951;16489;16387;42483745;41215434;25331890;136597;27549670
FR;1;2022-03-19;1119;3296;11887;8455;11355;42484864;41218730;25343777;145052;27561025
FR;1;2022-03-20;221;555;1723;1013;1757;42485085;41219285;25345500;146065;27562782
FR;1;2022-03-21;1078;2752;11485;13445;10832;42486163;41222037;25356985;159510;27573614
FR;1;2022-03-22;1213;3198;12246;18688;11236;42487376;41225235;25369231;178198;27584850
FR;1;2022-03-23;1481;4294;16005;20108;15689;42488857;41229529;25385236;198306;27600539
FR;1;2022-03-24;1093;2724;10384;16032;9637;42489950;41232253;25395620;214338;27610176
FR;1;2022-03-25;1526;4315;16718;25293;15365;42491476;41236568;25412338;239631;27625541
FR;1;2022-03-26;1101;3009;10850;11448;10511;42492577;41239577;25423188;251079;27636052
FR;1;2022-03-27;231;541;1748;1380;1800;42492808;41240118;25424936;252459;27637852
FR;1;2022-03-28;1074;2475;9964;15878;9588;42493882;41242593;25434900;268337;27647440
FR;1;2022-03-29;1138;2732;11545;25083;10908;42495020;41245325;25446445;293420;27658348
FR;1;2022-03-30;1613;3534;14155;24167;13689;42496633;41248859;25460600;317587;27672037
FR;1;2022-03-31;1275;2955;11681;22626;11189;42497908;41251814;25472281;340213;27683226
FR;1;2022-04-01;2189;4001;18448;28491;17311;42500097;41255815;25490729;368704;27700537
FR;1;2022-04-02;904;1869;8189;9214;7935;42501001;41257684;25498918;377918;27708472
FR;1;2022-04-03;198;371;1432;1054;1433;42501199;41258055;25500350;378972;27709905
FR;1;2022-04-04;1401;2384;11353;17641;10734;42502600;41260439;25511703;396613;27720639
FR;1;2022-04-05;1351;2625;12980;31147;12002;42503951;41263064;25524683;427760;27732641
FR;1;2022-04-06;1365;2890;12181;23897;11612;42505316;41265954;25536864;451657;27744253
FR;1;2022-04-07;1167;2663;12320;31016;11784;42506483;41268617;25549184;482673;27756037
FR;1;2022-04-08;1577;3575;17540;40568;16449;42508060;41272192;25566724;523241;27772486
FR;1;2022-04-09;814;1981;8401;12487;8098;42508874;41274173;25575125;535728;27780584
FR;1;2022-04-10;193;491;1832;1848;1875;42509067;41274664;25576957;537576;27782459
FR;1;2022-04-11;988;2216;10954;22297;10664;42510055;41276880;25587911;559873;27793123
FR;1;2022-04-12;1253;2507;12794;38009;12279;42511308;41279387;25600705;597882;27805402
FR;1;2022-04-13;1218;2758;12246;30585;11976;42512526;41282145;25612951;628467;27817378
FR;1;2022-04-14;1199;2464;12068;33548;12072;42513725;41284609;25625019;662015;27829450
FR;1;2022-04-15;1464;2901;14379;33185;13753;42515189;41287510;25639398;695200;27843203
FR;1;2022-04-16;656;1390;5835;7976;5755;42515845;41288900;25645233;703176;27848958
FR;1;2022-04-17;153;273;929;1119;971;42515998;41289173;25646162;704295;27849929
FR;1;2022-04-18;135;458;2634;998;2658;42516133;41289631;25648796;705293;27852587
FR;1;2022-04-19;1212;2566;11769;27885;11500;42517345;41292197;25660565;733178;27864087
FR;1;2022-04-20;1315;2605;12157;26809;11992;42518660;41294802;25672722;759987;27876079
FR;1;2022-04-21;1218;2439;11518;33114;11684;42519878;41297241;25684240;793101;27887763
FR;1;2022-04-22;1495;3050;15186;35413;14771;42521373;41300291;25699426;828514;27902534
FR;1;2022-04-23;754;1564;6728;9886;6634;42522127;41301855;25706154;838400;27909168
FR;1;2022-04-24;195;359;1373;1520;1326;42522322;41302214;25707527;839920;27910494
FR;1;2022-04-25;1006;2109;9849;19660;9747;42523328;41304323;25717376;859580;27920241
FR;1;2022-04-26;1310;2596;12584;36529;12190;42524638;41306919;25729960;896109;27932431
FR;1;2022-04-27;1296;2389;10634;29146;10771;42525934;41309308;25740594;925255;27943202
FR;1;2022-04-28;1261;2359;11546;34150;11384;42527195;41311667;25752140;959405;27954586
FR;1;2022-04-29;1585;3376;14385;35467;13824;42528780;41315043;25766525;994872;27968410
FR;1;2022-04-30;818;1446;6437;9150;6280;42529598;41316489;25772962;1004022;27974690
FR;1;2022-05-01;175;280;821;947;815;42529773;41316769;25773783;1004969;27975505
FR;1;2022-05-02;1095;2340;10340;16851;10230;42530868;41319109;25784123;1021820;27985735
FR;1;2022-05-03;1448;2785;12679;32765;12573;42532316;41321894;25796802;1054585;27998308
FR;1;2022-05-04;1320;2617;11199;23754;11352;42533636;41324511;25808001;1078339;28009660
FR;1;2022-05-05;1389;2484;12147;31689;12072;42535025;41326995;25820148;1110028;28021732
FR;1;2022-05-06;1705;3186;14198;34817;13758;42536730;41330181;25834346;1144845;28035490
FR;1;2022-05-07;840;1456;5967;9085;5999;42537570;41331637;25840313;1153930;28041489
FR;1;2022-05-08;186;323;1057;1457;1118;42537756;41331960;25841370;1155387;28042607
FR;1;2022-05-09;1051;1966;9228;19235;9140;42538807;41333926;25850598;1174622;28051747
FR;1;2022-05-10;1408;2637;12549;36949;12137;42540215;41336563;25863147;1211571;28063884
FR;1;2022-05-11;1402;2325;9874;25926;9786;42541617;41338888;25873021;1237497;28073670
FR;1;2022-05-12;1278;2331;10472;33477;10160;42542895;41341219;25883493;1270974;28083830
FR;1;2022-05-13;1591;2754;12742;35666;12385;42544486;41343973;25896235;1306640;28096215
FR;1;2022-05-14;772;1298;5476;10205;5357;42545258;41345271;25901711;1316845;28101572
FR;1;2022-05-15;219;391;1178;1344;1241;42545477;41345662;25902889;1318189;28102813
FR;1;2022-05-16;949;1715;8052;20050;8103;42546426;41347377;25910941;1338239;28110916
FR;1;2022-05-17;1269;2230;11099;36060;10703;42547695;41349607;25922040;1374299;28121619
FR;1;2022-05-18;1277;2063;9009;25639;8961;42548972;41351670;25931049;1399938;28130580
FR;1;2022-05-19;1171;2331;9818;33854;9906;42550143;41354001;25940867;1433792;28140486
FR;1;2022-05-20;1548;2703;12495;37612;12075;42551691;41356704;25953362;1471404;28152561
FR;1;2022-05-21;772;1357;5240;9373;5159;42552463;41358061;25958602;1480777;28157720
FR;1;2022-05-22;190;282;946;1388;945;42552653;41358343;25959548;1482165;28158665
FR;1;2022-05-23;946;1799;8359;19391;8318;42553599;41360142;25967907;1501556;28166983
FR;1;2022-05-24;1273;2406;10705;37141;10547;42554872;41362548;25978612;1538697;28177530
FR;1;2022-05-25;1259;2236;8779;23646;8936;42556131;41364784;25987391;1562343;28186466
FR;1;2022-05-26;157;309;1569;1145;1563;42556288;41365093;25988960;1563488;28188029
FR;1;2022-05-27;1092;2126;8767;20423;8518;42557380;41367219;25997727;1583911;28196547
FR;1;2022-05-28;481;1030;3684;6529;3721;42557861;41368249;26001411;1590440;28200268
FR;1;2022-05-29;118;256;703;890;713;42557979;41368505;26002114;1591330;28200981
FR;1;2022-05-30;806;1701;6546;18523;6571;42558785;41370206;26008660;1609853;28207552
FR;1;2022-05-31;1256;2144;9230;34302;9101;42560041;41372350;26017890;1644155;28216653
FR;1;2022-06-01;1244;2420;10416;23315;10259;42561285;41374770;26028306;1667470;28226912
FR;1;2022-06-02;1198;2232;10659;34032;10216;42562483;41377002;26038965;1701502;28237128
FR;1;2022-06-03;1356;2673;12686;37067;12106;42563839;41379675;26051651;1738569;28249234
FR;1;2022-06-04;671;1254;4742;8667;4817;42564510;41380929;26056393;1747236;28254051
FR;1;2022-06-05;126;283;806;1046;828;42564636;41381212;26057199;1748282;28254879
FR;1;2022-06-06;172;509;1989;1171;1968;42564808;41381721;26059188;1749453;28256847
FR;1;2022-06-07;1117;2246;9155;34004;8816;42565925;41383967;26068343;1783457;28265663
FR;1;2022-06-08;1076;2170;8655;27513;8533;42567001;41386137;26076998;1810970;28274196
FR;1;2022-06-09;1043;2100;9955;37469;9635;42568044;41388237;26086953;1848439;28283831
FR;1;2022-06-10;1311;2524;12362;43024;11934;42569355;41390761;26099315;1891463;28295765
FR;1;2022-06-11;650;1435;5133;11073;5177;42570005;41392196;26104448;1902536;28300942
FR;1;2022-06-12;146;360;1011;1679;1066;42570151;41392556;26105459;1904215;28302008
FR;1;2022-06-13;883;1748;6994;22192;6848;42571034;41394304;26112453;1926407;28308856
FR;1;2022-06-14;1072;2117;9802;42712;9203;42572106;41396421;26122255;1969119;28318059
FR;1;2022-06-15;1037;1890;8735;29327;8414;42573143;41398311;26130990;1998446;28326473
FR;1;2022-06-16;922;1777;9349;38383;8828;42574065;41400088;26140339;2036829;28335301
FR;1;2022-06-17;1195;2513;11848;44729;11332;42575260;41402601;26152187;2081558;28346633
FR;1;2022-06-18;554;1252;4310;10535;4247;42575814;41403853;26156497;2092093;28350880
FR;1;2022-06-19;135;315;998;1540;1076;42575949;41404168;26157495;2093633;28351956
FR;1;2022-06-20;843;1657;8468;25015;8128;42576792;41405825;26165963;2118648;28360084
FR;1;2022-06-21;1089;2099;9743;47687;8831;42577881;41407924;26175706;2166335;28368915
FR;1;2022-06-22;1013;1982;8403;37037;7897;42578894;41409906;26184109;2203372;28376812
FR;1;2022-06-23;1039;2109;10104;52729;9374;42579933;41412015;26194213;2256101;28386186
FR;1;2022-06-24;1232;2669;12853;65793;11644;42581165;41414684;26207066;2321894;28397830
FR;1;2022-06-25;672;1492;5913;18903;5695;42581837;41416176;26212979;2340797;28403525
FR;1;2022-06-26;165;397;1814;3491;1703;42582002;41416573;26214793;2344288;28405228
FR;1;2022-06-27;925;1748;9882;45918;9105;42582927;41418321;26224675;2390206;28414333
FR;1;2022-06-28;1191;2542;13812;86419;12373;42584118;41420863;26238487;2476625;28426706
FR;1;2022-06-29;1218;2269;11451;67290;10521;42585336;41423132;26249938;2543915;28437227
FR;1;2022-06-30;1258;2354;13473;89873;11786;42586594;41425486;26263411;2633788;28449013
FR;1;2022-07-01;1554;3116;19965;109070;17585;42588148;41428602;26283376;2742858;28466598
FR;1;2022-07-02;742;1513;7946;33741;7187;42588890;41430115;26291322;2776599;28473785
FR;1;2022-07-03;223;472;1925;6066;1739;42589113;41430587;26293247;2782665;28475524
FR;1;2022-07-04;1191;2283;13750;75348;12132;42590304;41432870;26306997;2858013;28487656
FR;1;2022-07-05;1387;2711;17593;126099;15059;42591691;41435581;26324590;2984112;28502715
FR;1;2022-07-06;1317;2283;14813;93489;12826;42593008;41437864;26339403;3077601;28515541
FR;1;2022-07-07;1406;2472;16839;119176;13908;42594414;41440336;26356242;3196777;28529449
FR;1;2022-07-08;1501;2779;19514;129686;15888;42595915;41443115;26375756;3326463;28545337
FR;1;2022-07-09;652;1258;7275;35948;6317;42596567;41444373;26383031;3362411;28551654
FR;1;2022-07-10;227;471;2236;6676;2030;42596794;41444844;26385267;3369087;28553684
FR;1;2022-07-11;1163;2153;14251;84245;11850;42597957;41446997;26399518;3453332;28565534
FR;1;2022-07-12;1505;2725;19352;137094;15788;42599462;41449722;26418870;3590426;28581322
FR;1;2022-07-13;1367;2306;14672;89551;12520;42600829;41452028;26433542;3679977;28593842
FR;1;2022-07-14;150;293;1824;5245;1729;42600979;41452321;26435366;3685222;28595571
FR;1;2022-07-15;1222;2243;14205;80429;11866;42602201;41454564;26449571;3765651;28607437
FR;1;2022-07-16;502;1025;5606;23892;4854;42602703;41455589;26455177;3789543;28612291
FR;1;2022-07-17;153;356;1648;4434;1493;42602856;41455945;26456825;3793977;28613784
FR;1;2022-07-18;947;1955;11179;59130;9447;42603803;41457900;26468004;3853107;28623231
FR;1;2022-07-19;1206;2090;14598;99227;11629;42605009;41459990;26482602;3952334;28634860
FR;1;2022-07-20;1136;1936;12162;74172;10073;42606145;41461926;26494764;4026506;28644933
FR;1;2022-07-21;1093;1887;12266;84175;9856;42607238;41463813;26507030;4110681;28654789
FR;1;2022-07-22;1203;2149;13891;85550;11226;42608441;41465962;26520921;4196231;28666015
FR;1;2022-07-23;515;1044;5096;21219;4473;42608956;41467006;26526017;4217450;28670488
FR;1;2022-07-24;138;298;1293;3665;1130;42609094;41467304;26527310;4221115;28671618
FR;1;2022-07-25;847;1578;8878;45976;7318;42609941;41468882;26536188;4267091;28678936
FR;1;2022-07-26;1110;1916;12571;81626;10192;42611051;41470798;26548759;4348717;28689128
FR;1;2022-07-27;993;1676;9600;58026;7982;42612044;41472474;26558359;4406743;28697110
FR;1;2022-07-28;949;1622;9721;61382;7678;42612993;41474096;26568080;4468125;28704788
FR;1;2022-07-29;1086;1715;10229;62486;8142;42614079;41475811;26578309;4530611;28712930
FR;1;2022-07-30;381;692;3299;14382;2807;42614460;41476503;26581608;4544993;28715737
FR;1;2022-07-31;128;250;860;2292;735;42614588;41476753;26582468;4547285;28716472
FR;1;2022-08-01;633;1078;5697;28638;4658;42615221;41477831;26588165;4575923;28721130
FR;1;2022-08-02;828;1380;7760;53501;6161;42616049;41479211;26595925;4629424;28727291
FR;1;2022-08-03;662;1010;5789;36667;4588;42616711;41480221;26601714;4666091;28731879
FR;1;2022-08-04;605;1002;5899;40814;4709;42617316;41481223;26607613;4706905;28736588
FR;1;2022-08-05;702;1136;6291;42396;4948;42618018;41482359;26613904;4749301;28741536
FR;1;2022-08-06;258;442;1830;8840;1513;42618276;41482801;26615734;4758141;28743049
FR;1;2022-08-07;73;126;489;1507;404;42618349;41482927;26616223;4759648;28743453
FR;1;2022-08-08;434;746;3424;20543;2764;42618783;41483673;26619647;4780191;28746217
FR;1;2022-08-09;550;895;5146;37052;4071;42619333;41484568;26624793;4817243;28750288
FR;2;2020-12-27;0;0;0;0;0;0;0;0;0;0
FR;2;2020-12-28;0;0;0;0;0;0;0;0;0;0
FR;2;2020-12-29;0;0;0;0;0;0;0;0;0;0
FR;2;2020-12-30;0;0;0;0;0;0;0;0;0;0
FR;2;2020-12-31;0;0;0;0;0;0;0;0;0;0
FR;2;2021-01-01;0;0;0;0;0;0;0;0;0;0
FR;2;2021-01-02;0;0;0;0;0;0;0;0;0;0
FR;2;2021-01-03;0;0;0;0;0;0;0;0;0;0
FR;2;2021-01-04;0;0;0;0;0;0;0;0;0;0
FR;2;2021-01-05;0;0;0;0;0;0;0;0;0;0
FR;2;2021-01-06;0;0;0;0;0;0;0;0;0;0
FR;2;2021-01-07;0;0;0;0;0;0;0;0;0;0
FR;2;2021-01-08;0;0;0;0;0;0;0;0;0;0
FR;2;2021-01-09;0;0;0;0;0;0;0;0;0;0
FR;2;2021-01-10;0;0;0;0;0;0;0;0;0;0
FR;2;2021-01-11;0;0;0;0;0;0;0;0;0;0
FR;2;2021-01-12;0;0;0;0;0;0;0;0;0;0
FR;2;2021-01-13;0;0;0;0;0;0;0;0;0;0
FR;2;2021-01-14;1667;0;0;0;0;1667;0;0;0;0
FR;2;2021-01-15;398;0;0;0;0;2065;0;0;0;0
FR;2;2021-01-16;316;0;0;0;0;2381;0;0;0;0
FR;2;2021-01-17;83;0;0;0;0;2464;0;0;0;0
FR;2;2021-01-18;3074;2;0;0;0;5538;2;0;0;0
FR;2;2021-01-19;4680;0;0;0;0;10218;2;0;0;0
FR;2;2021-01-20;5135;6;0;0;0;15353;8;0;0;0
FR;2;2021-01-21;5344;9;0;0;0;20697;17;0;0;0
FR;2;2021-01-22;5119;13;0;0;0;25816;30;0;0;0
FR;2;2021-01-23;1871;1;0;0;0;27687;31;0;0;0
FR;2;2021-01-24;162;2;0;0;0;27849;33;0;0;0
FR;2;2021-01-25;3814;3;0;0;0;31663;36;0;0;0
FR;2;2021-01-26;3921;5;0;0;0;35584;41;0;0;0
FR;2;2021-01-27;3601;3;0;0;0;39185;44;0;0;0
FR;2;2021-01-28;3752;8;0;0;0;42937;52;0;0;0
FR;2;2021-01-29;3295;3;0;0;0;46232;55;0;0;0
FR;2;2021-01-30;1130;2;0;0;0;47362;57;0;0;0
FR;2;2021-01-31;45;2;0;0;0;47407;59;0;0;0
FR;2;2021-02-01;3404;9;0;0;0;50811;68;0;0;0
FR;2;2021-02-02;4491;14;0;0;0;55302;82;0;0;0
FR;2;2021-02-03;5220;7;0;0;0;60522;89;0;0;0
FR;2;2021-02-04;4936;11;0;0;0;65458;100;0;0;0
FR;2;2021-02-05;4812;14;0;0;0;70270;114;0;0;0
FR;2;2021-02-06;2040;14;0;0;0;72310;128;0;0;0
FR;2;2021-02-07;101;4;0;0;0;72411;132;0;0;0
FR;2;2021-02-08;7555;23;0;0;0;79966;155;0;0;0
FR;2;2021-02-09;8424;27;0;0;0;88390;182;0;0;0
FR;2;2021-02-10;9341;58;0;0;0;97731;240;0;0;0
FR;2;2021-02-11;10286;114;0;0;0;108017;354;0;0;0
FR;2;2021-02-12;10055;268;0;0;0;118072;622;0;0;0
FR;2;2021-02-13;3120;224;0;0;0;121192;846;0;0;0
FR;2;2021-02-14;355;9;0;0;0;121547;855;0;0;0
FR;2;2021-02-15;3458;3111;0;0;0;125005;3966;0;0;0
FR;2;2021-02-16;5072;4101;0;0;0;130077;8067;0;0;0
FR;2;2021-02-17;4256;4514;0;0;0;134333;12581;0;0;0
FR;2;2021-02-18;5402;5146;0;0;0;139735;17727;0;0;0
FR;2;2021-02-19;5327;4441;0;0;0;145062;22168;0;0;0
FR;2;2021-02-20;1869;1516;0;0;0;146931;23684;0;0;0
FR;2;2021-02-21;244;95;0;0;0;147175;23779;0;0;0
FR;2;2021-02-22;3613;3767;0;0;0;150788;27546;0;0;0
FR;2;2021-02-23;4954;3723;0;0;0;155742;31269;0;0;0
FR;2;2021-02-24;5015;3519;0;0;0;160757;34788;0;0;0
FR;2;2021-02-25;5490;3469;0;0;0;166247;38257;0;0;0
FR;2;2021-02-26;4364;3165;0;0;0;170611;41422;0;0;0
FR;2;2021-02-27;1624;1060;0;0;0;172235;42482;0;0;0
FR;2;2021-02-28;177;24;0;0;0;172412;42506;0;0;0
FR;2;2021-03-01;5184;3722;0;0;0;177596;46228;0;0;0
FR;2;2021-03-02;6532;4737;0;0;0;184128;50965;0;0;0
FR;2;2021-03-03;6538;4942;0;0;0;190666;55907;0;0;0
FR;2;2021-03-04;8404;4130;0;0;0;199070;60037;0;0;0
FR;2;2021-03-05;8033;4057;0;0;0;207103;64094;0;0;0
FR;2;2021-03-06;4785;1680;0;0;0;211888;65774;0;0;0
FR;2;2021-03-07;2372;30;0;0;0;214260;65804;0;0;0
FR;2;2021-03-08;4166;8373;0;0;0;218426;74177;0;0;0
FR;2;2021-03-09;7491;8551;1;0;0;225917;82728;1;0;0
FR;2;2021-03-10;7102;9173;0;0;0;233019;91901;1;0;0
FR;2;2021-03-11;9377;9299;1;0;0;242396;101200;2;0;0
FR;2;2021-03-12;7976;8313;0;0;0;250372;109513;2;0;0
FR;2;2021-03-13;10051;2575;0;0;0;260423;112088;2;0;0
FR;2;2021-03-14;4840;389;0;0;0;265263;112477;2;0;0
FR;2;2021-03-15;10910;3475;0;0;0;276173;115952;2;0;0
FR;2;2021-03-16;16764;4666;1;0;0;292937;120618;3;0;0
FR;2;2021-03-17;20235;3990;0;0;0;313172;124608;3;0;0
FR;2;2021-03-18;23372;5046;0;0;0;336544;129654;3;0;0
FR;2;2021-03-19;23305;4624;0;0;0;359849;134278;3;0;0
FR;2;2021-03-20;25448;1582;0;0;0;385297;135860;3;0;0
FR;2;2021-03-21;17671;153;0;0;0;402968;136013;3;0;0
FR;2;2021-03-22;17786;3197;0;0;0;420754;139210;3;0;0
FR;2;2021-03-23;22694;4229;0;0;0;443448;143439;3;0;0
FR;2;2021-03-24;23958;5043;0;0;0;467406;148482;3;0;0
FR;2;2021-03-25;26750;5182;1;0;0;494156;153664;4;0;0
FR;2;2021-03-26;26982;4223;0;0;0;521138;157887;4;0;0
FR;2;2021-03-27;15920;1351;0;0;0;537058;159238;4;0;0
FR;2;2021-03-28;10561;138;0;0;0;547619;159376;4;0;0
FR;2;2021-03-29;18991;4315;0;0;0;566610;163691;4;0;0
FR;2;2021-03-30;24584;6071;0;0;0;591194;169762;4;0;0
FR;2;2021-03-31;28560;5914;0;0;0;619754;175676;4;0;0
FR;2;2021-04-01;34547;8547;1;0;0;654301;184223;5;0;0
FR;2;2021-04-02;29981;7697;0;0;0;684282;191920;5;0;0
FR;2;2021-04-03;16955;4021;0;0;0;701237;195941;5;0;0
FR;2;2021-04-04;9306;1145;2;0;0;710543;197086;7;0;0
FR;2;2021-04-05;12444;800;0;0;0;722987;197886;7;0;0
FR;2;2021-04-06;27148;7160;0;0;0;750135;205046;7;0;0
FR;2;2021-04-07;30929;7130;1;0;0;781064;212176;8;0;0
FR;2;2021-04-08;36890;8651;1;0;0;817954;220827;9;0;0
FR;2;2021-04-09;33841;8456;28;0;0;851795;229283;37;0;0
FR;2;2021-04-10;19681;9172;1;0;0;871476;238455;38;0;0
FR;2;2021-04-11;7942;4250;1;0;0;879418;242705;39;0;0
FR;2;2021-04-12;17125;11053;0;0;0;896543;253758;39;0;0
FR;2;2021-04-13;19453;16066;1;0;0;915996;269824;40;0;0
FR;2;2021-04-14;18065;16373;7;0;0;934061;286197;47;0;0
FR;2;2021-04-15;22196;21432;27;0;0;956257;307629;74;0;0
FR;2;2021-04-16;20707;20387;45;0;0;976964;328016;119;0;0
FR;2;2021-04-17;13255;22468;5;0;0;990219;350484;124;0;0
FR;2;2021-04-18;5909;14395;6;0;0;996128;364879;130;0;0
FR;2;2021-04-19;16836;16316;24;0;0;1012964;381195;154;0;0
FR;2;2021-04-20;19324;21645;38;0;0;1032288;402840;192;0;0
FR;2;2021-04-21;20287;21757;76;0;0;1052575;424597;268;0;0
FR;2;2021-04-22;23819;24901;41;0;0;1076394;449498;309;0;0
FR;2;2021-04-23;24524;25395;76;0;0;1100918;474893;385;0;0
FR;2;2021-04-24;25304;15064;104;0;0;1126222;489957;489;0;0
FR;2;2021-04-25;9595;8605;5;0;0;1135817;498562;494;0;0
FR;2;2021-04-26;17159;17418;21;0;0;1152976;515980;515;0;0
FR;2;2021-04-27;19242;24125;40;0;0;1172218;540105;555;0;0
FR;2;2021-04-28;22336;26322;112;0;0;1194554;566427;667;0;0
FR;2;2021-04-29;25471;30281;69;0;0;1220025;596708;736;0;0
FR;2;2021-04-30;25531;27863;49;1;0;1245556;624571;785;1;0
FR;2;2021-05-01;14986;9863;6;0;0;1260542;634434;791;1;0
FR;2;2021-05-02;6638;9172;2;0;0;1267180;643606;793;1;0
FR;2;2021-05-03;20016;19193;40;0;0;1287196;662799;833;1;0
FR;2;2021-05-04;18282;29092;33;0;0;1305478;691891;866;1;0
FR;2;2021-05-05;18371;29426;48;0;0;1323849;721317;914;1;0
FR;2;2021-05-06;23543;35310;131;0;0;1347392;756627;1045;1;0
FR;2;2021-05-07;25330;33215;97;0;0;1372722;789842;1142;1;0
FR;2;2021-05-08;21340;10207;14;0;0;1394062;800049;1156;1;0
FR;2;2021-05-09;13165;7755;7;0;0;1407227;807804;1163;1;0
FR;2;2021-05-10;32939;21945;49;0;0;1440166;829749;1212;1;0
FR;2;2021-05-11;43601;20972;101;0;0;1483767;850721;1313;1;0
FR;2;2021-05-12;50047;19734;143;0;0;1533814;870455;1456;1;0
FR;2;2021-05-13;51293;5678;31;0;0;1585107;876133;1487;1;0
FR;2;2021-05-14;61348;12888;132;0;0;1646455;889021;1619;1;0
FR;2;2021-05-15;65932;7123;39;0;0;1712387;896144;1658;1;0
FR;2;2021-05-16;43586;2572;10;0;0;1755973;898716;1668;1;0
FR;2;2021-05-17;44745;12511;114;0;0;1800718;911227;1782;1;0
FR;2;2021-05-18;54641;12254;191;0;0;1855359;923481;1973;1;0
FR;2;2021-05-19;57174;10558;281;0;0;1912533;934039;2254;1;0
FR;2;2021-05-20;63436;10824;288;0;0;1975969;944863;2542;1;0
FR;2;2021-05-21;64296;11632;230;0;0;2040265;956495;2772;1;0
FR;2;2021-05-22;61481;4511;65;0;0;2101746;961006;2837;1;0
FR;2;2021-05-23;37534;572;22;0;0;2139280;961578;2859;1;0
FR;2;2021-05-24;17240;2040;35;0;0;2156520;963618;2894;1;0
FR;2;2021-05-25;21110;12210;240;0;0;2177630;975828;3134;1;0
FR;2;2021-05-26;19937;11474;229;0;0;2197567;987302;3363;1;0
FR;2;2021-05-27;22997;12659;182;0;0;2220564;999961;3545;1;0
FR;2;2021-05-28;29391;14989;190;0;0;2249955;1014950;3735;1;0
FR;2;2021-05-29;30420;8187;57;0;0;2280375;1023137;3792;1;0
FR;2;2021-05-30;4647;1815;6;0;0;2285022;1024952;3798;1;0
FR;2;2021-05-31;28590;18727;184;0;0;2313612;1043679;3982;1;0
FR;2;2021-06-01;45722;19948;224;0;0;2359334;1063627;4206;1;0
FR;2;2021-06-02;37474;19247;182;0;0;2396808;1082874;4388;1;0
FR;2;2021-06-03;51277;23222;161;0;0;2448085;1106096;4549;1;0
FR;2;2021-06-04;65512;24055;215;0;0;2513597;1130151;4764;1;0
FR;2;2021-06-05;34598;24063;52;0;0;2548195;1154214;4816;1;0
FR;2;2021-06-06;4955;6193;10;0;0;2553150;1160407;4826;1;0
FR;2;2021-06-07;28173;23027;149;0;0;2581323;1183434;4975;1;0
FR;2;2021-06-08;46375;22905;143;0;0;2627698;1206339;5118;1;0
FR;2;2021-06-09;34289;20942;107;0;0;2661987;1227281;5225;1;0
FR;2;2021-06-10;42639;19118;95;1;0;2704626;1246399;5320;2;0
FR;2;2021-06-11;55297;25178;134;0;0;2759923;1271577;5454;2;0
FR;2;2021-06-12;30559;19779;53;0;0;2790482;1291356;5507;2;0
FR;2;2021-06-13;3330;9189;13;0;0;2793812;1300545;5520;2;0
FR;2;2021-06-14;25300;24135;92;0;0;2819112;1324680;5612;2;0
FR;2;2021-06-15;39043;22834;154;0;0;2858155;1347514;5766;2;0
FR;2;2021-06-16;30161;21400;135;0;0;2888316;1368914;5901;2;0
FR;2;2021-06-17;36909;25826;150;0;0;2925225;1394740;6051;2;0
FR;2;2021-06-18;46854;28846;122;0;0;2972079;1423586;6173;2;0
FR;2;2021-06-19;24525;24899;39;0;0;2996604;1448485;6212;2;0
FR;2;2021-06-20;3741;10064;9;0;0;3000345;1458549;6221;2;0
FR;2;2021-06-21;17528;42839;88;0;0;3017873;1501388;6309;2;0
FR;2;2021-06-22;28359;49565;110;0;0;3046232;1550953;6419;2;0
FR;2;2021-06-23;21788;49583;107;1;1;3068020;1600536;6526;3;1
FR;2;2021-06-24;28376;50276;134;0;0;3096396;1650812;6660;3;1
FR;2;2021-06-25;33400;60417;128;0;0;3129796;1711229;6788;3;1
FR;2;2021-06-26;16385;59289;54;1;0;3146181;1770518;6842;4;1
FR;2;2021-06-27;2566;29311;22;1;0;3148747;1799829;6864;5;1
FR;2;2021-06-28;12640;54327;83;0;0;3161387;1854156;6947;5;1
FR;2;2021-06-29;19848;59931;178;0;0;3181235;1914087;7125;5;1
FR;2;2021-06-30;16327;57967;253;17;0;3197562;1972054;7378;22;1
FR;2;2021-07-01;20490;59881;228;0;0;3218052;2031935;7606;22;1
FR;2;2021-07-02;24073;62140;184;0;0;3242125;2094075;7790;22;1
FR;2;2021-07-03;12115;57101;153;0;0;3254240;2151176;7943;22;1
FR;2;2021-07-04;1958;23303;18;0;0;3256198;2174479;7961;22;1
FR;2;2021-07-05;9174;29355;106;0;0;3265372;2203834;8067;22;1
FR;2;2021-07-06;14580;36222;135;0;0;3279952;2240056;8202;22;1
FR;2;2021-07-07;14413;33665;139;0;0;3294365;2273721;8341;22;1
FR;2;2021-07-08;19717;40308;162;0;0;3314082;2314029;8503;22;1
FR;2;2021-07-09;27099;54304;202;1;0;3341181;2368333;8705;23;1
FR;2;2021-07-10;13386;33687;107;0;0;3354567;2402020;8812;23;1
FR;2;2021-07-11;1808;4360;16;0;0;3356375;2406380;8828;23;1
FR;2;2021-07-12;12965;37296;119;0;0;3369340;2443676;8947;23;1
FR;2;2021-07-13;37114;53184;150;0;0;3406454;2496860;9097;23;1
FR;2;2021-07-14;6623;3545;15;0;0;3413077;2500405;9112;23;1
FR;2;2021-07-15;47240;47026;156;0;0;3460317;2547431;9268;23;1
FR;2;2021-07-16;64309;55795;187;0;0;3524626;2603226;9455;23;1
FR;2;2021-07-17;31598;23925;96;0;0;3556224;2627151;9551;23;1
FR;2;2021-07-18;6087;4847;19;0;0;3562311;2631998;9570;23;1
FR;2;2021-07-19;32999;28649;94;0;0;3595310;2660647;9664;23;1
FR;2;2021-07-20;51995;44532;155;0;0;3647305;2705179;9819;23;1
FR;2;2021-07-21;45249;34705;93;0;0;3692554;2739884;9912;23;1
FR;2;2021-07-22;56280;41086;128;1;0;3748834;2780970;10040;24;1
FR;2;2021-07-23;68289;49014;170;0;0;3817123;2829984;10210;24;1
FR;2;2021-07-24;36173;21594;82;0;0;3853296;2851578;10292;24;1
FR;2;2021-07-25;6745;2627;10;0;0;3860041;2854205;10302;24;1
FR;2;2021-07-26;36312;22412;91;1;0;3896353;2876617;10393;25;1
FR;2;2021-07-27;62381;34596;180;0;0;3958734;2911213;10573;25;1
FR;2;2021-07-28;55313;26430;132;0;0;4014047;2937643;10705;25;1
FR;2;2021-07-29;68469;32797;189;0;0;4082516;2970440;10894;25;1
FR;2;2021-07-30;74453;37784;222;1;0;4156969;3008224;11116;26;1
FR;2;2021-07-31;34766;16203;104;0;0;4191735;3024427;11220;26;1
FR;2;2021-08-01;5411;2268;19;0;0;4197146;3026695;11239;26;1
FR;2;2021-08-02;35878;16191;101;0;0;4233024;3042886;11340;26;1
FR;2;2021-08-03;55975;28280;142;0;0;4288999;3071166;11482;26;1
FR;2;2021-08-04;46628;20849;128;1;0;4335627;3092015;11610;27;1
FR;2;2021-08-05;54630;31584;215;0;0;4390257;3123599;11825;27;1
FR;2;2021-08-06;58094;42397;242;1;0;4448351;3165996;12067;28;1
FR;2;2021-08-07;25145;17616;89;0;0;4473496;3183612;12156;28;1
FR;2;2021-08-08;3836;3655;21;0;0;4477332;3187267;12177;28;1
FR;2;2021-08-09;29306;21087;92;0;0;4506638;3208354;12269;28;1
FR;2;2021-08-10;44997;33480;155;0;0;4551635;3241834;12424;28;1
FR;2;2021-08-11;35272;25170;151;0;0;4586907;3267004;12575;28;1
FR;2;2021-08-12;41900;35713;162;0;0;4628807;3302717;12737;28;1
FR;2;2021-08-13;42597;37195;218;0;0;4671404;3339912;12955;28;1
FR;2;2021-08-14;18513;22197;93;0;0;4689917;3362109;13048;28;1
FR;2;2021-08-15;3847;3804;17;0;0;4693764;3365913;13065;28;1
FR;2;2021-08-16;25087;27167;110;0;0;4718851;3393080;13175;28;1
FR;2;2021-08-17;38256;43443;205;2;0;4757107;3436523;13380;30;1
FR;2;2021-08-18;32250;36367;195;1;1;4789357;3472890;13575;31;2
FR;2;2021-08-19;37433;46569;224;0;0;4826790;3519459;13799;31;2
FR;2;2021-08-20;40562;55619;269;1;0;4867352;3575078;14068;32;2
FR;2;2021-08-21;18120;24314;116;0;0;4885472;3599392;14184;32;2
FR;2;2021-08-22;2906;4322;22;1;1;4888378;3603714;14206;33;3
FR;2;2021-08-23;19248;35158;131;1;0;4907626;3638872;14337;34;3
FR;2;2021-08-24;31946;56049;236;0;0;4939572;3694921;14573;34;3
FR;2;2021-08-25;25932;43456;250;0;0;4965504;3738377;14823;34;3
FR;2;2021-08-26;32359;55817;387;0;0;4997863;3794194;15210;34;3
FR;2;2021-08-27;36999;65636;478;2;0;5034862;3859830;15688;36;3
FR;2;2021-08-28;17819;28507;300;0;0;5052681;3888337;15988;36;3
FR;2;2021-08-29;2654;5034;47;0;0;5055335;3893371;16035;36;3
FR;2;2021-08-30;18414;37730;400;0;757;5073749;3931101;16435;36;760
FR;2;2021-08-31;28076;57502;887;4;1544;5101825;3988603;17322;40;2304
FR;2;2021-09-01;21592;39857;1309;0;2112;5123417;4028460;18631;40;4416
FR;2;2021-09-02;25483;48647;1962;2;3324;5148900;4077107;20593;42;7740
FR;2;2021-09-03;33409;64515;2988;3;4853;5182309;4141622;23581;45;12593
FR;2;2021-09-04;16832;27721;1442;1;2368;5199141;4169343;25023;46;14961
FR;2;2021-09-05;2262;3605;266;0;412;5201403;4172948;25289;46;15373
FR;2;2021-09-06;14040;28715;1769;1;2943;5215443;4201663;27058;47;18316
FR;2;2021-09-07;21106;41083;3020;13;4890;5236549;4242746;30078;60;23206
FR;2;2021-09-08;17245;31929;2734;6;4488;5253794;4274675;32812;66;27694
FR;2;2021-09-09;20977;40476;4433;3;6797;5274771;4315151;37245;69;34491
FR;2;2021-09-10;28203;51215;5285;4;8884;5302974;4366366;42530;73;43375
FR;2;2021-09-11;13655;22417;2404;5;3964;5316629;4388783;44934;78;47339
FR;2;2021-09-12;1823;2777;289;0;510;5318452;4391560;45223;78;47849
FR;2;2021-09-13;11658;21437;2472;4;4022;5330110;4412997;47695;82;51871
FR;2;2021-09-14;18572;32766;5086;13;9060;5348682;4445763;52781;95;60931
FR;2;2021-09-15;14911;28260;5169;3;7770;5363593;4474023;57950;98;68701
FR;2;2021-09-16;16078;32779;6736;12;10527;5379671;4506802;64686;110;79228
FR;2;2021-09-17;20911;47120;8779;10;14595;5400582;4553922;73465;120;93823
FR;2;2021-09-18;9857;20949;3803;6;6036;5410439;4574871;77268;126;99859
FR;2;2021-09-19;1166;2614;396;0;633;5411605;4577485;77664;126;100492
FR;2;2021-09-20;7498;18747;3854;7;6144;5419103;4596232;81518;133;106636
FR;2;2021-09-21;11214;30010;6495;5;10745;5430317;4626242;88013;138;117381
FR;2;2021-09-22;9407;23530;5491;6;8515;5439724;4649772;93504;144;125896
FR;2;2021-09-23;10726;28902;7881;9;12645;5450450;4678674;101385;153;138541
FR;2;2021-09-24;15071;42913;10876;18;17221;5465521;4721587;112261;171;155762
FR;2;2021-09-25;7259;18775;3965;9;6112;5472780;4740362;116226;180;161874
FR;2;2021-09-26;1079;2551;495;0;630;5473859;4742913;116721;180;162504
FR;2;2021-09-27;6313;16419;4285;8;6532;5480172;4759332;121006;188;169036
FR;2;2021-09-28;9238;25546;7768;14;12067;5489410;4784878;128774;202;181103
FR;2;2021-09-29;8081;20201;6068;25;9261;5497491;4805079;134842;227;190364
FR;2;2021-09-30;9864;25819;9506;16;14093;5507355;4830898;144348;243;204457
FR;2;2021-10-01;13972;35705;12916;25;19292;5521327;4866603;157264;268;223749
FR;2;2021-10-02;6874;15910;4847;7;7021;5528201;4882513;162111;275;230770
FR;2;2021-10-03;841;1918;492;1;505;5529042;4884431;162603;276;231275
FR;2;2021-10-04;5822;13900;5515;5;7857;5534864;4898331;168118;281;239132
FR;2;2021-10-05;9053;22541;11121;19;15724;5543917;4920872;179239;300;254856
FR;2;2021-10-06;7783;17748;8241;11;11078;5551700;4938620;187480;311;265934
FR;2;2021-10-07;9198;22192;12381;15;16853;5560898;4960812;199861;326;282787
FR;2;2021-10-08;13429;32084;17348;27;23558;5574327;4992896;217209;353;306345
FR;2;2021-10-09;5999;12850;6042;6;7899;5580326;5005746;223251;359;314244
FR;2;2021-10-10;884;1614;436;2;616;5581210;5007360;223687;361;314860
FR;2;2021-10-11;5604;11572;6455;17;8831;5586814;5018932;230142;378;323691
FR;2;2021-10-12;8032;17780;12543;13;16760;5594846;5036712;242685;391;340451
FR;2;2021-10-13;6942;14850;10253;12;13629;5601788;5051562;252938;403;354080
FR;2;2021-10-14;8311;17934;14993;13;19457;5610099;5069496;267931;416;373537
FR;2;2021-10-15;11852;26313;20903;26;27973;5621951;5095809;288834;442;401510
FR;2;2021-10-16;5139;8737;1819;0;3213;5627090;5104546;290653;442;404723
FR;2;2021-10-17;651;1166;184;0;368;5627741;5105712;290837;442;405091
FR;2;2021-10-18;4561;7375;663;2;1646;5632302;5113087;291500;444;406737
FR;2;2021-10-19;6237;9873;730;5;2045;5638539;5122960;292230;449;408782
FR;2;2021-10-20;5168;8070;758;3;1682;5643707;5131030;292988;452;410464
FR;2;2021-10-21;6089;9970;778;5;2101;5649796;5141000;293766;457;412565
FR;2;2021-10-22;8450;14592;1148;4;2879;5658246;5155592;294914;461;415444
FR;2;2021-10-23;3844;5999;586;0;1232;5662090;5161591;295500;461;416676
FR;2;2021-10-24;494;887;100;0;203;5662584;5162478;295600;461;416879
FR;2;2021-10-25;3357;5360;306;1;830;5665941;5167838;295906;462;417709
FR;2;2021-10-26;4176;7259;1130;4;2014;5670117;5175097;297036;466;419723
FR;2;2021-10-27;3676;6613;1193;5;1997;5673793;5181710;298229;471;421720
FR;2;2021-10-28;4597;7698;1731;3;2749;5678390;5189408;299960;474;424469
FR;2;2021-10-29;5408;11084;2435;4;3673;5683798;5200492;302395;478;428142
FR;2;2021-10-30;2749;4441;975;1;1437;5686547;5204933;303370;479;429579
FR;2;2021-10-31;364;535;139;1;190;5686911;5205468;303509;480;429769
FR;2;2021-11-01;427;550;177;0;264;5687338;5206018;303686;480;430033
FR;2;2021-11-02;3292;6758;1183;0;1762;5690630;5212776;304869;480;431795
FR;2;2021-11-03;3340;6233;1386;2;1964;5693970;5219009;306255;482;433759
FR;2;2021-11-04;3986;7083;1764;4;2490;5697956;5226092;308019;486;436249
FR;2;2021-11-05;5230;10510;2867;5;3954;5703186;5236602;310886;491;440203
FR;2;2021-11-06;2594;4679;1402;0;1813;5705780;5241281;312288;491;442016
FR;2;2021-11-07;506;863;220;0;286;5706286;5242144;312508;491;442302
FR;2;2021-11-08;2578;5358;1201;3;1675;5708864;5247502;313709;494;443977
FR;2;2021-11-09;2750;6931;2398;5;3180;5711614;5254433;316107;499;447157
FR;2;2021-11-10;2588;5696;5107;6;6288;5714202;5260129;321214;505;453445
FR;2;2021-11-11;444;749;743;2;923;5714646;5260878;321957;507;454368
FR;2;2021-11-12;2953;8103;8971;8;10912;5717599;5268981;330928;515;465280
FR;2;2021-11-13;1538;3381;3867;7;4535;5719137;5272362;334795;522;469815
FR;2;2021-11-14;257;593;351;1;485;5719394;5272955;335146;523;470300
FR;2;2021-11-15;1622;3671;4444;9;5331;5721016;5276626;339590;532;475631
FR;2;2021-11-16;2184;5910;8304;14;10073;5723200;5282536;347894;546;485704
FR;2;2021-11-17;1741;4539;6626;8;7842;5724941;5287075;354520;554;493546
FR;2;2021-11-18;2192;5935;9178;11;11008;5727133;5293010;363698;565;504554
FR;2;2021-11-19;2698;7793;12971;19;15476;5729831;5300803;376669;584;520030
FR;2;2021-11-20;1565;3339;5173;5;6081;5731396;5304142;381842;589;526111
FR;2;2021-11-21;246;516;540;0;662;5731642;5304658;382382;589;526773
FR;2;2021-11-22;1277;2597;4479;5;5402;5732919;5307255;386861;594;532175
FR;2;2021-11-23;1616;4302;8196;9;9911;5734535;5311557;395057;603;542086
FR;2;2021-11-24;1418;3772;7473;14;8730;5735953;5315329;402530;617;550816
FR;2;2021-11-25;1812;4887;11464;21;13662;5737765;5320216;413994;638;564478
FR;2;2021-11-26;2540;7760;22663;31;26072;5740305;5327976;436657;669;590550
FR;2;2021-11-27;1497;4165;12269;18;14030;5741802;5332141;448926;687;604580
FR;2;2021-11-28;292;844;1970;3;2296;5742094;5332985;450896;690;606876
FR;2;2021-11-29;1445;4362;15082;23;17250;5743539;5337347;465978;713;624126
FR;2;2021-11-30;1911;6708;26234;36;29984;5745450;5344055;492212;749;654110
FR;2;2021-12-01;1911;6067;26198;30;29524;5747361;5350122;518410;779;683634
FR;2;2021-12-02;1911;6818;37708;52;41953;5749272;5356940;556118;831;725587
FR;2;2021-12-03;2552;10094;53611;111;59350;5751824;5367034;609729;942;784937
FR;2;2021-12-04;1848;6303;37113;38;40803;5753672;5373337;646842;980;825740
FR;2;2021-12-05;458;2254;14258;14;15989;5754130;5375591;661100;994;841729
FR;2;2021-12-06;2484;9890;77704;109;84761;5756614;5385481;738804;1103;926490
FR;2;2021-12-07;3455;15327;122429;238;133737;5760069;5400808;861233;1341;1060227
FR;2;2021-12-08;3724;16023;133192;330;145375;5763793;5416831;994425;1671;1205602
FR;2;2021-12-09;4549;19633;170189;554;185567;5768342;5436464;1164614;2225;1391169
FR;2;2021-12-10;4672;22839;188641;490;206109;5773014;5459303;1353255;2715;1597278
FR;2;2021-12-11;3684;16639;132436;239;144880;5776698;5475942;1485691;2954;1742158
FR;2;2021-12-12;1257;7128;59089;83;65140;5777955;5483070;1544780;3037;1807298
FR;2;2021-12-13;5527;26849;220681;605;242970;5783482;5509919;1765461;3642;2050268
FR;2;2021-12-14;7015;37498;300755;909;332212;5790497;5547417;2066216;4551;2382480
FR;2;2021-12-15;6558;36239;285211;956;315822;5797055;5583656;2351427;5507;2698302
FR;2;2021-12-16;7762;37927;312130;980;343735;5804817;5621583;2663557;6487;3042037
FR;2;2021-12-17;8680;41245;327870;976;360964;5813497;5662828;2991427;7463;3403001
FR;2;2021-12-18;6514;26559;212335;448;233646;5820011;5689387;3203762;7911;3636647
FR;2;2021-12-19;2603;11464;90208;182;100361;5822614;5700851;3293970;8093;3737008
FR;2;2021-12-20;9546;33581;275210;706;303366;5832160;5734432;3569180;8799;4040374
FR;2;2021-12-21;11564;38321;309620;968;341412;5843724;5772753;3878800;9767;4381786
FR;2;2021-12-22;10456;32831;265104;952;292476;5854180;5805584;4143904;10719;4674262
FR;2;2021-12-23;9426;26693;199491;700;221285;5863606;5832277;4343395;11419;4895547
FR;2;2021-12-24;2783;7491;43855;140;49559;5866389;5839768;4387250;11559;4945106
FR;2;2021-12-25;201;689;2002;10;2492;5866590;5840457;4389252;11569;4947598
FR;2;2021-12-26;1320;4209;25155;71;28681;5867910;5844666;4414407;11640;4976279
FR;2;2021-12-27;8077;29927;218407;659;243333;5875987;5874593;4632814;12299;5219612
FR;2;2021-12-28;9839;36324;272084;742;301975;5885826;5910917;4904898;13041;5521587
FR;2;2021-12-29;9497;32267;246124;766;272689;5895323;5943184;5151022;13807;5794276
FR;2;2021-12-30;9462;28107;208822;662;231457;5904785;5971291;5359844;14469;6025733
FR;2;2021-12-31;3010;8356;54987;176;61234;5907795;5979647;5414831;14645;6086967
FR;2;2022-01-01;227;691;2851;7;3347;5908022;5980338;5417682;14652;6090314
FR;2;2022-01-02;1504;4854;29511;75;33398;5909526;5985192;5447193;14727;6123712
FR;2;2022-01-03;9589;35406;266520;806;293890;5919115;6020598;5713713;15533;6417602
FR;2;2022-01-04;12847;45428;342080;1068;377013;5931962;6066026;6055793;16601;6794615
FR;2;2022-01-05;11272;38653;294176;884;323817;5943234;6104679;6349969;17485;7118432
FR;2;2022-01-06;13652;43506;331940;1298;364726;5956886;6148185;6681909;18783;7483158
FR;2;2022-01-07;14223;47628;361091;1270;396427;5971109;6195813;7043000;20053;7879585
FR;2;2022-01-08;7948;28157;201260;515;221708;5979057;6223970;7244260;20568;8101293
FR;2;2022-01-09;2749;8983;62523;137;69515;5981806;6232953;7306783;20705;8170808
FR;2;2022-01-10;10096;31923;232463;857;255041;5991902;6264876;7539246;21562;8425849
FR;2;2022-01-11;11469;36253;265901;1029;290592;6003371;6301129;7805147;22591;8716441
FR;2;2022-01-12;8763;29815;206316;863;226171;6012134;6330944;8011463;23454;8942612
FR;2;2022-01-13;9387;31344;224483;832;244829;6021521;6362288;8235946;24286;9187441
FR;2;2022-01-14;9743;35625;254534;920;277655;6031264;6397913;8490480;25206;9465096
FR;2;2022-01-15;5357;19448;140779;363;153634;6036621;6417361;8631259;25569;9618730
FR;2;2022-01-16;1511;5492;35880;81;39831;6038132;6422853;8667139;25650;9658561
FR;2;2022-01-17;5546;19282;135409;601;147252;6043678;6442135;8802548;26251;9805813
FR;2;2022-01-18;6420;21517;148625;648;160472;6050098;6463652;8951173;26899;9966285
FR;2;2022-01-19;4391;16333;105091;551;113697;6054489;6479985;9056264;27450;10079982
FR;2;2022-01-20;4870;17595;115290;603;123688;6059359;6497580;9171554;28053;10203670
FR;2;2022-01-21;5197;20072;137336;679;147760;6064556;6517652;9308890;28732;10351430
FR;2;2022-01-22;3030;10954;74260;260;80326;6067586;6528606;9383150;28992;10431756
FR;2;2022-01-23;724;2723;15241;41;16832;6068310;6531329;9398391;29033;10448588
FR;2;2022-01-24;3291;12822;75068;430;81028;6071601;6544151;9473459;29463;10529616
FR;2;2022-01-25;3574;14427;79621;496;85452;6075175;6558578;9553080;29959;10615068
FR;2;2022-01-26;2514;10688;58972;363;63013;6077689;6569266;9612052;30322;10678081
FR;2;2022-01-27;2680;11330;64177;388;67922;6080369;6580596;9676229;30710;10746003
FR;2;2022-01-28;3550;18325;91715;429;98935;6083919;6598921;9767944;31139;10844938
FR;2;2022-01-29;1895;9242;48849;164;52929;6085814;6608163;9816793;31303;10897867
FR;2;2022-01-30;464;2230;9453;38;10602;6086278;6610393;9826246;31341;10908469
FR;2;2022-01-31;1888;9576;43828;208;47339;6088166;6619969;9870074;31549;10955808
FR;2;2022-02-01;1916;10048;47027;279;50107;6090082;6630017;9917101;31828;11005915
FR;2;2022-02-02;1613;9014;41109;250;44166;6091695;6639031;9958210;32078;11050081
FR;2;2022-02-03;1724;8949;40520;205;42924;6093419;6647980;9998730;32283;11093005
FR;2;2022-02-04;2152;15208;66641;299;71347;6095571;6663188;10065371;32582;11164352
FR;2;2022-02-05;1360;8524;35943;132;39227;6096931;6671712;10101314;32714;11203579
FR;2;2022-02-06;275;1771;6125;16;6899;6097206;6673483;10107439;32730;11210478
FR;2;2022-02-07;1350;9577;37752;134;41301;6098556;6683060;10145191;32864;11251779
FR;2;2022-02-08;1300;9826;40948;173;43740;6099856;6692886;10186139;33037;11295519
FR;2;2022-02-09;1160;8833;37039;174;40461;6101016;6701719;10223178;33211;11335980
FR;2;2022-02-10;1027;7994;33835;204;36507;6102043;6709713;10257013;33415;11372487
FR;2;2022-02-11;1390;12083;53341;223;57693;6103433;6721796;10310354;33638;11430180
FR;2;2022-02-12;752;6533;27985;83;30804;6104185;6728329;10338339;33721;11460984
FR;2;2022-02-13;200;1340;4833;20;5574;6104385;6729669;10343172;33741;11466558
FR;2;2022-02-14;834;6728;30270;90;33229;6105219;6736397;10373442;33831;11499787
FR;2;2022-02-15;773;6468;28046;141;29990;6105992;6742865;10401488;33972;11529777
FR;2;2022-02-16;655;5360;22060;123;23625;6106647;6748225;10423548;34095;11553402
FR;2;2022-02-17;518;3778;14146;98;14612;6107165;6752003;10437694;34193;11568014
FR;2;2022-02-18;722;5365;20435;134;21126;6107887;6757368;10458129;34327;11589140
FR;2;2022-02-19;429;3054;10529;66;11244;6108316;6760422;10468658;34393;11600384
FR;2;2022-02-20;102;515;1458;3;1605;6108418;6760937;10470116;34396;11601989
FR;2;2022-02-21;422;2684;9122;65;9499;6108840;6763621;10479238;34461;11611488
FR;2;2022-02-22;390;2565;8892;76;8794;6109230;6766186;10488130;34537;11620282
FR;2;2022-02-23;431;2602;8990;82;9267;6109661;6768788;10497120;34619;11629549
FR;2;2022-02-24;314;2033;6800;81;6828;6109975;6770821;10503920;34700;11636377
FR;2;2022-02-25;457;3204;11417;108;11282;6110432;6774025;10515337;34808;11647659
FR;2;2022-02-26;296;1892;6034;49;6341;6110728;6775917;10521371;34857;11654000
FR;2;2022-02-27;76;313;905;5;948;6110804;6776230;10522276;34862;11654948
FR;2;2022-02-28;330;1687;5523;53;5531;6111134;6777917;10527799;34915;11660479
FR;2;2022-03-01;277;1562;5477;45;5194;6111411;6779479;10533276;34960;11665673
FR;2;2022-03-02;298;1441;5245;45;5089;6111709;6780920;10538521;35005;11670762
FR;2;2022-03-03;225;1111;3708;42;3485;6111934;6782031;10542229;35047;11674247
FR;2;2022-03-04;243;1468;4857;73;4504;6112177;6783499;10547086;35120;11678751
FR;2;2022-03-05;174;904;2979;32;2723;6112351;6784403;10550065;35152;11681474
FR;2;2022-03-06;42;182;279;5;319;6112393;6784585;10550344;35157;11681793
FR;2;2022-03-07;156;657;1986;70;1776;6112549;6785242;10552330;35227;11683569
FR;2;2022-03-08;144;662;2272;51;1905;6112693;6785904;10554602;35278;11685474
FR;2;2022-03-09;154;707;2346;37;2047;6112847;6786611;10556948;35315;11687521
FR;2;2022-03-10;122;603;1691;35;1466;6112969;6787214;10558639;35350;11688987
FR;2;2022-03-11;171;756;2767;57;2366;6113140;6787970;10561406;35407;11691353
FR;2;2022-03-12;147;484;1785;27;1554;6113287;6788454;10563191;35434;11692907
FR;2;2022-03-13;25;75;202;29;203;6113312;6788529;10563393;35463;11693110
FR;2;2022-03-14;128;468;1566;529;1295;6113440;6788997;10564959;35992;11694405
FR;2;2022-03-15;138;437;1710;689;1329;6113578;6789434;10566669;36681;11695734
FR;2;2022-03-16;141;475;2013;1614;1593;6113719;6789909;10568682;38295;11697327
FR;2;2022-03-17;93;413;1408;1193;1144;6113812;6790322;10570090;39488;11698471
FR;2;2022-03-18;145;494;2019;1792;1662;6113957;6790816;10572109;41280;11700133
FR;2;2022-03-19;108;319;1210;941;1015;6114065;6791135;10573319;42221;11701148
FR;2;2022-03-20;13;77;191;59;168;6114078;6791212;10573510;42280;11701316
FR;2;2022-03-21;96;305;1213;1483;1076;6114174;6791517;10574723;43763;11702392
FR;2;2022-03-22;117;388;1530;1829;1291;6114291;6791905;10576253;45592;11703683
FR;2;2022-03-23;139;361;1669;3032;1465;6114430;6792266;10577922;48624;11705148
FR;2;2022-03-24;116;293;1183;1547;1000;6114546;6792559;10579105;50171;11706148
FR;2;2022-03-25;119;361;1803;2449;1473;6114665;6792920;10580908;52620;11707621
FR;2;2022-03-26;77;247;1203;1222;952;6114742;6793167;10582111;53842;11708573
FR;2;2022-03-27;19;36;153;100;132;6114761;6793203;10582264;53942;11708705
FR;2;2022-03-28;94;287;1136;1601;995;6114855;6793490;10583400;55543;11709700
FR;2;2022-03-29;108;258;1324;2465;1104;6114963;6793748;10584724;58008;11710804
FR;2;2022-03-30;91;312;1487;3183;1319;6115054;6794060;10586211;61191;11712123
FR;2;2022-03-31;104;284;1274;2329;1088;6115158;6794344;10587485;63520;11713211
FR;2;2022-04-01;122;323;1567;2344;1322;6115280;6794667;10589052;65864;11714533
FR;2;2022-04-02;72;161;845;891;737;6115352;6794828;10589897;66755;11715270
FR;2;2022-04-03;16;53;128;112;142;6115368;6794881;10590025;66867;11715412
FR;2;2022-04-04;110;236;986;1438;795;6115478;6795117;10591011;68305;11716207
FR;2;2022-04-05;143;290;1314;2886;1141;6115621;6795407;10592325;71191;11717348
FR;2;2022-04-06;88;252;1304;2520;1127;6115709;6795659;10593629;73711;11718475
FR;2;2022-04-07;120;218;1299;2681;1039;6115829;6795877;10594928;76392;11719514
FR;2;2022-04-08;125;335;1627;3231;1323;6115954;6796212;10596555;79623;11720837
FR;2;2022-04-09;90;219;899;1045;731;6116044;6796431;10597454;80668;11721568
FR;2;2022-04-10;37;47;143;162;119;6116081;6796478;10597597;80830;11721687
FR;2;2022-04-11;88;192;885;1531;775;6116169;6796670;10598482;82361;11722462
FR;2;2022-04-12;176;268;1179;2737;1058;6116345;6796938;10599661;85098;11723520
FR;2;2022-04-13;145;229;1125;2452;985;6116490;6797167;10600786;87550;11724505
FR;2;2022-04-14;114;220;1084;2673;916;6116604;6797387;10601870;90223;11725421
FR;2;2022-04-15;113;245;1197;2275;1066;6116717;6797632;10603067;92498;11726487
FR;2;2022-04-16;65;108;541;545;452;6116782;6797740;10603608;93043;11726939
FR;2;2022-04-17;15;26;57;53;53;6116797;6797766;10603665;93096;11726992
FR;2;2022-04-18;12;35;120;70;115;6116809;6797801;10603785;93166;11727107
FR;2;2022-04-19;112;237;1116;1707;948;6116921;6798038;10604901;94873;11728055
FR;2;2022-04-20;95;240;1099;2146;930;6117016;6798278;10606000;97019;11728985
FR;2;2022-04-21;111;231;981;1909;837;6117127;6798509;10606981;98928;11729822
FR;2;2022-04-22;97;272;1241;2086;1023;6117224;6798781;10608222;101014;11730845
FR;2;2022-04-23;66;155;644;762;573;6117290;6798936;10608866;101776;11731418
FR;2;2022-04-24;12;29;101;68;79;6117302;6798965;10608967;101844;11731497
FR;2;2022-04-25;103;203;820;1314;709;6117405;6799168;10609787;103158;11732206
FR;2;2022-04-26;108;183;1039;1999;877;6117513;6799351;10610826;105157;11733083
FR;2;2022-04-27;96;177;860;1782;763;6117609;6799528;10611686;106939;11733846
FR;2;2022-04-28;91;214;948;1913;842;6117700;6799742;10612634;108852;11734688
FR;2;2022-04-29;81;280;1129;1691;1039;6117781;6800022;10613763;110543;11735727
FR;2;2022-04-30;65;126;470;538;429;6117846;6800148;10614233;111081;11736156
FR;2;2022-05-01;20;24;84;48;85;6117866;6800172;10614317;111129;11736241
FR;2;2022-05-02;115;225;762;1206;659;6117981;6800397;10615079;112335;11736900
FR;2;2022-05-03;148;228;996;1767;935;6118129;6800625;10616075;114102;11737835
FR;2;2022-05-04;90;222;923;1809;866;6118219;6800847;10616998;115911;11738701
FR;2;2022-05-05;126;195;851;1697;768;6118345;6801042;10617849;117608;11739469
FR;2;2022-05-06;133;243;1098;1848;1012;6118478;6801285;10618947;119456;11740481
FR;2;2022-05-07;40;97;470;504;406;6118518;6801382;10619417;119960;11740887
FR;2;2022-05-08;45;53;106;70;100;6118563;6801435;10619523;120030;11740987
FR;2;2022-05-09;101;174;653;984;604;6118664;6801609;10620176;121014;11741591
FR;2;2022-05-10;120;245;938;1830;893;6118784;6801854;10621114;122844;11742484
FR;2;2022-05-11;100;171;810;1871;790;6118884;6802025;10621924;124715;11743274
FR;2;2022-05-12;110;172;842;2093;802;6118994;6802197;10622766;126808;11744076
FR;2;2022-05-13;100;232;968;2089;897;6119094;6802429;10623734;128897;11744973
FR;2;2022-05-14;76;117;451;554;409;6119170;6802546;10624185;129451;11745382
FR;2;2022-05-15;24;37;93;87;107;6119194;6802583;10624278;129538;11745489
FR;2;2022-05-16;103;170;599;923;537;6119297;6802753;10624877;130461;11746026
FR;2;2022-05-17;95;184;689;1685;657;6119392;6802937;10625566;132146;11746683
FR;2;2022-05-18;80;180;640;1421;645;6119472;6803117;10626206;133567;11747328
FR;2;2022-05-19;69;159;707;1822;750;6119541;6803276;10626913;135389;11748078
FR;2;2022-05-20;107;177;872;1699;777;6119648;6803453;10627785;137088;11748855
FR;2;2022-05-21;48;96;397;517;338;6119696;6803549;10628182;137605;11749193
FR;2;2022-05-22;8;23;69;37;57;6119704;6803572;10628251;137642;11749250
FR;2;2022-05-23;85;131;498;930;469;6119789;6803703;10628749;138572;11749719
FR;2;2022-05-24;87;161;625;1610;613;6119876;6803864;10629374;140182;11750332
FR;2;2022-05-25;71;141;538;1144;491;6119947;6804005;10629912;141326;11750823
FR;2;2022-05-26;8;30;77;41;85;6119955;6804035;10629989;141367;11750908
FR;2;2022-05-27;44;121;456;817;438;6119999;6804156;10630445;142184;11751346
FR;2;2022-05-28;28;60;220;243;220;6120027;6804216;10630665;142427;11751566
FR;2;2022-05-29;13;34;43;25;51;6120040;6804250;10630708;142452;11751617
FR;2;2022-05-30;65;108;418;720;404;6120105;6804358;10631126;143172;11752021
FR;2;2022-05-31;76;133;561;1276;509;6120181;6804491;10631687;144448;11752530
FR;2;2022-06-01;59;153;558;1074;537;6120240;6804644;10632245;145522;11753067
FR;2;2022-06-02;92;171;624;1400;589;6120332;6804815;10632869;146922;11753656
FR;2;2022-06-03;70;155;666;1603;593;6120402;6804970;10633535;148525;11754249
FR;2;2022-06-04;68;92;281;433;267;6120470;6805062;10633816;148958;11754516
FR;2;2022-06-05;12;17;62;57;47;6120482;6805079;10633878;149015;11754563
FR;2;2022-06-06;11;27;92;75;92;6120493;6805106;10633970;149090;11754655
FR;2;2022-06-07;98;218;662;1531;575;6120591;6805324;10634632;150621;11755230
FR;2;2022-06-08;70;117;475;1165;410;6120661;6805441;10635107;151786;11755640
FR;2;2022-06-09;91;164;611;1921;568;6120752;6805605;10635718;153707;11756208
FR;2;2022-06-10;86;166;647;1682;619;6120838;6805771;10636365;155389;11756827
FR;2;2022-06-11;42;83;286;528;258;6120880;6805854;10636651;155917;11757085
FR;2;2022-06-12;18;38;58;78;60;6120898;6805892;10636709;155995;11757145
FR;2;2022-06-13;39;118;388;948;373;6120937;6806010;10637097;156943;11757518
FR;2;2022-06-14;65;154;598;2086;535;6121002;6806164;10637695;159029;11758053
FR;2;2022-06-15;76;103;518;1495;442;6121078;6806267;10638213;160524;11758495
FR;2;2022-06-16;127;126;494;1410;421;6121205;6806393;10638707;161934;11758916
FR;2;2022-06-17;72;131;584;1815;510;6121277;6806524;10639291;163749;11759426
FR;2;2022-06-18;75;92;224;578;196;6121352;6806616;10639515;164327;11759622
FR;2;2022-06-19;11;14;53;71;41;6121363;6806630;10639568;164398;11759663
FR;2;2022-06-20;61;124;400;1027;391;6121424;6806754;10639968;165425;11760054
FR;2;2022-06-21;106;115;524;2121;453;6121530;6806869;10640492;167546;11760507
FR;2;2022-06-22;39;106;461;1889;414;6121569;6806975;10640953;169435;11760921
FR;2;2022-06-23;56;108;536;2281;451;6121625;6807083;10641489;171716;11761372
FR;2;2022-06-24;66;121;707;3193;570;6121691;6807204;10642196;174909;11761942
FR;2;2022-06-25;30;89;294;986;250;6121721;6807293;10642490;175895;11762192
FR;2;2022-06-26;30;27;131;194;97;6121751;6807320;10642621;176089;11762289
FR;2;2022-06-27;79;136;579;2472;481;6121830;6807456;10643200;178561;11762770
FR;2;2022-06-28;110;138;812;4814;650;6121940;6807594;10644012;183375;11763420
FR;2;2022-06-29;72;149;774;4384;635;6122012;6807743;10644786;187759;11764055
FR;2;2022-06-30;72;133;830;5176;617;6122084;6807876;10645616;192935;11764672
FR;2;2022-07-01;110;153;1136;6678;831;6122194;6808029;10646752;199613;11765503
FR;2;2022-07-02;65;131;471;1973;391;6122259;6808160;10647223;201586;11765894
FR;2;2022-07-03;23;30;144;334;128;6122282;6808190;10647367;201920;11766022
FR;2;2022-07-04;119;175;771;3773;606;6122401;6808365;10648138;205693;11766628
FR;2;2022-07-05;116;184;1118;6808;824;6122517;6808549;10649256;212501;11767452
FR;2;2022-07-06;92;147;945;5800;691;6122609;6808696;10650201;218301;11768143
FR;2;2022-07-07;80;183;1020;6494;747;6122689;6808879;10651221;224795;11768890
FR;2;2022-07-08;64;122;1091;7027;753;6122753;6809001;10652312;231822;11769643
FR;2;2022-07-09;34;61;417;1869;298;6122787;6809062;10652729;233691;11769941
FR;2;2022-07-10;6;17;96;312;82;6122793;6809079;10652825;234003;11770023
FR;2;2022-07-11;68;118;676;3811;533;6122861;6809197;10653501;237814;11770556
FR;2;2022-07-12;98;178;1047;6502;803;6122959;6809375;10654548;244316;11771359
FR;2;2022-07-13;60;125;875;4647;581;6123019;6809500;10655423;248963;11771940
FR;2;2022-07-14;6;12;86;247;56;6123025;6809512;10655509;249210;11771996
FR;2;2022-07-15;58;126;738;3785;558;6123083;6809638;10656247;252995;11772554
FR;2;2022-07-16;27;53;287;1028;240;6123110;6809691;10656534;254023;11772794
FR;2;2022-07-17;5;12;77;201;66;6123115;6809703;10656611;254224;11772860
FR;2;2022-07-18;56;103;509;2507;380;6123171;6809806;10657120;256731;11773240
FR;2;2022-07-19;66;132;768;4245;555;6123237;6809938;10657888;260976;11773795
FR;2;2022-07-20;54;117;578;3177;428;6123291;6810055;10658466;264153;11774223
FR;2;2022-07-21;59;106;664;3675;479;6123350;6810161;10659130;267828;11774702
FR;2;2022-07-22;49;97;688;3506;495;6123399;6810258;10659818;271334;11775197
FR;2;2022-07-23;39;93;285;1167;223;6123438;6810351;10660103;272501;11775420
FR;2;2022-07-24;13;23;68;201;67;6123451;6810374;10660171;272702;11775487
FR;2;2022-07-25;48;69;383;1915;280;6123499;6810443;10660554;274617;11775767
FR;2;2022-07-26;59;131;600;3418;471;6123558;6810574;10661154;278035;11776238
FR;2;2022-07-27;42;82;446;2777;351;6123600;6810656;10661600;280812;11776589
FR;2;2022-07-28;29;75;439;2424;347;6123629;6810731;10662039;283236;11776936
FR;2;2022-07-29;63;88;520;2847;335;6123692;6810819;10662559;286083;11777271
FR;2;2022-07-30;21;35;162;774;110;6123713;6810854;10662721;286857;11777381
FR;2;2022-07-31;6;12;27;104;21;6123719;6810866;10662748;286961;11777402
FR;2;2022-08-01;35;91;273;1260;217;6123754;6810957;10663021;288221;11777619
FR;2;2022-08-02;49;73;314;2039;236;6123803;6811030;10663335;290260;11777855
FR;2;2022-08-03;26;51;242;1606;175;6123829;6811081;10663577;291866;11778030
FR;2;2022-08-04;39;62;295;1678;230;6123868;6811143;10663872;293544;11778260
FR;2;2022-08-05;28;85;309;1875;220;6123896;6811228;10664181;295419;11778480
FR;2;2022-08-06;21;40;94;358;72;6123917;6811268;10664275;295777;11778552
FR;2;2022-08-07;3;4;14;69;13;6123920;6811272;10664289;295846;11778565
FR;2;2022-08-08;14;31;206;860;134;6123934;6811303;10664495;296706;11778699
FR;2;2022-08-09;26;43;255;1423;216;6123960;6811346;10664750;298129;11778915
FR;3;2020-12-27;0;0;0;0;0;0;0;0;0;0
FR;3;2020-12-28;0;0;0;0;0;0;0;0;0;0
FR;3;2020-12-29;0;0;0;0;0;0;0;0;0;0
FR;3;2020-12-30;0;0;0;0;0;0;0;0;0;0
FR;3;2020-12-31;0;0;0;0;0;0;0;0;0;0
FR;3;2021-01-01;0;0;0;0;0;0;0;0;0;0
FR;3;2021-01-02;0;0;0;0;0;0;0;0;0;0
FR;3;2021-01-03;0;0;0;0;0;0;0;0;0;0
FR;3;2021-01-04;0;0;0;0;0;0;0;0;0;0
FR;3;2021-01-05;0;0;0;0;0;0;0;0;0;0
FR;3;2021-01-06;0;0;0;0;0;0;0;0;0;0
FR;3;2021-01-07;0;0;0;0;0;0;0;0;0;0
FR;3;2021-01-08;0;0;0;0;0;0;0;0;0;0
FR;3;2021-01-09;0;0;0;0;0;0;0;0;0;0
FR;3;2021-01-10;0;0;0;0;0;0;0;0;0;0
FR;3;2021-01-11;0;0;0;0;0;0;0;0;0;0
FR;3;2021-01-12;0;0;0;0;0;0;0;0;0;0
FR;3;2021-01-13;0;0;0;0;0;0;0;0;0;0
FR;3;2021-01-14;0;0;0;0;0;0;0;0;0;0
FR;3;2021-01-15;0;0;0;0;0;0;0;0;0;0
FR;3;2021-01-16;0;0;0;0;0;0;0;0;0;0
FR;3;2021-01-17;0;0;0;0;0;0;0;0;0;0
FR;3;2021-01-18;0;0;0;0;0;0;0;0;0;0
FR;3;2021-01-19;0;0;0;0;0;0;0;0;0;0
FR;3;2021-01-20;0;0;0;0;0;0;0;0;0;0
FR;3;2021-01-21;0;0;0;0;0;0;0;0;0;0
FR;3;2021-01-22;0;0;0;0;0;0;0;0;0;0
FR;3;2021-01-23;0;0;0;0;0;0;0;0;0;0
FR;3;2021-01-24;0;0;0;0;0;0;0;0;0;0
FR;3;2021-01-25;0;0;0;0;0;0;0;0;0;0
FR;3;2021-01-26;0;0;0;0;0;0;0;0;0;0
FR;3;2021-01-27;0;0;0;0;0;0;0;0;0;0
FR;3;2021-01-28;0;0;0;0;0;0;0;0;0;0
FR;3;2021-01-29;0;0;0;0;0;0;0;0;0;0
FR;3;2021-01-30;0;0;0;0;0;0;0;0;0;0
FR;3;2021-01-31;0;0;0;0;0;0;0;0;0;0
FR;3;2021-02-01;0;0;0;0;0;0;0;0;0;0
FR;3;2021-02-02;0;0;0;0;0;0;0;0;0;0
FR;3;2021-02-03;0;0;0;0;0;0;0;0;0;0
FR;3;2021-02-04;0;0;0;0;0;0;0;0;0;0
FR;3;2021-02-05;0;0;0;0;0;0;0;0;0;0
FR;3;2021-02-06;1589;0;0;0;0;1589;0;0;0;0
FR;3;2021-02-07;1423;1;0;0;0;3012;1;0;0;0
FR;3;2021-02-08;2786;1;0;0;0;5798;2;0;0;0
FR;3;2021-02-09;6782;0;0;0;0;12580;2;0;0;0
FR;3;2021-02-10;9608;0;0;0;0;22188;2;0;0;0
FR;3;2021-02-11;13618;1;0;0;0;35806;3;0;0;0
FR;3;2021-02-12;13404;0;0;0;0;49210;3;0;0;0
FR;3;2021-02-13;3796;1;0;0;0;53006;4;0;0;0
FR;3;2021-02-14;974;0;0;0;0;53980;4;0;0;0
FR;3;2021-02-15;10491;1;0;0;0;64471;5;0;0;0
FR;3;2021-02-16;12550;4;0;0;0;77021;9;0;0;0
FR;3;2021-02-17;11154;0;0;0;0;88175;9;0;0;0
FR;3;2021-02-18;14942;2;0;0;0;103117;11;0;0;0
FR;3;2021-02-19;14361;1;0;0;0;117478;12;0;0;0
FR;3;2021-02-20;3330;0;0;0;0;120808;12;0;0;0
FR;3;2021-02-21;618;0;0;0;0;121426;12;0;0;0
FR;3;2021-02-22;9166;0;0;0;0;130592;12;0;0;0
FR;3;2021-02-23;11398;3;0;0;0;141990;15;0;0;0
FR;3;2021-02-24;14305;1;0;0;0;156295;16;0;0;0
FR;3;2021-02-25;44931;3;0;0;0;201226;19;0;0;0
FR;3;2021-02-26;61887;7;0;0;0;263113;26;0;0;0
FR;3;2021-02-27;34803;10;0;0;0;297916;36;0;0;0
FR;3;2021-02-28;2463;0;0;0;0;300379;36;0;0;0
FR;3;2021-03-01;20516;14;0;0;0;320895;50;0;0;0
FR;3;2021-03-02;38869;21;0;0;0;359764;71;0;0;0
FR;3;2021-03-03;48740;15;0;0;0;408504;86;0;0;0
FR;3;2021-03-04;82221;20;0;0;0;490725;106;0;0;0
FR;3;2021-03-05;118127;41;0;0;0;608852;147;0;0;0
FR;3;2021-03-06;120714;63;1;0;0;729566;210;1;0;0
FR;3;2021-03-07;55179;25;0;0;0;784745;235;1;0;0
FR;3;2021-03-08;42811;25;0;0;0;827556;260;1;0;0
FR;3;2021-03-09;78972;50;0;0;0;906528;310;1;0;0
FR;3;2021-03-10;80978;53;0;0;0;987506;363;1;0;0
FR;3;2021-03-11;128439;59;0;0;0;1115945;422;1;0;0
FR;3;2021-03-12;182721;102;0;0;0;1298666;524;1;0;0
FR;3;2021-03-13;132151;76;0;0;0;1430817;600;1;0;0
FR;3;2021-03-14;14056;5;0;0;0;1444873;605;1;0;0
FR;3;2021-03-15;52235;63;0;0;0;1497108;668;1;0;0
FR;3;2021-03-16;1215;43;0;0;0;1498323;711;1;0;0
FR;3;2021-03-17;944;44;0;0;0;1499267;755;1;0;0
FR;3;2021-03-18;1569;29;0;0;0;1500836;784;1;0;0
FR;3;2021-03-19;70454;49;0;0;0;1571290;833;1;0;0
FR;3;2021-03-20;65233;45;0;0;0;1636523;878;1;0;0
FR;3;2021-03-21;5759;8;0;0;0;1642282;886;1;0;0
FR;3;2021-03-22;37504;44;0;0;0;1679786;930;1;0;0
FR;3;2021-03-23;84658;75;0;0;0;1764444;1005;1;0;0
FR;3;2021-03-24;90943;97;0;0;0;1855387;1102;1;0;0
FR;3;2021-03-25;150058;133;0;0;0;2005445;1235;1;0;0
FR;3;2021-03-26;165425;154;0;0;0;2170870;1389;1;0;0
FR;3;2021-03-27;68457;101;0;0;0;2239327;1490;1;0;0
FR;3;2021-03-28;6475;21;0;0;0;2245802;1511;1;0;0
FR;3;2021-03-29;54164;74;0;0;0;2299966;1585;1;0;0
FR;3;2021-03-30;93173;102;0;0;0;2393139;1687;1;0;0
FR;3;2021-03-31;63536;102;0;0;0;2456675;1789;1;0;0
FR;3;2021-04-01;86130;108;0;0;0;2542805;1897;1;0;0
FR;3;2021-04-02;86904;174;0;0;0;2629709;2071;1;0;0
FR;3;2021-04-03;35875;125;0;0;0;2665584;2196;1;0;0
FR;3;2021-04-04;3573;18;0;0;0;2669157;2214;1;0;0
FR;3;2021-04-05;4489;33;0;0;0;2673646;2247;1;0;0
FR;3;2021-04-06;29752;95;0;0;0;2703398;2342;1;0;0
FR;3;2021-04-07;32341;91;0;0;0;2735739;2433;1;0;0
FR;3;2021-04-08;78819;249;0;0;0;2814558;2682;1;0;0
FR;3;2021-04-09;161752;429;0;0;0;2976310;3111;1;0;0
FR;3;2021-04-10;75760;352;0;0;0;3052070;3463;1;0;0
FR;3;2021-04-11;7311;46;0;0;0;3059381;3509;1;0;0
FR;3;2021-04-12;51478;215;0;0;0;3110859;3724;1;0;0
FR;3;2021-04-13;86229;341;0;0;0;3197088;4065;1;0;0
FR;3;2021-04-14;67839;359;0;0;0;3264927;4424;1;0;0
FR;3;2021-04-15;93233;386;0;0;0;3358160;4810;1;0;0
FR;3;2021-04-16;112520;598;0;0;0;3470680;5408;1;0;0
FR;3;2021-04-17;53316;339;1;0;0;3523996;5747;2;0;0
FR;3;2021-04-18;9745;42;0;0;0;3533741;5789;2;0;0
FR;3;2021-04-19;25106;260;0;0;0;3558847;6049;2;0;0
FR;3;2021-04-20;45673;413;0;0;0;3604520;6462;2;0;0
FR;3;2021-04-21;38978;492;0;0;0;3643498;6954;2;0;0
FR;3;2021-04-22;54708;820;0;0;0;3698206;7774;2;0;0
FR;3;2021-04-23;70489;1041;0;0;0;3768695;8815;2;0;0
FR;3;2021-04-24;37244;1051;0;0;0;3805939;9866;2;0;0
FR;3;2021-04-25;6209;153;0;0;0;3812148;10019;2;0;0
FR;3;2021-04-26;19786;676;0;0;0;3831934;10695;2;0;0
FR;3;2021-04-27;34480;1283;0;0;0;3866414;11978;2;0;0
FR;3;2021-04-28;28967;1979;0;0;0;3895381;13957;2;0;0
FR;3;2021-04-29;45382;6028;0;0;0;3940763;19985;2;0;0
FR;3;2021-04-30;55462;8998;1;0;0;3996225;28983;3;0;0
FR;3;2021-05-01;9513;2023;0;0;0;4005738;31006;3;0;0
FR;3;2021-05-02;3074;477;0;0;0;4008812;31483;3;0;0
FR;3;2021-05-03;13062;3891;0;0;0;4021874;35374;3;0;0
FR;3;2021-05-04;23114;8458;0;0;0;4044988;43832;3;0;0
FR;3;2021-05-05;18758;10706;0;0;0;4063746;54538;3;0;0
FR;3;2021-05-06;34628;21053;0;0;0;4098374;75591;3;0;0
FR;3;2021-05-07;44202;28645;0;0;0;4142576;104236;3;0;0
FR;3;2021-05-08;6785;9159;0;0;0;4149361;113395;3;0;0
FR;3;2021-05-09;1795;2659;0;0;0;4151156;116054;3;0;0
FR;3;2021-05-10;14996;12790;0;0;0;4166152;128844;3;0;0
FR;3;2021-05-11;27095;26026;0;0;0;4193247;154870;3;0;0
FR;3;2021-05-12;17268;27825;0;0;0;4210515;182695;3;0;0
FR;3;2021-05-13;2281;3495;0;0;0;4212796;186190;3;0;0
FR;3;2021-05-14;14517;25956;0;0;0;4227313;212146;3;0;0
FR;3;2021-05-15;7233;20928;0;0;0;4234546;233074;3;0;0
FR;3;2021-05-16;976;2650;0;0;0;4235522;235724;3;0;0
FR;3;2021-05-17;7963;20048;0;0;0;4243485;255772;3;0;0
FR;3;2021-05-18;13412;29929;0;0;0;4256897;285701;3;0;0
FR;3;2021-05-19;9271;31040;0;0;0;4266168;316741;3;0;0
FR;3;2021-05-20;12804;53563;3;0;0;4278972;370304;6;0;0
FR;3;2021-05-21;12763;65874;2;0;0;4291735;436178;8;0;0
FR;3;2021-05-22;4963;33560;1;0;0;4296698;469738;9;0;0
FR;3;2021-05-23;651;2657;0;0;0;4297349;472395;9;0;0
FR;3;2021-05-24;883;4859;0;0;0;4298232;477254;9;0;0
FR;3;2021-05-25;5309;46072;1;0;0;4303541;523326;10;0;0
FR;3;2021-05-26;4974;51658;1;0;0;4308515;574984;11;0;0
FR;3;2021-05-27;6330;78538;3;0;0;4314845;653522;14;0;0
FR;3;2021-05-28;7543;99722;2;0;0;4322388;753244;16;0;0
FR;3;2021-05-29;3348;60752;1;0;0;4325736;813996;17;0;0
FR;3;2021-05-30;548;8169;0;0;0;4326284;822165;17;0;0
FR;3;2021-05-31;2441;35668;3;0;0;4328725;857833;20;0;0
FR;3;2021-06-01;3408;64840;10;0;0;4332133;922673;30;0;0
FR;3;2021-06-02;2732;58545;6;0;0;4334865;981218;36;0;0
FR;3;2021-06-03;3495;87369;10;0;0;4338360;1068587;46;0;0
FR;3;2021-06-04;4114;105526;22;0;0;4342474;1174113;68;0;0
FR;3;2021-06-05;1982;52439;4;0;0;4344456;1226552;72;0;0
FR;3;2021-06-06;508;5314;1;0;0;4344964;1231866;73;0;0
FR;3;2021-06-07;1478;30877;11;0;0;4346442;1262743;84;0;0
FR;3;2021-06-08;2060;47330;18;0;0;4348502;1310073;102;0;0
FR;3;2021-06-09;1794;42014;13;0;0;4350296;1352087;115;0;0
FR;3;2021-06-10;2251;67747;17;0;0;4352547;1419834;132;0;0
FR;3;2021-06-11;2480;96647;34;0;0;4355027;1516481;166;0;0
FR;3;2021-06-12;1176;40662;6;0;0;4356203;1557143;172;0;0
FR;3;2021-06-13;282;3694;3;0;0;4356485;1560837;175;0;0
FR;3;2021-06-14;1043;42464;17;0;0;4357528;1603301;192;0;0
FR;3;2021-06-15;1369;80475;20;0;0;4358897;1683776;212;0;0
FR;3;2021-06-16;1259;65530;20;0;0;4360156;1749306;232;0;0
FR;3;2021-06-17;1664;102065;41;0;0;4361820;1851371;273;0;0
FR;3;2021-06-18;1870;118198;62;0;0;4363690;1969569;335;0;0
FR;3;2021-06-19;802;39430;22;0;0;4364492;2008999;357;0;0
FR;3;2021-06-20;159;3262;0;0;0;4364651;2012261;357;0;0
FR;3;2021-06-21;771;39127;16;0;0;4365422;2051388;373;0;0
FR;3;2021-06-22;1065;70000;52;0;0;4366487;2121388;425;0;0
FR;3;2021-06-23;942;50824;39;0;0;4367429;2172212;464;0;0
FR;3;2021-06-24;1310;77189;48;0;0;4368739;2249401;512;0;0
FR;3;2021-06-25;1403;90401;73;0;0;4370142;2339802;585;0;0
FR;3;2021-06-26;629;33113;29;0;0;4370771;2372915;614;0;0
FR;3;2021-06-27;166;3882;1;0;0;4370937;2376797;615;0;0
FR;3;2021-06-28;654;30202;27;0;0;4371591;2406999;642;0;0
FR;3;2021-06-29;856;56358;95;0;0;4372447;2463357;737;0;0
FR;3;2021-06-30;905;45114;93;0;0;4373352;2508471;830;0;0
FR;3;2021-07-01;1162;65906;108;0;0;4374514;2574377;938;0;0
FR;3;2021-07-02;1306;90446;170;0;0;4375820;2664823;1108;0;0
FR;3;2021-07-03;602;31187;51;0;0;4376422;2696010;1159;0;0
FR;3;2021-07-04;144;4113;3;0;0;4376566;2700123;1162;0;0
FR;3;2021-07-05;610;33718;60;0;0;4377176;2733841;1222;0;0
FR;3;2021-07-06;960;55983;88;0;0;4378136;2789824;1310;0;0
FR;3;2021-07-07;870;42983;80;0;0;4379006;2832807;1390;0;0
FR;3;2021-07-08;1124;60740;99;0;0;4380130;2893547;1489;0;0
FR;3;2021-07-09;1260;68855;128;0;0;4381390;2962402;1617;0;0
FR;3;2021-07-10;643;25043;59;0;0;4382033;2987445;1676;0;0
FR;3;2021-07-11;129;3229;4;0;0;4382162;2990674;1680;0;0
FR;3;2021-07-12;662;23771;59;0;0;4382824;3014445;1739;0;0
FR;3;2021-07-13;1647;34594;90;0;0;4384471;3049039;1829;0;0
FR;3;2021-07-14;267;2535;2;0;0;4384738;3051574;1831;0;0
FR;3;2021-07-15;1938;30546;85;0;0;4386676;3082120;1916;0;0
FR;3;2021-07-16;2520;38742;122;0;0;4389196;3120862;2038;0;0
FR;3;2021-07-17;1048;13731;26;0;0;4390244;3134593;2064;0;0
FR;3;2021-07-18;264;2566;3;0;0;4390508;3137159;2067;0;0
FR;3;2021-07-19;1276;17034;37;0;0;4391784;3154193;2104;0;0
FR;3;2021-07-20;1823;27015;98;0;0;4393607;3181208;2202;0;0
FR;3;2021-07-21;1651;19601;44;0;0;4395258;3200809;2246;0;0
FR;3;2021-07-22;1854;27682;83;0;0;4397112;3228491;2329;0;0
FR;3;2021-07-23;2215;30348;117;0;0;4399327;3258839;2446;0;0
FR;3;2021-07-24;825;6962;25;0;0;4400152;3265801;2471;0;0
FR;3;2021-07-25;210;1307;1;0;0;4400362;3267108;2472;0;0
FR;3;2021-07-26;928;10591;28;0;0;4401290;3277699;2500;0;0
FR;3;2021-07-27;1168;16877;56;0;0;4402458;3294576;2556;0;0
FR;3;2021-07-28;988;12033;40;0;0;4403446;3306609;2596;0;0
FR;3;2021-07-29;1127;15748;63;0;0;4404573;3322357;2659;0;0
FR;3;2021-07-30;1128;18018;79;0;0;4405701;3340375;2738;0;0
FR;3;2021-07-31;406;3739;15;0;0;4406107;3344114;2753;0;0
FR;3;2021-08-01;114;465;1;0;0;4406221;3344579;2754;0;0
FR;3;2021-08-02;421;5087;22;0;0;4406642;3349666;2776;0;0
FR;3;2021-08-03;494;7525;27;0;0;4407136;3357191;2803;0;0
FR;3;2021-08-04;435;4856;26;0;0;4407571;3362047;2829;0;0
FR;3;2021-08-05;430;3682;13;0;0;4408001;3365729;2842;0;0
FR;3;2021-08-06;456;4743;30;0;0;4408457;3370472;2872;0;0
FR;3;2021-08-07;214;1908;11;0;0;4408671;3372380;2883;0;0
FR;3;2021-08-08;249;430;2;0;0;4408920;3372810;2885;0;0
FR;3;2021-08-09;317;2432;11;0;0;4409237;3375242;2896;0;0
FR;3;2021-08-10;368;3810;15;0;0;4409605;3379052;2911;0;0
FR;3;2021-08-11;289;2691;15;0;0;4409894;3381743;2926;0;0
FR;3;2021-08-12;277;2604;12;0;0;4410171;3384347;2938;0;0
FR;3;2021-08-13;277;2262;16;0;0;4410448;3386609;2954;0;0
FR;3;2021-08-14;172;906;1;0;0;4410620;3387515;2955;0;0
FR;3;2021-08-15;56;175;0;0;0;4410676;3387690;2955;0;0
FR;3;2021-08-16;123;1047;8;0;0;4410799;3388737;2963;0;0
FR;3;2021-08-17;188;1464;8;0;0;4410987;3390201;2971;0;0
FR;3;2021-08-18;203;1326;10;0;0;4411190;3391527;2981;0;0
FR;3;2021-08-19;165;1392;10;0;0;4411355;3392919;2991;0;0
FR;3;2021-08-20;167;1615;16;0;0;4411522;3394534;3007;0;0
FR;3;2021-08-21;93;584;2;0;0;4411615;3395118;3009;0;0
FR;3;2021-08-22;42;187;1;0;0;4411657;3395305;3010;0;0
FR;3;2021-08-23;141;915;7;0;0;4411798;3396220;3017;0;0
FR;3;2021-08-24;124;946;10;0;0;4411922;3397166;3027;0;0
FR;3;2021-08-25;137;832;3;0;0;4412059;3397998;3030;0;0
FR;3;2021-08-26;172;849;9;0;0;4412231;3398847;3039;0;0
FR;3;2021-08-27;178;946;9;0;0;4412409;3399793;3048;0;0
FR;3;2021-08-28;99;370;4;0;0;4412508;3400163;3052;0;0
FR;3;2021-08-29;128;134;1;0;0;4412636;3400297;3053;0;0
FR;3;2021-08-30;100;584;0;0;125;4412736;3400881;3053;0;125
FR;3;2021-08-31;131;696;7;0;143;4412867;3401577;3060;0;268
FR;3;2021-09-01;120;466;5;0;114;4412987;3402043;3065;0;382
FR;3;2021-09-02;100;623;22;0;114;4413087;3402666;3087;0;496
FR;3;2021-09-03;115;574;17;0;121;4413202;3403240;3104;0;617
FR;3;2021-09-04;54;299;3;0;55;4413256;3403539;3107;0;672
FR;3;2021-09-05;51;68;5;0;28;4413307;3403607;3112;0;700
FR;3;2021-09-06;116;381;4;0;140;4413423;3403988;3116;0;840
FR;3;2021-09-07;123;455;14;0;124;4413546;3404443;3130;0;964
FR;3;2021-09-08;120;353;2;0;94;4413666;3404796;3132;0;1058
FR;3;2021-09-09;93;387;8;0;108;4413759;3405183;3140;0;1166
FR;3;2021-09-10;100;407;3;0;96;4413859;3405590;3143;0;1262
FR;3;2021-09-11;76;233;4;0;66;4413935;3405823;3147;0;1328
FR;3;2021-09-12;37;46;1;0;17;4413972;3405869;3148;0;1345
FR;3;2021-09-13;73;309;7;0;104;4414045;3406178;3155;0;1449
FR;3;2021-09-14;72;282;6;0;100;4414117;3406460;3161;0;1549
FR;3;2021-09-15;61;257;3;0;6;4414178;3406717;3164;0;1555
FR;3;2021-09-16;62;326;5;0;5;4414240;3407043;3169;0;1560
FR;3;2021-09-17;52;334;3;0;7;4414292;3407377;3172;0;1567
FR;3;2021-09-18;36;177;1;0;1;4414328;3407554;3173;0;1568
FR;3;2021-09-19;28;30;2;0;1;4414356;3407584;3175;0;1569
FR;3;2021-09-20;81;198;0;0;1;4414437;3407782;3175;0;1570
FR;3;2021-09-21;59;286;6;0;7;4414496;3408068;3181;0;1577
FR;3;2021-09-22;64;231;6;0;7;4414560;3408299;3187;0;1584
FR;3;2021-09-23;37;266;11;0;7;4414597;3408565;3198;0;1591
FR;3;2021-09-24;27;325;12;0;19;4414624;3408890;3210;0;1610
FR;3;2021-09-25;31;142;3;0;3;4414655;3409032;3213;0;1613
FR;3;2021-09-26;16;58;1;0;1;4414671;3409090;3214;0;1614
FR;3;2021-09-27;46;293;3;0;5;4414717;3409383;3217;0;1619
FR;3;2021-09-28;49;250;6;0;8;4414766;3409633;3223;0;1627
FR;3;2021-09-29;37;224;10;0;14;4414803;3409857;3233;0;1641
FR;3;2021-09-30;39;202;8;0;10;4414842;3410059;3241;0;1651
FR;3;2021-10-01;21;163;6;0;7;4414863;3410222;3247;0;1658
FR;3;2021-10-02;16;86;0;0;0;4414879;3410308;3247;0;1658
FR;3;2021-10-03;19;18;1;0;2;4414898;3410326;3248;0;1660
FR;3;2021-10-04;31;158;4;0;4;4414929;3410484;3252;0;1664
FR;3;2021-10-05;16;150;10;0;13;4414945;3410634;3262;0;1677
FR;3;2021-10-06;32;149;8;0;9;4414977;3410783;3270;0;1686
FR;3;2021-10-07;19;135;6;0;6;4414996;3410918;3276;0;1692
FR;3;2021-10-08;23;141;10;0;9;4415019;3411059;3286;0;1701
FR;3;2021-10-09;14;72;1;0;1;4415033;3411131;3287;0;1702
FR;3;2021-10-10;13;18;2;0;3;4415046;3411149;3289;0;1705
FR;3;2021-10-11;15;121;4;0;5;4415061;3411270;3293;0;1710
FR;3;2021-10-12;19;105;5;0;5;4415080;3411375;3298;0;1715
FR;3;2021-10-13;25;115;9;0;7;4415105;3411490;3307;0;1722
FR;3;2021-10-14;18;154;3;0;4;4415123;3411644;3310;0;1726
FR;3;2021-10-15;23;150;8;0;11;4415146;3411794;3318;0;1737
FR;3;2021-10-16;11;77;6;0;8;4415157;3411871;3324;0;1745
FR;3;2021-10-17;12;25;0;0;0;4415169;3411896;3324;0;1745
FR;3;2021-10-18;18;120;2;0;2;4415187;3412016;3326;0;1747
FR;3;2021-10-19;16;117;19;0;21;4415203;3412133;3345;0;1768
FR;3;2021-10-20;24;129;6;0;7;4415227;3412262;3351;0;1775
FR;3;2021-10-21;27;128;17;0;13;4415254;3412390;3368;0;1788
FR;3;2021-10-22;23;115;16;0;19;4415277;3412505;3384;0;1807
FR;3;2021-10-23;15;58;2;0;1;4415292;3412563;3386;0;1808
FR;3;2021-10-24;7;35;0;0;0;4415299;3412598;3386;0;1808
FR;3;2021-10-25;23;149;7;0;7;4415322;3412747;3393;0;1815
FR;3;2021-10-26;23;105;22;0;19;4415345;3412852;3415;0;1834
FR;3;2021-10-27;18;105;9;0;9;4415363;3412957;3424;0;1843
FR;3;2021-10-28;22;119;33;0;36;4415385;3413076;3457;0;1879
FR;3;2021-10-29;12;111;64;0;54;4415397;3413187;3521;0;1933
FR;3;2021-10-30;10;65;11;1;10;4415407;3413252;3532;1;1943
FR;3;2021-10-31;8;23;1;0;1;4415415;3413275;3533;1;1944
FR;3;2021-11-01;10;23;2;0;1;4415425;3413298;3535;1;1945
FR;3;2021-11-02;9;103;10;0;12;4415434;3413401;3545;1;1957
FR;3;2021-11-03;19;110;10;0;10;4415453;3413511;3555;1;1967
FR;3;2021-11-04;18;89;4;0;3;4415471;3413600;3559;1;1970
FR;3;2021-11-05;19;128;8;1;5;4415490;3413728;3567;2;1975
FR;3;2021-11-06;10;62;3;0;3;4415500;3413790;3570;2;1978
FR;3;2021-11-07;6;21;1;0;1;4415506;3413811;3571;2;1979
FR;3;2021-11-08;11;134;7;0;5;4415517;3413945;3578;2;1984
FR;3;2021-11-09;13;139;5;0;5;4415530;3414084;3583;2;1989
FR;3;2021-11-10;14;166;14;0;15;4415544;3414250;3597;2;2004
FR;3;2021-11-11;11;49;3;0;3;4415555;3414299;3600;2;2007
FR;3;2021-11-12;14;145;6;0;4;4415569;3414444;3606;2;2011
FR;3;2021-11-13;7;69;9;0;10;4415576;3414513;3615;2;2021
FR;3;2021-11-14;3;24;1;0;1;4415579;3414537;3616;2;2022
FR;3;2021-11-15;5;180;10;0;11;4415584;3414717;3626;2;2033
FR;3;2021-11-16;6;146;11;0;10;4415590;3414863;3637;2;2043
FR;3;2021-11-17;7;161;10;0;7;4415597;3415024;3647;2;2050
FR;3;2021-11-18;14;154;10;0;11;4415611;3415178;3657;2;2061
FR;3;2021-11-19;10;206;22;0;27;4415621;3415384;3679;2;2088
FR;3;2021-11-20;6;107;6;0;6;4415627;3415491;3685;2;2094
FR;3;2021-11-21;3;26;3;0;3;4415630;3415517;3688;2;2097
FR;3;2021-11-22;11;207;11;0;11;4415641;3415724;3699;2;2108
FR;3;2021-11-23;8;207;15;0;14;4415649;3415931;3714;2;2122
FR;3;2021-11-24;8;209;9;0;17;4415657;3416140;3723;2;2139
FR;3;2021-11-25;12;241;11;0;11;4415669;3416381;3734;2;2150
FR;3;2021-11-26;8;311;35;0;33;4415677;3416692;3769;2;2183
FR;3;2021-11-27;8;144;20;0;21;4415685;3416836;3789;2;2204
FR;3;2021-11-28;3;63;7;0;7;4415688;3416899;3796;2;2211
FR;3;2021-11-29;5;268;20;0;21;4415693;3417167;3816;2;2232
FR;3;2021-11-30;6;357;28;0;31;4415699;3417524;3844;2;2263
FR;3;2021-12-01;28;396;35;0;37;4415727;3417920;3879;2;2300
FR;3;2021-12-02;9;408;33;0;36;4415736;3418328;3912;2;2336
FR;3;2021-12-03;4;467;37;0;38;4415740;3418795;3949;2;2374
FR;3;2021-12-04;3;247;26;0;28;4415743;3419042;3975;2;2402
FR;3;2021-12-05;1;67;5;0;5;4415744;3419109;3980;2;2407
FR;3;2021-12-06;5;432;14;0;15;4415749;3419541;3994;2;2422
FR;3;2021-12-07;4;506;20;0;24;4415753;3420047;4014;2;2446
FR;3;2021-12-08;6;463;29;0;30;4415759;3420510;4043;2;2476
FR;3;2021-12-09;3;531;17;0;22;4415762;3421041;4060;2;2498
FR;3;2021-12-10;10;538;29;0;25;4415772;3421579;4089;2;2523
FR;3;2021-12-11;4;342;10;0;9;4415776;3421921;4099;2;2532
FR;3;2021-12-12;1;112;3;0;3;4415777;3422033;4102;2;2535
FR;3;2021-12-13;2;509;19;0;21;4415779;3422542;4121;2;2556
FR;3;2021-12-14;7;658;18;0;21;4415786;3423200;4139;2;2577
FR;3;2021-12-15;9;629;17;0;21;4415795;3423829;4156;2;2598
FR;3;2021-12-16;10;638;19;0;18;4415805;3424467;4175;2;2616
FR;3;2021-12-17;5;721;18;0;19;4415810;3425188;4193;2;2635
FR;3;2021-12-18;4;384;4;0;5;4415814;3425572;4197;2;2640
FR;3;2021-12-19;3;194;2;0;2;4415817;3425766;4199;2;2642
FR;3;2021-12-20;8;657;23;0;28;4415825;3426423;4222;2;2670
FR;3;2021-12-21;3;749;10;0;13;4415828;3427172;4232;2;2683
FR;3;2021-12-22;10;690;9;0;10;4415838;3427862;4241;2;2693
FR;3;2021-12-23;2;601;8;0;8;4415840;3428463;4249;2;2701
FR;3;2021-12-24;2;253;3;0;6;4415842;3428716;4252;2;2707
FR;3;2021-12-25;0;25;0;0;0;4415842;3428741;4252;2;2707
FR;3;2021-12-26;0;92;1;0;1;4415842;3428833;4253;2;2708
FR;3;2021-12-27;7;502;17;0;20;4415849;3429335;4270;2;2728
FR;3;2021-12-28;1;653;6;0;5;4415850;3429988;4276;2;2733
FR;3;2021-12-29;4;542;14;0;16;4415854;3430530;4290;2;2749
FR;3;2021-12-30;3;564;7;0;10;4415857;3431094;4297;2;2759
FR;3;2021-12-31;0;197;5;0;7;4415857;3431291;4302;2;2766
FR;3;2022-01-01;0;26;0;0;2;4415857;3431317;4302;2;2768
FR;3;2022-01-02;0;80;0;0;0;4415857;3431397;4302;2;2768
FR;3;2022-01-03;4;540;17;0;21;4415861;3431937;4319;2;2789
FR;3;2022-01-04;6;587;9;0;8;4415867;3432524;4328;2;2797
FR;3;2022-01-05;4;533;10;0;14;4415871;3433057;4338;2;2811
FR;3;2022-01-06;5;512;9;0;10;4415876;3433569;4347;2;2821
FR;3;2022-01-07;2;539;11;0;13;4415878;3434108;4358;2;2834
FR;3;2022-01-08;4;267;4;0;5;4415882;3434375;4362;2;2839
FR;3;2022-01-09;0;117;0;0;0;4415882;3434492;4362;2;2839
FR;3;2022-01-10;2;461;12;0;12;4415884;3434953;4374;2;2851
FR;3;2022-01-11;2;501;1;0;1;4415886;3435454;4375;2;2852
FR;3;2022-01-12;2;429;9;0;10;4415888;3435883;4384;2;2862
FR;3;2022-01-13;3;406;11;0;12;4415891;3436289;4395;2;2874
FR;3;2022-01-14;3;454;10;0;13;4415894;3436743;4405;2;2887
FR;3;2022-01-15;0;291;2;0;3;4415894;3437034;4407;2;2890
FR;3;2022-01-16;1;113;1;0;1;4415895;3437147;4408;2;2891
FR;3;2022-01-17;2;336;8;0;9;4415897;3437483;4416;2;2900
FR;3;2022-01-18;2;392;1;0;2;4415899;3437875;4417;2;2902
FR;3;2022-01-19;2;338;5;0;10;4415901;3438213;4422;2;2912
FR;3;2022-01-20;1;370;5;0;3;4415902;3438583;4427;2;2915
FR;3;2022-01-21;4;358;5;0;7;4415906;3438941;4432;2;2922
FR;3;2022-01-22;2;230;1;0;2;4415908;3439171;4433;2;2924
FR;3;2022-01-23;0;81;0;0;1;4415908;3439252;4433;2;2925
FR;3;2022-01-24;2;338;1;0;6;4415910;3439590;4434;2;2931
FR;3;2022-01-25;0;184;0;0;0;4415910;3439774;4434;2;2931
FR;3;2022-01-26;0;82;0;0;0;4415910;3439856;4434;2;2931
FR;3;2022-01-27;0;54;0;0;0;4415910;3439910;4434;2;2931
FR;3;2022-01-28;0;124;0;0;0;4415910;3440034;4434;2;2931
FR;3;2022-01-29;0;105;0;0;0;4415910;3440139;4434;2;2931
FR;3;2022-01-30;0;51;0;0;0;4415910;3440190;4434;2;2931
FR;3;2022-01-31;0;96;0;0;0;4415910;3440286;4434;2;2931
FR;3;2022-02-01;0;101;0;0;1;4415910;3440387;4434;2;2932
FR;3;2022-02-02;0;91;0;0;0;4415910;3440478;4434;2;2932
FR;3;2022-02-03;0;97;0;0;0;4415910;3440575;4434;2;2932
FR;3;2022-02-04;0;122;0;0;0;4415910;3440697;4434;2;2932
FR;3;2022-02-05;0;72;0;0;0;4415910;3440769;4434;2;2932
FR;3;2022-02-06;0;11;0;0;0;4415910;3440780;4434;2;2932
FR;3;2022-02-07;0;88;0;0;1;4415910;3440868;4434;2;2933
FR;3;2022-02-08;0;0;0;0;0;4415910;3440868;4434;2;2933
FR;3;2022-02-09;0;0;0;0;0;4415910;3440868;4434;2;2933
FR;3;2022-02-10;0;0;0;0;0;4415910;3440868;4434;2;2933
FR;3;2022-02-11;0;0;0;0;0;4415910;3440868;4434;2;2933
FR;3;2022-02-12;0;0;0;0;0;4415910;3440868;4434;2;2933
FR;3;2022-02-13;0;0;0;0;0;4415910;3440868;4434;2;2933
FR;3;2022-02-14;0;0;0;0;0;4415910;3440868;4434;2;2933
FR;3;2022-02-15;0;0;0;0;0;4415910;3440868;4434;2;2933
FR;3;2022-02-16;0;0;0;0;0;4415910;3440868;4434;2;2933
FR;3;2022-02-17;0;0;0;0;0;4415910;3440868;4434;2;2933
FR;3;2022-02-18;0;0;0;0;0;4415910;3440868;4434;2;2933
FR;3;2022-02-19;0;0;0;0;0;4415910;3440868;4434;2;2933
FR;3;2022-02-20;0;0;0;0;0;4415910;3440868;4434;2;2933
FR;3;2022-02-21;2;0;0;0;0;4415912;3440868;4434;2;2933
FR;3;2022-02-22;0;0;0;0;0;4415912;3440868;4434;2;2933
FR;3;2022-02-23;0;0;0;0;0;4415912;3440868;4434;2;2933
FR;3;2022-02-24;0;0;0;0;0;4415912;3440868;4434;2;2933
FR;3;2022-02-25;0;0;0;0;0;4415912;3440868;4434;2;2933
FR;3;2022-02-26;0;0;0;0;0;4415912;3440868;4434;2;2933
FR;3;2022-02-27;0;0;0;0;0;4415912;3440868;4434;2;2933
FR;3;2022-02-28;1;0;0;0;0;4415913;3440868;4434;2;2933
FR;3;2022-03-01;1;0;0;0;0;4415914;3440868;4434;2;2933
FR;3;2022-03-02;0;0;0;0;0;4415914;3440868;4434;2;2933
FR;3;2022-03-03;0;0;0;0;0;4415914;3440868;4434;2;2933
FR;3;2022-03-04;0;0;0;0;0;4415914;3440868;4434;2;2933
FR;3;2022-03-05;0;0;0;0;0;4415914;3440868;4434;2;2933
FR;3;2022-03-06;1;0;0;0;0;4415915;3440868;4434;2;2933
FR;3;2022-03-07;0;0;0;0;0;4415915;3440868;4434;2;2933
FR;3;2022-03-08;1;0;0;0;0;4415916;3440868;4434;2;2933
FR;3;2022-03-09;0;0;0;0;0;4415916;3440868;4434;2;2933
FR;3;2022-03-10;0;0;0;0;0;4415916;3440868;4434;2;2933
FR;3;2022-03-11;0;0;0;0;0;4415916;3440868;4434;2;2933
FR;3;2022-03-12;0;0;0;0;0;4415916;3440868;4434;2;2933
FR;3;2022-03-13;0;0;0;0;0;4415916;3440868;4434;2;2933
FR;3;2022-03-14;0;0;0;0;0;4415916;3440868;4434;2;2933
FR;3;2022-03-15;0;0;0;0;0;4415916;3440868;4434;2;2933
FR;3;2022-03-16;0;0;0;0;0;4415916;3440868;4434;2;2933
FR;3;2022-03-17;0;0;0;0;0;4415916;3440868;4434;2;2933
FR;3;2022-03-18;0;0;0;0;0;4415916;3440868;4434;2;2933
FR;3;2022-03-19;0;0;0;0;0;4415916;3440868;4434;2;2933
FR;3;2022-03-20;1;0;0;0;0;4415917;3440868;4434;2;2933
FR;3;2022-03-21;0;0;0;0;0;4415917;3440868;4434;2;2933
FR;3;2022-03-22;0;0;0;0;0;4415917;3440868;4434;2;2933
FR;3;2022-03-23;1;0;0;0;0;4415918;3440868;4434;2;2933
FR;3;2022-03-24;0;0;0;0;0;4415918;3440868;4434;2;2933
FR;3;2022-03-25;1;0;0;0;0;4415919;3440868;4434;2;2933
FR;3;2022-03-26;0;0;0;0;0;4415919;3440868;4434;2;2933
FR;3;2022-03-27;0;0;0;0;0;4415919;3440868;4434;2;2933
FR;3;2022-03-28;0;0;0;0;0;4415919;3440868;4434;2;2933
FR;3;2022-03-29;0;0;0;0;0;4415919;3440868;4434;2;2933
FR;3;2022-03-30;0;0;0;0;0;4415919;3440868;4434;2;2933
FR;3;2022-03-31;0;0;0;0;0;4415919;3440868;4434;2;2933
FR;3;2022-04-01;0;0;0;0;0;4415919;3440868;4434;2;2933
FR;3;2022-04-02;0;0;0;0;0;4415919;3440868;4434;2;2933
FR;3;2022-04-03;0;0;0;0;0;4415919;3440868;4434;2;2933
FR;3;2022-04-04;0;0;0;0;0;4415919;3440868;4434;2;2933
FR;3;2022-04-05;0;0;0;0;0;4415919;3440868;4434;2;2933
FR;3;2022-04-06;0;0;0;0;0;4415919;3440868;4434;2;2933
FR;3;2022-04-07;0;0;0;0;0;4415919;3440868;4434;2;2933
FR;3;2022-04-08;0;0;0;0;0;4415919;3440868;4434;2;2933
FR;3;2022-04-09;0;0;0;0;0;4415919;3440868;4434;2;2933
FR;3;2022-04-10;0;0;0;0;0;4415919;3440868;4434;2;2933
FR;3;2022-04-11;0;0;0;0;0;4415919;3440868;4434;2;2933
FR;3;2022-04-12;0;0;0;0;0;4415919;3440868;4434;2;2933
FR;3;2022-04-13;0;0;0;0;0;4415919;3440868;4434;2;2933
FR;3;2022-04-14;0;0;0;0;0;4415919;3440868;4434;2;2933
FR;3;2022-04-15;1;0;0;0;0;4415920;3440868;4434;2;2933
FR;3;2022-04-16;0;0;0;0;0;4415920;3440868;4434;2;2933
FR;3;2022-04-17;0;0;0;0;0;4415920;3440868;4434;2;2933
FR;3;2022-04-18;0;0;0;0;0;4415920;3440868;4434;2;2933
FR;3;2022-04-19;0;0;0;0;0;4415920;3440868;4434;2;2933
FR;3;2022-04-20;0;0;0;0;0;4415920;3440868;4434;2;2933
FR;3;2022-04-21;0;0;0;0;0;4415920;3440868;4434;2;2933
FR;3;2022-04-22;0;0;0;0;0;4415920;3440868;4434;2;2933
FR;3;2022-04-23;0;0;0;0;0;4415920;3440868;4434;2;2933
FR;3;2022-04-24;0;0;0;0;0;4415920;3440868;4434;2;2933
FR;3;2022-04-25;0;0;0;0;0;4415920;3440868;4434;2;2933
FR;3;2022-04-26;0;0;0;0;0;4415920;3440868;4434;2;2933
FR;3;2022-04-27;0;0;0;0;0;4415920;3440868;4434;2;2933
FR;3;2022-04-28;0;0;0;0;0;4415920;3440868;4434;2;2933
FR;3;2022-04-29;0;0;0;0;0;4415920;3440868;4434;2;2933
FR;3;2022-04-30;0;0;0;0;0;4415920;3440868;4434;2;2933
FR;3;2022-05-01;0;0;0;0;0;4415920;3440868;4434;2;2933
FR;3;2022-05-02;0;0;0;0;0;4415920;3440868;4434;2;2933
FR;3;2022-05-03;0;0;0;0;0;4415920;3440868;4434;2;2933
FR;3;2022-05-04;0;0;0;0;0;4415920;3440868;4434;2;2933
FR;3;2022-05-05;0;0;0;0;0;4415920;3440868;4434;2;2933
FR;3;2022-05-06;0;0;0;0;0;4415920;3440868;4434;2;2933
FR;3;2022-05-07;0;0;0;0;0;4415920;3440868;4434;2;2933
FR;3;2022-05-08;0;0;0;0;0;4415920;3440868;4434;2;2933
FR;3;2022-05-09;0;0;0;0;0;4415920;3440868;4434;2;2933
FR;3;2022-05-10;0;0;0;0;0;4415920;3440868;4434;2;2933
FR;3;2022-05-11;0;0;0;0;0;4415920;3440868;4434;2;2933
FR;3;2022-05-12;0;0;0;0;0;4415920;3440868;4434;2;2933
FR;3;2022-05-13;0;0;0;0;0;4415920;3440868;4434;2;2933
FR;3;2022-05-14;1;0;0;0;0;4415921;3440868;4434;2;2933
FR;3;2022-05-15;0;0;0;0;0;4415921;3440868;4434;2;2933
FR;3;2022-05-16;0;0;0;0;0;4415921;3440868;4434;2;2933
FR;3;2022-05-17;0;0;0;0;0;4415921;3440868;4434;2;2933
FR;3;2022-05-18;0;0;0;0;0;4415921;3440868;4434;2;2933
FR;3;2022-05-19;0;0;0;0;0;4415921;3440868;4434;2;2933
FR;3;2022-05-20;0;0;0;0;0;4415921;3440868;4434;2;2933
FR;3;2022-05-21;0;0;0;0;0;4415921;3440868;4434;2;2933
FR;3;2022-05-22;0;0;0;0;0;4415921;3440868;4434;2;2933
FR;3;2022-05-23;0;0;0;0;0;4415921;3440868;4434;2;2933
FR;3;2022-05-24;0;0;0;0;0;4415921;3440868;4434;2;2933
FR;3;2022-05-25;0;0;0;0;0;4415921;3440868;4434;2;2933
FR;3;2022-05-26;0;0;0;0;0;4415921;3440868;4434;2;2933
FR;3;2022-05-27;0;0;0;0;0;4415921;3440868;4434;2;2933
FR;3;2022-05-28;0;0;0;0;0;4415921;3440868;4434;2;2933
FR;3;2022-05-29;0;0;0;0;0;4415921;3440868;4434;2;2933
FR;3;2022-05-30;0;0;0;0;0;4415921;3440868;4434;2;2933
FR;3;2022-05-31;0;0;0;0;0;4415921;3440868;4434;2;2933
FR;3;2022-06-01;0;0;0;0;0;4415921;3440868;4434;2;2933
FR;3;2022-06-02;0;0;0;0;0;4415921;3440868;4434;2;2933
FR;3;2022-06-03;0;0;0;0;0;4415921;3440868;4434;2;2933
FR;3;2022-06-04;0;0;0;0;0;4415921;3440868;4434;2;2933
FR;3;2022-06-05;0;0;0;0;0;4415921;3440868;4434;2;2933
FR;3;2022-06-06;0;0;0;0;0;4415921;3440868;4434;2;2933
FR;3;2022-06-07;0;0;0;0;0;4415921;3440868;4434;2;2933
FR;3;2022-06-08;0;0;0;0;0;4415921;3440868;4434;2;2933
FR;3;2022-06-09;0;0;0;0;0;4415921;3440868;4434;2;2933
FR;3;2022-06-10;0;0;0;0;0;4415921;3440868;4434;2;2933
FR;3;2022-06-11;0;0;0;0;0;4415921;3440868;4434;2;2933
FR;3;2022-06-12;0;0;0;0;0;4415921;3440868;4434;2;2933
FR;3;2022-06-13;1;0;0;0;0;4415922;3440868;4434;2;2933
FR;3;2022-06-14;0;0;0;0;0;4415922;3440868;4434;2;2933
FR;3;2022-06-15;0;0;0;0;0;4415922;3440868;4434;2;2933
FR;3;2022-06-16;0;0;0;0;0;4415922;3440868;4434;2;2933
FR;3;2022-06-17;0;0;0;0;0;4415922;3440868;4434;2;2933
FR;3;2022-06-18;0;0;0;0;0;4415922;3440868;4434;2;2933
FR;3;2022-06-19;0;0;0;0;0;4415922;3440868;4434;2;2933
FR;3;2022-06-20;0;0;0;0;0;4415922;3440868;4434;2;2933
FR;3;2022-06-21;0;0;0;0;0;4415922;3440868;4434;2;2933
FR;3;2022-06-22;0;0;0;0;0;4415922;3440868;4434;2;2933
FR;3;2022-06-23;0;0;0;0;0;4415922;3440868;4434;2;2933
FR;3;2022-06-24;0;0;0;0;0;4415922;3440868;4434;2;2933
FR;3;2022-06-25;0;0;0;0;0;4415922;3440868;4434;2;2933
FR;3;2022-06-26;0;0;0;0;0;4415922;3440868;4434;2;2933
FR;3;2022-06-27;0;0;0;0;0;4415922;3440868;4434;2;2933
FR;3;2022-06-28;0;0;0;0;0;4415922;3440868;4434;2;2933
FR;3;2022-06-29;1;0;0;0;0;4415923;3440868;4434;2;2933
FR;3;2022-06-30;0;0;0;0;0;4415923;3440868;4434;2;2933
FR;3;2022-07-01;0;0;0;0;0;4415923;3440868;4434;2;2933
FR;3;2022-07-02;0;0;0;0;0;4415923;3440868;4434;2;2933
FR;3;2022-07-03;0;0;0;0;0;4415923;3440868;4434;2;2933
FR;3;2022-07-04;0;0;0;0;0;4415923;3440868;4434;2;2933
FR;3;2022-07-05;0;0;0;0;0;4415923;3440868;4434;2;2933
FR;3;2022-07-06;0;0;0;0;0;4415923;3440868;4434;2;2933
FR;3;2022-07-07;0;0;0;0;0;4415923;3440868;4434;2;2933
FR;3;2022-07-08;0;0;0;0;0;4415923;3440868;4434;2;2933
FR;3;2022-07-09;0;0;0;0;0;4415923;3440868;4434;2;2933
FR;3;2022-07-10;0;0;0;0;0;4415923;3440868;4434;2;2933
FR;3;2022-07-11;0;0;0;0;0;4415923;3440868;4434;2;2933
FR;3;2022-07-12;0;0;0;0;0;4415923;3440868;4434;2;2933
FR;3;2022-07-13;0;0;0;0;0;4415923;3440868;4434;2;2933
FR;3;2022-07-14;0;0;0;0;0;4415923;3440868;4434;2;2933
FR;3;2022-07-15;0;0;0;0;0;4415923;3440868;4434;2;2933
FR;3;2022-07-16;0;0;0;0;0;4415923;3440868;4434;2;2933
FR;3;2022-07-17;0;0;0;0;0;4415923;3440868;4434;2;2933
FR;3;2022-07-18;0;0;0;0;0;4415923;3440868;4434;2;2933
FR;3;2022-07-19;0;0;0;0;0;4415923;3440868;4434;2;2933
FR;3;2022-07-20;0;0;0;0;0;4415923;3440868;4434;2;2933
FR;3;2022-07-21;0;0;0;0;0;4415923;3440868;4434;2;2933
FR;3;2022-07-22;0;0;0;0;0;4415923;3440868;4434;2;2933
FR;3;2022-07-23;0;0;0;0;0;4415923;3440868;4434;2;2933
FR;3;2022-07-24;0;0;0;0;0;4415923;3440868;4434;2;2933
FR;3;2022-07-25;0;0;0;0;0;4415923;3440868;4434;2;2933
FR;3;2022-07-26;0;0;0;0;0;4415923;3440868;4434;2;2933
FR;3;2022-07-27;0;0;0;0;0;4415923;3440868;4434;2;2933
FR;3;2022-07-28;0;0;0;0;0;4415923;3440868;4434;2;2933
FR;3;2022-07-29;0;0;0;0;0;4415923;3440868;4434;2;2933
FR;3;2022-07-30;0;0;0;0;0;4415923;3440868;4434;2;2933
FR;3;2022-07-31;0;0;0;0;0;4415923;3440868;4434;2;2933
FR;3;2022-08-01;0;0;0;0;0;4415923;3440868;4434;2;2933
FR;3;2022-08-02;0;0;0;0;0;4415923;3440868;4434;2;2933
FR;3;2022-08-03;0;0;0;0;0;4415923;3440868;4434;2;2933
FR;3;2022-08-04;0;0;0;0;0;4415923;3440868;4434;2;2933
FR;3;2022-08-05;0;0;0;0;0;4415923;3440868;4434;2;2933
FR;3;2022-08-06;0;0;0;0;0;4415923;3440868;4434;2;2933
FR;3;2022-08-07;0;0;0;0;0;4415923;3440868;4434;2;2933
FR;3;2022-08-08;0;0;0;0;0;4415923;3440868;4434;2;2933
FR;3;2022-08-09;0;0;0;0;0;4415923;3440868;4434;2;2933
FR;4;2020-12-27;0;0;0;0;0;0;0;0;0;0
FR;4;2020-12-28;0;0;0;0;0;0;0;0;0;0
FR;4;2020-12-29;0;0;0;0;0;0;0;0;0;0
FR;4;2020-12-30;0;0;0;0;0;0;0;0;0;0
FR;4;2020-12-31;0;0;0;0;0;0;0;0;0;0
FR;4;2021-01-01;0;0;0;0;0;0;0;0;0;0
FR;4;2021-01-02;0;0;0;0;0;0;0;0;0;0
FR;4;2021-01-03;0;0;0;0;0;0;0;0;0;0
FR;4;2021-01-04;0;0;0;0;0;0;0;0;0;0
FR;4;2021-01-05;0;0;0;0;0;0;0;0;0;0
FR;4;2021-01-06;0;0;0;0;0;0;0;0;0;0
FR;4;2021-01-07;0;0;0;0;0;0;0;0;0;0
FR;4;2021-01-08;0;0;0;0;0;0;0;0;0;0
FR;4;2021-01-09;0;0;0;0;0;0;0;0;0;0
FR;4;2021-01-10;0;0;0;0;0;0;0;0;0;0
FR;4;2021-01-11;0;0;0;0;0;0;0;0;0;0
FR;4;2021-01-12;0;0;0;0;0;0;0;0;0;0
FR;4;2021-01-13;0;0;0;0;0;0;0;0;0;0
FR;4;2021-01-14;0;0;0;0;0;0;0;0;0;0
FR;4;2021-01-15;0;0;0;0;0;0;0;0;0;0
FR;4;2021-01-16;0;0;0;0;0;0;0;0;0;0
FR;4;2021-01-17;0;0;0;0;0;0;0;0;0;0
FR;4;2021-01-18;0;0;0;0;0;0;0;0;0;0
FR;4;2021-01-19;0;0;0;0;0;0;0;0;0;0
FR;4;2021-01-20;0;0;0;0;0;0;0;0;0;0
FR;4;2021-01-21;0;0;0;0;0;0;0;0;0;0
FR;4;2021-01-22;0;0;0;0;0;0;0;0;0;0
FR;4;2021-01-23;0;0;0;0;0;0;0;0;0;0
FR;4;2021-01-24;0;0;0;0;0;0;0;0;0;0
FR;4;2021-01-25;0;0;0;0;0;0;0;0;0;0
FR;4;2021-01-26;0;0;0;0;0;0;0;0;0;0
FR;4;2021-01-27;0;0;0;0;0;0;0;0;0;0
FR;4;2021-01-28;0;0;0;0;0;0;0;0;0;0
FR;4;2021-01-29;0;0;0;0;0;0;0;0;0;0
FR;4;2021-01-30;0;0;0;0;0;0;0;0;0;0
FR;4;2021-01-31;0;0;0;0;0;0;0;0;0;0
FR;4;2021-02-01;0;0;0;0;0;0;0;0;0;0
FR;4;2021-02-02;0;0;0;0;0;0;0;0;0;0
FR;4;2021-02-03;0;0;0;0;0;0;0;0;0;0
FR;4;2021-02-04;0;0;0;0;0;0;0;0;0;0
FR;4;2021-02-05;0;0;0;0;0;0;0;0;0;0
FR;4;2021-02-06;0;0;0;0;0;0;0;0;0;0
FR;4;2021-02-07;0;0;0;0;0;0;0;0;0;0
FR;4;2021-02-08;0;0;0;0;0;0;0;0;0;0
FR;4;2021-02-09;0;0;0;0;0;0;0;0;0;0
FR;4;2021-02-10;0;0;0;0;0;0;0;0;0;0
FR;4;2021-02-11;0;0;0;0;0;0;0;0;0;0
FR;4;2021-02-12;0;0;0;0;0;0;0;0;0;0
FR;4;2021-02-13;0;0;0;0;0;0;0;0;0;0
FR;4;2021-02-14;0;0;0;0;0;0;0;0;0;0
FR;4;2021-02-15;0;0;0;0;0;0;0;0;0;0
FR;4;2021-02-16;0;0;0;0;0;0;0;0;0;0
FR;4;2021-02-17;0;0;0;0;0;0;0;0;0;0
FR;4;2021-02-18;0;0;0;0;0;0;0;0;0;0
FR;4;2021-02-19;0;0;0;0;0;0;0;0;0;0
FR;4;2021-02-20;0;0;0;0;0;0;0;0;0;0
FR;4;2021-02-21;0;0;0;0;0;0;0;0;0;0
FR;4;2021-02-22;0;0;0;0;0;0;0;0;0;0
FR;4;2021-02-23;0;0;0;0;0;0;0;0;0;0
FR;4;2021-02-24;0;0;0;0;0;0;0;0;0;0
FR;4;2021-02-25;0;0;0;0;0;0;0;0;0;0
FR;4;2021-02-26;0;0;0;0;0;0;0;0;0;0
FR;4;2021-02-27;0;0;0;0;0;0;0;0;0;0
FR;4;2021-02-28;0;0;0;0;0;0;0;0;0;0
FR;4;2021-03-01;0;0;0;0;0;0;0;0;0;0
FR;4;2021-03-02;0;0;0;0;0;0;0;0;0;0
FR;4;2021-03-03;0;0;0;0;0;0;0;0;0;0
FR;4;2021-03-04;0;0;0;0;0;0;0;0;0;0
FR;4;2021-03-05;0;0;0;0;0;0;0;0;0;0
FR;4;2021-03-06;0;0;0;0;0;0;0;0;0;0
FR;4;2021-03-07;0;0;0;0;0;0;0;0;0;0
FR;4;2021-03-08;0;0;0;0;0;0;0;0;0;0
FR;4;2021-03-09;0;0;0;0;0;0;0;0;0;0
FR;4;2021-03-10;0;0;0;0;0;0;0;0;0;0
FR;4;2021-03-11;0;0;0;0;0;0;0;0;0;0
FR;4;2021-03-12;0;0;0;0;0;0;0;0;0;0
FR;4;2021-03-13;0;0;0;0;0;0;0;0;0;0
FR;4;2021-03-14;0;0;0;0;0;0;0;0;0;0
FR;4;2021-03-15;0;0;0;0;0;0;0;0;0;0
FR;4;2021-03-16;0;0;0;0;0;0;0;0;0;0
FR;4;2021-03-17;0;0;0;0;0;0;0;0;0;0
FR;4;2021-03-18;0;0;0;0;0;0;0;0;0;0
FR;4;2021-03-19;0;0;0;0;0;0;0;0;0;0
FR;4;2021-03-20;0;0;0;0;0;0;0;0;0;0
FR;4;2021-03-21;0;0;0;0;0;0;0;0;0;0
FR;4;2021-03-22;0;0;0;0;0;0;0;0;0;0
FR;4;2021-03-23;0;0;0;0;0;0;0;0;0;0
FR;4;2021-03-24;0;0;0;0;0;0;0;0;0;0
FR;4;2021-03-25;0;0;0;0;0;0;0;0;0;0
FR;4;2021-03-26;0;0;0;0;0;0;0;0;0;0
FR;4;2021-03-27;0;0;0;0;0;0;0;0;0;0
FR;4;2021-03-28;0;0;0;0;0;0;0;0;0;0
FR;4;2021-03-29;0;0;0;0;0;0;0;0;0;0
FR;4;2021-03-30;0;0;0;0;0;0;0;0;0;0
FR;4;2021-03-31;0;0;0;0;0;0;0;0;0;0
FR;4;2021-04-01;0;0;0;0;0;0;0;0;0;0
FR;4;2021-04-02;0;0;0;0;0;0;0;0;0;0
FR;4;2021-04-03;0;0;0;0;0;0;0;0;0;0
FR;4;2021-04-04;0;0;0;0;0;0;0;0;0;0
FR;4;2021-04-05;0;0;0;0;0;0;0;0;0;0
FR;4;2021-04-06;0;0;0;0;0;0;0;0;0;0
FR;4;2021-04-07;0;0;0;0;0;0;0;0;0;0
FR;4;2021-04-08;0;0;0;0;0;0;0;0;0;0
FR;4;2021-04-09;0;0;0;0;0;0;0;0;0;0
FR;4;2021-04-10;0;0;0;0;0;0;0;0;0;0
FR;4;2021-04-11;0;0;0;0;0;0;0;0;0;0
FR;4;2021-04-12;0;0;0;0;0;0;0;0;0;0
FR;4;2021-04-13;0;0;0;0;0;0;0;0;0;0
FR;4;2021-04-14;0;0;0;0;0;0;0;0;0;0
FR;4;2021-04-15;0;0;0;0;0;0;0;0;0;0
FR;4;2021-04-16;0;0;0;0;0;0;0;0;0;0
FR;4;2021-04-17;0;0;0;0;0;0;0;0;0;0
FR;4;2021-04-18;0;0;0;0;0;0;0;0;0;0
FR;4;2021-04-19;0;0;0;0;0;0;0;0;0;0
FR;4;2021-04-20;0;0;0;0;0;0;0;0;0;0
FR;4;2021-04-21;0;0;0;0;0;0;0;0;0;0
FR;4;2021-04-22;0;0;0;0;0;0;0;0;0;0
FR;4;2021-04-23;3867;0;0;0;0;3867;0;0;0;0
FR;4;2021-04-24;1569;0;0;0;0;5436;0;0;0;0
FR;4;2021-04-25;125;0;0;0;0;5561;0;0;0;0
FR;4;2021-04-26;2869;1;0;0;0;8430;1;0;0;0
FR;4;2021-04-27;9520;3;0;0;0;17950;4;0;0;0
FR;4;2021-04-28;9906;6;0;0;0;27856;10;0;0;0
FR;4;2021-04-29;15992;8;0;0;0;43848;18;0;0;0
FR;4;2021-04-30;19232;10;0;0;0;63080;28;0;0;0
FR;4;2021-05-01;1994;6;0;0;0;65074;34;0;0;0
FR;4;2021-05-02;483;0;0;0;0;65557;34;0;0;0
FR;4;2021-05-03;5064;2;0;0;0;70621;36;0;0;0
FR;4;2021-05-04;8401;11;0;0;0;79022;47;0;0;0
FR;4;2021-05-05;6188;7;0;0;0;85210;54;0;0;0
FR;4;2021-05-06;11381;11;0;0;0;96591;65;0;0;0
FR;4;2021-05-07;19125;9;0;0;0;115716;74;0;0;0
FR;4;2021-05-08;2378;6;0;0;0;118094;80;0;0;0
FR;4;2021-05-09;686;3;0;0;0;118780;83;0;0;0
FR;4;2021-05-10;7241;5;1;0;0;126021;88;1;0;0
FR;4;2021-05-11;14318;12;0;0;0;140339;100;1;0;0
FR;4;2021-05-12;10170;15;0;0;0;150509;115;1;0;0
FR;4;2021-05-13;1583;3;0;0;0;152092;118;1;0;0
FR;4;2021-05-14;7766;7;0;0;0;159858;125;1;0;0
FR;4;2021-05-15;3718;8;1;0;0;163576;133;2;0;0
FR;4;2021-05-16;417;1;0;0;0;163993;134;2;0;0
FR;4;2021-05-17;4477;6;0;0;0;168470;140;2;0;0
FR;4;2021-05-18;8759;10;0;0;0;177229;150;2;0;0
FR;4;2021-05-19;5693;7;0;0;0;182922;157;2;0;0
FR;4;2021-05-20;9482;7;0;0;0;192404;164;2;0;0
FR;4;2021-05-21;12800;30;0;0;0;205204;194;2;0;0
FR;4;2021-05-22;5056;15;0;0;0;210260;209;2;0;0
FR;4;2021-05-23;494;4;0;0;0;210754;213;2;0;0
FR;4;2021-05-24;1058;7;0;0;0;211812;220;2;0;0
FR;4;2021-05-25;7626;16;0;0;0;219438;236;2;0;0
FR;4;2021-05-26;7727;16;0;0;0;227165;252;2;0;0
FR;4;2021-05-27;14332;35;0;0;0;241497;287;2;0;0
FR;4;2021-05-28;26588;82;1;0;0;268085;369;3;0;0
FR;4;2021-05-29;11385;18;0;0;0;279470;387;3;0;0
FR;4;2021-05-30;973;6;0;0;0;280443;393;3;0;0
FR;4;2021-05-31;12691;21;0;0;0;293134;414;3;0;0
FR;4;2021-06-01;20259;47;1;0;0;313393;461;4;0;0
FR;4;2021-06-02;14521;33;0;0;0;327914;494;4;0;0
FR;4;2021-06-03;19425;24;1;0;0;347339;518;5;0;0
FR;4;2021-06-04;22514;47;0;0;0;369853;565;5;0;0
FR;4;2021-06-05;9713;32;0;0;0;379566;597;5;0;0
FR;4;2021-06-06;1039;1;0;0;0;380605;598;5;0;0
FR;4;2021-06-07;9226;19;0;0;0;389831;617;5;0;0
FR;4;2021-06-08;14612;31;0;0;0;404443;648;5;0;0
FR;4;2021-06-09;12205;25;0;0;0;416648;673;5;0;0
FR;4;2021-06-10;15403;30;0;0;0;432051;703;5;0;0
FR;4;2021-06-11;16982;56;0;0;0;449033;759;5;0;0
FR;4;2021-06-12;7448;27;0;0;0;456481;786;5;0;0
FR;4;2021-06-13;907;3;0;0;0;457388;789;5;0;0
FR;4;2021-06-14;6649;26;0;0;0;464037;815;5;0;0
FR;4;2021-06-15;10887;37;0;0;0;474924;852;5;0;0
FR;4;2021-06-16;8908;16;0;0;0;483832;868;5;0;0
FR;4;2021-06-17;10897;37;0;0;0;494729;905;5;0;0
FR;4;2021-06-18;12420;45;0;0;0;507149;950;5;0;0
FR;4;2021-06-19;5567;25;0;0;0;512716;975;5;0;0
FR;4;2021-06-20;821;5;0;0;0;513537;980;5;0;0
FR;4;2021-06-21;5097;20;0;0;0;518634;1000;5;0;0
FR;4;2021-06-22;7908;28;2;0;0;526542;1028;7;0;0
FR;4;2021-06-23;7098;41;2;0;0;533640;1069;9;0;0
FR;4;2021-06-24;8649;46;1;0;0;542289;1115;10;0;0
FR;4;2021-06-25;10171;40;2;0;0;552460;1155;12;0;0
FR;4;2021-06-26;4845;21;0;0;0;557305;1176;12;0;0
FR;4;2021-06-27;764;4;0;0;0;558069;1180;12;0;0
FR;4;2021-06-28;4827;16;1;0;0;562896;1196;13;0;0
FR;4;2021-06-29;7103;28;2;0;0;569999;1224;15;0;0
FR;4;2021-06-30;6719;39;2;0;0;576718;1263;17;0;0
FR;4;2021-07-01;8201;41;0;0;0;584919;1304;17;0;0
FR;4;2021-07-02;9421;52;1;0;0;594340;1356;18;0;0
FR;4;2021-07-03;4846;20;0;0;0;599186;1376;18;0;0
FR;4;2021-07-04;687;5;0;0;0;599873;1381;18;0;0
FR;4;2021-07-05;4771;19;2;0;0;604644;1400;20;0;0
FR;4;2021-07-06;7725;28;4;0;0;612369;1428;24;0;0
FR;4;2021-07-07;7077;34;2;0;0;619446;1462;26;0;0
FR;4;2021-07-08;9228;40;2;0;0;628674;1502;28;0;0
FR;4;2021-07-09;10279;34;1;0;0;638953;1536;29;0;0
FR;4;2021-07-10;4636;14;2;0;0;643589;1550;31;0;0
FR;4;2021-07-11;583;4;1;0;0;644172;1554;32;0;0
FR;4;2021-07-12;5871;29;0;0;0;650043;1583;32;0;0
FR;4;2021-07-13;14232;29;0;0;0;664275;1612;32;0;0
FR;4;2021-07-14;2288;15;0;0;0;666563;1627;32;0;0
FR;4;2021-07-15;18235;36;0;0;0;684798;1663;32;0;0
FR;4;2021-07-16;22832;71;2;0;0;707630;1734;34;0;0
FR;4;2021-07-17;9736;20;0;0;0;717366;1754;34;0;0
FR;4;2021-07-18;1356;4;0;0;0;718722;1758;34;0;0
FR;4;2021-07-19;12989;30;1;0;0;731711;1788;35;0;0
FR;4;2021-07-20;17341;26;1;0;0;749052;1814;36;0;0
FR;4;2021-07-21;15614;33;0;0;0;764666;1847;36;0;0
FR;4;2021-07-22;18242;44;2;0;0;782908;1891;38;0;0
FR;4;2021-07-23;20413;57;7;0;0;803321;1948;45;0;0
FR;4;2021-07-24;9290;32;0;0;0;812611;1980;45;0;0
FR;4;2021-07-25;1353;8;0;0;0;813964;1988;45;0;0
FR;4;2021-07-26;11039;22;0;0;0;825003;2010;45;0;0
FR;4;2021-07-27;14676;35;3;0;0;839679;2045;48;0;0
FR;4;2021-07-28;12928;26;2;0;0;852607;2071;50;0;0
FR;4;2021-07-29;14086;54;4;0;0;866693;2125;54;0;0
FR;4;2021-07-30;15495;46;2;0;0;882188;2171;56;0;0
FR;4;2021-07-31;6840;14;2;0;0;889028;2185;58;0;0
FR;4;2021-08-01;904;1;0;0;0;889932;2186;58;0;0
FR;4;2021-08-02;7915;30;0;0;0;897847;2216;58;0;0
FR;4;2021-08-03;10795;31;2;0;0;908642;2247;60;0;0
FR;4;2021-08-04;9740;29;0;0;0;918382;2276;60;0;0
FR;4;2021-08-05;9820;41;0;0;0;928202;2317;60;0;0
FR;4;2021-08-06;10196;31;3;0;0;938398;2348;63;0;0
FR;4;2021-08-07;5097;30;1;0;0;943495;2378;64;0;0
FR;4;2021-08-08;1219;13;0;0;0;944714;2391;64;0;0
FR;4;2021-08-09;6338;31;0;0;0;951052;2422;64;0;0
FR;4;2021-08-10;8746;18;0;0;0;959798;2440;64;0;0
FR;4;2021-08-11;7940;34;4;0;0;967738;2474;68;0;0
FR;4;2021-08-12;8585;30;1;0;0;976323;2504;69;0;0
FR;4;2021-08-13;7555;25;0;1;0;983878;2529;69;1;0
FR;4;2021-08-14;3791;20;0;0;0;987669;2549;69;1;0
FR;4;2021-08-15;769;5;0;0;0;988438;2554;69;1;0
FR;4;2021-08-16;4006;17;0;0;0;992444;2571;69;1;0
FR;4;2021-08-17;5626;17;1;0;0;998070;2588;70;1;0
FR;4;2021-08-18;5166;37;0;0;0;1003236;2625;70;1;0
FR;4;2021-08-19;5483;33;3;0;0;1008719;2658;73;1;0
FR;4;2021-08-20;5218;25;1;0;0;1013937;2683;74;1;0
FR;4;2021-08-21;2309;21;1;0;0;1016246;2704;75;1;0
FR;4;2021-08-22;405;2;0;0;0;1016651;2706;75;1;0
FR;4;2021-08-23;2930;19;1;0;0;1019581;2725;76;1;0
FR;4;2021-08-24;3754;15;0;0;0;1023335;2740;76;1;0
FR;4;2021-08-25;3541;25;1;0;0;1026876;2765;77;1;0
FR;4;2021-08-26;3711;20;2;0;0;1030587;2785;79;1;0
FR;4;2021-08-27;3614;31;2;0;0;1034201;2816;81;1;0
FR;4;2021-08-28;1725;10;1;0;0;1035926;2826;82;1;0
FR;4;2021-08-29;387;7;1;0;0;1036313;2833;83;1;0
FR;4;2021-08-30;2009;25;0;0;15;1038322;2858;83;1;15
FR;4;2021-08-31;2484;21;0;0;14;1040806;2879;83;1;29
FR;4;2021-09-01;2083;38;1;0;21;1042889;2917;84;1;50
FR;4;2021-09-02;2303;31;4;0;18;1045192;2948;88;1;68
FR;4;2021-09-03;2362;44;5;0;36;1047554;2992;93;1;104
FR;4;2021-09-04;1374;17;0;0;8;1048928;3009;93;1;112
FR;4;2021-09-05;432;2;0;0;2;1049360;3011;93;1;114
FR;4;2021-09-06;1711;61;0;0;22;1051071;3072;93;1;136
FR;4;2021-09-07;1676;18;1;0;9;1052747;3090;94;1;145
FR;4;2021-09-08;1285;26;3;0;19;1054032;3116;97;1;164
FR;4;2021-09-09;1387;23;2;0;9;1055419;3139;99;1;173
FR;4;2021-09-10;1521;31;2;0;23;1056940;3170;101;1;196
FR;4;2021-09-11;743;11;0;0;3;1057683;3181;101;1;199
FR;4;2021-09-12;169;4;0;0;3;1057852;3185;101;1;202
FR;4;2021-09-13;1320;22;1;0;16;1059172;3207;102;1;218
FR;4;2021-09-14;1501;9;2;0;6;1060673;3216;104;1;224
FR;4;2021-09-15;1095;27;1;0;24;1061768;3243;105;1;248
FR;4;2021-09-16;1102;22;2;0;15;1062870;3265;107;1;263
FR;4;2021-09-17;894;21;1;0;12;1063764;3286;108;1;275
FR;4;2021-09-18;464;6;1;0;5;1064228;3292;109;1;280
FR;4;2021-09-19;182;3;0;0;2;1064410;3295;109;1;282
FR;4;2021-09-20;453;19;0;0;13;1064863;3314;109;1;295
FR;4;2021-09-21;428;11;0;0;7;1065291;3325;109;1;302
FR;4;2021-09-22;374;19;2;0;13;1065665;3344;111;1;315
FR;4;2021-09-23;482;16;1;0;15;1066147;3360;112;1;330
FR;4;2021-09-24;412;13;2;0;9;1066559;3373;114;1;339
FR;4;2021-09-25;280;10;1;0;5;1066839;3383;115;1;344
FR;4;2021-09-26;74;2;0;0;1;1066913;3385;115;1;345
FR;4;2021-09-27;262;10;1;0;8;1067175;3395;116;1;353
FR;4;2021-09-28;317;8;0;0;8;1067492;3403;116;1;361
FR;4;2021-09-29;374;18;1;0;12;1067866;3421;117;1;373
FR;4;2021-09-30;364;40;0;0;21;1068230;3461;117;1;394
FR;4;2021-10-01;411;54;0;0;48;1068641;3515;117;1;442
FR;4;2021-10-02;196;22;1;0;13;1068837;3537;118;1;455
FR;4;2021-10-03;85;1;0;0;0;1068922;3538;118;1;455
FR;4;2021-10-04;361;20;1;0;16;1069283;3558;119;1;471
FR;4;2021-10-05;283;19;2;0;15;1069566;3577;121;1;486
FR;4;2021-10-06;246;22;1;0;18;1069812;3599;122;1;504
FR;4;2021-10-07;263;25;2;0;13;1070075;3624;124;1;517
FR;4;2021-10-08;354;24;2;0;20;1070429;3648;126;1;537
FR;4;2021-10-09;193;6;6;0;7;1070622;3654;132;1;544
FR;4;2021-10-10;95;3;2;0;3;1070717;3657;134;1;547
FR;4;2021-10-11;248;15;1;0;14;1070965;3672;135;1;561
FR;4;2021-10-12;207;14;0;0;13;1071172;3686;135;1;574
FR;4;2021-10-13;219;28;1;0;25;1071391;3714;136;1;599
FR;4;2021-10-14;311;21;4;0;15;1071702;3735;140;1;614
FR;4;2021-10-15;322;24;5;0;25;1072024;3759;145;1;639
FR;4;2021-10-16;166;6;2;0;6;1072190;3765;147;1;645
FR;4;2021-10-17;70;2;0;0;1;1072260;3767;147;1;646
FR;4;2021-10-18;280;15;1;0;12;1072540;3782;148;1;658
FR;4;2021-10-19;214;14;2;0;15;1072754;3796;150;1;673
FR;4;2021-10-20;228;27;4;0;15;1072982;3823;154;1;688
FR;4;2021-10-21;242;17;0;0;13;1073224;3840;154;1;701
FR;4;2021-10-22;215;25;2;0;20;1073439;3865;156;1;721
FR;4;2021-10-23;116;16;1;0;15;1073555;3881;157;1;736
FR;4;2021-10-24;38;4;0;0;1;1073593;3885;157;1;737
FR;4;2021-10-25;213;7;2;0;9;1073806;3892;159;1;746
FR;4;2021-10-26;196;14;0;0;12;1074002;3906;159;1;758
FR;4;2021-10-27;195;11;4;0;11;1074197;3917;163;1;769
FR;4;2021-10-28;183;18;4;0;21;1074380;3935;167;1;790
FR;4;2021-10-29;222;15;2;0;13;1074602;3950;169;1;803
FR;4;2021-10-30;102;2;1;0;2;1074704;3952;170;1;805
FR;4;2021-10-31;56;3;2;0;3;1074760;3955;172;1;808
FR;4;2021-11-01;75;27;4;0;24;1074835;3982;176;1;832
FR;4;2021-11-02;159;20;2;0;21;1074994;4002;178;1;853
FR;4;2021-11-03;129;20;8;1;18;1075123;4022;186;2;871
FR;4;2021-11-04;182;15;1;0;12;1075305;4037;187;2;883
FR;4;2021-11-05;130;17;1;0;16;1075435;4054;188;2;899
FR;4;2021-11-06;79;6;1;0;6;1075514;4060;189;2;905
FR;4;2021-11-07;80;2;2;0;4;1075594;4062;191;2;909
FR;4;2021-11-08;159;20;1;0;20;1075753;4082;192;2;929
FR;4;2021-11-09;156;14;3;0;16;1075909;4096;195;2;945
FR;4;2021-11-10;117;29;6;0;31;1076026;4125;201;2;976
FR;4;2021-11-11;95;10;0;0;10;1076121;4135;201;2;986
FR;4;2021-11-12;103;19;2;0;18;1076224;4154;203;2;1004
FR;4;2021-11-13;74;15;2;0;14;1076298;4169;205;2;1018
FR;4;2021-11-14;54;5;4;0;8;1076352;4174;209;2;1026
FR;4;2021-11-15;98;26;2;0;24;1076450;4200;211;2;1050
FR;4;2021-11-16;105;13;2;0;15;1076555;4213;213;2;1065
FR;4;2021-11-17;119;30;4;0;30;1076674;4243;217;2;1095
FR;4;2021-11-18;100;34;13;0;42;1076774;4277;230;2;1137
FR;4;2021-11-19;87;19;3;0;20;1076861;4296;233;2;1157
FR;4;2021-11-20;75;8;1;0;8;1076936;4304;234;2;1165
FR;4;2021-11-21;63;7;2;0;9;1076999;4311;236;2;1174
FR;4;2021-11-22;106;28;9;0;33;1077105;4339;245;2;1207
FR;4;2021-11-23;76;31;5;0;28;1077181;4370;250;2;1235
FR;4;2021-11-24;87;23;11;0;24;1077268;4393;261;2;1259
FR;4;2021-11-25;92;28;14;0;30;1077360;4421;275;2;1289
FR;4;2021-11-26;83;43;12;0;45;1077443;4464;287;2;1334
FR;4;2021-11-27;40;22;15;0;25;1077483;4486;302;2;1359
FR;4;2021-11-28;50;8;0;0;7;1077533;4494;302;2;1366
FR;4;2021-11-29;87;31;16;0;40;1077620;4525;318;2;1406
FR;4;2021-11-30;73;36;12;0;40;1077693;4561;330;2;1446
FR;4;2021-12-01;87;60;19;0;67;1077780;4621;349;2;1513
FR;4;2021-12-02;103;48;19;0;53;1077883;4669;368;2;1566
FR;4;2021-12-03;100;36;15;0;44;1077983;4705;383;2;1610
FR;4;2021-12-04;71;31;18;0;44;1078054;4736;401;2;1654
FR;4;2021-12-05;62;6;1;0;7;1078116;4742;402;2;1661
FR;4;2021-12-06;104;46;19;0;59;1078220;4788;421;2;1720
FR;4;2021-12-07;81;37;9;0;36;1078301;4825;430;2;1756
FR;4;2021-12-08;69;31;16;0;37;1078370;4856;446;2;1793
FR;4;2021-12-09;61;32;10;0;38;1078431;4888;456;2;1831
FR;4;2021-12-10;63;64;20;0;68;1078494;4952;476;2;1899
FR;4;2021-12-11;28;34;7;0;34;1078522;4986;483;2;1933
FR;4;2021-12-12;24;10;3;0;13;1078546;4996;486;2;1946
FR;4;2021-12-13;71;40;14;0;49;1078617;5036;500;2;1995
FR;4;2021-12-14;59;43;17;0;54;1078676;5079;517;2;2049
FR;4;2021-12-15;65;64;28;0;84;1078741;5143;545;2;2133
FR;4;2021-12-16;32;44;19;0;57;1078773;5187;564;2;2190
FR;4;2021-12-17;40;55;12;0;60;1078813;5242;576;2;2250
FR;4;2021-12-18;48;29;2;0;30;1078861;5271;578;2;2280
FR;4;2021-12-19;15;4;1;0;4;1078876;5275;579;2;2284
FR;4;2021-12-20;41;38;10;0;41;1078917;5313;589;2;2325
FR;4;2021-12-21;27;30;15;0;36;1078944;5343;604;2;2361
FR;4;2021-12-22;36;37;10;0;38;1078980;5380;614;2;2399
FR;4;2021-12-23;39;45;8;0;49;1079019;5425;622;2;2448
FR;4;2021-12-24;23;26;10;0;30;1079042;5451;632;2;2478
FR;4;2021-12-25;6;3;3;0;4;1079048;5454;635;2;2482
FR;4;2021-12-26;4;3;1;0;2;1079052;5457;636;2;2484
FR;4;2021-12-27;28;41;9;0;43;1079080;5498;645;2;2527
FR;4;2021-12-28;24;28;7;0;29;1079104;5526;652;2;2556
FR;4;2021-12-29;49;25;10;0;29;1079153;5551;662;2;2585
FR;4;2021-12-30;42;18;12;0;21;1079195;5569;674;2;2606
FR;4;2021-12-31;18;6;8;0;11;1079213;5575;682;2;2617
FR;4;2022-01-01;5;4;4;0;6;1079218;5579;686;2;2623
FR;4;2022-01-02;40;5;16;0;20;1079258;5584;702;2;2643
FR;4;2022-01-03;41;54;21;1;60;1079299;5638;723;3;2703
FR;4;2022-01-04;33;27;13;0;30;1079332;5665;736;3;2733
FR;4;2022-01-05;48;22;19;0;25;1079380;5687;755;3;2758
FR;4;2022-01-06;48;22;23;0;37;1079428;5709;778;3;2795
FR;4;2022-01-07;28;20;15;0;20;1079456;5729;793;3;2815
FR;4;2022-01-08;9;6;10;0;12;1079465;5735;803;3;2827
FR;4;2022-01-09;18;2;3;0;4;1079483;5737;806;3;2831
FR;4;2022-01-10;41;22;19;0;36;1079524;5759;825;3;2867
FR;4;2022-01-11;26;30;12;0;34;1079550;5789;837;3;2901
FR;4;2022-01-12;32;21;13;0;23;1079582;5810;850;3;2924
FR;4;2022-01-13;52;19;27;0;37;1079634;5829;877;3;2961
FR;4;2022-01-14;23;29;13;0;32;1079657;5858;890;3;2993
FR;4;2022-01-15;12;6;8;0;12;1079669;5864;898;3;3005
FR;4;2022-01-16;11;9;12;0;20;1079680;5873;910;3;3025
FR;4;2022-01-17;24;18;12;0;24;1079704;5891;922;3;3049
FR;4;2022-01-18;16;13;8;0;18;1079720;5904;930;3;3067
FR;4;2022-01-19;30;23;11;0;32;1079750;5927;941;3;3099
FR;4;2022-01-20;31;34;11;0;37;1079781;5961;952;3;3136
FR;4;2022-01-21;9;12;19;1;16;1079790;5973;971;4;3152
FR;4;2022-01-22;30;10;2;0;10;1079820;5983;973;4;3162
FR;4;2022-01-23;7;2;4;0;6;1079827;5985;977;4;3168
FR;4;2022-01-24;14;21;8;0;27;1079841;6006;985;4;3195
FR;4;2022-01-25;20;32;9;1;37;1079861;6038;994;5;3232
FR;4;2022-01-26;19;14;8;1;17;1079880;6052;1002;6;3249
FR;4;2022-01-27;20;18;8;0;24;1079900;6070;1010;6;3273
FR;4;2022-01-28;13;23;8;0;26;1079913;6093;1018;6;3299
FR;4;2022-01-29;17;6;5;0;10;1079930;6099;1023;6;3309
FR;4;2022-01-30;18;3;1;0;4;1079948;6102;1024;6;3313
FR;4;2022-01-31;22;27;8;0;31;1079970;6129;1032;6;3344
FR;4;2022-02-01;11;20;11;0;20;1079981;6149;1043;6;3364
FR;4;2022-02-02;17;11;11;2;17;1079998;6160;1054;8;3381
FR;4;2022-02-03;13;23;10;0;27;1080011;6183;1064;8;3408
FR;4;2022-02-04;7;5;7;0;9;1080018;6188;1071;8;3417
FR;4;2022-02-05;7;14;1;0;13;1080025;6202;1072;8;3430
FR;4;2022-02-06;6;3;2;0;4;1080031;6205;1074;8;3434
FR;4;2022-02-07;15;19;7;0;19;1080046;6224;1081;8;3453
FR;4;2022-02-08;16;20;13;1;21;1080062;6244;1094;9;3474
FR;4;2022-02-09;16;11;8;0;15;1080078;6255;1102;9;3489
FR;4;2022-02-10;19;23;9;0;24;1080097;6278;1111;9;3513
FR;4;2022-02-11;18;14;8;0;19;1080115;6292;1119;9;3532
FR;4;2022-02-12;23;6;2;0;6;1080138;6298;1121;9;3538
FR;4;2022-02-13;7;3;3;0;6;1080145;6301;1124;9;3544
FR;4;2022-02-14;19;10;9;0;15;1080164;6311;1133;9;3559
FR;4;2022-02-15;17;7;1;0;7;1080181;6318;1134;9;3566
FR;4;2022-02-16;16;9;10;0;15;1080197;6327;1144;9;3581
FR;4;2022-02-17;11;4;4;0;6;1080208;6331;1148;9;3587
FR;4;2022-02-18;17;15;7;0;20;1080225;6346;1155;9;3607
FR;4;2022-02-19;16;4;2;0;5;1080241;6350;1157;9;3612
FR;4;2022-02-20;7;3;0;0;2;1080248;6353;1157;9;3614
FR;4;2022-02-21;23;3;4;0;5;1080271;6356;1161;9;3619
FR;4;2022-02-22;8;5;10;0;10;1080279;6361;1171;9;3629
FR;4;2022-02-23;16;6;9;0;9;1080295;6367;1180;9;3638
FR;4;2022-02-24;10;5;3;0;6;1080305;6372;1183;9;3644
FR;4;2022-02-25;15;5;7;0;6;1080320;6377;1190;9;3650
FR;4;2022-02-26;26;3;0;0;3;1080346;6380;1190;9;3653
FR;4;2022-02-27;9;0;1;0;1;1080355;6380;1191;9;3654
FR;4;2022-02-28;17;3;2;0;3;1080372;6383;1193;9;3657
FR;4;2022-03-01;7;2;7;0;3;1080379;6385;1200;9;3660
FR;4;2022-03-02;13;2;4;0;5;1080392;6387;1204;9;3665
FR;4;2022-03-03;16;5;1;0;4;1080408;6392;1205;9;3669
FR;4;2022-03-04;7;7;2;1;5;1080415;6399;1207;10;3674
FR;4;2022-03-05;9;2;0;0;2;1080424;6401;1207;10;3676
FR;4;2022-03-06;4;0;1;0;1;1080428;6401;1208;10;3677
FR;4;2022-03-07;10;4;1;0;3;1080438;6405;1209;10;3680
FR;4;2022-03-08;13;3;0;0;3;1080451;6408;1209;10;3683
FR;4;2022-03-09;8;6;2;0;7;1080459;6414;1211;10;3690
FR;4;2022-03-10;5;1;5;0;2;1080464;6415;1216;10;3692
FR;4;2022-03-11;8;4;5;0;2;1080472;6419;1221;10;3694
FR;4;2022-03-12;9;2;0;0;0;1080481;6421;1221;10;3694
FR;4;2022-03-13;5;1;1;0;2;1080486;6422;1222;10;3696
FR;4;2022-03-14;4;1;1;0;2;1080490;6423;1223;10;3698
FR;4;2022-03-15;6;4;2;0;3;1080496;6427;1225;10;3701
FR;4;2022-03-16;7;3;3;0;3;1080503;6430;1228;10;3704
FR;4;2022-03-17;3;4;1;0;5;1080506;6434;1229;10;3709
FR;4;2022-03-18;9;3;0;0;3;1080515;6437;1229;10;3712
FR;4;2022-03-19;1;1;0;0;1;1080516;6438;1229;10;3713
FR;4;2022-03-20;2;0;2;0;1;1080518;6438;1231;10;3714
FR;4;2022-03-21;5;3;1;0;4;1080523;6441;1232;10;3718
FR;4;2022-03-22;3;2;2;0;3;1080526;6443;1234;10;3721
FR;4;2022-03-23;6;4;4;0;7;1080532;6447;1238;10;3728
FR;4;2022-03-24;2;6;3;1;7;1080534;6453;1241;11;3735
FR;4;2022-03-25;3;1;2;0;1;1080537;6454;1243;11;3736
FR;4;2022-03-26;5;5;0;0;5;1080542;6459;1243;11;3741
FR;4;2022-03-27;1;0;2;0;1;1080543;6459;1245;11;3742
FR;4;2022-03-28;5;1;3;0;3;1080548;6460;1248;11;3745
FR;4;2022-03-29;8;0;4;1;0;1080556;6460;1252;12;3745
FR;4;2022-03-30;3;4;0;0;4;1080559;6464;1252;12;3749
FR;4;2022-03-31;2;3;1;1;3;1080561;6467;1253;13;3752
FR;4;2022-04-01;14;2;5;0;5;1080575;6469;1258;13;3757
FR;4;2022-04-02;4;4;0;0;3;1080579;6473;1258;13;3760
FR;4;2022-04-03;0;0;0;0;0;1080579;6473;1258;13;3760
FR;4;2022-04-04;4;4;4;0;5;1080583;6477;1262;13;3765
FR;4;2022-04-05;3;3;1;1;2;1080586;6480;1263;14;3767
FR;4;2022-04-06;5;0;0;0;0;1080591;6480;1263;14;3767
FR;4;2022-04-07;3;2;3;2;5;1080594;6482;1266;16;3772
FR;4;2022-04-08;4;1;1;0;1;1080598;6483;1267;16;3773
FR;4;2022-04-09;0;0;1;1;1;1080598;6483;1268;17;3774
FR;4;2022-04-10;1;2;0;0;2;1080599;6485;1268;17;3776
FR;4;2022-04-11;3;3;4;0;5;1080602;6488;1272;17;3781
FR;4;2022-04-12;3;1;4;0;2;1080605;6489;1276;17;3783
FR;4;2022-04-13;4;7;2;0;9;1080609;6496;1278;17;3792
FR;4;2022-04-14;6;4;2;1;5;1080615;6500;1280;18;3797
FR;4;2022-04-15;5;8;1;0;9;1080620;6508;1281;18;3806
FR;4;2022-04-16;1;0;0;0;0;1080621;6508;1281;18;3806
FR;4;2022-04-17;2;1;0;0;1;1080623;6509;1281;18;3807
FR;4;2022-04-18;2;2;5;0;3;1080625;6511;1286;18;3810
FR;4;2022-04-19;2;0;1;0;0;1080627;6511;1287;18;3810
FR;4;2022-04-20;14;4;1;0;3;1080641;6515;1288;18;3813
FR;4;2022-04-21;5;1;0;0;1;1080646;6516;1288;18;3814
FR;4;2022-04-22;1;1;2;0;2;1080647;6517;1290;18;3816
FR;4;2022-04-23;2;3;3;0;6;1080649;6520;1293;18;3822
FR;4;2022-04-24;0;2;0;0;2;1080649;6522;1293;18;3824
FR;4;2022-04-25;3;4;3;0;7;1080652;6526;1296;18;3831
FR;4;2022-04-26;5;6;1;0;6;1080657;6532;1297;18;3837
FR;4;2022-04-27;4;1;1;1;1;1080661;6533;1298;19;3838
FR;4;2022-04-28;3;5;5;0;6;1080664;6538;1303;19;3844
FR;4;2022-04-29;6;3;0;0;2;1080670;6541;1303;19;3846
FR;4;2022-04-30;0;1;1;0;2;1080670;6542;1304;19;3848
FR;4;2022-05-01;0;0;0;0;0;1080670;6542;1304;19;3848
FR;4;2022-05-02;5;16;6;0;19;1080675;6558;1310;19;3867
FR;4;2022-05-03;2;6;2;0;7;1080677;6564;1312;19;3874
FR;4;2022-05-04;7;4;1;0;4;1080684;6568;1313;19;3878
FR;4;2022-05-05;2;2;1;1;1;1080686;6570;1314;20;3879
FR;4;2022-05-06;2;1;1;0;1;1080688;6571;1315;20;3880
FR;4;2022-05-07;0;0;0;0;0;1080688;6571;1315;20;3880
FR;4;2022-05-08;1;1;0;0;1;1080689;6572;1315;20;3881
FR;4;2022-05-09;5;0;0;0;0;1080694;6572;1315;20;3881
FR;4;2022-05-10;1;1;0;2;3;1080695;6573;1315;22;3884
FR;4;2022-05-11;3;2;3;0;5;1080698;6575;1318;22;3889
FR;4;2022-05-12;6;3;1;1;4;1080704;6578;1319;23;3893
FR;4;2022-05-13;0;0;2;0;2;1080704;6578;1321;23;3895
FR;4;2022-05-14;0;2;0;0;2;1080704;6580;1321;23;3897
FR;4;2022-05-15;2;2;0;0;0;1080706;6582;1321;23;3897
FR;4;2022-05-16;5;2;2;0;2;1080711;6584;1323;23;3899
FR;4;2022-05-17;5;1;2;0;3;1080716;6585;1325;23;3902
FR;4;2022-05-18;2;5;0;0;5;1080718;6590;1325;23;3907
FR;4;2022-05-19;2;2;3;0;4;1080720;6592;1328;23;3911
FR;4;2022-05-20;3;1;3;0;1;1080723;6593;1331;23;3912
FR;4;2022-05-21;2;0;1;0;1;1080725;6593;1332;23;3913
FR;4;2022-05-22;0;0;1;0;1;1080725;6593;1333;23;3914
FR;4;2022-05-23;0;0;2;0;0;1080725;6593;1335;23;3914
FR;4;2022-05-24;1;4;0;0;4;1080726;6597;1335;23;3918
FR;4;2022-05-25;1;3;0;0;1;1080727;6600;1335;23;3919
FR;4;2022-05-26;2;0;1;0;1;1080729;6600;1336;23;3920
FR;4;2022-05-27;0;1;0;1;1;1080729;6601;1336;24;3921
FR;4;2022-05-28;1;0;0;0;0;1080730;6601;1336;24;3921
FR;4;2022-05-29;1;0;0;0;0;1080731;6601;1336;24;3921
FR;4;2022-05-30;2;4;2;0;5;1080733;6605;1338;24;3926
FR;4;2022-05-31;2;1;0;0;1;1080735;6606;1338;24;3927
FR;4;2022-06-01;1;11;7;0;15;1080736;6617;1345;24;3942
FR;4;2022-06-02;3;5;2;0;5;1080739;6622;1347;24;3947
FR;4;2022-06-03;2;5;4;1;6;1080741;6627;1351;25;3953
FR;4;2022-06-04;0;1;1;0;1;1080741;6628;1352;25;3954
FR;4;2022-06-05;0;0;0;0;0;1080741;6628;1352;25;3954
FR;4;2022-06-06;5;0;2;0;1;1080746;6628;1354;25;3955
FR;4;2022-06-07;5;1;0;1;1;1080751;6629;1354;26;3956
FR;4;2022-06-08;0;3;3;0;6;1080751;6632;1357;26;3962
FR;4;2022-06-09;1;2;0;0;1;1080752;6634;1357;26;3963
FR;4;2022-06-10;3;0;3;0;1;1080755;6634;1360;26;3964
FR;4;2022-06-11;1;0;0;0;0;1080756;6634;1360;26;3964
FR;4;2022-06-12;4;0;0;0;0;1080760;6634;1360;26;3964
FR;4;2022-06-13;4;2;2;0;1;1080764;6636;1362;26;3965
FR;4;2022-06-14;3;2;0;0;2;1080767;6638;1362;26;3967
FR;4;2022-06-15;6;0;4;0;0;1080773;6638;1366;26;3967
FR;4;2022-06-16;1;2;1;1;1;1080774;6640;1367;27;3968
FR;4;2022-06-17;2;1;0;0;1;1080776;6641;1367;27;3969
FR;4;2022-06-18;0;0;0;0;0;1080776;6641;1367;27;3969
FR;4;2022-06-19;0;0;0;0;0;1080776;6641;1367;27;3969
FR;4;2022-06-20;4;2;2;1;3;1080780;6643;1369;28;3972
FR;4;2022-06-21;3;2;3;1;3;1080783;6645;1372;29;3975
FR;4;2022-06-22;2;1;0;0;1;1080785;6646;1372;29;3976
FR;4;2022-06-23;3;3;3;0;5;1080788;6649;1375;29;3981
FR;4;2022-06-24;2;0;2;0;0;1080790;6649;1377;29;3981
FR;4;2022-06-25;1;0;1;1;1;1080791;6649;1378;30;3982
FR;4;2022-06-26;0;0;1;0;1;1080791;6649;1379;30;3983
FR;4;2022-06-27;1;2;0;3;2;1080792;6651;1379;33;3985
FR;4;2022-06-28;0;4;2;1;5;1080792;6655;1381;34;3990
FR;4;2022-06-29;1;1;0;0;1;1080793;6656;1381;34;3991
FR;4;2022-06-30;1;0;0;0;0;1080794;6656;1381;34;3991
FR;4;2022-07-01;2;3;8;0;3;1080796;6659;1389;34;3994
FR;4;2022-07-02;0;1;0;0;0;1080796;6660;1389;34;3994
FR;4;2022-07-03;0;0;0;0;0;1080796;6660;1389;34;3994
FR;4;2022-07-04;2;0;0;0;0;1080798;6660;1389;34;3994
FR;4;2022-07-05;1;0;0;0;0;1080799;6660;1389;34;3994
FR;4;2022-07-06;5;0;0;0;0;1080804;6660;1389;34;3994
FR;4;2022-07-07;1;0;2;1;0;1080805;6660;1391;35;3994
FR;4;2022-07-08;2;1;0;0;1;1080807;6661;1391;35;3995
FR;4;2022-07-09;2;2;1;0;3;1080809;6663;1392;35;3998
FR;4;2022-07-10;2;0;0;0;0;1080811;6663;1392;35;3998
FR;4;2022-07-11;2;0;2;0;0;1080813;6663;1394;35;3998
FR;4;2022-07-12;0;0;1;0;1;1080813;6663;1395;35;3999
FR;4;2022-07-13;2;2;3;0;2;1080815;6665;1398;35;4001
FR;4;2022-07-14;1;0;1;0;0;1080816;6665;1399;35;4001
FR;4;2022-07-15;8;1;0;0;1;1080824;6666;1399;35;4002
FR;4;2022-07-16;2;0;0;2;0;1080826;6666;1399;37;4002
FR;4;2022-07-17;0;0;0;0;0;1080826;6666;1399;37;4002
FR;4;2022-07-18;1;2;1;0;2;1080827;6668;1400;37;4004
FR;4;2022-07-19;3;0;1;0;1;1080830;6668;1401;37;4005
FR;4;2022-07-20;9;0;0;0;0;1080839;6668;1401;37;4005
FR;4;2022-07-21;2;1;1;0;1;1080841;6669;1402;37;4006
FR;4;2022-07-22;3;0;1;0;0;1080844;6669;1403;37;4006
FR;4;2022-07-23;1;2;0;0;1;1080845;6671;1403;37;4007
FR;4;2022-07-24;0;0;0;0;0;1080845;6671;1403;37;4007
FR;4;2022-07-25;2;0;0;0;0;1080847;6671;1403;37;4007
FR;4;2022-07-26;1;0;1;0;1;1080848;6671;1404;37;4008
FR;4;2022-07-27;2;1;0;0;0;1080850;6672;1404;37;4008
FR;4;2022-07-28;3;0;0;0;0;1080853;6672;1404;37;4008
FR;4;2022-07-29;0;0;0;0;0;1080853;6672;1404;37;4008
FR;4;2022-07-30;1;0;2;0;0;1080854;6672;1406;37;4008
FR;4;2022-07-31;0;0;0;0;0;1080854;6672;1406;37;4008
FR;4;2022-08-01;0;0;0;0;0;1080854;6672;1406;37;4008
FR;4;2022-08-02;4;0;0;0;0;1080858;6672;1406;37;4008
FR;4;2022-08-03;0;0;0;0;0;1080858;6672;1406;37;4008
FR;4;2022-08-04;1;0;0;0;0;1080859;6672;1406;37;4008
FR;4;2022-08-05;1;0;0;0;0;1080860;6672;1406;37;4008
FR;4;2022-08-06;2;0;0;0;0;1080862;6672;1406;37;4008
FR;4;2022-08-07;3;0;0;0;0;1080865;6672;1406;37;4008
FR;4;2022-08-08;1;0;0;0;0;1080866;6672;1406;37;4008
FR;4;2022-08-09;1;0;0;2;0;1080867;6672;1406;39;4008
FR;5;2020-12-27;0;0;0;0;0;0;0;0;0;0
FR;5;2020-12-28;0;0;0;0;0;0;0;0;0;0
FR;5;2020-12-29;0;0;0;0;0;0;0;0;0;0
FR;5;2020-12-30;0;0;0;0;0;0;0;0;0;0
FR;5;2020-12-31;0;0;0;0;0;0;0;0;0;0
FR;5;2021-01-01;0;0;0;0;0;0;0;0;0;0
FR;5;2021-01-02;0;0;0;0;0;0;0;0;0;0
FR;5;2021-01-03;0;0;0;0;0;0;0;0;0;0
FR;5;2021-01-04;0;0;0;0;0;0;0;0;0;0
FR;5;2021-01-05;0;0;0;0;0;0;0;0;0;0
FR;5;2021-01-06;0;0;0;0;0;0;0;0;0;0
FR;5;2021-01-07;0;0;0;0;0;0;0;0;0;0
FR;5;2021-01-08;0;0;0;0;0;0;0;0;0;0
FR;5;2021-01-09;0;0;0;0;0;0;0;0;0;0
FR;5;2021-01-10;0;0;0;0;0;0;0;0;0;0
FR;5;2021-01-11;0;0;0;0;0;0;0;0;0;0
FR;5;2021-01-12;0;0;0;0;0;0;0;0;0;0
FR;5;2021-01-13;0;0;0;0;0;0;0;0;0;0
FR;5;2021-01-14;0;0;0;0;0;0;0;0;0;0
FR;5;2021-01-15;0;0;0;0;0;0;0;0;0;0
FR;5;2021-01-16;0;0;0;0;0;0;0;0;0;0
FR;5;2021-01-17;0;0;0;0;0;0;0;0;0;0
FR;5;2021-01-18;0;0;0;0;0;0;0;0;0;0
FR;5;2021-01-19;0;0;0;0;0;0;0;0;0;0
FR;5;2021-01-20;0;0;0;0;0;0;0;0;0;0
FR;5;2021-01-21;0;0;0;0;0;0;0;0;0;0
FR;5;2021-01-22;0;0;0;0;0;0;0;0;0;0
FR;5;2021-01-23;0;0;0;0;0;0;0;0;0;0
FR;5;2021-01-24;0;0;0;0;0;0;0;0;0;0
FR;5;2021-01-25;0;0;0;0;0;0;0;0;0;0
FR;5;2021-01-26;0;0;0;0;0;0;0;0;0;0
FR;5;2021-01-27;0;0;0;0;0;0;0;0;0;0
FR;5;2021-01-28;0;0;0;0;0;0;0;0;0;0
FR;5;2021-01-29;0;0;0;0;0;0;0;0;0;0
FR;5;2021-01-30;0;0;0;0;0;0;0;0;0;0
FR;5;2021-01-31;0;0;0;0;0;0;0;0;0;0
FR;5;2021-02-01;0;0;0;0;0;0;0;0;0;0
FR;5;2021-02-02;0;0;0;0;0;0;0;0;0;0
FR;5;2021-02-03;0;0;0;0;0;0;0;0;0;0
FR;5;2021-02-04;0;0;0;0;0;0;0;0;0;0
FR;5;2021-02-05;0;0;0;0;0;0;0;0;0;0
FR;5;2021-02-06;0;0;0;0;0;0;0;0;0;0
FR;5;2021-02-07;0;0;0;0;0;0;0;0;0;0
FR;5;2021-02-08;0;0;0;0;0;0;0;0;0;0
FR;5;2021-02-09;0;0;0;0;0;0;0;0;0;0
FR;5;2021-02-10;0;0;0;0;0;0;0;0;0;0
FR;5;2021-02-11;0;0;0;0;0;0;0;0;0;0
FR;5;2021-02-12;0;0;0;0;0;0;0;0;0;0
FR;5;2021-02-13;0;0;0;0;0;0;0;0;0;0
FR;5;2021-02-14;0;0;0;0;0;0;0;0;0;0
FR;5;2021-02-15;0;0;0;0;0;0;0;0;0;0
FR;5;2021-02-16;0;0;0;0;0;0;0;0;0;0
FR;5;2021-02-17;0;0;0;0;0;0;0;0;0;0
FR;5;2021-02-18;0;0;0;0;0;0;0;0;0;0
FR;5;2021-02-19;0;0;0;0;0;0;0;0;0;0
FR;5;2021-02-20;0;0;0;0;0;0;0;0;0;0
FR;5;2021-02-21;0;0;0;0;0;0;0;0;0;0
FR;5;2021-02-22;0;0;0;0;0;0;0;0;0;0
FR;5;2021-02-23;0;0;0;0;0;0;0;0;0;0
FR;5;2021-02-24;0;0;0;0;0;0;0;0;0;0
FR;5;2021-02-25;0;0;0;0;0;0;0;0;0;0
FR;5;2021-02-26;0;0;0;0;0;0;0;0;0;0
FR;5;2021-02-27;0;0;0;0;0;0;0;0;0;0
FR;5;2021-02-28;0;0;0;0;0;0;0;0;0;0
FR;5;2021-03-01;0;0;0;0;0;0;0;0;0;0
FR;5;2021-03-02;0;0;0;0;0;0;0;0;0;0
FR;5;2021-03-03;0;0;0;0;0;0;0;0;0;0
FR;5;2021-03-04;0;0;0;0;0;0;0;0;0;0
FR;5;2021-03-05;0;0;0;0;0;0;0;0;0;0
FR;5;2021-03-06;0;0;0;0;0;0;0;0;0;0
FR;5;2021-03-07;0;0;0;0;0;0;0;0;0;0
FR;5;2021-03-08;0;0;0;0;0;0;0;0;0;0
FR;5;2021-03-09;0;0;0;0;0;0;0;0;0;0
FR;5;2021-03-10;0;0;0;0;0;0;0;0;0;0
FR;5;2021-03-11;0;0;0;0;0;0;0;0;0;0
FR;5;2021-03-12;0;0;0;0;0;0;0;0;0;0
FR;5;2021-03-13;0;0;0;0;0;0;0;0;0;0
FR;5;2021-03-14;0;0;0;0;0;0;0;0;0;0
FR;5;2021-03-15;0;0;0;0;0;0;0;0;0;0
FR;5;2021-03-16;0;0;0;0;0;0;0;0;0;0
FR;5;2021-03-17;0;0;0;0;0;0;0;0;0;0
FR;5;2021-03-18;0;0;0;0;0;0;0;0;0;0
FR;5;2021-03-19;0;0;0;0;0;0;0;0;0;0
FR;5;2021-03-20;0;0;0;0;0;0;0;0;0;0
FR;5;2021-03-21;0;0;0;0;0;0;0;0;0;0
FR;5;2021-03-22;0;0;0;0;0;0;0;0;0;0
FR;5;2021-03-23;0;0;0;0;0;0;0;0;0;0
FR;5;2021-03-24;0;0;0;0;0;0;0;0;0;0
FR;5;2021-03-25;0;0;0;0;0;0;0;0;0;0
FR;5;2021-03-26;0;0;0;0;0;0;0;0;0;0
FR;5;2021-03-27;0;0;0;0;0;0;0;0;0;0
FR;5;2021-03-28;0;0;0;0;0;0;0;0;0;0
FR;5;2021-03-29;0;0;0;0;0;0;0;0;0;0
FR;5;2021-03-30;0;0;0;0;0;0;0;0;0;0
FR;5;2021-03-31;0;0;0;0;0;0;0;0;0;0
FR;5;2021-04-01;0;0;0;0;0;0;0;0;0;0
FR;5;2021-04-02;0;0;0;0;0;0;0;0;0;0
FR;5;2021-04-03;0;0;0;0;0;0;0;0;0;0
FR;5;2021-04-04;0;0;0;0;0;0;0;0;0;0
FR;5;2021-04-05;0;0;0;0;0;0;0;0;0;0
FR;5;2021-04-06;0;0;0;0;0;0;0;0;0;0
FR;5;2021-04-07;0;0;0;0;0;0;0;0;0;0
FR;5;2021-04-08;0;0;0;0;0;0;0;0;0;0
FR;5;2021-04-09;0;0;0;0;0;0;0;0;0;0
FR;5;2021-04-10;0;0;0;0;0;0;0;0;0;0
FR;5;2021-04-11;0;0;0;0;0;0;0;0;0;0
FR;5;2021-04-12;0;0;0;0;0;0;0;0;0;0
FR;5;2021-04-13;0;0;0;0;0;0;0;0;0;0
FR;5;2021-04-14;0;0;0;0;0;0;0;0;0;0
FR;5;2021-04-15;0;0;0;0;0;0;0;0;0;0
FR;5;2021-04-16;0;0;0;0;0;0;0;0;0;0
FR;5;2021-04-17;0;0;0;0;0;0;0;0;0;0
FR;5;2021-04-18;0;0;0;0;0;0;0;0;0;0
FR;5;2021-04-19;0;0;0;0;0;0;0;0;0;0
FR;5;2021-04-20;0;0;0;0;0;0;0;0;0;0
FR;5;2021-04-21;0;0;0;0;0;0;0;0;0;0
FR;5;2021-04-22;0;0;0;0;0;0;0;0;0;0
FR;5;2021-04-23;0;0;0;0;0;0;0;0;0;0
FR;5;2021-04-24;0;0;0;0;0;0;0;0;0;0
FR;5;2021-04-25;0;0;0;0;0;0;0;0;0;0
FR;5;2021-04-26;0;0;0;0;0;0;0;0;0;0
FR;5;2021-04-27;0;0;0;0;0;0;0;0;0;0
FR;5;2021-04-28;0;0;0;0;0;0;0;0;0;0
FR;5;2021-04-29;0;0;0;0;0;0;0;0;0;0
FR;5;2021-04-30;0;0;0;0;0;0;0;0;0;0
FR;5;2021-05-01;0;0;0;0;0;0;0;0;0;0
FR;5;2021-05-02;0;0;0;0;0;0;0;0;0;0
FR;5;2021-05-03;0;0;0;0;0;0;0;0;0;0
FR;5;2021-05-04;0;0;0;0;0;0;0;0;0;0
FR;5;2021-05-05;0;0;0;0;0;0;0;0;0;0
FR;5;2021-05-06;0;0;0;0;0;0;0;0;0;0
FR;5;2021-05-07;0;0;0;0;0;0;0;0;0;0
FR;5;2021-05-08;0;0;0;0;0;0;0;0;0;0
FR;5;2021-05-09;0;0;0;0;0;0;0;0;0;0
FR;5;2021-05-10;0;0;0;0;0;0;0;0;0;0
FR;5;2021-05-11;0;0;0;0;0;0;0;0;0;0
FR;5;2021-05-12;0;0;0;0;0;0;0;0;0;0
FR;5;2021-05-13;0;0;0;0;0;0;0;0;0;0
FR;5;2021-05-14;0;0;0;0;0;0;0;0;0;0
FR;5;2021-05-15;0;0;0;0;0;0;0;0;0;0
FR;5;2021-05-16;0;0;0;0;0;0;0;0;0;0
FR;5;2021-05-17;0;0;0;0;0;0;0;0;0;0
FR;5;2021-05-18;0;0;0;0;0;0;0;0;0;0
FR;5;2021-05-19;0;0;0;0;0;0;0;0;0;0
FR;5;2021-05-20;0;0;0;0;0;0;0;0;0;0
FR;5;2021-05-21;0;0;0;0;0;0;0;0;0;0
FR;5;2021-05-22;0;0;0;0;0;0;0;0;0;0
FR;5;2021-05-23;0;0;0;0;0;0;0;0;0;0
FR;5;2021-05-24;0;0;0;0;0;0;0;0;0;0
FR;5;2021-05-25;0;0;0;0;0;0;0;0;0;0
FR;5;2021-05-26;0;0;0;0;0;0;0;0;0;0
FR;5;2021-05-27;0;0;0;0;0;0;0;0;0;0
FR;5;2021-05-28;0;0;0;0;0;0;0;0;0;0
FR;5;2021-05-29;0;0;0;0;0;0;0;0;0;0
FR;5;2021-05-30;0;0;0;0;0;0;0;0;0;0
FR;5;2021-05-31;0;0;0;0;0;0;0;0;0;0
FR;5;2021-06-01;0;0;0;0;0;0;0;0;0;0
FR;5;2021-06-02;0;0;0;0;0;0;0;0;0;0
FR;5;2021-06-03;0;0;0;0;0;0;0;0;0;0
FR;5;2021-06-04;0;0;0;0;0;0;0;0;0;0
FR;5;2021-06-05;0;0;0;0;0;0;0;0;0;0
FR;5;2021-06-06;0;0;0;0;0;0;0;0;0;0
FR;5;2021-06-07;0;0;0;0;0;0;0;0;0;0
FR;5;2021-06-08;0;0;0;0;0;0;0;0;0;0
FR;5;2021-06-09;0;0;0;0;0;0;0;0;0;0
FR;5;2021-06-10;0;0;0;0;0;0;0;0;0;0
FR;5;2021-06-11;0;0;0;0;0;0;0;0;0;0
FR;5;2021-06-12;0;0;0;0;0;0;0;0;0;0
FR;5;2021-06-13;0;0;0;0;0;0;0;0;0;0
FR;5;2021-06-14;0;0;0;0;0;0;0;0;0;0
FR;5;2021-06-15;0;0;0;0;0;0;0;0;0;0
FR;5;2021-06-16;0;0;0;0;0;0;0;0;0;0
FR;5;2021-06-17;0;0;0;0;0;0;0;0;0;0
FR;5;2021-06-18;0;0;0;0;0;0;0;0;0;0
FR;5;2021-06-19;0;0;0;0;0;0;0;0;0;0
FR;5;2021-06-20;0;0;0;0;0;0;0;0;0;0
FR;5;2021-06-21;0;0;0;0;0;0;0;0;0;0
FR;5;2021-06-22;0;0;0;0;0;0;0;0;0;0
FR;5;2021-06-23;0;0;0;0;0;0;0;0;0;0
FR;5;2021-06-24;0;0;0;0;0;0;0;0;0;0
FR;5;2021-06-25;0;0;0;0;0;0;0;0;0;0
FR;5;2021-06-26;0;0;0;0;0;0;0;0;0;0
FR;5;2021-06-27;0;0;0;0;0;0;0;0;0;0
FR;5;2021-06-28;0;0;0;0;0;0;0;0;0;0
FR;5;2021-06-29;0;0;0;0;0;0;0;0;0;0
FR;5;2021-06-30;0;0;0;0;0;0;0;0;0;0
FR;5;2021-07-01;0;0;0;0;0;0;0;0;0;0
FR;5;2021-07-02;0;0;0;0;0;0;0;0;0;0
FR;5;2021-07-03;0;0;0;0;0;0;0;0;0;0
FR;5;2021-07-04;0;0;0;0;0;0;0;0;0;0
FR;5;2021-07-05;0;0;0;0;0;0;0;0;0;0
FR;5;2021-07-06;0;0;0;0;0;0;0;0;0;0
FR;5;2021-07-07;0;0;0;0;0;0;0;0;0;0
FR;5;2021-07-08;0;0;0;0;0;0;0;0;0;0
FR;5;2021-07-09;0;0;0;0;0;0;0;0;0;0
FR;5;2021-07-10;0;0;0;0;0;0;0;0;0;0
FR;5;2021-07-11;0;0;0;0;0;0;0;0;0;0
FR;5;2021-07-12;0;0;0;0;0;0;0;0;0;0
FR;5;2021-07-13;0;0;0;0;0;0;0;0;0;0
FR;5;2021-07-14;0;0;0;0;0;0;0;0;0;0
FR;5;2021-07-15;0;0;0;0;0;0;0;0;0;0
FR;5;2021-07-16;0;0;0;0;0;0;0;0;0;0
FR;5;2021-07-17;0;0;0;0;0;0;0;0;0;0
FR;5;2021-07-18;0;0;0;0;0;0;0;0;0;0
FR;5;2021-07-19;0;0;0;0;0;0;0;0;0;0
FR;5;2021-07-20;0;0;0;0;0;0;0;0;0;0
FR;5;2021-07-21;0;0;0;0;0;0;0;0;0;0
FR;5;2021-07-22;0;0;0;0;0;0;0;0;0;0
FR;5;2021-07-23;0;0;0;0;0;0;0;0;0;0
FR;5;2021-07-24;0;0;0;0;0;0;0;0;0;0
FR;5;2021-07-25;0;0;0;0;0;0;0;0;0;0
FR;5;2021-07-26;0;0;0;0;0;0;0;0;0;0
FR;5;2021-07-27;0;0;0;0;0;0;0;0;0;0
FR;5;2021-07-28;0;0;0;0;0;0;0;0;0;0
FR;5;2021-07-29;0;0;0;0;0;0;0;0;0;0
FR;5;2021-07-30;0;0;0;0;0;0;0;0;0;0
FR;5;2021-07-31;0;0;0;0;0;0;0;0;0;0
FR;5;2021-08-01;0;0;0;0;0;0;0;0;0;0
FR;5;2021-08-02;0;0;0;0;0;0;0;0;0;0
FR;5;2021-08-03;0;0;0;0;0;0;0;0;0;0
FR;5;2021-08-04;0;0;0;0;0;0;0;0;0;0
FR;5;2021-08-05;0;0;0;0;0;0;0;0;0;0
FR;5;2021-08-06;0;0;0;0;0;0;0;0;0;0
FR;5;2021-08-07;0;0;0;0;0;0;0;0;0;0
FR;5;2021-08-08;0;0;0;0;0;0;0;0;0;0
FR;5;2021-08-09;0;0;0;0;0;0;0;0;0;0
FR;5;2021-08-10;0;0;0;0;0;0;0;0;0;0
FR;5;2021-08-11;0;0;0;0;0;0;0;0;0;0
FR;5;2021-08-12;0;0;0;0;0;0;0;0;0;0
FR;5;2021-08-13;0;0;0;0;0;0;0;0;0;0
FR;5;2021-08-14;0;0;0;0;0;0;0;0;0;0
FR;5;2021-08-15;0;0;0;0;0;0;0;0;0;0
FR;5;2021-08-16;0;0;0;0;0;0;0;0;0;0
FR;5;2021-08-17;0;0;0;0;0;0;0;0;0;0
FR;5;2021-08-18;0;0;0;0;0;0;0;0;0;0
FR;5;2021-08-19;0;0;0;0;0;0;0;0;0;0
FR;5;2021-08-20;0;0;0;0;0;0;0;0;0;0
FR;5;2021-08-21;0;0;0;0;0;0;0;0;0;0
FR;5;2021-08-22;0;0;0;0;0;0;0;0;0;0
FR;5;2021-08-23;0;0;0;0;0;0;0;0;0;0
FR;5;2021-08-24;0;0;0;0;0;0;0;0;0;0
FR;5;2021-08-25;0;0;0;0;0;0;0;0;0;0
FR;5;2021-08-26;0;0;0;0;0;0;0;0;0;0
FR;5;2021-08-27;0;0;0;0;0;0;0;0;0;0
FR;5;2021-08-28;0;0;0;0;0;0;0;0;0;0
FR;5;2021-08-29;0;0;0;0;0;0;0;0;0;0
FR;5;2021-08-30;0;0;0;0;0;0;0;0;0;0
FR;5;2021-08-31;0;0;0;0;0;0;0;0;0;0
FR;5;2021-09-01;0;0;0;0;0;0;0;0;0;0
FR;5;2021-09-02;0;0;0;0;0;0;0;0;0;0
FR;5;2021-09-03;0;0;0;0;0;0;0;0;0;0
FR;5;2021-09-04;0;0;0;0;0;0;0;0;0;0
FR;5;2021-09-05;0;0;0;0;0;0;0;0;0;0
FR;5;2021-09-06;0;0;0;0;0;0;0;0;0;0
FR;5;2021-09-07;0;0;0;0;0;0;0;0;0;0
FR;5;2021-09-08;0;0;0;0;0;0;0;0;0;0
FR;5;2021-09-09;0;0;0;0;0;0;0;0;0;0
FR;5;2021-09-10;0;0;0;0;0;0;0;0;0;0
FR;5;2021-09-11;0;0;0;0;0;0;0;0;0;0
FR;5;2021-09-12;0;0;0;0;0;0;0;0;0;0
FR;5;2021-09-13;0;0;0;0;0;0;0;0;0;0
FR;5;2021-09-14;0;0;0;0;0;0;0;0;0;0
FR;5;2021-09-15;0;0;0;0;0;0;0;0;0;0
FR;5;2021-09-16;0;0;0;0;0;0;0;0;0;0
FR;5;2021-09-17;0;0;0;0;0;0;0;0;0;0
FR;5;2021-09-18;0;0;0;0;0;0;0;0;0;0
FR;5;2021-09-19;0;0;0;0;0;0;0;0;0;0
FR;5;2021-09-20;0;0;0;0;0;0;0;0;0;0
FR;5;2021-09-21;0;0;0;0;0;0;0;0;0;0
FR;5;2021-09-22;0;0;0;0;0;0;0;0;0;0
FR;5;2021-09-23;0;0;0;0;0;0;0;0;0;0
FR;5;2021-09-24;0;0;0;0;0;0;0;0;0;0
FR;5;2021-09-25;0;0;0;0;0;0;0;0;0;0
FR;5;2021-09-26;0;0;0;0;0;0;0;0;0;0
FR;5;2021-09-27;0;0;0;0;0;0;0;0;0;0
FR;5;2021-09-28;0;0;0;0;0;0;0;0;0;0
FR;5;2021-09-29;0;0;0;0;0;0;0;0;0;0
FR;5;2021-09-30;0;0;0;0;0;0;0;0;0;0
FR;5;2021-10-01;0;0;0;0;0;0;0;0;0;0
FR;5;2021-10-02;0;0;0;0;0;0;0;0;0;0
FR;5;2021-10-03;0;0;0;0;0;0;0;0;0;0
FR;5;2021-10-04;0;0;0;0;0;0;0;0;0;0
FR;5;2021-10-05;0;0;0;0;0;0;0;0;0;0
FR;5;2021-10-06;0;0;0;0;0;0;0;0;0;0
FR;5;2021-10-07;0;0;0;0;0;0;0;0;0;0
FR;5;2021-10-08;0;0;0;0;0;0;0;0;0;0
FR;5;2021-10-09;0;0;0;0;0;0;0;0;0;0
FR;5;2021-10-10;0;0;0;0;0;0;0;0;0;0
FR;5;2021-10-11;0;0;0;0;0;0;0;0;0;0
FR;5;2021-10-12;0;0;0;0;0;0;0;0;0;0
FR;5;2021-10-13;0;0;0;0;0;0;0;0;0;0
FR;5;2021-10-14;0;0;0;0;0;0;0;0;0;0
FR;5;2021-10-15;0;0;0;0;0;0;0;0;0;0
FR;5;2021-10-16;0;0;0;0;0;0;0;0;0;0
FR;5;2021-10-17;0;0;0;0;0;0;0;0;0;0
FR;5;2021-10-18;0;0;0;0;0;0;0;0;0;0
FR;5;2021-10-19;0;0;0;0;0;0;0;0;0;0
FR;5;2021-10-20;0;0;0;0;0;0;0;0;0;0
FR;5;2021-10-21;0;0;0;0;0;0;0;0;0;0
FR;5;2021-10-22;0;0;0;0;0;0;0;0;0;0
FR;5;2021-10-23;0;0;0;0;0;0;0;0;0;0
FR;5;2021-10-24;0;0;0;0;0;0;0;0;0;0
FR;5;2021-10-25;0;0;0;0;0;0;0;0;0;0
FR;5;2021-10-26;0;0;0;0;0;0;0;0;0;0
FR;5;2021-10-27;0;0;0;0;0;0;0;0;0;0
FR;5;2021-10-28;0;0;0;0;0;0;0;0;0;0
FR;5;2021-10-29;0;0;0;0;0;0;0;0;0;0
FR;5;2021-10-30;0;0;0;0;0;0;0;0;0;0
FR;5;2021-10-31;0;0;0;0;0;0;0;0;0;0
FR;5;2021-11-01;0;0;0;0;0;0;0;0;0;0
FR;5;2021-11-02;0;0;0;0;0;0;0;0;0;0
FR;5;2021-11-03;0;0;0;0;0;0;0;0;0;0
FR;5;2021-11-04;0;0;0;0;0;0;0;0;0;0
FR;5;2021-11-05;0;0;0;0;0;0;0;0;0;0
FR;5;2021-11-06;0;0;0;0;0;0;0;0;0;0
FR;5;2021-11-07;0;0;0;0;0;0;0;0;0;0
FR;5;2021-11-08;0;0;0;0;0;0;0;0;0;0
FR;5;2021-11-09;0;0;0;0;0;0;0;0;0;0
FR;5;2021-11-10;0;0;0;0;0;0;0;0;0;0
FR;5;2021-11-11;0;0;0;0;0;0;0;0;0;0
FR;5;2021-11-12;0;0;0;0;0;0;0;0;0;0
FR;5;2021-11-13;0;0;0;0;0;0;0;0;0;0
FR;5;2021-11-14;0;0;0;0;0;0;0;0;0;0
FR;5;2021-11-15;0;0;0;0;0;0;0;0;0;0
FR;5;2021-11-16;0;0;0;0;0;0;0;0;0;0
FR;5;2021-11-17;0;0;0;0;0;0;0;0;0;0
FR;5;2021-11-18;0;0;0;0;0;0;0;0;0;0
FR;5;2021-11-19;0;0;0;0;0;0;0;0;0;0
FR;5;2021-11-20;0;0;0;0;0;0;0;0;0;0
FR;5;2021-11-21;0;0;0;0;0;0;0;0;0;0
FR;5;2021-11-22;0;0;0;0;0;0;0;0;0;0
FR;5;2021-11-23;0;0;0;0;0;0;0;0;0;0
FR;5;2021-11-24;0;0;0;0;0;0;0;0;0;0
FR;5;2021-11-25;0;0;0;0;0;0;0;0;0;0
FR;5;2021-11-26;0;0;0;0;0;0;0;0;0;0
FR;5;2021-11-27;0;0;0;0;0;0;0;0;0;0
FR;5;2021-11-28;0;0;0;0;0;0;0;0;0;0
FR;5;2021-11-29;0;0;0;0;0;0;0;0;0;0
FR;5;2021-11-30;0;0;0;0;0;0;0;0;0;0
FR;5;2021-12-01;0;0;0;0;0;0;0;0;0;0
FR;5;2021-12-02;0;0;0;0;0;0;0;0;0;0
FR;5;2021-12-03;0;0;0;0;0;0;0;0;0;0
FR;5;2021-12-04;0;0;0;0;0;0;0;0;0;0
FR;5;2021-12-05;0;0;0;0;0;0;0;0;0;0
FR;5;2021-12-06;0;0;0;0;0;0;0;0;0;0
FR;5;2021-12-07;0;0;0;0;0;0;0;0;0;0
FR;5;2021-12-08;0;0;0;0;0;0;0;0;0;0
FR;5;2021-12-09;0;0;0;0;0;0;0;0;0;0
FR;5;2021-12-10;0;0;0;0;0;0;0;0;0;0
FR;5;2021-12-11;0;0;0;0;0;0;0;0;0;0
FR;5;2021-12-12;0;0;0;0;0;0;0;0;0;0
FR;5;2021-12-13;0;0;0;0;0;0;0;0;0;0
FR;5;2021-12-14;33;45;77;0;88;33;45;77;0;88
FR;5;2021-12-15;196;44;37;0;49;229;89;114;0;137
FR;5;2021-12-16;181;21;44;0;48;410;110;158;0;185
FR;5;2021-12-17;311;16;72;0;74;721;126;230;0;259
FR;5;2021-12-18;765;24;22;0;29;1486;150;252;0;288
FR;5;2021-12-19;586;15;15;0;17;2072;165;267;0;305
FR;5;2021-12-20;1223;31;35;0;38;3295;196;302;0;343
FR;5;2021-12-21;1535;22;54;1;60;4830;218;356;1;403
FR;5;2021-12-22;4069;40;37;0;46;8899;258;393;1;449
FR;5;2021-12-23;3042;16;21;0;25;11941;274;414;1;474
FR;5;2021-12-24;761;18;9;0;14;12702;292;423;1;488
FR;5;2021-12-25;61;5;2;0;3;12763;297;425;1;491
FR;5;2021-12-26;623;6;3;0;4;13386;303;428;1;495
FR;5;2021-12-27;4081;25;21;0;23;17467;328;449;1;518
FR;5;2021-12-28;5204;23;41;1;43;22671;351;490;2;561
FR;5;2021-12-29;8107;34;66;2;69;30778;385;556;4;630
FR;5;2021-12-30;5173;18;33;0;39;35951;403;589;4;669
FR;5;2021-12-31;1553;8;10;0;11;37504;411;599;4;680
FR;5;2022-01-01;185;2;2;0;3;37689;413;601;4;683
FR;5;2022-01-02;1489;1;1;0;1;39178;414;602;4;684
FR;5;2022-01-03;3064;36;33;0;32;42242;450;635;4;716
FR;5;2022-01-04;3033;39;33;0;42;45275;489;668;4;758
FR;5;2022-01-05;19323;203;97;1;108;64598;692;765;5;866
FR;5;2022-01-06;3746;133;122;0;142;68344;825;887;5;1008
FR;5;2022-01-07;5007;202;48;2;56;73351;1027;935;7;1064
FR;5;2022-01-08;13659;514;45;0;52;87010;1541;980;7;1116
FR;5;2022-01-09;5754;399;15;0;20;92764;1940;995;7;1136
FR;5;2022-01-10;3455;326;25;0;29;96219;2266;1020;7;1165
FR;5;2022-01-11;3671;284;38;0;41;99890;2550;1058;7;1206
FR;5;2022-01-12;22652;3005;90;0;113;122542;5555;1148;7;1319
FR;5;2022-01-13;4037;622;30;0;32;126579;6177;1178;7;1351
FR;5;2022-01-14;4843;582;44;0;51;131422;6759;1222;7;1402
FR;5;2022-01-15;14685;1746;38;3;49;146107;8505;1260;10;1451
FR;5;2022-01-16;4727;666;3;0;5;150834;9171;1263;10;1456
FR;5;2022-01-17;2297;716;26;0;29;153131;9887;1289;10;1485
FR;5;2022-01-18;2430;870;30;0;40;155561;10757;1319;10;1525
FR;5;2022-01-19;18482;6423;74;2;142;174043;17180;1393;12;1667
FR;5;2022-01-20;1920;1068;25;0;34;175963;18248;1418;12;1701
FR;5;2022-01-21;3077;1372;47;1;59;179040;19620;1465;13;1760
FR;5;2022-01-22;10721;3454;33;1;43;189761;23074;1498;14;1803
FR;5;2022-01-23;2629;1415;6;0;10;192390;24489;1504;14;1813
FR;5;2022-01-24;1160;1340;19;0;23;193550;25829;1523;14;1836
FR;5;2022-01-25;1220;1549;19;2;30;194770;27378;1542;16;1866
FR;5;2022-01-26;10752;12027;50;1;89;205522;39405;1592;17;1955
FR;5;2022-01-27;1292;1693;10;0;17;206814;41098;1602;17;1972
FR;5;2022-01-28;1699;3347;16;0;19;208513;44445;1618;17;1991
FR;5;2022-01-29;6238;8041;68;0;96;214751;52486;1686;17;2087
FR;5;2022-01-30;1509;2950;5;0;18;216260;55436;1691;17;2105
FR;5;2022-01-31;589;1773;23;0;24;216849;57209;1714;17;2129
FR;5;2022-02-01;712;1706;10;0;15;217561;58915;1724;17;2144
FR;5;2022-02-02;6957;15656;52;0;94;224518;74571;1776;17;2238
FR;5;2022-02-03;491;1690;14;0;13;225009;76261;1790;17;2251
FR;5;2022-02-04;945;3002;19;0;31;225954;79263;1809;17;2282
FR;5;2022-02-05;3535;8917;23;0;37;229489;88180;1832;17;2319
FR;5;2022-02-06;737;2397;10;0;19;230226;90577;1842;17;2338
FR;5;2022-02-07;884;1596;22;0;24;231110;92173;1864;17;2362
FR;5;2022-02-08;722;1287;18;0;20;231832;93460;1882;17;2382
FR;5;2022-02-09;4544;12877;44;0;76;236376;106337;1926;17;2458
FR;5;2022-02-10;646;1059;14;0;15;237022;107396;1940;17;2473
FR;5;2022-02-11;793;2032;16;0;21;237815;109428;1956;17;2494
FR;5;2022-02-12;2286;6813;33;0;53;240101;116241;1989;17;2547
FR;5;2022-02-13;464;1540;8;0;8;240565;117781;1997;17;2555
FR;5;2022-02-14;678;1288;10;0;13;241243;119069;2007;17;2568
FR;5;2022-02-15;482;886;9;0;14;241725;119955;2016;17;2582
FR;5;2022-02-16;2980;9123;41;1;58;244705;129078;2057;18;2640
FR;5;2022-02-17;436;809;6;0;7;245141;129887;2063;18;2647
FR;5;2022-02-18;649;1408;13;0;17;245790;131295;2076;18;2664
FR;5;2022-02-19;1373;4315;16;0;28;247163;135610;2092;18;2692
FR;5;2022-02-20;247;879;6;0;8;247410;136489;2098;18;2700
FR;5;2022-02-21;221;607;2;0;4;247631;137096;2100;18;2704
FR;5;2022-02-22;262;545;17;0;17;247893;137641;2117;18;2721
FR;5;2022-02-23;1909;6926;23;1;43;249802;144567;2140;19;2764
FR;5;2022-02-24;182;374;6;1;7;249984;144941;2146;20;2771
FR;5;2022-02-25;336;950;13;0;12;250320;145891;2159;20;2783
FR;5;2022-02-26;972;3070;10;0;14;251292;148961;2169;20;2797
FR;5;2022-02-27;149;506;0;0;3;251441;149467;2169;20;2800
FR;5;2022-02-28;162;369;1;0;1;251603;149836;2170;20;2801
FR;5;2022-03-01;130;280;6;0;7;251733;150116;2176;20;2808
FR;5;2022-03-02;1241;4156;28;3;40;252974;154272;2204;23;2848
FR;5;2022-03-03;121;251;5;0;10;253095;154523;2209;23;2858
FR;5;2022-03-04;196;488;13;0;14;253291;155011;2222;23;2872
FR;5;2022-03-05;677;1990;8;0;16;253968;157001;2230;23;2888
FR;5;2022-03-06;108;260;0;0;0;254076;157261;2230;23;2888
FR;5;2022-03-07;71;228;5;0;3;254147;157489;2235;23;2891
FR;5;2022-03-08;46;133;7;1;7;254193;157622;2242;24;2898
FR;5;2022-03-09;910;3078;24;0;36;255103;160700;2266;24;2934
FR;5;2022-03-10;82;202;8;0;12;255185;160902;2274;24;2946
FR;5;2022-03-11;148;369;13;1;15;255333;161271;2287;25;2961
FR;5;2022-03-12;758;1613;13;1;30;256091;162884;2300;26;2991
FR;5;2022-03-13;78;100;0;0;0;256169;162984;2300;26;2991
FR;5;2022-03-14;67;119;7;1;7;256236;163103;2307;27;2998
FR;5;2022-03-15;83;99;4;0;7;256319;163202;2311;27;3005
FR;5;2022-03-16;883;1827;15;3;36;257202;165029;2326;30;3041
FR;5;2022-03-17;68;123;8;4;10;257270;165152;2334;34;3051
FR;5;2022-03-18;172;318;13;4;18;257442;165470;2347;38;3069
FR;5;2022-03-19;751;1163;12;5;33;258193;166633;2359;43;3102
FR;5;2022-03-20;45;93;1;0;1;258238;166726;2360;43;3103
FR;5;2022-03-21;71;120;10;6;15;258309;166846;2370;49;3118
FR;5;2022-03-22;56;119;8;8;9;258365;166965;2378;57;3127
FR;5;2022-03-23;805;1461;14;8;36;259170;168426;2392;65;3163
FR;5;2022-03-24;70;93;8;7;7;259240;168519;2400;72;3170
FR;5;2022-03-25;222;293;14;8;18;259462;168812;2414;80;3188
FR;5;2022-03-26;707;853;12;5;26;260169;169665;2426;85;3214
FR;5;2022-03-27;75;80;0;0;3;260244;169745;2426;85;3217
FR;5;2022-03-28;81;93;1;2;3;260325;169838;2427;87;3220
FR;5;2022-03-29;71;82;10;4;12;260396;169920;2437;91;3232
FR;5;2022-03-30;823;1116;16;13;29;261219;171036;2453;104;3261
FR;5;2022-03-31;102;125;1;4;6;261321;171161;2454;108;3267
FR;5;2022-04-01;112;86;7;12;11;261433;171247;2461;120;3278
FR;5;2022-04-02;330;349;3;3;15;261763;171596;2464;123;3293
FR;5;2022-04-03;54;59;1;0;1;261817;171655;2465;123;3294
FR;5;2022-04-04;40;57;4;1;8;261857;171712;2469;124;3302
FR;5;2022-04-05;52;60;6;7;9;261909;171772;2475;131;3311
FR;5;2022-04-06;421;439;7;15;16;262330;172211;2482;146;3327
FR;5;2022-04-07;45;69;5;7;7;262375;172280;2487;153;3334
FR;5;2022-04-08;134;112;12;13;14;262509;172392;2499;166;3348
FR;5;2022-04-09;311;324;2;5;17;262820;172716;2501;171;3365
FR;5;2022-04-10;43;31;2;0;2;262863;172747;2503;171;3367
FR;5;2022-04-11;50;60;3;2;4;262913;172807;2506;173;3371
FR;5;2022-04-12;59;54;3;3;5;262972;172861;2509;176;3376
FR;5;2022-04-13;382;413;3;8;16;263354;173274;2512;184;3392
FR;5;2022-04-14;48;48;5;5;9;263402;173322;2517;189;3401
FR;5;2022-04-15;91;109;4;4;5;263493;173431;2521;193;3406
FR;5;2022-04-16;188;184;2;1;13;263681;173615;2523;194;3419
FR;5;2022-04-17;12;11;1;0;1;263693;173626;2524;194;3420
FR;5;2022-04-18;9;10;2;0;3;263702;173636;2526;194;3423
FR;5;2022-04-19;75;71;6;1;6;263777;173707;2532;195;3429
FR;5;2022-04-20;361;349;9;6;12;264138;174056;2541;201;3441
FR;5;2022-04-21;42;64;9;10;12;264180;174120;2550;211;3453
FR;5;2022-04-22;113;96;5;4;5;264293;174216;2555;215;3458
FR;5;2022-04-23;209;193;3;2;10;264502;174409;2558;217;3468
FR;5;2022-04-24;37;35;0;0;3;264539;174444;2558;217;3471
FR;5;2022-04-25;69;65;1;1;4;264608;174509;2559;218;3475
FR;5;2022-04-26;60;63;2;1;5;264668;174572;2561;219;3480
FR;5;2022-04-27;335;316;2;7;14;265003;174888;2563;226;3494
FR;5;2022-04-28;80;54;4;5;8;265083;174942;2567;231;3502
FR;5;2022-04-29;117;84;5;18;12;265200;175026;2572;249;3514
FR;5;2022-04-30;183;114;2;3;10;265383;175140;2574;252;3524
FR;5;2022-05-01;11;7;0;0;0;265394;175147;2574;252;3524
FR;5;2022-05-02;52;28;4;5;2;265446;175175;2578;257;3526
FR;5;2022-05-03;84;57;2;5;11;265530;175232;2580;262;3537
FR;5;2022-05-04;278;205;1;2;7;265808;175437;2581;264;3544
FR;5;2022-05-05;62;32;3;4;5;265870;175469;2584;268;3549
FR;5;2022-05-06;105;65;2;3;5;265975;175534;2586;271;3554
FR;5;2022-05-07;171;117;3;10;13;266146;175651;2589;281;3567
FR;5;2022-05-08;8;8;0;0;2;266154;175659;2589;281;3569
FR;5;2022-05-09;44;34;15;3;16;266198;175693;2604;284;3585
FR;5;2022-05-10;54;49;3;4;5;266252;175742;2607;288;3590
FR;5;2022-05-11;326;237;12;7;21;266578;175979;2619;295;3611
FR;5;2022-05-12;46;34;2;3;2;266624;176013;2621;298;3613
FR;5;2022-05-13;109;83;3;8;8;266733;176096;2624;306;3621
FR;5;2022-05-14;209;131;0;1;8;266942;176227;2624;307;3629
FR;5;2022-05-15;22;9;2;0;1;266964;176236;2626;307;3630
FR;5;2022-05-16;52;34;4;5;4;267016;176270;2630;312;3634
FR;5;2022-05-17;72;40;5;0;2;267088;176310;2635;312;3636
FR;5;2022-05-18;289;214;4;4;8;267377;176524;2639;316;3644
FR;5;2022-05-19;45;35;5;3;3;267422;176559;2644;319;3647
FR;5;2022-05-20;76;63;3;10;1;267498;176622;2647;329;3648
FR;5;2022-05-21;242;166;2;3;17;267740;176788;2649;332;3665
FR;5;2022-05-22;20;14;2;5;2;267760;176802;2651;337;3667
FR;5;2022-05-23;42;31;4;3;6;267802;176833;2655;340;3673
FR;5;2022-05-24;47;45;3;2;5;267849;176878;2658;342;3678
FR;5;2022-05-25;329;256;4;1;16;268178;177134;2662;343;3694
FR;5;2022-05-26;17;5;0;1;2;268195;177139;2662;344;3696
FR;5;2022-05-27;99;54;4;4;9;268294;177193;2666;348;3705
FR;5;2022-05-28;99;78;5;3;10;268393;177271;2671;351;3715
FR;5;2022-05-29;14;14;1;0;2;268407;177285;2672;351;3717
FR;5;2022-05-30;56;41;2;1;2;268463;177326;2674;352;3719
FR;5;2022-05-31;57;43;1;8;1;268520;177369;2675;360;3720
FR;5;2022-06-01;257;241;9;2;25;268777;177610;2684;362;3745
FR;5;2022-06-02;63;61;5;0;9;268840;177671;2689;362;3754
FR;5;2022-06-03;81;71;4;5;10;268921;177742;2693;367;3764
FR;5;2022-06-04;156;109;2;1;9;269077;177851;2695;368;3773
FR;5;2022-06-05;17;11;0;0;1;269094;177862;2695;368;3774
FR;5;2022-06-06;16;9;0;1;0;269110;177871;2695;369;3774
FR;5;2022-06-07;49;56;1;1;2;269159;177927;2696;370;3776
FR;5;2022-06-08;283;225;3;4;17;269442;178152;2699;374;3793
FR;5;2022-06-09;52;41;6;3;7;269494;178193;2705;377;3800
FR;5;2022-06-10;80;72;1;1;6;269574;178265;2706;378;3806
FR;5;2022-06-11;172;141;3;3;10;269746;178406;2709;381;3816
FR;5;2022-06-12;17;16;0;0;2;269763;178422;2709;381;3818
FR;5;2022-06-13;56;47;9;3;10;269819;178469;2718;384;3828
FR;5;2022-06-14;59;56;1;3;6;269878;178525;2719;387;3834
FR;5;2022-06-15;266;260;5;2;27;270144;178785;2724;389;3861
FR;5;2022-06-16;47;29;5;2;5;270191;178814;2729;391;3866
FR;5;2022-06-17;98;67;5;5;10;270289;178881;2734;396;3876
FR;5;2022-06-18;146;95;10;2;26;270435;178976;2744;398;3902
FR;5;2022-06-19;26;15;0;1;4;270461;178991;2744;399;3906
FR;5;2022-06-20;56;49;8;0;11;270517;179040;2752;399;3917
FR;5;2022-06-21;51;73;5;3;7;270568;179113;2757;402;3924
FR;5;2022-06-22;222;246;7;9;33;270790;179359;2764;411;3957
FR;5;2022-06-23;50;36;2;5;6;270840;179395;2766;416;3963
FR;5;2022-06-24;91;68;12;5;16;270931;179463;2778;421;3979
FR;5;2022-06-25;154;124;3;7;14;271085;179587;2781;428;3993
FR;5;2022-06-26;26;19;2;0;5;271111;179606;2783;428;3998
FR;5;2022-06-27;57;60;5;7;11;271168;179666;2788;435;4009
FR;5;2022-06-28;70;49;8;2;14;271238;179715;2796;437;4023
FR;5;2022-06-29;297;268;9;21;34;271535;179983;2805;458;4057
FR;5;2022-06-30;86;57;10;12;17;271621;180040;2815;470;4074
FR;5;2022-07-01;124;65;7;11;12;271745;180105;2822;481;4086
FR;5;2022-07-02;191;131;4;0;22;271936;180236;2826;481;4108
FR;5;2022-07-03;30;25;1;0;4;271966;180261;2827;481;4112
FR;5;2022-07-04;101;64;2;5;6;272067;180325;2829;486;4118
FR;5;2022-07-05;104;72;3;8;13;272171;180397;2832;494;4131
FR;5;2022-07-06;278;168;9;36;27;272449;180565;2841;530;4158
FR;5;2022-07-07;87;68;6;9;13;272536;180633;2847;539;4171
FR;5;2022-07-08;152;120;7;14;25;272688;180753;2854;553;4196
FR;5;2022-07-09;116;68;1;8;10;272804;180821;2855;561;4206
FR;5;2022-07-10;15;6;0;0;1;272819;180827;2855;561;4207
FR;5;2022-07-11;92;72;10;2;19;272911;180899;2865;563;4226
FR;5;2022-07-12;66;63;5;9;7;272977;180962;2870;572;4233
FR;5;2022-07-13;167;117;10;19;16;273144;181079;2880;591;4249
FR;5;2022-07-14;8;4;0;0;0;273152;181083;2880;591;4249
FR;5;2022-07-15;74;66;5;14;15;273226;181149;2885;605;4264
FR;5;2022-07-16;54;44;3;0;3;273280;181193;2888;605;4267
FR;5;2022-07-17;10;7;0;0;1;273290;181200;2888;605;4268
FR;5;2022-07-18;60;46;0;5;3;273350;181246;2888;610;4271
FR;5;2022-07-19;63;42;5;3;7;273413;181288;2893;613;4278
FR;5;2022-07-20;118;106;4;11;14;273531;181394;2897;624;4292
FR;5;2022-07-21;38;42;2;10;5;273569;181436;2899;634;4297
FR;5;2022-07-22;45;69;11;14;23;273614;181505;2910;648;4320
FR;5;2022-07-23;58;78;2;1;11;273672;181583;2912;649;4331
FR;5;2022-07-24;11;9;3;1;3;273683;181592;2915;650;4334
FR;5;2022-07-25;53;48;2;7;8;273736;181640;2917;657;4342
FR;5;2022-07-26;57;52;5;41;6;273793;181692;2922;698;4348
FR;5;2022-07-27;105;117;4;4;13;273898;181809;2926;702;4361
FR;5;2022-07-28;39;35;2;2;6;273937;181844;2928;704;4367
FR;5;2022-07-29;56;72;3;13;8;273993;181916;2931;717;4375
FR;5;2022-07-30;53;53;5;1;7;274046;181969;2936;718;4382
FR;5;2022-07-31;7;11;1;0;1;274053;181980;2937;718;4383
FR;5;2022-08-01;38;51;1;2;6;274091;182031;2938;720;4389
FR;5;2022-08-02;30;43;8;7;8;274121;182074;2946;727;4397
FR;5;2022-08-03;54;50;4;10;9;274175;182124;2950;737;4406
FR;5;2022-08-04;20;18;1;6;1;274195;182142;2951;743;4407
FR;5;2022-08-05;33;24;3;3;3;274228;182166;2954;746;4410
FR;5;2022-08-06;23;26;0;0;0;274251;182192;2954;746;4410
FR;5;2022-08-07;2;2;0;0;1;274253;182194;2954;746;4411
FR;5;2022-08-08;23;19;1;2;2;274276;182213;2955;748;4413
FR;5;2022-08-09;24;25;3;2;3;274300;182238;2958;750;4416
FR;6;2020-12-27;0;0;0;0;0;0;0;0;0;0
FR;6;2020-12-28;0;0;0;0;0;0;0;0;0;0
FR;6;2020-12-29;0;0;0;0;0;0;0;0;0;0
FR;6;2020-12-30;0;0;0;0;0;0;0;0;0;0
FR;6;2020-12-31;0;0;0;0;0;0;0;0;0;0
FR;6;2021-01-01;0;0;0;0;0;0;0;0;0;0
FR;6;2021-01-02;0;0;0;0;0;0;0;0;0;0
FR;6;2021-01-03;0;0;0;0;0;0;0;0;0;0
FR;6;2021-01-04;0;0;0;0;0;0;0;0;0;0
FR;6;2021-01-05;0;0;0;0;0;0;0;0;0;0
FR;6;2021-01-06;0;0;0;0;0;0;0;0;0;0
FR;6;2021-01-07;0;0;0;0;0;0;0;0;0;0
FR;6;2021-01-08;0;0;0;0;0;0;0;0;0;0
FR;6;2021-01-09;0;0;0;0;0;0;0;0;0;0
FR;6;2021-01-10;0;0;0;0;0;0;0;0;0;0
FR;6;2021-01-11;0;0;0;0;0;0;0;0;0;0
FR;6;2021-01-12;0;0;0;0;0;0;0;0;0;0
FR;6;2021-01-13;0;0;0;0;0;0;0;0;0;0
FR;6;2021-01-14;0;0;0;0;0;0;0;0;0;0
FR;6;2021-01-15;0;0;0;0;0;0;0;0;0;0
FR;6;2021-01-16;0;0;0;0;0;0;0;0;0;0
FR;6;2021-01-17;0;0;0;0;0;0;0;0;0;0
FR;6;2021-01-18;0;0;0;0;0;0;0;0;0;0
FR;6;2021-01-19;0;0;0;0;0;0;0;0;0;0
FR;6;2021-01-20;0;0;0;0;0;0;0;0;0;0
FR;6;2021-01-21;0;0;0;0;0;0;0;0;0;0
FR;6;2021-01-22;0;0;0;0;0;0;0;0;0;0
FR;6;2021-01-23;0;0;0;0;0;0;0;0;0;0
FR;6;2021-01-24;0;0;0;0;0;0;0;0;0;0
FR;6;2021-01-25;0;0;0;0;0;0;0;0;0;0
FR;6;2021-01-26;0;0;0;0;0;0;0;0;0;0
FR;6;2021-01-27;0;0;0;0;0;0;0;0;0;0
FR;6;2021-01-28;0;0;0;0;0;0;0;0;0;0
FR;6;2021-01-29;0;0;0;0;0;0;0;0;0;0
FR;6;2021-01-30;0;0;0;0;0;0;0;0;0;0
FR;6;2021-01-31;0;0;0;0;0;0;0;0;0;0
FR;6;2021-02-01;0;0;0;0;0;0;0;0;0;0
FR;6;2021-02-02;0;0;0;0;0;0;0;0;0;0
FR;6;2021-02-03;0;0;0;0;0;0;0;0;0;0
FR;6;2021-02-04;0;0;0;0;0;0;0;0;0;0
FR;6;2021-02-05;0;0;0;0;0;0;0;0;0;0
FR;6;2021-02-06;0;0;0;0;0;0;0;0;0;0
FR;6;2021-02-07;0;0;0;0;0;0;0;0;0;0
FR;6;2021-02-08;0;0;0;0;0;0;0;0;0;0
FR;6;2021-02-09;0;0;0;0;0;0;0;0;0;0
FR;6;2021-02-10;0;0;0;0;0;0;0;0;0;0
FR;6;2021-02-11;0;0;0;0;0;0;0;0;0;0
FR;6;2021-02-12;0;0;0;0;0;0;0;0;0;0
FR;6;2021-02-13;0;0;0;0;0;0;0;0;0;0
FR;6;2021-02-14;0;0;0;0;0;0;0;0;0;0
FR;6;2021-02-15;0;0;0;0;0;0;0;0;0;0
FR;6;2021-02-16;0;0;0;0;0;0;0;0;0;0
FR;6;2021-02-17;0;0;0;0;0;0;0;0;0;0
FR;6;2021-02-18;0;0;0;0;0;0;0;0;0;0
FR;6;2021-02-19;0;0;0;0;0;0;0;0;0;0
FR;6;2021-02-20;0;0;0;0;0;0;0;0;0;0
FR;6;2021-02-21;0;0;0;0;0;0;0;0;0;0
FR;6;2021-02-22;0;0;0;0;0;0;0;0;0;0
FR;6;2021-02-23;0;0;0;0;0;0;0;0;0;0
FR;6;2021-02-24;0;0;0;0;0;0;0;0;0;0
FR;6;2021-02-25;0;0;0;0;0;0;0;0;0;0
FR;6;2021-02-26;0;0;0;0;0;0;0;0;0;0
FR;6;2021-02-27;0;0;0;0;0;0;0;0;0;0
FR;6;2021-02-28;0;0;0;0;0;0;0;0;0;0
FR;6;2021-03-01;0;0;0;0;0;0;0;0;0;0
FR;6;2021-03-02;0;0;0;0;0;0;0;0;0;0
FR;6;2021-03-03;0;0;0;0;0;0;0;0;0;0
FR;6;2021-03-04;0;0;0;0;0;0;0;0;0;0
FR;6;2021-03-05;0;0;0;0;0;0;0;0;0;0
FR;6;2021-03-06;0;0;0;0;0;0;0;0;0;0
FR;6;2021-03-07;0;0;0;0;0;0;0;0;0;0
FR;6;2021-03-08;0;0;0;0;0;0;0;0;0;0
FR;6;2021-03-09;0;0;0;0;0;0;0;0;0;0
FR;6;2021-03-10;0;0;0;0;0;0;0;0;0;0
FR;6;2021-03-11;0;0;0;0;0;0;0;0;0;0
FR;6;2021-03-12;0;0;0;0;0;0;0;0;0;0
FR;6;2021-03-13;0;0;0;0;0;0;0;0;0;0
FR;6;2021-03-14;0;0;0;0;0;0;0;0;0;0
FR;6;2021-03-15;0;0;0;0;0;0;0;0;0;0
FR;6;2021-03-16;0;0;0;0;0;0;0;0;0;0
FR;6;2021-03-17;0;0;0;0;0;0;0;0;0;0
FR;6;2021-03-18;0;0;0;0;0;0;0;0;0;0
FR;6;2021-03-19;0;0;0;0;0;0;0;0;0;0
FR;6;2021-03-20;0;0;0;0;0;0;0;0;0;0
FR;6;2021-03-21;0;0;0;0;0;0;0;0;0;0
FR;6;2021-03-22;0;0;0;0;0;0;0;0;0;0
FR;6;2021-03-23;0;0;0;0;0;0;0;0;0;0
FR;6;2021-03-24;0;0;0;0;0;0;0;0;0;0
FR;6;2021-03-25;0;0;0;0;0;0;0;0;0;0
FR;6;2021-03-26;0;0;0;0;0;0;0;0;0;0
FR;6;2021-03-27;0;0;0;0;0;0;0;0;0;0
FR;6;2021-03-28;0;0;0;0;0;0;0;0;0;0
FR;6;2021-03-29;0;0;0;0;0;0;0;0;0;0
FR;6;2021-03-30;0;0;0;0;0;0;0;0;0;0
FR;6;2021-03-31;0;0;0;0;0;0;0;0;0;0
FR;6;2021-04-01;0;0;0;0;0;0;0;0;0;0
FR;6;2021-04-02;0;0;0;0;0;0;0;0;0;0
FR;6;2021-04-03;0;0;0;0;0;0;0;0;0;0
FR;6;2021-04-04;0;0;0;0;0;0;0;0;0;0
FR;6;2021-04-05;0;0;0;0;0;0;0;0;0;0
FR;6;2021-04-06;0;0;0;0;0;0;0;0;0;0
FR;6;2021-04-07;0;0;0;0;0;0;0;0;0;0
FR;6;2021-04-08;0;0;0;0;0;0;0;0;0;0
FR;6;2021-04-09;0;0;0;0;0;0;0;0;0;0
FR;6;2021-04-10;0;0;0;0;0;0;0;0;0;0
FR;6;2021-04-11;0;0;0;0;0;0;0;0;0;0
FR;6;2021-04-12;0;0;0;0;0;0;0;0;0;0
FR;6;2021-04-13;0;0;0;0;0;0;0;0;0;0
FR;6;2021-04-14;0;0;0;0;0;0;0;0;0;0
FR;6;2021-04-15;0;0;0;0;0;0;0;0;0;0
FR;6;2021-04-16;0;0;0;0;0;0;0;0;0;0
FR;6;2021-04-17;0;0;0;0;0;0;0;0;0;0
FR;6;2021-04-18;0;0;0;0;0;0;0;0;0;0
FR;6;2021-04-19;0;0;0;0;0;0;0;0;0;0
FR;6;2021-04-20;0;0;0;0;0;0;0;0;0;0
FR;6;2021-04-21;0;0;0;0;0;0;0;0;0;0
FR;6;2021-04-22;0;0;0;0;0;0;0;0;0;0
FR;6;2021-04-23;0;0;0;0;0;0;0;0;0;0
FR;6;2021-04-24;0;0;0;0;0;0;0;0;0;0
FR;6;2021-04-25;0;0;0;0;0;0;0;0;0;0
FR;6;2021-04-26;0;0;0;0;0;0;0;0;0;0
FR;6;2021-04-27;0;0;0;0;0;0;0;0;0;0
FR;6;2021-04-28;0;0;0;0;0;0;0;0;0;0
FR;6;2021-04-29;0;0;0;0;0;0;0;0;0;0
FR;6;2021-04-30;0;0;0;0;0;0;0;0;0;0
FR;6;2021-05-01;0;0;0;0;0;0;0;0;0;0
FR;6;2021-05-02;0;0;0;0;0;0;0;0;0;0
FR;6;2021-05-03;0;0;0;0;0;0;0;0;0;0
FR;6;2021-05-04;0;0;0;0;0;0;0;0;0;0
FR;6;2021-05-05;0;0;0;0;0;0;0;0;0;0
FR;6;2021-05-06;0;0;0;0;0;0;0;0;0;0
FR;6;2021-05-07;0;0;0;0;0;0;0;0;0;0
FR;6;2021-05-08;0;0;0;0;0;0;0;0;0;0
FR;6;2021-05-09;0;0;0;0;0;0;0;0;0;0
FR;6;2021-05-10;0;0;0;0;0;0;0;0;0;0
FR;6;2021-05-11;0;0;0;0;0;0;0;0;0;0
FR;6;2021-05-12;0;0;0;0;0;0;0;0;0;0
FR;6;2021-05-13;0;0;0;0;0;0;0;0;0;0
FR;6;2021-05-14;0;0;0;0;0;0;0;0;0;0
FR;6;2021-05-15;0;0;0;0;0;0;0;0;0;0
FR;6;2021-05-16;0;0;0;0;0;0;0;0;0;0
FR;6;2021-05-17;0;0;0;0;0;0;0;0;0;0
FR;6;2021-05-18;0;0;0;0;0;0;0;0;0;0
FR;6;2021-05-19;0;0;0;0;0;0;0;0;0;0
FR;6;2021-05-20;0;0;0;0;0;0;0;0;0;0
FR;6;2021-05-21;0;0;0;0;0;0;0;0;0;0
FR;6;2021-05-22;0;0;0;0;0;0;0;0;0;0
FR;6;2021-05-23;0;0;0;0;0;0;0;0;0;0
FR;6;2021-05-24;0;0;0;0;0;0;0;0;0;0
FR;6;2021-05-25;0;0;0;0;0;0;0;0;0;0
FR;6;2021-05-26;0;0;0;0;0;0;0;0;0;0
FR;6;2021-05-27;0;0;0;0;0;0;0;0;0;0
FR;6;2021-05-28;0;0;0;0;0;0;0;0;0;0
FR;6;2021-05-29;0;0;0;0;0;0;0;0;0;0
FR;6;2021-05-30;0;0;0;0;0;0;0;0;0;0
FR;6;2021-05-31;0;0;0;0;0;0;0;0;0;0
FR;6;2021-06-01;0;0;0;0;0;0;0;0;0;0
FR;6;2021-06-02;0;0;0;0;0;0;0;0;0;0
FR;6;2021-06-03;0;0;0;0;0;0;0;0;0;0
FR;6;2021-06-04;0;0;0;0;0;0;0;0;0;0
FR;6;2021-06-05;0;0;0;0;0;0;0;0;0;0
FR;6;2021-06-06;0;0;0;0;0;0;0;0;0;0
FR;6;2021-06-07;0;0;0;0;0;0;0;0;0;0
FR;6;2021-06-08;0;0;0;0;0;0;0;0;0;0
FR;6;2021-06-09;0;0;0;0;0;0;0;0;0;0
FR;6;2021-06-10;0;0;0;0;0;0;0;0;0;0
FR;6;2021-06-11;0;0;0;0;0;0;0;0;0;0
FR;6;2021-06-12;0;0;0;0;0;0;0;0;0;0
FR;6;2021-06-13;0;0;0;0;0;0;0;0;0;0
FR;6;2021-06-14;0;0;0;0;0;0;0;0;0;0
FR;6;2021-06-15;0;0;0;0;0;0;0;0;0;0
FR;6;2021-06-16;0;0;0;0;0;0;0;0;0;0
FR;6;2021-06-17;0;0;0;0;0;0;0;0;0;0
FR;6;2021-06-18;0;0;0;0;0;0;0;0;0;0
FR;6;2021-06-19;0;0;0;0;0;0;0;0;0;0
FR;6;2021-06-20;0;0;0;0;0;0;0;0;0;0
FR;6;2021-06-21;0;0;0;0;0;0;0;0;0;0
FR;6;2021-06-22;0;0;0;0;0;0;0;0;0;0
FR;6;2021-06-23;0;0;0;0;0;0;0;0;0;0
FR;6;2021-06-24;0;0;0;0;0;0;0;0;0;0
FR;6;2021-06-25;0;0;0;0;0;0;0;0;0;0
FR;6;2021-06-26;0;0;0;0;0;0;0;0;0;0
FR;6;2021-06-27;0;0;0;0;0;0;0;0;0;0
FR;6;2021-06-28;0;0;0;0;0;0;0;0;0;0
FR;6;2021-06-29;0;0;0;0;0;0;0;0;0;0
FR;6;2021-06-30;0;0;0;0;0;0;0;0;0;0
FR;6;2021-07-01;0;0;0;0;0;0;0;0;0;0
FR;6;2021-07-02;0;0;0;0;0;0;0;0;0;0
FR;6;2021-07-03;0;0;0;0;0;0;0;0;0;0
FR;6;2021-07-04;0;0;0;0;0;0;0;0;0;0
FR;6;2021-07-05;0;0;0;0;0;0;0;0;0;0
FR;6;2021-07-06;0;0;0;0;0;0;0;0;0;0
FR;6;2021-07-07;0;0;0;0;0;0;0;0;0;0
FR;6;2021-07-08;0;0;0;0;0;0;0;0;0;0
FR;6;2021-07-09;0;0;0;0;0;0;0;0;0;0
FR;6;2021-07-10;0;0;0;0;0;0;0;0;0;0
FR;6;2021-07-11;0;0;0;0;0;0;0;0;0;0
FR;6;2021-07-12;0;0;0;0;0;0;0;0;0;0
FR;6;2021-07-13;0;0;0;0;0;0;0;0;0;0
FR;6;2021-07-14;0;0;0;0;0;0;0;0;0;0
FR;6;2021-07-15;0;0;0;0;0;0;0;0;0;0
FR;6;2021-07-16;0;0;0;0;0;0;0;0;0;0
FR;6;2021-07-17;0;0;0;0;0;0;0;0;0;0
FR;6;2021-07-18;0;0;0;0;0;0;0;0;0;0
FR;6;2021-07-19;0;0;0;0;0;0;0;0;0;0
FR;6;2021-07-20;0;0;0;0;0;0;0;0;0;0
FR;6;2021-07-21;0;0;0;0;0;0;0;0;0;0
FR;6;2021-07-22;0;0;0;0;0;0;0;0;0;0
FR;6;2021-07-23;0;0;0;0;0;0;0;0;0;0
FR;6;2021-07-24;0;0;0;0;0;0;0;0;0;0
FR;6;2021-07-25;0;0;0;0;0;0;0;0;0;0
FR;6;2021-07-26;0;0;0;0;0;0;0;0;0;0
FR;6;2021-07-27;0;0;0;0;0;0;0;0;0;0
FR;6;2021-07-28;0;0;0;0;0;0;0;0;0;0
FR;6;2021-07-29;0;0;0;0;0;0;0;0;0;0
FR;6;2021-07-30;0;0;0;0;0;0;0;0;0;0
FR;6;2021-07-31;0;0;0;0;0;0;0;0;0;0
FR;6;2021-08-01;0;0;0;0;0;0;0;0;0;0
FR;6;2021-08-02;0;0;0;0;0;0;0;0;0;0
FR;6;2021-08-03;0;0;0;0;0;0;0;0;0;0
FR;6;2021-08-04;0;0;0;0;0;0;0;0;0;0
FR;6;2021-08-05;0;0;0;0;0;0;0;0;0;0
FR;6;2021-08-06;0;0;0;0;0;0;0;0;0;0
FR;6;2021-08-07;0;0;0;0;0;0;0;0;0;0
FR;6;2021-08-08;0;0;0;0;0;0;0;0;0;0
FR;6;2021-08-09;0;0;0;0;0;0;0;0;0;0
FR;6;2021-08-10;0;0;0;0;0;0;0;0;0;0
FR;6;2021-08-11;0;0;0;0;0;0;0;0;0;0
FR;6;2021-08-12;0;0;0;0;0;0;0;0;0;0
FR;6;2021-08-13;0;0;0;0;0;0;0;0;0;0
FR;6;2021-08-14;0;0;0;0;0;0;0;0;0;0
FR;6;2021-08-15;0;0;0;0;0;0;0;0;0;0
FR;6;2021-08-16;0;0;0;0;0;0;0;0;0;0
FR;6;2021-08-17;0;0;0;0;0;0;0;0;0;0
FR;6;2021-08-18;0;0;0;0;0;0;0;0;0;0
FR;6;2021-08-19;0;0;0;0;0;0;0;0;0;0
FR;6;2021-08-20;0;0;0;0;0;0;0;0;0;0
FR;6;2021-08-21;0;0;0;0;0;0;0;0;0;0
FR;6;2021-08-22;0;0;0;0;0;0;0;0;0;0
FR;6;2021-08-23;0;0;0;0;0;0;0;0;0;0
FR;6;2021-08-24;0;0;0;0;0;0;0;0;0;0
FR;6;2021-08-25;0;0;0;0;0;0;0;0;0;0
FR;6;2021-08-26;0;0;0;0;0;0;0;0;0;0
FR;6;2021-08-27;0;0;0;0;0;0;0;0;0;0
FR;6;2021-08-28;0;0;0;0;0;0;0;0;0;0
FR;6;2021-08-29;0;0;0;0;0;0;0;0;0;0
FR;6;2021-08-30;0;0;0;0;0;0;0;0;0;0
FR;6;2021-08-31;0;0;0;0;0;0;0;0;0;0
FR;6;2021-09-01;0;0;0;0;0;0;0;0;0;0
FR;6;2021-09-02;0;0;0;0;0;0;0;0;0;0
FR;6;2021-09-03;0;0;0;0;0;0;0;0;0;0
FR;6;2021-09-04;0;0;0;0;0;0;0;0;0;0
FR;6;2021-09-05;0;0;0;0;0;0;0;0;0;0
FR;6;2021-09-06;0;0;0;0;0;0;0;0;0;0
FR;6;2021-09-07;0;0;0;0;0;0;0;0;0;0
FR;6;2021-09-08;0;0;0;0;0;0;0;0;0;0
FR;6;2021-09-09;0;0;0;0;0;0;0;0;0;0
FR;6;2021-09-10;0;0;0;0;0;0;0;0;0;0
FR;6;2021-09-11;0;0;0;0;0;0;0;0;0;0
FR;6;2021-09-12;0;0;0;0;0;0;0;0;0;0
FR;6;2021-09-13;0;0;0;0;0;0;0;0;0;0
FR;6;2021-09-14;0;0;0;0;0;0;0;0;0;0
FR;6;2021-09-15;0;0;0;0;0;0;0;0;0;0
FR;6;2021-09-16;0;0;0;0;0;0;0;0;0;0
FR;6;2021-09-17;0;0;0;0;0;0;0;0;0;0
FR;6;2021-09-18;0;0;0;0;0;0;0;0;0;0
FR;6;2021-09-19;0;0;0;0;0;0;0;0;0;0
FR;6;2021-09-20;0;0;0;0;0;0;0;0;0;0
FR;6;2021-09-21;0;0;0;0;0;0;0;0;0;0
FR;6;2021-09-22;0;0;0;0;0;0;0;0;0;0
FR;6;2021-09-23;0;0;0;0;0;0;0;0;0;0
FR;6;2021-09-24;0;0;0;0;0;0;0;0;0;0
FR;6;2021-09-25;0;0;0;0;0;0;0;0;0;0
FR;6;2021-09-26;0;0;0;0;0;0;0;0;0;0
FR;6;2021-09-27;0;0;0;0;0;0;0;0;0;0
FR;6;2021-09-28;0;0;0;0;0;0;0;0;0;0
FR;6;2021-09-29;0;0;0;0;0;0;0;0;0;0
FR;6;2021-09-30;0;0;0;0;0;0;0;0;0;0
FR;6;2021-10-01;0;0;0;0;0;0;0;0;0;0
FR;6;2021-10-02;0;0;0;0;0;0;0;0;0;0
FR;6;2021-10-03;0;0;0;0;0;0;0;0;0;0
FR;6;2021-10-04;0;0;0;0;0;0;0;0;0;0
FR;6;2021-10-05;0;0;0;0;0;0;0;0;0;0
FR;6;2021-10-06;0;0;0;0;0;0;0;0;0;0
FR;6;2021-10-07;0;0;0;0;0;0;0;0;0;0
FR;6;2021-10-08;0;0;0;0;0;0;0;0;0;0
FR;6;2021-10-09;0;0;0;0;0;0;0;0;0;0
FR;6;2021-10-10;0;0;0;0;0;0;0;0;0;0
FR;6;2021-10-11;0;0;0;0;0;0;0;0;0;0
FR;6;2021-10-12;0;0;0;0;0;0;0;0;0;0
FR;6;2021-10-13;0;0;0;0;0;0;0;0;0;0
FR;6;2021-10-14;0;0;0;0;0;0;0;0;0;0
FR;6;2021-10-15;0;0;0;0;0;0;0;0;0;0
FR;6;2021-10-16;0;0;0;0;0;0;0;0;0;0
FR;6;2021-10-17;0;0;0;0;0;0;0;0;0;0
FR;6;2021-10-18;0;0;0;0;0;0;0;0;0;0
FR;6;2021-10-19;0;0;0;0;0;0;0;0;0;0
FR;6;2021-10-20;0;0;0;0;0;0;0;0;0;0
FR;6;2021-10-21;0;0;0;0;0;0;0;0;0;0
FR;6;2021-10-22;0;0;0;0;0;0;0;0;0;0
FR;6;2021-10-23;0;0;0;0;0;0;0;0;0;0
FR;6;2021-10-24;0;0;0;0;0;0;0;0;0;0
FR;6;2021-10-25;0;0;0;0;0;0;0;0;0;0
FR;6;2021-10-26;0;0;0;0;0;0;0;0;0;0
FR;6;2021-10-27;0;0;0;0;0;0;0;0;0;0
FR;6;2021-10-28;0;0;0;0;0;0;0;0;0;0
FR;6;2021-10-29;0;0;0;0;0;0;0;0;0;0
FR;6;2021-10-30;0;0;0;0;0;0;0;0;0;0
FR;6;2021-10-31;0;0;0;0;0;0;0;0;0;0
FR;6;2021-11-01;0;0;0;0;0;0;0;0;0;0
FR;6;2021-11-02;0;0;0;0;0;0;0;0;0;0
FR;6;2021-11-03;0;0;0;0;0;0;0;0;0;0
FR;6;2021-11-04;0;0;0;0;0;0;0;0;0;0
FR;6;2021-11-05;0;0;0;0;0;0;0;0;0;0
FR;6;2021-11-06;0;0;0;0;0;0;0;0;0;0
FR;6;2021-11-07;0;0;0;0;0;0;0;0;0;0
FR;6;2021-11-08;0;0;0;0;0;0;0;0;0;0
FR;6;2021-11-09;0;0;0;0;0;0;0;0;0;0
FR;6;2021-11-10;0;0;0;0;0;0;0;0;0;0
FR;6;2021-11-11;0;0;0;0;0;0;0;0;0;0
FR;6;2021-11-12;0;0;0;0;0;0;0;0;0;0
FR;6;2021-11-13;0;0;0;0;0;0;0;0;0;0
FR;6;2021-11-14;0;0;0;0;0;0;0;0;0;0
FR;6;2021-11-15;0;0;0;0;0;0;0;0;0;0
FR;6;2021-11-16;0;0;0;0;0;0;0;0;0;0
FR;6;2021-11-17;0;0;0;0;0;0;0;0;0;0
FR;6;2021-11-18;0;0;0;0;0;0;0;0;0;0
FR;6;2021-11-19;0;0;0;0;0;0;0;0;0;0
FR;6;2021-11-20;0;0;0;0;0;0;0;0;0;0
FR;6;2021-11-21;0;0;0;0;0;0;0;0;0;0
FR;6;2021-11-22;0;0;0;0;0;0;0;0;0;0
FR;6;2021-11-23;0;0;0;0;0;0;0;0;0;0
FR;6;2021-11-24;0;0;0;0;0;0;0;0;0;0
FR;6;2021-11-25;0;0;0;0;0;0;0;0;0;0
FR;6;2021-11-26;0;0;0;0;0;0;0;0;0;0
FR;6;2021-11-27;0;0;0;0;0;0;0;0;0;0
FR;6;2021-11-28;0;0;0;0;0;0;0;0;0;0
FR;6;2021-11-29;0;0;0;0;0;0;0;0;0;0
FR;6;2021-11-30;0;0;0;0;0;0;0;0;0;0
FR;6;2021-12-01;0;0;0;0;0;0;0;0;0;0
FR;6;2021-12-02;0;0;0;0;0;0;0;0;0;0
FR;6;2021-12-03;0;0;0;0;0;0;0;0;0;0
FR;6;2021-12-04;0;0;0;0;0;0;0;0;0;0
FR;6;2021-12-05;0;0;0;0;0;0;0;0;0;0
FR;6;2021-12-06;0;0;0;0;0;0;0;0;0;0
FR;6;2021-12-07;0;0;0;0;0;0;0;0;0;0
FR;6;2021-12-08;0;0;0;0;0;0;0;0;0;0
FR;6;2021-12-09;0;0;0;0;0;0;0;0;0;0
FR;6;2021-12-10;0;0;0;0;0;0;0;0;0;0
FR;6;2021-12-11;0;0;0;0;0;0;0;0;0;0
FR;6;2021-12-12;0;0;0;0;0;0;0;0;0;0
FR;6;2021-12-13;0;0;0;0;0;0;0;0;0;0
FR;6;2021-12-14;0;0;0;0;0;0;0;0;0;0
FR;6;2021-12-15;0;0;0;0;0;0;0;0;0;0
FR;6;2021-12-16;0;0;0;0;0;0;0;0;0;0
FR;6;2021-12-17;0;0;0;0;0;0;0;0;0;0
FR;6;2021-12-18;0;0;0;0;0;0;0;0;0;0
FR;6;2021-12-19;0;0;0;0;0;0;0;0;0;0
FR;6;2021-12-20;0;0;0;0;0;0;0;0;0;0
FR;6;2021-12-21;0;0;0;0;0;0;0;0;0;0
FR;6;2021-12-22;0;0;0;0;0;0;0;0;0;0
FR;6;2021-12-23;0;0;0;0;0;0;0;0;0;0
FR;6;2021-12-24;0;0;0;0;0;0;0;0;0;0
FR;6;2021-12-25;0;0;0;0;0;0;0;0;0;0
FR;6;2021-12-26;0;0;0;0;0;0;0;0;0;0
FR;6;2021-12-27;0;0;0;0;0;0;0;0;0;0
FR;6;2021-12-28;0;0;0;0;0;0;0;0;0;0
FR;6;2021-12-29;0;0;0;0;0;0;0;0;0;0
FR;6;2021-12-30;0;0;0;0;0;0;0;0;0;0
FR;6;2021-12-31;0;0;0;0;0;0;0;0;0;0
FR;6;2022-01-01;0;0;0;0;0;0;0;0;0;0
FR;6;2022-01-02;0;0;0;0;0;0;0;0;0;0
FR;6;2022-01-03;0;0;0;0;0;0;0;0;0;0
FR;6;2022-01-04;0;0;0;0;0;0;0;0;0;0
FR;6;2022-01-05;0;0;0;0;0;0;0;0;0;0
FR;6;2022-01-06;0;0;0;0;0;0;0;0;0;0
FR;6;2022-01-07;0;0;0;0;0;0;0;0;0;0
FR;6;2022-01-08;0;0;0;0;0;0;0;0;0;0
FR;6;2022-01-09;0;0;0;0;0;0;0;0;0;0
FR;6;2022-01-10;0;0;0;0;0;0;0;0;0;0
FR;6;2022-01-11;0;0;0;0;0;0;0;0;0;0
FR;6;2022-01-12;0;0;0;0;0;0;0;0;0;0
FR;6;2022-01-13;0;0;0;0;0;0;0;0;0;0
FR;6;2022-01-14;0;0;0;0;0;0;0;0;0;0
FR;6;2022-01-15;0;0;0;0;0;0;0;0;0;0
FR;6;2022-01-16;0;0;0;0;0;0;0;0;0;0
FR;6;2022-01-17;0;0;0;0;0;0;0;0;0;0
FR;6;2022-01-18;0;0;0;0;0;0;0;0;0;0
FR;6;2022-01-19;0;0;0;0;0;0;0;0;0;0
FR;6;2022-01-20;0;0;0;0;0;0;0;0;0;0
FR;6;2022-01-21;0;0;0;0;0;0;0;0;0;0
FR;6;2022-01-22;0;0;0;0;0;0;0;0;0;0
FR;6;2022-01-23;0;0;0;0;0;0;0;0;0;0
FR;6;2022-01-24;0;0;0;0;0;0;0;0;0;0
FR;6;2022-01-25;0;0;0;0;0;0;0;0;0;0
FR;6;2022-01-26;0;0;0;0;0;0;0;0;0;0
FR;6;2022-01-27;0;0;0;0;0;0;0;0;0;0
FR;6;2022-01-28;0;0;0;0;0;0;0;0;0;0
FR;6;2022-01-29;0;0;0;0;0;0;0;0;0;0
FR;6;2022-01-30;0;0;0;0;0;0;0;0;0;0
FR;6;2022-01-31;0;0;0;0;0;0;0;0;0;0
FR;6;2022-02-01;0;0;0;0;0;0;0;0;0;0
FR;6;2022-02-02;0;0;0;0;0;0;0;0;0;0
FR;6;2022-02-03;0;0;0;0;0;0;0;0;0;0
FR;6;2022-02-04;0;0;0;0;0;0;0;0;0;0
FR;6;2022-02-05;0;0;0;0;0;0;0;0;0;0
FR;6;2022-02-06;0;0;0;0;0;0;0;0;0;0
FR;6;2022-02-07;0;0;0;0;0;0;0;0;0;0
FR;6;2022-02-08;0;0;0;0;0;0;0;0;0;0
FR;6;2022-02-09;0;0;0;0;0;0;0;0;0;0
FR;6;2022-02-10;0;0;0;0;0;0;0;0;0;0
FR;6;2022-02-11;0;0;0;0;0;0;0;0;0;0
FR;6;2022-02-12;0;0;0;0;0;0;0;0;0;0
FR;6;2022-02-13;0;0;0;0;0;0;0;0;0;0
FR;6;2022-02-14;0;0;0;0;0;0;0;0;0;0
FR;6;2022-02-15;0;0;0;0;0;0;0;0;0;0
FR;6;2022-02-16;0;0;0;0;0;0;0;0;0;0
FR;6;2022-02-17;0;0;0;0;0;0;0;0;0;0
FR;6;2022-02-18;0;0;0;0;0;0;0;0;0;0
FR;6;2022-02-19;0;0;0;0;0;0;0;0;0;0
FR;6;2022-02-20;0;0;0;0;0;0;0;0;0;0
FR;6;2022-02-21;0;0;0;0;0;0;0;0;0;0
FR;6;2022-02-22;0;0;0;0;0;0;0;0;0;0
FR;6;2022-02-23;0;0;0;0;0;0;0;0;0;0
FR;6;2022-02-24;0;0;0;0;0;0;0;0;0;0
FR;6;2022-02-25;0;0;0;0;0;0;0;0;0;0
FR;6;2022-02-26;1;0;0;0;0;1;0;0;0;0
FR;6;2022-02-27;0;0;0;0;0;1;0;0;0;0
FR;6;2022-02-28;0;0;0;0;0;1;0;0;0;0
FR;6;2022-03-01;3;0;0;0;0;4;0;0;0;0
FR;6;2022-03-02;97;9;2;0;7;101;9;2;0;7
FR;6;2022-03-03;0;0;0;0;0;101;9;2;0;7
FR;6;2022-03-04;91;4;0;0;4;192;13;2;0;11
FR;6;2022-03-05;391;23;2;0;14;583;36;4;0;25
FR;6;2022-03-06;7;1;0;0;0;590;37;4;0;25
FR;6;2022-03-07;337;19;0;0;13;927;56;4;0;38
FR;6;2022-03-08;230;14;0;0;5;1157;70;4;0;43
FR;6;2022-03-09;519;29;2;0;21;1676;99;6;0;64
FR;6;2022-03-10;206;19;0;1;12;1882;118;6;1;76
FR;6;2022-03-11;328;21;6;0;21;2210;139;12;1;97
FR;6;2022-03-12;518;25;1;0;20;2728;164;13;1;117
FR;6;2022-03-13;40;2;0;0;1;2768;166;13;1;118
FR;6;2022-03-14;201;4;2;0;3;2969;170;15;1;121
FR;6;2022-03-15;112;11;2;0;9;3081;181;17;1;130
FR;6;2022-03-16;310;17;1;1;14;3391;198;18;2;144
FR;6;2022-03-17;117;6;1;2;4;3508;204;19;4;148
FR;6;2022-03-18;215;10;0;0;6;3723;214;19;4;154
FR;6;2022-03-19;307;19;2;0;9;4030;233;21;4;163
FR;6;2022-03-20;15;5;0;0;1;4045;238;21;4;164
FR;6;2022-03-21;132;23;1;0;4;4177;261;22;4;168
FR;6;2022-03-22;97;15;0;0;4;4274;276;22;4;172
FR;6;2022-03-23;226;108;3;0;14;4500;384;25;4;186
FR;6;2022-03-24;100;15;1;3;4;4600;399;26;7;190
FR;6;2022-03-25;203;141;2;1;15;4803;540;28;8;205
FR;6;2022-03-26;331;295;7;1;19;5134;835;35;9;224
FR;6;2022-03-27;32;30;1;0;1;5166;865;36;9;225
FR;6;2022-03-28;200;208;8;1;17;5366;1073;44;10;242
FR;6;2022-03-29;124;189;12;2;12;5490;1262;56;12;254
FR;6;2022-03-30;305;476;10;2;22;5795;1738;66;14;276
FR;6;2022-03-31;123;140;10;0;14;5918;1878;76;14;290
FR;6;2022-04-01;195;150;11;2;23;6113;2028;87;16;313
FR;6;2022-04-02;206;241;9;1;13;6319;2269;96;17;326
FR;6;2022-04-03;17;21;0;0;1;6336;2290;96;17;327
FR;6;2022-04-04;137;114;6;1;9;6473;2404;102;18;336
FR;6;2022-04-05;145;88;15;1;11;6618;2492;117;19;347
FR;6;2022-04-06;204;245;22;26;27;6822;2737;139;45;374
FR;6;2022-04-07;127;96;15;9;17;6949;2833;154;54;391
FR;6;2022-04-08;199;170;16;3;17;7148;3003;170;57;408
FR;6;2022-04-09;145;139;6;12;13;7293;3142;176;69;421
FR;6;2022-04-10;10;20;3;0;1;7303;3162;179;69;422
FR;6;2022-04-11;101;106;4;0;5;7404;3268;183;69;427
FR;6;2022-04-12;136;75;5;8;10;7540;3343;188;77;437
FR;6;2022-04-13;162;175;7;5;13;7702;3518;195;82;450
FR;6;2022-04-14;100;103;5;10;8;7802;3621;200;92;458
FR;6;2022-04-15;158;148;11;7;19;7960;3769;211;99;477
FR;6;2022-04-16;127;132;5;0;14;8087;3901;216;99;491
FR;6;2022-04-17;8;9;4;0;4;8095;3910;220;99;495
FR;6;2022-04-18;8;15;3;0;4;8103;3925;223;99;499
FR;6;2022-04-19;97;112;4;3;3;8200;4037;227;102;502
FR;6;2022-04-20;177;227;8;7;15;8377;4264;235;109;517
FR;6;2022-04-21;111;93;8;4;11;8488;4357;243;113;528
FR;6;2022-04-22;138;160;13;12;13;8626;4517;256;125;541
FR;6;2022-04-23;106;129;1;1;7;8732;4646;257;126;548
FR;6;2022-04-24;5;21;1;0;0;8737;4667;258;126;548
FR;6;2022-04-25;91;128;3;8;11;8828;4795;261;134;559
FR;6;2022-04-26;101;128;18;2;16;8929;4923;279;136;575
FR;6;2022-04-27;197;159;21;1;27;9126;5082;300;137;602
FR;6;2022-04-28;109;87;7;1;8;9235;5169;307;138;610
FR;6;2022-04-29;191;168;16;2;20;9426;5337;323;140;630
FR;6;2022-04-30;133;125;7;1;24;9559;5462;330;141;654
FR;6;2022-05-01;7;6;0;0;0;9566;5468;330;141;654
FR;6;2022-05-02;94;66;3;4;3;9660;5534;333;145;657
FR;6;2022-05-03;136;92;11;2;7;9796;5626;344;147;664
FR;6;2022-05-04;167;118;25;12;29;9963;5744;369;159;693
FR;6;2022-05-05;101;70;8;3;12;10064;5814;377;162;705
FR;6;2022-05-06;152;110;10;9;16;10216;5924;387;171;721
FR;6;2022-05-07;139;93;13;3;23;10355;6017;400;174;744
FR;6;2022-05-08;20;8;6;5;7;10375;6025;406;179;751
FR;6;2022-05-09;86;78;9;7;13;10461;6103;415;186;764
FR;6;2022-05-10;111;80;15;7;12;10572;6183;430;193;776
FR;6;2022-05-11;130;124;11;14;20;10702;6307;441;207;796
FR;6;2022-05-12;105;76;7;5;15;10807;6383;448;212;811
FR;6;2022-05-13;154;97;17;21;22;10961;6480;465;233;833
FR;6;2022-05-14;81;60;6;7;15;11042;6540;471;240;848
FR;6;2022-05-15;12;7;0;0;0;11054;6547;471;240;848
FR;6;2022-05-16;64;54;6;2;12;11118;6601;477;242;860
FR;6;2022-05-17;123;77;5;7;11;11241;6678;482;249;871
FR;6;2022-05-18;131;116;5;1;13;11372;6794;487;250;884
FR;6;2022-05-19;124;57;6;8;9;11496;6851;493;258;893
FR;6;2022-05-20;126;115;13;3;18;11622;6966;506;261;911
FR;6;2022-05-21;92;69;14;3;12;11714;7035;520;264;923
FR;6;2022-05-22;19;12;5;0;4;11733;7047;525;264;927
FR;6;2022-05-23;77;72;4;2;7;11810;7119;529;266;934
FR;6;2022-05-24;116;98;8;2;16;11926;7217;537;268;950
FR;6;2022-05-25;139;129;6;3;11;12065;7346;543;271;961
FR;6;2022-05-26;7;9;3;0;9;12072;7355;546;271;970
FR;6;2022-05-27;127;105;15;11;18;12199;7460;561;282;988
FR;6;2022-05-28;53;75;1;5;8;12252;7535;562;287;996
FR;6;2022-05-29;8;10;0;0;1;12260;7545;562;287;997
FR;6;2022-05-30;70;70;7;4;4;12330;7615;569;291;1001
FR;6;2022-05-31;87;102;10;2;14;12417;7717;579;293;1015
FR;6;2022-06-01;97;89;10;1;11;12514;7806;589;294;1026
FR;6;2022-06-02;91;60;6;3;9;12605;7866;595;297;1035
FR;6;2022-06-03;126;102;13;7;21;12731;7968;608;304;1056
FR;6;2022-06-04;63;51;10;0;12;12794;8019;618;304;1068
FR;6;2022-06-05;16;15;2;1;4;12810;8034;620;305;1072
FR;6;2022-06-06;9;6;0;0;0;12819;8040;620;305;1072
FR;6;2022-06-07;79;90;3;4;8;12898;8130;623;309;1080
FR;6;2022-06-08;92;110;13;5;20;12990;8240;636;314;1100
FR;6;2022-06-09;75;81;15;3;15;13065;8321;651;317;1115
FR;6;2022-06-10;116;93;26;10;22;13181;8414;677;327;1137
FR;6;2022-06-11;83;62;6;10;12;13264;8476;683;337;1149
FR;6;2022-06-12;6;14;1;0;2;13270;8490;684;337;1151
FR;6;2022-06-13;74;59;18;1;7;13344;8549;702;338;1158
FR;6;2022-06-14;98;100;8;5;16;13442;8649;710;343;1174
FR;6;2022-06-15;80;85;7;8;15;13522;8734;717;351;1189
FR;6;2022-06-16;53;40;11;7;14;13575;8774;728;358;1203
FR;6;2022-06-17;85;85;3;13;11;13660;8859;731;371;1214
FR;6;2022-06-18;71;61;13;0;21;13731;8920;744;371;1235
FR;6;2022-06-19;6;6;3;0;4;13737;8926;747;371;1239
FR;6;2022-06-20;42;41;4;1;6;13779;8967;751;372;1245
FR;6;2022-06-21;59;73;10;7;17;13838;9040;761;379;1262
FR;6;2022-06-22;86;85;8;2;17;13924;9125;769;381;1279
FR;6;2022-06-23;64;39;13;7;15;13988;9164;782;388;1294
FR;6;2022-06-24;77;85;7;14;20;14065;9249;789;402;1314
FR;6;2022-06-25;67;61;4;3;8;14132;9310;793;405;1322
FR;6;2022-06-26;6;7;1;0;1;14138;9317;794;405;1323
FR;6;2022-06-27;53;50;4;9;12;14191;9367;798;414;1335
FR;6;2022-06-28;68;47;5;3;15;14259;9414;803;417;1350
FR;6;2022-06-29;97;117;26;37;19;14356;9531;829;454;1369
FR;6;2022-06-30;84;59;33;10;12;14440;9590;862;464;1381
FR;6;2022-07-01;115;94;25;33;18;14555;9684;887;497;1399
FR;6;2022-07-02;57;67;26;2;37;14612;9751;913;499;1436
FR;6;2022-07-03;11;4;4;3;4;14623;9755;917;502;1440
FR;6;2022-07-04;61;43;3;23;13;14684;9798;920;525;1453
FR;6;2022-07-05;65;53;19;67;27;14749;9851;939;592;1480
FR;6;2022-07-06;94;64;7;11;12;14843;9915;946;603;1492
FR;6;2022-07-07;97;79;42;37;14;14940;9994;988;640;1506
FR;6;2022-07-08;138;87;42;27;10;15078;10081;1030;667;1516
FR;6;2022-07-09;53;50;16;29;26;15131;10131;1046;696;1542
FR;6;2022-07-10;3;7;8;0;9;15134;10138;1054;696;1551
FR;6;2022-07-11;54;44;5;4;12;15188;10182;1059;700;1563
FR;6;2022-07-12;70;72;12;22;12;15258;10254;1071;722;1575
FR;6;2022-07-13;84;65;14;21;25;15342;10319;1085;743;1600
FR;6;2022-07-14;4;3;1;0;1;15346;10322;1086;743;1601
FR;6;2022-07-15;74;59;9;57;16;15420;10381;1095;800;1617
FR;6;2022-07-16;27;31;17;0;17;15447;10412;1112;800;1634
FR;6;2022-07-17;3;7;0;0;0;15450;10419;1112;800;1634
FR;6;2022-07-18;37;62;11;14;15;15487;10481;1123;814;1649
FR;6;2022-07-19;54;48;4;19;6;15541;10529;1127;833;1655
FR;6;2022-07-20;53;70;7;22;11;15594;10599;1134;855;1666
FR;6;2022-07-21;49;59;4;5;11;15643;10658;1138;860;1677
FR;6;2022-07-22;55;73;6;24;7;15698;10731;1144;884;1684
FR;6;2022-07-23;38;40;6;10;6;15736;10771;1150;894;1690
FR;6;2022-07-24;11;14;1;3;3;15747;10785;1151;897;1693
FR;6;2022-07-25;60;44;8;12;9;15807;10829;1159;909;1702
FR;6;2022-07-26;47;64;14;6;10;15854;10893;1173;915;1712
FR;6;2022-07-27;53;78;15;11;17;15907;10971;1188;926;1729
FR;6;2022-07-28;30;48;4;6;8;15937;11019;1192;932;1737
FR;6;2022-07-29;43;71;10;38;24;15980;11090;1202;970;1761
FR;6;2022-07-30;24;46;4;15;7;16004;11136;1206;985;1768
FR;6;2022-07-31;0;1;1;0;0;16004;11137;1207;985;1768
FR;6;2022-08-01;38;35;14;8;9;16042;11172;1221;993;1777
FR;6;2022-08-02;37;45;10;14;6;16079;11217;1231;1007;1783
FR;6;2022-08-03;29;52;7;16;11;16108;11269;1238;1023;1794
FR;6;2022-08-04;25;21;4;9;6;16133;11290;1242;1032;1800
FR;6;2022-08-05;43;45;1;7;5;16176;11335;1243;1039;1805
FR;6;2022-08-06;17;24;1;3;2;16193;11359;1244;1042;1807
FR;6;2022-08-07;1;2;0;0;0;16194;11361;1244;1042;1807
FR;6;2022-08-08;23;33;1;0;1;16217;11394;1245;1042;1808
FR;6;2022-08-09;22;29;5;2;2;16239;11423;1250;1044;1810
FR;0;2020-12-27;609;0;0;0;0;609;0;0;0;0
FR;0;2020-12-28;682;1;0;0;0;1291;1;0;0;0
FR;0;2020-12-29;384;0;0;0;0;1675;1;0;0;0
FR;0;2020-12-30;443;0;0;0;0;2118;1;0;0;0
FR;0;2020-12-31;439;1;0;0;0;2557;2;0;0;0
FR;0;2021-01-01;1154;2;0;0;0;3711;4;0;0;0
FR;0;2021-01-02;362;3;0;0;0;4073;7;0;0;0
FR;0;2021-01-03;404;0;0;0;0;4477;7;0;0;0
FR;0;2021-01-04;2103;4;0;0;0;6580;11;0;0;0
FR;0;2021-01-05;7748;3;0;0;0;14328;14;0;0;0
FR;0;2021-01-06;12455;16;0;0;0;26783;30;0;0;0
FR;0;2021-01-07;29461;16;0;0;0;56244;46;0;0;0
FR;0;2021-01-08;37141;17;0;0;0;93385;63;0;0;0
FR;0;2021-01-09;11212;7;0;0;0;104597;70;0;0;0
FR;0;2021-01-10;6005;7;0;0;0;110602;77;0;0;0
FR;0;2021-01-11;39934;21;0;0;0;150536;98;0;0;0
FR;0;2021-01-12;62138;19;0;0;0;212674;117;0;0;0
FR;0;2021-01-13;65116;41;0;0;0;277790;158;0;0;0
FR;0;2021-01-14;83116;143;0;0;0;360906;301;0;0;0
FR;0;2021-01-15;69006;54;0;0;0;429912;355;0;0;0
FR;0;2021-01-16;20215;72;0;0;0;450127;427;0;0;0
FR;0;2021-01-17;10985;51;0;0;0;461112;478;0;0;0
FR;0;2021-01-18;85900;168;0;0;0;547012;646;0;0;0
FR;0;2021-01-19;130595;186;0;0;0;677607;832;0;0;0
FR;0;2021-01-20;137543;188;0;0;0;815150;1020;0;0;0
FR;0;2021-01-21;158399;181;0;0;0;973549;1201;0;0;0
FR;0;2021-01-22;121061;232;0;0;0;1094610;1433;0;0;0
FR;0;2021-01-23;38478;69;0;0;0;1133088;1502;0;0;0
FR;0;2021-01-24;9745;100;0;0;0;1142833;1602;0;0;0
FR;0;2021-01-25;78237;1333;0;0;0;1221070;2935;0;0;0
FR;0;2021-01-26;100375;3472;1;0;0;1321445;6407;1;0;0
FR;0;2021-01-27;107239;6093;0;0;0;1428684;12500;1;0;0
FR;0;2021-01-28;124352;15516;0;0;0;1553036;28016;1;0;0
FR;0;2021-01-29;92186;18105;0;0;0;1645222;46121;1;0;0
FR;0;2021-01-30;29121;4400;0;0;0;1674343;50521;1;0;0
FR;0;2021-01-31;5233;1809;0;0;0;1679576;52330;1;0;0
FR;0;2021-02-01;53125;21963;0;0;0;1732701;74293;1;0;0
FR;0;2021-02-02;72304;36661;0;0;0;1805005;110954;1;0;0
FR;0;2021-02-03;72304;38853;0;0;0;1877309;149807;1;0;0
FR;0;2021-02-04;82074;52914;0;0;0;1959383;202721;1;0;0
FR;0;2021-02-05;68227;46789;0;0;0;2027610;249510;1;0;0
FR;0;2021-02-06;23048;11036;0;0;0;2050658;260546;1;0;0
FR;0;2021-02-07;5187;5574;0;0;0;2055845;266120;1;0;0
FR;0;2021-02-08;46835;47556;0;0;0;2102680;313676;1;0;0
FR;0;2021-02-09;66003;76011;0;0;0;2168683;389687;1;0;0
FR;0;2021-02-10;71014;80719;0;0;0;2239697;470406;1;0;0
FR;0;2021-02-11;87276;103038;0;0;0;2326973;573444;1;0;0
FR;0;2021-02-12;79318;75441;0;0;0;2406291;648885;1;0;0
FR;0;2021-02-13;22379;19573;0;0;0;2428670;668458;1;0;0
FR;0;2021-02-14;5075;7371;0;0;0;2433745;675829;1;0;0
FR;0;2021-02-15;38090;76833;0;0;0;2471835;752662;1;0;0
FR;0;2021-02-16;50396;100571;0;0;0;2522231;853233;1;0;0
FR;0;2021-02-17;50528;105624;20;0;0;2572759;958857;21;0;0
FR;0;2021-02-18;69787;121760;0;0;0;2642546;1080617;21;0;0
FR;0;2021-02-19;65066;91671;1;0;0;2707612;1172288;22;0;0
FR;0;2021-02-20;18586;28693;0;0;0;2726198;1200981;22;0;0
FR;0;2021-02-21;3318;6203;0;0;0;2729516;1207184;22;0;0
FR;0;2021-02-22;37496;73355;2;0;0;2767012;1280539;24;0;0
FR;0;2021-02-23;53780;84975;1;0;0;2820792;1365514;25;0;0
FR;0;2021-02-24;60017;82319;1;0;0;2880809;1447833;26;0;0
FR;0;2021-02-25;100579;91436;1;0;0;2981388;1539269;27;0;0
FR;0;2021-02-26;113464;70783;1;0;0;3094852;1610052;28;0;0
FR;0;2021-02-27;52101;22311;1;0;0;3146953;1632363;29;0;0
FR;0;2021-02-28;6197;4215;2;0;0;3153150;1636578;31;0;0
FR;0;2021-03-01;65881;53717;1;0;0;3219031;1690295;32;0;0
FR;0;2021-03-02;101376;66982;3;0;0;3320407;1757277;35;0;0
FR;0;2021-03-03;116518;65447;0;0;0;3436925;1822724;35;0;0
FR;0;2021-03-04;163619;71410;3;0;0;3600544;1894134;38;0;0
FR;0;2021-03-05;200922;62867;3;0;0;3801466;1957001;41;0;0
FR;0;2021-03-06;207955;17628;3;0;0;4009421;1974629;44;0;0
FR;0;2021-03-07;121275;4602;1;0;0;4130696;1979231;45;0;0
FR;0;2021-03-08;107143;50051;2;0;0;4237839;2029282;47;0;0
FR;0;2021-03-09;172450;56359;2;0;0;4410289;2085641;49;0;0
FR;0;2021-03-10;178987;57181;5;0;0;4589276;2142822;54;0;0
FR;0;2021-03-11;242889;63851;2;0;0;4832165;2206673;56;0;0
FR;0;2021-03-12;294814;53449;1;0;0;5126979;2260122;57;0;0
FR;0;2021-03-13;231401;15275;1;0;0;5358380;2275397;58;0;0
FR;0;2021-03-14;63350;3201;1;0;0;5421730;2278598;59;0;0
FR;0;2021-03-15;158653;31955;3;0;0;5580383;2310553;62;0;0
FR;0;2021-03-16;141565;39014;6;0;0;5721948;2349567;68;0;0
FR;0;2021-03-17;150480;37915;4;0;0;5872428;2387482;72;0;0
FR;0;2021-03-18;167832;44456;5;0;0;6040260;2431938;77;0;0
FR;0;2021-03-19;229994;37020;2;0;0;6270254;2468958;79;0;0
FR;0;2021-03-20;166678;11491;1;0;0;6436932;2480449;80;0;0
FR;0;2021-03-21;49941;2316;1;0;0;6486873;2482765;81;0;0
FR;0;2021-03-22;170045;33876;2;0;0;6656918;2516641;83;0;0
FR;0;2021-03-23;250380;42355;1;0;0;6907298;2558996;84;0;0
FR;0;2021-03-24;256898;43658;0;0;0;7164196;2602654;84;0;0
FR;0;2021-03-25;341804;44996;5;0;0;7506000;2647650;89;0;0
FR;0;2021-03-26;358797;41903;5;1;0;7864797;2689553;94;1;0
FR;0;2021-03-27;195255;16869;1;0;0;8060052;2706422;95;1;0
FR;0;2021-03-28;59338;4350;3;0;0;8119390;2710772;98;1;0
FR;0;2021-03-29;202967;53690;4;0;0;8322357;2764462;102;1;0
FR;0;2021-03-30;285471;69885;5;0;0;8607828;2834347;107;1;0
FR;0;2021-03-31;263029;73609;4;0;0;8870857;2907956;111;1;0
FR;0;2021-04-01;315465;91094;11;0;0;9186322;2999050;122;1;0
FR;0;2021-04-02;281328;93818;7;0;0;9467650;3092868;129;1;0
FR;0;2021-04-03;141074;62261;6;0;0;9608724;3155129;135;1;0
FR;0;2021-04-04;46529;18881;2;0;0;9655253;3174010;137;1;0
FR;0;2021-04-05;63335;10639;11;0;0;9718588;3184649;148;1;0
FR;0;2021-04-06;217204;111055;17;0;0;9935792;3295704;165;1;0
FR;0;2021-04-07;260247;115305;17;0;0;10196039;3411009;182;1;0
FR;0;2021-04-08;337826;122313;14;0;0;10533865;3533322;196;1;0
FR;0;2021-04-09;410142;116699;49;0;0;10944007;3650021;245;1;0
FR;0;2021-04-10;212615;82752;15;0;0;11156622;3732773;260;1;0
FR;0;2021-04-11;56141;34311;7;0;0;11212763;3767084;267;1;0
FR;0;2021-04-12;237066;115558;46;0;0;11449829;3882642;313;1;0
FR;0;2021-04-13;309479;144350;98;1;0;11759308;4026992;411;2;0
FR;0;2021-04-14;294514;139474;214;0;0;12053822;4166466;625;2;0
FR;0;2021-04-15;337096;149491;338;0;0;12390918;4315957;963;2;0
FR;0;2021-04-16;339276;146339;353;0;0;12730194;4462296;1316;2;0
FR;0;2021-04-17;188652;89948;109;0;0;12918846;4552244;1425;2;0
FR;0;2021-04-18;51616;35384;47;0;0;12970462;4587628;1472;2;0
FR;0;2021-04-19;205679;138190;456;0;0;13176141;4725818;1928;2;0
FR;0;2021-04-20;254409;171327;569;0;0;13430550;4897145;2497;2;0
FR;0;2021-04-21;253254;169434;835;0;0;13683804;5066579;3332;2;0
FR;0;2021-04-22;287552;189416;818;0;0;13971356;5255995;4150;2;0
FR;0;2021-04-23;297826;183838;747;0;0;14269182;5439833;4897;2;0
FR;0;2021-04-24;190443;111741;252;0;0;14459625;5551574;5149;2;0
FR;0;2021-04-25;69556;38799;51;0;0;14529181;5590373;5200;2;0
FR;0;2021-04-26;220947;157298;563;0;0;14750128;5747671;5763;2;0
FR;0;2021-04-27;284599;187601;940;0;0;15034727;5935272;6703;2;0
FR;0;2021-04-28;299496;183854;1426;1;1;15334223;6119126;8129;3;1
FR;0;2021-04-29;357121;197216;1277;0;0;15691344;6316342;9406;3;1
FR;0;2021-04-30;372201;185331;1121;1;0;16063545;6501673;10527;4;1
FR;0;2021-05-01;167634;52502;179;0;0;16231179;6554175;10706;4;1
FR;0;2021-05-02;91736;37781;83;0;0;16322915;6591956;10789;4;1
FR;0;2021-05-03;288909;167195;842;0;0;16611824;6759151;11631;4;1
FR;0;2021-05-04;315660;224895;1232;0;0;16927484;6984046;12863;4;1
FR;0;2021-05-05;327182;225534;1314;0;0;17254666;7209580;14177;4;1
FR;0;2021-05-06;379503;240166;1632;0;0;17634169;7449746;15809;4;1
FR;0;2021-05-07;372744;257915;1222;0;0;18006913;7707661;17031;4;1
FR;0;2021-05-08;222157;69325;299;0;0;18229070;7776986;17330;4;1
FR;0;2021-05-09;129699;45615;243;0;0;18358769;7822601;17573;4;1
FR;0;2021-05-10;313376;229151;1235;0;0;18672145;8051752;18808;4;1
FR;0;2021-05-11;403886;257985;1565;0;0;19076031;8309737;20373;4;1
FR;0;2021-05-12;434100;233429;1542;0;0;19510131;8543166;21915;4;1
FR;0;2021-05-13;338593;56714;431;0;0;19848724;8599880;22346;4;1
FR;0;2021-05-14;454114;167367;1126;0;0;20302838;8767247;23472;4;1
FR;0;2021-05-15;374965;94190;443;0;0;20677803;8861437;23915;4;1
FR;0;2021-05-16;202748;20711;168;0;0;20880551;8882148;24083;4;1
FR;0;2021-05-17;376106;148748;1553;0;0;21256657;9030896;25636;4;1
FR;0;2021-05-18;460125;153546;1988;0;0;21716782;9184442;27624;4;1
FR;0;2021-05-19;467389;143731;2460;0;0;22184171;9328173;30084;4;1
FR;0;2021-05-20;507511;160288;2336;0;0;22691682;9488461;32420;4;1
FR;0;2021-05-21;489654;174767;1995;0;0;23181336;9663228;34415;4;1
FR;0;2021-05-22;347180;80006;668;0;0;23528516;9743234;35083;4;1
FR;0;2021-05-23;161688;14280;246;0;0;23690204;9757514;35329;4;1
FR;0;2021-05-24;263185;33165;604;0;0;23953389;9790679;35933;4;1
FR;0;2021-05-25;400264;189874;2351;1;0;24353653;9980553;38284;5;1
FR;0;2021-05-26;413448;189593;2221;0;0;24767101;10170146;40505;5;1
FR;0;2021-05-27;449789;219318;2161;0;0;25216890;10389464;42666;5;1
FR;0;2021-05-28;429539;260191;1892;0;0;25646429;10649655;44558;5;1
FR;0;2021-05-29;298974;149884;585;0;0;25945403;10799539;45143;5;1
FR;0;2021-05-30;107142;32562;163;0;0;26052545;10832101;45306;5;1
FR;0;2021-05-31;358030;203324;1468;1;1;26410575;11035425;46774;6;2
FR;0;2021-06-01;430996;251369;1962;1;1;26841571;11286794;48736;7;3
FR;0;2021-06-02;420089;231456;1984;0;0;27261660;11518250;50720;7;3
FR;0;2021-06-03;465593;258151;1823;0;0;27727253;11776401;52543;7;3
FR;0;2021-06-04;456223;305235;1732;1;1;28183476;12081636;54275;8;4
FR;0;2021-06-05;304795;189206;652;0;0;28488271;12270842;54927;8;4
FR;0;2021-06-06;133298;49047;226;0;0;28621569;12319889;55153;8;4
FR;0;2021-06-07;339841;261729;1525;0;0;28961410;12581618;56678;8;4
FR;0;2021-06-08;393836;291021;1803;0;0;29355246;12872639;58481;8;4
FR;0;2021-06-09;384842;274763;1729;0;0;29740088;13147402;60210;8;4
FR;0;2021-06-10;404156;288261;1724;1;0;30144244;13435663;61934;9;4
FR;0;2021-06-11;386629;356820;1467;0;0;30530873;13792483;63401;9;4
FR;0;2021-06-12;283251;211086;494;0;0;30814124;14003569;63895;9;4
FR;0;2021-06-13;104882;73883;204;0;0;30919006;14077452;64099;9;4
FR;0;2021-06-14;240821;354774;1426;1;0;31159827;14432226;65525;10;4
FR;0;2021-06-15;308133;385060;1568;1;0;31467960;14817286;67093;11;4
FR;0;2021-06-16;313967;357494;1418;1;0;31781927;15174780;68511;12;4
FR;0;2021-06-17;317663;372738;1426;1;0;32099590;15547518;69937;13;4
FR;0;2021-06-18;321729;442579;1336;1;0;32421319;15990097;71273;14;4
FR;0;2021-06-19;224338;273851;449;0;0;32645657;16263948;71722;14;4
FR;0;2021-06-20;74422;102453;129;0;0;32720079;16366401;71851;14;4
FR;0;2021-06-21;195749;401748;1037;1;1;32915828;16768149;72888;15;5
FR;0;2021-06-22;223183;467433;1264;10;2;33139011;17235582;74152;25;7
FR;0;2021-06-23;234012;439983;1197;1;1;33373023;17675565;75349;26;8
FR;0;2021-06-24;241849;409543;1356;0;0;33614872;18085108;76705;26;8
FR;0;2021-06-25;227623;522641;1400;0;0;33842495;18607749;78105;26;8
FR;0;2021-06-26;153239;370806;587;1;0;33995734;18978555;78692;27;8
FR;0;2021-06-27;55895;156098;168;1;0;34051629;19134653;78860;28;8
FR;0;2021-06-28;154765;452737;1175;0;0;34206394;19587390;80035;28;8
FR;0;2021-06-29;182682;507197;2124;0;0;34389076;20094587;82159;28;8
FR;0;2021-06-30;203993;484869;2014;21;2;34593069;20579456;84173;49;10
FR;0;2021-07-01;231320;458110;2223;5;1;34824389;21037566;86396;54;11
FR;0;2021-07-02;228623;520142;2120;5;2;35053012;21557708;88516;59;13
FR;0;2021-07-03;142036;368736;908;3;1;35195048;21926444;89424;62;14
FR;0;2021-07-04;56736;141109;265;0;0;35251784;22067553;89689;62;14
FR;0;2021-07-05;168488;419048;1668;8;2;35420272;22486601;91357;70;16
FR;0;2021-07-06;196749;474627;1829;45;8;35617021;22961228;93186;115;24
FR;0;2021-07-07;213146;439150;1878;25;4;35830167;23400378;95064;140;28
FR;0;2021-07-08;231620;424175;2089;20;6;36061787;23824553;97153;160;34
FR;0;2021-07-09;228579;511007;2184;4;2;36290366;24335560;99337;164;36
FR;0;2021-07-10;148598;339914;983;1;1;36438964;24675474;100320;165;37
FR;0;2021-07-11;60192;110119;283;0;0;36499156;24785593;100603;165;37
FR;0;2021-07-12;169287;478061;1761;4;0;36668443;25263654;102364;169;37
FR;0;2021-07-13;287243;527100;2046;8;1;36955686;25790754;104410;177;38
FR;0;2021-07-14;181067;157535;435;0;0;37136753;25948289;104845;177;38
FR;0;2021-07-15;347070;502155;2099;1;0;37483823;26450444;106944;178;38
FR;0;2021-07-16;380065;495543;2022;3;1;37863888;26945987;108966;181;39
FR;0;2021-07-17;259717;319725;876;1;0;38123605;27265712;109842;182;39
FR;0;2021-07-18;109705;114659;310;0;0;38233310;27380371;110152;182;39
FR;0;2021-07-19;285458;424514;1629;3;0;38518768;27804885;111781;185;39
FR;0;2021-07-20;376885;451926;1723;0;0;38895653;28256811;113504;185;39
FR;0;2021-07-21;395764;407437;1549;4;2;39291417;28664248;115053;189;41
FR;0;2021-07-22;441022;387757;1715;4;2;39732439;29052005;116768;193;43
FR;0;2021-07-23;440305;422709;1882;4;1;40172744;29474714;118650;197;44
FR;0;2021-07-24;285241;269439;804;1;0;40457985;29744153;119454;198;44
FR;0;2021-07-25;121102;79969;234;0;0;40579087;29824122;119688;198;44
FR;0;2021-07-26;347417;322726;1614;3;2;40926504;30146848;121302;201;46
FR;0;2021-07-27;464044;319803;1697;4;2;41390548;30466651;122999;205;48
FR;0;2021-07-28;459417;289660;1635;4;2;41849965;30756311;124634;209;50
FR;0;2021-07-29;489803;276567;1796;2;0;42339768;31032878;126430;211;50
FR;0;2021-07-30;461802;302630;1941;5;1;42801570;31335508;128371;216;51
FR;0;2021-07-31;285387;185086;914;1;0;43086957;31520594;129285;217;51
FR;0;2021-08-01;111992;49952;252;0;0;43198949;31570546;129537;217;51
FR;0;2021-08-02;341372;234358;1602;2;0;43540321;31804904;131139;219;51
FR;0;2021-08-03;398577;244765;1722;2;1;43938898;32049669;132861;221;52
FR;0;2021-08-04;384812;209883;1592;6;3;44323710;32259552;134453;227;55
FR;0;2021-08-05;366149;228658;1710;0;0;44689859;32488210;136163;227;55
FR;0;2021-08-06;359708;271519;1835;4;1;45049567;32759729;137998;231;56
FR;0;2021-08-07;213110;178359;755;4;3;45262677;32938088;138753;235;59
FR;0;2021-08-08;74191;63214;275;0;0;45336868;33001302;139028;235;59
FR;0;2021-08-09;258725;259123;1547;4;3;45595593;33260425;140575;239;62
FR;0;2021-08-10;306786;277551;1659;2;1;45902379;33537976;142234;241;63
FR;0;2021-08-11;279666;259924;1441;5;1;46182045;33797900;143675;246;64
FR;0;2021-08-12;271493;278366;1662;3;1;46453538;34076266;145337;249;65
FR;0;2021-08-13;252106;278088;1592;3;2;46705644;34354354;146929;252;67
FR;0;2021-08-14;145312;197195;740;0;0;46850956;34551549;147669;252;67
FR;0;2021-08-15;39346;50112;216;1;0;46890302;34601661;147885;253;67
FR;0;2021-08-16;186121;317859;1540;0;0;47076423;34919520;149425;253;67
FR;0;2021-08-17;215629;336204;1636;7;1;47292052;35255724;151061;260;68
FR;0;2021-08-18;199001;324593;1597;7;4;47491053;35580317;152658;267;72
FR;0;2021-08-19;191972;325589;1638;1;0;47683025;35905906;154296;268;72
FR;0;2021-08-20;186420;366357;1817;3;2;47869445;36272263;156113;271;74
FR;0;2021-08-21;104781;238132;705;0;0;47974226;36510395;156818;271;74
FR;0;2021-08-22;31905;87209;255;1;1;48006131;36597604;157073;272;75
FR;0;2021-08-23;140936;357158;1561;3;1;48147067;36954762;158634;275;76
FR;0;2021-08-24;162445;376826;1848;5;1;48309512;37331588;160482;280;77
FR;0;2021-08-25;151103;350829;2033;8;2;48460615;37682417;162515;288;79
FR;0;2021-08-26;142821;342818;2559;10;0;48603436;38025235;165074;298;79
FR;0;2021-08-27;148409;388295;2790;11;3;48751845;38413530;167864;309;82
FR;0;2021-08-28;90646;249587;1404;0;0;48842491;38663117;169268;309;82
FR;0;2021-08-29;27311;83365;518;1;0;48869802;38746482;169786;310;82
FR;0;2021-08-30;117379;324792;4712;6;5978;48987181;39071274;174498;316;6060
FR;0;2021-08-31;128744;334539;10185;19;11823;49115925;39405813;184683;335;17883
FR;0;2021-09-01;135992;285700;22428;7;24374;49251917;39691513;207111;342;42257
FR;0;2021-09-02;114292;247277;26513;20;28943;49366209;39938790;233624;362;71200
FR;0;2021-09-03;118272;292713;29962;24;33026;49484481;40231503;263586;386;104226
FR;0;2021-09-04;89873;217770;12585;12;14112;49574354;40449273;276171;398;118338
FR;0;2021-09-05;21353;44831;4395;2;4722;49595707;40494104;280566;400;123060
FR;0;2021-09-06;75393;180675;31950;16;34295;49671100;40674779;312516;416;157355
FR;0;2021-09-07;80271;181257;33242;43;36229;49751371;40856036;345758;459;193584
FR;0;2021-09-08;90961;206137;29661;28;32518;49842332;41062173;375419;487;226102
FR;0;2021-09-09;76891;165394;33061;27;36599;49919223;41227567;408480;514;262701
FR;0;2021-09-10;95984;203758;35733;28;40625;50015207;41431325;444213;542;303326
FR;0;2021-09-11;67137;169284;12138;19;14370;50082344;41600609;456351;561;317696
FR;0;2021-09-12;12820;32100;2774;1;3174;50095164;41632709;459125;562;320870
FR;0;2021-09-13;64518;126256;41223;34;44146;50159682;41758965;500348;596;365016
FR;0;2021-09-14;73439;129098;56361;79;62228;50233121;41888063;556709;675;427244
FR;0;2021-09-15;76576;167834;55656;58;54823;50309697;42055897;612365;733;482067
FR;0;2021-09-16;63833;114551;60064;83;60075;50373530;42170448;672429;816;542142
FR;0;2021-09-17;75033;156837;53845;71;57277;50448563;42327285;726274;887;599419
FR;0;2021-09-18;48212;139633;15601;25;17311;50496775;42466918;741875;912;616730
FR;0;2021-09-19;7881;23687;2436;1;2615;50504656;42490605;744311;913;619345
FR;0;2021-09-20;44517;93857;50074;72;50318;50549173;42584462;794385;985;669663
FR;0;2021-09-21;45866;98455;62754;75;63435;50595039;42682917;857139;1060;733098
FR;0;2021-09-22;48655;142395;55366;82;55405;50643694;42825312;912505;1142;788503
FR;0;2021-09-23;43236;92076;62383;94;63548;50686930;42917388;974888;1236;852051
FR;0;2021-09-24;52272;133347;54543;107;59166;50739202;43050735;1029431;1343;911217
FR;0;2021-09-25;35211;115610;16272;36;18296;50774413;43166345;1045703;1379;929513
FR;0;2021-09-26;5542;17802;2268;5;2327;50779955;43184147;1047971;1384;931840
FR;0;2021-09-27;33956;76951;47190;97;48153;50813911;43261098;1095161;1481;979993
FR;0;2021-09-28;36484;75273;54960;89;56519;50850395;43336371;1150121;1570;1036512
FR;0;2021-09-29;44381;100818;53342;112;54853;50894776;43437189;1203463;1682;1091365
FR;0;2021-09-30;36305;72933;57030;96;59550;50931081;43510122;1260493;1778;1150915
FR;0;2021-10-01;61678;102478;57802;108;63913;50992759;43612600;1318295;1886;1214828
FR;0;2021-10-02;39453;78424;20960;39;23348;51032212;43691024;1339255;1925;1238176
FR;0;2021-10-03;5284;10499;2529;4;2538;51037496;43701523;1341784;1929;1240714
FR;0;2021-10-04;35130;58532;52614;84;54818;51072626;43760055;1394398;2013;1295532
FR;0;2021-10-05;33854;64343;60999;135;64998;51106480;43824398;1455397;2148;1360530
FR;0;2021-10-06;42683;79320;65738;113;68309;51149163;43903718;1521135;2261;1428839
FR;0;2021-10-07;30511;62256;65419;90;68816;51179674;43965974;1586554;2351;1497655
FR;0;2021-10-08;49438;91907;77744;110;84701;51229112;44057881;1664298;2461;1582356
FR;0;2021-10-09;33648;60940;31539;35;33913;51262760;44118821;1695837;2496;1616269
FR;0;2021-10-10;4701;7442;3192;9;3481;51267461;44126263;1699029;2505;1619750
FR;0;2021-10-11;30685;49943;61038;105;64085;51298146;44176206;1760067;2610;1683835
FR;0;2021-10-12;31584;54480;70602;140;75941;51329730;44230686;1830669;2750;1759776
FR;0;2021-10-13;40090;62831;74425;136;79324;51369820;44293517;1905094;2886;1839100
FR;0;2021-10-14;30303;52895;68751;116;73806;51400123;44346412;1973845;3002;1912906
FR;0;2021-10-15;44888;75294;93233;191;102978;51445011;44421706;2067078;3193;2015884
FR;0;2021-10-16;31298;44122;36690;44;39634;51476309;44465828;2103768;3237;2055518
FR;0;2021-10-17;3839;5244;3593;2;3680;51480148;44471072;2107361;3239;2059198
FR;0;2021-10-18;28914;42411;67490;133;71356;51509062;44513483;2174851;3372;2130554
FR;0;2021-10-19;27147;45618;76399;140;81619;51536209;44559101;2251250;3512;2212173
FR;0;2021-10-20;35286;52459;96936;181;101520;51571495;44611560;2348186;3693;2313693
FR;0;2021-10-21;26104;45202;83952;112;89140;51597599;44656762;2432138;3805;2402833
FR;0;2021-10-22;38407;62498;104889;200;112578;51636006;44719260;2537027;4005;2515411
FR;0;2021-10-23;27001;41227;45455;57;48623;51663007;44760487;2582482;4062;2564034
FR;0;2021-10-24;2918;4780;3681;6;3928;51665925;44765267;2586163;4068;2567962
FR;0;2021-10-25;26004;36282;82325;144;86634;51691929;44801549;2668488;4212;2654596
FR;0;2021-10-26;23720;35056;87242;166;92355;51715649;44836605;2755730;4378;2746951
FR;0;2021-10-27;30073;46397;108997;257;114687;51745722;44883002;2864727;4635;2861638
FR;0;2021-10-28;23577;34970;88698;153;94466;51769299;44917972;2953425;4788;2956104
FR;0;2021-10-29;31561;51490;117315;204;125339;51800860;44969462;3070740;4992;3081443
FR;0;2021-10-30;20550;33224;50345;76;53386;51821410;45002686;3121085;5068;3134829
FR;0;2021-10-31;2487;3740;3589;3;3877;51823897;45006426;3124674;5071;3138706
FR;0;2021-11-01;8402;4866;3210;3;3572;51832299;45011292;3127884;5074;3142278
FR;0;2021-11-02;25990;40135;93575;156;99579;51858289;45051427;3221459;5230;3241857
FR;0;2021-11-03;30062;47977;118885;218;125838;51888351;45099404;3340344;5448;3367695
FR;0;2021-11-04;23770;37524;107562;217;114412;51912121;45136928;3447906;5665;3482107
FR;0;2021-11-05;32362;53000;141632;235;151363;51944483;45189928;3589538;5900;3633470
FR;0;2021-11-06;21516;34581;64883;123;68300;51965999;45224509;3654421;6023;3701770
FR;0;2021-11-07;2399;4186;5194;6;5591;51968398;45228695;3659615;6029;3707361
FR;0;2021-11-08;20581;37814;127186;227;134295;51988979;45266509;3786801;6256;3841656
FR;0;2021-11-09;22393;44762;161679;339;172241;52011372;45311271;3948480;6595;4013897
FR;0;2021-11-10;31563;55059;186997;446;198791;52042935;45366330;4135477;7041;4212688
FR;0;2021-11-11;4655;6760;12964;28;13957;52047590;45373090;4148441;7069;4226645
FR;0;2021-11-12;29067;55162;183770;252;197364;52076657;45428252;4332211;7321;4424009
FR;0;2021-11-13;20343;32674;80694;118;86319;52097000;45460926;4412905;7439;4510328
FR;0;2021-11-14;2352;3887;7173;6;7854;52099352;45464813;4420078;7445;4518182
FR;0;2021-11-15;20470;38714;160845;313;171568;52119822;45503527;4580923;7758;4689750
FR;0;2021-11-16;23627;43995;200406;392;215018;52143449;45547522;4781329;8150;4904768
FR;0;2021-11-17;30488;50389;199838;406;212874;52173937;45597911;4981167;8556;5117642
FR;0;2021-11-18;23424;45516;191664;469;205555;52197361;45643427;5172831;9025;5323197
FR;0;2021-11-19;33665;61450;243209;549;262181;52231026;45704877;5416040;9574;5585378
FR;0;2021-11-20;25397;36728;102151;206;109717;52256423;45741605;5518191;9780;5695095
FR;0;2021-11-21;2638;4515;9651;19;10633;52259061;45746120;5527842;9799;5705728
FR;0;2021-11-22;22792;33285;180374;470;194854;52281853;45779405;5708216;10269;5900582
FR;0;2021-11-23;25708;45642;229370;549;247832;52307561;45825047;5937586;10818;6148414
FR;0;2021-11-24;31795;53781;224797;715;243222;52339356;45878828;6162383;11533;6391636
FR;0;2021-11-25;25617;49196;255928;740;277759;52364973;45928024;6418311;12273;6669395
FR;0;2021-11-26;33245;74904;379473;864;414628;52398218;46002928;6797784;13137;7084023
FR;0;2021-11-27;23466;49722;214900;389;236675;52421684;46052650;7012684;13526;7320698
FR;0;2021-11-28;3507;10539;56755;66;63330;52425191;46063189;7069439;13592;7384028
FR;0;2021-11-29;19411;54197;341451;862;371693;52444602;46117386;7410890;14454;7755721
FR;0;2021-11-30;24770;72068;457379;988;500771;52469372;46189454;7868269;15442;8256492
FR;0;2021-12-01;27331;75877;469085;1159;511334;52496703;46265331;8337354;16601;8767826
FR;0;2021-12-02;22077;71881;527094;1280;574863;52518780;46337212;8864448;17881;9342689
FR;0;2021-12-03;25540;92970;596370;1420;651175;52544320;46430182;9460818;19301;9993864
FR;0;2021-12-04;18311;60552;336219;690;369782;52562631;46490734;9797037;19991;10363646
FR;0;2021-12-05;4153;16211;95781;157;107058;52566784;46506945;9892818;20148;10470704
FR;0;2021-12-06;27973;73049;493133;1173;539946;52594757;46579994;10385951;21321;11010650
FR;0;2021-12-07;23519;91573;645367;1773;706305;52618276;46671567;11031318;23094;11716955
FR;0;2021-12-08;25479;92324;591569;1874;647486;52643755;46763891;11622887;24968;12364441
FR;0;2021-12-09;24049;94274;663084;2180;726385;52667804;46858165;12285971;27148;13090826
FR;0;2021-12-10;28042;111235;736039;2075;806166;52695846;46969400;13022010;29223;13896992
FR;0;2021-12-11;20248;76217;435171;987;480388;52716094;47045617;13457181;30210;14377380
FR;0;2021-12-12;5628;23236;142297;262;159214;52721722;47068853;13599478;30472;14536594
FR;0;2021-12-13;21343;91159;587623;1699;649272;52743065;47160012;14187101;32171;15185866
FR;0;2021-12-14;27922;118647;765523;2654;847485;52770987;47278659;14952624;34825;16033351
FR;0;2021-12-15;28414;114523;694316;2265;769069;52799401;47393182;15646940;37090;16802420
FR;0;2021-12-16;28013;116019;764006;2558;844418;52827414;47509201;16410946;39648;17646838
FR;0;2021-12-17;31636;128787;807855;2709;892079;52859050;47637988;17218801;42357;18538917
FR;0;2021-12-18;24930;81711;469956;1178;522202;52883980;47719699;17688757;43535;19061119
FR;0;2021-12-19;8756;28742;169385;376;191103;52892736;47748441;17858142;43911;19252222
FR;0;2021-12-20;31718;97508;591471;1786;658739;52924454;47845949;18449613;45697;19910961
FR;0;2021-12-21;39449;112293;682395;2390;759560;52963903;47958242;19132008;48087;20670521
FR;0;2021-12-22;39518;99589;575747;2168;642142;53003421;48057831;19707755;50255;21312663
FR;0;2021-12-23;33768;79730;440981;1654;494397;53037189;48137561;20148736;51909;21807060
FR;0;2021-12-24;10687;26153;111019;398;126672;53047876;48163714;20259755;52307;21933732
FR;0;2021-12-25;774;3575;7586;25;9032;53048650;48167289;20267341;52332;21942764
FR;0;2021-12-26;4695;11899;52094;142;60141;53053345;48179188;20319435;52474;22002905
FR;0;2021-12-27;30447;84104;453538;1364;509160;53083792;48263292;20772973;53838;22512065
FR;0;2021-12-28;38359;99089;564148;1769;632251;53122151;48362381;21337121;55607;23144316
FR;0;2021-12-29;39863;88461;501180;1687;560990;53162014;48450842;21838301;57294;23705306
FR;0;2021-12-30;35915;75293;421014;1520;471141;53197929;48526135;22259315;58814;24176447
FR;0;2021-12-31;12044;25172;116869;405;131661;53209973;48551307;22376184;59219;24308108
FR;0;2022-01-01;1473;3211;8512;37;9940;53211446;48554518;22384696;59256;24318048
FR;0;2022-01-02;6091;12998;58414;125;66945;53217537;48567516;22443110;59381;24384993
FR;0;2022-01-03;35862;90301;494800;1593;551673;53253399;48657817;22937910;60974;24936666
FR;0;2022-01-04;41745;111139;641352;2306;714358;53295144;48768956;23579262;63280;25651024
FR;0;2022-01-05;60846;103675;569137;1981;634157;53355990;48872631;24148399;65261;26285181
FR;0;2022-01-06;44220;110449;638955;2696;711427;53400210;48983080;24787354;67957;26996608
FR;0;2022-01-07;50804;123425;710978;2807;790469;53451014;49106505;25498332;70764;27787077
FR;0;2022-01-08;45001;80346;423797;1213;472878;53496015;49186851;25922129;71977;28259955
FR;0;2022-01-09;15598;26646;128561;300;145681;53511613;49213497;26050690;72277;28405636
FR;0;2022-01-10;35316;93465;469276;1811;522718;53546929;49306962;26519966;74088;28928354
FR;0;2022-01-11;41846;100598;548203;2306;608464;53588775;49407560;27068169;76394;29536818
FR;0;2022-01-12;60329;95772;452647;1967;504322;53649104;49503332;27520816;78361;30041140
FR;0;2022-01-13;38197;92582;487319;2084;541025;53687301;49595914;28008135;80445;30582165
FR;0;2022-01-14;42549;103373;568564;2286;628969;53729850;49699287;28576699;82731;31211134
FR;0;2022-01-15;39382;65877;340123;985;377559;53769232;49765164;28916822;83716;31588693
FR;0;2022-01-16;11395;19234;87412;216;99424;53780627;49784398;29004234;83932;31688117
FR;0;2022-01-17;24710;60114;320264;1381;354165;53805337;49844512;29324498;85313;32042282
FR;0;2022-01-18;28287;68733;361056;1801;397544;53833624;49913245;29685554;87114;32439826
FR;0;2022-01-19;43188;67119;281260;1450;311065;53876812;49980364;29966814;88564;32750891
FR;0;2022-01-20;23592;59652;298977;1739;328479;53900404;50040016;30265791;90303;33079370
FR;0;2022-01-21;28180;68919;366342;2086;401171;53928584;50108935;30632133;92389;33480541
FR;0;2022-01-22;27618;47999;218783;839;241765;53956202;50156934;30850916;93228;33722306
FR;0;2022-01-23;6709;12995;48672;172;55174;53962911;50169929;30899588;93400;33777480
FR;0;2022-01-24;16259;47510;217282;1138;239323;53979170;50217439;31116870;94538;34016803
FR;0;2022-01-25;19011;54438;243016;1547;267061;53998181;50271877;31359886;96085;34283864
FR;0;2022-01-26;28143;60469;209264;1297;229446;54026324;50332346;31569150;97382;34513310
FR;0;2022-01-27;16319;46303;207634;1274;225920;54042643;50378649;31776784;98656;34739230
FR;0;2022-01-28;21568;77774;290035;1574;321414;54064211;50456423;32066819;100230;35060644
FR;0;2022-01-29;18413;52830;184115;688;204567;54082624;50509253;32250934;100918;35265211
FR;0;2022-01-30;4471;14506;39138;124;45093;54087095;50523759;32290072;101042;35310304
FR;0;2022-01-31;11250;43880;148191;739;164790;54098345;50567639;32438263;101781;35475094
FR;0;2022-02-01;13432;48345;174096;1142;191394;54111777;50615984;32612359;102923;35666488
FR;0;2022-02-02;20413;66323;171507;1034;190134;54132190;50682307;32783866;103957;35856622
FR;0;2022-02-03;11425;44718;157539;989;173323;54143615;50727025;32941405;104946;36029945
FR;0;2022-02-04;14610;66522;239234;1265;264171;54158225;50793547;33180639;106211;36294116
FR;0;2022-02-05;12887;51483;153539;523;172334;54171112;50845030;33334178;106734;36466450
FR;0;2022-02-06;2714;12198;28886;101;33836;54173826;50857228;33363064;106835;36500286
FR;0;2022-02-07;9526;46728;156857;587;176323;54183352;50903956;33519921;107422;36676609
FR;0;2022-02-08;9718;43018;166607;867;184395;54193070;50946974;33686528;108289;36861004
FR;0;2022-02-09;14319;58189;172329;870;193030;54207389;51005163;33858857;109159;37054034
FR;0;2022-02-10;8656;38899;150211;878;166682;54216045;51044062;34009068;110037;37220716
FR;0;2022-02-11;10851;55624;218475;1100;243064;54226896;51099686;34227543;111137;37463780
FR;0;2022-02-12;8377;40932;134710;461;151732;54235273;51140618;34362253;111598;37615512
FR;0;2022-02-13;1898;8595;26558;85;30917;54237171;51149213;34388811;111683;37646429
FR;0;2022-02-14;6973;35206;148356;482;166350;54244144;51184419;34537167;112165;37812779
FR;0;2022-02-15;7001;36148;146957;751;162540;54251145;51220567;34684124;112916;37975319
FR;0;2022-02-16;9379;42919;132517;720;146735;54260524;51263486;34816641;113636;38122054
FR;0;2022-02-17;5559;24269;87275;585;94842;54266083;51287755;34903916;114221;38216896
FR;0;2022-02-18;6985;33532;119632;804;129299;54273068;51321287;35023548;115025;38346195
FR;0;2022-02-19;5365;24536;70019;370;77328;54278433;51345823;35093567;115395;38423523
FR;0;2022-02-20;1143;4646;12164;39;13942;54279576;51350469;35105731;115434;38437465
FR;0;2022-02-21;4087;17874;61941;351;67171;54283663;51368343;35167672;115785;38504636
FR;0;2022-02-22;4442;18624;60808;575;64443;54288105;51386967;35228480;116360;38569079
FR;0;2022-02-23;6571;27318;66488;591;71887;54294676;51414285;35294968;116951;38640966
FR;0;2022-02-24;3838;15446;50416;517;53238;54298514;51429731;35345384;117468;38694204
FR;0;2022-02-25;5273;23943;76332;803;80067;54303787;51453674;35421716;118271;38774271
FR;0;2022-02-26;3984;17759;47404;359;51471;54307771;51471433;35469120;118630;38825742
FR;0;2022-02-27;878;3001;8030;47;8941;54308649;51474434;35477150;118677;38834683
FR;0;2022-02-28;3120;12507;40468;358;42903;54311769;51486941;35517618;119035;38877586
FR;0;2022-03-01;3760;12521;44174;435;44836;54315529;51499462;35561792;119470;38922422
FR;0;2022-03-02;5270;17732;47117;443;49048;54320799;51517194;35608909;119913;38971470
FR;0;2022-03-03;2785;9286;29878;367;29996;54323584;51526480;35638787;120280;39001466
FR;0;2022-03-04;3214;12359;40289;664;39438;54326798;51538839;35679076;120944;39040904
FR;0;2022-03-05;3065;9257;24948;310;25109;54329863;51548096;35704024;121254;39066013
FR;0;2022-03-06;515;1393;3194;43;3437;54330378;51549489;35707218;121297;39069450
FR;0;2022-03-07;2258;5596;18418;315;17687;54332636;51555085;35725636;121612;39087137
FR;0;2022-03-08;2071;6038;19434;359;17901;54334707;51561123;35745070;121971;39105038
FR;0;2022-03-09;3519;10469;22177;405;21272;54338226;51571592;35767247;122376;39126310
FR;0;2022-03-10;1766;5569;16969;342;15794;54339992;51577161;35784216;122718;39142104
FR;0;2022-03-11;2398;7526;24488;539;22251;54342390;51584687;35808704;123257;39164355
FR;0;2022-03-12;2659;6769;17158;308;16512;54345049;51591456;35825862;123565;39180867
FR;0;2022-03-13;390;785;2319;147;2269;54345439;51592241;35828181;123712;39183136
FR;0;2022-03-14;1525;4246;14969;4408;13822;54346964;51596487;35843150;128120;39196958
FR;0;2022-03-15;1677;5792;16358;7551;14583;54348641;51602279;35859508;135671;39211541
FR;0;2022-03-16;2987;7287;19411;13133;18083;54351628;51609566;35878919;148804;39229624
FR;0;2022-03-17;1417;3941;13126;10842;11971;54353045;51613507;35892045;159646;39241595
FR;0;2022-03-18;2256;5735;19983;18285;18076;54355301;51619242;35912028;177931;39259671
FR;0;2022-03-19;2286;4798;13111;9401;12413;54357587;51624040;35925139;187332;39272084
FR;0;2022-03-20;297;730;1917;1072;1928;54357884;51624770;35927056;188404;39274012
FR;0;2022-03-21;1382;3203;12710;14934;11931;54359266;51627973;35939766;203338;39285943
FR;0;2022-03-22;1486;3722;13786;20525;12543;54360752;51631695;35953552;223863;39298486
FR;0;2022-03-23;2658;6228;17695;23148;17211;54363410;51637923;35971247;247011;39315697
FR;0;2022-03-24;1381;3131;11579;17590;10655;54364791;51641054;35982826;264601;39326352
FR;0;2022-03-25;2074;5111;18539;27751;16872;54366865;51646165;36001365;292352;39343224
FR;0;2022-03-26;2221;4409;12072;12676;11513;54369086;51650574;36013437;305028;39354737
FR;0;2022-03-27;358;687;1904;1480;1937;54369444;51651261;36015341;306508;39356674
FR;0;2022-03-28;1454;3064;11112;17482;10606;54370898;51654325;36026453;323990;39367280
FR;0;2022-03-29;1449;3261;12895;27555;12036;54372347;51657586;36039348;351545;39379316
FR;0;2022-03-30;2835;5442;15668;27365;15063;54375182;51663028;36055016;378910;39394379
FR;0;2022-03-31;1606;3507;12967;24960;12300;54376788;51666535;36067983;403870;39406679
FR;0;2022-04-01;2632;4562;20038;30849;18672;54379420;51671097;36088021;434719;39425351
FR;0;2022-04-02;1516;2624;9046;10109;8703;54380936;51673721;36097067;444828;39434054
FR;0;2022-04-03;285;504;1561;1166;1577;54381221;51674225;36098628;445994;39435631
FR;0;2022-04-04;1692;2795;12353;19081;11551;54382913;51677020;36110981;465075;39447182
FR;0;2022-04-05;1694;3066;14316;34042;13165;54384607;51680086;36125297;499117;39460347
FR;0;2022-04-06;2083;3826;13514;26458;12782;54386690;51683912;36138811;525575;39473129
FR;0;2022-04-07;1462;3048;13642;33715;12852;54388152;51686960;36152453;559290;39485981
FR;0;2022-04-08;2039;4193;19196;43815;17804;54390191;51691153;36171649;603105;39503785
FR;0;2022-04-09;1360;2663;9309;13550;8860;54391551;51693816;36180958;616655;39512645
FR;0;2022-04-10;284;591;1980;2010;1999;54391835;51694407;36182938;618665;39514644
FR;0;2022-04-11;1230;2577;11850;23830;11453;54393065;51696984;36194788;642495;39526097
FR;0;2022-04-12;1627;2905;13985;40757;13354;54394692;51699889;36208773;683252;39539451
FR;0;2022-04-13;1911;3582;13383;33050;12999;54396603;51703471;36222156;716302;39552450
FR;0;2022-04-14;1467;2839;13164;36237;13010;54398070;51706310;36235320;752539;39565460
FR;0;2022-04-15;1832;3411;15592;35471;14852;54399902;51709721;36250912;788010;39580312
FR;0;2022-04-16;1037;1814;6383;8522;6234;54400939;51711535;36257295;796532;39586546
FR;0;2022-04-17;190;320;991;1172;1030;54401129;51711855;36258286;797704;39587576
FR;0;2022-04-18;166;520;2764;1068;2783;54401295;51712375;36261050;798772;39590359
FR;0;2022-04-19;1498;2986;12896;29596;12457;54402793;51715361;36273946;828368;39602816
FR;0;2022-04-20;1962;3425;13274;28968;12952;54404755;51718786;36287220;857336;39615768
FR;0;2022-04-21;1487;2828;12516;35037;12545;54406242;51721614;36299736;892373;39628313
FR;0;2022-04-22;1844;3579;16447;37515;15814;54408086;51725193;36316183;929888;39644127
FR;0;2022-04-23;1137;2044;7379;10651;7230;54409223;51727237;36323562;940539;39651357
FR;0;2022-04-24;249;446;1475;1588;1410;54409472;51727683;36325037;942127;39652767
FR;0;2022-04-25;1272;2509;10676;20983;10478;54410744;51730192;36335713;963110;39663245
FR;0;2022-04-26;1584;2976;13644;38531;13094;54412328;51733168;36349357;1001641;39676339
FR;0;2022-04-27;1928;3042;11518;30937;11576;54414256;51736210;36360875;1032578;39687915
FR;0;2022-04-28;1544;2719;12510;36069;12248;54415800;51738929;36373385;1068647;39700163
FR;0;2022-04-29;1980;3911;15535;37178;14897;54417780;51742840;36388920;1105825;39715060
FR;0;2022-04-30;1199;1812;6917;9692;6745;54418979;51744652;36395837;1115517;39721805
FR;0;2022-05-01;213;317;905;995;900;54419192;51744969;36396742;1116512;39722705
FR;0;2022-05-02;1361;2675;11115;18066;10913;54420553;51747644;36407857;1134578;39733618
FR;0;2022-05-03;1818;3168;13690;34539;13533;54422371;51750812;36421547;1169117;39747151
FR;0;2022-05-04;1862;3166;12149;25577;12258;54424233;51753978;36433696;1194694;39759409
FR;0;2022-05-05;1680;2783;13010;33394;12858;54425913;51756761;36446706;1228088;39772267
FR;0;2022-05-06;2097;3605;15309;36677;14792;54428010;51760366;36462015;1264765;39787059
FR;0;2022-05-07;1190;1763;6453;9602;6441;54429200;51762129;36468468;1274367;39793500
FR;0;2022-05-08;260;393;1169;1532;1228;54429460;51762522;36469637;1275899;39794728
FR;0;2022-05-09;1287;2252;9905;20229;9773;54430747;51764774;36479542;1296128;39804501
FR;0;2022-05-10;1694;3012;13505;38792;13050;54432441;51767786;36493047;1334920;39817551
FR;0;2022-05-11;1961;2859;10710;27818;10622;54434402;51770645;36503757;1362738;39828173
FR;0;2022-05-12;1545;2616;11324;35579;10983;54435947;51773261;36515081;1398317;39839156
FR;0;2022-05-13;1954;3166;13732;37784;13314;54437901;51776427;36528813;1436101;39852470
FR;0;2022-05-14;1139;1608;5933;10767;5791;54439040;51778035;36534746;1446868;39858261
FR;0;2022-05-15;279;446;1273;1431;1349;54439319;51778481;36536019;1448299;39859610
FR;0;2022-05-16;1173;1975;8663;20980;8658;54440492;51780456;36544682;1469279;39868268
FR;0;2022-05-17;1564;2532;11800;37752;11376;54442056;51782988;36556482;1507031;39879644
FR;0;2022-05-18;1779;2578;9658;27065;9632;54443835;51785566;36566140;1534096;39889276
FR;0;2022-05-19;1411;2584;10539;35687;10672;54445246;51788150;36576679;1569783;39899948
FR;0;2022-05-20;1860;3059;13386;39324;12872;54447106;51791209;36590065;1609107;39912820
FR;0;2022-05-21;1156;1688;5654;9896;5527;54448262;51792897;36595719;1619003;39918347
FR;0;2022-05-22;237;331;1023;1430;1009;54448499;51793228;36596742;1620433;39919356
FR;0;2022-05-23;1150;2033;8867;20326;8800;54449649;51795261;36605609;1640759;39928156
FR;0;2022-05-24;1524;2714;11341;38755;11185;54451173;51797975;36616950;1679514;39939341
FR;0;2022-05-25;1799;2765;9327;24794;9455;54452972;51800740;36626277;1704308;39948796
FR;0;2022-05-26;191;353;1650;1187;1660;54453163;51801093;36627927;1705495;39950456
FR;0;2022-05-27;1362;2407;9242;21256;8984;54454525;51803500;36637169;1726751;39959440
FR;0;2022-05-28;662;1243;3910;6780;3959;54455187;51804743;36641079;1733531;39963399
FR;0;2022-05-29;154;314;747;915;767;54455341;51805057;36641826;1734446;39964166
FR;0;2022-05-30;999;1924;6975;19248;6986;54456340;51806981;36648801;1753694;39971152
FR;0;2022-05-31;1478;2423;9802;35588;9626;54457818;51809404;36658603;1789282;39980778
FR;0;2022-06-01;1658;2914;11000;24392;10847;54459476;51812318;36669603;1813674;39991625
FR;0;2022-06-02;1447;2529;11296;35435;10828;54460923;51814847;36680899;1849109;40002453
FR;0;2022-06-03;1635;3006;13373;38683;12736;54462558;51817853;36694272;1887792;40015189
FR;0;2022-06-04;958;1507;5036;9101;5106;54463516;51819360;36699308;1896893;40020295
FR;0;2022-06-05;171;326;870;1104;880;54463687;51819686;36700178;1897997;40021175
FR;0;2022-06-06;213;551;2083;1247;2061;54463900;51820237;36702261;1899244;40023236
FR;0;2022-06-07;1348;2611;9821;35541;9402;54465248;51822848;36712082;1934785;40032638
FR;0;2022-06-08;1521;2625;9149;28687;8986;54466769;51825473;36721231;1963472;40041624
FR;0;2022-06-09;1262;2388;10587;39396;10226;54468031;51827861;36731818;2002868;40051850
FR;0;2022-06-10;1596;2855;13039;44717;12582;54469627;51830716;36744857;2047585;40064432
FR;0;2022-06-11;948;1721;5428;11614;5457;54470575;51832437;36750285;2059199;40069889
FR;0;2022-06-12;191;428;1070;1757;1130;54470766;51832865;36751355;2060956;40071019
FR;0;2022-06-13;1057;1974;7411;23144;7239;54471823;51834839;36758766;2084100;40078258
FR;0;2022-06-14;1297;2429;10409;44806;9762;54473120;51837268;36769175;2128906;40088020
FR;0;2022-06-15;1465;2338;9269;30832;8898;54474585;51839606;36778444;2159738;40096918
FR;0;2022-06-16;1150;1974;9860;39803;9269;54475735;51841580;36788304;2199541;40106187
FR;0;2022-06-17;1452;2797;12440;46562;11864;54477187;51844377;36800744;2246103;40118051
FR;0;2022-06-18;846;1500;4557;11115;4490;54478033;51845877;36805301;2257218;40122541
FR;0;2022-06-19;178;350;1054;1612;1125;54478211;51846227;36806355;2258830;40123666
FR;0;2022-06-20;1006;1873;8882;26044;8539;54479217;51848100;36815237;2284874;40132205
FR;0;2022-06-21;1308;2362;10285;49819;9311;54480525;51850462;36825522;2334693;40141516
FR;0;2022-06-22;1362;2420;8879;38937;8362;54481887;51852882;36834401;2373630;40149878
FR;0;2022-06-23;1212;2295;10658;55022;9851;54483099;51855177;36845059;2428652;40159729
FR;0;2022-06-24;1468;2943;13581;69005;12250;54484567;51858120;36858640;2497657;40171979
FR;0;2022-06-25;924;1766;6215;19900;5968;54485491;51859886;36864855;2517557;40177947
FR;0;2022-06-26;227;450;1949;3685;1807;54485718;51860336;36866804;2521242;40179754
FR;0;2022-06-27;1115;1996;10470;48409;9611;54486833;51862332;36877274;2569651;40189365
FR;0;2022-06-28;1439;2780;14639;91239;13057;54488272;51865112;36891913;2660890;40202422
FR;0;2022-06-29;1686;2804;12260;71732;11210;54489958;51867916;36904173;2732622;40213632
FR;0;2022-06-30;1501;2603;14346;95071;12432;54491459;51870519;36918519;2827693;40226064
FR;0;2022-07-01;1905;3431;21141;115792;18449;54493364;51873950;36939660;2943485;40244513
FR;0;2022-07-02;1055;1843;8447;35716;7637;54494419;51875793;36948107;2979201;40252150
FR;0;2022-07-03;287;531;2074;6403;1875;54494706;51876324;36950181;2985604;40254025
FR;0;2022-07-04;1474;2565;14526;79149;12757;54496180;51878889;36964707;3064753;40266782
FR;0;2022-07-05;1673;3020;18733;132982;15923;54497853;51881909;36983440;3197735;40282705
FR;0;2022-07-06;1786;2662;15774;99336;13556;54499639;51884571;36999214;3297071;40296261
FR;0;2022-07-07;1671;2802;17909;125717;14682;54501310;51887373;37017123;3422788;40310943
FR;0;2022-07-08;1857;3109;20654;136754;16677;54503167;51890482;37037777;3559542;40327620
FR;0;2022-07-09;857;1439;7710;37854;6654;54504024;51891921;37045487;3597396;40334274
FR;0;2022-07-10;253;501;2340;6988;2122;54504277;51892422;37047827;3604384;40336396
FR;0;2022-07-11;1379;2387;14944;88062;12414;54505656;51894809;37062771;3692446;40348810
FR;0;2022-07-12;1739;3038;20417;143627;16611;54507395;51897847;37083188;3836073;40365421
FR;0;2022-07-13;1680;2615;15574;94238;13144;54509075;51900462;37098762;3930311;40378565
FR;0;2022-07-14;169;312;1912;5492;1786;54509244;51900774;37100674;3935803;40380351
FR;0;2022-07-15;1436;2495;14957;84285;12456;54510680;51903269;37115631;4020088;40392807
FR;0;2022-07-16;612;1153;5913;24922;5114;54511292;51904422;37121544;4045010;40397921
FR;0;2022-07-17;171;382;1725;4635;1560;54511463;51904804;37123269;4049645;40399481
FR;0;2022-07-18;1101;2168;11700;61656;9847;54512564;51906972;37134969;4111301;40409328
FR;0;2022-07-19;1392;2312;15376;103494;12198;54513956;51909284;37150345;4214795;40421526
FR;0;2022-07-20;1370;2229;12751;77382;10526;54515326;51911513;37163096;4292177;40432052
FR;0;2022-07-21;1241;2095;12937;87865;10352;54516567;51913608;37176033;4380042;40442404
FR;0;2022-07-22;1355;2388;14597;89094;11751;54517922;51915996;37190630;4469136;40454155
FR;0;2022-07-23;651;1257;5389;22397;4714;54518573;51917253;37196019;4491533;40458869
FR;0;2022-07-24;173;344;1365;3870;1203;54518746;51917597;37197384;4495403;40460072
FR;0;2022-07-25;1010;1739;9271;47910;7615;54519756;51919336;37206655;4543313;40467687
FR;0;2022-07-26;1274;2163;13191;85091;10680;54521030;51921499;37219846;4628404;40478367
FR;0;2022-07-27;1195;1954;10065;60818;8363;54522225;51923453;37229911;4689222;40486730
FR;0;2022-07-28;1050;1780;10166;63814;8039;54523275;51925233;37240077;4753036;40494769
FR;0;2022-07-29;1248;1946;10762;65384;8509;54524523;51927179;37250839;4818420;40503278
FR;0;2022-07-30;480;826;3472;15172;2931;54525003;51928005;37254311;4833592;40506209
FR;0;2022-07-31;141;274;889;2396;757;54525144;51928279;37255200;4835988;40506966
FR;0;2022-08-01;744;1255;5985;29908;4890;54525888;51929534;37261185;4865896;40511856
FR;0;2022-08-02;948;1541;8092;55561;6411;54526836;51931075;37269277;4921457;40518267
FR;0;2022-08-03;771;1163;6042;38299;4783;54527607;51932238;37275319;4959756;40523050
FR;0;2022-08-04;690;1103;6199;42507;4946;54528297;51933341;37281518;5002263;40527996
FR;0;2022-08-05;807;1290;6604;44281;5176;54529104;51934631;37288122;5046544;40533172
FR;0;2022-08-06;321;532;1925;9201;1587;54529425;51935163;37290047;5055745;40534759
FR;0;2022-08-07;82;134;503;1576;418;54529507;51935297;37290550;5057321;40535177
FR;0;2022-08-08;495;829;3632;21405;2901;54530002;51936126;37294182;5078726;40538078
FR;0;2022-08-09;623;992;5409;38481;4292;54530625;51937118;37299591;5117207;40542370
