fra;vaccin;jour;n_dose1;n_dose2;n_dose3;n_dose4;n_rappel;n_cum_dose1;n_cum_dose2;n_cum_dose3;n_cum_dose4;n_cum_rappel
FR;1;2020-12-27;602;0;0;0;0;602;0;0;0;0
FR;1;2020-12-28;669;1;0;0;0;1271;1;0;0;0
FR;1;2020-12-29;374;0;0;0;0;1645;1;0;0;0
FR;1;2020-12-30;440;0;0;0;0;2085;1;0;0;0
FR;1;2020-12-31;436;1;0;0;0;2521;2;0;0;0
FR;1;2021-01-01;1137;2;0;0;0;3658;4;0;0;0
FR;1;2021-01-02;358;3;0;0;0;4016;7;0;0;0
FR;1;2021-01-03;402;0;0;0;0;4418;7;0;0;0
FR;1;2021-01-04;2092;2;0;0;0;6510;9;0;0;0
FR;1;2021-01-05;7732;3;0;0;0;14242;12;0;0;0
FR;1;2021-01-06;12449;13;0;0;0;26691;25;0;0;0
FR;1;2021-01-07;29449;9;0;0;0;56140;34;0;0;0
FR;1;2021-01-08;37123;12;0;0;0;93263;46;0;0;0
FR;1;2021-01-09;11209;4;0;0;0;104472;50;0;0;0
FR;1;2021-01-10;5996;3;0;0;0;110468;53;0;0;0
FR;1;2021-01-11;39925;17;0;0;0;150393;70;0;0;0
FR;1;2021-01-12;62127;16;0;0;0;212520;86;0;0;0
FR;1;2021-01-13;65110;31;0;0;0;277630;117;0;0;0
FR;1;2021-01-14;81437;87;0;0;0;359067;204;0;0;0
FR;1;2021-01-15;68596;34;0;0;0;427663;238;0;0;0
FR;1;2021-01-16;19893;69;0;0;0;447556;307;0;0;0
FR;1;2021-01-17;10896;48;0;0;0;458452;355;0;0;0
FR;1;2021-01-18;82813;162;0;0;0;541265;517;0;0;0
FR;1;2021-01-19;125899;174;0;0;0;667164;691;0;0;0
FR;1;2021-01-20;132392;167;0;0;0;799556;858;0;0;0
FR;1;2021-01-21;153041;161;0;0;0;952597;1019;0;0;0
FR;1;2021-01-22;115929;200;0;0;0;1068526;1219;0;0;0
FR;1;2021-01-23;36601;64;0;0;0;1105127;1283;0;0;0
FR;1;2021-01-24;9580;73;0;0;0;1114707;1356;0;0;0
FR;1;2021-01-25;74413;1270;0;0;0;1189120;2626;0;0;0
FR;1;2021-01-26;96446;3292;1;0;0;1285566;5918;1;0;0
FR;1;2021-01-27;103625;5934;0;0;0;1389191;11852;1;0;0
FR;1;2021-01-28;120583;15063;0;0;0;1509774;26915;1;0;0
FR;1;2021-01-29;88880;17774;0;0;0;1598654;44689;1;0;0
FR;1;2021-01-30;27984;4316;0;0;0;1626638;49005;1;0;0
FR;1;2021-01-31;5183;1742;0;0;0;1631821;50747;1;0;0
FR;1;2021-02-01;49708;21539;0;0;0;1681529;72286;1;0;0
FR;1;2021-02-02;67792;35832;0;0;0;1749321;108118;1;0;0
FR;1;2021-02-03;67073;38140;0;0;0;1816394;146258;1;0;0
FR;1;2021-02-04;77122;51643;0;0;0;1893516;197901;1;0;0
FR;1;2021-02-05;63407;46088;0;0;0;1956923;243989;1;0;0
FR;1;2021-02-06;19408;10759;0;0;0;1976331;254748;1;0;0
FR;1;2021-02-07;3659;5320;0;0;0;1979990;260068;1;0;0
FR;1;2021-02-08;36482;46897;0;0;0;2016472;306965;1;0;0
FR;1;2021-02-09;50790;74606;0;0;0;2067262;381571;1;0;0
FR;1;2021-02-10;52048;79432;0;0;0;2119310;461003;1;0;0
FR;1;2021-02-11;63351;101399;0;0;0;2182661;562402;1;0;0
FR;1;2021-02-12;55839;74804;0;0;0;2238500;637206;1;0;0
FR;1;2021-02-13;15451;19268;0;0;0;2253951;656474;1;0;0
FR;1;2021-02-14;3744;7276;0;0;0;2257695;663750;1;0;0
FR;1;2021-02-15;24130;73495;0;0;0;2281825;737245;1;0;0
FR;1;2021-02-16;32754;96471;0;0;0;2314579;833716;1;0;0
FR;1;2021-02-17;35099;100206;1;0;0;2349678;933922;2;0;0
FR;1;2021-02-18;49428;115573;0;0;0;2399106;1049495;2;0;0
FR;1;2021-02-19;45368;86702;1;0;0;2444474;1136197;3;0;0
FR;1;2021-02-20;13376;27077;0;0;0;2457850;1163274;3;0;0
FR;1;2021-02-21;2454;6189;0;0;0;2460304;1169463;3;0;0
FR;1;2021-02-22;24708;69443;2;0;0;2485012;1238906;5;0;0
FR;1;2021-02-23;37415;80764;1;0;0;2522427;1319670;6;0;0
FR;1;2021-02-24;40673;78306;1;0;0;2563100;1397976;7;0;0
FR;1;2021-02-25;50134;88005;1;0;0;2613234;1485981;8;0;0
FR;1;2021-02-26;47189;67600;1;0;0;2660423;1553581;9;0;0
FR;1;2021-02-27;15667;21082;0;0;0;2676090;1574663;9;0;0
FR;1;2021-02-28;3553;4224;1;0;0;2679643;1578887;10;0;0
FR;1;2021-03-01;40149;49537;1;0;0;2719792;1628424;11;0;0
FR;1;2021-03-02;55960;61904;2;0;0;2775752;1690328;13;0;0
FR;1;2021-03-03;61209;60603;0;0;0;2836961;1750931;13;0;0
FR;1;2021-03-04;72974;66263;3;0;0;2909935;1817194;16;0;0
FR;1;2021-03-05;74737;58949;3;0;0;2984672;1876143;19;0;0
FR;1;2021-03-06;82434;15967;2;0;0;3067106;1892110;21;0;0
FR;1;2021-03-07;63703;4901;1;0;0;3130809;1897011;22;0;0
FR;1;2021-03-08;60143;41948;2;0;0;3190952;1938959;24;0;0
FR;1;2021-03-09;85969;47939;1;0;0;3276921;1986898;25;0;0
FR;1;2021-03-10;90877;47930;5;0;0;3367798;2034828;30;0;0
FR;1;2021-03-11;105037;54234;1;0;0;3472835;2089062;31;0;0
FR;1;2021-03-12;104088;45041;1;0;0;3576923;2134103;32;0;0
FR;1;2021-03-13;89182;12704;1;0;0;3666105;2146807;33;0;0
FR;1;2021-03-14;44446;2861;1;0;0;3710551;2149668;34;0;0
FR;1;2021-03-15;95476;28597;3;0;0;3806027;2178265;37;0;0
FR;1;2021-03-16;123570;34426;5;0;0;3929597;2212691;42;0;0
FR;1;2021-03-17;129280;34179;4;0;0;4058877;2246870;46;0;0
FR;1;2021-03-18;142859;39553;5;0;0;4201736;2286423;51;0;0
FR;1;2021-03-19;136216;32509;2;0;0;4337952;2318932;53;0;0
FR;1;2021-03-20;75974;9966;1;0;0;4413926;2328898;54;0;0
FR;1;2021-03-21;26495;2340;1;0;0;4440421;2331238;55;0;0
FR;1;2021-03-22;114720;30779;2;0;0;4555141;2362017;57;0;0
FR;1;2021-03-23;142994;38110;1;0;0;4698135;2400127;58;0;0
FR;1;2021-03-24;141973;38544;0;0;0;4840108;2438671;58;0;0
FR;1;2021-03-25;164975;39602;4;0;0;5005083;2478273;62;0;0
FR;1;2021-03-26;166363;37515;4;1;0;5171446;2515788;66;1;0
FR;1;2021-03-27;110867;15305;1;0;0;5282313;2531093;67;1;0
FR;1;2021-03-28;42293;3894;3;0;0;5324606;2534987;70;1;0
FR;1;2021-03-29;129789;49596;4;0;0;5454395;2584583;74;1;0
FR;1;2021-03-30;167696;63518;4;0;0;5622091;2648101;78;1;0
FR;1;2021-03-31;170895;67234;4;0;0;5792986;2715335;82;1;0
FR;1;2021-04-01;194735;80790;11;0;0;5987721;2796125;93;1;0
FR;1;2021-04-02;164418;85017;7;0;0;6152139;2881142;100;1;0
FR;1;2021-04-03;88227;58049;5;0;0;6240366;2939191;105;1;0
FR;1;2021-04-04;33594;17686;0;0;0;6273960;2956877;105;1;0
FR;1;2021-04-05;46378;9960;11;0;0;6320338;2966837;116;1;0
FR;1;2021-04-06;160268;102338;17;0;0;6480606;3069175;133;1;0
FR;1;2021-04-07;196941;108199;16;0;0;6677547;3177374;149;1;0
FR;1;2021-04-08;222056;112834;13;0;0;6899603;3290208;162;1;0
FR;1;2021-04-09;214503;107407;21;0;0;7114106;3397615;183;1;0
FR;1;2021-04-10;117155;73263;14;0;0;7231261;3470878;197;1;0
FR;1;2021-04-11;40873;30125;6;0;0;7272134;3501003;203;1;0
FR;1;2021-04-12;168420;103887;45;0;0;7440554;3604890;248;1;0
FR;1;2021-04-13;203761;127983;97;1;0;7644315;3732873;345;2;0
FR;1;2021-04-14;208553;122670;206;0;0;7852868;3855543;551;2;0
FR;1;2021-04-15;221615;127060;311;0;0;8074483;3982603;862;2;0
FR;1;2021-04-16;206007;125194;308;0;0;8280490;4107797;1170;2;0
FR;1;2021-04-17;122064;67256;103;0;0;8402554;4175053;1273;2;0
FR;1;2021-04-18;35953;20933;41;0;0;8438507;4195986;1314;2;0
FR;1;2021-04-19;163712;121690;431;0;0;8602219;4317676;1745;2;0
FR;1;2021-04-20;189364;148921;531;0;0;8791583;4466597;2276;2;0
FR;1;2021-04-21;193935;146963;758;0;0;8985518;4613560;3034;2;0
FR;1;2021-04-22;208984;163181;777;0;0;9194502;4776741;3811;2;0
FR;1;2021-04-23;198913;157058;671;0;0;9393415;4933799;4482;2;0
FR;1;2021-04-24;126304;95488;148;0;0;9519719;5029287;4630;2;0
FR;1;2021-04-25;53619;30025;46;0;0;9573338;5059312;4676;2;0
FR;1;2021-04-26;181089;138390;539;0;0;9754427;5197702;5215;2;0
FR;1;2021-04-27;221323;161913;900;0;0;9975750;5359615;6115;2;0
FR;1;2021-04-28;238243;155099;1310;1;1;10213993;5514714;7425;3;1
FR;1;2021-04-29;270228;160462;1208;0;0;10484221;5675176;8633;3;1
FR;1;2021-04-30;271935;148145;1069;0;0;10756156;5823321;9702;3;1
FR;1;2021-05-01;141123;40615;172;0;0;10897279;5863936;9874;3;1
FR;1;2021-05-02;81521;28095;81;0;0;10978800;5892031;9955;3;1
FR;1;2021-05-03;250733;145163;800;0;0;11229533;6037194;10755;3;1
FR;1;2021-05-04;265818;186903;1198;0;0;11495351;6224097;11953;3;1
FR;1;2021-05-05;283817;184783;1265;0;0;11779168;6408880;13218;3;1
FR;1;2021-05-06;309896;183295;1499;0;0;12089064;6592175;14717;3;1
FR;1;2021-05-07;284040;195658;1125;0;0;12373104;6787833;15842;3;1
FR;1;2021-05-08;191636;48748;285;0;0;12564740;6836581;16127;3;1
FR;1;2021-05-09;114044;35824;236;0;0;12678784;6872405;16363;3;1
FR;1;2021-05-10;258151;194045;1183;0;0;12936935;7066450;17546;3;1
FR;1;2021-05-11;318828;210962;1462;0;0;13255763;7277412;19008;3;1
FR;1;2021-05-12;356568;185715;1399;0;0;13612331;7463127;20407;3;1
FR;1;2021-05-13;283407;47707;399;0;0;13895738;7510834;20806;3;1
FR;1;2021-05-14;370438;128559;990;0;0;14266176;7639393;21796;3;1
FR;1;2021-05-15;298049;66099;402;0;0;14564225;7705492;22198;3;1
FR;1;2021-05-16;157752;15528;158;0;0;14721977;7721020;22356;3;1
FR;1;2021-05-17;318892;116286;1436;0;0;15040869;7837306;23792;3;1
FR;1;2021-05-18;383274;111207;1796;0;0;15424143;7948513;25588;3;1
FR;1;2021-05-19;395209;102531;2176;0;0;15819352;8051044;27764;3;1
FR;1;2021-05-20;421754;96102;2042;0;0;16241106;8147146;29806;3;1
FR;1;2021-05-21;399765;97164;1756;0;0;16640871;8244310;31562;3;1
FR;1;2021-05-22;275649;42012;602;0;0;16916520;8286322;32164;3;1
FR;1;2021-05-23;122997;11140;224;0;0;17039517;8297462;32388;3;1
FR;1;2021-05-24;243985;26224;566;0;0;17283502;8323686;32954;3;1
FR;1;2021-05-25;366176;131619;2108;1;0;17649678;8455305;35062;4;1
FR;1;2021-05-26;380769;125942;1990;0;0;18030447;8581247;37052;4;1
FR;1;2021-05-27;406100;128052;1974;0;0;18436547;8709299;39026;4;1
FR;1;2021-05-28;365980;145282;1698;0;0;18802527;8854581;40724;4;1
FR;1;2021-05-29;253805;80835;525;0;0;19056332;8935416;41249;4;1
FR;1;2021-05-30;100958;22547;157;0;0;19157290;8957963;41406;4;1
FR;1;2021-05-31;314268;148761;1280;1;1;19471558;9106724;42686;5;2
FR;1;2021-06-01;361526;166400;1724;1;1;19833084;9273124;44410;6;3
FR;1;2021-06-02;364816;153196;1791;0;0;20197900;9426320;46201;6;3
FR;1;2021-06-03;390746;147575;1647;0;0;20588646;9573895;47848;6;3
FR;1;2021-06-04;363647;175485;1492;1;1;20952293;9749380;49340;7;4
FR;1;2021-06-05;258471;112642;596;0;0;21210764;9862022;49936;7;4
FR;1;2021-06-06;126751;37534;215;0;0;21337515;9899556;50151;7;4
FR;1;2021-06-07;300267;207758;1362;0;0;21637782;10107314;51513;7;4
FR;1;2021-06-08;330583;220691;1638;0;0;21968365;10328005;53151;7;4
FR;1;2021-06-09;336428;212159;1607;0;0;22304793;10540164;54758;7;4
FR;1;2021-06-10;343707;201795;1609;0;0;22648500;10741959;56367;7;4
FR;1;2021-06-11;311734;235195;1294;0;0;22960234;10977154;57661;7;4
FR;1;2021-06-12;244032;150648;431;0;0;23204266;11127802;58092;7;4
FR;1;2021-06-13;100323;61001;188;0;0;23304589;11188803;58280;7;4
FR;1;2021-06-14;207679;288706;1317;1;0;23512268;11477509;59597;8;4
FR;1;2021-06-15;256719;282060;1391;1;0;23768987;11759569;60988;9;4
FR;1;2021-06-16;273533;270606;1262;1;0;24042520;12030175;62250;10;4
FR;1;2021-06-17;268103;244758;1231;1;0;24310623;12274933;63481;11;4
FR;1;2021-06-18;260428;295648;1149;1;0;24571051;12570581;64630;12;4
FR;1;2021-06-19;193414;209482;387;0;0;24764465;12780063;65017;12;4
FR;1;2021-06-20;69657;89150;117;0;0;24834122;12869213;65134;12;4
FR;1;2021-06-21;172202;319812;929;1;1;25006324;13189025;66063;13;5
FR;1;2021-06-22;185692;347852;1098;10;2;25192016;13536877;67161;23;7
FR;1;2021-06-23;204056;339463;1048;0;0;25396072;13876340;68209;23;7
FR;1;2021-06-24;203410;282105;1168;0;0;25599482;14158445;69377;23;7
FR;1;2021-06-25;182506;371828;1196;0;0;25781988;14530273;70573;23;7
FR;1;2021-06-26;131349;278340;503;0;0;25913337;14808613;71076;23;7
FR;1;2021-06-27;52374;122906;145;0;0;25965711;14931519;71221;23;7
FR;1;2021-06-28;136515;368154;1058;0;0;26102226;15299673;72279;23;7
FR;1;2021-06-29;154758;390761;1849;0;0;26256984;15690434;74128;23;7
FR;1;2021-06-30;179916;379822;1663;4;2;26436900;16070256;75791;27;9
FR;1;2021-07-01;201295;332206;1886;5;1;26638195;16402462;77677;32;10
FR;1;2021-07-02;193588;367653;1764;5;3;26831783;16770115;79441;37;13
FR;1;2021-07-03;124389;280454;704;3;1;26956172;17050569;80145;40;14
FR;1;2021-07-04;53909;113686;244;0;0;27010081;17164255;80389;40;14
FR;1;2021-07-05;153705;356018;1500;8;2;27163786;17520273;81889;48;16
FR;1;2021-07-06;173339;382509;1601;45;8;27337125;17902782;83490;93;24
FR;1;2021-07-07;190634;362572;1657;24;5;27527759;18265354;85147;117;29
FR;1;2021-07-08;201399;323108;1825;20;7;27729158;18588462;86972;137;36
FR;1;2021-07-09;189730;387659;1851;3;2;27918888;18976121;88823;140;38
FR;1;2021-07-10;129877;281141;814;1;1;28048765;19257262;89637;141;39
FR;1;2021-07-11;57629;102504;261;0;0;28106394;19359766;89898;141;39
FR;1;2021-07-12;149481;417023;1580;4;0;28255875;19776789;91478;145;39
FR;1;2021-07-13;234095;439488;1805;8;2;28489970;20216277;93283;153;41
FR;1;2021-07-14;171751;151528;417;0;0;28661721;20367805;93700;153;41
FR;1;2021-07-15;279494;424769;1856;1;0;28941215;20792574;95556;154;41
FR;1;2021-07-16;290277;401200;1710;3;1;29231492;21193774;97266;157;42
FR;1;2021-07-17;217282;282107;754;1;0;29448774;21475881;98020;158;42
FR;1;2021-07-18;101966;107300;288;0;0;29550740;21583181;98308;158;42
FR;1;2021-07-19;238083;379113;1495;3;0;29788823;21962294;99803;161;42
FR;1;2021-07-20;305595;380688;1468;0;0;30094418;22342982;101271;161;42
FR;1;2021-07-21;333141;353380;1412;4;2;30427559;22696362;102683;165;44
FR;1;2021-07-22;364536;319222;1501;3;2;30792095;23015584;104184;168;46
FR;1;2021-07-23;349257;343574;1586;4;2;31141352;23359158;105770;172;48
FR;1;2021-07-24;238914;240972;696;1;0;31380266;23600130;106466;173;48
FR;1;2021-07-25;112753;76057;219;0;0;31493019;23676187;106685;173;48
FR;1;2021-07-26;299027;290012;1496;2;2;31792046;23966199;108181;175;50
FR;1;2021-07-27;385718;268677;1457;4;2;32177764;24234876;109638;179;52
FR;1;2021-07-28;390106;251425;1460;4;2;32567870;24486301;111098;183;54
FR;1;2021-07-29;406026;228228;1538;2;1;32973896;24714529;112636;185;55
FR;1;2021-07-30;370606;246955;1632;4;1;33344502;24961484;114268;189;56
FR;1;2021-07-31;243355;165124;793;1;0;33587857;25126608;115061;190;56
FR;1;2021-08-01;105526;47231;233;0;0;33693383;25173839;115294;190;56
FR;1;2021-08-02;297050;213201;1476;2;0;33990433;25387040;116770;192;56
FR;1;2021-08-03;331186;209168;1547;2;1;34321619;25596208;118317;194;57
FR;1;2021-08-04;327875;184330;1437;5;3;34649494;25780538;119754;199;60
FR;1;2021-08-05;301129;193542;1482;0;0;34950623;25974080;121236;199;60
FR;1;2021-08-06;290864;224468;1558;3;1;35241487;26198548;122794;202;61
FR;1;2021-08-07;182601;158820;654;4;3;35424088;26357368;123448;206;64
FR;1;2021-08-08;68839;59123;247;0;0;35492927;26416491;123695;206;64
FR;1;2021-08-09;222643;235854;1438;4;3;35715570;26652345;125133;210;67
FR;1;2021-08-10;252526;240574;1487;2;1;35968096;26892919;126620;212;68
FR;1;2021-08-11;236072;232319;1271;5;1;36204168;27125238;127891;217;69
FR;1;2021-08-12;220648;240248;1485;3;1;36424816;27365486;129376;220;70
FR;1;2021-08-13;201633;238568;1356;2;2;36626449;27604054;130732;222;72
FR;1;2021-08-14;122820;174148;645;0;0;36749269;27778202;131377;222;72
FR;1;2021-08-15;34663;46128;198;1;0;36783932;27824330;131575;223;72
FR;1;2021-08-16;156847;289825;1421;0;0;36940779;28114155;132996;223;72
FR;1;2021-08-17;171510;291544;1421;5;1;37112289;28405699;134417;228;73
FR;1;2021-08-18;161339;286979;1389;6;3;37273628;28692678;135806;234;76
FR;1;2021-08-19;148837;277743;1397;1;0;37422465;28970421;137203;235;76
FR;1;2021-08-20;140431;309167;1526;2;2;37562896;29279588;138729;237;78
FR;1;2021-08-21;84244;213250;586;0;0;37647140;29492838;139315;237;78
FR;1;2021-08-22;28545;82691;230;0;0;37675685;29575529;139545;237;78
FR;1;2021-08-23;118597;321160;1421;2;1;37794282;29896689;140966;239;79
FR;1;2021-08-24;126598;319895;1602;5;1;37920880;30216584;142568;244;80
FR;1;2021-08-25;121465;306581;1776;8;3;38042345;30523165;144344;252;83
FR;1;2021-08-26;106541;286213;2157;10;1;38148886;30809378;146501;262;84
FR;1;2021-08-27;107598;321683;2300;9;3;38256484;31131061;148801;271;87
FR;1;2021-08-28;70975;220712;1100;0;0;38327459;31351773;149901;271;87
FR;1;2021-08-29;24135;78155;467;1;0;38351594;31429928;150368;272;87
FR;1;2021-08-30;96814;286510;4307;6;5112;38448408;31716438;154675;278;5199
FR;1;2021-08-31;98034;276434;9285;15;10155;38546442;31992872;163960;293;15354
FR;1;2021-09-01;112015;245345;21105;7;22078;38658457;32238217;185065;300;37432
FR;1;2021-09-02;84786;198013;24524;11;25442;38743243;32436230;209589;311;62874
FR;1;2021-09-03;82336;227602;26946;20;27976;38825579;32663832;236535;331;90850
FR;1;2021-09-04;71571;189717;11138;11;11659;38897150;32853549;247673;342;102509
FR;1;2021-09-05;18599;41184;4121;2;4292;38915749;32894733;251794;344;106801
FR;1;2021-09-06;59482;151612;30173;15;31142;38975231;33046345;281967;359;137943
FR;1;2021-09-07;57226;139713;30203;27;31121;39032457;33186058;312170;386;169064
FR;1;2021-09-08;71282;173883;26917;20;27870;39103739;33359941;339087;406;196934
FR;1;2021-09-09;54253;124579;28600;23;29650;39157992;33484520;367687;429;226584
FR;1;2021-09-10;65852;152094;30431;22;31566;39223844;33636614;398118;451;258150
FR;1;2021-09-11;52357;146612;9727;14;10306;39276201;33783226;407845;465;268456
FR;1;2021-09-12;10773;29242;2482;1;2635;39286974;33812468;410327;466;271091
FR;1;2021-09-13;51337;104591;38730;28;39927;39338311;33917059;449057;494;311018
FR;1;2021-09-14;53206;96067;51255;65;52909;39391517;34013126;500312;559;363927
FR;1;2021-09-15;60364;139305;50463;55;46966;39451881;34152431;550775;614;410893
FR;1;2021-09-16;46541;81443;53294;71;49486;39498422;34233874;604069;685;460379
FR;1;2021-09-17;53139;109379;45047;61;42643;39551561;34343253;649116;746;503022
FR;1;2021-09-18;37842;118488;11790;19;11258;39589403;34461741;660906;765;514280
FR;1;2021-09-19;6494;21035;2037;1;1973;39595897;34482776;662943;766;516253
FR;1;2021-09-20;36434;74925;46177;66;44093;39632331;34557701;709120;832;560346
FR;1;2021-09-21;34128;68157;56233;71;52636;39666459;34625858;765353;903;612982
FR;1;2021-09-22;38755;118533;49833;76;46819;39705214;34744391;815186;979;659801
FR;1;2021-09-23;31936;62856;54465;85;50819;39737150;34807247;869651;1064;710620
FR;1;2021-09-24;36730;90108;43642;91;41877;39773880;34897355;913293;1155;752497
FR;1;2021-09-25;27628;96620;12298;27;12164;39801508;34993975;925591;1182;764661
FR;1;2021-09-26;4360;15191;1770;5;1693;39805868;35009166;927361;1187;766354
FR;1;2021-09-27;27314;60232;42888;89;41570;39833182;35069398;970249;1276;807924
FR;1;2021-09-28;26852;49459;47162;75;44400;39860034;35118857;1017411;1351;852324
FR;1;2021-09-29;35833;80384;47246;87;45528;39895867;35199241;1064657;1438;897852
FR;1;2021-09-30;26014;46800;47496;80;45374;39921881;35246041;1112153;1518;943226
FR;1;2021-10-01;47147;65052;44862;83;44419;39969028;35311093;1157015;1601;987645
FR;1;2021-10-02;32341;62370;16107;32;16297;40001369;35373463;1173122;1633;1003942
FR;1;2021-10-03;4325;8573;2031;3;2024;40005694;35382036;1175153;1636;1005966
FR;1;2021-10-04;28784;44437;47088;79;46902;40034478;35426473;1222241;1715;1052868
FR;1;2021-10-05;24269;41622;49835;116;49190;40058747;35468095;1272076;1831;1102058
FR;1;2021-10-06;34433;61349;57442;102;57132;40093180;35529444;1329518;1933;1159190
FR;1;2021-10-07;20957;39825;52994;75;51813;40114137;35569269;1382512;2008;1211003
FR;1;2021-10-08;34967;59596;60361;83;61056;40149104;35628865;1442873;2091;1272059
FR;1;2021-10-09;27428;47989;25476;30;25975;40176532;35676854;1468349;2121;1298034
FR;1;2021-10-10;3653;5790;2746;7;2847;40180185;35682644;1471095;2128;1300881
FR;1;2021-10-11;24706;38166;54561;88;55171;40204891;35720810;1525656;2216;1356052
FR;1;2021-10-12;23161;36557;58023;126;59087;40228052;35757367;1583679;2342;1415139
FR;1;2021-10-13;32825;47800;64146;124;65618;40260877;35805167;1647825;2466;1480757
FR;1;2021-10-14;21609;34777;53728;103;54295;40282486;35839944;1701553;2569;1535052
FR;1;2021-10-15;32558;48812;72303;165;74919;40315044;35888756;1773856;2734;1609971
FR;1;2021-10-16;25964;35275;34858;44;36392;40341008;35924031;1808714;2778;1646363
FR;1;2021-10-17;3097;4066;3407;2;3318;40344105;35928097;1812121;2780;1649681
FR;1;2021-10-18;23564;34913;66807;131;69650;40367669;35963010;1878928;2911;1719331
FR;1;2021-10-19;20600;34620;75631;135;79520;40388269;35997630;1954559;3046;1798851
FR;1;2021-10-20;29803;44218;96143;177;99766;40418072;36041848;2050702;3223;1898617
FR;1;2021-10-21;19623;35073;83127;107;86976;40437695;36076921;2133829;3330;1985593
FR;1;2021-10-22;29538;47646;103703;196;109578;40467233;36124567;2237532;3526;2095171
FR;1;2021-10-23;23009;35159;44849;57;47350;40490242;36159726;2282381;3583;2142521
FR;1;2021-10-24;2374;3879;3579;6;3733;40492616;36163605;2285960;3589;2146254
FR;1;2021-10-25;22394;30831;81995;143;85761;40515010;36194436;2367955;3732;2232015
FR;1;2021-10-26;19298;27706;86060;162;90275;40534308;36222142;2454015;3894;2322290
FR;1;2021-10-27;26141;39663;107762;252;112608;40560449;36261805;2561777;4146;2434898
FR;1;2021-10-28;18647;27071;86894;150;91589;40579096;36288876;2648671;4296;2526487
FR;1;2021-10-29;25882;40191;114787;200;121523;40604978;36329067;2763458;4496;2648010
FR;1;2021-10-30;17678;28647;49339;75;51914;40622656;36357714;2812797;4571;2699924
FR;1;2021-10-31;2055;3195;3443;2;3677;40624711;36360909;2816240;4573;2703601
FR;1;2021-11-01;7721;4218;3021;3;3265;40632432;36365127;2819261;4576;2706866
FR;1;2021-11-02;21866;33205;92346;157;97693;40654298;36398332;2911607;4733;2804559
FR;1;2021-11-03;26302;41545;117445;215;123797;40680600;36439877;3029052;4948;2928356
FR;1;2021-11-04;19496;30306;105736;213;111828;40700096;36470183;3134788;5161;3040184
FR;1;2021-11-05;26918;42241;138720;228;147300;40727014;36512424;3273508;5389;3187484
FR;1;2021-11-06;18818;29820;63443;123;66411;40745832;36542244;3336951;5512;3253895
FR;1;2021-11-07;1791;3339;4959;6;5298;40747623;36545583;3341910;5518;3259193
FR;1;2021-11-08;17696;32320;125927;224;132490;40765319;36577903;3467837;5742;3391683
FR;1;2021-11-09;19260;37707;159227;335;168938;40784579;36615610;3627064;6077;3560621
FR;1;2021-11-10;28695;49202;181823;440;192371;40813274;36664812;3808887;6517;3752992
FR;1;2021-11-11;3827;5941;12197;26;13006;40817101;36670753;3821084;6543;3765998
FR;1;2021-11-12;25934;46856;174750;244;186344;40843035;36717609;3995834;6787;3952342
FR;1;2021-11-13;18696;29241;76803;111;81740;40861731;36746850;4072637;6898;4034082
FR;1;2021-11-14;2028;3314;6812;5;7382;40863759;36750164;4079449;6903;4041464
FR;1;2021-11-15;18619;34881;156347;303;166109;40882378;36785045;4235796;7206;4207573
FR;1;2021-11-16;21117;37928;192012;377;204788;40903495;36822973;4427808;7583;4412361
FR;1;2021-11-17;28513;45715;193146;399;204922;40932008;36868688;4620954;7982;4617283
FR;1;2021-11-18;21061;38941;182384;457;194362;40953069;36907629;4803338;8439;4811645
FR;1;2021-11-19;30777;53357;230148;529;246558;40983846;36960986;5033486;8968;5058203
FR;1;2021-11-20;23713;33323;96942;201;103580;41007559;36994309;5130428;9169;5161783
FR;1;2021-11-21;2313;4011;9096;18;9967;41009872;36998320;5139524;9187;5171750
FR;1;2021-11-22;21355;30499;175802;465;189318;41031227;37028819;5315326;9652;5361068
FR;1;2021-11-23;23876;41162;221099;539;237797;41055103;37069981;5536425;10191;5598865
FR;1;2021-11-24;30262;49789;217260;703;234388;41085365;37119770;5753685;10894;5833253
FR;1;2021-11-25;23506;43959;244358;718;263906;41108871;37163729;5998043;11612;6097159
FR;1;2021-11-26;30590;66527;356686;833;388365;41139461;37230256;6354729;12445;6485524
FR;1;2021-11-27;21797;45392;202555;371;222537;41161258;37275648;6557284;12816;6708061
FR;1;2021-11-28;3137;9674;54758;63;61034;41164395;37285322;6612042;12879;6769095
FR;1;2021-11-29;17856;49535;326275;840;354263;41182251;37334857;6938317;13719;7123358
FR;1;2021-11-30;22745;64948;431032;952;470600;41204996;37399805;7369349;14671;7593958
FR;1;2021-12-01;24928;69373;442744;1130;481589;41229924;37469178;7812093;15801;8075547
FR;1;2021-12-02;19984;64493;489250;1228;532697;41249908;37533671;8301343;17029;8608244
FR;1;2021-12-03;22840;81848;542608;1307;591600;41272748;37615519;8843951;18336;9199844
FR;1;2021-12-04;16374;53935;299030;652;328863;41289122;37669454;9142981;18988;9528707
FR;1;2021-12-05;3622;13914;81495;143;91053;41292744;37683368;9224476;19131;9619760
FR;1;2021-12-06;21401;62805;415315;1065;455041;41314145;37746173;9639791;20196;10074801
FR;1;2021-12-07;19808;75843;522818;1531;572430;41333953;37822016;10162609;21727;10647231
FR;1;2021-12-08;21567;75882;458228;1543;501934;41355520;37897898;10620837;23270;11149165
FR;1;2021-12-09;19398;74125;492767;1625;540634;41374918;37972023;11113604;24895;11689799
FR;1;2021-12-10;23110;87633;547268;1586;599836;41398028;38059656;11660872;26481;12289635
FR;1;2021-12-11;16516;59034;302680;747;335427;41414544;38118690;11963552;27228;12625062
FR;1;2021-12-12;4344;16020;83181;179;94070;41418888;38134710;12046733;27407;12719132
FR;1;2021-12-13;15581;63827;366828;1093;406169;41434469;38198537;12413561;28500;13125301
FR;1;2021-12-14;20548;80353;464548;1742;515022;41455017;38278890;12878109;30242;13640323
FR;1;2021-12-15;21434;77540;408925;1308;452999;41476451;38356430;13287034;31550;14093322
FR;1;2021-12-16;19972;77380;451691;1574;500463;41496423;38433810;13738725;33124;14593785
FR;1;2021-12-17;22543;86712;479793;1733;530928;41518966;38520522;14218518;34857;15124713
FR;1;2021-12-18;17585;54755;257561;730;288474;41536551;38575277;14476079;35587;15413187
FR;1;2021-12-19;5537;17122;79132;194;90734;41542088;38592399;14555211;35781;15503921
FR;1;2021-12-20;20828;63203;316110;1081;355185;41562916;38655602;14871321;36862;15859106
FR;1;2021-12-21;26113;73233;372625;1421;417976;41589029;38728835;15243946;38283;16277082
FR;1;2021-12-22;24907;66009;310513;1215;349488;41613936;38794844;15554459;39498;16626570
FR;1;2021-12-23;21238;52355;241398;954;272980;41635174;38847199;15795857;40452;16899550
FR;1;2021-12-24;7102;18260;67109;256;77030;41642276;38865459;15862966;40708;16976580
FR;1;2021-12-25;502;2782;5569;15;6530;41642778;38868241;15868535;40723;16983110
FR;1;2021-12-26;2749;7598;26922;70;31449;41645527;38875839;15895457;40793;17014559
FR;1;2021-12-27;18226;53565;235021;707;265693;41663753;38929404;16130478;41500;17280252
FR;1;2021-12-28;23256;62034;291954;1025;330142;41687009;38991438;16422432;42525;17610394
FR;1;2021-12-29;22197;55556;254921;918;288138;41709206;39046994;16677353;43443;17898532
FR;1;2021-12-30;21224;46387;212100;857;239567;41730430;39093381;16889453;44300;18138099
FR;1;2021-12-31;7461;16635;61834;229;70359;41737891;39110016;16951287;44529;18208458
FR;1;2022-01-01;1005;2483;5645;29;6577;41738896;39112499;16956932;44558;18215035
FR;1;2022-01-02;3055;8071;28874;50;33526;41741951;39120570;16985806;44608;18248561
FR;1;2022-01-03;20578;53968;228119;786;257537;41762529;39174538;17213925;45394;18506098
FR;1;2022-01-04;25231;64887;299159;1235;337210;41787760;39239425;17513084;46629;18843308
FR;1;2022-01-05;29847;63992;274772;1097;310127;41817607;39303417;17787856;47726;19153435
FR;1;2022-01-06;26636;66000;306808;1396;346439;41844243;39369417;18094664;49122;19499874
FR;1;2022-01-07;31424;74728;349756;1535;393857;41875667;39444145;18444420;50657;19893731
FR;1;2022-01-08;23356;51393;222466;695;251100;41899023;39495538;18666886;51352;20144831
FR;1;2022-01-09;7076;17183;66011;163;76144;41906099;39512721;18732897;51515;20220975
FR;1;2022-01-10;21559;56838;236698;952;267172;41927658;39569559;18969595;52467;20488147
FR;1;2022-01-11;26525;63259;282202;1277;317754;41954183;39632818;19251797;53744;20805901
FR;1;2022-01-12;28763;62318;246153;1103;277927;41982946;39695136;19497950;54847;21083828
FR;1;2022-01-13;24519;60002;262718;1252;296062;42007465;39755138;19760668;56099;21379890
FR;1;2022-01-14;27816;66578;313904;1366;351188;42035281;39821716;20074572;57465;21731078
FR;1;2022-01-15;19269;44367;199275;619;223851;42054550;39866083;20273847;58084;21954929
FR;1;2022-01-16;5135;12989;51497;135;59573;42059685;39879072;20325344;58219;22014502
FR;1;2022-01-17;16762;39737;184780;780;206820;42076447;39918809;20510124;58999;22221322
FR;1;2022-01-18;19247;45798;212354;1151;236984;42095694;39964607;20722478;60150;22458306
FR;1;2022-01-19;20187;43961;176045;896;197176;42115881;40008568;20898523;61046;22655482
FR;1;2022-01-20;16633;40454;183589;1137;204685;42132514;40049022;21082112;62183;22860167
FR;1;2022-01-21;19768;46970;228889;1406;253305;42152282;40095992;21311001;63589;23113472
FR;1;2022-01-22;13826;33312;144470;578;161365;42166108;40129304;21455471;64167;23274837
FR;1;2022-01-23;3346;8803;33402;130;38321;42169454;40138107;21488873;64297;23313158
FR;1;2022-01-24;11742;32803;142158;706;158243;42181196;40170910;21631031;65003;23471401
FR;1;2022-01-25;14107;38160;163339;1048;181524;42195303;40209070;21794370;66051;23652925
FR;1;2022-01-26;14836;37475;150199;931;166265;42210139;40246545;21944569;66982;23819190
FR;1;2022-01-27;12293;33017;143396;884;157880;42222432;40279562;22087965;67866;23977070
FR;1;2022-01-28;16253;54116;198255;1144;222440;42238685;40333678;22286220;69010;24199510
FR;1;2022-01-29;10259;35446;135176;522;151545;42248944;40369124;22421396;69532;24351055
FR;1;2022-01-30;2475;9295;29666;86;34460;42251419;40378419;22451062;69618;24385515
FR;1;2022-01-31;8732;32356;104304;530;117395;42260151;40410775;22555366;70148;24502910
FR;1;2022-02-01;10276;36295;127023;863;141230;42270427;40447070;22682389;71011;24644140
FR;1;2022-02-02;11550;41178;130305;780;145848;42281977;40488248;22812694;71791;24789988
FR;1;2022-02-03;8779;33469;116958;780;130353;42290756;40521717;22929652;72571;24920341
FR;1;2022-02-04;11422;48117;172524;965;192780;42302178;40569834;23102176;73536;25113121
FR;1;2022-02-05;7891;33906;117556;391;133057;42310069;40603740;23219732;73927;25246178
FR;1;2022-02-06;1690;8045;22734;85;26905;42311759;40611785;23242466;74012;25273083
FR;1;2022-02-07;7156;35411;119047;452;134972;42318915;40647196;23361513;74464;25408055
FR;1;2022-02-08;7578;31626;125604;694;140579;42326493;40678822;23487117;75158;25548634
FR;1;2022-02-09;8473;36246;135208;695;152428;42334966;40715068;23622325;75853;25701062
FR;1;2022-02-10;6587;29404;116303;674;130070;42341553;40744472;23738628;76527;25831132
FR;1;2022-02-11;8569;41386;165080;875;185293;42350122;40785858;23903708;77402;26016425
FR;1;2022-02-12;5296;27536;106672;378;120846;42355418;40813394;24010380;77780;26137271
FR;1;2022-02-13;1223;5700;21707;65;25319;42356641;40819094;24032087;77845;26162590
FR;1;2022-02-14;5381;27088;118038;388;133061;42362022;40846182;24150125;78233;26295651
FR;1;2022-02-15;5594;28173;118855;609;132454;42367616;40874355;24268980;78842;26428105
FR;1;2022-02-16;5656;28232;110378;595;122987;42373272;40902587;24379358;79437;26551092
FR;1;2022-02-17;4417;19338;73102;486;80180;42377689;40921925;24452460;79923;26631272
FR;1;2022-02-18;5534;26534;99154;668;108103;42383223;40948459;24551614;80591;26739375
FR;1;2022-02-19;3533;17088;59461;304;66036;42386756;40965547;24611075;80895;26805411
FR;1;2022-02-20;784;3225;10690;35;12313;42387540;40968772;24621765;80930;26817724
FR;1;2022-02-21;3363;14484;52792;286;57640;42390903;40983256;24674557;81216;26875364
FR;1;2022-02-22;3720;15387;51873;499;55600;42394623;40998643;24726430;81715;26930964
FR;1;2022-02-23;4163;17660;57450;508;62549;42398786;41016303;24783880;82223;26993513
FR;1;2022-02-24;3246;12798;43574;436;46357;42402032;41029101;24827454;82659;27039870
FR;1;2022-02-25;4405;19511;64851;695;68714;42406437;41048612;24892305;83354;27108584
FR;1;2022-02-26;2678;12693;41350;309;45103;42409115;41061305;24933655;83663;27153687
FR;1;2022-02-27;639;2170;7116;42;7981;42409754;41063475;24940771;83705;27161668
FR;1;2022-02-28;2565;10232;34925;301;37349;42412319;41073707;24975696;84006;27199017
FR;1;2022-03-01;2778;10416;38646;389;39571;42415097;41084123;25014342;84395;27238588
FR;1;2022-03-02;3451;11903;41813;390;43865;42418548;41096026;25056155;84785;27282453
FR;1;2022-03-03;2322;7609;26121;320;26434;42420870;41103635;25082276;85105;27308887
FR;1;2022-03-04;2656;10245;35393;576;34871;42423526;41113880;25117669;85681;27343758
FR;1;2022-03-05;1743;6293;21946;278;22333;42425269;41120173;25139615;85959;27366091
FR;1;2022-03-06;350;940;2914;37;3112;42425619;41121113;25142529;85996;27369203
FR;1;2022-03-07;1437;4575;16409;245;15867;42427056;41125688;25158938;86241;27385070
FR;1;2022-03-08;1542;5108;17134;307;15955;42428598;41130796;25176072;86548;27401025
FR;1;2022-03-09;1874;6492;19780;368;19127;42430472;41137288;25195852;86916;27420152
FR;1;2022-03-10;1305;4451;15203;305;14221;42431777;41141739;25211055;87221;27434373
FR;1;2022-03-11;1694;6164;21684;482;19831;42433471;41147903;25232739;87703;27454204
FR;1;2022-03-12;1226;4596;15351;276;14897;42434697;41152499;25248090;87979;27469101
FR;1;2022-03-13;240;604;2104;115;2052;42434937;41153103;25250194;88094;27471153
FR;1;2022-03-14;1075;3569;13366;3874;12489;42436012;41156672;25263560;91968;27483642
FR;1;2022-03-15;1262;3855;14527;6861;13008;42437274;41160527;25278087;98829;27496650
FR;1;2022-03-16;1605;4770;17345;11513;16398;42438879;41165297;25295432;110342;27513048
FR;1;2022-03-17;1097;3186;11680;9637;10775;42439976;41168483;25307112;119979;27523823
FR;1;2022-03-18;1668;4721;17919;16486;16348;42441644;41173204;25325031;136465;27540171
FR;1;2022-03-19;1112;3194;11881;8451;11347;42442756;41176398;25336912;144916;27551518
FR;1;2022-03-20;218;535;1718;1007;1751;42442974;41176933;25338630;145923;27553269
FR;1;2022-03-21;1040;2692;11474;13442;10819;42444014;41179625;25350104;159365;27564088
FR;1;2022-03-22;1191;3074;12222;18682;11211;42445205;41182699;25362326;178047;27575299
FR;1;2022-03-23;1467;4178;15975;20093;15655;42446672;41186877;25378301;198140;27590954
FR;1;2022-03-24;1070;2526;10360;16015;9612;42447742;41189403;25388661;214155;27600566
FR;1;2022-03-25;1499;4058;16687;25280;15330;42449241;41193461;25405348;239435;27615896
FR;1;2022-03-26;1098;2905;10839;11430;10496;42450339;41196366;25416187;250865;27626392
FR;1;2022-03-27;228;537;1738;1378;1790;42450567;41196903;25417925;252243;27628182
FR;1;2022-03-28;1035;2385;9939;15861;9560;42451602;41199288;25427864;268104;27637742
FR;1;2022-03-29;1111;2702;11525;25061;10892;42452713;41201990;25439389;293165;27648634
FR;1;2022-03-30;1595;3466;14121;24144;13652;42454308;41205456;25453510;317309;27662286
FR;1;2022-03-31;1264;2621;11630;22554;11136;42455572;41208077;25465140;339863;27673422
FR;1;2022-04-01;1664;3763;18401;28458;17246;42457236;41211840;25483541;368321;27690668
FR;1;2022-04-02;887;1854;8176;9208;7924;42458123;41213694;25491717;377529;27698592
FR;1;2022-04-03;188;366;1428;1056;1429;42458311;41214060;25493145;378585;27700021
FR;1;2022-04-04;1086;2171;11283;17631;10657;42459397;41216231;25504428;396216;27710678
FR;1;2022-04-05;1254;2495;12932;31102;11951;42460651;41218726;25517360;427318;27722629
FR;1;2022-04-06;1324;2715;12112;23768;11526;42461975;41221441;25529472;451086;27734155
FR;1;2022-04-07;1136;2496;12275;30964;11736;42463111;41223937;25541747;482050;27745891
FR;1;2022-04-08;1560;3465;17484;40405;16399;42464671;41227402;25559231;522455;27762290
FR;1;2022-04-09;803;1971;8385;12476;8078;42465474;41229373;25567616;534931;27770368
FR;1;2022-04-10;186;462;1821;1831;1855;42465660;41229835;25569437;536762;27772223
FR;1;2022-04-11;953;2104;10926;22114;10636;42466613;41231939;25580363;558876;27782859
FR;1;2022-04-12;1198;2386;12737;37838;12230;42467811;41234325;25593100;596714;27795089
FR;1;2022-04-13;1165;2603;12196;30338;11906;42468976;41236928;25605296;627052;27806995
FR;1;2022-04-14;1172;2293;11990;33292;11996;42470148;41239221;25617286;660344;27818991
FR;1;2022-04-15;1419;2785;14304;32980;13678;42471567;41242006;25631590;693324;27832669
FR;1;2022-04-16;651;1388;5821;7971;5741;42472218;41243394;25637411;701295;27838410
FR;1;2022-04-17;149;271;928;1108;970;42472367;41243665;25638339;702403;27839380
FR;1;2022-04-18;125;385;2612;982;2637;42472492;41244050;25640951;703385;27842017
FR;1;2022-04-19;1186;2491;11721;27686;11400;42473678;41246541;25652672;731071;27853417
FR;1;2022-04-20;1265;2518;12090;26664;11910;42474943;41249059;25664762;757735;27865327
FR;1;2022-04-21;1206;2341;11439;32913;11593;42476149;41251400;25676201;790648;27876920
FR;1;2022-04-22;1475;2942;15145;35342;14731;42477624;41254342;25691346;825990;27891651
FR;1;2022-04-23;746;1558;6713;9874;6617;42478370;41255900;25698059;835864;27898268
FR;1;2022-04-24;190;355;1369;1510;1321;42478560;41256255;25699428;837374;27899589
FR;1;2022-04-25;993;2047;9814;19547;9701;42479553;41258302;25709242;856921;27909290
FR;1;2022-04-26;1293;2574;12542;36347;12142;42480846;41260876;25721784;893268;27921432
FR;1;2022-04-27;1276;2348;10565;28817;10699;42482122;41263224;25732349;922085;27932131
FR;1;2022-04-28;1245;2285;11478;33835;11294;42483367;41265509;25743827;955920;27943425
FR;1;2022-04-29;1566;2902;14294;35166;13720;42484933;41268411;25758121;991086;27957145
FR;1;2022-04-30;804;1432;6365;9113;6200;42485737;41269843;25764486;1000199;27963345
FR;1;2022-05-01;151;265;809;914;804;42485888;41270108;25765295;1001113;27964149
FR;1;2022-05-02;902;1831;10209;16631;10085;42486790;41271939;25775504;1017744;27974234
FR;1;2022-05-03;1365;2501;12442;32466;12328;42488155;41274440;25787946;1050210;27986562
FR;1;2022-05-04;1271;2399;10876;23514;11022;42489426;41276839;25798822;1073724;27997584
FR;1;2022-05-05;1326;2339;11574;31346;11442;42490752;41279178;25810396;1105070;28009026
FR;1;2022-05-06;1655;3098;14044;34575;13593;42492407;41282276;25824440;1139645;28022619
FR;1;2022-05-07;823;1448;5915;9064;5947;42493230;41283724;25830355;1148709;28028566
FR;1;2022-05-08;180;318;1048;1453;1110;42493410;41284042;25831403;1150162;28029676
FR;1;2022-05-09;1012;1843;9126;18973;9032;42494422;41285885;25840529;1169135;28038708
FR;1;2022-05-10;1343;2486;12317;36659;11908;42495765;41288371;25852846;1205794;28050616
FR;1;2022-05-11;1363;2176;9750;25688;9658;42497128;41290547;25862596;1231482;28060274
FR;1;2022-05-12;1243;2212;10262;33013;9915;42498371;41292759;25872858;1264495;28070189
FR;1;2022-05-13;1554;2683;12607;35388;12252;42499925;41295442;25885465;1299883;28082441
FR;1;2022-05-14;754;1277;5392;10132;5265;42500679;41296719;25890857;1310015;28087706
FR;1;2022-05-15;205;364;1143;1333;1210;42500884;41297083;25892000;1311348;28088916
FR;1;2022-05-16;913;1657;7857;19772;7888;42501797;41298740;25899857;1331120;28096804
FR;1;2022-05-17;1230;2178;10931;35581;10534;42503027;41300918;25910788;1366701;28107338
FR;1;2022-05-18;1226;1988;8661;25355;8618;42504253;41302906;25919449;1392056;28115956
FR;1;2022-05-19;1135;2249;9620;33202;9626;42505388;41305155;25929069;1425258;28125582
FR;1;2022-05-20;1518;2602;12159;37216;11754;42506906;41307757;25941228;1462474;28137336
FR;1;2022-05-21;751;1325;5162;9230;5075;42507657;41309082;25946390;1471704;28142411
FR;1;2022-05-22;180;274;927;1338;919;42507837;41309356;25947317;1473042;28143330
FR;1;2022-05-23;901;1695;7669;18967;7619;42508738;41311051;25954986;1492009;28150949
FR;1;2022-05-24;1230;2325;10039;36350;9901;42509968;41313376;25965025;1528359;28160850
FR;1;2022-05-25;1218;2175;8485;23166;8622;42511186;41315551;25973510;1551525;28169472
FR;1;2022-05-26;137;256;1036;1052;1062;42511323;41315807;25974546;1552577;28170534
FR;1;2022-05-27;1038;1997;7824;20258;7620;42512361;41317804;25982370;1572835;28178154
FR;1;2022-05-28;463;994;3381;6499;3430;42512824;41318798;25985751;1579334;28181584
FR;1;2022-05-29;107;241;673;852;678;42512931;41319039;25986424;1580186;28182262
FR;1;2022-05-30;778;1623;5987;18199;6001;42513709;41320662;25992411;1598385;28188263
FR;1;2022-05-31;1217;2077;8978;33864;8868;42514926;41322739;26001389;1632249;28197131
FR;1;2022-06-01;1102;2013;7340;22696;7238;42516028;41324752;26008729;1654945;28204369
FR;1;2022-06-02;1107;2051;8398;33360;8031;42517135;41326803;26017127;1688305;28212400
FR;1;2022-06-03;1302;2501;9767;36518;9387;42518437;41329304;26026894;1724823;28221787
FR;1;2022-06-04;633;1183;3964;8502;4054;42519070;41330487;26030858;1733325;28225841
FR;1;2022-06-05;104;250;715;944;731;42519174;41330737;26031573;1734269;28226572
FR;1;2022-06-06;103;223;721;1008;720;42519277;41330960;26032294;1735277;28227292
FR;1;2022-06-07;1036;2067;8198;33344;7887;42520313;41333027;26040492;1768621;28235179
FR;1;2022-06-08;1013;2011;7294;26697;7164;42521326;41335038;26047786;1795318;28242343
FR;1;2022-06-09;949;1873;7741;35546;7426;42522275;41336911;26055527;1830864;28249769
FR;2;2020-12-27;0;0;0;0;0;0;0;0;0;0
FR;2;2020-12-28;0;0;0;0;0;0;0;0;0;0
FR;2;2020-12-29;0;0;0;0;0;0;0;0;0;0
FR;2;2020-12-30;0;0;0;0;0;0;0;0;0;0
FR;2;2020-12-31;0;0;0;0;0;0;0;0;0;0
FR;2;2021-01-01;0;0;0;0;0;0;0;0;0;0
FR;2;2021-01-02;0;0;0;0;0;0;0;0;0;0
FR;2;2021-01-03;0;0;0;0;0;0;0;0;0;0
FR;2;2021-01-04;0;0;0;0;0;0;0;0;0;0
FR;2;2021-01-05;0;0;0;0;0;0;0;0;0;0
FR;2;2021-01-06;0;0;0;0;0;0;0;0;0;0
FR;2;2021-01-07;0;0;0;0;0;0;0;0;0;0
FR;2;2021-01-08;0;0;0;0;0;0;0;0;0;0
FR;2;2021-01-09;0;0;0;0;0;0;0;0;0;0
FR;2;2021-01-10;0;0;0;0;0;0;0;0;0;0
FR;2;2021-01-11;0;0;0;0;0;0;0;0;0;0
FR;2;2021-01-12;0;0;0;0;0;0;0;0;0;0
FR;2;2021-01-13;0;0;0;0;0;0;0;0;0;0
FR;2;2021-01-14;1681;0;0;0;0;1681;0;0;0;0
FR;2;2021-01-15;396;0;0;0;0;2077;0;0;0;0
FR;2;2021-01-16;315;0;0;0;0;2392;0;0;0;0
FR;2;2021-01-17;81;0;0;0;0;2473;0;0;0;0
FR;2;2021-01-18;3073;2;0;0;0;5546;2;0;0;0
FR;2;2021-01-19;4677;0;0;0;0;10223;2;0;0;0
FR;2;2021-01-20;5135;4;0;0;0;15358;6;0;0;0
FR;2;2021-01-21;5338;9;0;0;0;20696;15;0;0;0
FR;2;2021-01-22;5115;9;0;0;0;25811;24;0;0;0
FR;2;2021-01-23;1866;0;0;0;0;27677;24;0;0;0
FR;2;2021-01-24;160;1;0;0;0;27837;25;0;0;0
FR;2;2021-01-25;3811;3;0;0;0;31648;28;0;0;0
FR;2;2021-01-26;3919;1;0;0;0;35567;29;0;0;0
FR;2;2021-01-27;3598;2;0;0;0;39165;31;0;0;0
FR;2;2021-01-28;3748;7;0;0;0;42913;38;0;0;0
FR;2;2021-01-29;3293;2;0;0;0;46206;40;0;0;0
FR;2;2021-01-30;1130;1;0;0;0;47336;41;0;0;0
FR;2;2021-01-31;45;1;0;0;0;47381;42;0;0;0
FR;2;2021-02-01;3400;4;0;0;0;50781;46;0;0;0
FR;2;2021-02-02;4489;10;0;0;0;55270;56;0;0;0
FR;2;2021-02-03;5218;6;0;0;0;60488;62;0;0;0
FR;2;2021-02-04;4931;10;0;0;0;65419;72;0;0;0
FR;2;2021-02-05;4810;13;0;0;0;70229;85;0;0;0
FR;2;2021-02-06;2040;13;0;0;0;72269;98;0;0;0
FR;2;2021-02-07;101;4;0;0;0;72370;102;0;0;0
FR;2;2021-02-08;7553;21;0;0;0;79923;123;0;0;0
FR;2;2021-02-09;8420;28;0;0;0;88343;151;0;0;0
FR;2;2021-02-10;9338;59;0;0;0;97681;210;0;0;0
FR;2;2021-02-11;10280;99;0;0;0;107961;309;0;0;0
FR;2;2021-02-12;10055;261;0;0;0;118016;570;0;0;0
FR;2;2021-02-13;3119;226;0;0;0;121135;796;0;0;0
FR;2;2021-02-14;355;9;0;0;0;121490;805;0;0;0
FR;2;2021-02-15;3454;3100;0;0;0;124944;3905;0;0;0
FR;2;2021-02-16;5066;4033;0;0;0;130010;7938;0;0;0
FR;2;2021-02-17;4253;4472;0;0;0;134263;12410;0;0;0
FR;2;2021-02-18;5400;5120;0;0;0;139663;17530;0;0;0
FR;2;2021-02-19;5324;4404;0;0;0;144987;21934;0;0;0
FR;2;2021-02-20;1869;1508;0;0;0;146856;23442;0;0;0
FR;2;2021-02-21;242;88;0;0;0;147098;23530;0;0;0
FR;2;2021-02-22;3612;3750;0;0;0;150710;27280;0;0;0
FR;2;2021-02-23;4952;3692;0;0;0;155662;30972;0;0;0
FR;2;2021-02-24;5010;3495;0;0;0;160672;34467;0;0;0
FR;2;2021-02-25;5483;3456;0;0;0;166155;37923;0;0;0
FR;2;2021-02-26;4361;3150;0;0;0;170516;41073;0;0;0
FR;2;2021-02-27;1623;1052;0;0;0;172139;42125;0;0;0
FR;2;2021-02-28;177;29;0;0;0;172316;42154;0;0;0
FR;2;2021-03-01;5179;3725;0;0;0;177495;45879;0;0;0
FR;2;2021-03-02;6528;4731;0;0;0;184023;50610;0;0;0
FR;2;2021-03-03;6534;4923;0;0;0;190557;55533;0;0;0
FR;2;2021-03-04;8399;4066;0;0;0;198956;59599;0;0;0
FR;2;2021-03-05;8028;4061;0;0;0;206984;63660;0;0;0
FR;2;2021-03-06;4784;1686;0;0;0;211768;65346;0;0;0
FR;2;2021-03-07;2372;30;0;0;0;214140;65376;0;0;0
FR;2;2021-03-08;4165;8332;0;0;0;218305;73708;0;0;0
FR;2;2021-03-09;7487;8500;1;0;0;225792;82208;1;0;0
FR;2;2021-03-10;7099;9142;0;0;0;232891;91350;1;0;0
FR;2;2021-03-11;9372;9244;1;0;0;242263;100594;2;0;0
FR;2;2021-03-12;7972;8229;0;0;0;250235;108823;2;0;0
FR;2;2021-03-13;10046;2560;0;0;0;260281;111383;2;0;0
FR;2;2021-03-14;4838;403;0;0;0;265119;111786;2;0;0
FR;2;2021-03-15;10908;3488;0;0;0;276027;115274;2;0;0
FR;2;2021-03-16;16762;4647;1;0;0;292789;119921;3;0;0
FR;2;2021-03-17;20227;3974;0;0;0;313016;123895;3;0;0
FR;2;2021-03-18;23365;4977;0;0;0;336381;128872;3;0;0
FR;2;2021-03-19;23303;4587;0;0;0;359684;133459;3;0;0
FR;2;2021-03-20;25444;1548;0;0;0;385128;135007;3;0;0
FR;2;2021-03-21;17670;150;0;0;0;402798;135157;3;0;0
FR;2;2021-03-22;17782;3145;0;0;0;420580;138302;3;0;0
FR;2;2021-03-23;22687;4199;0;0;0;443267;142501;3;0;0
FR;2;2021-03-24;23955;5021;0;0;0;467222;147522;3;0;0
FR;2;2021-03-25;26740;5140;1;0;0;493962;152662;4;0;0
FR;2;2021-03-26;26977;4238;0;0;0;520939;156900;4;0;0
FR;2;2021-03-27;15918;1330;0;0;0;536857;158230;4;0;0
FR;2;2021-03-28;10561;120;0;0;0;547418;158350;4;0;0
FR;2;2021-03-29;18987;4291;0;0;0;566405;162641;4;0;0
FR;2;2021-03-30;24577;6029;0;0;0;590982;168670;4;0;0
FR;2;2021-03-31;28553;5925;0;0;0;619535;174595;4;0;0
FR;2;2021-04-01;34544;8504;1;0;0;654079;183099;5;0;0
FR;2;2021-04-02;29976;7666;0;0;0;684055;190765;5;0;0
FR;2;2021-04-03;16953;3805;0;0;0;701008;194570;5;0;0
FR;2;2021-04-04;9305;1027;2;0;0;710313;195597;7;0;0
FR;2;2021-04-05;12444;805;0;0;0;722757;196402;7;0;0
FR;2;2021-04-06;27144;7043;0;0;0;749901;203445;7;0;0
FR;2;2021-04-07;30927;7145;1;0;0;780828;210590;8;0;0
FR;2;2021-04-08;36880;8738;1;0;0;817708;219328;9;0;0
FR;2;2021-04-09;33835;8532;28;0;0;851543;227860;37;0;0
FR;2;2021-04-10;19678;9038;1;0;0;871221;236898;38;0;0
FR;2;2021-04-11;7941;4254;1;0;0;879162;241152;39;0;0
FR;2;2021-04-12;17121;11136;0;0;0;896283;252288;39;0;0
FR;2;2021-04-13;19448;16183;1;0;0;915731;268471;40;0;0
FR;2;2021-04-14;18060;16311;7;0;0;933791;284782;47;0;0
FR;2;2021-04-15;22188;21024;27;0;0;955979;305806;74;0;0
FR;2;2021-04-16;20705;20169;45;0;0;976684;325975;119;0;0
FR;2;2021-04-17;13253;22435;5;0;0;989937;348410;124;0;0
FR;2;2021-04-18;5907;14393;6;0;0;995844;362803;130;0;0
FR;2;2021-04-19;16831;16275;24;0;0;1012675;379078;154;0;0
FR;2;2021-04-20;19319;21591;38;0;0;1031994;400669;192;0;0
FR;2;2021-04-21;20282;21715;76;0;0;1052276;422384;268;0;0
FR;2;2021-04-22;23810;24869;41;0;0;1076086;447253;309;0;0
FR;2;2021-04-23;24518;25359;76;0;0;1100604;472612;385;0;0
FR;2;2021-04-24;25301;15085;104;0;0;1125905;487697;489;0;0
FR;2;2021-04-25;9594;8601;5;0;0;1135499;496298;494;0;0
FR;2;2021-04-26;17157;17266;21;0;0;1152656;513564;515;0;0
FR;2;2021-04-27;19240;24222;40;0;0;1171896;537786;555;0;0
FR;2;2021-04-28;22333;26226;112;0;0;1194229;564012;667;0;0
FR;2;2021-04-29;25467;30160;69;0;0;1219696;594172;736;0;0
FR;2;2021-04-30;25529;27748;49;1;0;1245225;621920;785;1;0
FR;2;2021-05-01;14983;9870;6;0;0;1260208;631790;791;1;0
FR;2;2021-05-02;6635;9175;2;0;0;1266843;640965;793;1;0
FR;2;2021-05-03;20012;19233;40;0;0;1286855;660198;833;1;0
FR;2;2021-05-04;18280;29053;33;0;0;1305135;689251;866;1;0
FR;2;2021-05-05;18361;29394;48;0;0;1323496;718645;914;1;0
FR;2;2021-05-06;23540;35258;131;0;0;1347036;753903;1045;1;0
FR;2;2021-05-07;25324;33195;97;0;0;1372360;787098;1142;1;0
FR;2;2021-05-08;21337;9860;14;0;0;1393697;796958;1156;1;0
FR;2;2021-05-09;13162;7833;7;0;0;1406859;804791;1163;1;0
FR;2;2021-05-10;32937;22102;49;0;0;1439796;826893;1212;1;0
FR;2;2021-05-11;43595;21015;101;0;0;1483391;847908;1313;1;0
FR;2;2021-05-12;50041;19828;143;0;0;1533432;867736;1456;1;0
FR;2;2021-05-13;51289;5737;31;0;0;1584721;873473;1487;1;0
FR;2;2021-05-14;61344;12910;132;0;0;1646065;886383;1619;1;0
FR;2;2021-05-15;65927;7137;39;0;0;1711992;893520;1658;1;0
FR;2;2021-05-16;43581;2567;10;0;0;1755573;896087;1668;1;0
FR;2;2021-05-17;44742;12570;114;0;0;1800315;908657;1782;1;0
FR;2;2021-05-18;54635;12238;191;0;0;1854950;920895;1973;1;0
FR;2;2021-05-19;57164;10587;281;0;0;1912114;931482;2254;1;0
FR;2;2021-05-20;63432;10835;287;0;0;1975546;942317;2541;1;0
FR;2;2021-05-21;64289;11639;230;0;0;2039835;953956;2771;1;0
FR;2;2021-05-22;61479;4507;65;0;0;2101314;958463;2836;1;0
FR;2;2021-05-23;37531;571;22;0;0;2138845;959034;2858;1;0
FR;2;2021-05-24;17236;2037;34;0;0;2156081;961071;2892;1;0
FR;2;2021-05-25;21104;12221;240;0;0;2177185;973292;3132;1;0
FR;2;2021-05-26;19933;11459;229;0;0;2197118;984751;3361;1;0
FR;2;2021-05-27;22994;12660;182;0;0;2220112;997411;3543;1;0
FR;2;2021-05-28;29389;14953;190;0;0;2249501;1012364;3733;1;0
FR;2;2021-05-29;30418;8180;57;0;0;2279919;1020544;3790;1;0
FR;2;2021-05-30;4646;1818;6;0;0;2284565;1022362;3796;1;0
FR;2;2021-05-31;28587;18712;183;0;0;2313152;1041074;3979;1;0
FR;2;2021-06-01;45712;19998;224;0;0;2358864;1061072;4203;1;0
FR;2;2021-06-02;37465;19289;182;0;0;2396329;1080361;4385;1;0
FR;2;2021-06-03;51270;23310;161;0;0;2447599;1103671;4546;1;0
FR;2;2021-06-04;65509;24052;215;0;0;2513108;1127723;4761;1;0
FR;2;2021-06-05;34598;24036;51;0;0;2547706;1151759;4812;1;0
FR;2;2021-06-06;4953;6199;10;0;0;2552659;1157958;4822;1;0
FR;2;2021-06-07;28167;23041;146;0;0;2580826;1180999;4968;1;0
FR;2;2021-06-08;46369;22920;143;0;0;2627195;1203919;5111;1;0
FR;2;2021-06-09;34285;20909;107;0;0;2661480;1224828;5218;1;0
FR;2;2021-06-10;42636;19128;95;1;0;2704116;1243956;5313;2;0
FR;2;2021-06-11;55290;25218;134;0;0;2759406;1269174;5447;2;0
FR;2;2021-06-12;30559;19774;53;0;0;2789965;1288948;5500;2;0
FR;2;2021-06-13;3329;9186;13;0;0;2793294;1298134;5513;2;0
FR;2;2021-06-14;25295;24155;92;0;0;2818589;1322289;5605;2;0
FR;2;2021-06-15;39034;22843;154;0;0;2857623;1345132;5759;2;0
FR;2;2021-06-16;30159;21435;134;0;0;2887782;1366567;5893;2;0
FR;2;2021-06-17;36905;25853;150;0;0;2924687;1392420;6043;2;0
FR;2;2021-06-18;46845;28816;122;0;0;2971532;1421236;6165;2;0
FR;2;2021-06-19;24524;24894;39;0;0;2996056;1446130;6204;2;0
FR;2;2021-06-20;3740;10064;10;0;0;2999796;1456194;6214;2;0
FR;2;2021-06-21;17521;42841;87;0;0;3017317;1499035;6301;2;0
FR;2;2021-06-22;28357;49564;110;0;0;3045674;1548599;6411;2;0
FR;2;2021-06-23;21788;49561;107;1;1;3067462;1598160;6518;3;1
FR;2;2021-06-24;28375;50280;133;0;0;3095837;1648440;6651;3;1
FR;2;2021-06-25;33399;60399;127;0;0;3129236;1708839;6778;3;1
FR;2;2021-06-26;16378;59248;54;1;0;3145614;1768087;6832;4;1
FR;2;2021-06-27;2564;29321;22;1;0;3148178;1797408;6854;5;1
FR;2;2021-06-28;12637;54339;83;0;0;3160815;1851747;6937;5;1
FR;2;2021-06-29;19841;59887;178;0;0;3180656;1911634;7115;5;1
FR;2;2021-06-30;16322;57886;252;17;0;3196978;1969520;7367;22;1
FR;2;2021-07-01;20484;59893;227;0;0;3217462;2029413;7594;22;1
FR;2;2021-07-02;24071;62143;184;0;0;3241533;2091556;7778;22;1
FR;2;2021-07-03;12112;57078;153;0;0;3253645;2148634;7931;22;1
FR;2;2021-07-04;1957;23309;18;0;0;3255602;2171943;7949;22;1
FR;2;2021-07-05;9171;29368;106;0;0;3264773;2201311;8055;22;1
FR;2;2021-07-06;14575;36206;135;0;0;3279348;2237517;8190;22;1
FR;2;2021-07-07;14404;33672;139;0;0;3293752;2271189;8329;22;1
FR;2;2021-07-08;19714;40300;162;0;0;3313466;2311489;8491;22;1
FR;2;2021-07-09;27094;54280;202;1;0;3340560;2365769;8693;23;1
FR;2;2021-07-10;13384;33666;107;0;0;3353944;2399435;8800;23;1
FR;2;2021-07-11;1805;4351;16;0;0;3355749;2403786;8816;23;1
FR;2;2021-07-12;12963;37274;118;0;0;3368712;2441060;8934;23;1
FR;2;2021-07-13;37111;53216;150;0;0;3405823;2494276;9084;23;1
FR;2;2021-07-14;6609;3560;15;0;0;3412432;2497836;9099;23;1
FR;2;2021-07-15;47235;47023;156;0;0;3459667;2544859;9255;23;1
FR;2;2021-07-16;64306;55809;187;0;0;3523973;2600668;9442;23;1
FR;2;2021-07-17;31593;23931;96;0;0;3555566;2624599;9538;23;1
FR;2;2021-07-18;6086;4881;19;0;0;3561652;2629480;9557;23;1
FR;2;2021-07-19;32990;28681;94;0;0;3594642;2658161;9651;23;1
FR;2;2021-07-20;51989;44563;155;0;0;3646631;2702724;9806;23;1
FR;2;2021-07-21;45245;34754;93;0;0;3691876;2737478;9899;23;1
FR;2;2021-07-22;56273;41093;128;1;0;3748149;2778571;10027;24;1
FR;2;2021-07-23;68280;49078;170;0;0;3816429;2827649;10197;24;1
FR;2;2021-07-24;36168;21594;82;0;0;3852597;2849243;10279;24;1
FR;2;2021-07-25;6744;2650;10;0;0;3859341;2851893;10289;24;1
FR;2;2021-07-26;36299;22446;91;1;0;3895640;2874339;10380;25;1
FR;2;2021-07-27;62362;34617;180;0;0;3958002;2908956;10560;25;1
FR;2;2021-07-28;55300;26451;132;0;0;4013302;2935407;10692;25;1
FR;2;2021-07-29;68459;32792;189;0;0;4081761;2968199;10881;25;1
FR;2;2021-07-30;74435;37769;222;1;1;4156196;3005968;11103;26;2
FR;2;2021-07-31;34753;16191;104;0;0;4190949;3022159;11207;26;2
FR;2;2021-08-01;5398;2275;19;0;0;4196347;3024434;11226;26;2
FR;2;2021-08-02;35866;16200;101;0;0;4232213;3040634;11327;26;2
FR;2;2021-08-03;55968;28291;142;0;0;4288181;3068925;11469;26;2
FR;2;2021-08-04;46625;20863;128;1;0;4334806;3089788;11597;27;2
FR;2;2021-08-05;54622;31588;215;0;0;4389428;3121376;11812;27;2
FR;2;2021-08-06;58082;42385;242;1;0;4447510;3163761;12054;28;2
FR;2;2021-08-07;25141;17603;89;0;0;4472651;3181364;12143;28;2
FR;2;2021-08-08;3833;3667;21;0;0;4476484;3185031;12164;28;2
FR;2;2021-08-09;29303;21126;91;0;0;4505787;3206157;12255;28;2
FR;2;2021-08-10;44990;33514;154;0;0;4550777;3239671;12409;28;2
FR;2;2021-08-11;35266;25175;151;0;0;4586043;3264846;12560;28;2
FR;2;2021-08-12;41894;35735;162;0;0;4627937;3300581;12722;28;2
FR;2;2021-08-13;42588;37080;218;0;0;4670525;3337661;12940;28;2
FR;2;2021-08-14;18509;22248;93;0;0;4689034;3359909;13033;28;2
FR;2;2021-08-15;3822;3811;17;0;0;4692856;3363720;13050;28;2
FR;2;2021-08-16;25079;27200;110;0;0;4717935;3390920;13160;28;2
FR;2;2021-08-17;38251;43485;205;2;0;4756186;3434405;13365;30;2
FR;2;2021-08-18;32246;36364;195;1;1;4788432;3470769;13560;31;3
FR;2;2021-08-19;37429;46586;224;0;0;4825861;3517355;13784;31;3
FR;2;2021-08-20;40558;55607;269;1;0;4866419;3572962;14053;32;3
FR;2;2021-08-21;18117;24308;115;0;0;4884536;3597270;14168;32;3
FR;2;2021-08-22;2905;4319;22;1;1;4887441;3601589;14190;33;4
FR;2;2021-08-23;19240;35158;131;1;0;4906681;3636747;14321;34;4
FR;2;2021-08-24;31940;56034;235;0;0;4938621;3692781;14556;34;4
FR;2;2021-08-25;25926;43433;250;0;0;4964547;3736214;14806;34;4
FR;2;2021-08-26;32351;55795;387;0;0;4996898;3792009;15193;34;4
FR;2;2021-08-27;36995;65597;478;2;0;5033893;3857606;15671;36;4
FR;2;2021-08-28;17814;28491;300;0;0;5051707;3886097;15971;36;4
FR;2;2021-08-29;2654;5032;47;0;0;5054361;3891129;16018;36;4
FR;2;2021-08-30;18412;37744;399;0;755;5072773;3928873;16417;36;759
FR;2;2021-08-31;28076;57497;886;4;1546;5100849;3986370;17303;40;2305
FR;2;2021-09-01;21591;39846;1308;0;2095;5122440;4026216;18611;40;4400
FR;2;2021-09-02;25480;48618;1962;2;3300;5147920;4074834;20573;42;7700
FR;2;2021-09-03;33405;64489;2988;3;4832;5181325;4139323;23561;45;12532
FR;2;2021-09-04;16827;27703;1442;1;2358;5198152;4167026;25003;46;14890
FR;2;2021-09-05;2261;3609;265;0;411;5200413;4170635;25268;46;15301
FR;2;2021-09-06;14038;28729;1769;1;2929;5214451;4199364;27037;47;18230
FR;2;2021-09-07;21102;41061;3020;13;4863;5235553;4240425;30057;60;23093
FR;2;2021-09-08;17241;31934;2732;6;4469;5252794;4272359;32789;66;27562
FR;2;2021-09-09;20974;40429;4432;3;6755;5273768;4312788;37221;69;34317
FR;2;2021-09-10;28197;51164;5282;4;8832;5301965;4363952;42503;73;43149
FR;2;2021-09-11;13653;22359;2403;5;3941;5315618;4386311;44906;78;47090
FR;2;2021-09-12;1822;2787;284;0;505;5317440;4389098;45190;78;47595
FR;2;2021-09-13;11656;21444;2470;4;4013;5329096;4410542;47660;82;51608
FR;2;2021-09-14;18567;32775;5084;13;9049;5347663;4443317;52744;95;60657
FR;2;2021-09-15;14911;28280;5164;3;7777;5362574;4471597;57908;98;68434
FR;2;2021-09-16;16074;32768;6735;14;10528;5378648;4504365;64643;112;78962
FR;2;2021-09-17;20911;47093;8777;10;14580;5399559;4551458;73420;122;93542
FR;2;2021-09-18;9854;20922;3804;6;6020;5409413;4572380;77224;128;99562
FR;2;2021-09-19;1164;2648;396;0;644;5410577;4575028;77620;128;100206
FR;2;2021-09-20;7492;18778;3851;7;6154;5418069;4593806;81471;135;106360
FR;2;2021-09-21;11207;30005;6494;5;10740;5429276;4623811;87965;140;117100
FR;2;2021-09-22;9406;23539;5491;7;8514;5438682;4647350;93456;147;125614
FR;2;2021-09-23;10723;28875;7879;9;12633;5449405;4676225;101335;156;138247
FR;2;2021-09-24;15066;42871;10874;18;17199;5464471;4719096;112209;174;155446
FR;2;2021-09-25;7256;18744;3963;10;6084;5471727;4737840;116172;184;161530
FR;2;2021-09-26;1079;2557;494;0;631;5472806;4740397;116666;184;162161
FR;2;2021-09-27;6313;16451;4286;8;6551;5479119;4756848;120952;192;168712
FR;2;2021-09-28;9238;25551;7768;13;12075;5488357;4782399;128720;205;180787
FR;2;2021-09-29;8079;20204;6066;25;9263;5496436;4802603;134786;230;190050
FR;2;2021-09-30;9862;25797;9503;16;14080;5506298;4828400;144289;246;204130
FR;2;2021-10-01;13968;35641;12913;25;19236;5520266;4864041;157202;271;223366
FR;2;2021-10-02;6874;15881;4845;6;7009;5527140;4879922;162047;277;230375
FR;2;2021-10-03;841;1933;492;1;511;5527981;4881855;162539;278;230886
FR;2;2021-10-04;5819;13929;5516;5;7861;5533800;4895784;168055;283;238747
FR;2;2021-10-05;9052;22546;11121;19;15716;5542852;4918330;179176;302;254463
FR;2;2021-10-06;7783;17736;8240;11;11070;5550635;4936066;187416;313;265533
FR;2;2021-10-07;9195;22181;12378;15;16838;5559830;4958247;199794;328;282371
FR;2;2021-10-08;13425;32056;17346;27;23538;5573255;4990303;217140;355;305909
FR;2;2021-10-09;5998;12832;6041;6;7884;5579253;5003135;223181;361;313793
FR;2;2021-10-10;883;1633;436;2;630;5580136;5004768;223617;363;314423
FR;2;2021-10-11;5605;11591;6454;17;8830;5585741;5016359;230071;380;323253
FR;2;2021-10-12;8033;17754;12538;13;16731;5593774;5034113;242609;393;339984
FR;2;2021-10-13;6944;14848;10245;11;13608;5600718;5048961;252854;404;353592
FR;2;2021-10-14;8309;17944;14990;13;19449;5609027;5066905;267844;417;373041
FR;2;2021-10-15;11846;26278;20902;26;27945;5620873;5093183;288746;443;400986
FR;2;2021-10-16;5138;8727;1818;0;3207;5626011;5101910;290564;443;404193
FR;2;2021-10-17;651;1185;184;0;373;5626662;5103095;290748;443;404566
FR;2;2021-10-18;4559;7419;661;2;1673;5631221;5110514;291409;445;406239
FR;2;2021-10-19;6235;9888;729;5;2049;5637456;5120402;292138;450;408288
FR;2;2021-10-20;5163;8094;756;3;1685;5642619;5128496;292894;453;409973
FR;2;2021-10-21;6089;9968;779;5;2100;5648708;5138464;293673;458;412073
FR;2;2021-10-22;8448;14582;1147;4;2879;5657156;5153046;294820;462;414952
FR;2;2021-10-23;3840;6000;585;0;1235;5660996;5159046;295405;462;416187
FR;2;2021-10-24;494;888;100;0;203;5661490;5159934;295505;462;416390
FR;2;2021-10-25;3357;5367;304;1;826;5664847;5165301;295809;463;417216
FR;2;2021-10-26;4175;7256;1125;4;2004;5669022;5172557;296934;467;419220
FR;2;2021-10-27;3673;6632;1193;5;1998;5672695;5179189;298127;472;421218
FR;2;2021-10-28;4596;7695;1728;3;2747;5677291;5186884;299855;475;423965
FR;2;2021-10-29;5408;11073;2433;4;3669;5682699;5197957;302288;479;427634
FR;2;2021-10-30;2748;4441;973;1;1428;5685447;5202398;303261;480;429062
FR;2;2021-10-31;363;532;139;1;187;5685810;5202930;303400;481;429249
FR;2;2021-11-01;423;553;175;0;267;5686233;5203483;303575;481;429516
FR;2;2021-11-02;3287;6756;1179;0;1757;5689520;5210239;304754;481;431273
FR;2;2021-11-03;3338;6250;1383;2;1966;5692858;5216489;306137;483;433239
FR;2;2021-11-04;3985;7097;1762;4;2492;5696843;5223586;307899;487;435731
FR;2;2021-11-05;5227;10508;2864;5;3943;5702070;5234094;310763;492;439674
FR;2;2021-11-06;2594;4668;1398;0;1810;5704664;5238762;312161;492;441484
FR;2;2021-11-07;507;865;218;0;287;5705171;5239627;312379;492;441771
FR;2;2021-11-08;2578;5362;1201;3;1676;5707749;5244989;313580;495;443447
FR;2;2021-11-09;2750;6949;2395;6;3176;5710499;5251938;315975;501;446623
FR;2;2021-11-10;2587;5710;5094;6;6274;5713086;5257648;321069;507;452897
FR;2;2021-11-11;436;746;732;2;913;5713522;5258394;321801;509;453810
FR;2;2021-11-12;2951;8114;8965;8;10903;5716473;5266508;330766;517;464713
FR;2;2021-11-13;1534;3382;3865;7;4528;5718007;5269890;334631;524;469241
FR;2;2021-11-14;254;602;349;1;485;5718261;5270492;334980;525;469726
FR;2;2021-11-15;1622;3688;4435;9;5320;5719883;5274180;339415;534;475046
FR;2;2021-11-16;2184;5947;8297;14;10076;5722067;5280127;347712;548;485122
FR;2;2021-11-17;1739;4553;6619;8;7831;5723806;5284680;354331;556;492953
FR;2;2021-11-18;2189;5948;9171;11;10996;5725995;5290628;363502;567;503949
FR;2;2021-11-19;2697;7803;12959;19;15467;5728692;5298431;376461;586;519416
FR;2;2021-11-20;1563;3339;5173;5;6080;5730255;5301770;381634;591;525496
FR;2;2021-11-21;246;519;540;0;662;5730501;5302289;382174;591;526158
FR;2;2021-11-22;1275;2622;4469;5;5400;5731776;5304911;386643;596;531558
FR;2;2021-11-23;1614;4307;8188;9;9895;5733390;5309218;394831;605;541453
FR;2;2021-11-24;1418;3792;7463;14;8723;5734808;5313010;402294;619;550176
FR;2;2021-11-25;1812;4895;11450;21;13650;5736620;5317905;413744;640;563826
FR;2;2021-11-26;2538;7780;22656;31;26068;5739158;5325685;436400;671;589894
FR;2;2021-11-27;1497;4139;12256;18;13998;5740655;5329824;448656;689;603892
FR;2;2021-11-28;291;841;1967;3;2291;5740946;5330665;450623;692;606183
FR;2;2021-11-29;1444;4379;15073;23;17241;5742390;5335044;465696;715;623424
FR;2;2021-11-30;1910;6752;26221;36;29979;5744300;5341796;491917;751;653403
FR;2;2021-12-01;1906;6091;26185;29;29506;5746206;5347887;518102;780;682909
FR;2;2021-12-02;1908;6826;37685;52;41931;5748114;5354713;555787;832;724840
FR;2;2021-12-03;2550;10108;53588;112;59312;5750664;5364821;609375;944;784152
FR;2;2021-12-04;1849;6303;37092;38;40770;5752513;5371124;646467;982;824922
FR;2;2021-12-05;458;2262;14252;14;15989;5752971;5373386;660719;996;840911
FR;2;2021-12-06;2467;9894;77684;109;84730;5755438;5383280;738403;1105;925641
FR;2;2021-12-07;3446;15333;122411;238;133700;5758884;5398613;860814;1343;1059341
FR;2;2021-12-08;3718;16062;133172;330;145377;5762602;5414675;993986;1673;1204718
FR;2;2021-12-09;4544;19636;170150;554;185513;5767146;5434311;1164136;2227;1390231
FR;2;2021-12-10;4672;22814;188609;490;206043;5771818;5457125;1352745;2717;1596274
FR;2;2021-12-11;3682;16622;132423;239;144854;5775500;5473747;1485168;2956;1741128
FR;2;2021-12-12;1257;7127;59082;83;65130;5776757;5480874;1544250;3039;1806258
FR;2;2021-12-13;5525;26870;220657;604;242945;5782282;5507744;1764907;3643;2049203
FR;2;2021-12-14;7018;37521;300717;910;332181;5789300;5545265;2065624;4553;2381384
FR;2;2021-12-15;6557;36239;285175;955;315771;5795857;5581504;2350799;5508;2697155
FR;2;2021-12-16;7761;37924;312104;981;343690;5803618;5619428;2662903;6489;3040845
FR;2;2021-12-17;8682;41247;327831;976;360909;5812300;5660675;2990734;7465;3401754
FR;2;2021-12-18;6515;26562;212320;448;233620;5818815;5687237;3203054;7913;3635374
FR;2;2021-12-19;2600;11489;90202;183;100377;5821415;5698726;3293256;8096;3735751
FR;2;2021-12-20;9549;33609;275160;706;303335;5830964;5732335;3568416;8802;4039086
FR;2;2021-12-21;11555;38327;309594;969;341381;5842519;5770662;3878010;9771;4380467
FR;2;2021-12-22;10458;32849;265082;952;292463;5852977;5803511;4143092;10723;4672930
FR;2;2021-12-23;9429;26711;199462;700;221262;5862406;5830222;4342554;11423;4894192
FR;2;2021-12-24;2781;7502;43846;140;49562;5865187;5837724;4386400;11563;4943754
FR;2;2021-12-25;201;698;2000;10;2493;5865388;5838422;4388400;11573;4946247
FR;2;2021-12-26;1322;4212;25148;71;28676;5866710;5842634;4413548;11644;4974923
FR;2;2021-12-27;8076;29939;218382;659;243305;5874786;5872573;4631930;12303;5218228
FR;2;2021-12-28;9840;36340;272065;741;301951;5884626;5908913;4903995;13044;5520179
FR;2;2021-12-29;9495;32285;246109;766;272679;5894121;5941198;5150104;13810;5792858
FR;2;2021-12-30;9454;28139;208811;662;231464;5903575;5969337;5358915;14472;6024322
FR;2;2021-12-31;3007;8372;54980;177;61233;5906582;5977709;5413895;14649;6085555
FR;2;2022-01-01;227;689;2849;7;3343;5906809;5978398;5416744;14656;6088898
FR;2;2022-01-02;1504;4858;29507;75;33396;5908313;5983256;5446251;14731;6122294
FR;2;2022-01-03;9585;35373;266503;806;293861;5917898;6018629;5712754;15537;6416155
FR;2;2022-01-04;12844;45379;342068;1068;376954;5930742;6064008;6054822;16605;6793109
FR;2;2022-01-05;11269;38672;294153;886;323810;5942011;6102680;6348975;17491;7116919
FR;2;2022-01-06;13647;43503;331929;1298;364712;5955658;6146183;6680904;18789;7481631
FR;2;2022-01-07;14219;47639;361080;1270;396410;5969877;6193822;7041984;20059;7878041
FR;2;2022-01-08;7947;28148;201257;515;221687;5977824;6221970;7243241;20574;8099728
FR;2;2022-01-09;2749;8994;62519;137;69522;5980573;6230964;7305760;20711;8169250
FR;2;2022-01-10;10089;31925;232450;858;255039;5990662;6262889;7538210;21569;8424289
FR;2;2022-01-11;11470;36256;265883;1030;290574;6002132;6299145;7804093;22599;8714863
FR;2;2022-01-12;8758;29818;206302;862;226159;6010890;6328963;8010395;23461;8941022
FR;2;2022-01-13;9387;31352;224465;831;244814;6020277;6360315;8234860;24292;9185836
FR;2;2022-01-14;9742;35654;254519;920;277677;6030019;6395969;8489379;25212;9463513
FR;2;2022-01-15;5356;19462;140771;363;153640;6035375;6415431;8630150;25575;9617153
FR;2;2022-01-16;1511;5519;35872;80;39847;6036886;6420950;8666022;25655;9657000
FR;2;2022-01-17;5545;19297;135386;601;147246;6042431;6440247;8801408;26256;9804246
FR;2;2022-01-18;6418;21526;148611;648;160470;6048849;6461773;8950019;26904;9964716
FR;2;2022-01-19;4389;16361;105082;552;113703;6053238;6478134;9055101;27456;10078419
FR;2;2022-01-20;4867;17599;115279;603;123673;6058105;6495733;9170380;28059;10202092
FR;2;2022-01-21;5195;20064;137323;678;147743;6063300;6515797;9307703;28737;10349835
FR;2;2022-01-22;3027;10961;74257;259;80326;6066327;6526758;9381960;28996;10430161
FR;2;2022-01-23;723;2734;15237;41;16836;6067050;6529492;9397197;29037;10446997
FR;2;2022-01-24;3293;12821;75059;430;81021;6070343;6542313;9472256;29467;10528018
FR;2;2022-01-25;3571;14442;79612;496;85449;6073914;6556755;9551868;29963;10613467
FR;2;2022-01-26;2515;10667;58961;363;62990;6076429;6567422;9610829;30326;10676457
FR;2;2022-01-27;2680;11295;64170;388;67911;6079109;6578717;9674999;30714;10744368
FR;2;2022-01-28;3543;18373;91711;430;98961;6082652;6597090;9766710;31144;10843329
FR;2;2022-01-29;1894;9249;48840;164;52924;6084546;6606339;9815550;31308;10896253
FR;2;2022-01-30;464;2240;9452;38;10605;6085010;6608579;9825002;31346;10906858
FR;2;2022-01-31;1887;9584;43818;208;47338;6086897;6618163;9868820;31554;10954196
FR;2;2022-02-01;1911;10048;47020;279;50101;6088808;6628211;9915840;31833;11004297
FR;2;2022-02-02;1607;9028;41102;251;44172;6090415;6637239;9956942;32084;11048469
FR;2;2022-02-03;1723;8943;40510;204;42910;6092138;6646182;9997452;32288;11091379
FR;2;2022-02-04;2152;15212;66627;297;71345;6094290;6661394;10064079;32585;11162724
FR;2;2022-02-05;1360;8537;35940;131;39235;6095650;6669931;10100019;32716;11201959
FR;2;2022-02-06;274;1776;6124;16;6898;6095924;6671707;10106143;32732;11208857
FR;2;2022-02-07;1350;9602;37747;134;41306;6097274;6681309;10143890;32866;11250163
FR;2;2022-02-08;1299;9814;40928;173;43713;6098573;6691123;10184818;33039;11293876
FR;2;2022-02-09;1160;8819;37033;174;40452;6099733;6699942;10221851;33213;11334328
FR;2;2022-02-10;1024;7985;33832;204;36501;6100757;6707927;10255683;33417;11370829
FR;2;2022-02-11;1388;12079;53338;222;57685;6102145;6720006;10309021;33639;11428514
FR;2;2022-02-12;749;6533;27986;83;30805;6102894;6726539;10337007;33722;11459319
FR;2;2022-02-13;200;1336;4833;20;5574;6103094;6727875;10341840;33742;11464893
FR;2;2022-02-14;835;6727;30265;90;33228;6103929;6734602;10372105;33832;11498121
FR;2;2022-02-15;772;6450;28044;141;29982;6104701;6741052;10400149;33973;11528103
FR;2;2022-02-16;655;5352;22052;123;23616;6105356;6746404;10422201;34096;11551719
FR;2;2022-02-17;515;3775;14144;98;14609;6105871;6750179;10436345;34194;11566328
FR;2;2022-02-18;721;5362;20429;134;21125;6106592;6755541;10456774;34328;11587453
FR;2;2022-02-19;430;3048;10527;66;11241;6107022;6758589;10467301;34394;11598694
FR;2;2022-02-20;101;512;1456;3;1604;6107123;6759101;10468757;34397;11600298
FR;2;2022-02-21;421;2682;9117;65;9493;6107544;6761783;10477874;34462;11609791
FR;2;2022-02-22;389;2565;8888;76;8792;6107933;6764348;10486762;34538;11618583
FR;2;2022-02-23;431;2600;8987;82;9265;6108364;6766948;10495749;34620;11627848
FR;2;2022-02-24;314;2029;6798;81;6826;6108678;6768977;10502547;34701;11634674
FR;2;2022-02-25;455;3195;11414;108;11277;6109133;6772172;10513961;34809;11645951
FR;2;2022-02-26;294;1891;6035;49;6340;6109427;6774063;10519996;34858;11652291
FR;2;2022-02-27;75;312;905;5;948;6109502;6774375;10520901;34863;11653239
FR;2;2022-02-28;330;1682;5523;53;5531;6109832;6776057;10526424;34916;11658770
FR;2;2022-03-01;275;1559;5475;44;5191;6110107;6777616;10531899;34960;11663961
FR;2;2022-03-02;296;1431;5243;45;5084;6110403;6779047;10537142;35005;11669045
FR;2;2022-03-03;225;1102;3704;42;3479;6110628;6780149;10540846;35047;11672524
FR;2;2022-03-04;241;1463;4853;73;4498;6110869;6781612;10545699;35120;11677022
FR;2;2022-03-05;173;903;2977;32;2720;6111042;6782515;10548676;35152;11679742
FR;2;2022-03-06;40;182;278;5;318;6111082;6782697;10548954;35157;11680060
FR;2;2022-03-07;155;654;1982;69;1773;6111237;6783351;10550936;35226;11681833
FR;2;2022-03-08;143;655;2270;51;1902;6111380;6784006;10553206;35277;11683735
FR;2;2022-03-09;153;698;2341;37;2042;6111533;6784704;10555547;35314;11685777
FR;2;2022-03-10;120;598;1688;35;1461;6111653;6785302;10557235;35349;11687238
FR;2;2022-03-11;169;754;2767;57;2366;6111822;6786056;10560002;35406;11689604
FR;2;2022-03-12;144;482;1784;27;1553;6111966;6786538;10561786;35433;11691157
FR;2;2022-03-13;25;75;201;29;202;6111991;6786613;10561987;35462;11691359
FR;2;2022-03-14;125;465;1561;529;1290;6112116;6787078;10563548;35991;11692649
FR;2;2022-03-15;138;417;1706;688;1322;6112254;6787495;10565254;36679;11693971
FR;2;2022-03-16;141;466;2011;1611;1589;6112395;6787961;10567265;38290;11695560
FR;2;2022-03-17;93;412;1405;1193;1142;6112488;6788373;10568670;39483;11696702
FR;2;2022-03-18;144;490;2018;1787;1660;6112632;6788863;10570688;41270;11698362
FR;2;2022-03-19;108;319;1209;940;1014;6112740;6789182;10571897;42210;11699376
FR;2;2022-03-20;12;76;191;59;167;6112752;6789258;10572088;42269;11699543
FR;2;2022-03-21;96;301;1210;1481;1074;6112848;6789559;10573298;43750;11700617
FR;2;2022-03-22;117;383;1528;1828;1290;6112965;6789942;10574826;45578;11701907
FR;2;2022-03-23;139;350;1667;3032;1458;6113104;6790292;10576493;48610;11703365
FR;2;2022-03-24;116;290;1181;1546;997;6113220;6790582;10577674;50156;11704362
FR;2;2022-03-25;119;360;1803;2449;1473;6113339;6790942;10579477;52605;11705835
FR;2;2022-03-26;77;246;1203;1220;952;6113416;6791188;10580680;53825;11706787
FR;2;2022-03-27;19;36;152;100;131;6113435;6791224;10580832;53925;11706918
FR;2;2022-03-28;94;286;1134;1588;994;6113529;6791510;10581966;55513;11707912
FR;2;2022-03-29;106;257;1324;2462;1104;6113635;6791767;10583290;57975;11709016
FR;2;2022-03-30;91;312;1483;3183;1316;6113726;6792079;10584773;61158;11710332
FR;2;2022-03-31;103;281;1269;2327;1083;6113829;6792360;10586042;63485;11711415
FR;2;2022-04-01;120;316;1563;2341;1315;6113949;6792676;10587605;65826;11712730
FR;2;2022-04-02;72;161;845;889;737;6114021;6792837;10588450;66715;11713467
FR;2;2022-04-03;16;53;128;112;142;6114037;6792890;10588578;66827;11713609
FR;2;2022-04-04;108;227;985;1434;792;6114145;6793117;10589563;68261;11714401
FR;2;2022-04-05;142;286;1309;2871;1137;6114287;6793403;10590872;71132;11715538
FR;2;2022-04-06;88;247;1303;2500;1115;6114375;6793650;10592175;73632;11716653
FR;2;2022-04-07;119;214;1295;2681;1034;6114494;6793864;10593470;76313;11717687
FR;2;2022-04-08;123;328;1622;3207;1319;6114617;6794192;10595092;79520;11719006
FR;2;2022-04-09;90;218;899;1045;731;6114707;6794410;10595991;80565;11719737
FR;2;2022-04-10;37;46;143;161;118;6114744;6794456;10596134;80726;11719855
FR;2;2022-04-11;85;184;881;1518;772;6114829;6794640;10597015;82244;11720627
FR;2;2022-04-12;176;260;1176;2732;1054;6115005;6794900;10598191;84976;11721681
FR;2;2022-04-13;143;224;1114;2420;973;6115148;6795124;10599305;87396;11722654
FR;2;2022-04-14;114;219;1082;2667;914;6115262;6795343;10600387;90063;11723568
FR;2;2022-04-15;111;244;1194;2257;1050;6115373;6795587;10601581;92320;11724618
FR;2;2022-04-16;64;108;540;545;452;6115437;6795695;10602121;92865;11725070
FR;2;2022-04-17;15;26;57;53;53;6115452;6795721;10602178;92918;11725123
FR;2;2022-04-18;11;35;118;65;113;6115463;6795756;10602296;92983;11725236
FR;2;2022-04-19;108;235;1114;1703;945;6115571;6795991;10603410;94686;11726181
FR;2;2022-04-20;95;237;1091;2103;919;6115666;6796228;10604501;96789;11727100
FR;2;2022-04-21;110;229;972;1827;829;6115776;6796457;10605473;98616;11727929
FR;2;2022-04-22;96;268;1240;2080;1021;6115872;6796725;10606713;100696;11728950
FR;2;2022-04-23;66;154;644;762;573;6115938;6796879;10607357;101458;11729523
FR;2;2022-04-24;12;28;100;68;78;6115950;6796907;10607457;101526;11729601
FR;2;2022-04-25;103;201;819;1312;708;6116053;6797108;10608276;102838;11730309
FR;2;2022-04-26;109;183;1034;1937;872;6116162;6797291;10609310;104775;11731181
FR;2;2022-04-27;95;177;855;1682;758;6116257;6797468;10610165;106457;11731939
FR;2;2022-04-28;90;212;946;1897;840;6116347;6797680;10611111;108354;11732779
FR;2;2022-04-29;77;279;1124;1687;1034;6116424;6797959;10612235;110041;11733813
FR;2;2022-04-30;65;125;469;535;428;6116489;6798084;10612704;110576;11734241
FR;2;2022-05-01;17;23;80;46;81;6116506;6798107;10612784;110622;11734322
FR;2;2022-05-02;112;211;751;1204;649;6116618;6798318;10613535;111826;11734971
FR;2;2022-05-03;148;223;984;1728;922;6116766;6798541;10614519;113554;11735893
FR;2;2022-05-04;87;218;911;1788;853;6116853;6798759;10615430;115342;11736746
FR;2;2022-05-05;123;191;835;1673;749;6116976;6798950;10616265;117015;11737495
FR;2;2022-05-06;130;234;1087;1845;999;6117106;6799184;10617352;118860;11738494
FR;2;2022-05-07;40;96;464;504;400;6117146;6799280;10617816;119364;11738894
FR;2;2022-05-08;45;52;106;70;99;6117191;6799332;10617922;119434;11738993
FR;2;2022-05-09;101;171;646;981;599;6117292;6799503;10618568;120415;11739592
FR;2;2022-05-10;112;236;924;1765;876;6117404;6799739;10619492;122180;11740468
FR;2;2022-05-11;96;163;801;1852;781;6117500;6799902;10620293;124032;11741249
FR;2;2022-05-12;108;166;829;2072;790;6117608;6800068;10621122;126104;11742039
FR;2;2022-05-13;94;228;952;2082;884;6117702;6800296;10622074;128186;11742923
FR;2;2022-05-14;75;116;439;552;397;6117777;6800412;10622513;128738;11743320
FR;2;2022-05-15;24;34;91;86;102;6117801;6800446;10622604;128824;11743422
FR;2;2022-05-16;102;168;580;921;519;6117903;6800614;10623184;129745;11743941
FR;2;2022-05-17;95;181;678;1665;649;6117998;6800795;10623862;131410;11744590
FR;2;2022-05-18;80;179;628;1404;634;6118078;6800974;10624490;132814;11745224
FR;2;2022-05-19;68;157;694;1757;727;6118146;6801131;10625184;134571;11745951
FR;2;2022-05-20;98;174;847;1632;753;6118244;6801305;10626031;136203;11746704
FR;2;2022-05-21;44;95;391;517;334;6118288;6801400;10626422;136720;11747038
FR;2;2022-05-22;8;22;66;37;56;6118296;6801422;10626488;136757;11747094
FR;2;2022-05-23;81;127;464;900;453;6118377;6801549;10626952;137657;11747547
FR;2;2022-05-24;84;161;609;1534;594;6118461;6801710;10627561;139191;11748141
FR;2;2022-05-25;67;135;523;1134;475;6118528;6801845;10628084;140325;11748616
FR;2;2022-05-26;7;25;59;41;65;6118535;6801870;10628143;140366;11748681
FR;2;2022-05-27;44;112;429;804;410;6118579;6801982;10628572;141170;11749091
FR;2;2022-05-28;26;60;211;236;215;6118605;6802042;10628783;141406;11749306
FR;2;2022-05-29;10;34;43;23;51;6118615;6802076;10628826;141429;11749357
FR;2;2022-05-30;65;102;392;690;369;6118680;6802178;10629218;142119;11749726
FR;2;2022-05-31;71;128;542;1215;490;6118751;6802306;10629760;143334;11750216
FR;2;2022-06-01;53;135;438;1018;428;6118804;6802441;10630198;144352;11750644
FR;2;2022-06-02;83;155;501;1331;477;6118887;6802596;10630699;145683;11751121
FR;2;2022-06-03;62;144;549;1554;503;6118949;6802740;10631248;147237;11751624
FR;2;2022-06-04;52;88;248;429;230;6119001;6802828;10631496;147666;11751854
FR;2;2022-06-05;11;17;60;57;46;6119012;6802845;10631556;147723;11751900
FR;2;2022-06-06;11;11;44;73;46;6119023;6802856;10631600;147796;11751946
FR;2;2022-06-07;95;197;596;1418;500;6119118;6803053;10632196;149214;11752446
FR;2;2022-06-08;62;106;420;1121;355;6119180;6803159;10632616;150335;11752801
FR;2;2022-06-09;86;149;505;1615;469;6119266;6803308;10633121;151950;11753270
FR;3;2020-12-27;0;0;0;0;0;0;0;0;0;0
FR;3;2020-12-28;0;0;0;0;0;0;0;0;0;0
FR;3;2020-12-29;0;0;0;0;0;0;0;0;0;0
FR;3;2020-12-30;0;0;0;0;0;0;0;0;0;0
FR;3;2020-12-31;0;0;0;0;0;0;0;0;0;0
FR;3;2021-01-01;0;0;0;0;0;0;0;0;0;0
FR;3;2021-01-02;0;0;0;0;0;0;0;0;0;0
FR;3;2021-01-03;0;0;0;0;0;0;0;0;0;0
FR;3;2021-01-04;0;0;0;0;0;0;0;0;0;0
FR;3;2021-01-05;0;0;0;0;0;0;0;0;0;0
FR;3;2021-01-06;0;0;0;0;0;0;0;0;0;0
FR;3;2021-01-07;0;0;0;0;0;0;0;0;0;0
FR;3;2021-01-08;0;0;0;0;0;0;0;0;0;0
FR;3;2021-01-09;0;0;0;0;0;0;0;0;0;0
FR;3;2021-01-10;0;0;0;0;0;0;0;0;0;0
FR;3;2021-01-11;0;0;0;0;0;0;0;0;0;0
FR;3;2021-01-12;0;0;0;0;0;0;0;0;0;0
FR;3;2021-01-13;0;0;0;0;0;0;0;0;0;0
FR;3;2021-01-14;0;0;0;0;0;0;0;0;0;0
FR;3;2021-01-15;0;0;0;0;0;0;0;0;0;0
FR;3;2021-01-16;0;0;0;0;0;0;0;0;0;0
FR;3;2021-01-17;0;0;0;0;0;0;0;0;0;0
FR;3;2021-01-18;0;0;0;0;0;0;0;0;0;0
FR;3;2021-01-19;0;0;0;0;0;0;0;0;0;0
FR;3;2021-01-20;0;0;0;0;0;0;0;0;0;0
FR;3;2021-01-21;0;0;0;0;0;0;0;0;0;0
FR;3;2021-01-22;0;0;0;0;0;0;0;0;0;0
FR;3;2021-01-23;0;0;0;0;0;0;0;0;0;0
FR;3;2021-01-24;0;0;0;0;0;0;0;0;0;0
FR;3;2021-01-25;0;0;0;0;0;0;0;0;0;0
FR;3;2021-01-26;0;0;0;0;0;0;0;0;0;0
FR;3;2021-01-27;0;0;0;0;0;0;0;0;0;0
FR;3;2021-01-28;0;0;0;0;0;0;0;0;0;0
FR;3;2021-01-29;0;0;0;0;0;0;0;0;0;0
FR;3;2021-01-30;0;0;0;0;0;0;0;0;0;0
FR;3;2021-01-31;0;0;0;0;0;0;0;0;0;0
FR;3;2021-02-01;0;0;0;0;0;0;0;0;0;0
FR;3;2021-02-02;0;0;0;0;0;0;0;0;0;0
FR;3;2021-02-03;0;0;0;0;0;0;0;0;0;0
FR;3;2021-02-04;0;0;0;0;0;0;0;0;0;0
FR;3;2021-02-05;0;0;0;0;0;0;0;0;0;0
FR;3;2021-02-06;1655;0;0;0;0;1655;0;0;0;0
FR;3;2021-02-07;1423;0;0;0;0;3078;0;0;0;0
FR;3;2021-02-08;2784;1;0;0;0;5862;1;0;0;0
FR;3;2021-02-09;6782;0;0;0;0;12644;1;0;0;0
FR;3;2021-02-10;9604;0;0;0;0;22248;1;0;0;0
FR;3;2021-02-11;13612;0;0;0;0;35860;1;0;0;0
FR;3;2021-02-12;13399;0;0;0;0;49259;1;0;0;0
FR;3;2021-02-13;3784;1;0;0;0;53043;2;0;0;0
FR;3;2021-02-14;972;0;0;0;0;54015;2;0;0;0
FR;3;2021-02-15;10487;0;0;0;0;64502;2;0;0;0
FR;3;2021-02-16;12544;1;0;0;0;77046;3;0;0;0
FR;3;2021-02-17;11151;0;0;0;0;88197;3;0;0;0
FR;3;2021-02-18;14935;2;0;0;0;103132;5;0;0;0
FR;3;2021-02-19;14359;1;0;0;0;117491;6;0;0;0
FR;3;2021-02-20;3329;0;0;0;0;120820;6;0;0;0
FR;3;2021-02-21;618;0;0;0;0;121438;6;0;0;0
FR;3;2021-02-22;9163;0;0;0;0;130601;6;0;0;0
FR;3;2021-02-23;11395;1;0;0;0;141996;7;0;0;0
FR;3;2021-02-24;14299;1;0;0;0;156295;8;0;0;0
FR;3;2021-02-25;44929;1;0;0;0;201224;9;0;0;0
FR;3;2021-02-26;61882;3;0;0;0;263106;12;0;0;0
FR;3;2021-02-27;34801;5;0;0;0;297907;17;0;0;0
FR;3;2021-02-28;2463;0;0;0;0;300370;17;0;0;0
FR;3;2021-03-01;20513;10;0;0;0;320883;27;0;0;0
FR;3;2021-03-02;38864;18;0;0;0;359747;45;0;0;0
FR;3;2021-03-03;48732;15;0;0;0;408479;60;0;0;0
FR;3;2021-03-04;82218;20;0;0;0;490697;80;0;0;0
FR;3;2021-03-05;118123;40;0;0;0;608820;120;0;0;0
FR;3;2021-03-06;120712;56;1;0;0;729532;176;1;0;0
FR;3;2021-03-07;55175;27;0;0;0;784707;203;1;0;0
FR;3;2021-03-08;42809;25;0;0;0;827516;228;1;0;0
FR;3;2021-03-09;78967;44;0;0;0;906483;272;1;0;0
FR;3;2021-03-10;80968;47;0;0;0;987451;319;1;0;0
FR;3;2021-03-11;128425;56;0;0;0;1115876;375;1;0;0
FR;3;2021-03-12;182720;91;0;0;0;1298596;466;1;0;0
FR;3;2021-03-13;132145;63;0;0;0;1430741;529;1;0;0
FR;3;2021-03-14;14054;5;0;0;0;1444795;534;1;0;0
FR;3;2021-03-15;52225;48;0;0;0;1497020;582;1;0;0
FR;3;2021-03-16;1209;25;0;0;0;1498229;607;1;0;0
FR;3;2021-03-17;942;30;0;0;0;1499171;637;1;0;0
FR;3;2021-03-18;1565;13;0;0;0;1500736;650;1;0;0
FR;3;2021-03-19;70450;48;0;0;0;1571186;698;1;0;0
FR;3;2021-03-20;65226;45;0;0;0;1636412;743;1;0;0
FR;3;2021-03-21;5756;6;0;0;0;1642168;749;1;0;0
FR;3;2021-03-22;37497;39;0;0;0;1679665;788;1;0;0
FR;3;2021-03-23;84651;61;0;0;0;1764316;849;1;0;0
FR;3;2021-03-24;90935;92;0;0;0;1855251;941;1;0;0
FR;3;2021-03-25;150046;129;0;0;0;2005297;1070;1;0;0
FR;3;2021-03-26;165414;150;0;0;0;2170711;1220;1;0;0
FR;3;2021-03-27;68456;101;0;0;0;2239167;1321;1;0;0
FR;3;2021-03-28;6470;19;0;0;0;2245637;1340;1;0;0
FR;3;2021-03-29;54160;73;0;0;0;2299797;1413;1;0;0
FR;3;2021-03-30;93161;101;0;0;0;2392958;1514;1;0;0
FR;3;2021-03-31;63524;99;0;0;0;2456482;1613;1;0;0
FR;3;2021-04-01;86120;105;0;0;0;2542602;1718;1;0;0
FR;3;2021-04-02;86894;153;0;0;0;2629496;1871;1;0;0
FR;3;2021-04-03;35872;115;0;0;0;2665368;1986;1;0;0
FR;3;2021-04-04;3571;18;0;0;0;2668939;2004;1;0;0
FR;3;2021-04-05;4487;28;0;0;0;2673426;2032;1;0;0
FR;3;2021-04-06;29744;84;0;0;0;2703170;2116;1;0;0
FR;3;2021-04-07;32337;79;0;0;0;2735507;2195;1;0;0
FR;3;2021-04-08;78808;242;0;0;0;2814315;2437;1;0;0
FR;3;2021-04-09;161746;417;0;0;0;2976061;2854;1;0;0
FR;3;2021-04-10;75755;331;0;0;0;3051816;3185;1;0;0
FR;3;2021-04-11;7309;45;0;0;0;3059125;3230;1;0;0
FR;3;2021-04-12;51467;207;0;0;0;3110592;3437;1;0;0
FR;3;2021-04-13;86219;318;0;0;0;3196811;3755;1;0;0
FR;3;2021-04-14;67833;345;0;0;0;3264644;4100;1;0;0
FR;3;2021-04-15;93220;372;0;0;0;3357864;4472;1;0;0
FR;3;2021-04-16;112517;582;0;0;0;3470381;5054;1;0;0
FR;3;2021-04-17;53311;325;1;0;0;3523692;5379;2;0;0
FR;3;2021-04-18;9744;35;0;0;0;3533436;5414;2;0;0
FR;3;2021-04-19;25104;243;0;0;0;3558540;5657;2;0;0
FR;3;2021-04-20;45672;400;0;0;0;3604212;6057;2;0;0
FR;3;2021-04-21;38967;469;0;0;0;3643179;6526;2;0;0
FR;3;2021-04-22;54704;789;0;0;0;3697883;7315;2;0;0
FR;3;2021-04-23;70485;1025;0;0;0;3768368;8340;2;0;0
FR;3;2021-04-24;37240;1003;0;0;0;3805608;9343;2;0;0
FR;3;2021-04-25;6204;155;0;0;0;3811812;9498;2;0;0
FR;3;2021-04-26;19783;657;0;0;0;3831595;10155;2;0;0
FR;3;2021-04-27;34472;1266;0;0;0;3866067;11421;2;0;0
FR;3;2021-04-28;28967;1943;0;0;0;3895034;13364;2;0;0
FR;3;2021-04-29;45377;5968;0;0;0;3940411;19332;2;0;0
FR;3;2021-04-30;55452;8941;1;0;0;3995863;28273;3;0;0
FR;3;2021-05-01;9510;1978;0;0;0;4005373;30251;3;0;0
FR;3;2021-05-02;3070;488;0;0;0;4008443;30739;3;0;0
FR;3;2021-05-03;13059;3888;0;0;0;4021502;34627;3;0;0
FR;3;2021-05-04;23109;8410;0;0;0;4044611;43037;3;0;0
FR;3;2021-05-05;18754;10629;0;0;0;4063365;53666;3;0;0
FR;3;2021-05-06;34620;20917;0;0;0;4097985;74583;3;0;0
FR;3;2021-05-07;44202;28468;0;0;0;4142187;103051;3;0;0
FR;3;2021-05-08;6785;8959;0;0;0;4148972;112010;3;0;0
FR;3;2021-05-09;1793;2658;0;0;0;4150765;114668;3;0;0
FR;3;2021-05-10;14989;12627;0;0;0;4165754;127295;3;0;0
FR;3;2021-05-11;27093;25822;0;0;0;4192847;153117;3;0;0
FR;3;2021-05-12;17266;27553;0;0;0;4210113;180670;3;0;0
FR;3;2021-05-13;2277;3476;0;0;0;4212390;184146;3;0;0
FR;3;2021-05-14;14513;25790;0;0;0;4226903;209936;3;0;0
FR;3;2021-05-15;7230;20817;0;0;0;4234133;230753;3;0;0
FR;3;2021-05-16;975;2673;0;0;0;4235108;233426;3;0;0
FR;3;2021-05-17;7962;19964;0;0;0;4243070;253390;3;0;0
FR;3;2021-05-18;13410;29708;0;0;0;4256480;283098;3;0;0
FR;3;2021-05-19;9263;31466;0;0;0;4265743;314564;3;0;0
FR;3;2021-05-20;12801;53280;3;0;0;4278544;367844;6;0;0
FR;3;2021-05-21;12759;65601;2;0;0;4291303;433445;8;0;0
FR;3;2021-05-22;4960;33353;1;0;0;4296263;466798;9;0;0
FR;3;2021-05-23;649;2666;0;0;0;4296912;469464;9;0;0
FR;3;2021-05-24;879;4910;0;0;0;4297791;474374;9;0;0
FR;3;2021-05-25;5301;45360;1;0;0;4303092;519734;10;0;0
FR;3;2021-05-26;4972;51171;1;0;0;4308064;570905;11;0;0
FR;3;2021-05-27;6326;78003;3;0;0;4314390;648908;14;0;0
FR;3;2021-05-28;7542;99199;2;0;0;4321932;748107;16;0;0
FR;3;2021-05-29;3345;60379;1;0;0;4325277;808486;17;0;0
FR;3;2021-05-30;547;8202;0;0;0;4325824;816688;17;0;0
FR;3;2021-05-31;2439;35827;3;0;0;4328263;852515;20;0;0
FR;3;2021-06-01;3400;64733;10;0;0;4331663;917248;30;0;0
FR;3;2021-06-02;2727;58345;6;0;0;4334390;975593;36;0;0
FR;3;2021-06-03;3492;87471;10;0;0;4337882;1063064;46;0;0
FR;3;2021-06-04;4112;105108;22;0;0;4341994;1168172;68;0;0
FR;3;2021-06-05;1979;52252;4;0;0;4343973;1220424;72;0;0
FR;3;2021-06-06;505;5381;1;0;0;4344478;1225805;73;0;0
FR;3;2021-06-07;1472;31074;11;0;0;4345950;1256879;84;0;0
FR;3;2021-06-08;2048;47239;18;0;0;4347998;1304118;102;0;0
FR;3;2021-06-09;1788;42264;13;0;0;4349786;1346382;115;0;0
FR;3;2021-06-10;2245;67819;17;0;0;4352031;1414201;132;0;0
FR;3;2021-06-11;2474;96676;34;0;0;4354505;1510877;166;0;0
FR;3;2021-06-12;1175;40828;6;0;0;4355680;1551705;172;0;0
FR;3;2021-06-13;279;3786;3;0;0;4355959;1555491;175;0;0
FR;3;2021-06-14;1040;42576;17;0;0;4356999;1598067;192;0;0
FR;3;2021-06-15;1364;80578;20;0;0;4358363;1678645;212;0;0
FR;3;2021-06-16;1255;65673;20;0;0;4359618;1744318;232;0;0
FR;3;2021-06-17;1660;101816;41;0;0;4361278;1846134;273;0;0
FR;3;2021-06-18;1868;117937;61;0;0;4363146;1964071;334;0;0
FR;3;2021-06-19;801;39390;22;0;0;4363947;2003461;356;0;0
FR;3;2021-06-20;158;3366;0;0;0;4364105;2006827;356;0;0
FR;3;2021-06-21;768;39229;16;0;0;4364873;2046056;372;0;0
FR;3;2021-06-22;1061;69957;52;0;0;4365934;2116013;424;0;0
FR;3;2021-06-23;942;50823;39;0;0;4366876;2166836;463;0;0
FR;3;2021-06-24;1307;77150;48;0;0;4368183;2243986;511;0;0
FR;3;2021-06-25;1401;89976;73;0;0;4369584;2333962;584;0;0
FR;3;2021-06-26;627;33129;29;0;0;4370211;2367091;613;0;0
FR;3;2021-06-27;166;3979;1;0;0;4370377;2371070;614;0;0
FR;3;2021-06-28;649;30383;27;0;0;4371026;2401453;641;0;0
FR;3;2021-06-29;854;56168;95;0;0;4371880;2457621;736;0;0
FR;3;2021-06-30;902;45083;93;0;0;4372782;2502704;829;0;0
FR;3;2021-07-01;1161;65685;108;0;0;4373943;2568389;937;0;0
FR;3;2021-07-02;1300;90373;170;0;0;4375243;2658762;1107;0;0
FR;3;2021-07-03;600;31178;52;0;0;4375843;2689940;1159;0;0
FR;3;2021-07-04;142;4252;3;0;0;4375985;2694192;1162;0;0
FR;3;2021-07-05;609;33881;60;0;0;4376594;2728073;1222;0;0
FR;3;2021-07-06;958;56044;88;0;0;4377552;2784117;1310;0;0
FR;3;2021-07-07;870;43035;79;0;0;4378422;2827152;1389;0;0
FR;3;2021-07-08;1123;60729;99;0;0;4379545;2887881;1488;0;0
FR;3;2021-07-09;1258;68798;128;0;0;4380803;2956679;1616;0;0
FR;3;2021-07-10;642;25061;59;0;0;4381445;2981740;1675;0;0
FR;3;2021-07-11;128;3283;4;0;0;4381573;2985023;1679;0;0
FR;3;2021-07-12;660;23872;59;0;0;4382233;3008895;1738;0;0
FR;3;2021-07-13;1645;34721;90;0;0;4383878;3043616;1828;0;0
FR;3;2021-07-14;261;2609;2;0;0;4384139;3046225;1830;0;0
FR;3;2021-07-15;1934;30645;85;0;0;4386073;3076870;1915;0;0
FR;3;2021-07-16;2520;38852;122;0;0;4388593;3115722;2037;0;0
FR;3;2021-07-17;1046;13746;26;0;0;4389639;3129468;2063;0;0
FR;3;2021-07-18;262;2598;3;0;0;4389901;3132066;2066;0;0
FR;3;2021-07-19;1274;17176;37;0;0;4391175;3149242;2103;0;0
FR;3;2021-07-20;1823;27112;98;0;0;4392998;3176354;2201;0;0
FR;3;2021-07-21;1649;19714;44;0;0;4394647;3196068;2245;0;0
FR;3;2021-07-22;1849;27743;83;0;0;4396496;3223811;2328;0;0
FR;3;2021-07-23;2212;30439;117;0;0;4398708;3254250;2445;0;0
FR;3;2021-07-24;822;7006;25;0;0;4399530;3261256;2470;0;0
FR;3;2021-07-25;210;1338;1;0;0;4399740;3262594;2471;0;0
FR;3;2021-07-26;922;10693;28;0;0;4400662;3273287;2499;0;0
FR;3;2021-07-27;1166;16939;56;0;0;4401828;3290226;2555;0;0
FR;3;2021-07-28;988;12097;40;0;0;4402816;3302323;2595;0;0
FR;3;2021-07-29;1126;15838;63;0;0;4403942;3318161;2658;0;0
FR;3;2021-07-30;1126;18085;79;0;0;4405068;3336246;2737;0;0
FR;3;2021-07-31;406;3743;15;0;0;4405474;3339989;2752;0;0
FR;3;2021-08-01;113;486;1;0;0;4405587;3340475;2753;0;0
FR;3;2021-08-02;419;5150;22;0;0;4406006;3345625;2775;0;0
FR;3;2021-08-03;488;7579;27;0;0;4406494;3353204;2802;0;0
FR;3;2021-08-04;435;4881;26;0;0;4406929;3358085;2828;0;0
FR;3;2021-08-05;429;3731;12;0;0;4407358;3361816;2840;0;0
FR;3;2021-08-06;453;4783;30;0;0;4407811;3366599;2870;0;0
FR;3;2021-08-07;214;1923;11;0;0;4408025;3368522;2881;0;0
FR;3;2021-08-08;249;431;2;0;0;4408274;3368953;2883;0;0
FR;3;2021-08-09;314;2494;11;0;0;4408588;3371447;2894;0;0
FR;3;2021-08-10;363;3872;15;0;0;4408951;3375319;2909;0;0
FR;3;2021-08-11;285;2722;15;0;0;4409236;3378041;2924;0;0
FR;3;2021-08-12;276;2634;12;0;0;4409512;3380675;2936;0;0
FR;3;2021-08-13;277;2261;16;0;0;4409789;3382936;2952;0;0
FR;3;2021-08-14;169;916;1;0;0;4409958;3383852;2953;0;0
FR;3;2021-08-15;55;172;0;0;0;4410013;3384024;2953;0;0
FR;3;2021-08-16;123;1085;8;0;0;4410136;3385109;2961;0;0
FR;3;2021-08-17;187;1501;8;0;0;4410323;3386610;2969;0;0
FR;3;2021-08-18;200;1365;10;0;0;4410523;3387975;2979;0;0
FR;3;2021-08-19;165;1410;10;0;0;4410688;3389385;2989;0;0
FR;3;2021-08-20;166;1630;16;0;0;4410854;3391015;3005;0;0
FR;3;2021-08-21;93;586;2;0;0;4410947;3391601;3007;0;0
FR;3;2021-08-22;40;188;1;0;0;4410987;3391789;3008;0;0
FR;3;2021-08-23;140;930;7;0;0;4411127;3392719;3015;0;0
FR;3;2021-08-24;124;967;10;0;0;4411251;3393686;3025;0;0
FR;3;2021-08-25;136;841;2;0;0;4411387;3394527;3027;0;0
FR;3;2021-08-26;170;869;9;0;0;4411557;3395396;3036;0;0
FR;3;2021-08-27;172;967;9;0;0;4411729;3396363;3045;0;0
FR;3;2021-08-28;98;371;4;0;0;4411827;3396734;3049;0;0
FR;3;2021-08-29;128;133;1;0;0;4411955;3396867;3050;0;0
FR;3;2021-08-30;99;601;0;0;134;4412054;3397468;3050;0;134
FR;3;2021-08-31;129;711;7;0;151;4412183;3398179;3057;0;285
FR;3;2021-09-01;114;477;5;0;122;4412297;3398656;3062;0;407
FR;3;2021-09-02;100;634;22;0;119;4412397;3399290;3084;0;526
FR;3;2021-09-03;115;586;17;0;128;4412512;3399876;3101;0;654
FR;3;2021-09-04;53;303;3;0;58;4412565;3400179;3104;0;712
FR;3;2021-09-05;51;68;5;0;28;4412616;3400247;3109;0;740
FR;3;2021-09-06;113;394;4;0;144;4412729;3400641;3113;0;884
FR;3;2021-09-07;123;471;14;0;128;4412852;3401112;3127;0;1012
FR;3;2021-09-08;118;371;2;0;103;4412970;3401483;3129;0;1115
FR;3;2021-09-09;93;398;8;0;114;4413063;3401881;3137;0;1229
FR;3;2021-09-10;100;421;3;0;103;4413163;3402302;3140;0;1332
FR;3;2021-09-11;75;239;4;0;66;4413238;3402541;3144;0;1398
FR;3;2021-09-12;36;48;1;0;17;4413274;3402589;3145;0;1415
FR;3;2021-09-13;72;320;7;0;109;4413346;3402909;3152;0;1524
FR;3;2021-09-14;71;292;6;0;106;4413417;3403201;3158;0;1630
FR;3;2021-09-15;60;263;3;0;6;4413477;3403464;3161;0;1636
FR;3;2021-09-16;60;337;5;0;5;4413537;3403801;3166;0;1641
FR;3;2021-09-17;51;347;3;0;7;4413588;3404148;3169;0;1648
FR;3;2021-09-18;36;173;1;0;1;4413624;3404321;3170;0;1649
FR;3;2021-09-19;27;32;2;0;1;4413651;3404353;3172;0;1650
FR;3;2021-09-20;79;210;0;0;1;4413730;3404563;3172;0;1651
FR;3;2021-09-21;58;287;6;0;7;4413788;3404850;3178;0;1658
FR;3;2021-09-22;63;228;6;0;7;4413851;3405078;3184;0;1665
FR;3;2021-09-23;36;272;11;0;7;4413887;3405350;3195;0;1672
FR;3;2021-09-24;25;325;12;0;19;4413912;3405675;3207;0;1691
FR;3;2021-09-25;29;148;3;0;3;4413941;3405823;3210;0;1694
FR;3;2021-09-26;15;55;1;0;1;4413956;3405878;3211;0;1695
FR;3;2021-09-27;39;293;3;0;5;4413995;3406171;3214;0;1700
FR;3;2021-09-28;49;257;6;0;10;4414044;3406428;3220;0;1710
FR;3;2021-09-29;35;223;10;0;13;4414079;3406651;3230;0;1723
FR;3;2021-09-30;38;201;8;0;10;4414117;3406852;3238;0;1733
FR;3;2021-10-01;17;168;6;0;7;4414134;3407020;3244;0;1740
FR;3;2021-10-02;14;90;0;0;0;4414148;3407110;3244;0;1740
FR;3;2021-10-03;18;20;1;0;2;4414166;3407130;3245;0;1742
FR;3;2021-10-04;30;161;4;0;4;4414196;3407291;3249;0;1746
FR;3;2021-10-05;16;156;10;0;13;4414212;3407447;3259;0;1759
FR;3;2021-10-06;31;157;8;0;9;4414243;3407604;3267;0;1768
FR;3;2021-10-07;18;141;6;0;6;4414261;3407745;3273;0;1774
FR;3;2021-10-08;22;146;10;0;9;4414283;3407891;3283;0;1783
FR;3;2021-10-09;13;72;1;0;1;4414296;3407963;3284;0;1784
FR;3;2021-10-10;12;16;2;0;2;4414308;3407979;3286;0;1786
FR;3;2021-10-11;15;123;4;0;5;4414323;3408102;3290;0;1791
FR;3;2021-10-12;17;114;5;0;5;4414340;3408216;3295;0;1796
FR;3;2021-10-13;23;121;7;0;5;4414363;3408337;3302;0;1801
FR;3;2021-10-14;16;162;3;0;4;4414379;3408499;3305;0;1805
FR;3;2021-10-15;21;157;8;0;11;4414400;3408656;3313;0;1816
FR;3;2021-10-16;11;78;6;0;8;4414411;3408734;3319;0;1824
FR;3;2021-10-17;11;24;0;0;0;4414422;3408758;3319;0;1824
FR;3;2021-10-18;17;127;2;0;1;4414439;3408885;3321;0;1825
FR;3;2021-10-19;16;124;19;0;21;4414455;3409009;3340;0;1846
FR;3;2021-10-20;22;129;6;0;7;4414477;3409138;3346;0;1853
FR;3;2021-10-21;25;136;17;0;13;4414502;3409274;3363;0;1866
FR;3;2021-10-22;20;127;16;0;20;4414522;3409401;3379;0;1886
FR;3;2021-10-23;12;58;2;0;1;4414534;3409459;3381;0;1887
FR;3;2021-10-24;7;32;0;0;0;4414541;3409491;3381;0;1887
FR;3;2021-10-25;22;151;7;0;7;4414563;3409642;3388;0;1894
FR;3;2021-10-26;18;113;22;0;19;4414581;3409755;3410;0;1913
FR;3;2021-10-27;17;117;9;0;9;4414598;3409872;3419;0;1922
FR;3;2021-10-28;20;126;33;0;36;4414618;3409998;3452;0;1958
FR;3;2021-10-29;10;123;64;0;54;4414628;3410121;3516;0;2012
FR;3;2021-10-30;8;65;11;1;10;4414636;3410186;3527;1;2022
FR;3;2021-10-31;6;22;1;0;1;4414642;3410208;3528;1;2023
FR;3;2021-11-01;7;22;2;0;1;4414649;3410230;3530;1;2024
FR;3;2021-11-02;9;107;8;0;10;4414658;3410337;3538;1;2034
FR;3;2021-11-03;19;118;10;0;10;4414677;3410455;3548;1;2044
FR;3;2021-11-04;18;96;4;0;3;4414695;3410551;3552;1;2047
FR;3;2021-11-05;17;141;8;1;5;4414712;3410692;3560;2;2052
FR;3;2021-11-06;7;66;3;0;3;4414719;3410758;3563;2;2055
FR;3;2021-11-07;6;21;1;0;1;4414725;3410779;3564;2;2056
FR;3;2021-11-08;11;140;7;0;5;4414736;3410919;3571;2;2061
FR;3;2021-11-09;12;152;5;0;5;4414748;3411071;3576;2;2066
FR;3;2021-11-10;12;178;14;0;15;4414760;3411249;3590;2;2081
FR;3;2021-11-11;8;51;3;0;3;4414768;3411300;3593;2;2084
FR;3;2021-11-12;11;153;6;0;4;4414779;3411453;3599;2;2088
FR;3;2021-11-13;7;78;8;0;10;4414786;3411531;3607;2;2098
FR;3;2021-11-14;2;21;0;0;0;4414788;3411552;3607;2;2098
FR;3;2021-11-15;4;191;10;0;10;4414792;3411743;3617;2;2108
FR;3;2021-11-16;3;164;11;0;10;4414795;3411907;3628;2;2118
FR;3;2021-11-17;6;178;10;0;7;4414801;3412085;3638;2;2125
FR;3;2021-11-18;13;176;10;0;11;4414814;3412261;3648;2;2136
FR;3;2021-11-19;9;223;22;0;27;4414823;3412484;3670;2;2163
FR;3;2021-11-20;6;114;5;0;5;4414829;3412598;3675;2;2168
FR;3;2021-11-21;3;26;3;0;3;4414832;3412624;3678;2;2171
FR;3;2021-11-22;10;231;10;0;10;4414842;3412855;3688;2;2181
FR;3;2021-11-23;6;231;15;0;14;4414848;3413086;3703;2;2195
FR;3;2021-11-24;5;236;9;0;17;4414853;3413322;3712;2;2212
FR;3;2021-11-25;9;280;11;0;10;4414862;3413602;3723;2;2222
FR;3;2021-11-26;6;355;35;0;32;4414868;3413957;3758;2;2254
FR;3;2021-11-27;8;169;20;0;21;4414876;3414126;3778;2;2275
FR;3;2021-11-28;3;62;7;0;7;4414879;3414188;3785;2;2282
FR;3;2021-11-29;4;315;19;0;20;4414883;3414503;3804;2;2302
FR;3;2021-11-30;5;409;26;0;29;4414888;3414912;3830;2;2331
FR;3;2021-12-01;18;454;32;0;33;4414906;3415366;3862;2;2364
FR;3;2021-12-02;9;478;33;0;36;4414915;3415844;3895;2;2400
FR;3;2021-12-03;3;556;37;0;38;4414918;3416400;3932;2;2438
FR;3;2021-12-04;3;278;26;0;28;4414921;3416678;3958;2;2466
FR;3;2021-12-05;1;80;5;0;5;4414922;3416758;3963;2;2471
FR;3;2021-12-06;5;500;14;0;16;4414927;3417258;3977;2;2487
FR;3;2021-12-07;4;600;20;0;24;4414931;3417858;3997;2;2511
FR;3;2021-12-08;4;530;29;0;30;4414935;3418388;4026;2;2541
FR;3;2021-12-09;3;580;17;0;22;4414938;3418968;4043;2;2563
FR;3;2021-12-10;9;619;29;0;25;4414947;3419587;4072;2;2588
FR;3;2021-12-11;4;383;10;0;9;4414951;3419970;4082;2;2597
FR;3;2021-12-12;1;120;3;0;3;4414952;3420090;4085;2;2600
FR;3;2021-12-13;2;593;19;0;21;4414954;3420683;4104;2;2621
FR;3;2021-12-14;7;748;18;0;21;4414961;3421431;4122;2;2642
FR;3;2021-12-15;9;711;17;0;21;4414970;3422142;4139;2;2663
FR;3;2021-12-16;9;722;19;0;18;4414979;3422864;4158;2;2681
FR;3;2021-12-17;4;788;18;0;19;4414983;3423652;4176;2;2700
FR;3;2021-12-18;4;409;4;0;5;4414987;3424061;4180;2;2705
FR;3;2021-12-19;3;207;2;0;2;4414990;3424268;4182;2;2707
FR;3;2021-12-20;8;715;23;0;28;4414998;3424983;4205;2;2735
FR;3;2021-12-21;3;800;10;0;13;4415001;3425783;4215;2;2748
FR;3;2021-12-22;6;755;9;0;10;4415007;3426538;4224;2;2758
FR;3;2021-12-23;1;645;9;0;8;4415008;3427183;4233;2;2766
FR;3;2021-12-24;2;269;3;0;6;4415010;3427452;4236;2;2772
FR;3;2021-12-25;0;25;0;0;0;4415010;3427477;4236;2;2772
FR;3;2021-12-26;0;94;1;0;1;4415010;3427571;4237;2;2773
FR;3;2021-12-27;7;537;17;0;19;4415017;3428108;4254;2;2792
FR;3;2021-12-28;1;687;6;0;5;4415018;3428795;4260;2;2797
FR;3;2021-12-29;4;571;14;0;16;4415022;3429366;4274;2;2813
FR;3;2021-12-30;1;599;7;0;10;4415023;3429965;4281;2;2823
FR;3;2021-12-31;0;205;5;0;7;4415023;3430170;4286;2;2830
FR;3;2022-01-01;0;27;0;0;2;4415023;3430197;4286;2;2832
FR;3;2022-01-02;0;82;0;0;0;4415023;3430279;4286;2;2832
FR;3;2022-01-03;3;564;17;0;20;4415026;3430843;4303;2;2852
FR;3;2022-01-04;6;623;9;0;8;4415032;3431466;4312;2;2860
FR;3;2022-01-05;4;550;10;0;14;4415036;3432016;4322;2;2874
FR;3;2022-01-06;5;546;9;0;12;4415041;3432562;4331;2;2886
FR;3;2022-01-07;2;572;11;0;13;4415043;3433134;4342;2;2899
FR;3;2022-01-08;2;283;4;0;5;4415045;3433417;4346;2;2904
FR;3;2022-01-09;0;118;0;0;0;4415045;3433535;4346;2;2904
FR;3;2022-01-10;2;479;12;0;12;4415047;3434014;4358;2;2916
FR;3;2022-01-11;2;529;1;0;1;4415049;3434543;4359;2;2917
FR;3;2022-01-12;2;445;9;0;10;4415051;3434988;4368;2;2927
FR;3;2022-01-13;3;422;11;0;12;4415054;3435410;4379;2;2939
FR;3;2022-01-14;3;472;10;0;13;4415057;3435882;4389;2;2952
FR;3;2022-01-15;0;298;2;0;3;4415057;3436180;4391;2;2955
FR;3;2022-01-16;0;116;1;0;1;4415057;3436296;4392;2;2956
FR;3;2022-01-17;2;349;8;0;10;4415059;3436645;4400;2;2966
FR;3;2022-01-18;2;411;1;0;2;4415061;3437056;4401;2;2968
FR;3;2022-01-19;1;349;5;0;10;4415062;3437405;4406;2;2978
FR;3;2022-01-20;1;377;5;0;3;4415063;3437782;4411;2;2981
FR;3;2022-01-21;4;370;5;0;7;4415067;3438152;4416;2;2988
FR;3;2022-01-22;2;231;1;0;2;4415069;3438383;4417;2;2990
FR;3;2022-01-23;0;82;0;0;1;4415069;3438465;4417;2;2991
FR;3;2022-01-24;2;347;1;0;6;4415071;3438812;4418;2;2997
FR;3;2022-01-25;0;191;0;0;0;4415071;3439003;4418;2;2997
FR;3;2022-01-26;0;88;0;0;0;4415071;3439091;4418;2;2997
FR;3;2022-01-27;0;58;0;0;0;4415071;3439149;4418;2;2997
FR;3;2022-01-28;0;133;0;0;0;4415071;3439282;4418;2;2997
FR;3;2022-01-29;0;110;0;0;0;4415071;3439392;4418;2;2997
FR;3;2022-01-30;0;51;0;0;0;4415071;3439443;4418;2;2997
FR;3;2022-01-31;0;97;0;0;0;4415071;3439540;4418;2;2997
FR;3;2022-02-01;0;108;0;0;1;4415071;3439648;4418;2;2998
FR;3;2022-02-02;0;95;0;0;0;4415071;3439743;4418;2;2998
FR;3;2022-02-03;0;101;0;0;0;4415071;3439844;4418;2;2998
FR;3;2022-02-04;0;124;0;0;0;4415071;3439968;4418;2;2998
FR;3;2022-02-05;0;73;0;0;0;4415071;3440041;4418;2;2998
FR;3;2022-02-06;0;11;0;0;0;4415071;3440052;4418;2;2998
FR;3;2022-02-07;0;89;0;0;1;4415071;3440141;4418;2;2999
FR;3;2022-02-08;0;0;0;0;0;4415071;3440141;4418;2;2999
FR;3;2022-02-09;0;0;0;0;0;4415071;3440141;4418;2;2999
FR;3;2022-02-10;0;0;0;0;0;4415071;3440141;4418;2;2999
FR;3;2022-02-11;0;0;0;0;0;4415071;3440141;4418;2;2999
FR;3;2022-02-12;0;0;0;0;0;4415071;3440141;4418;2;2999
FR;3;2022-02-13;0;0;0;0;0;4415071;3440141;4418;2;2999
FR;3;2022-02-14;0;0;0;0;0;4415071;3440141;4418;2;2999
FR;3;2022-02-15;0;0;0;0;0;4415071;3440141;4418;2;2999
FR;3;2022-02-16;0;0;0;0;0;4415071;3440141;4418;2;2999
FR;3;2022-02-17;0;0;0;0;0;4415071;3440141;4418;2;2999
FR;3;2022-02-18;0;0;0;0;0;4415071;3440141;4418;2;2999
FR;3;2022-02-19;0;0;0;0;0;4415071;3440141;4418;2;2999
FR;3;2022-02-20;0;0;0;0;0;4415071;3440141;4418;2;2999
FR;3;2022-02-21;2;0;0;0;0;4415073;3440141;4418;2;2999
FR;3;2022-02-22;0;0;0;0;0;4415073;3440141;4418;2;2999
FR;3;2022-02-23;0;0;0;0;0;4415073;3440141;4418;2;2999
FR;3;2022-02-24;0;0;0;0;0;4415073;3440141;4418;2;2999
FR;3;2022-02-25;0;0;0;0;0;4415073;3440141;4418;2;2999
FR;3;2022-02-26;0;0;0;0;0;4415073;3440141;4418;2;2999
FR;3;2022-02-27;0;0;0;0;0;4415073;3440141;4418;2;2999
FR;3;2022-02-28;1;0;0;0;0;4415074;3440141;4418;2;2999
FR;3;2022-03-01;1;0;0;0;0;4415075;3440141;4418;2;2999
FR;3;2022-03-02;0;0;0;0;0;4415075;3440141;4418;2;2999
FR;3;2022-03-03;0;0;0;0;0;4415075;3440141;4418;2;2999
FR;3;2022-03-04;0;0;0;0;0;4415075;3440141;4418;2;2999
FR;3;2022-03-05;0;0;0;0;0;4415075;3440141;4418;2;2999
FR;3;2022-03-06;1;0;0;0;0;4415076;3440141;4418;2;2999
FR;3;2022-03-07;0;0;0;0;0;4415076;3440141;4418;2;2999
FR;3;2022-03-08;1;0;0;0;0;4415077;3440141;4418;2;2999
FR;3;2022-03-09;0;0;0;0;0;4415077;3440141;4418;2;2999
FR;3;2022-03-10;0;0;0;0;0;4415077;3440141;4418;2;2999
FR;3;2022-03-11;0;0;0;0;0;4415077;3440141;4418;2;2999
FR;3;2022-03-12;0;0;0;0;0;4415077;3440141;4418;2;2999
FR;3;2022-03-13;0;0;0;0;0;4415077;3440141;4418;2;2999
FR;3;2022-03-14;0;0;0;0;0;4415077;3440141;4418;2;2999
FR;3;2022-03-15;0;0;0;0;0;4415077;3440141;4418;2;2999
FR;3;2022-03-16;0;0;0;0;0;4415077;3440141;4418;2;2999
FR;3;2022-03-17;0;0;0;0;0;4415077;3440141;4418;2;2999
FR;3;2022-03-18;0;0;0;0;0;4415077;3440141;4418;2;2999
FR;3;2022-03-19;0;0;0;0;0;4415077;3440141;4418;2;2999
FR;3;2022-03-20;1;0;0;0;0;4415078;3440141;4418;2;2999
FR;3;2022-03-21;0;0;0;0;0;4415078;3440141;4418;2;2999
FR;3;2022-03-22;0;0;0;0;0;4415078;3440141;4418;2;2999
FR;3;2022-03-23;1;0;0;0;0;4415079;3440141;4418;2;2999
FR;3;2022-03-24;0;0;0;0;0;4415079;3440141;4418;2;2999
FR;3;2022-03-25;1;0;0;0;0;4415080;3440141;4418;2;2999
FR;3;2022-03-26;0;0;0;0;0;4415080;3440141;4418;2;2999
FR;3;2022-03-27;0;0;0;0;0;4415080;3440141;4418;2;2999
FR;3;2022-03-28;0;0;0;0;0;4415080;3440141;4418;2;2999
FR;3;2022-03-29;0;0;0;0;0;4415080;3440141;4418;2;2999
FR;3;2022-03-30;0;0;0;0;0;4415080;3440141;4418;2;2999
FR;3;2022-03-31;0;0;0;0;0;4415080;3440141;4418;2;2999
FR;3;2022-04-01;0;0;0;0;0;4415080;3440141;4418;2;2999
FR;3;2022-04-02;0;0;0;0;0;4415080;3440141;4418;2;2999
FR;3;2022-04-03;0;0;0;0;0;4415080;3440141;4418;2;2999
FR;3;2022-04-04;0;0;0;0;0;4415080;3440141;4418;2;2999
FR;3;2022-04-05;0;0;0;0;0;4415080;3440141;4418;2;2999
FR;3;2022-04-06;0;0;0;0;0;4415080;3440141;4418;2;2999
FR;3;2022-04-07;0;0;0;0;0;4415080;3440141;4418;2;2999
FR;3;2022-04-08;0;0;0;0;0;4415080;3440141;4418;2;2999
FR;3;2022-04-09;0;0;0;0;0;4415080;3440141;4418;2;2999
FR;3;2022-04-10;0;0;0;0;0;4415080;3440141;4418;2;2999
FR;3;2022-04-11;0;0;0;0;0;4415080;3440141;4418;2;2999
FR;3;2022-04-12;0;0;0;0;0;4415080;3440141;4418;2;2999
FR;3;2022-04-13;0;0;0;0;0;4415080;3440141;4418;2;2999
FR;3;2022-04-14;0;0;0;0;0;4415080;3440141;4418;2;2999
FR;3;2022-04-15;1;0;0;0;0;4415081;3440141;4418;2;2999
FR;3;2022-04-16;0;0;0;0;0;4415081;3440141;4418;2;2999
FR;3;2022-04-17;0;0;0;0;0;4415081;3440141;4418;2;2999
FR;3;2022-04-18;0;0;0;0;0;4415081;3440141;4418;2;2999
FR;3;2022-04-19;0;0;0;0;0;4415081;3440141;4418;2;2999
FR;3;2022-04-20;0;0;0;0;0;4415081;3440141;4418;2;2999
FR;3;2022-04-21;0;0;0;0;0;4415081;3440141;4418;2;2999
FR;3;2022-04-22;0;0;0;0;0;4415081;3440141;4418;2;2999
FR;3;2022-04-23;0;0;0;0;0;4415081;3440141;4418;2;2999
FR;3;2022-04-24;0;0;0;0;0;4415081;3440141;4418;2;2999
FR;3;2022-04-25;0;0;0;0;0;4415081;3440141;4418;2;2999
FR;3;2022-04-26;0;0;0;0;0;4415081;3440141;4418;2;2999
FR;3;2022-04-27;0;0;0;0;0;4415081;3440141;4418;2;2999
FR;3;2022-04-28;0;0;0;0;0;4415081;3440141;4418;2;2999
FR;3;2022-04-29;0;0;0;0;0;4415081;3440141;4418;2;2999
FR;3;2022-04-30;0;0;0;0;0;4415081;3440141;4418;2;2999
FR;3;2022-05-01;0;0;0;0;0;4415081;3440141;4418;2;2999
FR;3;2022-05-02;0;0;0;0;0;4415081;3440141;4418;2;2999
FR;3;2022-05-03;0;0;0;0;0;4415081;3440141;4418;2;2999
FR;3;2022-05-04;0;0;0;0;0;4415081;3440141;4418;2;2999
FR;3;2022-05-05;0;0;0;0;0;4415081;3440141;4418;2;2999
FR;3;2022-05-06;0;0;0;0;0;4415081;3440141;4418;2;2999
FR;3;2022-05-07;0;0;0;0;0;4415081;3440141;4418;2;2999
FR;3;2022-05-08;0;0;0;0;0;4415081;3440141;4418;2;2999
FR;3;2022-05-09;0;0;0;0;0;4415081;3440141;4418;2;2999
FR;3;2022-05-10;0;0;0;0;0;4415081;3440141;4418;2;2999
FR;3;2022-05-11;0;0;0;0;0;4415081;3440141;4418;2;2999
FR;3;2022-05-12;0;0;0;0;0;4415081;3440141;4418;2;2999
FR;3;2022-05-13;0;0;0;0;0;4415081;3440141;4418;2;2999
FR;3;2022-05-14;1;0;0;0;0;4415082;3440141;4418;2;2999
FR;3;2022-05-15;0;0;0;0;0;4415082;3440141;4418;2;2999
FR;3;2022-05-16;0;0;0;0;0;4415082;3440141;4418;2;2999
FR;3;2022-05-17;0;0;0;0;0;4415082;3440141;4418;2;2999
FR;3;2022-05-18;0;0;0;0;0;4415082;3440141;4418;2;2999
FR;3;2022-05-19;0;0;0;0;0;4415082;3440141;4418;2;2999
FR;3;2022-05-20;0;0;0;0;0;4415082;3440141;4418;2;2999
FR;3;2022-05-21;0;0;0;0;0;4415082;3440141;4418;2;2999
FR;3;2022-05-22;0;0;0;0;0;4415082;3440141;4418;2;2999
FR;3;2022-05-23;0;0;0;0;0;4415082;3440141;4418;2;2999
FR;3;2022-05-24;0;0;0;0;0;4415082;3440141;4418;2;2999
FR;3;2022-05-25;0;0;0;0;0;4415082;3440141;4418;2;2999
FR;3;2022-05-26;0;0;0;0;0;4415082;3440141;4418;2;2999
FR;3;2022-05-27;0;0;0;0;0;4415082;3440141;4418;2;2999
FR;3;2022-05-28;0;0;0;0;0;4415082;3440141;4418;2;2999
FR;3;2022-05-29;0;0;0;0;0;4415082;3440141;4418;2;2999
FR;3;2022-05-30;0;0;0;0;0;4415082;3440141;4418;2;2999
FR;3;2022-05-31;0;0;0;0;0;4415082;3440141;4418;2;2999
FR;3;2022-06-01;0;0;0;0;0;4415082;3440141;4418;2;2999
FR;3;2022-06-02;0;0;0;0;0;4415082;3440141;4418;2;2999
FR;3;2022-06-03;0;0;0;0;0;4415082;3440141;4418;2;2999
FR;3;2022-06-04;0;0;0;0;0;4415082;3440141;4418;2;2999
FR;3;2022-06-05;0;0;0;0;0;4415082;3440141;4418;2;2999
FR;3;2022-06-06;0;0;0;0;0;4415082;3440141;4418;2;2999
FR;3;2022-06-07;0;0;0;0;0;4415082;3440141;4418;2;2999
FR;3;2022-06-08;0;0;0;0;0;4415082;3440141;4418;2;2999
FR;3;2022-06-09;0;0;0;0;0;4415082;3440141;4418;2;2999
FR;4;2020-12-27;0;0;0;0;0;0;0;0;0;0
FR;4;2020-12-28;0;0;0;0;0;0;0;0;0;0
FR;4;2020-12-29;0;0;0;0;0;0;0;0;0;0
FR;4;2020-12-30;0;0;0;0;0;0;0;0;0;0
FR;4;2020-12-31;0;0;0;0;0;0;0;0;0;0
FR;4;2021-01-01;0;0;0;0;0;0;0;0;0;0
FR;4;2021-01-02;0;0;0;0;0;0;0;0;0;0
FR;4;2021-01-03;0;0;0;0;0;0;0;0;0;0
FR;4;2021-01-04;0;0;0;0;0;0;0;0;0;0
FR;4;2021-01-05;0;0;0;0;0;0;0;0;0;0
FR;4;2021-01-06;0;0;0;0;0;0;0;0;0;0
FR;4;2021-01-07;0;0;0;0;0;0;0;0;0;0
FR;4;2021-01-08;0;0;0;0;0;0;0;0;0;0
FR;4;2021-01-09;0;0;0;0;0;0;0;0;0;0
FR;4;2021-01-10;0;0;0;0;0;0;0;0;0;0
FR;4;2021-01-11;0;0;0;0;0;0;0;0;0;0
FR;4;2021-01-12;0;0;0;0;0;0;0;0;0;0
FR;4;2021-01-13;0;0;0;0;0;0;0;0;0;0
FR;4;2021-01-14;0;0;0;0;0;0;0;0;0;0
FR;4;2021-01-15;0;0;0;0;0;0;0;0;0;0
FR;4;2021-01-16;0;0;0;0;0;0;0;0;0;0
FR;4;2021-01-17;0;0;0;0;0;0;0;0;0;0
FR;4;2021-01-18;0;0;0;0;0;0;0;0;0;0
FR;4;2021-01-19;0;0;0;0;0;0;0;0;0;0
FR;4;2021-01-20;0;0;0;0;0;0;0;0;0;0
FR;4;2021-01-21;0;0;0;0;0;0;0;0;0;0
FR;4;2021-01-22;0;0;0;0;0;0;0;0;0;0
FR;4;2021-01-23;0;0;0;0;0;0;0;0;0;0
FR;4;2021-01-24;0;0;0;0;0;0;0;0;0;0
FR;4;2021-01-25;0;0;0;0;0;0;0;0;0;0
FR;4;2021-01-26;0;0;0;0;0;0;0;0;0;0
FR;4;2021-01-27;0;0;0;0;0;0;0;0;0;0
FR;4;2021-01-28;0;0;0;0;0;0;0;0;0;0
FR;4;2021-01-29;0;0;0;0;0;0;0;0;0;0
FR;4;2021-01-30;0;0;0;0;0;0;0;0;0;0
FR;4;2021-01-31;0;0;0;0;0;0;0;0;0;0
FR;4;2021-02-01;0;0;0;0;0;0;0;0;0;0
FR;4;2021-02-02;0;0;0;0;0;0;0;0;0;0
FR;4;2021-02-03;0;0;0;0;0;0;0;0;0;0
FR;4;2021-02-04;0;0;0;0;0;0;0;0;0;0
FR;4;2021-02-05;0;0;0;0;0;0;0;0;0;0
FR;4;2021-02-06;0;0;0;0;0;0;0;0;0;0
FR;4;2021-02-07;0;0;0;0;0;0;0;0;0;0
FR;4;2021-02-08;0;0;0;0;0;0;0;0;0;0
FR;4;2021-02-09;0;0;0;0;0;0;0;0;0;0
FR;4;2021-02-10;0;0;0;0;0;0;0;0;0;0
FR;4;2021-02-11;0;0;0;0;0;0;0;0;0;0
FR;4;2021-02-12;0;0;0;0;0;0;0;0;0;0
FR;4;2021-02-13;0;0;0;0;0;0;0;0;0;0
FR;4;2021-02-14;0;0;0;0;0;0;0;0;0;0
FR;4;2021-02-15;0;0;0;0;0;0;0;0;0;0
FR;4;2021-02-16;0;0;0;0;0;0;0;0;0;0
FR;4;2021-02-17;0;0;0;0;0;0;0;0;0;0
FR;4;2021-02-18;0;0;0;0;0;0;0;0;0;0
FR;4;2021-02-19;0;0;0;0;0;0;0;0;0;0
FR;4;2021-02-20;0;0;0;0;0;0;0;0;0;0
FR;4;2021-02-21;0;0;0;0;0;0;0;0;0;0
FR;4;2021-02-22;0;0;0;0;0;0;0;0;0;0
FR;4;2021-02-23;0;0;0;0;0;0;0;0;0;0
FR;4;2021-02-24;0;0;0;0;0;0;0;0;0;0
FR;4;2021-02-25;0;0;0;0;0;0;0;0;0;0
FR;4;2021-02-26;0;0;0;0;0;0;0;0;0;0
FR;4;2021-02-27;0;0;0;0;0;0;0;0;0;0
FR;4;2021-02-28;0;0;0;0;0;0;0;0;0;0
FR;4;2021-03-01;0;0;0;0;0;0;0;0;0;0
FR;4;2021-03-02;0;0;0;0;0;0;0;0;0;0
FR;4;2021-03-03;0;0;0;0;0;0;0;0;0;0
FR;4;2021-03-04;0;0;0;0;0;0;0;0;0;0
FR;4;2021-03-05;0;0;0;0;0;0;0;0;0;0
FR;4;2021-03-06;0;0;0;0;0;0;0;0;0;0
FR;4;2021-03-07;0;0;0;0;0;0;0;0;0;0
FR;4;2021-03-08;0;0;0;0;0;0;0;0;0;0
FR;4;2021-03-09;0;0;0;0;0;0;0;0;0;0
FR;4;2021-03-10;0;0;0;0;0;0;0;0;0;0
FR;4;2021-03-11;0;0;0;0;0;0;0;0;0;0
FR;4;2021-03-12;0;0;0;0;0;0;0;0;0;0
FR;4;2021-03-13;0;0;0;0;0;0;0;0;0;0
FR;4;2021-03-14;0;0;0;0;0;0;0;0;0;0
FR;4;2021-03-15;0;0;0;0;0;0;0;0;0;0
FR;4;2021-03-16;0;0;0;0;0;0;0;0;0;0
FR;4;2021-03-17;0;0;0;0;0;0;0;0;0;0
FR;4;2021-03-18;0;0;0;0;0;0;0;0;0;0
FR;4;2021-03-19;0;0;0;0;0;0;0;0;0;0
FR;4;2021-03-20;0;0;0;0;0;0;0;0;0;0
FR;4;2021-03-21;0;0;0;0;0;0;0;0;0;0
FR;4;2021-03-22;0;0;0;0;0;0;0;0;0;0
FR;4;2021-03-23;0;0;0;0;0;0;0;0;0;0
FR;4;2021-03-24;0;0;0;0;0;0;0;0;0;0
FR;4;2021-03-25;0;0;0;0;0;0;0;0;0;0
FR;4;2021-03-26;0;0;0;0;0;0;0;0;0;0
FR;4;2021-03-27;0;0;0;0;0;0;0;0;0;0
FR;4;2021-03-28;0;0;0;0;0;0;0;0;0;0
FR;4;2021-03-29;0;0;0;0;0;0;0;0;0;0
FR;4;2021-03-30;0;0;0;0;0;0;0;0;0;0
FR;4;2021-03-31;0;0;0;0;0;0;0;0;0;0
FR;4;2021-04-01;0;0;0;0;0;0;0;0;0;0
FR;4;2021-04-02;0;0;0;0;0;0;0;0;0;0
FR;4;2021-04-03;0;0;0;0;0;0;0;0;0;0
FR;4;2021-04-04;0;0;0;0;0;0;0;0;0;0
FR;4;2021-04-05;0;0;0;0;0;0;0;0;0;0
FR;4;2021-04-06;0;0;0;0;0;0;0;0;0;0
FR;4;2021-04-07;0;0;0;0;0;0;0;0;0;0
FR;4;2021-04-08;0;0;0;0;0;0;0;0;0;0
FR;4;2021-04-09;0;0;0;0;0;0;0;0;0;0
FR;4;2021-04-10;0;0;0;0;0;0;0;0;0;0
FR;4;2021-04-11;0;0;0;0;0;0;0;0;0;0
FR;4;2021-04-12;0;0;0;0;0;0;0;0;0;0
FR;4;2021-04-13;0;0;0;0;0;0;0;0;0;0
FR;4;2021-04-14;0;0;0;0;0;0;0;0;0;0
FR;4;2021-04-15;0;0;0;0;0;0;0;0;0;0
FR;4;2021-04-16;0;0;0;0;0;0;0;0;0;0
FR;4;2021-04-17;0;0;0;0;0;0;0;0;0;0
FR;4;2021-04-18;0;0;0;0;0;0;0;0;0;0
FR;4;2021-04-19;0;0;0;0;0;0;0;0;0;0
FR;4;2021-04-20;0;0;0;0;0;0;0;0;0;0
FR;4;2021-04-21;0;0;0;0;0;0;0;0;0;0
FR;4;2021-04-22;0;0;0;0;0;0;0;0;0;0
FR;4;2021-04-23;4005;0;0;0;0;4005;0;0;0;0
FR;4;2021-04-24;1569;0;0;0;0;5574;0;0;0;0
FR;4;2021-04-25;125;0;0;0;0;5699;0;0;0;0
FR;4;2021-04-26;2869;1;0;0;0;8568;1;0;0;0
FR;4;2021-04-27;9519;3;0;0;0;18087;4;0;0;0
FR;4;2021-04-28;9904;6;0;0;0;27991;10;0;0;0
FR;4;2021-04-29;15990;8;0;0;0;43981;18;0;0;0
FR;4;2021-04-30;19230;10;0;0;0;63211;28;0;0;0
FR;4;2021-05-01;1994;6;0;0;0;65205;34;0;0;0
FR;4;2021-05-02;482;0;0;0;0;65687;34;0;0;0
FR;4;2021-05-03;5058;2;0;0;0;70745;36;0;0;0
FR;4;2021-05-04;8397;10;0;0;0;79142;46;0;0;0
FR;4;2021-05-05;6182;7;0;0;0;85324;53;0;0;0
FR;4;2021-05-06;11378;11;0;0;0;96702;64;0;0;0
FR;4;2021-05-07;19121;9;0;0;0;115823;73;0;0;0
FR;4;2021-05-08;2377;6;0;0;0;118200;79;0;0;0
FR;4;2021-05-09;685;3;0;0;0;118885;82;0;0;0
FR;4;2021-05-10;7240;5;1;0;0;126125;87;1;0;0
FR;4;2021-05-11;14314;12;0;0;0;140439;99;1;0;0
FR;4;2021-05-12;10163;15;0;0;0;150602;114;1;0;0
FR;4;2021-05-13;1579;3;0;0;0;152181;117;1;0;0
FR;4;2021-05-14;7760;6;0;0;0;159941;123;1;0;0
FR;4;2021-05-15;3717;8;1;0;0;163658;131;2;0;0
FR;4;2021-05-16;417;1;0;0;0;164075;132;2;0;0
FR;4;2021-05-17;4476;6;0;0;0;168551;138;2;0;0
FR;4;2021-05-18;8752;10;0;0;0;177303;148;2;0;0
FR;4;2021-05-19;5690;7;0;0;0;182993;155;2;0;0
FR;4;2021-05-20;9479;7;0;0;0;192472;162;2;0;0
FR;4;2021-05-21;12791;30;0;0;0;205263;192;2;0;0
FR;4;2021-05-22;5057;15;0;0;0;210320;207;2;0;0
FR;4;2021-05-23;494;4;0;0;0;210814;211;2;0;0
FR;4;2021-05-24;1054;7;0;0;0;211868;218;2;0;0
FR;4;2021-05-25;7620;16;0;0;0;219488;234;2;0;0
FR;4;2021-05-26;7724;16;0;0;0;227212;250;2;0;0
FR;4;2021-05-27;14328;35;0;0;0;241540;285;2;0;0
FR;4;2021-05-28;26583;82;1;0;0;268123;367;3;0;0
FR;4;2021-05-29;11380;18;0;0;0;279503;385;3;0;0
FR;4;2021-05-30;971;6;0;0;0;280474;391;3;0;0
FR;4;2021-05-31;12688;21;0;0;0;293162;412;3;0;0
FR;4;2021-06-01;20249;46;1;0;0;313411;458;4;0;0
FR;4;2021-06-02;14519;33;0;0;0;327930;491;4;0;0
FR;4;2021-06-03;19411;24;1;0;0;347341;515;5;0;0
FR;4;2021-06-04;22510;47;0;0;0;369851;562;5;0;0
FR;4;2021-06-05;9712;32;0;0;0;379563;594;5;0;0
FR;4;2021-06-06;1039;1;0;0;0;380602;595;5;0;0
FR;4;2021-06-07;9224;19;0;0;0;389826;614;5;0;0
FR;4;2021-06-08;14607;31;0;0;0;404433;645;5;0;0
FR;4;2021-06-09;12203;25;0;0;0;416636;670;5;0;0
FR;4;2021-06-10;15398;30;0;0;0;432034;700;5;0;0
FR;4;2021-06-11;16980;56;0;0;0;449014;756;5;0;0
FR;4;2021-06-12;7444;27;0;0;0;456458;783;5;0;0
FR;4;2021-06-13;907;2;0;0;0;457365;785;5;0;0
FR;4;2021-06-14;6645;25;0;0;0;464010;810;5;0;0
FR;4;2021-06-15;10883;37;0;0;0;474893;847;5;0;0
FR;4;2021-06-16;8904;15;0;0;0;483797;862;5;0;0
FR;4;2021-06-17;10897;36;0;0;0;494694;898;5;0;0
FR;4;2021-06-18;12420;45;0;0;0;507114;943;5;0;0
FR;4;2021-06-19;5567;25;0;0;0;512681;968;5;0;0
FR;4;2021-06-20;819;5;0;0;0;513500;973;5;0;0
FR;4;2021-06-21;5081;20;0;0;0;518581;993;5;0;0
FR;4;2021-06-22;7905;28;2;0;0;526486;1021;7;0;0
FR;4;2021-06-23;7093;40;2;0;0;533579;1061;9;0;0
FR;4;2021-06-24;8647;46;1;0;0;542226;1107;10;0;0
FR;4;2021-06-25;10172;39;2;0;0;552398;1146;12;0;0
FR;4;2021-06-26;4840;21;0;0;0;557238;1167;12;0;0
FR;4;2021-06-27;760;3;0;0;0;557998;1170;12;0;0
FR;4;2021-06-28;4822;16;1;0;0;562820;1186;13;0;0
FR;4;2021-06-29;7098;27;2;0;0;569918;1213;15;0;0
FR;4;2021-06-30;6708;39;2;0;0;576626;1252;17;0;0
FR;4;2021-07-01;8193;40;0;0;0;584819;1292;17;0;0
FR;4;2021-07-02;9412;52;1;0;0;594231;1344;18;0;0
FR;4;2021-07-03;4844;19;0;0;0;599075;1363;18;0;0
FR;4;2021-07-04;686;5;0;0;0;599761;1368;18;0;0
FR;4;2021-07-05;4766;19;2;0;0;604527;1387;20;0;0
FR;4;2021-07-06;7717;28;4;0;0;612244;1415;24;0;0
FR;4;2021-07-07;7069;34;2;0;0;619313;1449;26;0;0
FR;4;2021-07-08;9221;40;2;0;0;628534;1489;28;0;0
FR;4;2021-07-09;10276;34;1;0;0;638810;1523;29;0;0
FR;4;2021-07-10;4634;14;2;0;0;643444;1537;31;0;0
FR;4;2021-07-11;582;4;1;0;0;644026;1541;32;0;0
FR;4;2021-07-12;5868;29;0;0;0;649894;1570;32;0;0
FR;4;2021-07-13;14230;29;0;0;0;664124;1599;32;0;0
FR;4;2021-07-14;2283;14;0;0;0;666407;1613;32;0;0
FR;4;2021-07-15;18232;36;0;0;0;684639;1649;32;0;0
FR;4;2021-07-16;22815;70;2;0;0;707454;1719;34;0;0
FR;4;2021-07-17;9734;20;0;0;0;717188;1739;34;0;0
FR;4;2021-07-18;1354;4;0;0;0;718542;1743;34;0;0
FR;4;2021-07-19;12980;28;1;0;0;731522;1771;35;0;0
FR;4;2021-07-20;17334;26;1;0;0;748856;1797;36;0;0
FR;4;2021-07-21;15606;33;0;0;0;764462;1830;36;0;0
FR;4;2021-07-22;18239;44;2;0;0;782701;1874;38;0;0
FR;4;2021-07-23;20405;57;7;0;0;803106;1931;45;0;0
FR;4;2021-07-24;9282;32;0;0;0;812388;1963;45;0;0
FR;4;2021-07-25;1350;8;0;0;0;813738;1971;45;0;0
FR;4;2021-07-26;11032;20;0;0;0;824770;1991;45;0;0
FR;4;2021-07-27;14662;35;3;0;0;839432;2026;48;0;0
FR;4;2021-07-28;12923;26;2;0;0;852355;2052;50;0;0
FR;4;2021-07-29;14080;54;4;0;0;866435;2106;54;0;0
FR;4;2021-07-30;15480;45;2;0;0;881915;2151;56;0;0
FR;4;2021-07-31;6833;14;2;0;0;888748;2165;58;0;0
FR;4;2021-08-01;905;1;0;0;0;889653;2166;58;0;0
FR;4;2021-08-02;7906;29;0;0;0;897559;2195;58;0;0
FR;4;2021-08-03;10789;32;2;0;0;908348;2227;60;0;0
FR;4;2021-08-04;9734;29;0;0;0;918082;2256;60;0;0
FR;4;2021-08-05;9815;41;0;0;0;927897;2297;60;0;0
FR;4;2021-08-06;10187;30;3;0;0;938084;2327;63;0;0
FR;4;2021-08-07;5090;30;1;0;0;943174;2357;64;0;0
FR;4;2021-08-08;1217;13;0;0;0;944391;2370;64;0;0
FR;4;2021-08-09;6334;31;0;0;0;950725;2401;64;0;0
FR;4;2021-08-10;8742;18;0;0;0;959467;2419;64;0;0
FR;4;2021-08-11;7931;33;4;0;0;967398;2452;68;0;0
FR;4;2021-08-12;8580;29;1;0;0;975978;2481;69;0;0
FR;4;2021-08-13;7548;24;0;1;0;983526;2505;69;1;0
FR;4;2021-08-14;3787;20;0;0;0;987313;2525;69;1;0
FR;4;2021-08-15;769;5;0;0;0;988082;2530;69;1;0
FR;4;2021-08-16;4002;16;0;0;0;992084;2546;69;1;0
FR;4;2021-08-17;5617;17;1;0;0;997701;2563;70;1;0
FR;4;2021-08-18;5165;34;0;0;0;1002866;2597;70;1;0
FR;4;2021-08-19;5476;33;3;0;0;1008342;2630;73;1;0
FR;4;2021-08-20;5211;24;1;0;0;1013553;2654;74;1;0
FR;4;2021-08-21;2309;21;1;0;0;1015862;2675;75;1;0
FR;4;2021-08-22;401;2;0;0;0;1016263;2677;75;1;0
FR;4;2021-08-23;2926;19;1;0;0;1019189;2696;76;1;0
FR;4;2021-08-24;3745;15;0;0;0;1022934;2711;76;1;0
FR;4;2021-08-25;3538;25;0;0;0;1026472;2736;76;1;0
FR;4;2021-08-26;3702;20;2;0;0;1030174;2756;78;1;0
FR;4;2021-08-27;3606;31;2;0;0;1033780;2787;80;1;0
FR;4;2021-08-28;1725;9;1;0;0;1035505;2796;81;1;0
FR;4;2021-08-29;387;7;1;0;0;1035892;2803;82;1;0
FR;4;2021-08-30;2009;24;0;0;14;1037901;2827;82;1;14
FR;4;2021-08-31;2481;20;0;0;13;1040382;2847;82;1;27
FR;4;2021-09-01;2078;38;1;0;21;1042460;2885;83;1;48
FR;4;2021-09-02;2301;31;4;0;18;1044761;2916;87;1;66
FR;4;2021-09-03;2357;44;5;0;32;1047118;2960;92;1;98
FR;4;2021-09-04;1373;17;0;0;8;1048491;2977;92;1;106
FR;4;2021-09-05;432;2;0;0;2;1048923;2979;92;1;108
FR;4;2021-09-06;1707;60;0;0;21;1050630;3039;92;1;129
FR;4;2021-09-07;1675;18;1;0;9;1052305;3057;93;1;138
FR;4;2021-09-08;1280;27;3;1;20;1053585;3084;96;2;158
FR;4;2021-09-09;1385;23;2;0;9;1054970;3107;98;2;167
FR;4;2021-09-10;1517;31;2;0;23;1056487;3138;100;2;190
FR;4;2021-09-11;738;11;0;0;3;1057225;3149;100;2;193
FR;4;2021-09-12;168;4;0;0;2;1057393;3153;100;2;195
FR;4;2021-09-13;1316;22;1;0;16;1058709;3175;101;2;211
FR;4;2021-09-14;1497;9;2;0;6;1060206;3184;103;2;217
FR;4;2021-09-15;1092;27;1;0;24;1061298;3211;104;2;241
FR;4;2021-09-16;1098;22;2;0;15;1062396;3233;106;2;256
FR;4;2021-09-17;890;21;1;0;12;1063286;3254;107;2;268
FR;4;2021-09-18;462;6;1;0;5;1063748;3260;108;2;273
FR;4;2021-09-19;181;3;0;0;2;1063929;3263;108;2;275
FR;4;2021-09-20;448;19;0;0;13;1064377;3282;108;2;288
FR;4;2021-09-21;423;11;0;0;7;1064800;3293;108;2;295
FR;4;2021-09-22;372;19;2;0;13;1065172;3312;110;2;308
FR;4;2021-09-23;477;16;1;0;15;1065649;3328;111;2;323
FR;4;2021-09-24;409;13;2;0;9;1066058;3341;113;2;332
FR;4;2021-09-25;281;9;1;0;4;1066339;3350;114;2;336
FR;4;2021-09-26;73;2;0;0;1;1066412;3352;114;2;337
FR;4;2021-09-27;261;10;1;0;8;1066673;3362;115;2;345
FR;4;2021-09-28;315;8;0;0;8;1066988;3370;115;2;353
FR;4;2021-09-29;372;18;1;0;12;1067360;3388;116;2;365
FR;4;2021-09-30;359;40;0;0;21;1067719;3428;116;2;386
FR;4;2021-10-01;408;49;0;0;43;1068127;3477;116;2;429
FR;4;2021-10-02;195;22;1;0;13;1068322;3499;117;2;442
FR;4;2021-10-03;85;1;0;0;0;1068407;3500;117;2;442
FR;4;2021-10-04;355;19;1;0;15;1068762;3519;118;2;457
FR;4;2021-10-05;277;19;2;0;15;1069039;3538;120;2;472
FR;4;2021-10-06;244;21;1;0;17;1069283;3559;121;2;489
FR;4;2021-10-07;258;25;2;0;13;1069541;3584;123;2;502
FR;4;2021-10-08;353;23;2;0;19;1069894;3607;125;2;521
FR;4;2021-10-09;193;6;6;0;7;1070087;3613;131;2;528
FR;4;2021-10-10;95;3;2;0;3;1070182;3616;133;2;531
FR;4;2021-10-11;246;15;1;0;14;1070428;3631;134;2;545
FR;4;2021-10-12;205;14;0;0;13;1070633;3645;134;2;558
FR;4;2021-10-13;218;27;1;0;24;1070851;3672;135;2;582
FR;4;2021-10-14;307;22;4;0;16;1071158;3694;139;2;598
FR;4;2021-10-15;321;24;5;0;25;1071479;3718;144;2;623
FR;4;2021-10-16;166;6;2;0;6;1071645;3724;146;2;629
FR;4;2021-10-17;70;2;0;0;1;1071715;3726;146;2;630
FR;4;2021-10-18;278;16;1;0;12;1071993;3742;147;2;642
FR;4;2021-10-19;210;14;2;0;15;1072203;3756;149;2;657
FR;4;2021-10-20;225;27;4;0;15;1072428;3783;153;2;672
FR;4;2021-10-21;235;17;0;0;13;1072663;3800;153;2;685
FR;4;2021-10-22;211;25;2;0;20;1072874;3825;155;2;705
FR;4;2021-10-23;115;16;1;0;15;1072989;3841;156;2;720
FR;4;2021-10-24;38;4;0;0;1;1073027;3845;156;2;721
FR;4;2021-10-25;210;7;2;0;9;1073237;3852;158;2;730
FR;4;2021-10-26;196;14;0;0;12;1073433;3866;158;2;742
FR;4;2021-10-27;192;11;4;0;11;1073625;3877;162;2;753
FR;4;2021-10-28;182;18;4;0;21;1073807;3895;166;2;774
FR;4;2021-10-29;220;15;2;0;13;1074027;3910;168;2;787
FR;4;2021-10-30;102;2;1;0;2;1074129;3912;169;2;789
FR;4;2021-10-31;56;3;2;0;3;1074185;3915;171;2;792
FR;4;2021-11-01;75;27;4;0;24;1074260;3942;175;2;816
FR;4;2021-11-02;156;20;2;0;21;1074416;3962;177;2;837
FR;4;2021-11-03;127;20;8;1;18;1074543;3982;185;3;855
FR;4;2021-11-04;176;15;1;0;12;1074719;3997;186;3;867
FR;4;2021-11-05;128;17;1;0;16;1074847;4014;187;3;883
FR;4;2021-11-06;77;6;1;0;6;1074924;4020;188;3;889
FR;4;2021-11-07;76;2;2;0;4;1075000;4022;190;3;893
FR;4;2021-11-08;158;20;1;0;20;1075158;4042;191;3;913
FR;4;2021-11-09;151;14;3;0;16;1075309;4056;194;3;929
FR;4;2021-11-10;114;29;6;0;31;1075423;4085;200;3;960
FR;4;2021-11-11;86;10;0;0;10;1075509;4095;200;3;970
FR;4;2021-11-12;99;19;2;0;18;1075608;4114;202;3;988
FR;4;2021-11-13;73;15;2;0;14;1075681;4129;204;3;1002
FR;4;2021-11-14;53;5;3;0;7;1075734;4134;207;3;1009
FR;4;2021-11-15;98;26;2;0;24;1075832;4160;209;3;1033
FR;4;2021-11-16;101;12;2;0;14;1075933;4172;211;3;1047
FR;4;2021-11-17;117;29;4;0;29;1076050;4201;215;3;1076
FR;4;2021-11-18;99;34;12;0;41;1076149;4235;227;3;1117
FR;4;2021-11-19;80;19;3;0;20;1076229;4254;230;3;1137
FR;4;2021-11-20;75;8;1;0;8;1076304;4262;231;3;1145
FR;4;2021-11-21;61;7;2;0;9;1076365;4269;233;3;1154
FR;4;2021-11-22;101;27;7;0;30;1076466;4296;240;3;1184
FR;4;2021-11-23;74;29;5;0;26;1076540;4325;245;3;1210
FR;4;2021-11-24;85;23;9;0;22;1076625;4348;254;3;1232
FR;4;2021-11-25;85;28;14;0;30;1076710;4376;268;3;1262
FR;4;2021-11-26;81;43;12;0;45;1076791;4419;280;3;1307
FR;4;2021-11-27;35;22;15;0;25;1076826;4441;295;3;1332
FR;4;2021-11-28;48;8;0;0;7;1076874;4449;295;3;1339
FR;4;2021-11-29;86;31;15;0;39;1076960;4480;310;3;1378
FR;4;2021-11-30;72;36;12;0;40;1077032;4516;322;3;1418
FR;4;2021-12-01;81;59;19;0;66;1077113;4575;341;3;1484
FR;4;2021-12-02;98;47;19;0;52;1077211;4622;360;3;1536
FR;4;2021-12-03;98;36;15;0;44;1077309;4658;375;3;1580
FR;4;2021-12-04;70;31;18;0;44;1077379;4689;393;3;1624
FR;4;2021-12-05;61;5;1;0;6;1077440;4694;394;3;1630
FR;4;2021-12-06;98;45;20;0;59;1077538;4739;414;3;1689
FR;4;2021-12-07;78;34;9;0;34;1077616;4773;423;3;1723
FR;4;2021-12-08;67;29;16;0;35;1077683;4802;439;3;1758
FR;4;2021-12-09;61;32;10;0;38;1077744;4834;449;3;1796
FR;4;2021-12-10;60;62;21;0;66;1077804;4896;470;3;1862
FR;4;2021-12-11;24;34;7;0;34;1077828;4930;477;3;1896
FR;4;2021-12-12;23;10;3;0;13;1077851;4940;480;3;1909
FR;4;2021-12-13;68;38;13;0;47;1077919;4978;493;3;1956
FR;4;2021-12-14;56;43;15;0;52;1077975;5021;508;3;2008
FR;4;2021-12-15;59;63;28;0;83;1078034;5084;536;3;2091
FR;4;2021-12-16;31;44;18;0;56;1078065;5128;554;3;2147
FR;4;2021-12-17;39;55;12;0;60;1078104;5183;566;3;2207
FR;4;2021-12-18;48;29;2;0;30;1078152;5212;568;3;2237
FR;4;2021-12-19;15;4;1;0;4;1078167;5216;569;3;2241
FR;4;2021-12-20;37;38;10;0;41;1078204;5254;579;3;2282
FR;4;2021-12-21;26;30;15;0;36;1078230;5284;594;3;2318
FR;4;2021-12-22;36;36;10;0;37;1078266;5320;604;3;2355
FR;4;2021-12-23;39;43;8;0;47;1078305;5363;612;3;2402
FR;4;2021-12-24;23;25;10;0;29;1078328;5388;622;3;2431
FR;4;2021-12-25;6;3;3;0;4;1078334;5391;625;3;2435
FR;4;2021-12-26;4;3;1;0;2;1078338;5394;626;3;2437
FR;4;2021-12-27;27;41;8;0;42;1078365;5435;634;3;2479
FR;4;2021-12-28;24;28;7;0;29;1078389;5463;641;3;2508
FR;4;2021-12-29;48;24;10;0;28;1078437;5487;651;3;2536
FR;4;2021-12-30;41;16;12;0;19;1078478;5503;663;3;2555
FR;4;2021-12-31;18;5;8;0;10;1078496;5508;671;3;2565
FR;4;2022-01-01;5;4;4;0;6;1078501;5512;675;3;2571
FR;4;2022-01-02;40;4;15;0;18;1078541;5516;690;3;2589
FR;4;2022-01-03;38;52;20;1;57;1078579;5568;710;4;2646
FR;4;2022-01-04;31;26;13;0;29;1078610;5594;723;4;2675
FR;4;2022-01-05;46;21;16;0;22;1078656;5615;739;4;2697
FR;4;2022-01-06;45;20;22;0;34;1078701;5635;761;4;2731
FR;4;2022-01-07;28;19;15;0;19;1078729;5654;776;4;2750
FR;4;2022-01-08;8;5;10;0;12;1078737;5659;786;4;2762
FR;4;2022-01-09;17;2;2;0;3;1078754;5661;788;4;2765
FR;4;2022-01-10;39;22;17;0;34;1078793;5683;805;4;2799
FR;4;2022-01-11;23;30;12;0;34;1078816;5713;817;4;2833
FR;4;2022-01-12;31;20;12;0;21;1078847;5733;829;4;2854
FR;4;2022-01-13;48;19;26;0;36;1078895;5752;855;4;2890
FR;4;2022-01-14;23;28;13;0;31;1078918;5780;868;4;2921
FR;4;2022-01-15;10;6;7;0;11;1078928;5786;875;4;2932
FR;4;2022-01-16;9;9;11;0;19;1078937;5795;886;4;2951
FR;4;2022-01-17;23;18;12;0;24;1078960;5813;898;4;2975
FR;4;2022-01-18;16;13;7;0;17;1078976;5826;905;4;2992
FR;4;2022-01-19;29;23;9;0;30;1079005;5849;914;4;3022
FR;4;2022-01-20;31;34;11;0;37;1079036;5883;925;4;3059
FR;4;2022-01-21;9;12;18;1;15;1079045;5895;943;5;3074
FR;4;2022-01-22;30;9;2;0;9;1079075;5904;945;5;3083
FR;4;2022-01-23;6;2;4;0;6;1079081;5906;949;5;3089
FR;4;2022-01-24;14;21;8;0;27;1079095;5927;957;5;3116
FR;4;2022-01-25;20;30;8;1;34;1079115;5957;965;6;3150
FR;4;2022-01-26;19;15;6;1;16;1079134;5972;971;7;3166
FR;4;2022-01-27;19;18;6;0;22;1079153;5990;977;7;3188
FR;4;2022-01-28;12;23;7;0;25;1079165;6013;984;7;3213
FR;4;2022-01-29;15;6;4;0;9;1079180;6019;988;7;3222
FR;4;2022-01-30;16;2;0;0;2;1079196;6021;988;7;3224
FR;4;2022-01-31;19;27;6;0;29;1079215;6048;994;7;3253
FR;4;2022-02-01;9;19;11;0;19;1079224;6067;1005;7;3272
FR;4;2022-02-02;16;11;10;2;16;1079240;6078;1015;9;3288
FR;4;2022-02-03;12;22;9;0;25;1079252;6100;1024;9;3313
FR;4;2022-02-04;6;5;7;0;9;1079258;6105;1031;9;3322
FR;4;2022-02-05;6;14;1;0;13;1079264;6119;1032;9;3335
FR;4;2022-02-06;5;2;2;0;3;1079269;6121;1034;9;3338
FR;4;2022-02-07;13;19;7;0;19;1079282;6140;1041;9;3357
FR;4;2022-02-08;15;19;13;1;20;1079297;6159;1054;10;3377
FR;4;2022-02-09;14;11;7;0;14;1079311;6170;1061;10;3391
FR;4;2022-02-10;18;23;9;0;24;1079329;6193;1070;10;3415
FR;4;2022-02-11;18;14;8;0;19;1079347;6207;1078;10;3434
FR;4;2022-02-12;23;6;1;0;5;1079370;6213;1079;10;3439
FR;4;2022-02-13;7;3;3;0;6;1079377;6216;1082;10;3445
FR;4;2022-02-14;18;10;7;0;13;1079395;6226;1089;10;3458
FR;4;2022-02-15;16;7;1;0;7;1079411;6233;1090;10;3465
FR;4;2022-02-16;11;9;10;0;15;1079422;6242;1100;10;3480
FR;4;2022-02-17;10;4;4;0;6;1079432;6246;1104;10;3486
FR;4;2022-02-18;17;13;6;0;17;1079449;6259;1110;10;3503
FR;4;2022-02-19;16;2;2;0;4;1079465;6261;1112;10;3507
FR;4;2022-02-20;7;2;0;0;1;1079472;6263;1112;10;3508
FR;4;2022-02-21;22;3;3;0;4;1079494;6266;1115;10;3512
FR;4;2022-02-22;8;4;8;0;8;1079502;6270;1123;10;3520
FR;4;2022-02-23;16;6;9;0;9;1079518;6276;1132;10;3529
FR;4;2022-02-24;9;4;2;0;4;1079527;6280;1134;10;3533
FR;4;2022-02-25;15;5;7;0;6;1079542;6285;1141;10;3539
FR;4;2022-02-26;26;3;0;0;3;1079568;6288;1141;10;3542
FR;4;2022-02-27;9;0;1;0;1;1079577;6288;1142;10;3543
FR;4;2022-02-28;14;3;2;0;3;1079591;6291;1144;10;3546
FR;4;2022-03-01;6;2;7;0;3;1079597;6293;1151;10;3549
FR;4;2022-03-02;10;2;3;0;4;1079607;6295;1154;10;3553
FR;4;2022-03-03;16;5;1;0;4;1079623;6300;1155;10;3557
FR;4;2022-03-04;6;7;2;1;5;1079629;6307;1157;11;3562
FR;4;2022-03-05;9;2;0;0;2;1079638;6309;1157;11;3564
FR;4;2022-03-06;4;0;1;0;1;1079642;6309;1158;11;3565
FR;4;2022-03-07;10;4;1;0;3;1079652;6313;1159;11;3568
FR;4;2022-03-08;13;2;0;0;2;1079665;6315;1159;11;3570
FR;4;2022-03-09;7;3;2;0;4;1079672;6318;1161;11;3574
FR;4;2022-03-10;5;1;5;0;2;1079677;6319;1166;11;3576
FR;4;2022-03-11;8;2;5;0;1;1079685;6321;1171;11;3577
FR;4;2022-03-12;9;2;0;0;0;1079694;6323;1171;11;3577
FR;4;2022-03-13;5;1;1;0;2;1079699;6324;1172;11;3579
FR;4;2022-03-14;4;1;0;0;1;1079703;6325;1172;11;3580
FR;4;2022-03-15;5;3;1;0;1;1079708;6328;1173;11;3581
FR;4;2022-03-16;6;3;3;0;3;1079714;6331;1176;11;3584
FR;4;2022-03-17;2;4;1;0;5;1079716;6335;1177;11;3589
FR;4;2022-03-18;7;3;0;0;3;1079723;6338;1177;11;3592
FR;4;2022-03-19;1;1;0;0;1;1079724;6339;1177;11;3593
FR;4;2022-03-20;2;0;2;0;1;1079726;6339;1179;11;3594
FR;4;2022-03-21;5;3;0;0;3;1079731;6342;1179;11;3597
FR;4;2022-03-22;3;2;1;0;2;1079734;6344;1180;11;3599
FR;4;2022-03-23;6;4;4;0;7;1079740;6348;1184;11;3606
FR;4;2022-03-24;2;4;3;1;5;1079742;6352;1187;12;3611
FR;4;2022-03-25;3;1;2;0;1;1079745;6353;1189;12;3612
FR;4;2022-03-26;5;5;0;0;5;1079750;6358;1189;12;3617
FR;4;2022-03-27;1;0;1;0;0;1079751;6358;1190;12;3617
FR;4;2022-03-28;4;1;3;0;3;1079755;6359;1193;12;3620
FR;4;2022-03-29;7;0;4;1;0;1079762;6359;1197;13;3620
FR;4;2022-03-30;1;4;0;0;4;1079763;6363;1197;13;3624
FR;4;2022-03-31;1;3;1;1;3;1079764;6366;1198;14;3627
FR;4;2022-04-01;13;3;5;0;6;1079777;6369;1203;14;3633
FR;4;2022-04-02;4;4;0;0;3;1079781;6373;1203;14;3636
FR;4;2022-04-03;0;0;0;0;0;1079781;6373;1203;14;3636
FR;4;2022-04-04;3;3;4;0;3;1079784;6376;1207;14;3639
FR;4;2022-04-05;3;3;1;1;2;1079787;6379;1208;15;3641
FR;4;2022-04-06;3;0;0;0;0;1079790;6379;1208;15;3641
FR;4;2022-04-07;3;2;1;2;3;1079793;6381;1209;17;3644
FR;4;2022-04-08;4;1;1;0;1;1079797;6382;1210;17;3645
FR;4;2022-04-09;0;0;1;1;1;1079797;6382;1211;18;3646
FR;4;2022-04-10;1;2;0;0;2;1079798;6384;1211;18;3648
FR;4;2022-04-11;3;2;4;0;4;1079801;6386;1215;18;3652
FR;4;2022-04-12;2;1;4;0;2;1079803;6387;1219;18;3654
FR;4;2022-04-13;4;7;1;0;8;1079807;6394;1220;18;3662
FR;4;2022-04-14;5;3;0;1;2;1079812;6397;1220;19;3664
FR;4;2022-04-15;2;7;1;0;8;1079814;6404;1221;19;3672
FR;4;2022-04-16;1;0;0;0;0;1079815;6404;1221;19;3672
FR;4;2022-04-17;1;1;0;0;1;1079816;6405;1221;19;3673
FR;4;2022-04-18;1;2;4;0;2;1079817;6407;1225;19;3675
FR;4;2022-04-19;2;0;1;0;0;1079819;6407;1226;19;3675
FR;4;2022-04-20;13;3;1;0;2;1079832;6410;1227;19;3677
FR;4;2022-04-21;5;1;0;0;1;1079837;6411;1227;19;3678
FR;4;2022-04-22;1;0;1;0;0;1079838;6411;1228;19;3678
FR;4;2022-04-23;1;3;2;0;5;1079839;6414;1230;19;3683
FR;4;2022-04-24;0;2;0;0;2;1079839;6416;1230;19;3685
FR;4;2022-04-25;3;4;3;0;7;1079842;6420;1233;19;3692
FR;4;2022-04-26;3;4;1;0;4;1079845;6424;1234;19;3696
FR;4;2022-04-27;4;0;0;0;0;1079849;6424;1234;19;3696
FR;4;2022-04-28;2;5;5;0;6;1079851;6429;1239;19;3702
FR;4;2022-04-29;3;2;0;0;1;1079854;6431;1239;19;3703
FR;4;2022-04-30;0;1;1;0;2;1079854;6432;1240;19;3705
FR;4;2022-05-01;0;0;0;0;0;1079854;6432;1240;19;3705
FR;4;2022-05-02;4;8;5;0;10;1079858;6440;1245;19;3715
FR;4;2022-05-03;0;2;1;0;2;1079858;6442;1246;19;3717
FR;4;2022-05-04;4;4;1;0;4;1079862;6446;1247;19;3721
FR;4;2022-05-05;2;1;1;0;1;1079864;6447;1248;19;3722
FR;4;2022-05-06;2;1;1;0;1;1079866;6448;1249;19;3723
FR;4;2022-05-07;0;0;0;0;0;1079866;6448;1249;19;3723
FR;4;2022-05-08;1;1;0;0;1;1079867;6449;1249;19;3724
FR;4;2022-05-09;5;0;0;0;0;1079872;6449;1249;19;3724
FR;4;2022-05-10;0;0;0;2;2;1079872;6449;1249;21;3726
FR;4;2022-05-11;2;1;0;0;1;1079874;6450;1249;21;3727
FR;4;2022-05-12;5;1;1;1;2;1079879;6451;1250;22;3729
FR;4;2022-05-13;0;0;2;0;2;1079879;6451;1252;22;3731
FR;4;2022-05-14;0;2;0;0;2;1079879;6453;1252;22;3733
FR;4;2022-05-15;1;2;0;0;0;1079880;6455;1252;22;3733
FR;4;2022-05-16;5;2;1;0;2;1079885;6457;1253;22;3735
FR;4;2022-05-17;3;1;1;0;2;1079888;6458;1254;22;3737
FR;4;2022-05-18;0;1;0;0;1;1079888;6459;1254;22;3738
FR;4;2022-05-19;2;1;2;0;2;1079890;6460;1256;22;3740
FR;4;2022-05-20;1;0;3;0;0;1079891;6460;1259;22;3740
FR;4;2022-05-21;2;0;1;0;1;1079893;6460;1260;22;3741
FR;4;2022-05-22;0;0;1;0;1;1079893;6460;1261;22;3742
FR;4;2022-05-23;0;0;2;0;0;1079893;6460;1263;22;3742
FR;4;2022-05-24;1;1;0;0;1;1079894;6461;1263;22;3743
FR;4;2022-05-25;1;1;0;0;0;1079895;6462;1263;22;3743
FR;4;2022-05-26;1;0;0;0;0;1079896;6462;1263;22;3743
FR;4;2022-05-27;0;0;0;0;0;1079896;6462;1263;22;3743
FR;4;2022-05-28;0;0;0;0;0;1079896;6462;1263;22;3743
FR;4;2022-05-29;0;0;0;0;0;1079896;6462;1263;22;3743
FR;4;2022-05-30;1;0;1;0;1;1079897;6462;1264;22;3744
FR;4;2022-05-31;2;0;0;0;0;1079899;6462;1264;22;3744
FR;4;2022-06-01;0;0;0;0;0;1079899;6462;1264;22;3744
FR;4;2022-06-02;1;0;0;0;0;1079900;6462;1264;22;3744
FR;4;2022-06-03;0;0;0;1;0;1079900;6462;1264;23;3744
FR;4;2022-06-04;0;0;0;0;0;1079900;6462;1264;23;3744
FR;4;2022-06-05;0;0;0;0;0;1079900;6462;1264;23;3744
FR;4;2022-06-06;1;0;0;0;0;1079901;6462;1264;23;3744
FR;4;2022-06-07;2;0;0;0;0;1079903;6462;1264;23;3744
FR;4;2022-06-08;0;1;0;0;1;1079903;6463;1264;23;3745
FR;4;2022-06-09;0;0;0;0;0;1079903;6463;1264;23;3745
FR;5;2020-12-27;0;0;0;0;0;0;0;0;0;0
FR;5;2020-12-28;0;0;0;0;0;0;0;0;0;0
FR;5;2020-12-29;0;0;0;0;0;0;0;0;0;0
FR;5;2020-12-30;0;0;0;0;0;0;0;0;0;0
FR;5;2020-12-31;0;0;0;0;0;0;0;0;0;0
FR;5;2021-01-01;0;0;0;0;0;0;0;0;0;0
FR;5;2021-01-02;0;0;0;0;0;0;0;0;0;0
FR;5;2021-01-03;0;0;0;0;0;0;0;0;0;0
FR;5;2021-01-04;0;0;0;0;0;0;0;0;0;0
FR;5;2021-01-05;0;0;0;0;0;0;0;0;0;0
FR;5;2021-01-06;0;0;0;0;0;0;0;0;0;0
FR;5;2021-01-07;0;0;0;0;0;0;0;0;0;0
FR;5;2021-01-08;0;0;0;0;0;0;0;0;0;0
FR;5;2021-01-09;0;0;0;0;0;0;0;0;0;0
FR;5;2021-01-10;0;0;0;0;0;0;0;0;0;0
FR;5;2021-01-11;0;0;0;0;0;0;0;0;0;0
FR;5;2021-01-12;0;0;0;0;0;0;0;0;0;0
FR;5;2021-01-13;0;0;0;0;0;0;0;0;0;0
FR;5;2021-01-14;0;0;0;0;0;0;0;0;0;0
FR;5;2021-01-15;0;0;0;0;0;0;0;0;0;0
FR;5;2021-01-16;0;0;0;0;0;0;0;0;0;0
FR;5;2021-01-17;0;0;0;0;0;0;0;0;0;0
FR;5;2021-01-18;0;0;0;0;0;0;0;0;0;0
FR;5;2021-01-19;0;0;0;0;0;0;0;0;0;0
FR;5;2021-01-20;0;0;0;0;0;0;0;0;0;0
FR;5;2021-01-21;0;0;0;0;0;0;0;0;0;0
FR;5;2021-01-22;0;0;0;0;0;0;0;0;0;0
FR;5;2021-01-23;0;0;0;0;0;0;0;0;0;0
FR;5;2021-01-24;0;0;0;0;0;0;0;0;0;0
FR;5;2021-01-25;0;0;0;0;0;0;0;0;0;0
FR;5;2021-01-26;0;0;0;0;0;0;0;0;0;0
FR;5;2021-01-27;0;0;0;0;0;0;0;0;0;0
FR;5;2021-01-28;0;0;0;0;0;0;0;0;0;0
FR;5;2021-01-29;0;0;0;0;0;0;0;0;0;0
FR;5;2021-01-30;0;0;0;0;0;0;0;0;0;0
FR;5;2021-01-31;0;0;0;0;0;0;0;0;0;0
FR;5;2021-02-01;0;0;0;0;0;0;0;0;0;0
FR;5;2021-02-02;0;0;0;0;0;0;0;0;0;0
FR;5;2021-02-03;0;0;0;0;0;0;0;0;0;0
FR;5;2021-02-04;0;0;0;0;0;0;0;0;0;0
FR;5;2021-02-05;0;0;0;0;0;0;0;0;0;0
FR;5;2021-02-06;0;0;0;0;0;0;0;0;0;0
FR;5;2021-02-07;0;0;0;0;0;0;0;0;0;0
FR;5;2021-02-08;0;0;0;0;0;0;0;0;0;0
FR;5;2021-02-09;0;0;0;0;0;0;0;0;0;0
FR;5;2021-02-10;0;0;0;0;0;0;0;0;0;0
FR;5;2021-02-11;0;0;0;0;0;0;0;0;0;0
FR;5;2021-02-12;0;0;0;0;0;0;0;0;0;0
FR;5;2021-02-13;0;0;0;0;0;0;0;0;0;0
FR;5;2021-02-14;0;0;0;0;0;0;0;0;0;0
FR;5;2021-02-15;0;0;0;0;0;0;0;0;0;0
FR;5;2021-02-16;0;0;0;0;0;0;0;0;0;0
FR;5;2021-02-17;0;0;0;0;0;0;0;0;0;0
FR;5;2021-02-18;0;0;0;0;0;0;0;0;0;0
FR;5;2021-02-19;0;0;0;0;0;0;0;0;0;0
FR;5;2021-02-20;0;0;0;0;0;0;0;0;0;0
FR;5;2021-02-21;0;0;0;0;0;0;0;0;0;0
FR;5;2021-02-22;0;0;0;0;0;0;0;0;0;0
FR;5;2021-02-23;0;0;0;0;0;0;0;0;0;0
FR;5;2021-02-24;0;0;0;0;0;0;0;0;0;0
FR;5;2021-02-25;0;0;0;0;0;0;0;0;0;0
FR;5;2021-02-26;0;0;0;0;0;0;0;0;0;0
FR;5;2021-02-27;0;0;0;0;0;0;0;0;0;0
FR;5;2021-02-28;0;0;0;0;0;0;0;0;0;0
FR;5;2021-03-01;0;0;0;0;0;0;0;0;0;0
FR;5;2021-03-02;0;0;0;0;0;0;0;0;0;0
FR;5;2021-03-03;0;0;0;0;0;0;0;0;0;0
FR;5;2021-03-04;0;0;0;0;0;0;0;0;0;0
FR;5;2021-03-05;0;0;0;0;0;0;0;0;0;0
FR;5;2021-03-06;0;0;0;0;0;0;0;0;0;0
FR;5;2021-03-07;0;0;0;0;0;0;0;0;0;0
FR;5;2021-03-08;0;0;0;0;0;0;0;0;0;0
FR;5;2021-03-09;0;0;0;0;0;0;0;0;0;0
FR;5;2021-03-10;0;0;0;0;0;0;0;0;0;0
FR;5;2021-03-11;0;0;0;0;0;0;0;0;0;0
FR;5;2021-03-12;0;0;0;0;0;0;0;0;0;0
FR;5;2021-03-13;0;0;0;0;0;0;0;0;0;0
FR;5;2021-03-14;0;0;0;0;0;0;0;0;0;0
FR;5;2021-03-15;0;0;0;0;0;0;0;0;0;0
FR;5;2021-03-16;0;0;0;0;0;0;0;0;0;0
FR;5;2021-03-17;0;0;0;0;0;0;0;0;0;0
FR;5;2021-03-18;0;0;0;0;0;0;0;0;0;0
FR;5;2021-03-19;0;0;0;0;0;0;0;0;0;0
FR;5;2021-03-20;0;0;0;0;0;0;0;0;0;0
FR;5;2021-03-21;0;0;0;0;0;0;0;0;0;0
FR;5;2021-03-22;0;0;0;0;0;0;0;0;0;0
FR;5;2021-03-23;0;0;0;0;0;0;0;0;0;0
FR;5;2021-03-24;0;0;0;0;0;0;0;0;0;0
FR;5;2021-03-25;0;0;0;0;0;0;0;0;0;0
FR;5;2021-03-26;0;0;0;0;0;0;0;0;0;0
FR;5;2021-03-27;0;0;0;0;0;0;0;0;0;0
FR;5;2021-03-28;0;0;0;0;0;0;0;0;0;0
FR;5;2021-03-29;0;0;0;0;0;0;0;0;0;0
FR;5;2021-03-30;0;0;0;0;0;0;0;0;0;0
FR;5;2021-03-31;0;0;0;0;0;0;0;0;0;0
FR;5;2021-04-01;0;0;0;0;0;0;0;0;0;0
FR;5;2021-04-02;0;0;0;0;0;0;0;0;0;0
FR;5;2021-04-03;0;0;0;0;0;0;0;0;0;0
FR;5;2021-04-04;0;0;0;0;0;0;0;0;0;0
FR;5;2021-04-05;0;0;0;0;0;0;0;0;0;0
FR;5;2021-04-06;0;0;0;0;0;0;0;0;0;0
FR;5;2021-04-07;0;0;0;0;0;0;0;0;0;0
FR;5;2021-04-08;0;0;0;0;0;0;0;0;0;0
FR;5;2021-04-09;0;0;0;0;0;0;0;0;0;0
FR;5;2021-04-10;0;0;0;0;0;0;0;0;0;0
FR;5;2021-04-11;0;0;0;0;0;0;0;0;0;0
FR;5;2021-04-12;0;0;0;0;0;0;0;0;0;0
FR;5;2021-04-13;0;0;0;0;0;0;0;0;0;0
FR;5;2021-04-14;0;0;0;0;0;0;0;0;0;0
FR;5;2021-04-15;0;0;0;0;0;0;0;0;0;0
FR;5;2021-04-16;0;0;0;0;0;0;0;0;0;0
FR;5;2021-04-17;0;0;0;0;0;0;0;0;0;0
FR;5;2021-04-18;0;0;0;0;0;0;0;0;0;0
FR;5;2021-04-19;0;0;0;0;0;0;0;0;0;0
FR;5;2021-04-20;0;0;0;0;0;0;0;0;0;0
FR;5;2021-04-21;0;0;0;0;0;0;0;0;0;0
FR;5;2021-04-22;0;0;0;0;0;0;0;0;0;0
FR;5;2021-04-23;0;0;0;0;0;0;0;0;0;0
FR;5;2021-04-24;0;0;0;0;0;0;0;0;0;0
FR;5;2021-04-25;0;0;0;0;0;0;0;0;0;0
FR;5;2021-04-26;0;0;0;0;0;0;0;0;0;0
FR;5;2021-04-27;0;0;0;0;0;0;0;0;0;0
FR;5;2021-04-28;0;0;0;0;0;0;0;0;0;0
FR;5;2021-04-29;0;0;0;0;0;0;0;0;0;0
FR;5;2021-04-30;0;0;0;0;0;0;0;0;0;0
FR;5;2021-05-01;0;0;0;0;0;0;0;0;0;0
FR;5;2021-05-02;0;0;0;0;0;0;0;0;0;0
FR;5;2021-05-03;0;0;0;0;0;0;0;0;0;0
FR;5;2021-05-04;0;0;0;0;0;0;0;0;0;0
FR;5;2021-05-05;0;0;0;0;0;0;0;0;0;0
FR;5;2021-05-06;0;0;0;0;0;0;0;0;0;0
FR;5;2021-05-07;0;0;0;0;0;0;0;0;0;0
FR;5;2021-05-08;0;0;0;0;0;0;0;0;0;0
FR;5;2021-05-09;0;0;0;0;0;0;0;0;0;0
FR;5;2021-05-10;0;0;0;0;0;0;0;0;0;0
FR;5;2021-05-11;0;0;0;0;0;0;0;0;0;0
FR;5;2021-05-12;0;0;0;0;0;0;0;0;0;0
FR;5;2021-05-13;0;0;0;0;0;0;0;0;0;0
FR;5;2021-05-14;0;0;0;0;0;0;0;0;0;0
FR;5;2021-05-15;0;0;0;0;0;0;0;0;0;0
FR;5;2021-05-16;0;0;0;0;0;0;0;0;0;0
FR;5;2021-05-17;0;0;0;0;0;0;0;0;0;0
FR;5;2021-05-18;0;0;0;0;0;0;0;0;0;0
FR;5;2021-05-19;0;0;0;0;0;0;0;0;0;0
FR;5;2021-05-20;0;0;0;0;0;0;0;0;0;0
FR;5;2021-05-21;0;0;0;0;0;0;0;0;0;0
FR;5;2021-05-22;0;0;0;0;0;0;0;0;0;0
FR;5;2021-05-23;0;0;0;0;0;0;0;0;0;0
FR;5;2021-05-24;0;0;0;0;0;0;0;0;0;0
FR;5;2021-05-25;0;0;0;0;0;0;0;0;0;0
FR;5;2021-05-26;0;0;0;0;0;0;0;0;0;0
FR;5;2021-05-27;0;0;0;0;0;0;0;0;0;0
FR;5;2021-05-28;0;0;0;0;0;0;0;0;0;0
FR;5;2021-05-29;0;0;0;0;0;0;0;0;0;0
FR;5;2021-05-30;0;0;0;0;0;0;0;0;0;0
FR;5;2021-05-31;0;0;0;0;0;0;0;0;0;0
FR;5;2021-06-01;0;0;0;0;0;0;0;0;0;0
FR;5;2021-06-02;0;0;0;0;0;0;0;0;0;0
FR;5;2021-06-03;0;0;0;0;0;0;0;0;0;0
FR;5;2021-06-04;0;0;0;0;0;0;0;0;0;0
FR;5;2021-06-05;0;0;0;0;0;0;0;0;0;0
FR;5;2021-06-06;0;0;0;0;0;0;0;0;0;0
FR;5;2021-06-07;0;0;0;0;0;0;0;0;0;0
FR;5;2021-06-08;0;0;0;0;0;0;0;0;0;0
FR;5;2021-06-09;0;0;0;0;0;0;0;0;0;0
FR;5;2021-06-10;0;0;0;0;0;0;0;0;0;0
FR;5;2021-06-11;0;0;0;0;0;0;0;0;0;0
FR;5;2021-06-12;0;0;0;0;0;0;0;0;0;0
FR;5;2021-06-13;0;0;0;0;0;0;0;0;0;0
FR;5;2021-06-14;0;0;0;0;0;0;0;0;0;0
FR;5;2021-06-15;0;0;0;0;0;0;0;0;0;0
FR;5;2021-06-16;0;0;0;0;0;0;0;0;0;0
FR;5;2021-06-17;0;0;0;0;0;0;0;0;0;0
FR;5;2021-06-18;0;0;0;0;0;0;0;0;0;0
FR;5;2021-06-19;0;0;0;0;0;0;0;0;0;0
FR;5;2021-06-20;0;0;0;0;0;0;0;0;0;0
FR;5;2021-06-21;0;0;0;0;0;0;0;0;0;0
FR;5;2021-06-22;0;0;0;0;0;0;0;0;0;0
FR;5;2021-06-23;0;0;0;0;0;0;0;0;0;0
FR;5;2021-06-24;0;0;0;0;0;0;0;0;0;0
FR;5;2021-06-25;0;0;0;0;0;0;0;0;0;0
FR;5;2021-06-26;0;0;0;0;0;0;0;0;0;0
FR;5;2021-06-27;0;0;0;0;0;0;0;0;0;0
FR;5;2021-06-28;0;0;0;0;0;0;0;0;0;0
FR;5;2021-06-29;0;0;0;0;0;0;0;0;0;0
FR;5;2021-06-30;0;0;0;0;0;0;0;0;0;0
FR;5;2021-07-01;0;0;0;0;0;0;0;0;0;0
FR;5;2021-07-02;0;0;0;0;0;0;0;0;0;0
FR;5;2021-07-03;0;0;0;0;0;0;0;0;0;0
FR;5;2021-07-04;0;0;0;0;0;0;0;0;0;0
FR;5;2021-07-05;0;0;0;0;0;0;0;0;0;0
FR;5;2021-07-06;0;0;0;0;0;0;0;0;0;0
FR;5;2021-07-07;0;0;0;0;0;0;0;0;0;0
FR;5;2021-07-08;0;0;0;0;0;0;0;0;0;0
FR;5;2021-07-09;0;0;0;0;0;0;0;0;0;0
FR;5;2021-07-10;0;0;0;0;0;0;0;0;0;0
FR;5;2021-07-11;0;0;0;0;0;0;0;0;0;0
FR;5;2021-07-12;0;0;0;0;0;0;0;0;0;0
FR;5;2021-07-13;0;0;0;0;0;0;0;0;0;0
FR;5;2021-07-14;0;0;0;0;0;0;0;0;0;0
FR;5;2021-07-15;0;0;0;0;0;0;0;0;0;0
FR;5;2021-07-16;0;0;0;0;0;0;0;0;0;0
FR;5;2021-07-17;0;0;0;0;0;0;0;0;0;0
FR;5;2021-07-18;0;0;0;0;0;0;0;0;0;0
FR;5;2021-07-19;0;0;0;0;0;0;0;0;0;0
FR;5;2021-07-20;0;0;0;0;0;0;0;0;0;0
FR;5;2021-07-21;0;0;0;0;0;0;0;0;0;0
FR;5;2021-07-22;0;0;0;0;0;0;0;0;0;0
FR;5;2021-07-23;0;0;0;0;0;0;0;0;0;0
FR;5;2021-07-24;0;0;0;0;0;0;0;0;0;0
FR;5;2021-07-25;0;0;0;0;0;0;0;0;0;0
FR;5;2021-07-26;0;0;0;0;0;0;0;0;0;0
FR;5;2021-07-27;0;0;0;0;0;0;0;0;0;0
FR;5;2021-07-28;0;0;0;0;0;0;0;0;0;0
FR;5;2021-07-29;0;0;0;0;0;0;0;0;0;0
FR;5;2021-07-30;0;0;0;0;0;0;0;0;0;0
FR;5;2021-07-31;0;0;0;0;0;0;0;0;0;0
FR;5;2021-08-01;0;0;0;0;0;0;0;0;0;0
FR;5;2021-08-02;0;0;0;0;0;0;0;0;0;0
FR;5;2021-08-03;0;0;0;0;0;0;0;0;0;0
FR;5;2021-08-04;0;0;0;0;0;0;0;0;0;0
FR;5;2021-08-05;0;0;0;0;0;0;0;0;0;0
FR;5;2021-08-06;0;0;0;0;0;0;0;0;0;0
FR;5;2021-08-07;0;0;0;0;0;0;0;0;0;0
FR;5;2021-08-08;0;0;0;0;0;0;0;0;0;0
FR;5;2021-08-09;0;0;0;0;0;0;0;0;0;0
FR;5;2021-08-10;0;0;0;0;0;0;0;0;0;0
FR;5;2021-08-11;0;0;0;0;0;0;0;0;0;0
FR;5;2021-08-12;0;0;0;0;0;0;0;0;0;0
FR;5;2021-08-13;0;0;0;0;0;0;0;0;0;0
FR;5;2021-08-14;0;0;0;0;0;0;0;0;0;0
FR;5;2021-08-15;0;0;0;0;0;0;0;0;0;0
FR;5;2021-08-16;0;0;0;0;0;0;0;0;0;0
FR;5;2021-08-17;0;0;0;0;0;0;0;0;0;0
FR;5;2021-08-18;0;0;0;0;0;0;0;0;0;0
FR;5;2021-08-19;0;0;0;0;0;0;0;0;0;0
FR;5;2021-08-20;0;0;0;0;0;0;0;0;0;0
FR;5;2021-08-21;0;0;0;0;0;0;0;0;0;0
FR;5;2021-08-22;0;0;0;0;0;0;0;0;0;0
FR;5;2021-08-23;0;0;0;0;0;0;0;0;0;0
FR;5;2021-08-24;0;0;0;0;0;0;0;0;0;0
FR;5;2021-08-25;0;0;0;0;0;0;0;0;0;0
FR;5;2021-08-26;0;0;0;0;0;0;0;0;0;0
FR;5;2021-08-27;0;0;0;0;0;0;0;0;0;0
FR;5;2021-08-28;0;0;0;0;0;0;0;0;0;0
FR;5;2021-08-29;0;0;0;0;0;0;0;0;0;0
FR;5;2021-08-30;0;0;0;0;0;0;0;0;0;0
FR;5;2021-08-31;0;0;0;0;0;0;0;0;0;0
FR;5;2021-09-01;0;0;0;0;0;0;0;0;0;0
FR;5;2021-09-02;0;0;0;0;0;0;0;0;0;0
FR;5;2021-09-03;0;0;0;0;0;0;0;0;0;0
FR;5;2021-09-04;0;0;0;0;0;0;0;0;0;0
FR;5;2021-09-05;0;0;0;0;0;0;0;0;0;0
FR;5;2021-09-06;0;0;0;0;0;0;0;0;0;0
FR;5;2021-09-07;0;0;0;0;0;0;0;0;0;0
FR;5;2021-09-08;0;0;0;0;0;0;0;0;0;0
FR;5;2021-09-09;0;0;0;0;0;0;0;0;0;0
FR;5;2021-09-10;0;0;0;0;0;0;0;0;0;0
FR;5;2021-09-11;0;0;0;0;0;0;0;0;0;0
FR;5;2021-09-12;0;0;0;0;0;0;0;0;0;0
FR;5;2021-09-13;0;0;0;0;0;0;0;0;0;0
FR;5;2021-09-14;0;0;0;0;0;0;0;0;0;0
FR;5;2021-09-15;0;0;0;0;0;0;0;0;0;0
FR;5;2021-09-16;0;0;0;0;0;0;0;0;0;0
FR;5;2021-09-17;0;0;0;0;0;0;0;0;0;0
FR;5;2021-09-18;0;0;0;0;0;0;0;0;0;0
FR;5;2021-09-19;0;0;0;0;0;0;0;0;0;0
FR;5;2021-09-20;0;0;0;0;0;0;0;0;0;0
FR;5;2021-09-21;0;0;0;0;0;0;0;0;0;0
FR;5;2021-09-22;0;0;0;0;0;0;0;0;0;0
FR;5;2021-09-23;0;0;0;0;0;0;0;0;0;0
FR;5;2021-09-24;0;0;0;0;0;0;0;0;0;0
FR;5;2021-09-25;0;0;0;0;0;0;0;0;0;0
FR;5;2021-09-26;0;0;0;0;0;0;0;0;0;0
FR;5;2021-09-27;0;0;0;0;0;0;0;0;0;0
FR;5;2021-09-28;0;0;0;0;0;0;0;0;0;0
FR;5;2021-09-29;0;0;0;0;0;0;0;0;0;0
FR;5;2021-09-30;0;0;0;0;0;0;0;0;0;0
FR;5;2021-10-01;0;0;0;0;0;0;0;0;0;0
FR;5;2021-10-02;0;0;0;0;0;0;0;0;0;0
FR;5;2021-10-03;0;0;0;0;0;0;0;0;0;0
FR;5;2021-10-04;0;0;0;0;0;0;0;0;0;0
FR;5;2021-10-05;0;0;0;0;0;0;0;0;0;0
FR;5;2021-10-06;0;0;0;0;0;0;0;0;0;0
FR;5;2021-10-07;0;0;0;0;0;0;0;0;0;0
FR;5;2021-10-08;0;0;0;0;0;0;0;0;0;0
FR;5;2021-10-09;0;0;0;0;0;0;0;0;0;0
FR;5;2021-10-10;0;0;0;0;0;0;0;0;0;0
FR;5;2021-10-11;0;0;0;0;0;0;0;0;0;0
FR;5;2021-10-12;0;0;0;0;0;0;0;0;0;0
FR;5;2021-10-13;0;0;0;0;0;0;0;0;0;0
FR;5;2021-10-14;0;0;0;0;0;0;0;0;0;0
FR;5;2021-10-15;0;0;0;0;0;0;0;0;0;0
FR;5;2021-10-16;0;0;0;0;0;0;0;0;0;0
FR;5;2021-10-17;0;0;0;0;0;0;0;0;0;0
FR;5;2021-10-18;0;0;0;0;0;0;0;0;0;0
FR;5;2021-10-19;0;0;0;0;0;0;0;0;0;0
FR;5;2021-10-20;0;0;0;0;0;0;0;0;0;0
FR;5;2021-10-21;0;0;0;0;0;0;0;0;0;0
FR;5;2021-10-22;0;0;0;0;0;0;0;0;0;0
FR;5;2021-10-23;0;0;0;0;0;0;0;0;0;0
FR;5;2021-10-24;0;0;0;0;0;0;0;0;0;0
FR;5;2021-10-25;0;0;0;0;0;0;0;0;0;0
FR;5;2021-10-26;0;0;0;0;0;0;0;0;0;0
FR;5;2021-10-27;0;0;0;0;0;0;0;0;0;0
FR;5;2021-10-28;0;0;0;0;0;0;0;0;0;0
FR;5;2021-10-29;0;0;0;0;0;0;0;0;0;0
FR;5;2021-10-30;0;0;0;0;0;0;0;0;0;0
FR;5;2021-10-31;0;0;0;0;0;0;0;0;0;0
FR;5;2021-11-01;0;0;0;0;0;0;0;0;0;0
FR;5;2021-11-02;0;0;0;0;0;0;0;0;0;0
FR;5;2021-11-03;0;0;0;0;0;0;0;0;0;0
FR;5;2021-11-04;0;0;0;0;0;0;0;0;0;0
FR;5;2021-11-05;0;0;0;0;0;0;0;0;0;0
FR;5;2021-11-06;0;0;0;0;0;0;0;0;0;0
FR;5;2021-11-07;0;0;0;0;0;0;0;0;0;0
FR;5;2021-11-08;0;0;0;0;0;0;0;0;0;0
FR;5;2021-11-09;0;0;0;0;0;0;0;0;0;0
FR;5;2021-11-10;0;0;0;0;0;0;0;0;0;0
FR;5;2021-11-11;0;0;0;0;0;0;0;0;0;0
FR;5;2021-11-12;0;0;0;0;0;0;0;0;0;0
FR;5;2021-11-13;0;0;0;0;0;0;0;0;0;0
FR;5;2021-11-14;0;0;0;0;0;0;0;0;0;0
FR;5;2021-11-15;0;0;0;0;0;0;0;0;0;0
FR;5;2021-11-16;0;0;0;0;0;0;0;0;0;0
FR;5;2021-11-17;0;0;0;0;0;0;0;0;0;0
FR;5;2021-11-18;0;0;0;0;0;0;0;0;0;0
FR;5;2021-11-19;0;0;0;0;0;0;0;0;0;0
FR;5;2021-11-20;0;0;0;0;0;0;0;0;0;0
FR;5;2021-11-21;0;0;0;0;0;0;0;0;0;0
FR;5;2021-11-22;0;0;0;0;0;0;0;0;0;0
FR;5;2021-11-23;0;0;0;0;0;0;0;0;0;0
FR;5;2021-11-24;0;0;0;0;0;0;0;0;0;0
FR;5;2021-11-25;0;0;0;0;0;0;0;0;0;0
FR;5;2021-11-26;0;0;0;0;0;0;0;0;0;0
FR;5;2021-11-27;0;0;0;0;0;0;0;0;0;0
FR;5;2021-11-28;0;0;0;0;0;0;0;0;0;0
FR;5;2021-11-29;0;0;0;0;0;0;0;0;0;0
FR;5;2021-11-30;0;0;0;0;0;0;0;0;0;0
FR;5;2021-12-01;0;0;0;0;0;0;0;0;0;0
FR;5;2021-12-02;0;0;0;0;0;0;0;0;0;0
FR;5;2021-12-03;0;0;0;0;0;0;0;0;0;0
FR;5;2021-12-04;0;0;0;0;0;0;0;0;0;0
FR;5;2021-12-05;0;0;0;0;0;0;0;0;0;0
FR;5;2021-12-06;0;0;0;0;0;0;0;0;0;0
FR;5;2021-12-07;0;0;0;0;0;0;0;0;0;0
FR;5;2021-12-08;0;0;0;0;0;0;0;0;0;0
FR;5;2021-12-09;0;0;0;0;0;0;0;0;0;0
FR;5;2021-12-10;0;0;0;0;0;0;0;0;0;0
FR;5;2021-12-11;0;0;0;0;0;0;0;0;0;0
FR;5;2021-12-12;0;0;0;0;0;0;0;0;0;0
FR;5;2021-12-13;0;0;0;0;0;0;0;0;0;0
FR;5;2021-12-14;29;45;77;0;88;29;45;77;0;88
FR;5;2021-12-15;196;44;37;0;49;225;89;114;0;137
FR;5;2021-12-16;180;21;44;0;48;405;110;158;0;185
FR;5;2021-12-17;310;16;72;0;74;715;126;230;0;259
FR;5;2021-12-18;765;24;22;0;29;1480;150;252;0;288
FR;5;2021-12-19;586;15;15;0;17;2066;165;267;0;305
FR;5;2021-12-20;1223;31;35;0;38;3289;196;302;0;343
FR;5;2021-12-21;1535;22;54;1;60;4824;218;356;1;403
FR;5;2021-12-22;4069;40;37;0;46;8893;258;393;1;449
FR;5;2021-12-23;3042;16;21;0;25;11935;274;414;1;474
FR;5;2021-12-24;759;18;9;0;15;12694;292;423;1;489
FR;5;2021-12-25;61;5;1;0;2;12755;297;424;1;491
FR;5;2021-12-26;623;6;3;0;4;13378;303;427;1;495
FR;5;2021-12-27;4080;25;21;0;23;17458;328;448;1;518
FR;5;2021-12-28;5202;23;41;1;43;22660;351;489;2;561
FR;5;2021-12-29;8104;34;66;2;69;30764;385;555;4;630
FR;5;2021-12-30;5173;18;33;0;39;35937;403;588;4;669
FR;5;2021-12-31;1553;8;10;0;11;37490;411;598;4;680
FR;5;2022-01-01;185;2;2;0;3;37675;413;600;4;683
FR;5;2022-01-02;1489;1;1;0;1;39164;414;601;4;684
FR;5;2022-01-03;3059;36;33;0;32;42223;450;634;4;716
FR;5;2022-01-04;3034;39;33;0;42;45257;489;667;4;758
FR;5;2022-01-05;19323;203;97;1;108;64580;692;764;5;866
FR;5;2022-01-06;3742;133;122;0;142;68322;825;886;5;1008
FR;5;2022-01-07;5007;200;48;2;56;73329;1025;934;7;1064
FR;5;2022-01-08;13654;514;45;0;52;86983;1539;979;7;1116
FR;5;2022-01-09;5755;399;15;0;20;92738;1938;994;7;1136
FR;5;2022-01-10;3453;326;25;0;29;96191;2264;1019;7;1165
FR;5;2022-01-11;3668;284;38;0;41;99859;2548;1057;7;1206
FR;5;2022-01-12;22653;3003;90;0;113;122512;5551;1147;7;1319
FR;5;2022-01-13;4035;622;30;0;32;126547;6173;1177;7;1351
FR;5;2022-01-14;4843;581;44;0;51;131390;6754;1221;7;1402
FR;5;2022-01-15;14681;1746;38;3;49;146071;8500;1259;10;1451
FR;5;2022-01-16;4727;666;3;0;5;150798;9166;1262;10;1456
FR;5;2022-01-17;2294;715;26;0;29;153092;9881;1288;10;1485
FR;5;2022-01-18;2430;870;30;0;40;155522;10751;1318;10;1525
FR;5;2022-01-19;18481;6422;74;2;142;174003;17173;1392;12;1667
FR;5;2022-01-20;1920;1067;25;0;34;175923;18240;1417;12;1701
FR;5;2022-01-21;3076;1371;47;1;59;178999;19611;1464;13;1760
FR;5;2022-01-22;10721;3454;33;1;43;189720;23065;1497;14;1803
FR;5;2022-01-23;2629;1415;5;0;9;192349;24480;1502;14;1812
FR;5;2022-01-24;1159;1340;19;0;23;193508;25820;1521;14;1835
FR;5;2022-01-25;1219;1548;19;2;29;194727;27368;1540;16;1864
FR;5;2022-01-26;10751;12025;50;1;89;205478;39393;1590;17;1953
FR;5;2022-01-27;1291;1693;10;0;17;206769;41086;1600;17;1970
FR;5;2022-01-28;1695;3347;16;0;19;208464;44433;1616;17;1989
FR;5;2022-01-29;6237;8040;68;0;96;214701;52473;1684;17;2085
FR;5;2022-01-30;1509;2950;5;0;18;216210;55423;1689;17;2103
FR;5;2022-01-31;588;1773;23;0;24;216798;57196;1712;17;2127
FR;5;2022-02-01;712;1703;10;0;15;217510;58899;1722;17;2142
FR;5;2022-02-02;6957;15654;52;0;94;224467;74553;1774;17;2236
FR;5;2022-02-03;490;1690;14;0;13;224957;76243;1788;17;2249
FR;5;2022-02-04;943;3001;19;0;31;225900;79244;1807;17;2280
FR;5;2022-02-05;3533;8916;23;0;37;229433;88160;1830;17;2317
FR;5;2022-02-06;737;2397;10;0;19;230170;90557;1840;17;2336
FR;5;2022-02-07;883;1595;22;0;24;231053;92152;1862;17;2360
FR;5;2022-02-08;722;1285;18;0;20;231775;93437;1880;17;2380
FR;5;2022-02-09;4536;12876;44;0;76;236311;106313;1924;17;2456
FR;5;2022-02-10;646;1059;14;0;15;236957;107372;1938;17;2471
FR;5;2022-02-11;793;2026;16;0;21;237750;109398;1954;17;2492
FR;5;2022-02-12;2285;6811;33;0;53;240035;116209;1987;17;2545
FR;5;2022-02-13;465;1540;8;0;8;240500;117749;1995;17;2553
FR;5;2022-02-14;678;1288;10;0;13;241178;119037;2005;17;2566
FR;5;2022-02-15;482;885;9;0;14;241660;119922;2014;17;2580
FR;5;2022-02-16;2980;9123;41;1;58;244640;129045;2055;18;2638
FR;5;2022-02-17;435;805;6;0;7;245075;129850;2061;18;2645
FR;5;2022-02-18;650;1407;13;0;17;245725;131257;2074;18;2662
FR;5;2022-02-19;1371;4315;16;0;28;247096;135572;2090;18;2690
FR;5;2022-02-20;247;879;6;0;8;247343;136451;2096;18;2698
FR;5;2022-02-21;221;607;2;0;4;247564;137058;2098;18;2702
FR;5;2022-02-22;259;545;17;0;17;247823;137603;2115;18;2719
FR;5;2022-02-23;1908;6924;22;1;42;249731;144527;2137;19;2761
FR;5;2022-02-24;182;374;5;1;6;249913;144901;2142;20;2767
FR;5;2022-02-25;336;949;13;0;12;250249;145850;2155;20;2779
FR;5;2022-02-26;972;3069;10;0;14;251221;148919;2165;20;2793
FR;5;2022-02-27;147;506;0;0;3;251368;149425;2165;20;2796
FR;5;2022-02-28;161;369;1;0;1;251529;149794;2166;20;2797
FR;5;2022-03-01;128;279;6;0;7;251657;150073;2172;20;2804
FR;5;2022-03-02;1240;4150;28;3;40;252897;154223;2200;23;2844
FR;5;2022-03-03;121;250;6;0;9;253018;154473;2206;23;2853
FR;5;2022-03-04;193;488;13;0;14;253211;154961;2219;23;2867
FR;5;2022-03-05;676;1990;8;0;16;253887;156951;2227;23;2883
FR;5;2022-03-06;108;260;0;0;0;253995;157211;2227;23;2883
FR;5;2022-03-07;71;228;5;0;3;254066;157439;2232;23;2886
FR;5;2022-03-08;46;130;7;1;7;254112;157569;2239;24;2893
FR;5;2022-03-09;909;3076;24;0;36;255021;160645;2263;24;2929
FR;5;2022-03-10;82;200;8;0;11;255103;160845;2271;24;2940
FR;5;2022-03-11;147;369;13;1;15;255250;161214;2284;25;2955
FR;5;2022-03-12;758;1613;13;1;30;256008;162827;2297;26;2985
FR;5;2022-03-13;76;100;0;0;0;256084;162927;2297;26;2985
FR;5;2022-03-14;67;118;7;1;7;256151;163045;2304;27;2992
FR;5;2022-03-15;83;99;3;0;6;256234;163144;2307;27;2998
FR;5;2022-03-16;883;1825;15;3;36;257117;164969;2322;30;3034
FR;5;2022-03-17;66;123;8;4;10;257183;165092;2330;34;3044
FR;5;2022-03-18;172;318;13;4;18;257355;165410;2343;38;3062
FR;5;2022-03-19;750;1162;12;5;33;258105;166572;2355;43;3095
FR;5;2022-03-20;45;93;1;0;1;258150;166665;2356;43;3096
FR;5;2022-03-21;71;120;10;6;15;258221;166785;2366;49;3111
FR;5;2022-03-22;56;119;8;8;9;258277;166904;2374;57;3120
FR;5;2022-03-23;804;1461;14;8;36;259081;168365;2388;65;3156
FR;5;2022-03-24;68;93;8;7;7;259149;168458;2396;72;3163
FR;5;2022-03-25;222;290;14;8;18;259371;168748;2410;80;3181
FR;5;2022-03-26;707;853;12;5;26;260078;169601;2422;85;3207
FR;5;2022-03-27;74;78;0;0;3;260152;169679;2422;85;3210
FR;5;2022-03-28;81;91;1;2;3;260233;169770;2423;87;3213
FR;5;2022-03-29;71;82;10;4;12;260304;169852;2433;91;3225
FR;5;2022-03-30;822;1115;16;13;29;261126;170967;2449;104;3254
FR;5;2022-03-31;102;124;1;4;6;261228;171091;2450;108;3260
FR;5;2022-04-01;107;86;7;12;11;261335;171177;2457;120;3271
FR;5;2022-04-02;329;349;3;3;15;261664;171526;2460;123;3286
FR;5;2022-04-03;54;59;1;0;1;261718;171585;2461;123;3287
FR;5;2022-04-04;38;57;4;1;8;261756;171642;2465;124;3295
FR;5;2022-04-05;51;60;6;7;9;261807;171702;2471;131;3304
FR;5;2022-04-06;421;439;7;15;16;262228;172141;2478;146;3320
FR;5;2022-04-07;45;68;5;7;7;262273;172209;2483;153;3327
FR;5;2022-04-08;133;110;12;14;15;262406;172319;2495;167;3342
FR;5;2022-04-09;308;323;2;5;17;262714;172642;2497;172;3359
FR;5;2022-04-10;43;31;2;0;2;262757;172673;2499;172;3361
FR;5;2022-04-11;50;60;3;2;4;262807;172733;2502;174;3365
FR;5;2022-04-12;57;54;3;3;5;262864;172787;2505;177;3370
FR;5;2022-04-13;382;413;3;8;16;263246;173200;2508;185;3386
FR;5;2022-04-14;47;48;5;5;9;263293;173248;2513;190;3395
FR;5;2022-04-15;91;109;3;5;5;263384;173357;2516;195;3400
FR;5;2022-04-16;188;184;2;1;13;263572;173541;2518;196;3413
FR;5;2022-04-17;12;10;1;0;1;263584;173551;2519;196;3414
FR;5;2022-04-18;8;9;2;0;2;263592;173560;2521;196;3416
FR;5;2022-04-19;73;70;6;1;6;263665;173630;2527;197;3422
FR;5;2022-04-20;360;349;9;6;12;264025;173979;2536;203;3434
FR;5;2022-04-21;42;64;9;10;12;264067;174043;2545;213;3446
FR;5;2022-04-22;113;96;5;4;5;264180;174139;2550;217;3451
FR;5;2022-04-23;209;192;3;2;10;264389;174331;2553;219;3461
FR;5;2022-04-24;37;35;0;0;3;264426;174366;2553;219;3464
FR;5;2022-04-25;67;65;1;1;4;264493;174431;2554;220;3468
FR;5;2022-04-26;60;61;2;1;5;264553;174492;2556;221;3473
FR;5;2022-04-27;335;316;2;7;14;264888;174808;2558;228;3487
FR;5;2022-04-28;75;54;4;5;8;264963;174862;2562;233;3495
FR;5;2022-04-29;117;82;5;18;12;265080;174944;2567;251;3507
FR;5;2022-04-30;182;115;2;3;10;265262;175059;2569;254;3517
FR;5;2022-05-01;11;7;0;0;0;265273;175066;2569;254;3517
FR;5;2022-05-02;49;27;4;5;2;265322;175093;2573;259;3519
FR;5;2022-05-03;83;55;2;5;11;265405;175148;2575;264;3530
FR;5;2022-05-04;277;204;1;2;7;265682;175352;2576;266;3537
FR;5;2022-05-05;62;32;2;4;4;265744;175384;2578;270;3541
FR;5;2022-05-06;104;64;2;3;5;265848;175448;2580;273;3546
FR;5;2022-05-07;170;115;3;10;13;266018;175563;2583;283;3559
FR;5;2022-05-08;8;8;0;0;2;266026;175571;2583;283;3561
FR;5;2022-05-09;44;32;15;3;16;266070;175603;2598;286;3577
FR;5;2022-05-10;54;49;3;4;5;266124;175652;2601;290;3582
FR;5;2022-05-11;324;236;12;7;21;266448;175888;2613;297;3603
FR;5;2022-05-12;46;34;1;3;2;266494;175922;2614;300;3605
FR;5;2022-05-13;108;83;3;8;9;266602;176005;2617;308;3614
FR;5;2022-05-14;206;131;0;1;8;266808;176136;2617;309;3622
FR;5;2022-05-15;22;7;2;0;1;266830;176143;2619;309;3623
FR;5;2022-05-16;52;33;4;5;4;266882;176176;2623;314;3627
FR;5;2022-05-17;72;40;5;0;2;266954;176216;2628;314;3629
FR;5;2022-05-18;288;214;4;4;8;267242;176430;2632;318;3637
FR;5;2022-05-19;44;35;4;3;2;267286;176465;2636;321;3639
FR;5;2022-05-20;74;62;2;5;1;267360;176527;2638;326;3640
FR;5;2022-05-21;241;166;2;3;17;267601;176693;2640;329;3657
FR;5;2022-05-22;20;14;2;5;2;267621;176707;2642;334;3659
FR;5;2022-05-23;42;24;4;3;6;267663;176731;2646;337;3665
FR;5;2022-05-24;45;45;3;2;5;267708;176776;2649;339;3670
FR;5;2022-05-25;326;253;4;1;15;268034;177029;2653;340;3685
FR;5;2022-05-26;14;5;0;1;2;268048;177034;2653;341;3687
FR;5;2022-05-27;97;54;4;4;9;268145;177088;2657;345;3696
FR;5;2022-05-28;95;75;5;3;10;268240;177163;2662;348;3706
FR;5;2022-05-29;14;14;1;0;2;268254;177177;2663;348;3708
FR;5;2022-05-30;55;39;2;1;2;268309;177216;2665;349;3710
FR;5;2022-05-31;55;42;1;8;1;268364;177258;2666;357;3711
FR;5;2022-06-01;247;236;8;2;22;268611;177494;2674;359;3733
FR;5;2022-06-02;55;60;4;0;7;268666;177554;2678;359;3740
FR;5;2022-06-03;78;69;3;5;8;268744;177623;2681;364;3748
FR;5;2022-06-04;155;106;2;1;9;268899;177729;2683;365;3757
FR;5;2022-06-05;16;10;0;0;1;268915;177739;2683;365;3758
FR;5;2022-06-06;13;9;0;0;0;268928;177748;2683;365;3758
FR;5;2022-06-07;48;55;0;1;1;268976;177803;2683;366;3759
FR;5;2022-06-08;277;221;2;4;16;269253;178024;2685;370;3775
FR;5;2022-06-09;47;35;5;3;5;269300;178059;2690;373;3780
FR;6;2020-12-27;0;0;0;0;0;0;0;0;0;0
FR;6;2020-12-28;0;0;0;0;0;0;0;0;0;0
FR;6;2020-12-29;0;0;0;0;0;0;0;0;0;0
FR;6;2020-12-30;0;0;0;0;0;0;0;0;0;0
FR;6;2020-12-31;0;0;0;0;0;0;0;0;0;0
FR;6;2021-01-01;0;0;0;0;0;0;0;0;0;0
FR;6;2021-01-02;0;0;0;0;0;0;0;0;0;0
FR;6;2021-01-03;0;0;0;0;0;0;0;0;0;0
FR;6;2021-01-04;0;0;0;0;0;0;0;0;0;0
FR;6;2021-01-05;0;0;0;0;0;0;0;0;0;0
FR;6;2021-01-06;0;0;0;0;0;0;0;0;0;0
FR;6;2021-01-07;0;0;0;0;0;0;0;0;0;0
FR;6;2021-01-08;0;0;0;0;0;0;0;0;0;0
FR;6;2021-01-09;0;0;0;0;0;0;0;0;0;0
FR;6;2021-01-10;0;0;0;0;0;0;0;0;0;0
FR;6;2021-01-11;0;0;0;0;0;0;0;0;0;0
FR;6;2021-01-12;0;0;0;0;0;0;0;0;0;0
FR;6;2021-01-13;0;0;0;0;0;0;0;0;0;0
FR;6;2021-01-14;0;0;0;0;0;0;0;0;0;0
FR;6;2021-01-15;0;0;0;0;0;0;0;0;0;0
FR;6;2021-01-16;0;0;0;0;0;0;0;0;0;0
FR;6;2021-01-17;0;0;0;0;0;0;0;0;0;0
FR;6;2021-01-18;0;0;0;0;0;0;0;0;0;0
FR;6;2021-01-19;0;0;0;0;0;0;0;0;0;0
FR;6;2021-01-20;0;0;0;0;0;0;0;0;0;0
FR;6;2021-01-21;0;0;0;0;0;0;0;0;0;0
FR;6;2021-01-22;0;0;0;0;0;0;0;0;0;0
FR;6;2021-01-23;0;0;0;0;0;0;0;0;0;0
FR;6;2021-01-24;0;0;0;0;0;0;0;0;0;0
FR;6;2021-01-25;0;0;0;0;0;0;0;0;0;0
FR;6;2021-01-26;0;0;0;0;0;0;0;0;0;0
FR;6;2021-01-27;0;0;0;0;0;0;0;0;0;0
FR;6;2021-01-28;0;0;0;0;0;0;0;0;0;0
FR;6;2021-01-29;0;0;0;0;0;0;0;0;0;0
FR;6;2021-01-30;0;0;0;0;0;0;0;0;0;0
FR;6;2021-01-31;0;0;0;0;0;0;0;0;0;0
FR;6;2021-02-01;0;0;0;0;0;0;0;0;0;0
FR;6;2021-02-02;0;0;0;0;0;0;0;0;0;0
FR;6;2021-02-03;0;0;0;0;0;0;0;0;0;0
FR;6;2021-02-04;0;0;0;0;0;0;0;0;0;0
FR;6;2021-02-05;0;0;0;0;0;0;0;0;0;0
FR;6;2021-02-06;0;0;0;0;0;0;0;0;0;0
FR;6;2021-02-07;0;0;0;0;0;0;0;0;0;0
FR;6;2021-02-08;0;0;0;0;0;0;0;0;0;0
FR;6;2021-02-09;0;0;0;0;0;0;0;0;0;0
FR;6;2021-02-10;0;0;0;0;0;0;0;0;0;0
FR;6;2021-02-11;0;0;0;0;0;0;0;0;0;0
FR;6;2021-02-12;0;0;0;0;0;0;0;0;0;0
FR;6;2021-02-13;0;0;0;0;0;0;0;0;0;0
FR;6;2021-02-14;0;0;0;0;0;0;0;0;0;0
FR;6;2021-02-15;0;0;0;0;0;0;0;0;0;0
FR;6;2021-02-16;0;0;0;0;0;0;0;0;0;0
FR;6;2021-02-17;0;0;0;0;0;0;0;0;0;0
FR;6;2021-02-18;0;0;0;0;0;0;0;0;0;0
FR;6;2021-02-19;0;0;0;0;0;0;0;0;0;0
FR;6;2021-02-20;0;0;0;0;0;0;0;0;0;0
FR;6;2021-02-21;0;0;0;0;0;0;0;0;0;0
FR;6;2021-02-22;0;0;0;0;0;0;0;0;0;0
FR;6;2021-02-23;0;0;0;0;0;0;0;0;0;0
FR;6;2021-02-24;0;0;0;0;0;0;0;0;0;0
FR;6;2021-02-25;0;0;0;0;0;0;0;0;0;0
FR;6;2021-02-26;0;0;0;0;0;0;0;0;0;0
FR;6;2021-02-27;0;0;0;0;0;0;0;0;0;0
FR;6;2021-02-28;0;0;0;0;0;0;0;0;0;0
FR;6;2021-03-01;0;0;0;0;0;0;0;0;0;0
FR;6;2021-03-02;0;0;0;0;0;0;0;0;0;0
FR;6;2021-03-03;0;0;0;0;0;0;0;0;0;0
FR;6;2021-03-04;0;0;0;0;0;0;0;0;0;0
FR;6;2021-03-05;0;0;0;0;0;0;0;0;0;0
FR;6;2021-03-06;0;0;0;0;0;0;0;0;0;0
FR;6;2021-03-07;0;0;0;0;0;0;0;0;0;0
FR;6;2021-03-08;0;0;0;0;0;0;0;0;0;0
FR;6;2021-03-09;0;0;0;0;0;0;0;0;0;0
FR;6;2021-03-10;0;0;0;0;0;0;0;0;0;0
FR;6;2021-03-11;0;0;0;0;0;0;0;0;0;0
FR;6;2021-03-12;0;0;0;0;0;0;0;0;0;0
FR;6;2021-03-13;0;0;0;0;0;0;0;0;0;0
FR;6;2021-03-14;0;0;0;0;0;0;0;0;0;0
FR;6;2021-03-15;0;0;0;0;0;0;0;0;0;0
FR;6;2021-03-16;0;0;0;0;0;0;0;0;0;0
FR;6;2021-03-17;0;0;0;0;0;0;0;0;0;0
FR;6;2021-03-18;0;0;0;0;0;0;0;0;0;0
FR;6;2021-03-19;0;0;0;0;0;0;0;0;0;0
FR;6;2021-03-20;0;0;0;0;0;0;0;0;0;0
FR;6;2021-03-21;0;0;0;0;0;0;0;0;0;0
FR;6;2021-03-22;0;0;0;0;0;0;0;0;0;0
FR;6;2021-03-23;0;0;0;0;0;0;0;0;0;0
FR;6;2021-03-24;0;0;0;0;0;0;0;0;0;0
FR;6;2021-03-25;0;0;0;0;0;0;0;0;0;0
FR;6;2021-03-26;0;0;0;0;0;0;0;0;0;0
FR;6;2021-03-27;0;0;0;0;0;0;0;0;0;0
FR;6;2021-03-28;0;0;0;0;0;0;0;0;0;0
FR;6;2021-03-29;0;0;0;0;0;0;0;0;0;0
FR;6;2021-03-30;0;0;0;0;0;0;0;0;0;0
FR;6;2021-03-31;0;0;0;0;0;0;0;0;0;0
FR;6;2021-04-01;0;0;0;0;0;0;0;0;0;0
FR;6;2021-04-02;0;0;0;0;0;0;0;0;0;0
FR;6;2021-04-03;0;0;0;0;0;0;0;0;0;0
FR;6;2021-04-04;0;0;0;0;0;0;0;0;0;0
FR;6;2021-04-05;0;0;0;0;0;0;0;0;0;0
FR;6;2021-04-06;0;0;0;0;0;0;0;0;0;0
FR;6;2021-04-07;0;0;0;0;0;0;0;0;0;0
FR;6;2021-04-08;0;0;0;0;0;0;0;0;0;0
FR;6;2021-04-09;0;0;0;0;0;0;0;0;0;0
FR;6;2021-04-10;0;0;0;0;0;0;0;0;0;0
FR;6;2021-04-11;0;0;0;0;0;0;0;0;0;0
FR;6;2021-04-12;0;0;0;0;0;0;0;0;0;0
FR;6;2021-04-13;0;0;0;0;0;0;0;0;0;0
FR;6;2021-04-14;0;0;0;0;0;0;0;0;0;0
FR;6;2021-04-15;0;0;0;0;0;0;0;0;0;0
FR;6;2021-04-16;0;0;0;0;0;0;0;0;0;0
FR;6;2021-04-17;0;0;0;0;0;0;0;0;0;0
FR;6;2021-04-18;0;0;0;0;0;0;0;0;0;0
FR;6;2021-04-19;0;0;0;0;0;0;0;0;0;0
FR;6;2021-04-20;0;0;0;0;0;0;0;0;0;0
FR;6;2021-04-21;0;0;0;0;0;0;0;0;0;0
FR;6;2021-04-22;0;0;0;0;0;0;0;0;0;0
FR;6;2021-04-23;0;0;0;0;0;0;0;0;0;0
FR;6;2021-04-24;0;0;0;0;0;0;0;0;0;0
FR;6;2021-04-25;0;0;0;0;0;0;0;0;0;0
FR;6;2021-04-26;0;0;0;0;0;0;0;0;0;0
FR;6;2021-04-27;0;0;0;0;0;0;0;0;0;0
FR;6;2021-04-28;0;0;0;0;0;0;0;0;0;0
FR;6;2021-04-29;0;0;0;0;0;0;0;0;0;0
FR;6;2021-04-30;0;0;0;0;0;0;0;0;0;0
FR;6;2021-05-01;0;0;0;0;0;0;0;0;0;0
FR;6;2021-05-02;0;0;0;0;0;0;0;0;0;0
FR;6;2021-05-03;0;0;0;0;0;0;0;0;0;0
FR;6;2021-05-04;0;0;0;0;0;0;0;0;0;0
FR;6;2021-05-05;0;0;0;0;0;0;0;0;0;0
FR;6;2021-05-06;0;0;0;0;0;0;0;0;0;0
FR;6;2021-05-07;0;0;0;0;0;0;0;0;0;0
FR;6;2021-05-08;0;0;0;0;0;0;0;0;0;0
FR;6;2021-05-09;0;0;0;0;0;0;0;0;0;0
FR;6;2021-05-10;0;0;0;0;0;0;0;0;0;0
FR;6;2021-05-11;0;0;0;0;0;0;0;0;0;0
FR;6;2021-05-12;0;0;0;0;0;0;0;0;0;0
FR;6;2021-05-13;0;0;0;0;0;0;0;0;0;0
FR;6;2021-05-14;0;0;0;0;0;0;0;0;0;0
FR;6;2021-05-15;0;0;0;0;0;0;0;0;0;0
FR;6;2021-05-16;0;0;0;0;0;0;0;0;0;0
FR;6;2021-05-17;0;0;0;0;0;0;0;0;0;0
FR;6;2021-05-18;0;0;0;0;0;0;0;0;0;0
FR;6;2021-05-19;0;0;0;0;0;0;0;0;0;0
FR;6;2021-05-20;0;0;0;0;0;0;0;0;0;0
FR;6;2021-05-21;0;0;0;0;0;0;0;0;0;0
FR;6;2021-05-22;0;0;0;0;0;0;0;0;0;0
FR;6;2021-05-23;0;0;0;0;0;0;0;0;0;0
FR;6;2021-05-24;0;0;0;0;0;0;0;0;0;0
FR;6;2021-05-25;0;0;0;0;0;0;0;0;0;0
FR;6;2021-05-26;0;0;0;0;0;0;0;0;0;0
FR;6;2021-05-27;0;0;0;0;0;0;0;0;0;0
FR;6;2021-05-28;0;0;0;0;0;0;0;0;0;0
FR;6;2021-05-29;0;0;0;0;0;0;0;0;0;0
FR;6;2021-05-30;0;0;0;0;0;0;0;0;0;0
FR;6;2021-05-31;0;0;0;0;0;0;0;0;0;0
FR;6;2021-06-01;0;0;0;0;0;0;0;0;0;0
FR;6;2021-06-02;0;0;0;0;0;0;0;0;0;0
FR;6;2021-06-03;0;0;0;0;0;0;0;0;0;0
FR;6;2021-06-04;0;0;0;0;0;0;0;0;0;0
FR;6;2021-06-05;0;0;0;0;0;0;0;0;0;0
FR;6;2021-06-06;0;0;0;0;0;0;0;0;0;0
FR;6;2021-06-07;0;0;0;0;0;0;0;0;0;0
FR;6;2021-06-08;0;0;0;0;0;0;0;0;0;0
FR;6;2021-06-09;0;0;0;0;0;0;0;0;0;0
FR;6;2021-06-10;0;0;0;0;0;0;0;0;0;0
FR;6;2021-06-11;0;0;0;0;0;0;0;0;0;0
FR;6;2021-06-12;0;0;0;0;0;0;0;0;0;0
FR;6;2021-06-13;0;0;0;0;0;0;0;0;0;0
FR;6;2021-06-14;0;0;0;0;0;0;0;0;0;0
FR;6;2021-06-15;0;0;0;0;0;0;0;0;0;0
FR;6;2021-06-16;0;0;0;0;0;0;0;0;0;0
FR;6;2021-06-17;0;0;0;0;0;0;0;0;0;0
FR;6;2021-06-18;0;0;0;0;0;0;0;0;0;0
FR;6;2021-06-19;0;0;0;0;0;0;0;0;0;0
FR;6;2021-06-20;0;0;0;0;0;0;0;0;0;0
FR;6;2021-06-21;0;0;0;0;0;0;0;0;0;0
FR;6;2021-06-22;0;0;0;0;0;0;0;0;0;0
FR;6;2021-06-23;0;0;0;0;0;0;0;0;0;0
FR;6;2021-06-24;0;0;0;0;0;0;0;0;0;0
FR;6;2021-06-25;0;0;0;0;0;0;0;0;0;0
FR;6;2021-06-26;0;0;0;0;0;0;0;0;0;0
FR;6;2021-06-27;0;0;0;0;0;0;0;0;0;0
FR;6;2021-06-28;0;0;0;0;0;0;0;0;0;0
FR;6;2021-06-29;0;0;0;0;0;0;0;0;0;0
FR;6;2021-06-30;0;0;0;0;0;0;0;0;0;0
FR;6;2021-07-01;0;0;0;0;0;0;0;0;0;0
FR;6;2021-07-02;0;0;0;0;0;0;0;0;0;0
FR;6;2021-07-03;0;0;0;0;0;0;0;0;0;0
FR;6;2021-07-04;0;0;0;0;0;0;0;0;0;0
FR;6;2021-07-05;0;0;0;0;0;0;0;0;0;0
FR;6;2021-07-06;0;0;0;0;0;0;0;0;0;0
FR;6;2021-07-07;0;0;0;0;0;0;0;0;0;0
FR;6;2021-07-08;0;0;0;0;0;0;0;0;0;0
FR;6;2021-07-09;0;0;0;0;0;0;0;0;0;0
FR;6;2021-07-10;0;0;0;0;0;0;0;0;0;0
FR;6;2021-07-11;0;0;0;0;0;0;0;0;0;0
FR;6;2021-07-12;0;0;0;0;0;0;0;0;0;0
FR;6;2021-07-13;0;0;0;0;0;0;0;0;0;0
FR;6;2021-07-14;0;0;0;0;0;0;0;0;0;0
FR;6;2021-07-15;0;0;0;0;0;0;0;0;0;0
FR;6;2021-07-16;0;0;0;0;0;0;0;0;0;0
FR;6;2021-07-17;0;0;0;0;0;0;0;0;0;0
FR;6;2021-07-18;0;0;0;0;0;0;0;0;0;0
FR;6;2021-07-19;0;0;0;0;0;0;0;0;0;0
FR;6;2021-07-20;0;0;0;0;0;0;0;0;0;0
FR;6;2021-07-21;0;0;0;0;0;0;0;0;0;0
FR;6;2021-07-22;0;0;0;0;0;0;0;0;0;0
FR;6;2021-07-23;0;0;0;0;0;0;0;0;0;0
FR;6;2021-07-24;0;0;0;0;0;0;0;0;0;0
FR;6;2021-07-25;0;0;0;0;0;0;0;0;0;0
FR;6;2021-07-26;0;0;0;0;0;0;0;0;0;0
FR;6;2021-07-27;0;0;0;0;0;0;0;0;0;0
FR;6;2021-07-28;0;0;0;0;0;0;0;0;0;0
FR;6;2021-07-29;0;0;0;0;0;0;0;0;0;0
FR;6;2021-07-30;0;0;0;0;0;0;0;0;0;0
FR;6;2021-07-31;0;0;0;0;0;0;0;0;0;0
FR;6;2021-08-01;0;0;0;0;0;0;0;0;0;0
FR;6;2021-08-02;0;0;0;0;0;0;0;0;0;0
FR;6;2021-08-03;0;0;0;0;0;0;0;0;0;0
FR;6;2021-08-04;0;0;0;0;0;0;0;0;0;0
FR;6;2021-08-05;0;0;0;0;0;0;0;0;0;0
FR;6;2021-08-06;0;0;0;0;0;0;0;0;0;0
FR;6;2021-08-07;0;0;0;0;0;0;0;0;0;0
FR;6;2021-08-08;0;0;0;0;0;0;0;0;0;0
FR;6;2021-08-09;0;0;0;0;0;0;0;0;0;0
FR;6;2021-08-10;0;0;0;0;0;0;0;0;0;0
FR;6;2021-08-11;0;0;0;0;0;0;0;0;0;0
FR;6;2021-08-12;0;0;0;0;0;0;0;0;0;0
FR;6;2021-08-13;0;0;0;0;0;0;0;0;0;0
FR;6;2021-08-14;0;0;0;0;0;0;0;0;0;0
FR;6;2021-08-15;0;0;0;0;0;0;0;0;0;0
FR;6;2021-08-16;0;0;0;0;0;0;0;0;0;0
FR;6;2021-08-17;0;0;0;0;0;0;0;0;0;0
FR;6;2021-08-18;0;0;0;0;0;0;0;0;0;0
FR;6;2021-08-19;0;0;0;0;0;0;0;0;0;0
FR;6;2021-08-20;0;0;0;0;0;0;0;0;0;0
FR;6;2021-08-21;0;0;0;0;0;0;0;0;0;0
FR;6;2021-08-22;0;0;0;0;0;0;0;0;0;0
FR;6;2021-08-23;0;0;0;0;0;0;0;0;0;0
FR;6;2021-08-24;0;0;0;0;0;0;0;0;0;0
FR;6;2021-08-25;0;0;0;0;0;0;0;0;0;0
FR;6;2021-08-26;0;0;0;0;0;0;0;0;0;0
FR;6;2021-08-27;0;0;0;0;0;0;0;0;0;0
FR;6;2021-08-28;0;0;0;0;0;0;0;0;0;0
FR;6;2021-08-29;0;0;0;0;0;0;0;0;0;0
FR;6;2021-08-30;0;0;0;0;0;0;0;0;0;0
FR;6;2021-08-31;0;0;0;0;0;0;0;0;0;0
FR;6;2021-09-01;0;0;0;0;0;0;0;0;0;0
FR;6;2021-09-02;0;0;0;0;0;0;0;0;0;0
FR;6;2021-09-03;0;0;0;0;0;0;0;0;0;0
FR;6;2021-09-04;0;0;0;0;0;0;0;0;0;0
FR;6;2021-09-05;0;0;0;0;0;0;0;0;0;0
FR;6;2021-09-06;0;0;0;0;0;0;0;0;0;0
FR;6;2021-09-07;0;0;0;0;0;0;0;0;0;0
FR;6;2021-09-08;0;0;0;0;0;0;0;0;0;0
FR;6;2021-09-09;0;0;0;0;0;0;0;0;0;0
FR;6;2021-09-10;0;0;0;0;0;0;0;0;0;0
FR;6;2021-09-11;0;0;0;0;0;0;0;0;0;0
FR;6;2021-09-12;0;0;0;0;0;0;0;0;0;0
FR;6;2021-09-13;0;0;0;0;0;0;0;0;0;0
FR;6;2021-09-14;0;0;0;0;0;0;0;0;0;0
FR;6;2021-09-15;0;0;0;0;0;0;0;0;0;0
FR;6;2021-09-16;0;0;0;0;0;0;0;0;0;0
FR;6;2021-09-17;0;0;0;0;0;0;0;0;0;0
FR;6;2021-09-18;0;0;0;0;0;0;0;0;0;0
FR;6;2021-09-19;0;0;0;0;0;0;0;0;0;0
FR;6;2021-09-20;0;0;0;0;0;0;0;0;0;0
FR;6;2021-09-21;0;0;0;0;0;0;0;0;0;0
FR;6;2021-09-22;0;0;0;0;0;0;0;0;0;0
FR;6;2021-09-23;0;0;0;0;0;0;0;0;0;0
FR;6;2021-09-24;0;0;0;0;0;0;0;0;0;0
FR;6;2021-09-25;0;0;0;0;0;0;0;0;0;0
FR;6;2021-09-26;0;0;0;0;0;0;0;0;0;0
FR;6;2021-09-27;0;0;0;0;0;0;0;0;0;0
FR;6;2021-09-28;0;0;0;0;0;0;0;0;0;0
FR;6;2021-09-29;0;0;0;0;0;0;0;0;0;0
FR;6;2021-09-30;0;0;0;0;0;0;0;0;0;0
FR;6;2021-10-01;0;0;0;0;0;0;0;0;0;0
FR;6;2021-10-02;0;0;0;0;0;0;0;0;0;0
FR;6;2021-10-03;0;0;0;0;0;0;0;0;0;0
FR;6;2021-10-04;0;0;0;0;0;0;0;0;0;0
FR;6;2021-10-05;0;0;0;0;0;0;0;0;0;0
FR;6;2021-10-06;0;0;0;0;0;0;0;0;0;0
FR;6;2021-10-07;0;0;0;0;0;0;0;0;0;0
FR;6;2021-10-08;0;0;0;0;0;0;0;0;0;0
FR;6;2021-10-09;0;0;0;0;0;0;0;0;0;0
FR;6;2021-10-10;0;0;0;0;0;0;0;0;0;0
FR;6;2021-10-11;0;0;0;0;0;0;0;0;0;0
FR;6;2021-10-12;0;0;0;0;0;0;0;0;0;0
FR;6;2021-10-13;0;0;0;0;0;0;0;0;0;0
FR;6;2021-10-14;0;0;0;0;0;0;0;0;0;0
FR;6;2021-10-15;0;0;0;0;0;0;0;0;0;0
FR;6;2021-10-16;0;0;0;0;0;0;0;0;0;0
FR;6;2021-10-17;0;0;0;0;0;0;0;0;0;0
FR;6;2021-10-18;0;0;0;0;0;0;0;0;0;0
FR;6;2021-10-19;0;0;0;0;0;0;0;0;0;0
FR;6;2021-10-20;0;0;0;0;0;0;0;0;0;0
FR;6;2021-10-21;0;0;0;0;0;0;0;0;0;0
FR;6;2021-10-22;0;0;0;0;0;0;0;0;0;0
FR;6;2021-10-23;0;0;0;0;0;0;0;0;0;0
FR;6;2021-10-24;0;0;0;0;0;0;0;0;0;0
FR;6;2021-10-25;0;0;0;0;0;0;0;0;0;0
FR;6;2021-10-26;0;0;0;0;0;0;0;0;0;0
FR;6;2021-10-27;0;0;0;0;0;0;0;0;0;0
FR;6;2021-10-28;0;0;0;0;0;0;0;0;0;0
FR;6;2021-10-29;0;0;0;0;0;0;0;0;0;0
FR;6;2021-10-30;0;0;0;0;0;0;0;0;0;0
FR;6;2021-10-31;0;0;0;0;0;0;0;0;0;0
FR;6;2021-11-01;0;0;0;0;0;0;0;0;0;0
FR;6;2021-11-02;0;0;0;0;0;0;0;0;0;0
FR;6;2021-11-03;0;0;0;0;0;0;0;0;0;0
FR;6;2021-11-04;0;0;0;0;0;0;0;0;0;0
FR;6;2021-11-05;0;0;0;0;0;0;0;0;0;0
FR;6;2021-11-06;0;0;0;0;0;0;0;0;0;0
FR;6;2021-11-07;0;0;0;0;0;0;0;0;0;0
FR;6;2021-11-08;0;0;0;0;0;0;0;0;0;0
FR;6;2021-11-09;0;0;0;0;0;0;0;0;0;0
FR;6;2021-11-10;0;0;0;0;0;0;0;0;0;0
FR;6;2021-11-11;0;0;0;0;0;0;0;0;0;0
FR;6;2021-11-12;0;0;0;0;0;0;0;0;0;0
FR;6;2021-11-13;0;0;0;0;0;0;0;0;0;0
FR;6;2021-11-14;0;0;0;0;0;0;0;0;0;0
FR;6;2021-11-15;0;0;0;0;0;0;0;0;0;0
FR;6;2021-11-16;0;0;0;0;0;0;0;0;0;0
FR;6;2021-11-17;0;0;0;0;0;0;0;0;0;0
FR;6;2021-11-18;0;0;0;0;0;0;0;0;0;0
FR;6;2021-11-19;0;0;0;0;0;0;0;0;0;0
FR;6;2021-11-20;0;0;0;0;0;0;0;0;0;0
FR;6;2021-11-21;0;0;0;0;0;0;0;0;0;0
FR;6;2021-11-22;0;0;0;0;0;0;0;0;0;0
FR;6;2021-11-23;0;0;0;0;0;0;0;0;0;0
FR;6;2021-11-24;0;0;0;0;0;0;0;0;0;0
FR;6;2021-11-25;0;0;0;0;0;0;0;0;0;0
FR;6;2021-11-26;0;0;0;0;0;0;0;0;0;0
FR;6;2021-11-27;0;0;0;0;0;0;0;0;0;0
FR;6;2021-11-28;0;0;0;0;0;0;0;0;0;0
FR;6;2021-11-29;0;0;0;0;0;0;0;0;0;0
FR;6;2021-11-30;0;0;0;0;0;0;0;0;0;0
FR;6;2021-12-01;0;0;0;0;0;0;0;0;0;0
FR;6;2021-12-02;0;0;0;0;0;0;0;0;0;0
FR;6;2021-12-03;0;0;0;0;0;0;0;0;0;0
FR;6;2021-12-04;0;0;0;0;0;0;0;0;0;0
FR;6;2021-12-05;0;0;0;0;0;0;0;0;0;0
FR;6;2021-12-06;0;0;0;0;0;0;0;0;0;0
FR;6;2021-12-07;0;0;0;0;0;0;0;0;0;0
FR;6;2021-12-08;0;0;0;0;0;0;0;0;0;0
FR;6;2021-12-09;0;0;0;0;0;0;0;0;0;0
FR;6;2021-12-10;0;0;0;0;0;0;0;0;0;0
FR;6;2021-12-11;0;0;0;0;0;0;0;0;0;0
FR;6;2021-12-12;0;0;0;0;0;0;0;0;0;0
FR;6;2021-12-13;0;0;0;0;0;0;0;0;0;0
FR;6;2021-12-14;0;0;0;0;0;0;0;0;0;0
FR;6;2021-12-15;0;0;0;0;0;0;0;0;0;0
FR;6;2021-12-16;0;0;0;0;0;0;0;0;0;0
FR;6;2021-12-17;0;0;0;0;0;0;0;0;0;0
FR;6;2021-12-18;0;0;0;0;0;0;0;0;0;0
FR;6;2021-12-19;0;0;0;0;0;0;0;0;0;0
FR;6;2021-12-20;0;0;0;0;0;0;0;0;0;0
FR;6;2021-12-21;0;0;0;0;0;0;0;0;0;0
FR;6;2021-12-22;0;0;0;0;0;0;0;0;0;0
FR;6;2021-12-23;0;0;0;0;0;0;0;0;0;0
FR;6;2021-12-24;0;0;0;0;0;0;0;0;0;0
FR;6;2021-12-25;0;0;0;0;0;0;0;0;0;0
FR;6;2021-12-26;0;0;0;0;0;0;0;0;0;0
FR;6;2021-12-27;0;0;0;0;0;0;0;0;0;0
FR;6;2021-12-28;0;0;0;0;0;0;0;0;0;0
FR;6;2021-12-29;0;0;0;0;0;0;0;0;0;0
FR;6;2021-12-30;0;0;0;0;0;0;0;0;0;0
FR;6;2021-12-31;0;0;0;0;0;0;0;0;0;0
FR;6;2022-01-01;0;0;0;0;0;0;0;0;0;0
FR;6;2022-01-02;0;0;0;0;0;0;0;0;0;0
FR;6;2022-01-03;0;0;0;0;0;0;0;0;0;0
FR;6;2022-01-04;0;0;0;0;0;0;0;0;0;0
FR;6;2022-01-05;0;0;0;0;0;0;0;0;0;0
FR;6;2022-01-06;0;0;0;0;0;0;0;0;0;0
FR;6;2022-01-07;0;0;0;0;0;0;0;0;0;0
FR;6;2022-01-08;0;0;0;0;0;0;0;0;0;0
FR;6;2022-01-09;0;0;0;0;0;0;0;0;0;0
FR;6;2022-01-10;0;0;0;0;0;0;0;0;0;0
FR;6;2022-01-11;0;0;0;0;0;0;0;0;0;0
FR;6;2022-01-12;0;0;0;0;0;0;0;0;0;0
FR;6;2022-01-13;0;0;0;0;0;0;0;0;0;0
FR;6;2022-01-14;0;0;0;0;0;0;0;0;0;0
FR;6;2022-01-15;0;0;0;0;0;0;0;0;0;0
FR;6;2022-01-16;0;0;0;0;0;0;0;0;0;0
FR;6;2022-01-17;0;0;0;0;0;0;0;0;0;0
FR;6;2022-01-18;0;0;0;0;0;0;0;0;0;0
FR;6;2022-01-19;0;0;0;0;0;0;0;0;0;0
FR;6;2022-01-20;0;0;0;0;0;0;0;0;0;0
FR;6;2022-01-21;0;0;0;0;0;0;0;0;0;0
FR;6;2022-01-22;0;0;0;0;0;0;0;0;0;0
FR;6;2022-01-23;0;0;0;0;0;0;0;0;0;0
FR;6;2022-01-24;0;0;0;0;0;0;0;0;0;0
FR;6;2022-01-25;0;0;0;0;0;0;0;0;0;0
FR;6;2022-01-26;0;0;0;0;0;0;0;0;0;0
FR;6;2022-01-27;0;0;0;0;0;0;0;0;0;0
FR;6;2022-01-28;0;0;0;0;0;0;0;0;0;0
FR;6;2022-01-29;0;0;0;0;0;0;0;0;0;0
FR;6;2022-01-30;0;0;0;0;0;0;0;0;0;0
FR;6;2022-01-31;0;0;0;0;0;0;0;0;0;0
FR;6;2022-02-01;0;0;0;0;0;0;0;0;0;0
FR;6;2022-02-02;0;0;0;0;0;0;0;0;0;0
FR;6;2022-02-03;0;0;0;0;0;0;0;0;0;0
FR;6;2022-02-04;0;0;0;0;0;0;0;0;0;0
FR;6;2022-02-05;0;0;0;0;0;0;0;0;0;0
FR;6;2022-02-06;0;0;0;0;0;0;0;0;0;0
FR;6;2022-02-07;0;0;0;0;0;0;0;0;0;0
FR;6;2022-02-08;0;0;0;0;0;0;0;0;0;0
FR;6;2022-02-09;0;0;0;0;0;0;0;0;0;0
FR;6;2022-02-10;0;0;0;0;0;0;0;0;0;0
FR;6;2022-02-11;0;0;0;0;0;0;0;0;0;0
FR;6;2022-02-12;0;0;0;0;0;0;0;0;0;0
FR;6;2022-02-13;0;0;0;0;0;0;0;0;0;0
FR;6;2022-02-14;0;0;0;0;0;0;0;0;0;0
FR;6;2022-02-15;0;0;0;0;0;0;0;0;0;0
FR;6;2022-02-16;0;0;0;0;0;0;0;0;0;0
FR;6;2022-02-17;0;0;0;0;0;0;0;0;0;0
FR;6;2022-02-18;0;0;0;0;0;0;0;0;0;0
FR;6;2022-02-19;0;0;0;0;0;0;0;0;0;0
FR;6;2022-02-20;0;0;0;0;0;0;0;0;0;0
FR;6;2022-02-21;0;0;0;0;0;0;0;0;0;0
FR;6;2022-02-22;0;0;0;0;0;0;0;0;0;0
FR;6;2022-02-23;0;0;0;0;0;0;0;0;0;0
FR;6;2022-02-24;0;0;0;0;0;0;0;0;0;0
FR;6;2022-02-25;0;0;0;0;0;0;0;0;0;0
FR;6;2022-02-26;1;0;0;0;0;1;0;0;0;0
FR;6;2022-02-27;0;0;0;0;0;1;0;0;0;0
FR;6;2022-02-28;0;0;0;0;0;1;0;0;0;0
FR;6;2022-03-01;3;0;0;0;0;4;0;0;0;0
FR;6;2022-03-02;97;9;2;0;7;101;9;2;0;7
FR;6;2022-03-03;0;0;0;0;0;101;9;2;0;7
FR;6;2022-03-04;91;4;0;0;4;192;13;2;0;11
FR;6;2022-03-05;391;23;2;0;14;583;36;4;0;25
FR;6;2022-03-06;7;1;0;0;0;590;37;4;0;25
FR;6;2022-03-07;337;19;0;0;13;927;56;4;0;38
FR;6;2022-03-08;230;14;0;0;5;1157;70;4;0;43
FR;6;2022-03-09;519;29;2;0;21;1676;99;6;0;64
FR;6;2022-03-10;206;19;0;1;12;1882;118;6;1;76
FR;6;2022-03-11;328;21;6;0;21;2210;139;12;1;97
FR;6;2022-03-12;518;25;1;0;20;2728;164;13;1;117
FR;6;2022-03-13;40;2;0;0;1;2768;166;13;1;118
FR;6;2022-03-14;201;4;2;0;3;2969;170;15;1;121
FR;6;2022-03-15;112;11;2;0;9;3081;181;17;1;130
FR;6;2022-03-16;310;17;1;1;14;3391;198;18;2;144
FR;6;2022-03-17;117;6;1;2;4;3508;204;19;4;148
FR;6;2022-03-18;214;11;0;0;6;3722;215;19;4;154
FR;6;2022-03-19;307;19;2;0;9;4029;234;21;4;163
FR;6;2022-03-20;15;5;0;0;1;4044;239;21;4;164
FR;6;2022-03-21;132;23;1;0;4;4176;262;22;4;168
FR;6;2022-03-22;97;15;0;0;4;4273;277;22;4;172
FR;6;2022-03-23;226;108;3;0;14;4499;385;25;4;186
FR;6;2022-03-24;100;15;1;3;4;4599;400;26;7;190
FR;6;2022-03-25;203;141;2;1;15;4802;541;28;8;205
FR;6;2022-03-26;331;295;7;1;19;5133;836;35;9;224
FR;6;2022-03-27;32;30;1;0;1;5165;866;36;9;225
FR;6;2022-03-28;200;208;8;1;17;5365;1074;44;10;242
FR;6;2022-03-29;126;189;12;2;12;5491;1263;56;12;254
FR;6;2022-03-30;305;476;10;2;22;5796;1739;66;14;276
FR;6;2022-03-31;124;140;10;0;14;5920;1879;76;14;290
FR;6;2022-04-01;195;150;11;2;23;6115;2029;87;16;313
FR;6;2022-04-02;205;241;9;1;13;6320;2270;96;17;326
FR;6;2022-04-03;17;21;0;0;1;6337;2291;96;17;327
FR;6;2022-04-04;132;114;6;1;9;6469;2405;102;18;336
FR;6;2022-04-05;145;88;15;1;11;6614;2493;117;19;347
FR;6;2022-04-06;204;245;22;26;27;6818;2738;139;45;374
FR;6;2022-04-07;127;96;15;5;17;6945;2834;154;50;391
FR;6;2022-04-08;199;170;16;3;17;7144;3004;170;53;408
FR;6;2022-04-09;145;139;6;12;13;7289;3143;176;65;421
FR;6;2022-04-10;10;20;3;0;1;7299;3163;179;65;422
FR;6;2022-04-11;101;106;4;0;5;7400;3269;183;65;427
FR;6;2022-04-12;135;75;5;8;10;7535;3344;188;73;437
FR;6;2022-04-13;160;175;7;5;13;7695;3519;195;78;450
FR;6;2022-04-14;100;103;5;10;8;7795;3622;200;88;458
FR;6;2022-04-15;160;148;11;7;19;7955;3770;211;95;477
FR;6;2022-04-16;127;132;5;0;14;8082;3902;216;95;491
FR;6;2022-04-17;8;9;4;0;4;8090;3911;220;95;495
FR;6;2022-04-18;8;15;3;0;4;8098;3926;223;95;499
FR;6;2022-04-19;97;112;4;3;3;8195;4038;227;98;502
FR;6;2022-04-20;173;227;8;7;15;8368;4265;235;105;517
FR;6;2022-04-21;111;93;8;4;11;8479;4358;243;109;528
FR;6;2022-04-22;138;160;13;12;13;8617;4518;256;121;541
FR;6;2022-04-23;104;129;1;1;7;8721;4647;257;122;548
FR;6;2022-04-24;5;21;1;0;0;8726;4668;258;122;548
FR;6;2022-04-25;90;128;3;8;11;8816;4796;261;130;559
FR;6;2022-04-26;101;128;18;2;16;8917;4924;279;132;575
FR;6;2022-04-27;197;159;21;1;27;9114;5083;300;133;602
FR;6;2022-04-28;109;87;7;1;8;9223;5170;307;134;610
FR;6;2022-04-29;191;168;16;2;20;9414;5338;323;136;630
FR;6;2022-04-30;131;125;7;1;24;9545;5463;330;137;654
FR;6;2022-05-01;7;6;0;0;0;9552;5469;330;137;654
FR;6;2022-05-02;94;65;3;4;3;9646;5534;333;141;657
FR;6;2022-05-03;137;92;11;2;7;9783;5626;344;143;664
FR;6;2022-05-04;166;118;25;12;29;9949;5744;369;155;693
FR;6;2022-05-05;101;70;8;3;12;10050;5814;377;158;705
FR;6;2022-05-06;152;110;10;9;16;10202;5924;387;167;721
FR;6;2022-05-07;138;93;13;3;23;10340;6017;400;170;744
FR;6;2022-05-08;20;8;6;5;7;10360;6025;406;175;751
FR;6;2022-05-09;86;73;9;7;13;10446;6098;415;182;764
FR;6;2022-05-10;111;80;15;7;12;10557;6178;430;189;776
FR;6;2022-05-11;129;120;11;14;20;10686;6298;441;203;796
FR;6;2022-05-12;105;75;6;5;13;10791;6373;447;208;809
FR;6;2022-05-13;154;95;17;21;20;10945;6468;464;229;829
FR;6;2022-05-14;81;60;6;7;15;11026;6528;470;236;844
FR;6;2022-05-15;12;7;0;0;0;11038;6535;470;236;844
FR;6;2022-05-16;64;54;6;2;12;11102;6589;476;238;856
FR;6;2022-05-17;123;77;5;7;11;11225;6666;481;245;867
FR;6;2022-05-18;130;116;5;1;13;11355;6782;486;246;880
FR;6;2022-05-19;124;57;6;8;9;11479;6839;492;254;889
FR;6;2022-05-20;127;115;13;3;18;11606;6954;505;257;907
FR;6;2022-05-21;90;67;14;3;12;11696;7021;519;260;919
FR;6;2022-05-22;19;12;5;0;4;11715;7033;524;260;923
FR;6;2022-05-23;73;72;3;2;6;11788;7105;527;262;929
FR;6;2022-05-24;116;98;8;2;16;11904;7203;535;264;945
FR;6;2022-05-25;139;128;6;3;11;12043;7331;541;267;956
FR;6;2022-05-26;7;9;3;0;9;12050;7340;544;267;965
FR;6;2022-05-27;127;105;15;11;18;12177;7445;559;278;983
FR;6;2022-05-28;51;73;1;5;8;12228;7518;560;283;991
FR;6;2022-05-29;8;10;0;0;1;12236;7528;560;283;992
FR;6;2022-05-30;69;69;7;4;4;12305;7597;567;287;996
FR;6;2022-05-31;87;102;10;2;14;12392;7699;577;289;1010
FR;6;2022-06-01;96;87;10;1;11;12488;7786;587;290;1021
FR;6;2022-06-02;88;60;6;3;9;12576;7846;593;293;1030
FR;6;2022-06-03;123;102;13;7;21;12699;7948;606;300;1051
FR;6;2022-06-04;61;51;10;0;12;12760;7999;616;300;1063
FR;6;2022-06-05;16;15;2;1;4;12776;8014;618;301;1067
FR;6;2022-06-06;8;6;0;0;0;12784;8020;618;301;1067
FR;6;2022-06-07;77;87;3;4;6;12861;8107;621;305;1073
FR;6;2022-06-08;92;108;13;5;20;12953;8215;634;310;1093
FR;6;2022-06-09;73;78;12;3;12;13026;8293;646;313;1105
FR;0;2020-12-27;602;0;0;0;0;602;0;0;0;0
FR;0;2020-12-28;669;1;0;0;0;1271;1;0;0;0
FR;0;2020-12-29;374;0;0;0;0;1645;1;0;0;0
FR;0;2020-12-30;440;0;0;0;0;2085;1;0;0;0
FR;0;2020-12-31;436;1;0;0;0;2521;2;0;0;0
FR;0;2021-01-01;1137;2;0;0;0;3658;4;0;0;0
FR;0;2021-01-02;358;3;0;0;0;4016;7;0;0;0
FR;0;2021-01-03;402;0;0;0;0;4418;7;0;0;0
FR;0;2021-01-04;2092;2;0;0;0;6510;9;0;0;0
FR;0;2021-01-05;7732;3;0;0;0;14242;12;0;0;0
FR;0;2021-01-06;12449;13;0;0;0;26691;25;0;0;0
FR;0;2021-01-07;29449;9;0;0;0;56140;34;0;0;0
FR;0;2021-01-08;37123;12;0;0;0;93263;46;0;0;0
FR;0;2021-01-09;11209;4;0;0;0;104472;50;0;0;0
FR;0;2021-01-10;5996;3;0;0;0;110468;53;0;0;0
FR;0;2021-01-11;39925;17;0;0;0;150393;70;0;0;0
FR;0;2021-01-12;62127;16;0;0;0;212520;86;0;0;0
FR;0;2021-01-13;65110;31;0;0;0;277630;117;0;0;0
FR;0;2021-01-14;83118;87;0;0;0;360748;204;0;0;0
FR;0;2021-01-15;68992;34;0;0;0;429740;238;0;0;0
FR;0;2021-01-16;20208;69;0;0;0;449948;307;0;0;0
FR;0;2021-01-17;10977;48;0;0;0;460925;355;0;0;0
FR;0;2021-01-18;85886;164;0;0;0;546811;519;0;0;0
FR;0;2021-01-19;130576;174;0;0;0;677387;693;0;0;0
FR;0;2021-01-20;137527;171;0;0;0;814914;864;0;0;0
FR;0;2021-01-21;158379;170;0;0;0;973293;1034;0;0;0
FR;0;2021-01-22;121044;209;0;0;0;1094337;1243;0;0;0
FR;0;2021-01-23;38467;64;0;0;0;1132804;1307;0;0;0
FR;0;2021-01-24;9740;74;0;0;0;1142544;1381;0;0;0
FR;0;2021-01-25;78224;1273;0;0;0;1220768;2654;0;0;0
FR;0;2021-01-26;100365;3293;1;0;0;1321133;5947;1;0;0
FR;0;2021-01-27;107223;5936;0;0;0;1428356;11883;1;0;0
FR;0;2021-01-28;124331;15070;0;0;0;1552687;26953;1;0;0
FR;0;2021-01-29;92173;17776;0;0;0;1644860;44729;1;0;0
FR;0;2021-01-30;29114;4317;0;0;0;1673974;49046;1;0;0
FR;0;2021-01-31;5228;1743;0;0;0;1679202;50789;1;0;0
FR;0;2021-02-01;53108;21543;0;0;0;1732310;72332;1;0;0
FR;0;2021-02-02;72281;35842;0;0;0;1804591;108174;1;0;0
FR;0;2021-02-03;72291;38146;0;0;0;1876882;146320;1;0;0
FR;0;2021-02-04;82053;51653;0;0;0;1958935;197973;1;0;0
FR;0;2021-02-05;68217;46101;0;0;0;2027152;244074;1;0;0
FR;0;2021-02-06;23103;10772;0;0;0;2050255;254846;1;0;0
FR;0;2021-02-07;5183;5324;0;0;0;2055438;260170;1;0;0
FR;0;2021-02-08;46819;46919;0;0;0;2102257;307089;1;0;0
FR;0;2021-02-09;65992;74634;0;0;0;2168249;381723;1;0;0
FR;0;2021-02-10;70990;79491;0;0;0;2239239;461214;1;0;0
FR;0;2021-02-11;87243;101498;0;0;0;2326482;562712;1;0;0
FR;0;2021-02-12;79293;75065;0;0;0;2405775;637777;1;0;0
FR;0;2021-02-13;22354;19495;0;0;0;2428129;657272;1;0;0
FR;0;2021-02-14;5071;7285;0;0;0;2433200;664557;1;0;0
FR;0;2021-02-15;38071;76595;0;0;0;2471271;741152;1;0;0
FR;0;2021-02-16;50364;100505;0;0;0;2521635;841657;1;0;0
FR;0;2021-02-17;50503;104678;1;0;0;2572138;946335;2;0;0
FR;0;2021-02-18;69763;120695;0;0;0;2641901;1067030;2;0;0
FR;0;2021-02-19;65051;91107;1;0;0;2706952;1158137;3;0;0
FR;0;2021-02-20;18574;28585;0;0;0;2725526;1186722;3;0;0
FR;0;2021-02-21;3314;6277;0;0;0;2728840;1192999;3;0;0
FR;0;2021-02-22;37483;73193;2;0;0;2766323;1266192;5;0;0
FR;0;2021-02-23;53762;84457;1;0;0;2820085;1350649;6;0;0
FR;0;2021-02-24;59982;81802;1;0;0;2880067;1432451;7;0;0
FR;0;2021-02-25;100546;91462;1;0;0;2980613;1523913;8;0;0
FR;0;2021-02-26;113432;70753;1;0;0;3094045;1594666;9;0;0
FR;0;2021-02-27;52091;22139;0;0;0;3146136;1616805;9;0;0
FR;0;2021-02-28;6193;4253;1;0;0;3152329;1621058;10;0;0
FR;0;2021-03-01;65841;53272;1;0;0;3218170;1674330;11;0;0
FR;0;2021-03-02;101352;66653;2;0;0;3319522;1740983;13;0;0
FR;0;2021-03-03;116475;65541;0;0;0;3435997;1806524;13;0;0
FR;0;2021-03-04;163591;70349;3;0;0;3599588;1876873;16;0;0
FR;0;2021-03-05;200888;63050;3;0;0;3800476;1939923;19;0;0
FR;0;2021-03-06;207930;17709;3;0;0;4008406;1957632;22;0;0
FR;0;2021-03-07;121250;4958;1;0;0;4129656;1962590;23;0;0
FR;0;2021-03-08;107117;50305;2;0;0;4236773;2012895;25;0;0
FR;0;2021-03-09;172423;56483;2;0;0;4409196;2069378;27;0;0
FR;0;2021-03-10;178944;57119;5;0;0;4588140;2126497;32;0;0
FR;0;2021-03-11;242834;63534;2;0;0;4830974;2190031;34;0;0
FR;0;2021-03-12;294780;53361;1;0;0;5125754;2243392;35;0;0
FR;0;2021-03-13;231374;15327;1;0;0;5357128;2258719;36;0;0
FR;0;2021-03-14;63338;3269;1;0;0;5420466;2261988;37;0;0
FR;0;2021-03-15;158609;32133;3;0;0;5579075;2294121;40;0;0
FR;0;2021-03-16;141541;39098;6;0;0;5720616;2333219;46;0;0
FR;0;2021-03-17;150449;38183;4;0;0;5871065;2371402;50;0;0
FR;0;2021-03-18;167789;44543;5;0;0;6038854;2415945;55;0;0
FR;0;2021-03-19;229969;37144;2;0;0;6268823;2453089;57;0;0
FR;0;2021-03-20;166644;11559;1;0;0;6435467;2464648;58;0;0
FR;0;2021-03-21;49921;2496;1;0;0;6485388;2467144;59;0;0
FR;0;2021-03-22;169999;33963;2;0;0;6655387;2501107;61;0;0
FR;0;2021-03-23;250332;42370;1;0;0;6905719;2543477;62;0;0
FR;0;2021-03-24;256863;43657;0;0;0;7162582;2587134;62;0;0
FR;0;2021-03-25;341761;44871;5;0;0;7504343;2632005;67;0;0
FR;0;2021-03-26;358754;41903;4;1;0;7863097;2673908;71;1;0
FR;0;2021-03-27;195241;16736;1;0;0;8058338;2690644;72;1;0
FR;0;2021-03-28;59324;4033;3;0;0;8117662;2694677;75;1;0
FR;0;2021-03-29;202936;53960;4;0;0;8320598;2748637;79;1;0
FR;0;2021-03-30;285434;69648;4;0;0;8606032;2818285;83;1;0
FR;0;2021-03-31;262972;73258;4;0;0;8869004;2891543;87;1;0
FR;0;2021-04-01;315399;89399;12;0;0;9184403;2980942;99;1;0
FR;0;2021-04-02;281288;92836;7;0;0;9465691;3073778;106;1;0
FR;0;2021-04-03;141052;61969;5;0;0;9606743;3135747;111;1;0
FR;0;2021-04-04;46470;18731;2;0;0;9653213;3154478;113;1;0
FR;0;2021-04-05;63309;10793;11;0;0;9716522;3165271;124;1;0
FR;0;2021-04-06;217156;109465;17;0;0;9933678;3274736;141;1;0
FR;0;2021-04-07;260205;115423;17;0;0;10193883;3390159;158;1;0
FR;0;2021-04-08;337744;121814;14;0;0;10531627;3511973;172;1;0
FR;0;2021-04-09;410084;116357;49;0;0;10941711;3628330;221;1;0
FR;0;2021-04-10;212588;82632;15;0;0;11154299;3710962;236;1;0
FR;0;2021-04-11;56123;34424;7;0;0;11210422;3745386;243;1;0
FR;0;2021-04-12;237008;115230;45;0;0;11447430;3860616;288;1;0
FR;0;2021-04-13;309428;144484;98;1;0;11756858;4005100;386;2;0
FR;0;2021-04-14;294446;139326;213;0;0;12051304;4144426;599;2;0
FR;0;2021-04-15;337023;148456;338;0;0;12388327;4292882;937;2;0
FR;0;2021-04-16;339229;145945;353;0;0;12727556;4438827;1290;2;0
FR;0;2021-04-17;188628;90016;109;0;0;12916184;4528843;1399;2;0
FR;0;2021-04-18;51604;35361;47;0;0;12967788;4564204;1446;2;0
FR;0;2021-04-19;205647;138208;455;0;0;13173435;4702412;1901;2;0
FR;0;2021-04-20;254355;170912;569;0;0;13427790;4873324;2470;2;0
FR;0;2021-04-21;253184;169147;834;0;0;13680974;5042471;3304;2;0
FR;0;2021-04-22;287498;188839;818;0;0;13968472;5231310;4122;2;0
FR;0;2021-04-23;297921;183442;747;0;0;14266393;5414752;4869;2;0
FR;0;2021-04-24;190414;111576;252;0;0;14456807;5526328;5121;2;0
FR;0;2021-04-25;69542;38781;51;0;0;14526349;5565109;5172;2;0
FR;0;2021-04-26;220898;156314;560;0;0;14747247;5721423;5732;2;0
FR;0;2021-04-27;284554;187404;940;0;0;15031801;5908827;6672;2;0
FR;0;2021-04-28;299447;183274;1422;1;1;15331248;6092101;8094;3;1
FR;0;2021-04-29;357062;196598;1277;0;0;15688310;6288699;9371;3;1
FR;0;2021-04-30;372146;184844;1119;1;0;16060456;6473543;10490;4;1
FR;0;2021-05-01;167610;52469;178;0;0;16228066;6526012;10668;4;1
FR;0;2021-05-02;91708;37758;83;0;0;16319774;6563770;10751;4;1
FR;0;2021-05-03;288862;168286;840;0;0;16608636;6732056;11591;4;1
FR;0;2021-05-04;315604;224376;1231;0;0;16924240;6956432;12822;4;1
FR;0;2021-05-05;327114;224813;1313;0;0;17251354;7181245;14135;4;1
FR;0;2021-05-06;379434;239481;1630;0;0;17630788;7420726;15765;4;1
FR;0;2021-05-07;372687;257331;1222;0;0;18003475;7678057;16987;4;1
FR;0;2021-05-08;222135;67573;299;0;0;18225610;7745630;17286;4;1
FR;0;2021-05-09;129684;46318;243;0;0;18355294;7791948;17529;4;1
FR;0;2021-05-10;313317;228779;1233;0;0;18668611;8020727;18762;4;1
FR;0;2021-05-11;403830;257811;1563;0;0;19072441;8278538;20325;4;1
FR;0;2021-05-12;434038;233111;1542;0;0;19506479;8511649;21867;4;1
FR;0;2021-05-13;338552;56923;430;0;0;19845031;8568572;22297;4;1
FR;0;2021-05-14;454055;167265;1122;0;0;20299086;8735837;23419;4;1
FR;0;2021-05-15;374923;94061;442;0;0;20674009;8829898;23861;4;1
FR;0;2021-05-16;202725;20769;168;0;0;20876734;8850667;24029;4;1
FR;0;2021-05-17;376072;148826;1550;0;0;21252806;8999493;25579;4;1
FR;0;2021-05-18;460071;153163;1987;0;0;21712877;9152656;27566;4;1
FR;0;2021-05-19;467326;144591;2457;0;0;22180203;9297247;30023;4;1
FR;0;2021-05-20;507466;160224;2332;0;0;22687669;9457471;32355;4;1
FR;0;2021-05-21;489604;174434;1988;0;0;23177273;9631905;34343;4;1
FR;0;2021-05-22;347145;79887;668;0;0;23524418;9711792;35011;4;1
FR;0;2021-05-23;161671;14381;246;0;0;23686089;9726173;35257;4;1
FR;0;2021-05-24;263154;33178;600;0;0;23949243;9759351;35857;4;1
FR;0;2021-05-25;400201;189216;2349;1;0;24349444;9948567;38206;5;1
FR;0;2021-05-26;413398;188588;2220;0;0;24762842;10137155;40426;5;1
FR;0;2021-05-27;449748;218751;2159;0;0;25212590;10355906;42585;5;1
FR;0;2021-05-28;429494;259516;1891;0;0;25642084;10615422;44476;5;1
FR;0;2021-05-29;298948;149412;583;0;0;25941032;10764834;45059;5;1
FR;0;2021-05-30;107122;32573;163;0;0;26048154;10797407;45222;5;1
FR;0;2021-05-31;357982;203321;1466;1;1;26406136;11000728;46688;6;2
FR;0;2021-06-01;430887;251177;1959;1;1;26837023;11251905;48647;7;3
FR;0;2021-06-02;419527;230863;1979;0;0;27256550;11482768;50626;7;3
FR;0;2021-06-03;464919;258380;1819;0;0;27721469;11741148;52445;7;3
FR;0;2021-06-04;455778;304692;1729;1;1;28177247;12045840;54174;8;4
FR;0;2021-06-05;304760;188962;651;0;0;28482007;12234802;54825;8;4
FR;0;2021-06-06;133248;49115;226;0;0;28615255;12283917;55051;8;4
FR;0;2021-06-07;339130;261892;1519;0;0;28954385;12545809;56570;8;4
FR;0;2021-06-08;393607;290881;1799;0;0;29347992;12836690;58369;8;4
FR;0;2021-06-09;384704;275357;1727;0;0;29732696;13112047;60096;8;4
FR;0;2021-06-10;403986;288772;1721;1;0;30136682;13400819;61817;9;4
FR;0;2021-06-11;386478;357145;1462;0;0;30523160;13757964;63279;9;4
FR;0;2021-06-12;283210;211277;490;0;0;30806370;13969241;63769;9;4
FR;0;2021-06-13;104838;73975;204;0;0;30911208;14043216;63973;9;4
FR;0;2021-06-14;240659;355462;1426;1;0;31151867;14398678;65399;10;4
FR;0;2021-06-15;308000;385518;1565;1;0;31459867;14784196;66964;11;4
FR;0;2021-06-16;313851;357729;1416;1;0;31773718;15141925;68380;12;4
FR;0;2021-06-17;317565;372463;1422;1;0;32091283;15514388;69802;13;4
FR;0;2021-06-18;321561;442446;1332;1;0;32412844;15956834;71134;14;4
FR;0;2021-06-19;224306;273791;448;0;0;32637150;16230625;71582;14;4
FR;0;2021-06-20;74374;102585;127;0;0;32711524;16333210;71709;14;4
FR;0;2021-06-21;195572;401902;1032;1;1;32907096;16735112;72741;15;5
FR;0;2021-06-22;223015;467401;1262;10;2;33130111;17202513;74003;25;7
FR;0;2021-06-23;233879;439887;1196;1;1;33363990;17642400;75199;26;8
FR;0;2021-06-24;241739;409581;1350;0;0;33605729;18051981;76549;26;8
FR;0;2021-06-25;227478;522242;1398;0;0;33833207;18574223;77947;26;8
FR;0;2021-06-26;153194;370738;586;1;0;33986401;18944961;78533;27;8
FR;0;2021-06-27;55864;156209;168;1;0;34042265;19101170;78701;28;8
FR;0;2021-06-28;154623;452892;1169;0;0;34196888;19554062;79870;28;8
FR;0;2021-06-29;182551;506843;2124;0;0;34379439;20060905;81994;28;8
FR;0;2021-06-30;203848;482830;2010;21;2;34583287;20543735;84004;49;10
FR;0;2021-07-01;231133;457824;2221;5;1;34814420;21001559;86225;54;11
FR;0;2021-07-02;228371;520221;2119;5;3;35042791;21521780;88344;59;14
FR;0;2021-07-03;141945;368729;909;3;1;35184736;21890509;89253;62;15
FR;0;2021-07-04;56694;141252;265;0;0;35241430;22031761;89518;62;15
FR;0;2021-07-05;168251;419286;1668;8;2;35409681;22451047;91186;70;17
FR;0;2021-07-06;196589;474787;1828;45;8;35606270;22925834;93014;115;25
FR;0;2021-07-07;212977;439313;1877;24;5;35819247;23365147;94891;139;30
FR;0;2021-07-08;231457;424177;2088;20;7;36050704;23789324;96979;159;37
FR;0;2021-07-09;228358;510771;2182;4;2;36279062;24300095;99161;163;39
FR;0;2021-07-10;148537;339882;982;1;1;36427599;24639977;100143;164;40
FR;0;2021-07-11;60144;110142;282;0;0;36487743;24750119;100425;164;40
FR;0;2021-07-12;168972;478198;1757;4;0;36656715;25228317;102182;168;40
FR;0;2021-07-13;287081;527454;2045;8;2;36943796;25755771;104227;176;42
FR;0;2021-07-14;180904;157711;434;0;0;37124700;25913482;104661;176;42
FR;0;2021-07-15;346895;502473;2097;1;0;37471595;26415955;106758;177;42
FR;0;2021-07-16;379918;495931;2021;3;1;37851513;26911886;108779;180;43
FR;0;2021-07-17;259655;319804;876;1;0;38111168;27231690;109655;181;43
FR;0;2021-07-18;109668;114783;310;0;0;38220836;27346473;109965;181;43
FR;0;2021-07-19;285327;424998;1627;3;0;38506163;27771471;111592;184;43
FR;0;2021-07-20;376741;452389;1722;0;0;38882904;28223860;113314;184;43
FR;0;2021-07-21;395641;407881;1549;4;2;39278545;28631741;114863;188;45
FR;0;2021-07-22;440897;388102;1714;4;2;39719442;29019843;116577;192;47
FR;0;2021-07-23;440154;423148;1880;4;2;40159596;29442991;118457;196;49
FR;0;2021-07-24;285186;269604;803;1;0;40444782;29712595;119260;197;49
FR;0;2021-07-25;121057;80053;230;0;0;40565839;29792648;119490;197;49
FR;0;2021-07-26;347280;323171;1615;3;2;40913119;30115819;121105;200;51
FR;0;2021-07-27;463908;320268;1696;4;2;41377027;30436087;122801;204;53
FR;0;2021-07-28;459317;289999;1634;4;2;41836344;30726086;124435;208;55
FR;0;2021-07-29;489691;276912;1794;2;1;42326035;31002998;126229;210;56
FR;0;2021-07-30;461647;302854;1935;5;2;42787682;31305852;128164;215;58
FR;0;2021-07-31;285347;185072;914;1;0;43073029;31490924;129078;216;58
FR;0;2021-08-01;111942;49993;253;0;0;43184971;31540917;129331;216;58
FR;0;2021-08-02;341241;234580;1599;2;0;43526212;31775497;130930;218;58
FR;0;2021-08-03;398431;245070;1718;2;1;43924643;32020567;132648;220;59
FR;0;2021-08-04;384669;210103;1591;6;3;44309312;32230670;134239;226;62
FR;0;2021-08-05;365995;228902;1709;0;0;44675307;32459572;135948;226;62
FR;0;2021-08-06;359586;271666;1833;4;1;45034893;32731238;137781;230;63
FR;0;2021-08-07;213046;178376;755;4;3;45247939;32909614;138536;234;66
FR;0;2021-08-08;74138;63234;270;0;0;45322077;32972848;138806;234;66
FR;0;2021-08-09;258594;259505;1540;4;3;45580671;33232353;140346;238;69
FR;0;2021-08-10;306621;277978;1656;2;1;45887292;33510331;142002;240;70
FR;0;2021-08-11;279554;260249;1441;5;1;46166846;33770580;143443;245;71
FR;0;2021-08-12;271398;278646;1660;3;1;46438244;34049226;145103;248;72
FR;0;2021-08-13;252046;277933;1590;3;2;46690290;34327159;146693;251;74
FR;0;2021-08-14;145285;197332;739;0;0;46835575;34524491;147432;251;74
FR;0;2021-08-15;39309;50116;215;1;0;46874884;34574607;147647;252;74
FR;0;2021-08-16;186051;318126;1539;0;0;47060935;34892733;149186;252;74
FR;0;2021-08-17;215565;336547;1635;7;1;47276500;35229280;150821;259;75
FR;0;2021-08-18;198950;324742;1594;7;4;47475450;35554022;152415;266;79
FR;0;2021-08-19;191907;325772;1634;1;0;47667357;35879794;154049;267;79
FR;0;2021-08-20;186366;366428;1812;3;2;47853723;36246222;155861;270;81
FR;0;2021-08-21;104763;238165;704;0;0;47958486;36484387;156565;270;81
FR;0;2021-08-22;31891;87200;253;1;1;47990377;36571587;156818;271;82
FR;0;2021-08-23;140903;357267;1560;3;1;48131280;36928854;158378;274;83
FR;0;2021-08-24;162407;376911;1847;5;1;48293687;37305765;160225;279;84
FR;0;2021-08-25;151065;350880;2028;8;3;48444752;37656645;162253;287;87
FR;0;2021-08-26;142764;342897;2555;10;1;48587516;37999542;164808;297;88
FR;0;2021-08-27;148371;388278;2789;11;3;48735887;38387820;167597;308;91
FR;0;2021-08-28;90612;249583;1405;0;0;48826499;38637403;169002;308;91
FR;0;2021-08-29;27304;83327;516;1;0;48853803;38720730;169518;309;91
FR;0;2021-08-30;117334;324879;4706;6;6015;48971137;39045609;174224;315;6106
FR;0;2021-08-31;128720;334662;10178;19;11865;49099857;39380271;184402;334;17971
FR;0;2021-09-01;135798;285706;22419;7;24316;49235655;39665977;206821;341;42287
FR;0;2021-09-02;112667;247296;26512;13;28879;49348322;39913273;233333;354;71166
FR;0;2021-09-03;118213;292721;29956;23;32968;49466535;40205994;263289;377;104134
FR;0;2021-09-04;89824;217740;12583;12;14083;49556359;40423734;275872;389;118217
FR;0;2021-09-05;21343;44863;4391;2;4733;49577702;40468597;280263;391;122950
FR;0;2021-09-06;75340;180795;31946;16;34236;49653042;40649392;312209;407;157186
FR;0;2021-09-07;80126;181263;33238;40;36121;49733168;40830655;345447;447;193307
FR;0;2021-09-08;89921;206215;29654;27;32462;49823089;41036870;375101;474;225769
FR;0;2021-09-09;76705;165429;33042;26;36528;49899794;41202299;408143;500;262297
FR;0;2021-09-10;95666;203710;35718;26;40524;49995460;41406009;443861;526;302821
FR;0;2021-09-11;66823;169221;12134;19;14316;50062283;41575230;455995;545;317137
FR;0;2021-09-12;12799;32081;2767;1;3159;50075082;41607311;458762;546;320296
FR;0;2021-09-13;64381;126377;41208;32;44065;50139463;41733688;499970;578;364361
FR;0;2021-09-14;73341;129143;56347;78;62070;50212804;41862831;556317;656;426431
FR;0;2021-09-15;76427;167875;55631;58;54773;50289231;42030706;611948;714;481204
FR;0;2021-09-16;63773;114570;60036;85;60034;50353004;42145276;671984;799;541238
FR;0;2021-09-17;74991;156840;53828;71;57242;50427995;42302116;725812;870;598480
FR;0;2021-09-18;48194;139589;15596;25;17284;50476189;42441705;741408;895;615764
FR;0;2021-09-19;7866;23718;2435;1;2620;50484055;42465423;743843;896;618384
FR;0;2021-09-20;44453;93932;50028;73;50261;50528508;42559355;793871;969;668645
FR;0;2021-09-21;45816;98460;62733;76;63390;50574324;42657815;856604;1045;732035
FR;0;2021-09-22;48596;142319;55332;83;55353;50622920;42800134;911936;1128;787388
FR;0;2021-09-23;43172;92019;62356;94;63474;50666092;42892153;974292;1222;850862
FR;0;2021-09-24;52230;133317;54530;109;59104;50718322;43025470;1028822;1331;909966
FR;0;2021-09-25;35194;115521;16265;37;18255;50753516;43140991;1045087;1368;928221
FR;0;2021-09-26;5527;17805;2265;5;2326;50759043;43158796;1047352;1373;930547
FR;0;2021-09-27;33927;76986;47178;97;48134;50792970;43235782;1094530;1470;978681
FR;0;2021-09-28;36454;75275;54936;88;56493;50829424;43311057;1149466;1558;1035174
FR;0;2021-09-29;44319;100829;53323;112;54816;50873743;43411886;1202789;1670;1089990
FR;0;2021-09-30;36273;72838;57007;96;59485;50910016;43484724;1259796;1766;1149475
FR;0;2021-10-01;61540;100910;57781;108;63705;50971556;43585634;1317577;1874;1213180
FR;0;2021-10-02;39424;78363;20953;38;23319;51010980;43663997;1338530;1912;1236499
FR;0;2021-10-03;5269;10527;2524;4;2537;51016249;43674524;1341054;1916;1239036
FR;0;2021-10-04;34988;58546;52609;84;54782;51051237;43733070;1393663;2000;1293818
FR;0;2021-10-05;33614;64343;60968;135;64934;51084851;43797413;1454631;2135;1358752
FR;0;2021-10-06;42491;79263;65691;113;68228;51127342;43876676;1520322;2248;1426980
FR;0;2021-10-07;30428;62172;65380;90;68670;51157770;43938848;1585702;2338;1495650
FR;0;2021-10-08;48767;91821;77719;110;84622;51206537;44030669;1663421;2448;1580272
FR;0;2021-10-09;33632;60899;31524;36;33867;51240169;44091568;1694945;2484;1614139
FR;0;2021-10-10;4643;7442;3186;9;3482;51244812;44099010;1698131;2493;1617621
FR;0;2021-10-11;30572;49895;61020;105;64020;51275384;44148905;1759151;2598;1681641
FR;0;2021-10-12;31416;54439;70566;139;75836;51306800;44203344;1829717;2737;1757477
FR;0;2021-10-13;40010;62796;74399;135;79255;51346810;44266140;1904116;2872;1836732
FR;0;2021-10-14;30241;52905;68725;116;73764;51377051;44319045;1972841;2988;1910496
FR;0;2021-10-15;44746;75271;93218;191;102900;51421797;44394316;2066059;3179;2013396
FR;0;2021-10-16;31279;44086;36684;44;39613;51453076;44438402;2102743;3223;2053009
FR;0;2021-10-17;3829;5277;3591;2;3692;51456905;44443679;2106334;3225;2056701
FR;0;2021-10-18;28418;42475;67471;133;71336;51485323;44486154;2173805;3358;2128037
FR;0;2021-10-19;27061;44646;76381;140;81605;51512384;44530800;2250186;3498;2209642
FR;0;2021-10-20;35213;52468;96909;180;101473;51547597;44583268;2347095;3678;2311115
FR;0;2021-10-21;25972;45194;83923;112;89102;51573569;44628462;2431018;3790;2400217
FR;0;2021-10-22;38217;62380;104868;200;112497;51611786;44690842;2535886;3990;2512714
FR;0;2021-10-23;26976;41233;45437;57;48601;51638762;44732075;2581323;4047;2561315
FR;0;2021-10-24;2913;4803;3679;6;3937;51641675;44736878;2585002;4053;2565252
FR;0;2021-10-25;25983;36356;82308;144;86603;51667658;44773234;2667310;4197;2651855
FR;0;2021-10-26;23687;35089;87207;166;92310;51691345;44808323;2754517;4363;2744165
FR;0;2021-10-27;30023;46423;108968;257;114626;51721368;44854746;2863485;4620;2858791
FR;0;2021-10-28;23445;34910;88659;153;94393;51744813;44889656;2952144;4773;2953184
FR;0;2021-10-29;31520;51402;117286;204;125259;51776333;44941058;3069430;4977;3078443
FR;0;2021-10-30;20536;33155;50324;77;53354;51796869;44974213;3119754;5054;3131797
FR;0;2021-10-31;2480;3752;3585;3;3868;51799349;44977965;3123339;5057;3135665
FR;0;2021-11-01;8226;4820;3202;3;3557;51807575;44982785;3126541;5060;3139222
FR;0;2021-11-02;25318;40088;93535;157;99481;51832893;45022873;3220076;5217;3238703
FR;0;2021-11-03;29786;47933;118846;218;125791;51862679;45070806;3338922;5435;3364494
FR;0;2021-11-04;23675;37514;107503;217;114335;51886354;45108320;3446425;5652;3478829
FR;0;2021-11-05;32290;52907;141593;234;151264;51918644;45161227;3588018;5886;3630093
FR;0;2021-11-06;21496;34560;64845;123;68230;51940140;45195787;3652863;6009;3698323
FR;0;2021-11-07;2380;4227;5180;6;5590;51942520;45200014;3658043;6015;3703913
FR;0;2021-11-08;20443;37842;127136;227;134191;51962963;45237856;3785179;6242;3838104
FR;0;2021-11-09;22173;44822;161630;341;172135;51985136;45282678;3946809;6583;4010239
FR;0;2021-11-10;31408;55119;186937;446;198691;52016544;45337797;4133746;7029;4208930
FR;0;2021-11-11;4357;6748;12932;28;13932;52020901;45344545;4146678;7057;4222862
FR;0;2021-11-12;28995;55142;183723;252;197269;52049896;45399687;4330401;7309;4420131
FR;0;2021-11-13;20310;32716;80678;118;86292;52070206;45432403;4411079;7427;4506423
FR;0;2021-11-14;2337;3942;7164;6;7874;52072543;45436345;4418243;7433;4514297
FR;0;2021-11-15;20343;38786;160794;312;171463;52092886;45475131;4579037;7745;4685760
FR;0;2021-11-16;23405;44051;200322;391;214888;52116291;45519182;4779359;8136;4900648
FR;0;2021-11-17;30375;50475;199779;407;212789;52146666;45569657;4979138;8543;5113437
FR;0;2021-11-18;23362;45099;191577;468;205410;52170028;45614756;5170715;9011;5318847
FR;0;2021-11-19;33563;61402;243132;548;262072;52203591;45676158;5413847;9559;5580919
FR;0;2021-11-20;25357;36784;102121;206;109673;52228948;45712942;5515968;9765;5690592
FR;0;2021-11-21;2623;4563;9641;18;10641;52231571;45717505;5525609;9783;5701233
FR;0;2021-11-22;22741;33379;180288;470;194758;52254312;45750884;5705897;10253;5895991
FR;0;2021-11-23;25570;45729;229307;548;247732;52279882;45796613;5935204;10801;6143723
FR;0;2021-11-24;31770;53840;224741;717;243150;52311652;45850453;6159945;11518;6386873
FR;0;2021-11-25;25412;49162;255833;739;277596;52337064;45899615;6415778;12257;6664469
FR;0;2021-11-26;33215;74705;379389;864;414510;52370279;45974320;6795167;13121;7078979
FR;0;2021-11-27;23337;49722;214846;389;236581;52393616;46024042;7010013;13510;7315560
FR;0;2021-11-28;3479;10585;56732;66;63339;52397095;46034627;7066745;13576;7378899
FR;0;2021-11-29;19390;54260;341382;863;371563;52416485;46088887;7408127;14439;7750462
FR;0;2021-11-30;24732;72145;457291;988;500648;52441217;46161032;7865418;15427;8251110
FR;0;2021-12-01;26933;75977;468980;1159;511194;52468150;46237009;8334398;16586;8762304
FR;0;2021-12-02;21999;71844;526987;1280;574716;52490149;46308853;8861385;17866;9337020
FR;0;2021-12-03;25491;92548;596248;1419;650994;52515640;46401401;9457633;19285;9988014
FR;0;2021-12-04;18296;60547;336166;690;369705;52533936;46461948;9793799;19975;10357719
FR;0;2021-12-05;4142;16261;95753;157;107053;52538078;46478209;9889552;20132;10464772
FR;0;2021-12-06;23971;73244;493033;1174;539846;52562049;46551453;10382585;21306;11004618
FR;0;2021-12-07;23336;91810;645258;1769;706188;52585385;46643263;11027843;23075;11710806
FR;0;2021-12-08;25356;92503;591445;1873;647376;52610741;46735766;11619288;24948;12358182
FR;0;2021-12-09;24006;94373;662944;2179;726207;52634747;46830139;12282232;27127;13084389
FR;0;2021-12-10;27851;111128;735927;2076;805970;52662598;46941267;13018159;29203;13890359
FR;0;2021-12-11;20226;76073;435120;986;480324;52682824;47017340;13453279;30189;14370683
FR;0;2021-12-12;5625;23277;142269;262;159216;52688449;47040617;13595548;30451;14529899
FR;0;2021-12-13;21176;91328;587517;1697;649182;52709625;47131945;14183065;32148;15179081
FR;0;2021-12-14;27658;118710;765375;2652;847364;52737283;47250655;14948440;34800;16026445
FR;0;2021-12-15;28255;114597;694182;2263;768923;52765538;47365252;15642622;37063;16795368
FR;0;2021-12-16;27953;116091;763876;2555;844275;52793491;47481343;16406498;39618;17639643
FR;0;2021-12-17;31578;128818;807726;2709;891990;52825069;47610161;17214224;42327;18531633
FR;0;2021-12-18;24917;81779;469909;1178;522158;52849986;47691940;17684133;43505;19053791
FR;0;2021-12-19;8741;28837;169352;377;191134;52858727;47720777;17853485;43882;19244925
FR;0;2021-12-20;31645;97596;591338;1787;658627;52890372;47818373;18444823;45669;19903552
FR;0;2021-12-21;39232;112412;682298;2391;759466;52929604;47930785;19127121;48060;20663018
FR;0;2021-12-22;39476;99689;575651;2167;642044;52969080;48030474;19702772;50227;21305062
FR;0;2021-12-23;33749;79770;440898;1654;494322;53002829;48110244;20143670;51881;21799384
FR;0;2021-12-24;10667;26074;110977;396;126642;53013496;48136318;20254647;52277;21926026
FR;0;2021-12-25;770;3513;7573;25;9029;53014266;48139831;20262220;52302;21935055
FR;0;2021-12-26;4698;11913;52075;141;60132;53018964;48151744;20314295;52443;21995187
FR;0;2021-12-27;30416;84107;453449;1366;509082;53049380;48235851;20767744;53809;22504269
FR;0;2021-12-28;38323;99112;564073;1767;632170;53087703;48334963;21331817;55576;23136439
FR;0;2021-12-29;39848;88470;501120;1686;560930;53127551;48423433;21832937;57262;23697369
FR;0;2021-12-30;35893;75159;420963;1519;471099;53163444;48498592;22253900;58781;24168468
FR;0;2021-12-31;12039;25225;116837;406;131620;53175483;48523817;22370737;59187;24300088
FR;0;2022-01-01;1422;3205;8500;36;9931;53176905;48527022;22379237;59223;24310019
FR;0;2022-01-02;6088;13016;58397;125;66941;53182993;48540038;22437634;59348;24376960
FR;0;2022-01-03;33263;89993;494692;1593;551507;53216256;48630031;22932326;60941;24928467
FR;0;2022-01-04;41146;110954;641282;2303;714243;53257402;48740985;23573608;63244;25642710
FR;0;2022-01-05;60489;103438;569048;1984;634081;53317891;48844423;24142656;65228;26276791
FR;0;2022-01-06;44075;110202;638890;2694;711339;53361966;48954625;24781546;67922;26988130
FR;0;2022-01-07;50680;123158;710910;2807;790355;53412646;49077783;25492456;70729;27778485
FR;0;2022-01-08;44967;80343;423782;1210;472856;53457613;49158126;25916238;71939;28251341
FR;0;2022-01-09;15597;26696;128547;300;145689;53473210;49184822;26044785;72239;28397030
FR;0;2022-01-10;35142;89590;469202;1810;522286;53508352;49274412;26513987;74049;28919316
FR;0;2022-01-11;41688;100358;548136;2307;608404;53550040;49374770;27062123;76356;29527720
FR;0;2022-01-12;60207;95604;452566;1965;504230;53610247;49470374;27514689;78321;30031950
FR;0;2022-01-13;37992;92417;487250;2083;540956;53648239;49562791;28001939;80404;30572906
FR;0;2022-01-14;42427;103313;568490;2286;628960;53690666;49666104;28570429;82690;31201866
FR;0;2022-01-15;39316;65879;340093;985;377554;53729982;49731983;28910522;83675;31579420
FR;0;2022-01-16;11382;19299;87384;215;99445;53741364;49751282;28997906;83890;31678865
FR;0;2022-01-17;24626;60116;320212;1381;354129;53765990;49811398;29318118;85271;32032994
FR;0;2022-01-18;28113;68618;361003;1799;397513;53794103;49880016;29679121;87070;32430507
FR;0;2022-01-19;43087;67116;281215;1450;311061;53837190;49947132;29960336;88520;32741568
FR;0;2022-01-20;23452;59531;298909;1740;328432;53860642;50006663;30259245;90260;33070000
FR;0;2022-01-21;28052;68787;366282;2086;401129;53888694;50075450;30625527;92346;33471129
FR;0;2022-01-22;27606;47967;218763;838;241745;53916300;50123417;30844290;93184;33712874
FR;0;2022-01-23;6704;13036;48648;171;55173;53923004;50136453;30892938;93355;33768047
FR;0;2022-01-24;16210;47332;217245;1136;239320;53939214;50183785;31110183;94491;34007367
FR;0;2022-01-25;18917;54371;242978;1547;267036;53958131;50238156;31353161;96038;34274403
FR;0;2022-01-26;28121;60270;209216;1296;229360;53986252;50298426;31562377;97334;34503763
FR;0;2022-01-27;16283;46081;207582;1272;225830;54002535;50344507;31769959;98606;34729593
FR;0;2022-01-28;21503;75992;289989;1574;321445;54024038;50420499;32059948;100180;35051038
FR;0;2022-01-29;18405;52851;184088;686;204574;54042443;50473350;32244036;100866;35255612
FR;0;2022-01-30;4464;14538;39123;124;45085;54046907;50487888;32283159;100990;35300697
FR;0;2022-01-31;11226;43837;148151;738;164786;54058133;50531725;32431310;101728;35465483
FR;0;2022-02-01;12908;48173;174064;1142;191366;54071041;50579898;32605374;102870;35656849
FR;0;2022-02-02;20130;65966;171469;1033;190130;54091171;50645864;32776843;103903;35846979
FR;0;2022-02-03;11004;44225;157491;984;173301;54102175;50690089;32934334;104887;36020280
FR;0;2022-02-04;14523;66459;239177;1262;264165;54116698;50756548;33173511;106149;36284445
FR;0;2022-02-05;12790;51446;153520;522;172342;54129488;50807994;33327031;106671;36456787
FR;0;2022-02-06;2706;12231;28870;101;33825;54132194;50820225;33355901;106772;36490612
FR;0;2022-02-07;9402;46716;156823;586;176322;54141596;50866941;33512724;107358;36666934
FR;0;2022-02-08;9614;42744;166563;868;184332;54151210;50909685;33679287;108226;36851266
FR;0;2022-02-09;14183;57952;172292;869;192970;54165393;50967637;33851579;109095;37044236
FR;0;2022-02-10;8275;38471;150158;878;166610;54173668;51006108;34001737;109973;37210846
FR;0;2022-02-11;10768;55505;218442;1097;243018;54184436;51061613;34220179;111070;37453864
FR;0;2022-02-12;8353;40886;134692;461;151709;54192789;51102499;34354871;111531;37605573
FR;0;2022-02-13;1895;8579;26551;85;30907;54194684;51111078;34381422;111616;37636480
FR;0;2022-02-14;6912;35113;148320;478;166315;54201596;51146191;34529742;112094;37802795
FR;0;2022-02-15;6864;35515;146909;750;162457;54208460;51181706;34676651;112844;37965252
FR;0;2022-02-16;9302;42716;132481;719;146676;54217762;51224422;34809132;113563;38111928
FR;0;2022-02-17;5377;23922;87256;584;94802;54223139;51248344;34896388;114147;38206730
FR;0;2022-02-18;6922;33316;119602;802;129262;54230061;51281660;35015990;114949;38335992
FR;0;2022-02-19;5350;24453;70006;370;77309;54235411;51306113;35085996;115319;38413301
FR;0;2022-02-20;1139;4618;12152;38;13926;54236550;51310731;35098148;115357;38427227
FR;0;2022-02-21;4029;17776;61914;351;67141;54240579;51328507;35160062;115708;38494368
FR;0;2022-02-22;4376;18501;60786;575;64417;54244955;51347008;35220848;116283;38558785
FR;0;2022-02-23;6518;27190;66468;591;71865;54251473;51374198;35287316;116874;38630650
FR;0;2022-02-24;3751;15205;50379;518;53193;54255224;51389403;35337695;117392;38683843
FR;0;2022-02-25;5211;23660;76285;803;80009;54260435;51413063;35413980;118195;38763852
FR;0;2022-02-26;3971;17656;47395;358;51460;54264406;51430719;35461375;118553;38815312
FR;0;2022-02-27;870;2988;8022;47;8933;54265276;51433707;35469397;118600;38824245
FR;0;2022-02-28;3071;12286;40451;354;42884;54268347;51445993;35509848;118954;38867129
FR;0;2022-03-01;3191;12256;44134;433;44772;54271538;51458249;35553982;119387;38911901
FR;0;2022-03-02;5094;17495;47089;438;49000;54276632;51475744;35601071;119825;38960901
FR;0;2022-03-03;2684;8966;29832;362;29926;54279316;51484710;35630903;120187;38990827
FR;0;2022-03-04;3187;12207;40261;650;39392;54282503;51496917;35671164;120837;39030219
FR;0;2022-03-05;2992;9211;24933;310;25085;54285495;51506128;35696097;121147;39055304
FR;0;2022-03-06;510;1383;3193;42;3431;54286005;51507511;35699290;121189;39058735
FR;0;2022-03-07;2010;5480;18397;314;17659;54288015;51512991;35717687;121503;39076394
FR;0;2022-03-08;1975;5909;19411;359;17871;54289990;51518900;35737098;121862;39094265
FR;0;2022-03-09;3462;10298;22149;405;21230;54293452;51529198;35759247;122267;39115495
FR;0;2022-03-10;1718;5269;16904;341;15707;54295170;51534467;35776151;122608;39131202
FR;0;2022-03-11;2346;7310;24475;540;22234;54297516;51541777;35800626;123148;39153436
FR;0;2022-03-12;2655;6718;17149;304;16500;54300171;51548495;35817775;123452;39169936
FR;0;2022-03-13;386;782;2306;144;2257;54300557;51549277;35820081;123596;39172193
FR;0;2022-03-14;1472;4157;14936;4404;13790;54302029;51553434;35835017;128000;39185983
FR;0;2022-03-15;1600;4385;16239;7549;14346;54303629;51557819;35851256;135549;39200329
FR;0;2022-03-16;2945;7081;19375;13128;18040;54306574;51564900;35870631;148677;39218369
FR;0;2022-03-17;1375;3731;13095;10836;11936;54307949;51568631;35883726;159513;39230305
FR;0;2022-03-18;2205;5543;19950;18277;18035;54310154;51574174;35903676;177790;39248340
FR;0;2022-03-19;2278;4695;13104;9396;12404;54312432;51578869;35916780;187186;39260744
FR;0;2022-03-20;293;709;1912;1066;1921;54312725;51579578;35918692;188252;39262665
FR;0;2022-03-21;1344;3139;12695;14929;11915;54314069;51582717;35931387;203181;39274580
FR;0;2022-03-22;1464;3593;13759;20518;12516;54315533;51586310;35945146;223699;39287096
FR;0;2022-03-23;2643;6101;17663;23133;17170;54318176;51592411;35962809;246832;39304266
FR;0;2022-03-24;1356;2928;11553;17572;10625;54319532;51595339;35974362;264404;39314891
FR;0;2022-03-25;2047;4850;18508;27738;16837;54321579;51600189;35992870;292142;39331728
FR;0;2022-03-26;2218;4304;12061;12656;11498;54323797;51604493;36004931;304798;39343226
FR;0;2022-03-27;354;681;1892;1478;1925;54324151;51605174;36006823;306276;39345151
FR;0;2022-03-28;1414;2971;11085;17452;10577;54325565;51608145;36017908;323728;39355728
FR;0;2022-03-29;1421;3230;12875;27530;12020;54326986;51611375;36030783;351258;39367748
FR;0;2022-03-30;2814;5373;15630;27342;15023;54329800;51616748;36046413;378600;39382771
FR;0;2022-03-31;1594;3169;12911;24886;12242;54331394;51619917;36059324;403486;39395013
FR;0;2022-04-01;2099;4318;19987;30813;18601;54333493;51624235;36079311;434299;39413614
FR;0;2022-04-02;1497;2609;9033;10101;8692;54334990;51626844;36088344;444400;39422306
FR;0;2022-04-03;275;499;1557;1168;1573;54335265;51627343;36089901;445568;39423879
FR;0;2022-04-04;1367;2572;12282;19067;11469;54336632;51629915;36102183;464635;39435348
FR;0;2022-04-05;1595;2932;14263;33982;13110;54338227;51632847;36116446;498617;39448458
FR;0;2022-04-06;2040;3646;13444;26309;12684;54340267;51636493;36129890;524926;39461142
FR;0;2022-04-07;1430;2876;13591;33659;12797;54341697;51639369;36143481;558585;39473939
FR;0;2022-04-08;2019;4074;19135;43629;17751;54343716;51643443;36162616;602214;39491690
FR;0;2022-04-09;1346;2651;9293;13539;8840;54345062;51646094;36171909;615753;39500530
FR;0;2022-04-10;277;561;1969;1992;1978;54345339;51646655;36173878;617745;39502508
FR;0;2022-04-11;1192;2456;11818;23634;11421;54346531;51649111;36185696;641379;39513929
FR;0;2022-04-12;1568;2776;13925;40581;13301;54348099;51651887;36199621;681960;39527230
FR;0;2022-04-13;1854;3422;13321;32771;12916;54349953;51655309;36212942;714731;39540146
FR;0;2022-04-14;1438;2666;13082;35975;12929;54351391;51657975;36226024;750706;39553075
FR;0;2022-04-15;1784;3293;15513;35249;14760;54353175;51661268;36241537;785955;39567835
FR;0;2022-04-16;1031;1812;6368;8517;6220;54354206;51663080;36247905;794472;39574055
FR;0;2022-04-17;185;317;990;1161;1029;54354391;51663397;36248895;795633;39575084
FR;0;2022-04-18;153;446;2739;1047;2758;54354544;51663843;36251634;796680;39577842
FR;0;2022-04-19;1466;2908;12846;29393;12354;54356010;51666751;36264480;826073;39590196
FR;0;2022-04-20;1906;3334;13199;28780;12858;54357916;51670085;36277679;854853;39603054
FR;0;2022-04-21;1474;2728;12428;34754;12446;54359390;51672813;36290107;889607;39615500
FR;0;2022-04-22;1823;3466;16404;37438;15770;54361213;51676279;36306511;927045;39631270
FR;0;2022-04-23;1126;2036;7363;10639;7212;54362339;51678315;36313874;937684;39638482
FR;0;2022-04-24;244;441;1470;1578;1404;54362583;51678756;36315344;939262;39639886
FR;0;2022-04-25;1256;2445;10640;20868;10431;54363839;51681201;36325984;960130;39650317
FR;0;2022-04-26;1566;2950;13597;38287;13039;54365405;51684151;36339581;998417;39663356
FR;0;2022-04-27;1907;3000;11443;30507;11498;54367312;51687151;36351024;1028924;39674854
FR;0;2022-04-28;1521;2643;12440;35738;12156;54368833;51689794;36363464;1064662;39687010
FR;0;2022-04-29;1954;3433;15439;36873;14787;54370787;51693227;36378903;1101535;39701797
FR;0;2022-04-30;1182;1798;6844;9652;6664;54371969;51695025;36385747;1111187;39708461
FR;0;2022-05-01;186;301;889;960;885;54372155;51695326;36386636;1112147;39709346
FR;0;2022-05-02;1161;2142;10972;17844;10749;54373316;51697468;36397608;1129991;39720095
FR;0;2022-05-03;1733;2873;13440;34201;13270;54375049;51700341;36411048;1164192;39733365
FR;0;2022-05-04;1805;2943;11814;25316;11915;54376854;51703284;36422862;1189508;39745280
FR;0;2022-05-05;1614;2633;12420;33026;12208;54378468;51705917;36435282;1222534;39757488
FR;0;2022-05-06;2043;3507;15144;36432;14614;54380511;51709424;36450426;1258966;39772102
FR;0;2022-05-07;1171;1752;6395;9581;6383;54381682;51711176;36456821;1268547;39778485
FR;0;2022-05-08;254;387;1160;1528;1219;54381936;51711563;36457981;1270075;39779704
FR;0;2022-05-09;1248;2119;9796;19964;9660;54383184;51713682;36467777;1290039;39789364
FR;0;2022-05-10;1620;2851;13259;38437;12803;54384804;51716533;36481036;1328476;39802167
FR;0;2022-05-11;1914;2696;10574;27561;10481;54386718;51719229;36491610;1356037;39812648
FR;0;2022-05-12;1507;2488;11099;35094;10722;54388225;51721717;36502709;1391131;39823370
FR;0;2022-05-13;1910;3089;13581;37499;13167;54390135;51724806;36516290;1428630;39836537
FR;0;2022-05-14;1117;1586;5837;10692;5687;54391252;51726392;36522127;1439322;39842224
FR;0;2022-05-15;264;414;1236;1419;1313;54391516;51726806;36523363;1440741;39843537
FR;0;2022-05-16;1136;1914;8448;20700;8425;54392652;51728720;36531811;1461441;39851962
FR;0;2022-05-17;1523;2477;11620;37253;11198;54394175;51731197;36543431;1498694;39863160
FR;0;2022-05-18;1724;2498;9298;26764;9274;54395899;51733695;36552729;1525458;39872434
FR;0;2022-05-19;1373;2499;10326;34970;10366;54397272;51736194;36563055;1560428;39882800
FR;0;2022-05-20;1818;2953;13024;38856;12526;54399090;51739147;36576079;1599284;39895326
FR;0;2022-05-21;1128;1653;5570;9753;5439;54400218;51740800;36581649;1609037;39900765
FR;0;2022-05-22;227;322;1001;1380;982;54400445;51741122;36582650;1610417;39901747
FR;0;2022-05-23;1097;1918;8142;19872;8084;54401542;51743040;36590792;1630289;39909831
FR;0;2022-05-24;1476;2630;10659;37888;10517;54403018;51745670;36601451;1668177;39920348
FR;0;2022-05-25;1751;2692;9018;24304;9123;54404769;51748362;36610469;1692481;39929471
FR;0;2022-05-26;166;295;1098;1094;1138;54404935;51748657;36611567;1693575;39930609
FR;0;2022-05-27;1306;2268;8272;21077;8057;54406241;51750925;36619839;1714652;39938666
FR;0;2022-05-28;635;1202;3598;6743;3663;54406876;51752127;36623437;1721395;39942329
FR;0;2022-05-29;139;299;717;875;732;54407015;51752426;36624154;1722270;39943061
FR;0;2022-05-30;968;1833;6389;18894;6377;54407983;51754259;36630543;1741164;39949438
FR;0;2022-05-31;1432;2349;9531;35089;9373;54409415;51756608;36640074;1776253;39958811
FR;0;2022-06-01;1498;2471;7796;23717;7699;54410913;51759079;36647870;1799970;39966510
FR;0;2022-06-02;1334;2326;8909;34694;8524;54412247;51761405;36656779;1834664;39975034
FR;0;2022-06-03;1565;2816;10332;38085;9919;54413812;51764221;36667111;1872749;39984953
FR;0;2022-06-04;901;1428;4224;8932;4305;54414713;51765649;36671335;1881681;39989258
FR;0;2022-06-05;147;292;777;1002;782;54414860;51765941;36672112;1882683;39990040
FR;0;2022-06-06;136;249;765;1081;766;54414996;51766190;36672877;1883764;39990806
FR;0;2022-06-07;1258;2406;8797;34767;8394;54416254;51768596;36681674;1918531;39999200
FR;0;2022-06-08;1444;2447;7729;27827;7556;54417698;51771043;36689403;1946358;40006756
FR;0;2022-06-09;1155;2135;8263;37167;7912;54418853;51773178;36697666;1983525;40014668
