fra;vaccin;jour;n_dose1;n_dose2;n_dose3;n_dose4;n_complet;n_rappel;n_2_rappel;n_rappel_biv;n_3_rappel;n_cum_dose1;n_cum_dose2;n_cum_dose3;n_cum_dose4;n_cum_complet;n_cum_rappel;n_cum_2_rappel;n_cum_rappel_biv;n_cum_3_rappel
FR;1;2020-12-27;616;0;0;0;55;0;0;0;0;616;0;0;0;55;0;0;0;0
FR;1;2020-12-28;702;1;0;0;43;0;0;0;0;1318;1;0;0;98;0;0;0;0
FR;1;2020-12-29;387;0;0;0;19;0;0;0;0;1705;1;0;0;117;0;0;0;0
FR;1;2020-12-30;450;0;0;0;18;0;0;0;0;2155;1;0;0;135;0;0;0;0
FR;1;2020-12-31;446;1;0;0;23;0;0;0;0;2601;2;0;0;158;0;0;0;0
FR;1;2021-01-01;1188;2;0;0;65;0;0;0;0;3789;4;0;0;223;0;0;0;0
FR;1;2021-01-02;366;4;0;0;29;0;0;0;0;4155;8;0;0;252;0;0;0;0
FR;1;2021-01-03;412;0;0;0;23;0;0;0;0;4567;8;0;0;275;0;0;0;0
FR;1;2021-01-04;2127;4;0;0;50;0;0;0;0;6694;12;0;0;325;0;0;0;0
FR;1;2021-01-05;7764;6;0;0;128;0;0;0;0;14458;18;0;0;453;0;0;0;0
FR;1;2021-01-06;12468;23;0;0;127;0;0;0;0;26926;41;0;0;580;0;0;0;0
FR;1;2021-01-07;29475;23;0;0;159;0;0;0;0;56401;64;0;0;739;0;0;0;0
FR;1;2021-01-08;37165;34;0;0;203;0;0;0;0;93566;98;0;0;942;0;0;0;0
FR;1;2021-01-09;11219;9;0;0;77;0;0;0;0;104785;107;0;0;1019;0;0;0;0
FR;1;2021-01-10;6012;8;0;0;28;0;0;0;0;110797;115;0;0;1047;0;0;0;0
FR;1;2021-01-11;39952;36;0;0;229;0;0;0;0;150749;151;0;0;1276;0;0;0;0
FR;1;2021-01-12;62156;27;0;0;297;0;0;0;0;212905;178;0;0;1573;0;0;0;0
FR;1;2021-01-13;65145;60;0;0;432;0;0;0;0;278050;238;0;0;2005;0;0;0;0
FR;1;2021-01-14;81465;237;0;0;959;0;0;0;0;359515;475;0;0;2964;0;0;0;0
FR;1;2021-01-15;68630;95;0;0;526;0;0;0;0;428145;570;0;0;3490;0;0;0;0
FR;1;2021-01-16;19903;73;0;0;172;0;0;0;0;448048;643;0;0;3662;0;0;0;0
FR;1;2021-01-17;10906;54;0;0;131;0;0;0;0;458954;697;0;0;3793;0;0;0;0
FR;1;2021-01-18;82843;177;0;0;590;0;0;0;0;541797;874;0;0;4383;0;0;0;0
FR;1;2021-01-19;125933;207;0;0;837;0;0;0;0;667730;1081;0;0;5220;0;0;0;0
FR;1;2021-01-20;132426;188;0;0;779;0;0;0;0;800156;1269;0;0;5999;0;0;0;0
FR;1;2021-01-21;153079;189;0;0;889;0;0;0;0;953235;1458;0;0;6888;0;0;0;0
FR;1;2021-01-22;115963;238;0;0;776;0;0;0;0;1069198;1696;0;0;7664;0;0;0;0
FR;1;2021-01-23;36616;78;0;0;201;0;0;0;0;1105814;1774;0;0;7865;0;0;0;0
FR;1;2021-01-24;9586;127;0;0;186;0;0;0;0;1115400;1901;0;0;8051;0;0;0;0
FR;1;2021-01-25;74436;1442;0;0;1761;0;0;0;0;1189836;3343;0;0;9812;0;0;0;0
FR;1;2021-01-26;96464;3685;1;0;4128;0;0;0;0;1286300;7028;1;0;13940;0;0;0;0
FR;1;2021-01-27;103656;6399;0;0;7083;0;0;0;0;1389956;13427;1;0;21023;0;0;0;0
FR;1;2021-01-28;120621;16352;0;0;17141;0;0;0;0;1510577;29779;1;0;38164;0;0;0;0
FR;1;2021-01-29;88901;18704;0;0;19242;0;0;0;0;1599478;48483;1;0;57406;0;0;0;0
FR;1;2021-01-30;27995;4509;0;0;4632;0;0;0;0;1627473;52992;1;0;62038;0;0;0;0
FR;1;2021-01-31;5194;1899;0;0;1937;0;0;0;0;1632667;54891;1;0;63975;0;0;0;0
FR;1;2021-02-01;49744;22912;0;0;23145;0;0;0;0;1682411;77803;1;0;87120;0;0;0;0
FR;1;2021-02-02;67836;37989;0;0;38444;0;0;0;0;1750247;115792;1;0;125564;0;0;0;0
FR;1;2021-02-03;67102;40043;0;0;40472;0;0;0;0;1817349;155835;1;0;166036;0;0;0;0
FR;1;2021-02-04;77149;54801;0;0;55368;0;0;0;0;1894498;210636;1;0;221404;0;0;0;0
FR;1;2021-02-05;63431;47999;0;0;48398;0;0;0;0;1957929;258635;1;0;269802;0;0;0;0
FR;1;2021-02-06;19427;11392;0;0;11499;0;0;0;0;1977356;270027;1;0;281301;0;0;0;0
FR;1;2021-02-07;3669;6021;0;0;6048;0;0;0;0;1981025;276048;1;0;287349;0;0;0;0
FR;1;2021-02-08;36508;48640;0;0;48879;0;0;0;0;2017533;324688;1;0;336228;0;0;0;0
FR;1;2021-02-09;50821;78089;0;0;78611;0;0;0;0;2068354;402777;1;0;414839;0;0;0;0
FR;1;2021-02-10;52077;83078;0;0;83553;0;0;0;0;2120431;485855;1;0;498392;0;0;0;0
FR;1;2021-02-11;63394;105060;0;0;105942;0;0;0;0;2183825;590915;1;0;604334;0;0;0;0
FR;1;2021-02-12;55882;75681;0;0;76356;0;0;0;0;2239707;666596;1;0;680690;0;0;0;0
FR;1;2021-02-13;15468;19307;0;0;19418;0;0;0;0;2255175;685903;1;0;700108;0;0;0;0
FR;1;2021-02-14;3747;7358;0;0;7423;0;0;0;0;2258922;693261;1;0;707531;0;0;0;0
FR;1;2021-02-15;24171;73606;0;0;73846;0;0;0;0;2283093;766867;1;0;781377;0;0;0;0
FR;1;2021-02-16;32783;95620;0;0;96008;0;0;0;0;2315876;862487;1;0;877385;0;0;0;0
FR;1;2021-02-17;35132;102218;20;0;102862;0;0;0;0;2351008;964705;21;0;980247;0;0;0;0
FR;1;2021-02-18;49463;118292;0;0;119269;0;0;0;0;2400471;1082997;21;0;1099516;0;0;0;0
FR;1;2021-02-19;45395;87633;1;0;88565;0;0;0;0;2445866;1170630;22;0;1188081;0;0;0;0
FR;1;2021-02-20;13398;27045;0;0;27220;0;0;0;0;2459264;1197675;22;0;1215301;0;0;0;0
FR;1;2021-02-21;2469;5983;0;0;6051;0;0;0;0;2461733;1203658;22;0;1221352;0;0;0;0
FR;1;2021-02-22;24723;69405;2;0;69697;0;0;0;0;2486456;1273063;24;0;1291049;0;0;0;0
FR;1;2021-02-23;37437;81501;1;0;82192;0;0;0;0;2523893;1354564;25;0;1373241;0;0;0;0
FR;1;2021-02-24;40711;79265;1;0;79960;0;0;0;0;2564604;1433829;26;0;1453201;0;0;0;0
FR;1;2021-02-25;50172;87864;1;0;88946;0;0;0;0;2614776;1521693;27;0;1542147;0;0;0;0
FR;1;2021-02-26;47231;67575;1;0;68446;0;0;0;0;2662007;1589268;28;0;1610593;0;0;0;0
FR;1;2021-02-27;15689;21340;1;0;21549;0;0;0;0;2677696;1610608;29;0;1632142;0;0;0;0
FR;1;2021-02-28;3565;4110;2;0;4182;0;0;0;0;2681261;1614718;31;0;1636324;0;0;0;0
FR;1;2021-03-01;40222;50279;1;0;51003;0;0;0;0;2721483;1664997;32;0;1687327;0;0;0;0
FR;1;2021-03-02;55992;62411;3;0;63586;0;0;0;0;2777475;1727408;35;0;1750913;0;0;0;0
FR;1;2021-03-03;61261;60485;0;0;61911;0;0;0;0;2838736;1787893;35;0;1812824;0;0;0;0
FR;1;2021-03-04;73017;68283;3;0;70492;0;0;0;0;2911753;1856176;38;0;1883316;0;0;0;0
FR;1;2021-03-05;74782;58628;3;0;60522;0;0;0;0;2986535;1914804;41;0;1943838;0;0;0;0
FR;1;2021-03-06;82467;15756;2;0;17460;0;0;0;0;3069002;1930560;43;0;1961298;0;0;0;0
FR;1;2021-03-07;63733;3983;1;0;5527;0;0;0;0;3132735;1934543;44;0;1966825;0;0;0;0
FR;1;2021-03-08;60193;41185;2;0;42466;0;0;0;0;3192928;1975728;46;0;2009291;0;0;0;0
FR;1;2021-03-09;86009;47438;1;0;49430;0;0;0;0;3278937;2023166;47;0;2058721;0;0;0;0
FR;1;2021-03-10;90945;47790;5;0;50053;0;0;0;0;3369882;2070956;52;0;2108774;0;0;0;0
FR;1;2021-03-11;105102;54576;1;0;57638;0;0;0;0;3474984;2125532;53;0;2166412;0;0;0;0
FR;1;2021-03-12;104159;44888;1;0;47884;0;0;0;0;3579143;2170420;54;0;2214296;0;0;0;0
FR;1;2021-03-13;89221;12597;1;0;14814;0;0;0;0;3668364;2183017;55;0;2229110;0;0;0;0
FR;1;2021-03-14;44460;2686;1;0;4018;0;0;0;0;3712824;2185703;56;0;2233128;0;0;0;0
FR;1;2021-03-15;95537;28001;3;0;30344;0;0;0;0;3808361;2213704;59;0;2263472;0;0;0;0
FR;1;2021-03-16;123604;34061;5;0;37603;0;0;0;0;3931965;2247765;64;0;2301075;0;0;0;0
FR;1;2021-03-17;129324;33556;4;0;37608;0;0;0;0;4061289;2281321;68;0;2338683;0;0;0;0
FR;1;2021-03-18;142918;39225;5;0;43896;0;0;0;0;4204207;2320546;73;0;2382579;0;0;0;0
FR;1;2021-03-19;136274;32007;2;0;36596;0;0;0;0;4340481;2352553;75;0;2419175;0;0;0;0
FR;1;2021-03-20;76023;9766;1;0;11983;0;0;0;0;4416504;2362319;76;0;2431158;0;0;0;0
FR;1;2021-03-21;26519;1991;1;0;2980;0;0;0;0;4443023;2364310;77;0;2434138;0;0;0;0
FR;1;2021-03-22;114776;30252;2;0;34075;0;0;0;0;4557799;2394562;79;0;2468213;0;0;0;0
FR;1;2021-03-23;143056;38031;1;0;42818;0;0;0;0;4700855;2432593;80;0;2511031;0;0;0;0
FR;1;2021-03-24;142024;38359;0;0;43218;0;0;0;0;4842879;2470952;80;0;2554249;0;0;0;0
FR;1;2021-03-25;165034;39857;4;0;46010;0;0;0;0;5007913;2510809;84;0;2600259;0;0;0;0
FR;1;2021-03-26;166419;37410;5;1;44018;0;0;0;0;5174332;2548219;89;1;2644277;0;0;0;0
FR;1;2021-03-27;110904;15473;1;0;19483;0;0;0;0;5285236;2563692;90;1;2663760;0;0;0;0
FR;1;2021-03-28;42310;4394;3;0;5949;0;0;0;0;5327546;2568086;93;1;2669709;0;0;0;0
FR;1;2021-03-29;129844;49024;4;0;53678;0;0;0;0;5457390;2617110;97;1;2723387;0;0;0;0
FR;1;2021-03-30;167745;63783;5;0;70789;0;0;0;0;5625135;2680893;102;1;2794176;0;0;0;0
FR;1;2021-03-31;170969;67925;4;0;75455;0;0;0;0;5796104;2748818;106;1;2869631;0;0;0;0
FR;1;2021-04-01;194868;83938;10;0;93433;0;0;0;0;5990972;2832756;116;1;2963064;0;0;0;0
FR;1;2021-04-02;164469;86775;7;0;94590;0;0;0;0;6155441;2919531;123;1;3057654;0;0;0;0
FR;1;2021-04-03;88258;58188;6;0;61730;0;0;0;0;6243699;2977719;129;1;3119384;0;0;0;0
FR;1;2021-04-04;33660;17722;0;0;19219;0;0;0;0;6277359;2995441;129;1;3138603;0;0;0;0
FR;1;2021-04-05;46424;9593;11;0;11470;0;0;0;0;6323783;3005034;140;1;3150073;0;0;0;0
FR;1;2021-04-06;160342;105489;17;0;111958;0;0;0;0;6484125;3110523;157;1;3262031;0;0;0;0
FR;1;2021-04-07;197031;108104;16;0;116926;0;0;0;0;6681156;3218627;173;1;3378957;0;0;0;0
FR;1;2021-04-08;222185;114221;14;0;125562;0;0;0;0;6903341;3332848;187;1;3504519;0;0;0;0
FR;1;2021-04-09;214603;108013;21;0;118898;0;0;0;0;7117944;3440861;208;1;3623417;0;0;0;0
FR;1;2021-04-10;117203;73226;14;0;78366;0;0;0;0;7235147;3514087;222;1;3701783;0;0;0;0
FR;1;2021-04-11;40901;29897;6;0;31800;0;0;0;0;7276048;3543984;228;1;3733583;0;0;0;0
FR;1;2021-04-12;168502;104557;46;0;111789;0;0;0;0;7444550;3648541;274;1;3845372;0;0;0;0
FR;1;2021-04-13;203838;127782;97;1;137115;0;0;0;0;7648388;3776323;371;2;3982487;0;0;0;0
FR;1;2021-04-14;208665;122937;208;0;133159;0;0;0;0;7857053;3899260;579;2;4115646;0;0;0;0
FR;1;2021-04-15;221726;128144;313;0;139173;0;0;0;0;8078779;4027404;892;2;4254819;0;0;0;0
FR;1;2021-04-16;206105;125760;309;0;135426;0;0;0;0;8284884;4153164;1201;2;4390245;0;0;0;0
FR;1;2021-04-17;122110;67117;103;0;72176;0;0;0;0;8406994;4220281;1304;2;4462421;0;0;0;0
FR;1;2021-04-18;35975;21007;41;0;22713;0;0;0;0;8442969;4241288;1345;2;4485134;0;0;0;0
FR;1;2021-04-19;163774;121576;432;0;129113;0;0;0;0;8606743;4362864;1777;2;4614247;0;0;0;0
FR;1;2021-04-20;189478;149676;531;0;158792;0;0;0;0;8796221;4512540;2308;2;4773039;0;0;0;0
FR;1;2021-04-21;194041;147665;760;0;157185;0;0;0;0;8990262;4660205;3068;2;4930224;0;0;0;0
FR;1;2021-04-22;209072;164485;778;0;175711;0;0;0;0;9199334;4824690;3846;2;5105935;0;0;0;0
FR;1;2021-04-23;198984;158014;671;0;169023;0;0;0;0;9398318;4982704;4517;2;5274958;0;0;0;0
FR;1;2021-04-24;126350;95851;148;0;101918;0;0;0;0;9524668;5078555;4665;2;5376876;0;0;0;0
FR;1;2021-04-25;53639;30068;46;0;32826;0;0;0;0;9578307;5108623;4711;2;5409702;0;0;0;0
FR;1;2021-04-26;181170;140198;542;0;148912;0;0;0;0;9759477;5248821;5253;2;5558614;0;0;0;0
FR;1;2021-04-27;221395;162554;901;0;173927;0;0;0;0;9980872;5411375;6154;2;5732541;0;0;0;0
FR;1;2021-04-28;238338;156114;1314;1;168794;1;0;0;0;10219210;5567489;7468;3;5901335;1;0;0;0
FR;1;2021-04-29;270333;161546;1211;0;177150;0;0;0;0;10489543;5729035;8679;3;6078485;1;0;0;0
FR;1;2021-04-30;272016;148940;1073;0;165043;0;0;0;0;10761559;5877975;9752;3;6243528;1;0;0;0
FR;1;2021-05-01;141173;40610;173;0;48638;0;0;0;0;10902732;5918585;9925;3;6292166;1;0;0;0
FR;1;2021-05-02;81561;28217;81;0;32972;0;0;0;0;10984293;5946802;10006;3;6325138;1;0;0;0
FR;1;2021-05-03;250809;142400;803;0;156091;0;0;0;0;11235102;6089202;10809;3;6481229;1;0;0;0
FR;1;2021-05-04;265921;187912;1202;0;203485;0;0;0;0;11501023;6277114;12011;3;6684714;1;0;0;0
FR;1;2021-05-05;283931;186123;1268;0;202777;0;0;0;0;11784954;6463237;13279;3;6887491;1;0;0;0
FR;1;2021-05-06;310014;184373;1502;0;204131;0;0;0;0;12094968;6647610;14781;3;7091622;1;0;0;0
FR;1;2021-05-07;284137;196648;1127;0;214465;0;0;0;0;12379105;6844258;15908;3;7306087;1;0;0;0
FR;1;2021-05-08;191675;51361;285;0;62746;0;0;0;0;12570780;6895619;16193;3;7368833;1;0;0;0
FR;1;2021-05-09;114068;34364;236;0;41536;0;0;0;0;12684848;6929983;16429;3;7410369;1;0;0;0
FR;1;2021-05-10;258232;194994;1187;0;210987;0;0;0;0;12943080;7124977;17616;3;7621356;1;0;0;0
FR;1;2021-05-11;318925;211168;1465;0;231402;0;0;0;0;13262005;7336145;19081;3;7852758;1;0;0;0
FR;1;2021-05-12;356670;186050;1401;0;208355;0;0;0;0;13618675;7522195;20482;3;8061113;1;0;0;0
FR;1;2021-05-13;283465;47357;401;0;64284;0;0;0;0;13902140;7569552;20883;3;8125397;1;0;0;0
FR;1;2021-05-14;370529;128523;995;0;151939;0;0;0;0;14272669;7698075;21878;3;8277336;1;0;0;0
FR;1;2021-05-15;298115;66191;404;0;84899;0;0;0;0;14570784;7764266;22282;3;8362235;1;0;0;0
FR;1;2021-05-16;157788;15478;158;0;26047;0;0;0;0;14728572;7779744;22440;3;8388282;1;0;0;0
FR;1;2021-05-17;318944;116179;1441;0;138149;0;0;0;0;15047516;7895923;23881;3;8526431;1;0;0;0
FR;1;2021-05-18;383362;111619;1801;0;137567;0;0;0;0;15430878;8007542;25682;3;8663998;1;0;0;0
FR;1;2021-05-19;395299;101619;2184;0;128559;0;0;0;0;15826177;8109161;27866;3;8792557;1;0;0;0
FR;1;2021-05-20;421840;95678;2049;0;125163;0;0;0;0;16248017;8204839;29915;3;8917720;1;0;0;0
FR;1;2021-05-21;399829;97396;1764;0;125808;0;0;0;0;16647846;8302235;31679;3;9043528;1;0;0;0
FR;1;2021-05-22;275706;41912;604;0;60935;0;0;0;0;16923552;8344147;32283;3;9104463;1;0;0;0
FR;1;2021-05-23;123026;10977;224;0;20582;0;0;0;0;17046578;8355124;32507;3;9125045;1;0;0;0
FR;1;2021-05-24;244023;26255;569;0;43786;0;0;0;0;17290601;8381379;33076;3;9168831;1;0;0;0
FR;1;2021-05-25;366239;131503;2115;1;158441;0;0;0;0;17656840;8512882;35191;4;9327272;1;0;0;0
FR;1;2021-05-26;380834;127302;1996;0;155646;0;0;0;0;18037674;8640184;37187;4;9482918;1;0;0;0
FR;1;2021-05-27;406178;128242;1978;0;158731;0;0;0;0;18443852;8768426;39165;4;9641649;1;0;0;0
FR;1;2021-05-28;366053;145667;1701;0;174237;0;0;0;0;18809905;8914093;40866;4;9815886;1;0;0;0
FR;1;2021-05-29;253846;81087;527;0;100287;0;0;0;0;19063751;8995180;41393;4;9916173;1;0;0;0
FR;1;2021-05-30;100980;22593;158;0;30829;0;0;0;0;19164731;9017773;41551;4;9947002;1;0;0;0
FR;1;2021-05-31;314339;149194;1286;1;172456;1;0;0;0;19479070;9166967;42837;5;10119458;2;0;0;0
FR;1;2021-06-01;361676;166405;1733;1;194113;1;0;0;0;19840746;9333372;44570;6;10313571;3;0;0;0
FR;1;2021-06-02;365413;154297;1797;0;183838;0;0;0;0;20206159;9487669;46367;6;10497409;3;0;0;0
FR;1;2021-06-03;391454;147378;1654;0;178350;0;0;0;0;20597613;9635047;48021;6;10675759;3;0;0;0
FR;1;2021-06-04;364126;175828;1495;1;205114;1;0;0;0;20961739;9810875;49516;7;10880873;4;0;0;0
FR;1;2021-06-05;258522;112795;597;0;133152;0;0;0;0;21220261;9923670;50113;7;11014025;4;0;0;0
FR;1;2021-06-06;126823;37568;215;0;48208;0;0;0;0;21347084;9961238;50328;7;11062233;4;0;0;0
FR;1;2021-06-07;301116;207761;1368;0;233045;0;0;0;0;21648200;10168999;51696;7;11295278;4;0;0;0
FR;1;2021-06-08;330872;220973;1645;0;248942;0;0;0;0;21979072;10389972;53341;7;11544220;4;0;0;0
FR;1;2021-06-09;336607;211039;1613;0;239817;0;0;0;0;22315679;10601011;54954;7;11784037;4;0;0;0
FR;1;2021-06-10;343918;199793;1614;0;229532;0;0;0;0;22659597;10800804;56568;7;12013569;4;0;0;0
FR;1;2021-06-11;311917;234705;1299;1;262612;0;0;0;0;22971514;11035509;57867;8;12276181;4;0;0;0
FR;1;2021-06-12;244096;150594;438;0;172205;0;0;0;0;23215610;11186103;58305;8;12448386;4;0;0;0
FR;1;2021-06-13;100374;61029;188;0;70690;0;0;0;0;23315984;11247132;58493;8;12519076;4;0;0;0
FR;1;2021-06-14;207862;287678;1320;1;307478;0;0;0;0;23523846;11534810;59813;9;12826554;4;0;0;0
FR;1;2021-06-15;256885;281194;1400;1;305038;0;0;0;0;23780731;11816004;61213;10;13131592;4;0;0;0
FR;1;2021-06-16;273668;270649;1263;1;296086;0;0;0;0;24054399;12086653;62476;11;13427678;4;0;0;0
FR;1;2021-06-17;268238;244997;1241;1;271063;0;0;0;0;24322637;12331650;63717;12;13698741;4;0;0;0
FR;1;2021-06-18;260619;295235;1155;1;321053;0;0;0;0;24583256;12626885;64872;13;14019794;4;0;0;0
FR;1;2021-06-19;193461;209573;388;0;228229;0;0;0;0;24776717;12836458;65260;13;14248023;4;0;0;0
FR;1;2021-06-20;69720;89039;121;0;96880;0;0;0;0;24846437;12925497;65381;13;14344903;4;0;0;0
FR;1;2021-06-21;172390;319757;934;1;338464;1;0;0;0;25018827;13245254;66315;14;14683367;5;0;0;0
FR;1;2021-06-22;185884;347992;1102;10;369045;1;0;0;0;25204711;13593246;67417;24;15052412;6;0;0;0
FR;1;2021-06-23;204225;339540;1049;0;363442;0;0;0;0;25408936;13932786;68466;24;15415854;6;0;0;0
FR;1;2021-06-24;203546;282013;1176;0;306762;0;0;0;0;25612482;14214799;69642;24;15722616;6;0;0;0
FR;1;2021-06-25;182674;371675;1200;0;395686;0;0;0;0;25795156;14586474;70842;24;16118302;6;0;0;0
FR;1;2021-06-26;131402;278546;504;0;295912;0;0;0;0;25926558;14865020;71346;24;16414214;6;0;0;0
FR;1;2021-06-27;52415;122854;146;0;130395;0;0;0;0;25978973;14987874;71492;24;16544609;6;0;0;0
FR;1;2021-06-28;136672;368211;1064;0;386813;0;0;0;0;26115645;15356085;72556;24;16931422;6;0;0;0
FR;1;2021-06-29;154908;391047;1848;0;412155;0;0;0;0;26270553;15747132;74404;24;17343577;6;0;0;0
FR;1;2021-06-30;180069;381864;1667;4;406477;2;0;0;0;26450622;16128996;76071;28;17750054;8;0;0;0
FR;1;2021-07-01;201567;332439;1889;5;360534;1;0;0;0;26652189;16461435;77960;33;18110588;9;0;0;0
FR;1;2021-07-02;193887;367278;1765;5;395493;2;0;0;0;26846076;16828713;79725;38;18506081;11;0;0;0
FR;1;2021-07-03;124484;280425;704;3;299545;1;0;0;0;26970560;17109138;80429;41;18805626;12;0;0;0
FR;1;2021-07-04;53966;113720;244;0;122133;0;0;0;0;27024526;17222858;80673;41;18927759;12;0;0;0
FR;1;2021-07-05;153972;355762;1500;8;379115;0;0;0;0;27178498;17578620;82173;49;19306874;12;0;0;0
FR;1;2021-07-06;173518;382283;1603;45;408185;8;0;0;0;27352016;17960903;83776;94;19715059;20;0;0;0
FR;1;2021-07-07;190854;362315;1659;25;390667;2;0;0;0;27542870;18323218;85435;119;20105726;22;0;0;0
FR;1;2021-07-08;201582;322939;1826;20;353604;3;0;0;0;27744452;18646157;87261;139;20459330;25;0;0;0
FR;1;2021-07-09;189989;387779;1854;3;418204;2;0;0;0;27934441;19033936;89115;142;20877534;27;0;0;0
FR;1;2021-07-10;129957;281166;818;1;302598;1;0;0;0;28064398;19315102;89933;143;21180132;28;0;0;0
FR;1;2021-07-11;57683;102523;262;0;112410;0;0;0;0;28122081;19417625;90195;143;21292542;28;0;0;0
FR;1;2021-07-12;149924;416827;1587;4;442846;0;0;0;0;28272005;19834452;91782;147;21735388;28;0;0;0
FR;1;2021-07-13;234290;439019;1808;8;476223;1;0;0;0;28506295;20273471;93590;155;22211611;29;0;0;0
FR;1;2021-07-14;171928;151339;418;0;176977;0;0;0;0;28678223;20424810;94008;155;22388588;29;0;0;0
FR;1;2021-07-15;279696;424160;1859;1;467160;0;0;0;0;28957919;20848970;95867;156;22855748;29;0;0;0
FR;1;2021-07-16;290446;400580;1711;3;445258;1;0;0;0;29248365;21249550;97578;159;23301006;30;0;0;0
FR;1;2021-07-17;217354;281970;755;1;315447;0;0;0;0;29465719;21531520;98333;160;23616453;30;0;0;0
FR;1;2021-07-18;102022;107196;288;0;123092;0;0;0;0;29567741;21638716;98621;160;23739545;30;0;0;0
FR;1;2021-07-19;238236;378414;1498;3;414486;0;0;0;0;29805977;22017130;100119;163;24154031;30;0;0;0
FR;1;2021-07-20;305769;379801;1470;0;425641;0;0;0;0;30111746;22396931;101589;163;24579672;30;0;0;0
FR;1;2021-07-21;333300;352758;1412;4;404164;1;0;0;0;30445046;22749689;103001;167;24983836;31;0;0;0
FR;1;2021-07-22;364691;318564;1502;3;375004;2;0;0;0;30809737;23068253;104503;170;25358840;33;0;0;0
FR;1;2021-07-23;349406;342822;1589;4;398388;1;0;0;0;31159143;23411075;106092;174;25757228;34;0;0;0
FR;1;2021-07-24;238964;240728;697;1;278072;0;0;0;0;31398107;23651803;106789;175;26035300;34;0;0;0
FR;1;2021-07-25;112808;76007;223;0;93710;0;0;0;0;31510915;23727810;107012;175;26129010;34;0;0;0
FR;1;2021-07-26;299144;289317;1495;2;335052;1;0;0;0;31810059;24017127;108507;177;26464062;35;0;0;0
FR;1;2021-07-27;385850;267932;1459;4;324916;1;0;0;0;32195909;24285059;109966;181;26788978;36;0;0;0
FR;1;2021-07-28;390213;250907;1463;4;307213;1;0;0;0;32586122;24535966;111429;185;27096191;37;0;0;0
FR;1;2021-07-29;406150;227610;1541;2;284342;0;0;0;0;32992272;24763576;112970;187;27380533;37;0;0;0
FR;1;2021-07-30;370752;246544;1638;4;298409;1;0;0;0;33363024;25010120;114608;191;27678942;38;0;0;0
FR;1;2021-07-31;243387;165084;794;1;199432;0;0;0;0;33606411;25175204;115402;192;27878374;38;0;0;0
FR;1;2021-08-01;105600;47212;235;0;61208;0;0;0;0;33712011;25222416;115637;192;27939582;38;0;0;0
FR;1;2021-08-02;297427;212825;1479;2;250643;0;0;0;0;34009438;25435241;117116;194;28190225;38;0;0;0
FR;1;2021-08-03;331347;208717;1557;2;250711;1;0;0;0;34340785;25643958;118673;196;28440936;39;0;0;0
FR;1;2021-08-04;328049;183846;1439;5;224017;3;0;0;0;34668834;25827804;120112;201;28664953;42;0;0;0
FR;1;2021-08-05;301290;193111;1483;0;229421;0;0;0;0;34970124;26020915;121595;201;28894374;42;0;0;0
FR;1;2021-08-06;290988;224106;1560;3;261419;0;0;0;0;35261112;26245021;123155;204;29155793;42;0;0;0
FR;1;2021-08-07;182675;158763;655;5;181687;1;0;0;0;35443787;26403784;123810;209;29337480;43;0;0;0
FR;1;2021-08-08;68890;59099;253;0;67629;0;0;0;0;35512677;26462883;124063;209;29405109;43;0;0;0
FR;1;2021-08-09;222793;235179;1445;4;263913;2;0;0;0;35735470;26698062;125508;213;29669022;45;0;0;0
FR;1;2021-08-10;252755;239859;1493;2;271715;0;0;0;0;35988225;26937921;127001;215;29940737;45;0;0;0
FR;1;2021-08-11;236247;231757;1271;5;261286;0;0;0;0;36224472;27169678;128272;220;30202023;45;0;0;0
FR;1;2021-08-12;220790;239761;1491;3;267889;0;0;0;0;36445262;27409439;129763;223;30469912;45;0;0;0
FR;1;2021-08-13;201723;238498;1360;2;264064;2;0;0;0;36646985;27647937;131123;225;30733976;47;0;0;0
FR;1;2021-08-14;122866;174036;645;0;189557;0;0;0;0;36769851;27821973;131768;225;30923533;47;0;0;0
FR;1;2021-08-15;34708;46118;201;1;50338;0;0;0;0;36804559;27868091;131969;226;30973871;47;0;0;0
FR;1;2021-08-16;156967;289359;1423;0;309959;0;0;0;0;36961526;28157450;133392;226;31283830;47;0;0;0
FR;1;2021-08-17;171618;290968;1422;5;313397;0;0;0;0;37133144;28448418;134814;231;31597227;47;0;0;0
FR;1;2021-08-18;161440;286677;1394;6;307329;3;0;0;0;37294584;28735095;136208;237;31904556;50;0;0;0
FR;1;2021-08-19;148958;277423;1405;1;297292;0;0;0;0;37443542;29012518;137613;238;32201848;50;0;0;0
FR;1;2021-08-20;140521;308938;1532;2;328197;2;0;0;0;37584063;29321456;139145;240;32530045;52;0;0;0
FR;1;2021-08-21;84281;213210;589;0;224543;0;0;0;0;37668344;29534666;139734;240;32754588;52;0;0;0
FR;1;2021-08-22;28582;82694;233;0;86700;0;0;0;0;37696926;29617360;139967;240;32841288;52;0;0;0
FR;1;2021-08-23;118666;320947;1422;2;337706;0;0;0;0;37815592;29938307;141389;242;33178994;52;0;0;0
FR;1;2021-08-24;126677;319637;1604;5;337479;0;0;0;0;37942269;30257944;142993;247;33516473;52;0;0;0
FR;1;2021-08-25;121543;306437;1781;8;323644;2;0;0;0;38063812;30564381;144774;255;33840117;54;0;0;0
FR;1;2021-08-26;106637;286062;2162;10;302387;0;0;0;0;38170449;30850443;146936;265;34142504;54;0;0;0
FR;1;2021-08-27;107659;321602;2303;9;338914;1;0;0;0;38278108;31172045;149239;274;34481418;55;0;0;0
FR;1;2021-08-28;71026;220693;1102;0;231235;0;0;0;0;38349134;31392738;150341;274;34712653;55;0;0;0
FR;1;2021-08-29;24154;78196;469;1;82089;0;0;0;0;38373288;31470934;150810;275;34794742;55;0;0;0
FR;1;2021-08-30;96900;286273;4313;6;299766;4974;0;0;0;38470188;31757207;155123;281;35094508;5029;0;0;0
FR;1;2021-08-31;98128;276243;9295;15;289916;10073;2;0;0;38568316;32033450;164418;296;35384424;15102;2;0;0
FR;1;2021-09-01;112358;245297;21120;8;257694;22153;1;0;0;38680674;32278747;185538;304;35642118;37255;3;0;0
FR;1;2021-09-02;86767;197907;24533;18;208317;25513;0;0;0;38767441;32476654;210071;322;35850435;62768;3;0;0
FR;1;2021-09-03;82428;227490;26957;21;238938;28042;0;0;0;38849869;32704144;237028;343;36089373;90810;3;0;0
FR;1;2021-09-04;71630;189714;11142;11;199313;11707;7;0;0;38921499;32893858;248170;354;36288686;102517;10;0;0
FR;1;2021-09-05;18613;41145;4124;2;43856;4274;0;0;0;38940112;32935003;252294;356;36332542;106791;10;0;0
FR;1;2021-09-06;59823;151394;30181;15;158942;31202;2;0;0;38999935;33086397;282475;371;36491484;137993;12;0;0
FR;1;2021-09-07;57400;139627;30213;30;146769;31247;2;0;0;39057335;33226024;312688;401;36638253;169240;14;0;0
FR;1;2021-09-08;72350;173788;26926;22;182288;27956;4;0;0;39129685;33399812;339614;423;36820541;197196;18;0;0
FR;1;2021-09-09;54491;124416;28634;24;131184;29743;5;0;0;39184176;33524228;368248;447;36951725;226939;23;0;0
FR;1;2021-09-10;66220;152071;30452;24;161177;31690;5;0;0;39250396;33676299;398700;471;37112902;258629;28;0;0
FR;1;2021-09-11;52690;146625;9731;14;154130;10352;0;0;0;39303086;33822924;408431;485;37267032;268981;28;0;0
FR;1;2021-09-12;10797;29271;2489;1;30971;2658;2;0;0;39313883;33852195;410920;486;37298003;271639;30;0;0
FR;1;2021-09-13;51515;104416;38763;31;110973;40081;16;0;0;39365398;33956611;449683;517;37408976;311720;46;0;0
FR;1;2021-09-14;53343;95993;51283;67;102397;53256;40;0;0;39418741;34052604;500966;584;37511373;364976;86;0;0
FR;1;2021-09-15;60579;139236;50496;55;146426;47057;68;0;0;39479320;34191840;551462;639;37657799;412033;154;0;0
FR;1;2021-09-16;46639;81362;53355;70;86263;49605;65;0;0;39525959;34273202;604817;709;37744062;461638;219;0;0
FR;1;2021-09-17;53225;109336;45072;61;115676;42701;62;0;0;39579184;34382538;649889;770;37859738;504339;281;0;0
FR;1;2021-09-18;37882;118488;11796;19;124079;11276;19;0;0;39617066;34501026;661685;789;37983817;515615;300;0;0
FR;1;2021-09-19;6531;21028;2042;1;22131;1983;1;0;0;39623597;34522054;663727;790;38005948;517598;301;0;0
FR;1;2021-09-20;36543;74835;46232;65;78560;44193;32;0;0;39660140;34596889;709959;855;38084508;561791;333;0;0
FR;1;2021-09-21;34202;68110;56267;72;71143;52742;77;0;0;39694342;34664999;766226;927;38155651;614533;410;0;0
FR;1;2021-09-22;38842;118606;49881;76;123027;46929;39;0;0;39733184;34783605;816107;1003;38278678;661462;449;0;0
FR;1;2021-09-23;32038;62897;54511;85;65802;50919;79;0;0;39765222;34846502;870618;1088;38344480;712381;528;0;0
FR;1;2021-09-24;36798;90034;43673;89;94394;41955;57;0;0;39802020;34936536;914291;1177;38438874;754336;585;0;0
FR;1;2021-09-25;27652;96704;12307;27;101065;12186;19;0;0;39829672;35033240;926598;1204;38539939;766522;604;0;0
FR;1;2021-09-26;4386;15197;1777;5;16061;1699;4;0;0;39834058;35048437;928375;1209;38556000;768221;608;0;0
FR;1;2021-09-27;27353;60215;42913;89;63449;41639;81;0;1;39861411;35108652;971288;1298;38619449;809860;689;0;1
FR;1;2021-09-28;26913;49425;47201;76;52047;44488;41;0;0;39888324;35158077;1018489;1374;38671496;854348;730;0;1
FR;1;2021-09-29;35925;80268;47292;87;84655;45616;36;0;0;39924249;35238345;1065781;1461;38756151;899964;766;0;1
FR;1;2021-09-30;26075;46898;47527;80;49262;45472;52;0;0;39950324;35285243;1113308;1541;38805413;945436;818;0;1
FR;1;2021-10-01;47304;66917;44904;83;70812;44620;15;0;0;39997628;35352160;1158212;1624;38876225;990056;833;0;1
FR;1;2021-10-02;32383;62404;16113;32;67218;16323;6;0;0;40030011;35414564;1174325;1656;38943443;1006379;839;0;1
FR;1;2021-10-03;4343;8565;2040;3;9314;2037;4;0;0;40034354;35423129;1176365;1659;38952757;1008416;843;0;1
FR;1;2021-10-04;28977;44421;47111;79;46840;46978;31;0;0;40063331;35467550;1223476;1738;38999597;1055394;874;0;1
FR;1;2021-10-05;24567;41633;49891;116;43135;49341;49;0;0;40087898;35509183;1273367;1854;39042732;1104735;923;0;1
FR;1;2021-10-06;34659;61373;57506;101;64490;57255;25;0;0;40122557;35570556;1330873;1955;39107222;1161990;948;0;1
FR;1;2021-10-07;21080;39911;53050;75;41093;51994;33;0;0;40143637;35610467;1383923;2030;39148315;1213984;981;0;1
FR;1;2021-10-08;35670;59639;60408;83;62874;61164;28;0;0;40179307;35670106;1444331;2113;39211189;1275148;1009;0;1
FR;1;2021-10-09;27466;48015;25497;29;52491;26022;10;0;0;40206773;35718121;1469828;2142;39263680;1301170;1019;0;1
FR;1;2021-10-10;3725;5811;2758;7;6289;2865;1;0;0;40210498;35723932;1472586;2149;39269969;1304035;1020;0;1
FR;1;2021-10-11;24857;38214;54586;88;40302;55260;48;0;0;40235355;35762146;1527172;2237;39310271;1359295;1068;0;1
FR;1;2021-10-12;23381;36586;58076;128;37103;59228;19;0;0;40258736;35798732;1585248;2365;39347374;1418523;1087;0;1
FR;1;2021-10-13;32974;47836;64175;125;50646;65699;23;0;1;40291710;35846568;1649423;2490;39398020;1484222;1110;0;2
FR;1;2021-10-14;21712;34773;53771;103;35683;54364;24;0;0;40313422;35881341;1703194;2593;39433703;1538586;1134;0;2
FR;1;2021-10-15;32751;48762;72329;165;50460;75022;23;0;0;40346173;35930103;1775523;2758;39484163;1613608;1157;0;2
FR;1;2021-10-16;26013;35284;34871;44;38302;36425;14;0;0;40372186;35965387;1810394;2802;39522465;1650033;1171;0;2
FR;1;2021-10-17;3159;4050;3417;2;4494;3317;3;0;0;40375345;35969437;1813811;2804;39526959;1653350;1174;0;2
FR;1;2021-10-18;24347;34885;66847;132;34931;69724;28;0;0;40399692;36004322;1880658;2936;39561890;1723074;1202;0;2
FR;1;2021-10-19;20722;35568;75671;135;33231;79596;41;0;0;40420414;36039890;1956329;3071;39595121;1802670;1243;0;2
FR;1;2021-10-20;29915;44202;96184;178;43281;99872;45;0;0;40450329;36084092;2052513;3249;39638402;1902542;1288;0;2
FR;1;2021-10-21;19803;35049;83192;107;31763;87051;31;0;0;40470132;36119141;2135705;3356;39670165;1989593;1319;0;2
FR;1;2021-10-22;29756;47760;103754;196;44569;109711;58;0;0;40499888;36166901;2239459;3552;39714734;2099304;1377;0;2
FR;1;2021-10-23;23055;35142;44874;57;36138;47384;11;0;0;40522943;36202043;2284333;3609;39750872;2146688;1388;0;2
FR;1;2021-10-24;2406;3841;3584;6;4040;3718;1;0;0;40525349;36205884;2287917;3615;39754912;2150406;1389;0;2
FR;1;2021-10-25;22499;30733;82029;143;29622;85833;37;0;0;40547848;36236617;2369946;3758;39784534;2236239;1426;0;2
FR;1;2021-10-26;19365;27647;86122;162;24749;90347;31;0;0;40567213;36264264;2456068;3920;39809283;2326586;1457;0;2
FR;1;2021-10-27;26221;39616;107822;252;37311;112737;47;0;0;40593434;36303880;2563890;4172;39846594;2439323;1504;0;2
FR;1;2021-10-28;18802;27110;86966;150;23494;91725;37;0;0;40612236;36330990;2650856;4322;39870088;2531048;1541;0;2
FR;1;2021-10-29;25931;40260;114840;202;35497;121673;53;0;0;40638167;36371250;2765696;4524;39905585;2652721;1594;0;2
FR;1;2021-10-30;17712;28712;49372;74;28305;51965;18;0;0;40655879;36399962;2815068;4598;39933890;2704686;1612;0;2
FR;1;2021-10-31;2086;3171;3451;2;3217;3685;2;0;0;40657965;36403133;2818519;4600;39937107;2708371;1614;0;2
FR;1;2021-11-01;8015;4270;3035;3;4357;3292;6;0;0;40665980;36407403;2821554;4603;39941464;2711663;1620;0;2
FR;1;2021-11-02;22908;33226;92410;156;29189;97857;39;0;1;40688888;36440629;2913964;4759;39970653;2809520;1659;0;3
FR;1;2021-11-03;26635;41563;117512;219;37019;123893;57;0;0;40715523;36482192;3031476;4978;40007672;2933413;1716;0;3
FR;1;2021-11-04;19627;30302;105822;213;24189;111974;43;0;0;40735150;36512494;3137298;5191;40031861;3045387;1759;0;3
FR;1;2021-11-05;27024;42298;138792;230;34190;147471;47;0;0;40762174;36554792;3276090;5421;40066051;3192858;1806;0;3
FR;1;2021-11-06;18863;29818;63490;123;27621;66507;25;0;0;40781037;36584610;3339580;5544;40093672;3259365;1831;0;3
FR;1;2021-11-07;1834;3278;4984;6;3033;5303;5;0;0;40782871;36587888;3344564;5550;40096705;3264668;1836;0;3
FR;1;2021-11-08;17877;32239;126011;224;25387;132646;48;0;0;40800748;36620127;3470575;5774;40122092;3397314;1884;0;3
FR;1;2021-11-09;19519;37601;159324;334;26142;169130;67;0;0;40820267;36657728;3629899;6108;40148234;3566444;1951;0;3
FR;1;2021-11-10;28889;49067;181923;441;39031;192537;86;0;0;40849156;36706795;3811822;6549;40187265;3758981;2037;0;3
FR;1;2021-11-11;4191;5936;12237;26;5108;13031;14;0;0;40853347;36712731;3824059;6575;40192373;3772012;2051;0;3
FR;1;2021-11-12;26023;46829;174846;244;35310;186529;81;0;0;40879370;36759560;3998905;6819;40227683;3958541;2132;0;3
FR;1;2021-11-13;18734;29151;76846;111;25377;81794;41;0;0;40898104;36788711;4075751;6930;40253060;4040335;2173;0;3
FR;1;2021-11-14;2050;3243;6827;5;2798;7358;6;0;0;40900154;36791954;4082578;6935;40255858;4047693;2179;0;3
FR;1;2021-11-15;18787;34715;156440;306;24626;166270;59;0;0;40918941;36826669;4239018;7241;40280484;4213963;2238;0;3
FR;1;2021-11-16;21365;37841;192149;380;23350;205058;103;0;1;40940306;36864510;4431167;7621;40303834;4419021;2341;0;4
FR;1;2021-11-17;28672;45557;193250;398;33033;205067;95;0;0;40968978;36910067;4624417;8019;40336867;4624088;2436;0;4
FR;1;2021-11-18;21143;39596;182530;458;25146;194644;87;0;0;40990121;36949663;4806947;8477;40362013;4818732;2523;0;4
FR;1;2021-11-19;30892;53327;230279;532;34833;246764;137;0;0;41021013;37002990;5037226;9009;40396846;5065496;2660;0;4
FR;1;2021-11-20;23769;33219;96998;202;26738;103645;44;0;0;41044782;37036209;5134224;9211;40423584;5169141;2704;0;4
FR;1;2021-11-21;2339;3910;9128;19;2957;9937;16;0;0;41047121;37040119;5143352;9230;40426541;5179078;2720;0;4
FR;1;2021-11-22;21422;30344;175928;467;16961;189475;78;0;0;41068543;37070463;5319280;9697;40443502;5368553;2798;0;4
FR;1;2021-11-23;24029;40979;221251;540;21332;237998;77;0;0;41092572;37111442;5540531;10237;40464834;5606551;2875;0;4
FR;1;2021-11-24;30298;49656;217389;702;31987;234564;68;0;0;41122870;37161098;5757920;10939;40496821;5841115;2943;0;4
FR;1;2021-11-25;23732;44038;244502;718;22095;264176;101;0;0;41146602;37205136;6002422;11657;40518916;6105291;3044;0;4
FR;1;2021-11-26;30621;66661;356832;836;33277;388609;154;0;0;41177223;37271797;6359254;12493;40552193;6493900;3198;0;4
FR;1;2021-11-27;21960;45287;202656;372;26185;222682;112;0;0;41199183;37317084;6561910;12865;40578378;6716582;3310;0;4
FR;1;2021-11-28;3179;9561;54800;63;3476;61019;37;0;0;41202362;37326645;6616710;12928;40581854;6777601;3347;0;4
FR;1;2021-11-29;17902;49475;326415;841;20797;354547;150;0;0;41220264;37376120;6943125;13769;40602651;7132148;3497;0;4
FR;1;2021-11-30;22792;64851;431183;952;23851;470819;262;0;0;41243056;37440971;7374308;14721;40626502;7602967;3759;0;4
FR;1;2021-12-01;25352;69113;442936;1131;28501;481805;271;0;0;41268408;37510084;7817244;15852;40655003;8084772;4030;0;4
FR;1;2021-12-02;20089;64395;489443;1229;18512;532964;272;0;0;41288497;37574479;8306687;17081;40673515;8617736;4302;0;4
FR;1;2021-12-03;22913;82347;542815;1310;30341;591810;307;0;0;41311410;37656826;8849502;18391;40703856;9209546;4609;0;4
FR;1;2021-12-04;16417;53836;299123;654;23246;328993;182;0;0;41327827;37710662;9148625;19045;40727102;9538539;4791;0;4
FR;1;2021-12-05;3635;13789;81546;143;4207;91047;85;0;0;41331462;37724451;9230171;19188;40731309;9629586;4876;0;4
FR;1;2021-12-06;25850;62460;415488;1066;22106;455213;356;0;0;41357312;37786911;9645659;20254;40753415;10084799;5232;0;4
FR;1;2021-12-07;20015;75482;523030;1536;24329;572664;371;0;0;41377327;37862393;10168689;21790;40777744;10657463;5603;0;4
FR;1;2021-12-08;21717;75556;458492;1545;30687;502169;378;0;0;41399044;37937949;10627181;23335;40808431;11159632;5981;0;4
FR;1;2021-12-09;19469;74014;493005;1625;24399;541024;397;0;0;41418513;38011963;11120186;24960;40832830;11700656;6378;0;4
FR;1;2021-12-10;23326;87590;547430;1585;32497;600064;391;0;1;41441839;38099553;11667616;26545;40865327;12300720;6769;0;5
FR;1;2021-12-11;16530;59127;302758;751;25983;335493;279;0;0;41458369;38158680;11970374;27296;40891310;12636213;7048;0;5
FR;1;2021-12-12;4392;15896;83229;179;5259;94039;96;0;0;41462761;38174576;12053603;27475;40896569;12730252;7144;0;5
FR;1;2021-12-13;15756;63479;367045;1094;23985;406328;235;0;0;41478517;38238055;12420648;28569;40920554;13136580;7379;0;5
FR;1;2021-12-14;20866;80182;464839;1748;28722;515286;505;0;1;41499383;38318237;12885487;30317;40949276;13651866;7884;0;6
FR;1;2021-12-15;21622;77345;409135;1309;33064;453203;311;0;1;41521005;38395582;13294622;31626;40982340;14105069;8195;0;7
FR;1;2021-12-16;20064;77142;451932;1577;27997;500679;325;0;0;41541069;38472724;13746554;33203;41010337;14605748;8520;0;7
FR;1;2021-12-17;22626;86470;479984;1737;34728;531020;371;0;0;41563695;38559194;14226538;34940;41045065;15136768;8891;0;7
FR;1;2021-12-18;17609;54592;257644;731;24721;288521;232;0;0;41581304;38613786;14484182;35671;41069786;15425289;9123;0;7
FR;1;2021-12-19;5562;16950;79197;194;5938;90692;116;0;0;41586866;38630736;14563379;35865;41075724;15515981;9239;0;7
FR;1;2021-12-20;20950;62984;316276;1081;26585;355317;284;0;0;41607816;38693720;14879655;36946;41102309;15871298;9523;0;7
FR;1;2021-12-21;26340;72926;372789;1423;30628;418110;337;0;0;41634156;38766646;15252444;38369;41132937;16289408;9860;0;7
FR;1;2021-12-22;24987;65725;310676;1217;29647;349604;361;0;1;41659143;38832371;15563120;39586;41162584;16639012;10221;0;8
FR;1;2021-12-23;21273;52168;241509;958;23395;273053;362;0;0;41680416;38884539;15804629;40544;41185979;16912065;10583;0;8
FR;1;2021-12-24;7129;18293;67162;258;9263;77060;154;0;1;41687545;38902832;15871791;40802;41195242;16989125;10737;0;9
FR;1;2021-12-25;507;2873;5590;15;1803;6536;55;0;0;41688052;38905705;15877381;40817;41197045;16995661;10792;0;9
FR;1;2021-12-26;2750;7579;26950;71;3495;31464;100;0;0;41690802;38913284;15904331;40888;41200540;17027125;10892;0;9
FR;1;2021-12-27;18312;53496;235134;705;25496;265784;365;0;0;41709114;38966780;16139465;41593;41226036;17292909;11257;0;9
FR;1;2021-12-28;23302;61928;292048;1026;27036;330219;595;0;1;41732416;39028708;16431513;42619;41253072;17623128;11852;0;10
FR;1;2021-12-29;22218;55438;255024;920;25307;288233;645;0;1;41754634;39084146;16686537;43539;41278379;17911361;12497;0;11
FR;1;2021-12-30;21240;46460;212170;858;22482;239628;718;0;0;41775874;39130606;16898707;44397;41300861;18150989;13215;0;11
FR;1;2021-12-31;7467;16545;61875;229;8733;70403;346;0;0;41783341;39147151;16960582;44626;41309594;18221392;13561;0;11
FR;1;2022-01-01;1158;2497;5666;30;1541;6585;72;0;0;41784499;39149648;16966248;44656;41311135;18227977;13633;0;11
FR;1;2022-01-02;3087;8076;28893;50;3673;33532;190;0;0;41787586;39157724;16995141;44706;41314808;18261509;13823;0;11
FR;1;2022-01-03;25744;54214;228266;789;27571;257736;957;0;1;41813330;39211938;17223407;45495;41342379;18519245;14780;0;12
FR;1;2022-01-04;26205;65045;299284;1240;29849;337321;1367;0;2;41839535;39276983;17522691;46735;41372228;18856566;16147;0;14
FR;1;2022-01-05;30548;64282;274907;1099;32543;310287;1263;0;0;41870083;39341265;17797598;47834;41404771;19166853;17410;0;14
FR;1;2022-01-06;26839;66223;306908;1401;29300;346572;1567;0;1;41896922;39407488;18104506;49235;41434071;19513425;18977;0;15
FR;1;2022-01-07;31572;75029;349848;1538;34437;393992;1822;0;1;41928494;39482517;18454354;50773;41468508;19907417;20799;0;16
FR;1;2022-01-08;23389;51376;222500;698;25590;251130;913;0;1;41951883;39533893;18676854;51471;41494098;20158547;21712;0;17
FR;1;2022-01-09;7092;17154;66026;163;8187;76135;335;0;0;41958975;39551047;18742880;51634;41502285;20234682;22047;0;17
FR;1;2022-01-10;21793;60625;236812;956;32956;267603;1257;0;1;41980768;39611672;18979692;52590;41535241;20502285;23304;0;18
FR;1;2022-01-11;26765;63466;282309;1280;31227;317833;1835;0;1;42007533;39675138;19262001;53870;41566468;20820118;25139;0;19
FR;1;2022-01-12;28962;62526;246276;1105;35088;278065;1685;0;3;42036495;39737664;19508277;54975;41601556;21098183;26824;0;22
FR;1;2022-01-13;24782;60190;262807;1253;30062;296127;1994;0;4;42061277;39797854;19771084;56228;41631618;21394310;28818;0;26
FR;1;2022-01-14;27967;66732;314027;1366;32153;351278;2475;0;1;42089244;39864586;20085111;57594;41663771;21745588;31293;0;27
FR;1;2022-01-15;19367;44429;199322;618;22477;223864;1362;0;1;42108611;39909015;20284433;58212;41686248;21969452;32655;0;28
FR;1;2022-01-16;5160;12974;51529;135;6032;59558;337;0;0;42113771;39921989;20335962;58347;41692280;22029010;32992;0;28
FR;1;2022-01-17;16868;39709;184842;783;20144;206836;1691;0;2;42130639;39961698;20520804;59130;41712424;22235846;34683;0;30
FR;1;2022-01-18;19453;45978;212439;1154;22990;237049;2457;0;1;42150092;40007676;20733243;60284;41735414;22472895;37140;0;31
FR;1;2022-01-19;20308;43981;176122;897;25492;197198;1974;0;4;42170400;40051657;20909365;61181;41760906;22670093;39114;0;35
FR;1;2022-01-20;16842;40582;183702;1147;20814;204754;2515;0;2;42187242;40092239;21093067;62328;41781720;22874847;41629;0;37
FR;1;2022-01-21;19917;47042;228968;1405;23916;253351;3107;0;1;42207159;40139281;21322035;63733;41805636;23128198;44736;0;38
FR;1;2022-01-22;13844;33346;144498;578;18444;161388;1404;0;2;42221003;40172627;21466533;64311;41824080;23289586;46140;0;40
FR;1;2022-01-23;3377;8767;33431;132;4575;38320;352;0;1;42224380;40181394;21499964;64443;41828655;23327906;46492;0;41
FR;1;2022-01-24;11812;32986;142227;717;17803;158267;2103;0;1;42236192;40214380;21642191;65160;41846458;23486173;48595;0;42
FR;1;2022-01-25;14213;38190;163421;1049;20293;181574;3182;0;1;42250405;40252570;21805612;66209;41866751;23667747;51777;0;43
FR;1;2022-01-26;14863;37717;150257;933;22642;166371;2516;0;1;42265268;40290287;21955869;67142;41889393;23834118;54293;0;44
FR;1;2022-01-27;12340;33324;143462;896;18503;158027;3228;0;3;42277608;40323611;22099331;68038;41907896;23992145;57521;0;47
FR;1;2022-01-28;16329;56928;198323;1144;32674;222397;4006;0;3;42293937;40380539;22297654;69182;41940570;24214542;61527;0;50
FR;1;2022-01-29;10268;35480;135208;525;19614;151542;1879;0;1;42304205;40416019;22432862;69707;41960184;24366084;63406;0;51
FR;1;2022-01-30;2485;9264;29683;86;4833;34450;435;0;1;42306690;40425283;22462545;69793;41965017;24400534;63841;0;52
FR;1;2022-01-31;8758;32489;104349;533;19484;117362;2341;0;3;42315448;40457772;22566894;70326;41984501;24517896;66182;0;55
FR;1;2022-02-01;10996;36465;127086;865;20643;141232;4326;0;1;42326444;40494237;22693980;71191;42005144;24659128;70508;0;56
FR;1;2022-02-02;12054;41588;130360;782;25267;145827;3777;0;9;42338498;40535825;22824340;71973;42030411;24804955;74285;0;65
FR;1;2022-02-03;9343;34048;117019;785;19111;130334;4289;0;4;42347841;40569873;22941359;72758;42049522;24935289;78574;0;69
FR;1;2022-02-04;11534;48736;172583;967;26028;192729;5487;0;5;42359375;40618609;23113942;73725;42075550;25128018;84061;0;74
FR;1;2022-02-05;7998;33929;117590;391;18174;133035;2420;0;3;42367373;40652538;23231532;74116;42093724;25261053;86481;0;77
FR;1;2022-02-06;1706;8000;22752;85;3873;26907;443;0;0;42369079;40660538;23254284;74201;42097597;25287960;86924;0;77
FR;1;2022-02-07;7343;35416;119107;459;18189;134978;3397;0;4;42376422;40695954;23373391;74660;42115786;25422938;90321;0;81
FR;1;2022-02-08;7764;31956;125663;695;14888;140652;4301;0;5;42384186;40727910;23499054;75355;42130674;25563590;94622;0;86
FR;1;2022-02-09;8651;36521;135258;701;17920;152503;3883;0;7;42392837;40764431;23634312;76056;42148594;25716093;98505;0;93
FR;1;2022-02-10;7021;30127;116377;675;13890;130166;4443;0;1;42399858;40794558;23750689;76731;42162484;25846259;102948;0;94
FR;1;2022-02-11;8656;41550;165145;878;18358;185370;5430;0;3;42408514;40836108;23915834;77609;42180842;26031629;108378;0;97
FR;1;2022-02-12;5342;27611;106713;379;12533;120898;2396;0;2;42413856;40863719;24022547;77988;42193375;26152527;110774;0;99
FR;1;2022-02-13;1265;5720;21718;66;2187;25336;402;0;3;42415121;40869439;24044265;78054;42195562;26177863;111176;0;102
FR;1;2022-02-14;5458;27225;118092;394;10641;133120;3384;0;4;42420579;40896664;24162357;78448;42206203;26310983;114560;0;106
FR;1;2022-02-15;5791;28862;118931;611;12207;132564;4882;0;1;42426370;40925526;24281288;79059;42218410;26443547;119442;0;107
FR;1;2022-02-16;5759;28491;110422;596;13756;123053;4152;0;3;42432129;40954017;24391710;79655;42232166;26566600;123594;0;110
FR;1;2022-02-17;4613;19739;73146;489;10125;80251;3998;0;3;42436742;40973756;24464856;80144;42242291;26646851;127592;0;113
FR;1;2022-02-18;5610;26790;99203;673;14163;108163;5519;0;2;42442352;41000546;24564059;80817;42256454;26755014;133111;0;115
FR;1;2022-02-19;3551;17177;59480;304;9569;66061;2266;0;0;42445903;41017723;24623539;81121;42266023;26821075;135377;0;115
FR;1;2022-02-20;791;3257;10706;36;1650;12333;360;0;1;42446694;41020980;24634245;81157;42267673;26833408;135737;0;116
FR;1;2022-02-21;3430;14593;52830;286;7916;57676;3126;0;2;42450124;41035573;24687075;81443;42275589;26891084;138863;0;118
FR;1;2022-02-22;3800;15540;51917;500;9037;55655;4070;0;1;42453924;41051113;24738992;81943;42284626;26946739;142933;0;119
FR;1;2022-02-23;4233;17822;57480;509;10741;62581;3569;0;3;42458157;41068935;24796472;82452;42295367;27009320;146502;0;122
FR;1;2022-02-24;3343;13133;43618;436;7828;46408;3657;0;2;42461500;41082068;24840090;82888;42303195;27055728;150159;0;124
FR;1;2022-02-25;4475;19969;64924;696;12087;68795;5767;0;4;42465975;41102037;24905014;83584;42315282;27124523;155926;0;128
FR;1;2022-02-26;2694;12802;41371;310;7649;45124;2494;0;2;42468669;41114839;24946385;83894;42322931;27169647;158420;0;130
FR;1;2022-02-27;644;2190;7129;42;1206;7994;431;0;0;42469313;41117029;24953514;83936;42324137;27177641;158851;0;130
FR;1;2022-02-28;2612;10493;34964;306;6075;37390;3124;0;0;42471925;41127522;24988478;84242;42330212;27215031;161975;0;130
FR;1;2022-03-01;3583;10753;38704;391;6358;39658;4549;0;4;42475508;41138275;25027182;84633;42336570;27254689;166524;0;134
FR;1;2022-03-02;3679;12185;41862;398;7452;43932;4110;0;1;42479187;41150460;25069044;85031;42344022;27298621;170634;0;135
FR;1;2022-03-03;2462;7985;26181;328;5241;26519;3379;0;1;42481649;41158445;25095225;85359;42349263;27325140;174013;0;136
FR;1;2022-03-04;2683;10507;35446;592;6939;34940;5277;0;3;42484332;41168952;25130671;85951;42356202;27360080;179290;0;139
FR;1;2022-03-05;1822;6363;21968;280;4202;22366;2571;0;1;42486154;41175315;25152639;86231;42360404;27382446;181861;0;140
FR;1;2022-03-06;359;956;2917;38;602;3120;327;0;0;42486513;41176271;25155556;86269;42361006;27385566;182188;0;140
FR;1;2022-03-07;1803;4719;16439;245;3043;15905;2831;0;4;42488316;41180990;25171995;86514;42364049;27401471;185019;0;144
FR;1;2022-03-08;1712;5256;17168;309;3667;15996;3472;0;3;42490028;41186246;25189163;86823;42367716;27417467;188491;0;147
FR;1;2022-03-09;1988;6676;19813;370;4752;19171;3422;0;4;42492016;41192922;25208976;87193;42372468;27436638;191913;0;151
FR;1;2022-03-10;1412;5010;15295;308;3662;14333;2943;0;2;42493428;41197932;25224271;87501;42376130;27450971;194856;0;153
FR;1;2022-03-11;1758;6407;21710;487;4442;19865;4737;0;1;42495186;41204339;25245981;87988;42380572;27470836;199593;0;154
FR;1;2022-03-12;1260;4653;15366;281;3096;14915;2686;0;2;42496446;41208992;25261347;88269;42383668;27485751;202279;0;156
FR;1;2022-03-13;256;612;2120;119;412;2066;468;0;0;42496702;41209604;25263467;88388;42384080;27487817;202747;0;156
FR;1;2022-03-14;1153;3678;13405;3882;2293;12527;6342;0;8;42497855;41213282;25276872;92270;42386373;27500344;209089;0;164
FR;1;2022-03-15;1408;5738;14661;6865;4321;13258;9846;0;8;42499263;41219020;25291533;99135;42390694;27513602;218935;0;172
FR;1;2022-03-16;1694;5085;17394;11520;3595;16459;14125;0;6;42500957;41224105;25308927;110655;42394289;27530061;233060;0;178
FR;1;2022-03-17;1175;3439;11733;9648;2364;10827;11732;0;8;42502132;41227544;25320660;120303;42396653;27540888;244792;0;186
FR;1;2022-03-18;1726;4930;17974;16507;3324;16413;19721;0;14;42503858;41232474;25338634;136810;42399977;27557301;264513;0;200
FR;1;2022-03-19;1126;3299;11890;8459;2275;11359;10141;0;6;42504984;41235773;25350524;145269;42402252;27568660;274654;0;206
FR;1;2022-03-20;224;559;1725;1014;361;1759;1224;0;2;42505208;41236332;25352249;146283;42402613;27570419;275878;0;208
FR;1;2022-03-21;1086;2766;11501;13461;1785;10850;15142;0;10;42506294;41239098;25363750;159744;42404398;27581269;291020;0;218
FR;1;2022-03-22;1279;3212;12260;18714;2153;11248;20617;0;5;42507573;41242310;25376010;178458;42406551;27592517;311637;0;223
FR;1;2022-03-23;1510;4357;16031;20111;2953;15712;21882;0;34;42509083;41246667;25392041;198569;42409504;27608229;333519;0;257
FR;1;2022-03-24;1117;2753;10401;16058;1910;9663;17562;0;15;42510200;41249420;25402442;214627;42411414;27617892;351081;0;272
FR;1;2022-03-25;1536;4360;16748;25315;2877;15400;27959;0;23;42511736;41253780;25419190;239942;42414291;27633292;379040;0;295
FR;1;2022-03-26;1110;3014;10856;11450;2064;10517;12862;0;20;42512846;41256794;25430046;251392;42416355;27643809;391902;0;315
FR;1;2022-03-27;234;546;1751;1382;334;1804;1593;0;1;42513080;41257340;25431797;252774;42416689;27645613;393495;0;316
FR;1;2022-03-28;1082;2489;9978;15885;1556;9601;17228;0;10;42514162;41259829;25441775;268659;42418245;27655214;410723;0;326
FR;1;2022-03-29;1142;2745;11557;25109;1595;10922;26505;0;30;42515304;41262574;25453332;293768;42419840;27666136;437228;0;356
FR;1;2022-03-30;1631;3609;14170;24228;2381;13710;25892;0;19;42516935;41266183;25467502;317996;42422221;27679846;463120;0;375
FR;1;2022-03-31;1279;3015;11698;22685;2042;11212;24005;0;40;42518214;41269198;25479200;340681;42424263;27691058;487125;0;415
FR;1;2022-04-01;2233;4021;18487;28531;2476;17357;30803;0;53;42520447;41273219;25497687;369212;42426739;27708415;517928;0;468
FR;1;2022-04-02;910;1889;8195;9238;1105;7954;10231;0;28;42521357;41275108;25505882;378450;42427844;27716369;528159;0;496
FR;1;2022-04-03;203;381;1433;1057;219;1434;1248;0;1;42521560;41275489;25507315;379507;42428063;27717803;529407;0;497
FR;1;2022-04-04;2564;2487;11371;17681;1570;10763;18899;0;30;42524124;41277976;25518686;397188;42429633;27728566;548306;0;527
FR;1;2022-04-05;2109;2708;13001;31220;1693;12026;32600;0;68;42526233;41280684;25531687;428408;42431326;27740592;580906;0;595
FR;1;2022-04-06;1820;3004;12204;23942;1911;11639;25240;0;62;42528053;41283688;25543891;452350;42433237;27752231;606146;0;657
FR;1;2022-04-07;1563;2738;12353;31082;1638;11818;32158;0;68;42529616;41286426;25556244;483432;42434875;27764049;638304;0;725
FR;1;2022-04-08;1755;3654;17559;40618;2046;16468;42687;0;76;42531371;41290080;25573803;524050;42436921;27780517;680991;0;801
FR;1;2022-04-09;822;1997;8404;12502;1074;8103;13502;0;26;42532193;41292077;25582207;536552;42437995;27788620;694493;0;827
FR;1;2022-04-10;201;651;1836;1855;416;1882;2075;0;6;42532394;41292728;25584043;538407;42438411;27790502;696568;0;833
FR;1;2022-04-11;1086;2256;10969;22348;1305;10687;23454;0;68;42533480;41294984;25595012;560755;42439716;27801189;720022;0;901
FR;1;2022-04-12;1339;2669;12822;38131;1583;12311;38882;0;119;42534819;41297653;25607834;598886;42441299;27813500;758904;0;1020
FR;1;2022-04-13;1277;2892;12272;30618;1787;12004;31389;0;85;42536096;41300545;25620106;629504;42443086;27825504;790293;0;1105
FR;1;2022-04-14;1228;2587;12118;33629;1590;12132;34066;0;88;42537324;41303132;25632224;663133;42444676;27837636;824359;0;1193
FR;1;2022-04-15;1498;3239;14404;33264;2058;13806;34667;0;107;42538822;41306371;25646628;696397;42446734;27851442;859026;0;1300
FR;1;2022-04-16;660;1406;5845;8003;764;5776;8757;0;31;42539482;41307777;25652473;704400;42447498;27857218;867783;0;1331
FR;1;2022-04-17;156;288;930;1121;175;975;1171;0;7;42539638;41308065;25653403;705521;42447673;27858193;868954;0;1338
FR;1;2022-04-18;166;479;2636;1002;296;2659;1187;0;5;42539804;41308544;25656039;706523;42447969;27860852;870141;0;1343
FR;1;2022-04-19;1257;2609;11785;27932;1497;11516;28787;0;69;42541061;41311153;25667824;734455;42449466;27872368;898928;0;1412
FR;1;2022-04-20;1350;2669;12176;26878;1671;12027;27704;0;82;42542411;41313822;25680000;761333;42451137;27884395;926632;0;1494
FR;1;2022-04-21;1242;2459;11548;33252;1508;11761;33607;0;107;42543653;41316281;25691548;794585;42452645;27896156;960239;0;1601
FR;1;2022-04-22;1524;3083;15216;35501;1916;14794;36698;0;120;42545177;41319364;25706764;830086;42454561;27910950;996937;0;1721
FR;1;2022-04-23;764;1581;6735;9893;917;6641;10577;0;30;42545941;41320945;25713499;839979;42455478;27917591;1007514;0;1751
FR;1;2022-04-24;196;373;1373;1521;237;1328;1744;0;7;42546137;41321318;25714872;841500;42455715;27918919;1009258;0;1758
FR;1;2022-04-25;1041;2129;9855;19732;1252;9756;20554;0;64;42547178;41323447;25724727;861232;42456967;27928675;1029812;0;1822
FR;1;2022-04-26;1349;2623;12604;36592;1604;12204;37179;0;163;42548527;41326070;25737331;897824;42458571;27940879;1066991;0;1985
FR;1;2022-04-27;1330;2406;10653;29242;1464;10789;29628;0;122;42549857;41328476;25747984;927066;42460035;27951668;1096619;0;2107
FR;1;2022-04-28;1284;2410;11561;34288;1517;11403;34437;0;127;42551141;41330886;25759545;961354;42461552;27963071;1131056;0;2234
FR;1;2022-04-29;1613;4272;14401;35560;3146;13855;36848;0;153;42552754;41335158;25773946;996914;42464698;27976926;1167904;0;2387
FR;1;2022-04-30;832;2524;6446;9173;1953;6289;9974;0;35;42553586;41337682;25780392;1006087;42466651;27983215;1177878;0;2422
FR;1;2022-05-01;177;288;832;949;190;826;1078;0;5;42553763;41337970;25781224;1007036;42466841;27984041;1178956;0;2427
FR;1;2022-05-02;1883;2606;10377;16949;1762;10300;17631;0;64;42555646;41340576;25791601;1023985;42468603;27994341;1196587;0;2491
FR;1;2022-05-03;1634;2873;12708;32893;1759;12600;33692;0;149;42557280;41343449;25804309;1056878;42470362;28006941;1230279;0;2640
FR;1;2022-05-04;1371;2743;11233;23815;1688;11394;24354;0;96;42558651;41346192;25815542;1080693;42472050;28018335;1254633;0;2736
FR;1;2022-05-05;1475;2695;12199;31854;1680;12122;32402;0;170;42560126;41348887;25827741;1112547;42473730;28030457;1287035;0;2906
FR;1;2022-05-06;1819;3231;14236;34932;1908;13819;36195;0;166;42561945;41352118;25841977;1147479;42475638;28044276;1323230;0;3072
FR;1;2022-05-07;858;1472;5979;9096;878;6013;9730;0;44;42562803;41353590;25847956;1156575;42476516;28050289;1332960;0;3116
FR;1;2022-05-08;190;329;1060;1472;222;1122;1548;0;8;42562993;41353919;25849016;1158047;42476738;28051411;1334508;0;3124
FR;1;2022-05-09;1150;2013;9248;19262;1153;9162;20035;0;93;42564143;41355932;25858264;1177309;42477891;28060573;1354543;0;3217
FR;1;2022-05-10;1493;3028;12621;37142;1938;12220;38040;0;177;42565636;41358960;25870885;1214451;42479829;28072793;1392583;0;3394
FR;1;2022-05-11;1435;2470;9911;26035;1689;9858;26557;0;138;42567071;41361430;25880796;1240486;42481518;28082651;1419140;0;3532
FR;1;2022-05-12;1320;2432;10524;33630;1524;10225;34273;0;188;42568391;41363862;25891320;1274116;42483042;28092876;1453413;0;3720
FR;1;2022-05-13;1610;2805;12767;35847;1682;12414;36943;0;149;42570001;41366667;25904087;1309963;42484724;28105290;1490356;0;3869
FR;1;2022-05-14;781;1321;5480;10215;807;5364;10730;0;51;42570782;41367988;25909567;1320178;42485531;28110654;1501086;0;3920
FR;1;2022-05-15;223;418;1182;1350;243;1252;1495;0;5;42571005;41368406;25910749;1321528;42485774;28111906;1502581;0;3925
FR;1;2022-05-16;971;1783;8078;20137;1003;8142;20550;0;117;42571976;41370189;25918827;1341665;42486777;28120048;1523131;0;4042
FR;1;2022-05-17;1293;2297;11121;36184;1380;10727;36968;0;172;42573269;41372486;25929948;1377849;42488157;28130775;1560099;0;4214
FR;1;2022-05-18;1311;2132;9037;25724;1364;8988;26282;0;99;42574580;41374618;25938985;1403573;42489521;28139763;1586381;0;4313
FR;1;2022-05-19;1203;2399;9852;33993;1408;9946;34195;0;150;42575783;41377017;25948837;1437566;42490929;28149709;1620576;0;4463
FR;1;2022-05-20;1561;2752;12527;37653;1714;12111;38512;0;151;42577344;41379769;25961364;1475219;42492643;28161820;1659088;0;4614
FR;1;2022-05-21;774;1375;5247;9374;866;5165;9943;0;37;42578118;41381144;25966611;1484593;42493509;28166985;1669031;0;4651
FR;1;2022-05-22;191;292;951;1396;203;952;1518;0;10;42578309;41381436;25967562;1485989;42493712;28167937;1670549;0;4661
FR;1;2022-05-23;970;1884;8371;19410;1170;8346;20027;0;79;42579279;41383320;25975933;1505399;42494882;28176283;1690576;0;4740
FR;1;2022-05-24;1288;2447;10724;37245;1437;10593;37819;0;173;42580567;41385767;25986657;1542644;42496319;28186876;1728395;0;4913
FR;1;2022-05-25;1273;2297;8792;23693;1423;8956;24055;0;111;42581840;41388064;25995449;1566337;42497742;28195832;1752450;0;5024
FR;1;2022-05-26;173;378;1585;1155;255;1578;1289;0;24;42582013;41388442;25997034;1567492;42497997;28197410;1753739;0;5048
FR;1;2022-05-27;1116;2185;8787;20456;1371;8535;21409;0;84;42583129;41390627;26005821;1587948;42499368;28205945;1775148;0;5132
FR;1;2022-05-28;486;1053;3689;6540;621;3727;6928;0;37;42583615;41391680;26009510;1594488;42499989;28209672;1782076;0;5169
FR;1;2022-05-29;121;257;707;895;149;718;1004;0;4;42583736;41391937;26010217;1595383;42500138;28210390;1783080;0;5173
FR;1;2022-05-30;831;1737;6558;18535;1040;6590;18989;0;85;42584567;41393674;26016775;1613918;42501178;28216980;1802069;0;5258
FR;1;2022-05-31;1267;2227;9246;34367;1361;9116;34968;0;159;42585834;41395901;26026021;1648285;42502539;28226096;1837037;0;5417
FR;1;2022-06-01;1320;2598;10432;23454;1745;10293;24302;0;115;42587154;41398499;26036453;1671739;42504284;28236389;1861339;0;5532
FR;1;2022-06-02;1224;2305;10666;34152;1444;10246;34984;0;162;42588378;41400804;26047119;1705891;42505728;28246635;1896323;0;5694
FR;1;2022-06-03;1446;2734;12709;37106;1724;12130;38282;0;157;42589824;41403538;26059828;1742997;42507452;28258765;1934605;0;5851
FR;1;2022-06-04;682;1261;4749;8677;758;4825;9167;0;62;42590506;41404799;26064577;1751674;42508210;28263590;1943772;0;5913
FR;1;2022-06-05;132;292;810;1048;150;834;1153;0;3;42590638;41405091;26065387;1752722;42508360;28264424;1944925;0;5916
FR;1;2022-06-06;576;1152;2025;1251;977;2040;1426;0;9;42591214;41406243;26067412;1753973;42509337;28266464;1946351;0;5925
FR;1;2022-06-07;1180;2337;9178;34042;1432;8839;35140;0;143;42592394;41408580;26076590;1788015;42510769;28275303;1981491;0;6068
FR;1;2022-06-08;1118;2235;8672;27576;1400;8555;28446;0;107;42593512;41410815;26085262;1815591;42512169;28283858;2009937;0;6175
FR;1;2022-06-09;1068;2148;9988;37565;1281;9672;38332;0;148;42594580;41412963;26095250;1853156;42513450;28293530;2048269;0;6323
FR;1;2022-06-10;1336;2782;12401;43120;1746;11985;44356;0;201;42595916;41415745;26107651;1896276;42515196;28305515;2092625;0;6524
FR;1;2022-06-11;659;1450;5140;11084;797;5189;11613;0;50;42596575;41417195;26112791;1907360;42515993;28310704;2104238;0;6574
FR;1;2022-06-12;153;375;1015;1687;187;1073;1788;0;11;42596728;41417570;26113806;1909047;42516180;28311777;2106026;0;6585
FR;1;2022-06-13;921;1835;7014;22225;1129;6871;23066;0;84;42597649;41419405;26120820;1931272;42517309;28318648;2129092;0;6669
FR;1;2022-06-14;1092;2222;9840;42847;1301;9243;43939;0;186;42598741;41421627;26130660;1974119;42518610;28327891;2173031;0;6855
FR;1;2022-06-15;1079;2000;8786;29376;1353;8464;29933;0;168;42599820;41423627;26139446;2003495;42519963;28336355;2202964;0;7023
FR;1;2022-06-16;952;1835;9400;38505;1055;8880;39412;0;188;42600772;41425462;26148846;2042000;42521018;28345235;2242376;0;7211
FR;1;2022-06-17;1224;2558;11897;44852;1468;11358;45998;0;224;42601996;41428020;26160743;2086852;42522486;28356593;2288374;0;7435
FR;1;2022-06-18;562;1275;4319;10543;715;4258;11085;0;62;42602558;41429295;26165062;2097395;42523201;28360851;2299459;0;7497
FR;1;2022-06-19;137;325;1002;1543;173;1081;1609;0;12;42602695;41429620;26166064;2098938;42523374;28361932;2301068;0;7509
FR;1;2022-06-20;860;1700;8491;25046;998;8155;25908;0;143;42603555;41431320;26174555;2123984;42524372;28370087;2326976;0;7652
FR;1;2022-06-21;1103;2137;9765;47756;1253;8855;49102;0;241;42604658;41433457;26184320;2171740;42525625;28378942;2376078;0;7893
FR;1;2022-06-22;1037;2063;8434;37154;1292;7952;38016;0;231;42605695;41435520;26192754;2208894;42526917;28386894;2414094;0;8124
FR;1;2022-06-23;1053;2175;10124;52805;1205;9406;53815;0;290;42606748;41437695;26202878;2261699;42528122;28396300;2467909;0;8414
FR;1;2022-06-24;1251;2713;12912;65963;1482;11696;67634;0;367;42607999;41440408;26215790;2327662;42529604;28407996;2535543;0;8781
FR;1;2022-06-25;684;1504;5927;18921;791;5708;19719;0;163;42608683;41441912;26221717;2346583;42530395;28413704;2555262;0;8944
FR;1;2022-06-26;167;405;1817;3494;190;1713;3730;0;34;42608850;41442317;26223534;2350077;42530585;28415417;2558992;0;8978
FR;1;2022-06-27;939;1770;9903;45977;939;9128;47112;0;300;42609789;41444087;26233437;2396054;42531524;28424545;2606104;0;9278
FR;1;2022-06-28;1212;2571;13837;86556;1376;12401;88241;0;570;42611001;41446658;26247274;2482610;42532900;28436946;2694345;0;9848
FR;1;2022-06-29;1242;2288;11480;67397;1251;10547;68443;0;487;42612243;41448946;26258754;2550007;42534151;28447493;2762788;0;10335
FR;1;2022-06-30;1287;2467;13515;89964;1414;11823;91763;0;645;42613530;41451413;26272269;2639971;42535565;28459316;2854551;0;10980
FR;1;2022-07-01;1649;3473;20308;109186;1987;17968;111577;0;859;42615179;41454886;26292577;2749157;42537552;28477284;2966128;0;11839
FR;1;2022-07-02;767;1524;8020;33770;746;7250;34796;0;315;42615946;41456410;26300597;2782927;42538298;28484534;3000924;0;12154
FR;1;2022-07-03;228;480;1941;6118;255;1757;6444;0;71;42616174;41456890;26302538;2789045;42538553;28486291;3007368;0;12225
FR;1;2022-07-04;1415;3043;13927;75407;1924;12353;77296;0;589;42617589;41459933;26316465;2864452;42540477;28498644;3084664;0;12814
FR;1;2022-07-05;1427;2833;17686;126356;1486;15142;128471;0;1059;42619016;41462766;26334151;2990808;42541963;28513786;3213135;0;13873
FR;1;2022-07-06;1349;2390;14881;93716;1373;12901;95152;0;814;42620365;41465156;26349032;3084524;42543336;28526687;3308287;0;14687
FR;1;2022-07-07;1437;2534;16928;119488;1401;13998;121583;0;1074;42621802;41467690;26365960;3204012;42544737;28540685;3429870;0;15761
FR;1;2022-07-08;1530;2818;19603;129993;1531;15967;132799;0;1219;42623332;41470508;26385563;3334005;42546268;28556652;3562669;0;16980
FR;1;2022-07-09;661;1273;7306;36016;689;6347;36806;0;392;42623993;41471781;26392869;3370021;42546957;28562999;3599475;0;17372
FR;1;2022-07-10;238;547;2240;6689;301;2032;7068;0;89;42624231;41472328;26395109;3376710;42547258;28565031;3606543;0;17461
FR;1;2022-07-11;1214;2228;14316;84441;1163;11935;86554;0;734;42625445;41474556;26409425;3461151;42548421;28576966;3693097;0;18195
FR;1;2022-07-12;1559;2789;19458;137402;1426;15896;139891;0;1485;42627004;41477345;26428883;3598553;42549847;28592862;3832988;0;19680
FR;1;2022-07-13;1420;2430;14786;89832;1309;12637;91518;0;1002;42628424;41479775;26443669;3688385;42551156;28605499;3924506;0;20682
FR;1;2022-07-14;161;348;1862;5286;193;1771;5433;0;74;42628585;41480123;26445531;3693671;42551349;28607270;3929939;0;20756
FR;1;2022-07-15;1256;2301;14360;80590;1182;12003;82594;0;959;42629841;41482424;26459891;3774261;42552531;28619273;4012533;0;21715
FR;1;2022-07-16;507;1051;5639;23945;543;4893;24585;0;302;42630348;41483475;26465530;3798206;42553074;28624166;4037118;0;22017
FR;1;2022-07-17;159;363;1655;4461;188;1499;4724;0;60;42630507;41483838;26467185;3802667;42553262;28625665;4041842;0;22077
FR;1;2022-07-18;973;2031;11297;59271;1140;9567;60994;0;715;42631480;41485869;26478482;3861938;42554402;28635232;4102836;0;22792
FR;1;2022-07-19;1227;2126;14690;99419;1188;11723;101414;0;1386;42632707;41487995;26493172;3961357;42555590;28646955;4204250;0;24178
FR;1;2022-07-20;1177;1996;12364;74361;1164;10274;75849;0;963;42633884;41489991;26505536;4035718;42556754;28657229;4280099;0;25141
FR;1;2022-07-21;1133;1949;12411;84540;1183;9988;85903;0;1211;42635017;41491940;26517947;4120258;42557937;28667217;4366002;0;26352
FR;1;2022-07-22;1243;2216;14093;85932;1235;11424;87665;0;1264;42636260;41494156;26532040;4206190;42559172;28678641;4453667;0;27616
FR;1;2022-07-23;535;1089;5232;21294;631;4606;21837;0;374;42636795;41495245;26537272;4227484;42559803;28683247;4475504;0;27990
FR;1;2022-07-24;148;305;1325;3699;150;1167;3923;0;65;42636943;41495550;26538597;4231183;42559953;28684414;4479427;0;28055
FR;1;2022-07-25;889;1627;9072;46110;978;7519;47486;0;680;42637832;41497177;26547669;4277293;42560931;28691933;4526913;0;28735
FR;1;2022-07-26;1126;1960;12678;81961;1115;10334;83574;0;1198;42638958;41499137;26560347;4359254;42562046;28702267;4610487;0;29933
FR;1;2022-07-27;1016;1725;9759;58515;1038;8138;59697;0;874;42639974;41500862;26570106;4417769;42563084;28710405;4670184;0;30807
FR;1;2022-07-28;979;1703;9851;61898;1107;7843;63129;0;967;42640953;41502565;26579957;4479667;42564191;28718248;4733313;0;31774
FR;1;2022-07-29;1111;1835;10453;62956;1159;8379;64269;0;1066;42642064;41504400;26590410;4542623;42565350;28726627;4797582;0;32840
FR;1;2022-07-30;392;716;3348;14491;432;2849;14850;0;279;42642456;41505116;26593758;4557114;42565782;28729476;4812432;0;33119
FR;1;2022-07-31;139;263;900;2335;158;766;2477;0;47;42642595;41505379;26594658;4559449;42565940;28730242;4814909;0;33166
FR;1;2022-08-01;728;1371;7250;28963;990;6109;29955;0;518;42643323;41506750;26601908;4588412;42566930;28736351;4844864;0;33684
FR;1;2022-08-02;897;1473;8232;54022;987;6627;54672;0;1090;42644220;41508223;26610140;4642434;42567917;28742978;4899536;0;34774
FR;1;2022-08-03;723;1102;6149;37033;746;4933;37762;0;644;42644943;41509325;26616289;4679467;42568663;28747911;4937298;0;35418
FR;1;2022-08-04;643;1073;6255;41445;690;5048;42000;0;850;42645586;41510398;26622544;4720912;42569353;28752959;4979298;0;36268
FR;1;2022-08-05;740;1190;6760;43065;800;5429;43695;0;933;42646326;41511588;26629304;4763977;42570153;28758388;5022993;0;37201
FR;1;2022-08-06;274;461;1991;8998;301;1672;9190;0;218;42646600;41512049;26631295;4772975;42570454;28760060;5032183;0;37419
FR;1;2022-08-07;89;144;520;1552;100;436;1629;0;35;42646689;41512193;26631815;4774527;42570554;28760496;5033812;0;37454
FR;1;2022-08-08;493;943;3798;21216;698;3130;21623;0;457;42647182;41513136;26635613;4795743;42571252;28763626;5055435;0;37911
FR;1;2022-08-09;608;1030;5679;38465;719;4554;38959;0;794;42647790;41514166;26641292;4834208;42571971;28768180;5094394;0;38705
FR;1;2022-08-10;536;1019;4432;26912;719;3632;27226;0;601;42648326;41515185;26645724;4861120;42572690;28771812;5121620;0;39306
FR;1;2022-08-11;538;912;4304;28204;623;3578;28532;0;635;42648864;41516097;26650028;4889324;42573313;28775390;5150152;0;39941
FR;1;2022-08-12;596;1025;4548;27161;699;3756;27572;0;666;42649460;41517122;26654576;4916485;42574012;28779146;5177724;0;40607
FR;1;2022-08-13;178;356;1247;5107;249;1064;5278;0;116;42649638;41517478;26655823;4921592;42574261;28780210;5183002;0;40723
FR;1;2022-08-14;65;115;276;871;97;235;941;0;24;42649703;41517593;26656099;4922463;42574358;28780445;5183943;0;40747
FR;1;2022-08-15;78;170;570;542;139;531;593;0;16;42649781;41517763;26656669;4923005;42574497;28780976;5184536;0;40763
FR;1;2022-08-16;522;933;3787;21486;691;3217;21686;0;582;42650303;41518696;26660456;4944491;42575188;28784193;5206222;0;41345
FR;1;2022-08-17;527;889;3766;22147;657;3193;22388;0;579;42650830;41519585;26664222;4966638;42575845;28787386;5228610;0;41924
FR;1;2022-08-18;543;879;3926;25434;679;3128;25653;0;630;42651373;41520464;26668148;4992072;42576524;28790514;5254263;0;42554
FR;1;2022-08-19;533;1038;4366;26531;737;3599;26838;0;732;42651906;41521502;26672514;5018603;42577261;28794113;5281101;0;43286
FR;1;2022-08-20;232;411;1289;5371;311;1106;5524;0;138;42652138;41521913;26673803;5023974;42577572;28795219;5286625;0;43424
FR;1;2022-08-21;82;110;283;989;75;249;1012;0;27;42652220;41522023;26674086;5024963;42577647;28795468;5287637;0;43451
FR;1;2022-08-22;473;886;3140;14945;658;2711;15221;0;411;42652693;41522909;26677226;5039908;42578305;28798179;5302858;0;43862
FR;1;2022-08-23;636;1057;4153;28310;742;3486;28389;0;830;42653329;41523966;26681379;5068218;42579047;28801665;5331247;0;44692
FR;1;2022-08-24;556;829;3401;19059;649;2770;19244;0;587;42653885;41524795;26684780;5087277;42579696;28804435;5350491;0;45279
FR;1;2022-08-25;562;923;3822;22919;643;3205;23148;0;655;42654447;41525718;26688602;5110196;42580339;28807640;5373639;0;45934
FR;1;2022-08-26;746;1127;4345;25155;803;3561;25531;0;745;42655193;41526845;26692947;5135351;42581142;28811201;5399170;0;46679
FR;1;2022-08-27;217;430;1322;5303;274;1190;5357;0;192;42655410;41527275;26694269;5140654;42581416;28812391;5404527;0;46871
FR;1;2022-08-28;111;145;298;898;104;280;947;0;33;42655521;41527420;26694567;5141552;42581520;28812671;5405474;0;46904
FR;1;2022-08-29;502;856;2976;14248;632;2515;14558;0;409;42656023;41528276;26697543;5155800;42582152;28815186;5420032;0;47313
FR;1;2022-08-30;739;1095;4622;27710;772;3772;28031;0;793;42656762;41529371;26702165;5183510;42582924;28818958;5448063;0;48106
FR;1;2022-08-31;579;827;3107;17230;605;2616;17493;0;483;42657341;41530198;26705272;5200740;42583529;28821574;5465556;0;48589
FR;1;2022-09-01;674;913;4325;21870;639;3684;22132;0;586;42658015;41531111;26709597;5222610;42584168;28825258;5487688;0;49175
FR;1;2022-09-02;771;1043;4880;27861;737;4075;28148;0;882;42658786;41532154;26714477;5250471;42584905;28829333;5515836;0;50057
FR;1;2022-09-03;317;502;1831;5874;341;1592;6103;0;174;42659103;41532656;26716308;5256345;42585246;28830925;5521939;0;50231
FR;1;2022-09-04;106;137;341;842;74;334;912;0;21;42659209;41532793;26716649;5257187;42585320;28831259;5522851;0;50252
FR;1;2022-09-05;573;669;3023;15687;492;2529;15970;0;499;42659782;41533462;26719672;5272874;42585812;28833788;5538821;0;50751
FR;1;2022-09-06;720;928;4564;31053;576;3702;31276;0;1002;42660502;41534390;26724236;5303927;42586388;28837490;5570097;0;51753
FR;1;2022-09-07;538;684;2918;16443;444;2421;16580;0;550;42661040;41535074;26727154;5320370;42586832;28839911;5586677;0;52303
FR;1;2022-09-08;567;784;3696;24203;527;3037;24282;0;796;42661607;41535858;26730850;5344573;42587359;28842948;5610959;0;53099
FR;1;2022-09-09;769;966;4300;26883;604;3587;27066;0;902;42662376;41536824;26735150;5371456;42587963;28846535;5638025;0;54001
FR;1;2022-09-10;328;463;1673;5587;293;1474;5777;0;203;42662704;41537287;26736823;5377043;42588256;28848009;5643802;0;54204
FR;1;2022-09-11;105;120;311;645;82;292;701;0;17;42662809;41537407;26737134;5377688;42588338;28848301;5644503;0;54221
FR;1;2022-09-12;448;584;2609;12946;408;2226;13226;0;462;42663257;41537991;26739743;5390634;42588746;28850527;5657729;0;54683
FR;1;2022-09-13;578;793;3867;25833;501;3380;25708;0;835;42663835;41538784;26743610;5416467;42589247;28853907;5683437;0;55518
FR;1;2022-09-14;570;693;2867;15694;478;2397;15930;0;537;42664405;41539477;26746477;5432161;42589725;28856304;5699367;0;56055
FR;1;2022-09-15;509;709;3331;23084;480;2838;23147;0;677;42664914;41540186;26749808;5455245;42590205;28859142;5722514;0;56732
FR;1;2022-09-16;714;928;4011;25330;611;3381;25532;0;891;42665628;41541114;26753819;5480575;42590816;28862523;5748046;0;57623
FR;1;2022-09-17;294;408;1392;5977;278;1217;6085;0;227;42665922;41541522;26755211;5486552;42591094;28863740;5754131;0;57850
FR;1;2022-09-18;97;123;310;923;100;278;979;0;33;42666019;41541645;26755521;5487475;42591194;28864018;5755110;0;57883
FR;1;2022-09-19;365;567;2132;12846;368;1828;12999;0;414;42666384;41542212;26757653;5500321;42591562;28865846;5768109;0;58297
FR;1;2022-09-20;554;802;3658;25806;548;3058;25844;0;853;42666938;41543014;26761311;5526127;42592110;28868904;5793953;0;59150
FR;1;2022-09-21;469;679;2624;15861;479;2252;15826;0;561;42667407;41543693;26763935;5541988;42592589;28871156;5809779;0;59711
FR;1;2022-09-22;534;753;3288;22946;493;2686;23136;0;742;42667941;41544446;26767223;5564934;42593082;28873842;5832915;0;60453
FR;1;2022-09-23;758;933;4349;28134;664;3629;28302;0;978;42668699;41545379;26771572;5593068;42593746;28877471;5861217;0;61431
FR;1;2022-09-24;352;534;1583;6694;375;1368;6865;0;300;42669051;41545913;26773155;5599762;42594121;28878839;5868082;0;61731
FR;1;2022-09-25;80;151;321;1071;104;293;1109;0;32;42669131;41546064;26773476;5600833;42594225;28879132;5869191;0;61763
FR;1;2022-09-26;382;638;2179;13059;416;1931;13153;0;412;42669513;41546702;26775655;5613892;42594641;28881063;5882344;0;62175
FR;1;2022-09-27;540;764;3458;25021;539;2793;25219;0;906;42670053;41547466;26779113;5638913;42595180;28883856;5907563;0;63081
FR;1;2022-09-28;516;711;2441;14957;498;2208;15048;0;597;42670569;41548177;26781554;5653870;42595678;28886064;5922611;0;63678
FR;1;2022-09-29;504;690;2980;20345;480;2505;20358;0;767;42671073;41548867;26784534;5674215;42596158;28888569;5942969;0;64445
FR;1;2022-09-30;678;965;3772;24416;664;3157;24663;0;968;42671751;41549832;26788306;5698631;42596822;28891726;5967632;0;65413
FR;1;2022-10-01;342;543;1899;5501;378;1655;5729;0;272;42672093;41550375;26790205;5704132;42597200;28893381;5973361;0;65685
FR;1;2022-10-02;53;117;204;567;80;203;588;0;29;42672146;41550492;26790409;5704699;42597280;28893584;5973949;0;65714
FR;1;2022-10-03;414;664;2197;10010;506;1941;10194;0;488;42672560;41551156;26792606;5714709;42597786;28895525;5984143;0;66202
FR;1;2022-10-04;543;693;2922;18919;460;2471;19010;0;1082;42673103;41551849;26795528;5733628;42598246;28897996;6003153;0;67284
FR;1;2022-10-05;429;679;2081;11096;450;1854;11230;0;722;42673532;41552528;26797609;5744724;42598696;28899850;6014383;0;68006
FR;1;2022-10-06;442;604;2492;15772;427;2057;15955;0;1060;42673974;41553132;26800101;5760496;42599123;28901907;6030338;0;69066
FR;1;2022-10-07;546;735;2691;16054;534;2307;16079;0;1160;42674520;41553867;26802792;5776550;42599657;28904214;6046417;0;70226
FR;1;2022-10-08;234;306;886;3169;237;775;3273;0;291;42674754;41554173;26803678;5779719;42599894;28904989;6049690;0;70517
FR;1;2022-10-09;75;87;150;461;77;134;487;0;50;42674829;41554260;26803828;5780180;42599971;28905123;6050177;0;70567
FR;1;2022-10-10;295;437;1314;4987;344;1232;5082;0;462;42675124;41554697;26805142;5785167;42600315;28906355;6055259;0;71029
FR;1;2022-10-11;317;430;1309;8083;318;1189;8184;0;757;42675441;41555127;26806451;5793250;42600633;28907544;6063443;0;71786
FR;1;2022-10-12;321;419;1058;5179;312;1052;5194;0;520;42675762;41555546;26807509;5798429;42600945;28908596;6068637;0;72306
FR;1;2022-10-13;324;382;1066;6068;292;921;6118;0;626;42676086;41555928;26808575;5804497;42601237;28909517;6074755;0;72932
FR;1;2022-10-14;408;530;1169;6709;442;1041;6778;0;675;42676494;41556458;26809744;5811206;42601679;28910558;6081533;0;73607
FR;1;2022-10-15;201;258;519;1859;212;500;1867;0;226;42676695;41556716;26810263;5813065;42601891;28911058;6083400;0;73833
FR;1;2022-10-16;47;58;110;292;40;117;311;0;48;42676742;41556774;26810373;5813357;42601931;28911175;6083711;0;73881
FR;1;2022-10-17;235;318;733;2652;252;688;2696;0;366;42676977;41557092;26811106;5816009;42602183;28911863;6086407;0;74247
FR;1;2022-10-18;262;310;951;4588;245;830;4685;0;865;42677239;41557402;26812057;5820597;42602428;28912693;6091092;0;75112
FR;1;2022-10-19;275;358;690;3181;291;661;3160;0;502;42677514;41557760;26812747;5823778;42602719;28913354;6094252;0;75614
FR;1;2022-10-20;278;313;888;4363;260;776;4401;0;771;42677792;41558073;26813635;5828141;42602979;28914130;6098653;0;76385
FR;1;2022-10-21;299;400;844;3802;354;737;3874;0;675;42678091;41558473;26814479;5831943;42603333;28914867;6102527;0;77060
FR;1;2022-10-22;135;168;306;1243;144;300;1209;0;209;42678226;41558641;26814785;5833186;42603477;28915167;6103736;0;77269
FR;1;2022-10-23;30;39;64;197;37;58;213;0;25;42678256;41558680;26814849;5833383;42603514;28915225;6103949;0;77294
FR;1;2022-10-24;272;231;476;1599;203;472;1655;0;306;42678528;41558911;26815325;5834982;42603717;28915697;6105604;0;77600
FR;1;2022-10-25;215;252;524;2649;220;445;2704;0;488;42678743;41559163;26815849;5837631;42603937;28916142;6108308;0;78088
FR;1;2022-10-26;232;244;390;1953;230;367;1959;0;435;42678975;41559407;26816239;5839584;42604167;28916509;6110267;0;78523
FR;1;2022-10-27;258;219;488;2163;191;506;2147;0;512;42679233;41559626;26816727;5841747;42604358;28917015;6112414;0;79035
FR;1;2022-10-28;306;313;529;2334;295;466;2401;0;473;42679539;41559939;26817256;5844081;42604653;28917481;6114815;0;79508
FR;1;2022-10-29;97;149;175;712;117;209;703;0;201;42679636;41560088;26817431;5844793;42604770;28917690;6115518;0;79709
FR;1;2022-10-30;37;41;60;181;33;54;187;0;38;42679673;41560129;26817491;5844974;42604803;28917744;6115705;0;79747
FR;1;2022-10-31;135;180;293;796;159;270;863;0;144;42679808;41560309;26817784;5845770;42604962;28918014;6116568;0;79891
FR;1;2022-11-01;39;107;755;115;93;751;135;0;18;42679847;41560416;26818539;5845885;42605055;28918765;6116703;0;79909
FR;1;2022-11-02;255;224;519;979;220;488;1040;0;354;42680102;41560640;26819058;5846864;42605275;28919253;6117743;0;80263
FR;1;2022-11-03;265;221;433;1376;209;392;1415;0;370;42680367;41560861;26819491;5848240;42605484;28919645;6119158;0;80633
FR;1;2022-11-04;229;250;420;1597;229;399;1635;0;437;42680596;41561111;26819911;5849837;42605713;28920044;6120793;0;81070
FR;1;2022-11-05;95;118;272;500;107;254;522;0;111;42680691;41561229;26820183;5850337;42605820;28920298;6121315;0;81181
FR;1;2022-11-06;35;42;32;131;41;35;129;0;33;42680726;41561271;26820215;5850468;42605861;28920333;6121444;0;81214
FR;1;2022-11-07;181;200;289;891;189;279;937;0;211;42680907;41561471;26820504;5851359;42606050;28920612;6122381;0;81425
FR;1;2022-11-08;194;230;453;1677;218;400;1704;0;518;42681101;41561701;26820957;5853036;42606268;28921012;6124085;0;81943
FR;1;2022-11-09;181;205;330;1103;192;296;1140;0;458;42681282;41561906;26821287;5854139;42606460;28921308;6125225;0;82401
FR;1;2022-11-10;203;261;426;1678;250;435;1665;0;580;42681485;41562167;26821713;5855817;42606710;28921743;6126890;0;82981
FR;1;2022-11-11;27;32;101;98;31;87;114;0;42;42681512;41562199;26821814;5855915;42606741;28921830;6127004;0;83023
FR;1;2022-11-12;80;110;254;375;97;252;390;0;101;42681592;41562309;26822068;5856290;42606838;28922082;6127394;0;83124
FR;1;2022-11-13;19;23;26;64;20;29;66;0;26;42681611;41562332;26822094;5856354;42606858;28922111;6127460;0;83150
FR;1;2022-11-14;166;170;255;765;158;259;835;0;234;42681777;41562502;26822349;5857119;42607016;28922370;6128295;0;83384
FR;1;2022-11-15;199;224;374;1288;223;350;1328;0;433;42681976;41562726;26822723;5858407;42607239;28922720;6129623;0;83817
FR;1;2022-11-16;180;214;323;981;209;336;1016;0;359;42682156;41562940;26823046;5859388;42607448;28923056;6130639;0;84176
FR;1;2022-11-17;163;177;282;1203;172;258;1208;0;386;42682319;41563117;26823328;5860591;42607620;28923314;6131847;0;84562
FR;1;2022-11-18;223;248;387;1313;242;376;1346;0;411;42682542;41563365;26823715;5861904;42607862;28923690;6133193;0;84973
FR;1;2022-11-19;119;100;242;434;98;207;467;0;99;42682661;41563465;26823957;5862338;42607960;28923897;6133660;0;85072
FR;1;2022-11-20;21;32;27;66;27;29;74;0;28;42682682;41563497;26823984;5862404;42607987;28923926;6133734;0;85100
FR;1;2022-11-21;174;163;264;638;138;281;673;0;211;42682856;41563660;26824248;5863042;42608125;28924207;6134407;0;85311
FR;1;2022-11-22;152;141;403;1153;124;386;1176;0;405;42683008;41563801;26824651;5864195;42608249;28924593;6135583;0;85716
FR;1;2022-11-23;176;162;237;758;143;238;780;0;241;42683184;41563963;26824888;5864953;42608392;28924831;6136363;0;85957
FR;1;2022-11-24;129;158;279;1175;140;278;1178;0;424;42683313;41564121;26825167;5866128;42608532;28925109;6137541;0;86381
FR;1;2022-11-25;194;225;422;1152;211;410;1184;0;392;42683507;41564346;26825589;5867280;42608743;28925519;6138725;0;86773
FR;1;2022-11-26;88;103;111;317;92;122;305;0;117;42683595;41564449;26825700;5867597;42608835;28925641;6139030;0;86890
FR;1;2022-11-27;14;28;18;71;15;30;77;0;49;42683609;41564477;26825718;5867668;42608850;28925671;6139107;0;86939
FR;1;2022-11-28;199;134;206;662;142;201;705;0;331;42683808;41564611;26825924;5868330;42608992;28925872;6139812;0;87270
FR;1;2022-11-29;167;136;257;1078;120;242;1088;0;454;42683975;41564747;26826181;5869408;42609112;28926114;6140900;0;87724
FR;1;2022-11-30;157;187;226;927;174;228;950;0;318;42684132;41564934;26826407;5870335;42609286;28926342;6141850;0;88042
FR;1;2022-12-01;131;129;644;1080;121;606;1121;0;361;42684263;41565063;26827051;5871415;42609407;28926948;6142971;0;88403
FR;1;2022-12-02;191;182;475;1178;178;470;1225;0;466;42684454;41565245;26827526;5872593;42609585;28927418;6144196;0;88869
FR;1;2022-12-03;101;101;226;524;90;203;525;0;174;42684555;41565346;26827752;5873117;42609675;28927621;6144721;0;89043
FR;1;2022-12-04;24;26;19;136;23;20;127;0;58;42684579;41565372;26827771;5873253;42609698;28927641;6144848;0;89101
FR;1;2022-12-05;130;115;264;857;110;259;887;0;303;42684709;41565487;26828035;5874110;42609808;28927900;6145735;0;89404
FR;1;2022-12-06;143;136;254;1434;123;258;1441;0;726;42684852;41565623;26828289;5875544;42609931;28928158;6147176;0;90130
FR;1;2022-12-07;143;137;230;1180;149;209;1197;0;571;42684995;41565760;26828519;5876724;42610080;28928367;6148373;0;90701
FR;1;2022-12-08;123;132;278;1729;123;234;1774;0;762;42685118;41565892;26828797;5878453;42610203;28928601;6150147;0;91463
FR;1;2022-12-09;193;186;298;1800;161;305;1820;0;718;42685311;41566078;26829095;5880253;42610364;28928906;6151967;0;92181
FR;1;2022-12-10;108;92;152;840;81;138;855;0;289;42685419;41566170;26829247;5881093;42610445;28929044;6152822;0;92470
FR;1;2022-12-11;31;30;30;215;26;28;200;0;62;42685450;41566200;26829277;5881308;42610471;28929072;6153022;0;92532
FR;1;2022-12-12;115;80;253;1093;79;239;1105;0;453;42685565;41566280;26829530;5882401;42610550;28929311;6154127;0;92985
FR;1;2022-12-13;113;115;242;1286;89;223;1294;0;609;42685678;41566395;26829772;5883687;42610639;28929534;6155421;0;93594
FR;1;2022-12-14;100;127;228;856;123;209;876;0;367;42685778;41566522;26830000;5884543;42610762;28929743;6156297;0;93961
FR;1;2022-12-15;125;120;235;1453;109;210;1470;0;679;42685903;41566642;26830235;5885996;42610871;28929953;6157767;0;94640
FR;1;2022-12-16;194;181;248;1282;187;239;1298;0;614;42686097;41566823;26830483;5887278;42611058;28930192;6159065;0;95254
FR;1;2022-12-17;87;78;92;451;70;89;453;0;200;42686184;41566901;26830575;5887729;42611128;28930281;6159518;0;95454
FR;1;2022-12-18;16;19;22;97;16;24;94;0;37;42686200;41566920;26830597;5887826;42611144;28930305;6159612;0;95491
FR;1;2022-12-19;145;118;184;778;123;159;815;0;358;42686345;41567038;26830781;5888604;42611267;28930464;6160427;0;95849
FR;1;2022-12-20;134;129;167;862;120;161;866;0;401;42686479;41567167;26830948;5889466;42611387;28930625;6161293;0;96250
FR;1;2022-12-21;129;97;136;613;103;103;622;0;352;42686608;41567264;26831084;5890079;42611490;28930728;6161915;0;96602
FR;1;2022-12-22;139;87;106;507;94;94;498;0;293;42686747;41567351;26831190;5890586;42611584;28930822;6162413;0;96895
FR;1;2022-12-23;121;99;117;351;86;117;342;0;173;42686868;41567450;26831307;5890937;42611670;28930939;6162755;0;97068
FR;1;2022-12-24;27;18;25;53;21;24;59;0;19;42686895;41567468;26831332;5890990;42611691;28930963;6162814;0;97087
FR;1;2022-12-25;3;3;9;10;3;7;9;0;11;42686898;41567471;26831341;5891000;42611694;28930970;6162823;0;97098
FR;1;2022-12-26;87;60;55;202;65;60;202;0;90;42686985;41567531;26831396;5891202;42611759;28931030;6163025;0;97188
FR;1;2022-12-27;104;130;106;365;125;110;378;0;173;42687089;41567661;26831502;5891567;42611884;28931140;6163403;0;97361
FR;1;2022-12-28;97;109;70;241;100;78;247;0;102;42687186;41567770;26831572;5891808;42611984;28931218;6163650;0;97463
FR;1;2022-12-29;101;84;82;262;83;80;280;0;111;42687287;41567854;26831654;5892070;42612067;28931298;6163930;0;97574
FR;1;2022-12-30;121;106;61;238;95;67;246;0;136;42687408;41567960;26831715;5892308;42612162;28931365;6164176;0;97710
FR;1;2022-12-31;35;32;14;64;36;12;64;0;14;42687443;41567992;26831729;5892372;42612198;28931377;6164240;0;97724
FR;1;2023-01-01;4;6;4;11;6;4;12;0;8;42687447;41567998;26831733;5892383;42612204;28931381;6164252;0;97732
FR;1;2023-01-02;60;49;47;96;57;39;103;0;49;42687507;41568047;26831780;5892479;42612261;28931420;6164355;0;97781
FR;2;2020-12-27;0;0;0;0;0;0;0;0;0;0;0;0;0;0;0;0;0;0
FR;2;2020-12-28;0;0;0;0;0;0;0;0;0;0;0;0;0;0;0;0;0;0
FR;2;2020-12-29;0;0;0;0;0;0;0;0;0;0;0;0;0;0;0;0;0;0
FR;2;2020-12-30;0;0;0;0;0;0;0;0;0;0;0;0;0;0;0;0;0;0
FR;2;2020-12-31;0;0;0;0;0;0;0;0;0;0;0;0;0;0;0;0;0;0
FR;2;2021-01-01;0;0;0;0;0;0;0;0;0;0;0;0;0;0;0;0;0;0
FR;2;2021-01-02;0;0;0;0;0;0;0;0;0;0;0;0;0;0;0;0;0;0
FR;2;2021-01-03;0;0;0;0;0;0;0;0;0;0;0;0;0;0;0;0;0;0
FR;2;2021-01-04;0;0;0;0;0;0;0;0;0;0;0;0;0;0;0;0;0;0
FR;2;2021-01-05;0;0;0;0;0;0;0;0;0;0;0;0;0;0;0;0;0;0
FR;2;2021-01-06;0;0;0;0;0;0;0;0;0;0;0;0;0;0;0;0;0;0
FR;2;2021-01-07;0;0;0;0;0;0;0;0;0;0;0;0;0;0;0;0;0;0
FR;2;2021-01-08;0;0;0;0;0;0;0;0;0;0;0;0;0;0;0;0;0;0
FR;2;2021-01-09;0;0;0;0;0;0;0;0;0;0;0;0;0;0;0;0;0;0
FR;2;2021-01-10;0;0;0;0;0;0;0;0;0;0;0;0;0;0;0;0;0;0
FR;2;2021-01-11;0;0;0;0;0;0;0;0;0;0;0;0;0;0;0;0;0;0
FR;2;2021-01-12;0;0;0;0;0;0;0;0;0;0;0;0;0;0;0;0;0;0
FR;2;2021-01-13;0;0;0;0;0;0;0;0;0;0;0;0;0;0;0;0;0;0
FR;2;2021-01-14;1644;0;0;0;213;0;0;0;0;1644;0;0;0;213;0;0;0;0
FR;2;2021-01-15;398;0;0;0;28;0;0;0;0;2042;0;0;0;241;0;0;0;0
FR;2;2021-01-16;316;0;0;0;12;0;0;0;0;2358;0;0;0;253;0;0;0;0
FR;2;2021-01-17;84;0;0;0;7;0;0;0;0;2442;0;0;0;260;0;0;0;0
FR;2;2021-01-18;3075;2;0;0;27;0;0;0;0;5517;2;0;0;287;0;0;0;0
FR;2;2021-01-19;4681;2;0;0;31;0;0;0;0;10198;4;0;0;318;0;0;0;0
FR;2;2021-01-20;5137;6;0;0;58;0;0;0;0;15335;10;0;0;376;0;0;0;0
FR;2;2021-01-21;5345;9;0;0;56;0;0;0;0;20680;19;0;0;432;0;0;0;0
FR;2;2021-01-22;5118;17;0;0;69;0;0;0;0;25798;36;0;0;501;0;0;0;0
FR;2;2021-01-23;1875;2;0;0;16;0;0;0;0;27673;38;0;0;517;0;0;0;0
FR;2;2021-01-24;163;2;0;0;8;0;0;0;0;27836;40;0;0;525;0;0;0;0
FR;2;2021-01-25;3814;3;0;0;36;0;0;0;0;31650;43;0;0;561;0;0;0;0
FR;2;2021-01-26;3926;6;0;0;42;0;0;0;0;35576;49;0;0;603;0;0;0;0
FR;2;2021-01-27;3605;4;0;0;36;0;0;0;0;39181;53;0;0;639;0;0;0;0
FR;2;2021-01-28;3755;9;0;0;44;0;0;0;0;42936;62;0;0;683;0;0;0;0
FR;2;2021-01-29;3299;5;0;0;41;0;0;0;0;46235;67;0;0;724;0;0;0;0
FR;2;2021-01-30;1133;3;0;0;16;0;0;0;0;47368;70;0;0;740;0;0;0;0
FR;2;2021-01-31;46;2;0;0;9;0;0;0;0;47414;72;0;0;749;0;0;0;0
FR;2;2021-02-01;3406;13;0;0;44;0;0;0;0;50820;85;0;0;793;0;0;0;0
FR;2;2021-02-02;4496;19;0;0;53;0;0;0;0;55316;104;0;0;846;0;0;0;0
FR;2;2021-02-03;5222;11;0;0;82;0;0;0;0;60538;115;0;0;928;0;0;0;0
FR;2;2021-02-04;4941;11;0;0;36;0;0;0;0;65479;126;0;0;964;0;0;0;0
FR;2;2021-02-05;4817;16;0;0;49;0;0;0;0;70296;142;0;0;1013;0;0;0;0
FR;2;2021-02-06;2044;15;0;0;41;0;0;0;0;72340;157;0;0;1054;0;0;0;0
FR;2;2021-02-07;103;6;0;0;20;0;0;0;0;72443;163;0;0;1074;0;0;0;0
FR;2;2021-02-08;7558;26;0;0;85;0;0;0;0;80001;189;0;0;1159;0;0;0;0
FR;2;2021-02-09;8434;30;0;0;98;0;0;0;0;88435;219;0;0;1257;0;0;0;0
FR;2;2021-02-10;9348;62;0;0;182;0;0;0;0;97783;281;0;0;1439;0;0;0;0
FR;2;2021-02-11;10291;129;0;0;253;0;0;0;0;108074;410;0;0;1692;0;0;0;0
FR;2;2021-02-12;10059;274;0;0;428;0;0;0;0;118133;684;0;0;2120;0;0;0;0
FR;2;2021-02-13;3120;225;0;0;263;0;0;0;0;121253;909;0;0;2383;0;0;0;0
FR;2;2021-02-14;358;11;0;0;21;0;0;0;0;121611;920;0;0;2404;0;0;0;0
FR;2;2021-02-15;3460;3122;0;0;3168;0;0;0;0;125071;4042;0;0;5572;0;0;0;0
FR;2;2021-02-16;5075;4153;0;0;4226;0;0;0;0;130146;8195;0;0;9798;0;0;0;0
FR;2;2021-02-17;4259;4551;0;0;4627;0;0;0;0;134405;12746;0;0;14425;0;0;0;0
FR;2;2021-02-18;5406;5176;0;0;5245;0;0;0;0;139811;17922;0;0;19670;0;0;0;0
FR;2;2021-02-19;5328;4485;0;0;4586;0;0;0;0;145139;22407;0;0;24256;0;0;0;0
FR;2;2021-02-20;1872;1520;0;0;1535;0;0;0;0;147011;23927;0;0;25791;0;0;0;0
FR;2;2021-02-21;244;96;0;0;98;0;0;0;0;147255;24023;0;0;25889;0;0;0;0
FR;2;2021-02-22;3614;3782;0;0;3843;0;0;0;0;150869;27805;0;0;29732;0;0;0;0
FR;2;2021-02-23;4956;3731;0;0;3793;0;0;0;0;155825;31536;0;0;33525;0;0;0;0
FR;2;2021-02-24;5017;3551;0;0;3603;0;0;0;0;160842;35087;0;0;37128;0;0;0;0
FR;2;2021-02-25;5500;3489;0;0;3578;0;0;0;0;166342;38576;0;0;40706;0;0;0;0
FR;2;2021-02-26;4367;3179;0;0;3249;0;0;0;0;170709;41755;0;0;43955;0;0;0;0
FR;2;2021-02-27;1629;1067;0;0;1086;0;0;0;0;172338;42822;0;0;45041;0;0;0;0
FR;2;2021-02-28;179;17;0;0;28;0;0;0;0;172517;42839;0;0;45069;0;0;0;0
FR;2;2021-03-01;5192;3759;0;0;3848;0;0;0;0;177709;46598;0;0;48917;0;0;0;0
FR;2;2021-03-02;6541;4725;0;0;4825;0;0;0;0;184250;51323;0;0;53742;0;0;0;0
FR;2;2021-03-03;6544;4953;0;0;5094;0;0;0;0;190794;56276;0;0;58836;0;0;0;0
FR;2;2021-03-04;8409;4203;0;0;4387;0;0;0;0;199203;60479;0;0;63223;0;0;0;0
FR;2;2021-03-05;8037;4056;0;0;4236;0;0;0;0;207240;64535;0;0;67459;0;0;0;0
FR;2;2021-03-06;4790;1683;0;0;1783;0;0;0;0;212030;66218;0;0;69242;0;0;0;0
FR;2;2021-03-07;2373;32;0;0;76;0;0;0;0;214403;66250;0;0;69318;0;0;0;0
FR;2;2021-03-08;4166;8392;0;0;8548;0;0;0;0;218569;74642;0;0;77866;0;0;0;0
FR;2;2021-03-09;7492;8601;1;0;8859;0;0;0;0;226061;83243;1;0;86725;0;0;0;0
FR;2;2021-03-10;7107;9240;0;0;9465;0;0;0;0;233168;92483;1;0;96190;0;0;0;0
FR;2;2021-03-11;9378;9355;1;0;9674;0;0;0;0;242546;101838;2;0;105864;0;0;0;0
FR;2;2021-03-12;7984;8361;0;0;8662;0;0;0;0;250530;110199;2;0;114526;0;0;0;0
FR;2;2021-03-13;10056;2589;0;0;2910;0;0;0;0;260586;112788;2;0;117436;0;0;0;0
FR;2;2021-03-14;4841;383;0;0;542;0;0;0;0;265427;113171;2;0;117978;0;0;0;0
FR;2;2021-03-15;10916;3472;0;0;3761;0;0;0;0;276343;116643;2;0;121739;0;0;0;0
FR;2;2021-03-16;16769;4708;1;0;5255;0;0;0;0;293112;121351;3;0;126994;0;0;0;0
FR;2;2021-03-17;20241;4004;0;0;4678;0;0;0;0;313353;125355;3;0;131672;0;0;0;0
FR;2;2021-03-18;23370;5118;0;0;5944;0;0;0;0;336723;130473;3;0;137616;0;0;0;0
FR;2;2021-03-19;23315;4672;0;0;5435;0;0;0;0;360038;135145;3;0;143051;0;0;0;0
FR;2;2021-03-20;25451;1580;0;0;2336;0;0;0;0;385489;136725;3;0;145387;0;0;0;0
FR;2;2021-03-21;17673;152;0;0;730;0;0;0;0;403162;136877;3;0;146117;0;0;0;0
FR;2;2021-03-22;17790;3253;0;0;3922;0;0;0;0;420952;140130;3;0;150039;0;0;0;0
FR;2;2021-03-23;22702;4283;0;0;5134;0;0;0;0;443654;144413;3;0;155173;0;0;0;0
FR;2;2021-03-24;23962;5076;0;0;5912;0;0;0;0;467616;149489;3;0;161085;0;0;0;0
FR;2;2021-03-25;26759;5245;1;0;6441;0;0;0;0;494375;154734;4;0;167526;0;0;0;0
FR;2;2021-03-26;26991;4233;0;0;5379;0;0;0;0;521366;158967;4;0;172905;0;0;0;0
FR;2;2021-03-27;15923;1363;0;0;1892;0;0;0;0;537289;160330;4;0;174797;0;0;0;0
FR;2;2021-03-28;10563;135;0;0;427;0;0;0;0;547852;160465;4;0;175224;0;0;0;0
FR;2;2021-03-29;19000;4344;0;0;5045;0;0;0;0;566852;164809;4;0;180269;0;0;0;0
FR;2;2021-03-30;24596;6104;0;0;7043;0;0;0;0;591448;170913;4;0;187312;0;0;0;0
FR;2;2021-03-31;28561;5930;0;0;7221;0;0;0;0;620009;176843;4;0;194533;0;0;0;0
FR;2;2021-04-01;34559;8573;1;0;10265;0;0;0;0;654568;185416;5;0;204798;0;0;0;0
FR;2;2021-04-02;29993;7734;0;0;9161;0;0;0;0;684561;193150;5;0;213959;0;0;0;0
FR;2;2021-04-03;16957;4233;0;0;4915;0;0;0;0;701518;197383;5;0;218874;0;0;0;0
FR;2;2021-04-04;9309;1268;2;0;1676;0;0;0;0;710827;198651;7;0;220550;0;0;0;0
FR;2;2021-04-05;12446;796;0;0;1380;0;0;0;0;723273;199447;7;0;221930;0;0;0;0
FR;2;2021-04-06;27158;7334;0;0;8724;0;0;0;0;750431;206781;7;0;230654;0;0;0;0
FR;2;2021-04-07;30930;7063;1;0;8640;0;0;0;0;781361;213844;8;0;239294;0;0;0;0
FR;2;2021-04-08;36894;8603;1;0;10528;0;0;0;0;818255;222447;9;0;249822;0;0;0;0
FR;2;2021-04-09;33852;8393;28;0;10176;0;0;0;0;852107;230840;37;0;259998;0;0;0;0
FR;2;2021-04-10;19689;9260;1;0;10173;0;0;0;0;871796;240100;38;0;270171;0;0;0;0
FR;2;2021-04-11;7942;4240;1;0;4603;0;0;0;0;879738;244340;39;0;274774;0;0;0;0
FR;2;2021-04-12;17128;11031;0;0;11870;0;0;0;0;896866;255371;39;0;286644;0;0;0;0
FR;2;2021-04-13;19460;16037;1;0;17102;0;0;0;0;916326;271408;40;0;303746;0;0;0;0
FR;2;2021-04-14;18070;16440;7;0;17534;0;0;0;0;934396;287848;47;0;321280;0;0;0;0
FR;2;2021-04-15;22204;21830;27;0;23281;0;0;0;0;956600;309678;74;0;344561;0;0;0;0
FR;2;2021-04-16;20720;20605;45;0;21874;0;0;0;0;977320;330283;119;0;366435;0;0;0;0
FR;2;2021-04-17;13258;22493;5;0;23223;0;0;0;0;990578;352776;124;0;389658;0;0;0;0
FR;2;2021-04-18;5911;14398;6;0;14738;0;0;0;0;996489;367174;130;0;404396;0;0;0;0
FR;2;2021-04-19;16850;16397;24;0;17201;0;0;0;0;1013339;383571;154;0;421597;0;0;0;0
FR;2;2021-04-20;19325;21790;38;0;22852;0;0;0;0;1032664;405361;192;0;444449;0;0;0;0
FR;2;2021-04-21;20292;21868;76;0;23019;0;0;0;0;1052956;427229;268;0;467468;0;0;0;0
FR;2;2021-04-22;23824;24942;41;0;26351;0;0;0;0;1076780;452171;309;0;493819;0;0;0;0
FR;2;2021-04-23;24532;25480;76;0;26990;0;0;0;0;1101312;477651;385;0;520809;0;0;0;0
FR;2;2021-04-24;25305;15062;104;0;16500;0;0;0;0;1126617;492713;489;0;537309;0;0;0;0
FR;2;2021-04-25;9597;8620;5;0;9181;0;0;0;0;1136214;501333;494;0;546490;0;0;0;0
FR;2;2021-04-26;17165;17634;21;0;18520;0;0;0;0;1153379;518967;515;0;565010;0;0;0;0
FR;2;2021-04-27;19246;24120;40;0;25303;0;0;0;0;1172625;543087;555;0;590313;0;0;0;0
FR;2;2021-04-28;22341;26438;112;0;27838;0;0;0;0;1194966;569525;667;0;618151;0;0;0;0
FR;2;2021-04-29;25473;30462;70;0;32151;0;0;0;0;1220439;599987;737;0;650302;0;0;0;0
FR;2;2021-04-30;25539;27954;49;1;29600;0;0;0;0;1245978;627941;786;1;679902;0;0;0;0
FR;2;2021-05-01;14988;9846;6;0;10648;0;0;0;0;1260966;637787;792;1;690550;0;0;0;0
FR;2;2021-05-02;6640;9165;2;0;9510;0;0;0;0;1267606;646952;794;1;700060;0;0;0;0
FR;2;2021-05-03;20023;19131;40;0;20335;0;0;0;0;1287629;666083;834;1;720395;0;0;0;0
FR;2;2021-05-04;18287;29190;33;0;30333;0;0;0;0;1305916;695273;867;1;750728;0;0;0;0
FR;2;2021-05-05;18385;29505;48;0;30801;0;0;0;0;1324301;724778;915;1;781529;0;0;0;0
FR;2;2021-05-06;23550;35404;132;0;36976;0;0;0;0;1347851;760182;1047;1;818505;0;0;0;0
FR;2;2021-05-07;25340;33234;97;0;35091;0;0;0;0;1373191;793416;1144;1;853596;0;0;0;0
FR;2;2021-05-08;21342;10602;15;0;11691;0;0;0;0;1394533;804018;1159;1;865287;0;0;0;0
FR;2;2021-05-09;13169;7653;7;0;8328;0;0;0;0;1407702;811671;1166;1;873615;0;0;0;0
FR;2;2021-05-10;32944;21732;50;0;23590;0;0;0;0;1440646;833403;1216;1;897205;0;0;0;0
FR;2;2021-05-11;43613;20913;101;0;23539;0;0;0;0;1484259;854316;1317;1;920744;0;0;0;0
FR;2;2021-05-12;50064;19639;143;0;22518;0;0;0;0;1534323;873955;1460;1;943262;0;0;0;0
FR;2;2021-05-13;51298;5607;31;0;8475;0;0;0;0;1585621;879562;1491;1;951737;0;0;0;0
FR;2;2021-05-14;61359;12887;132;0;16540;0;0;0;0;1646980;892449;1623;1;968277;0;0;0;0
FR;2;2021-05-15;65936;7096;39;0;10646;0;0;0;0;1712916;899545;1662;1;978923;0;0;0;0
FR;2;2021-05-16;43588;2572;10;0;4942;0;0;0;0;1756504;902117;1672;1;983865;0;0;0;0
FR;2;2021-05-17;44754;12460;114;0;15366;0;0;0;0;1801258;914577;1786;1;999231;0;0;0;0
FR;2;2021-05-18;54646;12279;190;0;15961;0;0;0;0;1855904;926856;1976;1;1015192;0;0;0;0
FR;2;2021-05-19;57177;10467;281;0;14508;0;0;0;0;1913081;937323;2257;1;1029700;0;0;0;0
FR;2;2021-05-20;63447;10801;288;0;14900;0;0;0;0;1976528;948124;2545;1;1044600;0;0;0;0
FR;2;2021-05-21;64305;11606;230;0;16030;0;0;0;0;2040833;959730;2775;1;1060630;0;0;0;0
FR;2;2021-05-22;61488;4531;65;0;8501;0;0;0;0;2102321;964261;2840;1;1069131;0;0;0;0
FR;2;2021-05-23;37536;575;22;0;2912;0;0;0;0;2139857;964836;2862;1;1072043;0;0;0;0
FR;2;2021-05-24;17245;2050;35;0;3257;0;0;0;0;2157102;966886;2897;1;1075300;0;0;0;0
FR;2;2021-05-25;21119;12248;241;0;13850;0;0;0;0;2178221;979134;3138;1;1089150;0;0;0;0
FR;2;2021-05-26;19942;11536;230;0;13060;0;0;0;0;2198163;990670;3368;1;1102210;0;0;0;0
FR;2;2021-05-27;23000;12640;182;0;14377;0;0;0;0;2221163;1003310;3550;1;1116587;0;0;0;0
FR;2;2021-05-28;29394;15039;190;0;17221;0;0;0;0;2250557;1018349;3740;1;1133808;0;0;0;0
FR;2;2021-05-29;30422;8193;58;0;10101;0;0;0;0;2280979;1026542;3798;1;1143909;0;0;0;0
FR;2;2021-05-30;4648;1820;6;0;2155;0;0;0;0;2285627;1028362;3804;1;1146064;0;0;0;0
FR;2;2021-05-31;28590;18749;184;0;20828;0;0;0;0;2314217;1047111;3988;1;1166892;0;0;0;0
FR;2;2021-06-01;45739;19902;225;0;23141;0;0;0;0;2359956;1067013;4213;1;1190033;0;0;0;0
FR;2;2021-06-02;37477;19304;182;0;22309;0;0;0;0;2397433;1086317;4395;1;1212342;0;0;0;0
FR;2;2021-06-03;51281;23112;161;0;26966;0;0;0;0;2448714;1109429;4556;1;1239308;0;0;0;0
FR;2;2021-06-04;65516;24093;217;0;29063;0;0;0;0;2514230;1133522;4773;1;1268371;0;0;0;0
FR;2;2021-06-05;34605;24100;52;0;26955;0;0;0;0;2548835;1157622;4825;1;1295326;0;0;0;0
FR;2;2021-06-06;4957;6193;10;0;6612;0;0;0;0;2553792;1163815;4835;1;1301938;0;0;0;0
FR;2;2021-06-07;28178;23011;150;0;25425;0;0;0;0;2581970;1186826;4985;1;1327363;0;0;0;0
FR;2;2021-06-08;46377;22939;143;0;26903;0;0;0;0;2628347;1209765;5128;1;1354266;0;0;0;0
FR;2;2021-06-09;34296;20982;107;0;24115;0;0;0;0;2662643;1230747;5235;1;1378381;0;0;0;0
FR;2;2021-06-10;42643;19084;96;1;23006;0;0;0;0;2705286;1249831;5331;2;1401387;0;0;0;0
FR;2;2021-06-11;55302;25143;134;0;30241;0;0;0;0;2760588;1274974;5465;2;1431628;0;0;0;0
FR;2;2021-06-12;30563;19796;53;0;22650;0;0;0;0;2791151;1294770;5518;2;1454278;0;0;0;0
FR;2;2021-06-13;3333;9193;13;0;9581;0;0;0;0;2794484;1303963;5531;2;1463859;0;0;0;0
FR;2;2021-06-14;25304;24112;92;0;26693;0;0;0;0;2819788;1328075;5623;2;1490552;0;0;0;0
FR;2;2021-06-15;39048;22824;154;0;26574;0;0;0;0;2858836;1350899;5777;2;1517126;0;0;0;0
FR;2;2021-06-16;30166;21365;135;0;24520;0;0;0;0;2889002;1372264;5912;2;1541646;0;0;0;0
FR;2;2021-06-17;36912;25760;150;0;29623;0;0;0;0;2925914;1398024;6062;2;1571269;0;0;0;0
FR;2;2021-06-18;46860;28885;123;0;33587;0;0;0;0;2972774;1426909;6185;2;1604856;0;0;0;0
FR;2;2021-06-19;24527;24931;39;0;27704;0;0;0;0;2997301;1451840;6224;2;1632560;0;0;0;0
FR;2;2021-06-20;3745;10057;9;0;10556;0;0;0;0;3001046;1461897;6233;2;1643116;0;0;0;0
FR;2;2021-06-21;17537;42852;88;0;44863;0;0;0;0;3018583;1504749;6321;2;1687979;0;0;0;0
FR;2;2021-06-22;28365;49615;110;0;53043;0;0;0;0;3046948;1554364;6431;2;1741022;0;0;0;0
FR;2;2021-06-23;21791;49600;107;1;52446;1;0;0;0;3068739;1603964;6538;3;1793468;1;0;0;0
FR;2;2021-06-24;28378;50305;134;0;54040;0;0;0;0;3097117;1654269;6672;3;1847508;1;0;0;0
FR;2;2021-06-25;33402;60457;128;0;64843;0;0;0;0;3130519;1714726;6800;3;1912351;1;0;0;0
FR;2;2021-06-26;16395;59334;54;1;61724;0;0;0;0;3146914;1774060;6854;4;1974075;1;0;0;0
FR;2;2021-06-27;2566;29319;22;1;29900;0;0;0;0;3149480;1803379;6876;5;2003975;1;0;0;0
FR;2;2021-06-28;12641;54337;84;0;56311;0;0;0;0;3162121;1857716;6960;5;2060286;1;0;0;0
FR;2;2021-06-29;19857;59984;178;0;62928;0;0;0;0;3181978;1917700;7138;5;2123214;1;0;0;0
FR;2;2021-06-30;16334;58024;253;17;60710;0;0;0;0;3198312;1975724;7391;22;2183924;1;0;0;0
FR;2;2021-07-01;20494;59865;228;0;63193;0;0;0;0;3218806;2035589;7619;22;2247117;1;0;0;0
FR;2;2021-07-02;24080;62159;184;0;66375;0;0;0;0;3242886;2097748;7803;22;2313492;1;0;0;0
FR;2;2021-07-03;12121;57137;153;0;59473;0;0;0;0;3255007;2154885;7956;22;2372965;1;0;0;0
FR;2;2021-07-04;1960;23304;18;0;23871;0;0;0;0;3256967;2178189;7974;22;2396836;1;0;0;0
FR;2;2021-07-05;9179;29274;106;0;30910;0;0;0;0;3266146;2207463;8080;22;2427746;1;0;0;0
FR;2;2021-07-06;14583;36268;135;0;38947;0;0;0;0;3280729;2243731;8215;22;2466693;1;0;0;0
FR;2;2021-07-07;14416;33660;139;0;36415;0;0;0;0;3295145;2277391;8354;22;2503108;1;0;0;0
FR;2;2021-07-08;19722;40322;162;0;43983;0;0;0;0;3314867;2317713;8516;22;2547091;1;0;0;0
FR;2;2021-07-09;27104;54320;202;1;59472;0;0;0;0;3341971;2372033;8718;23;2606563;1;0;0;0
FR;2;2021-07-10;13388;33705;107;0;36393;0;0;0;0;3355359;2405738;8825;23;2642956;1;0;0;0
FR;2;2021-07-11;1811;4345;16;0;4774;0;0;0;0;3357170;2410083;8841;23;2647730;1;0;0;0
FR;2;2021-07-12;12971;37277;119;0;39934;0;0;0;0;3370141;2447360;8960;23;2687664;1;0;0;0
FR;2;2021-07-13;37117;53158;152;0;60295;0;0;0;0;3407258;2500518;9112;23;2747959;1;0;0;0
FR;2;2021-07-14;6627;3540;15;0;4888;0;0;0;0;3413885;2504058;9127;23;2752847;1;0;0;0
FR;2;2021-07-15;47244;47012;156;0;55212;0;0;0;0;3461129;2551070;9283;23;2808059;1;0;0;0
FR;2;2021-07-16;64318;55765;188;0;66748;0;0;0;0;3525447;2606835;9471;23;2874807;1;0;0;0
FR;2;2021-07-17;31600;23912;96;0;29366;0;0;0;0;3557047;2630747;9567;23;2904173;1;0;0;0
FR;2;2021-07-18;6090;4810;19;0;5957;0;0;0;0;3563137;2635557;9586;23;2910130;1;0;0;0
FR;2;2021-07-19;33006;28620;94;0;34235;0;0;0;0;3596143;2664177;9680;23;2944365;1;0;0;0
FR;2;2021-07-20;51998;44521;155;0;53160;0;0;0;0;3648141;2708698;9835;23;2997525;1;0;0;0
FR;2;2021-07-21;45256;34648;93;0;42157;0;0;0;0;3693397;2743346;9928;23;3039682;1;0;0;0
FR;2;2021-07-22;56279;41087;128;1;50372;0;0;0;0;3749676;2784433;10056;24;3090054;1;0;0;0
FR;2;2021-07-23;68301;48973;170;0;60267;0;0;0;0;3817977;2833406;10226;24;3150321;1;0;0;0
FR;2;2021-07-24;36180;21614;82;0;27476;0;0;0;0;3854157;2855020;10308;24;3177797;1;0;0;0
FR;2;2021-07-25;6751;2613;10;0;3872;0;0;0;0;3860908;2857633;10318;24;3181669;1;0;0;0
FR;2;2021-07-26;36319;22346;91;1;27853;0;0;0;0;3897227;2879979;10409;25;3209522;1;0;0;0
FR;2;2021-07-27;62390;34563;180;0;43709;0;0;0;0;3959617;2914542;10589;25;3253231;1;0;0;0
FR;2;2021-07-28;55323;26426;132;0;34520;0;0;0;0;4014940;2940968;10721;25;3287751;1;0;0;0
FR;2;2021-07-29;68480;32788;189;0;42476;0;0;0;0;4083420;2973756;10910;25;3330227;1;0;0;0
FR;2;2021-07-30;74465;37812;222;1;48609;0;0;0;0;4157885;3011568;11132;26;3378836;1;0;0;0
FR;2;2021-07-31;34776;16203;105;0;21403;0;0;0;0;4192661;3027771;11237;26;3400239;1;0;0;0
FR;2;2021-08-01;5414;2257;19;0;3120;0;0;0;0;4198075;3030028;11256;26;3403359;1;0;0;0
FR;2;2021-08-02;35889;16161;101;0;21062;0;0;0;0;4233964;3046189;11357;26;3424421;1;0;0;0
FR;2;2021-08-03;55986;28267;142;0;35475;0;0;0;0;4289950;3074456;11499;26;3459896;1;0;0;0
FR;2;2021-08-04;46637;20835;128;1;26950;0;0;0;0;4336587;3095291;11627;27;3486846;1;0;0;0
FR;2;2021-08-05;54639;31551;215;0;38738;0;0;0;0;4391226;3126842;11842;27;3525584;1;0;0;0
FR;2;2021-08-06;58098;42393;242;1;50230;0;0;0;0;4449324;3169235;12084;28;3575814;1;0;0;0
FR;2;2021-08-07;25150;17626;89;0;21319;0;0;0;0;4474474;3186861;12173;28;3597133;1;0;0;0
FR;2;2021-08-08;3839;3646;21;0;4304;0;0;0;0;4478313;3190507;12194;28;3601437;1;0;0;0
FR;2;2021-08-09;29308;21037;92;0;24863;0;0;0;0;4507621;3211544;12286;28;3626300;1;0;0;0
FR;2;2021-08-10;45011;33470;155;0;39238;0;0;0;0;4552632;3245014;12441;28;3665538;1;0;0;0
FR;2;2021-08-11;35274;25149;151;0;29754;0;0;0;0;4587906;3270163;12592;28;3695292;1;0;0;0
FR;2;2021-08-12;41904;35694;163;0;41234;0;0;0;0;4629810;3305857;12755;28;3736526;1;0;0;0
FR;2;2021-08-13;42606;37304;218;0;42995;0;0;0;0;4672416;3343161;12973;28;3779521;1;0;0;0
FR;2;2021-08-14;18524;22148;94;0;24783;0;0;0;0;4690940;3365309;13067;28;3804304;1;0;0;0
FR;2;2021-08-15;3861;3797;17;0;4385;0;0;0;0;4694801;3369106;13084;28;3808689;1;0;0;0
FR;2;2021-08-16;25093;27127;111;0;30454;0;0;0;0;4719894;3396233;13195;28;3839143;1;0;0;0
FR;2;2021-08-17;38264;43409;207;2;48401;0;0;0;0;4758158;3439642;13402;30;3887544;1;0;0;0
FR;2;2021-08-18;32253;36350;195;1;40700;1;0;0;0;4790411;3475992;13597;31;3928244;2;0;0;0
FR;2;2021-08-19;37434;46581;224;0;51790;0;0;0;0;4827845;3522573;13821;31;3980034;2;0;0;0
FR;2;2021-08-20;40568;55640;271;1;61577;0;0;0;0;4868413;3578213;14092;32;4041611;2;0;0;0
FR;2;2021-08-21;18121;24315;117;0;27107;0;0;0;0;4886534;3602528;14209;32;4068718;2;0;0;0
FR;2;2021-08-22;2908;4325;22;1;4857;1;0;0;0;4889442;3606853;14231;33;4073575;3;0;0;0
FR;2;2021-08-23;19248;35150;131;1;38044;0;0;0;0;4908690;3642003;14362;34;4111619;3;0;0;0
FR;2;2021-08-24;31952;56037;236;0;60699;0;0;0;0;4940642;3698040;14598;34;4172318;3;0;0;0
FR;2;2021-08-25;25934;43452;251;0;47405;0;0;0;0;4966576;3741492;14849;34;4219723;3;0;0;0
FR;2;2021-08-26;32362;55832;388;0;60595;0;0;0;0;4998938;3797324;15237;34;4280318;3;0;0;0
FR;2;2021-08-27;37003;65684;477;2;71420;0;0;0;0;5035941;3863008;15714;36;4351738;3;0;0;0
FR;2;2021-08-28;17819;28553;300;0;31618;0;0;0;0;5053760;3891561;16014;36;4383356;3;0;0;0
FR;2;2021-08-29;2656;5010;47;0;5623;0;0;0;0;5056416;3896571;16061;36;4388979;3;0;0;0
FR;2;2021-08-30;18417;37727;400;0;40145;759;0;0;0;5074833;3934298;16461;36;4429124;762;0;0;0
FR;2;2021-08-31;28077;57512;887;4;60950;1557;0;0;0;5102910;3991810;17348;40;4490074;2319;0;0;0
FR;2;2021-09-01;21594;39874;1309;0;42266;2125;0;0;0;5124504;4031684;18657;40;4532340;4444;0;0;0
FR;2;2021-09-02;25485;48664;1963;2;50949;3366;0;0;0;5149989;4080348;20620;42;4583289;7810;0;0;0
FR;2;2021-09-03;33413;64566;2988;3;67539;4882;1;0;0;5183402;4144914;23608;45;4650828;12692;1;0;0
FR;2;2021-09-04;16832;27762;1443;1;29559;2383;0;0;0;5200234;4172676;25051;46;4680387;15075;1;0;0
FR;2;2021-09-05;2264;3588;266;0;3946;412;0;0;0;5202498;4176264;25317;46;4684333;15487;1;0;0
FR;2;2021-09-06;14043;28699;1771;1;29766;2945;0;0;0;5216541;4204963;27088;47;4714099;18432;1;0;0
FR;2;2021-09-07;21108;41106;3021;13;42274;4932;0;0;0;5237649;4246069;30109;60;4756373;23364;1;0;0
FR;2;2021-09-08;17248;31920;2736;6;32738;4500;0;0;0;5254897;4277989;32845;66;4789111;27864;1;0;0
FR;2;2021-09-09;20981;40486;4437;3;41238;6839;0;0;0;5275878;4318475;37282;69;4830349;34703;1;0;0
FR;2;2021-09-10;28200;51300;5286;4;51889;8968;1;0;0;5304078;4369775;42568;73;4882238;43671;2;0;0
FR;2;2021-09-11;13654;22446;2405;5;23133;3977;0;0;0;5317732;4392221;44973;78;4905371;47648;2;0;0
FR;2;2021-09-12;1824;2773;292;0;2968;510;0;0;0;5319556;4394994;45265;78;4908339;48158;2;0;0
FR;2;2021-09-13;11659;21444;2474;4;21708;4048;0;0;0;5331215;4416438;47739;82;4930047;52206;2;0;0
FR;2;2021-09-14;18576;32733;5092;13;31695;9058;2;0;0;5349791;4449171;52831;95;4961742;61264;4;0;0
FR;2;2021-09-15;14915;28237;5169;3;26931;7756;9;0;0;5364706;4477408;58000;98;4988673;69020;13;0;0
FR;2;2021-09-16;16078;32792;6737;12;30183;10537;4;0;0;5380784;4510200;64737;110;5018856;79557;17;0;0
FR;2;2021-09-17;20915;47160;8781;10;42819;14620;6;0;0;5401699;4557360;73518;120;5061675;94177;23;0;0
FR;2;2021-09-18;9857;20962;3804;6;19595;6036;1;0;0;5411556;4578322;77322;126;5081270;100213;24;0;0
FR;2;2021-09-19;1166;2595;396;0;2538;632;0;0;0;5412722;4580917;77718;126;5083808;100845;24;0;0
FR;2;2021-09-20;7501;18703;3856;7;17026;6137;4;0;0;5420223;4599620;81574;133;5100834;106982;28;0;0
FR;2;2021-09-21;11215;29990;6495;5;26539;10749;3;0;0;5431438;4629610;88069;138;5127373;117731;31;0;0
FR;2;2021-09-22;9413;23543;5490;6;21196;8521;8;0;0;5440851;4653153;93559;144;5148569;126252;39;0;0
FR;2;2021-09-23;10731;28900;7881;10;24726;12649;10;0;0;5451582;4682053;101440;154;5173295;138901;49;0;0
FR;2;2021-09-24;15075;42933;10876;18;37276;17240;21;0;0;5466657;4724986;112316;172;5210571;156141;70;0;0
FR;2;2021-09-25;7258;18795;3965;9;17151;6118;3;0;0;5473915;4743781;116281;181;5227722;162259;73;0;0
FR;2;2021-09-26;1080;2547;495;0;2493;630;1;0;0;5474995;4746328;116776;181;5230215;162889;74;0;0
FR;2;2021-09-27;6312;16404;4287;8;14796;6534;2;0;0;5481307;4762732;121063;189;5245011;169423;76;0;0
FR;2;2021-09-28;9241;25568;7769;14;21718;12082;7;0;0;5490548;4788300;128832;203;5266729;181505;83;0;0
FR;2;2021-09-29;8081;20203;6067;25;17609;9262;8;0;0;5498629;4808503;134899;228;5284338;190767;91;0;0
FR;2;2021-09-30;9865;25837;9509;16;21636;14101;6;0;0;5508494;4834340;144408;244;5305974;204868;97;0;0
FR;2;2021-10-01;13978;35731;12919;25;30049;19320;10;0;0;5522472;4870071;157327;269;5336023;224188;107;0;0
FR;2;2021-10-02;6874;15931;4850;7;14227;7047;6;0;0;5529346;4886002;162177;276;5350250;231235;113;0;0
FR;2;2021-10-03;841;1910;492;1;1840;502;0;0;0;5530187;4887912;162669;277;5352090;231737;113;0;0
FR;2;2021-10-04;5826;13900;5516;5;12137;7853;6;0;0;5536013;4901812;168185;282;5364227;239590;119;0;0
FR;2;2021-10-05;9057;22561;11125;19;18526;15739;1;0;0;5545070;4924373;179310;301;5382753;255329;120;0;0
FR;2;2021-10-06;7784;17744;8243;11;15273;11090;4;0;0;5552854;4942117;187553;312;5398026;266419;124;0;0
FR;2;2021-10-07;9204;22206;12386;14;18008;16872;6;0;0;5562058;4964323;199939;326;5416034;283291;130;0;0
FR;2;2021-10-08;13431;32136;17349;28;26510;23610;13;0;0;5575489;4996459;217288;354;5442544;306901;143;0;0
FR;2;2021-10-09;6000;12845;6044;6;11381;7895;7;0;0;5581489;5009304;223332;360;5453925;314796;150;0;0
FR;2;2021-10-10;885;1598;436;2;1541;606;1;0;0;5582374;5010902;223768;362;5455466;315402;151;0;0
FR;2;2021-10-11;5607;11551;6455;17;9940;8828;3;0;0;5587981;5022453;230223;379;5465406;324230;154;0;0
FR;2;2021-10-12;8029;17785;12550;13;13924;16782;9;0;0;5596010;5040238;242773;392;5479330;341012;163;0;0
FR;2;2021-10-13;6945;14852;10256;12;11808;13647;7;0;0;5602955;5055090;253029;404;5491138;354659;170;0;0
FR;2;2021-10-14;8314;17936;14996;13;13559;19471;11;0;0;5611269;5073026;268025;417;5504697;374130;181;0;0
FR;2;2021-10-15;11856;26310;20902;26;19414;27980;4;0;0;5623125;5099336;288927;443;5524111;402110;185;0;0
FR;2;2021-10-16;5140;8742;1819;0;8173;3220;2;0;0;5628265;5108078;290746;443;5532284;405330;187;0;0
FR;2;2021-10-17;651;1150;185;0;1082;355;1;0;0;5628916;5109228;290931;443;5533366;405685;188;0;0
FR;2;2021-10-18;4562;7343;665;2;7246;1634;0;0;0;5633478;5116571;291596;445;5540612;407319;188;0;0
FR;2;2021-10-19;6239;9854;732;5;9656;2035;5;0;0;5639717;5126425;292328;450;5550268;409354;193;0;0
FR;2;2021-10-20;5170;8054;759;3;8175;1677;0;0;0;5644887;5134479;293087;453;5558443;411031;193;0;0
FR;2;2021-10-21;6090;9976;780;5;9835;2103;1;0;0;5650977;5144455;293867;458;5568278;413134;194;0;0
FR;2;2021-10-22;8452;14595;1149;4;14470;2890;2;0;0;5659429;5159050;295016;462;5582748;416024;196;0;0
FR;2;2021-10-23;3845;5994;587;0;6128;1235;3;0;0;5663274;5165044;295603;462;5588876;417259;199;0;0
FR;2;2021-10-24;494;884;101;0;901;205;0;0;0;5663768;5165928;295704;462;5589777;417464;199;0;0
FR;2;2021-10-25;3359;5351;307;1;5525;826;2;0;0;5667127;5171279;296011;463;5595302;418290;201;0;0
FR;2;2021-10-26;4177;7239;1133;4;7130;2021;5;0;0;5671304;5178518;297144;467;5602432;420311;206;0;0
FR;2;2021-10-27;3677;6594;1193;5;6452;1992;1;0;0;5674981;5185112;298337;472;5608884;422303;207;0;0
FR;2;2021-10-28;4597;7687;1736;3;7416;2747;1;0;0;5679578;5192799;300073;475;5616300;425050;208;0;0
FR;2;2021-10-29;5413;11082;2437;4;10695;3682;3;0;0;5684991;5203881;302510;479;5626995;428732;211;0;0
FR;2;2021-10-30;2749;4454;976;1;4454;1444;2;0;0;5687740;5208335;303486;480;5631449;430176;213;0;0
FR;2;2021-10-31;364;535;140;1;544;191;1;0;0;5688104;5208870;303626;481;5631993;430367;214;0;0
FR;2;2021-11-01;429;548;181;0;564;267;1;0;0;5688533;5209418;303807;481;5632557;430634;215;0;0
FR;2;2021-11-02;3293;6757;1183;0;6802;1764;5;0;0;5691826;5216175;304990;481;5639359;432398;220;0;0
FR;2;2021-11-03;3340;6230;1388;2;6318;1967;2;0;0;5695166;5222405;306378;483;5645677;434365;222;0;0
FR;2;2021-11-04;3986;7073;1768;4;7112;2494;3;0;0;5699152;5229478;308146;487;5652789;436859;225;0;0
FR;2;2021-11-05;5234;10504;2867;5;10212;3959;6;0;0;5704386;5239982;311013;492;5663001;440818;231;0;0
FR;2;2021-11-06;2596;4677;1403;0;4637;1818;2;0;0;5706982;5244659;312416;492;5667638;442636;233;0;0
FR;2;2021-11-07;506;866;221;0;873;291;2;0;0;5707488;5245525;312637;492;5668511;442927;235;0;0
FR;2;2021-11-08;2578;5348;1205;3;5268;1676;3;0;0;5710066;5250873;313842;495;5673779;444603;238;0;0
FR;2;2021-11-09;2749;6910;2402;5;6445;3181;2;0;0;5712815;5257783;316244;500;5680224;447784;240;0;0
FR;2;2021-11-10;2590;5671;5115;6;4766;6291;7;0;0;5715405;5263454;321359;506;5684990;454075;247;0;0
FR;2;2021-11-11;446;756;752;2;648;936;3;0;0;5715851;5264210;322111;508;5685638;455011;250;0;0
FR;2;2021-11-12;2953;8084;8982;8;6199;10927;9;0;0;5718804;5272294;331093;516;5691837;465938;259;0;0
FR;2;2021-11-13;1539;3375;3871;7;2723;4538;4;0;0;5720343;5275669;334964;523;5694560;470476;263;0;0
FR;2;2021-11-14;257;588;351;1;487;481;3;0;0;5720600;5276257;335315;524;5695047;470957;266;0;0
FR;2;2021-11-15;1621;3653;4449;8;2909;5328;16;0;0;5722221;5279910;339764;532;5697956;476285;282;0;0
FR;2;2021-11-16;2184;5882;8311;14;4159;10081;16;0;0;5724405;5285792;348075;546;5702115;486366;298;0;0
FR;2;2021-11-17;1741;4526;6632;8;3171;7851;5;0;0;5726146;5290318;354707;554;5705286;494217;303;0;0
FR;2;2021-11-18;2192;5926;9187;10;4024;11018;8;0;0;5728338;5296244;363894;564;5709310;505235;311;0;0
FR;2;2021-11-19;2700;7758;12980;19;4837;15480;12;0;0;5731038;5304002;376874;583;5714147;520715;323;0;0
FR;2;2021-11-20;1566;3336;5181;5;2352;6095;3;0;0;5732604;5307338;382055;588;5716499;526810;326;0;0
FR;2;2021-11-21;250;503;541;0;393;653;3;0;0;5732854;5307841;382596;588;5716892;527463;329;0;0
FR;2;2021-11-22;1278;2574;4483;5;1673;5399;9;0;0;5734132;5310415;387079;593;5718565;532862;338;0;0
FR;2;2021-11-23;1617;4273;8202;9;2537;9913;6;0;0;5735749;5314688;395281;602;5721102;542775;344;0;0
FR;2;2021-11-24;1421;3753;7482;14;2249;8735;9;0;0;5737170;5318441;402763;616;5723351;551510;353;0;0
FR;2;2021-11-25;1813;4866;11472;21;2684;13668;6;0;0;5738983;5323307;414235;637;5726035;565178;359;0;0
FR;2;2021-11-26;2541;7736;22673;31;3815;26086;14;0;0;5741524;5331043;436908;668;5729850;591264;373;0;0
FR;2;2021-11-27;1498;4139;12275;18;2130;14032;12;0;0;5743022;5335182;449183;686;5731980;605296;385;0;0
FR;2;2021-11-28;292;840;1975;3;480;2304;5;0;0;5743314;5336022;451158;689;5732460;607600;390;0;0
FR;2;2021-11-29;1447;4354;15099;23;2013;17270;25;0;0;5744761;5340376;466257;712;5734473;624870;415;0;0
FR;2;2021-11-30;1912;6660;26246;36;2645;30006;22;0;0;5746673;5347036;492503;748;5737118;654876;437;0;0
FR;2;2021-12-01;1916;6020;26205;31;2489;29516;20;0;0;5748589;5353056;518708;779;5739607;684392;457;0;0
FR;2;2021-12-02;1914;6779;37729;52;2116;41981;32;0;0;5750503;5359835;556437;831;5741723;726373;489;0;0
FR;2;2021-12-03;2557;10075;53636;111;3598;59384;30;0;0;5753060;5369910;610073;942;5745321;785757;519;0;0
FR;2;2021-12-04;1850;6279;37127;38;2189;40816;15;0;0;5754910;5376189;647200;980;5747510;826573;534;0;0
FR;2;2021-12-05;458;2247;14263;14;536;15990;7;0;0;5755368;5378436;661463;994;5748046;842563;541;0;0
FR;2;2021-12-06;2487;9858;77725;109;2708;84778;25;0;0;5757855;5388294;739188;1103;5750754;927341;566;0;0
FR;2;2021-12-07;3457;15291;122465;238;3747;133785;40;0;0;5761312;5403585;861653;1341;5754501;1061126;606;0;0
FR;2;2021-12-08;3725;15988;133217;330;3858;145411;54;0;0;5765037;5419573;994870;1671;5758359;1206537;660;0;0
FR;2;2021-12-09;4546;19634;170232;555;4177;185629;61;0;0;5769583;5439207;1165102;2226;5762536;1392166;721;0;0
FR;2;2021-12-10;4675;22806;188692;490;5017;206177;68;0;0;5774258;5462013;1353794;2716;5767553;1598343;789;0;0
FR;2;2021-12-11;3688;16621;132465;239;3673;144925;61;0;0;5777946;5478634;1486259;2955;5771226;1743268;850;0;0
FR;2;2021-12-12;1256;7124;59111;83;1019;65168;12;0;0;5779202;5485758;1545370;3038;5772245;1808436;862;0;0
FR;2;2021-12-13;5530;26816;220721;605;5229;243018;159;0;0;5784732;5512574;1766091;3643;5777474;2051454;1021;0;0
FR;2;2021-12-14;7018;37453;300796;908;6146;332253;189;0;0;5791750;5550027;2066887;4551;5783620;2383707;1210;0;0
FR;2;2021-12-15;6556;36233;285255;957;5877;315896;185;0;0;5798306;5586260;2352142;5508;5789497;2699603;1395;0;0
FR;2;2021-12-16;7765;37913;312170;981;6570;343797;184;0;0;5806071;5624173;2664312;6489;5796067;3043400;1579;0;0
FR;2;2021-12-17;8681;41186;327902;976;8028;360972;231;0;0;5814752;5665359;2992214;7465;5804095;3404372;1810;0;0
FR;2;2021-12-18;6515;26541;212366;448;4911;233674;120;0;0;5821267;5691900;3204580;7913;5809006;3638046;1930;0;0
FR;2;2021-12-19;2603;11410;90221;182;1660;100356;25;0;0;5823870;5703310;3294801;8095;5810666;3738402;1955;0;0
FR;2;2021-12-20;9549;33533;275250;706;6605;303400;208;0;0;5833419;5736843;3570051;8801;5817271;4041802;2163;0;0
FR;2;2021-12-21;11565;38293;309645;968;7380;341435;259;0;0;5844984;5775136;3879696;9769;5824651;4383237;2422;0;0
FR;2;2021-12-22;10459;32780;265135;952;6447;292490;316;0;1;5855443;5807916;4144831;10721;5831098;4675727;2738;0;1
FR;2;2021-12-23;9426;26631;199528;701;5887;221285;227;0;0;5864869;5834547;4344359;11422;5836985;4897012;2965;0;1
FR;2;2021-12-24;2783;7473;43863;140;2038;49562;78;0;0;5867652;5842020;4388222;11562;5839023;4946574;3043;0;1
FR;2;2021-12-25;201;677;2003;10;210;2483;15;0;0;5867853;5842697;4390225;11572;5839233;4949057;3058;0;1
FR;2;2021-12-26;1320;4216;25159;71;1052;28692;70;0;0;5869173;5846913;4415384;11643;5840285;4977749;3128;0;1
FR;2;2021-12-27;8075;29921;218431;659;6627;243371;294;0;0;5877248;5876834;4633815;12302;5846912;5221120;3422;0;1
FR;2;2021-12-28;9834;36300;272109;742;6990;302010;958;0;1;5887082;5913134;4905924;13044;5853902;5523130;4380;0;2
FR;2;2021-12-29;9498;32229;246141;765;6412;272687;1088;0;0;5896580;5945363;5152065;13809;5860314;5795817;5468;0;2
FR;2;2021-12-30;9461;28081;208838;663;5977;231458;1156;0;0;5906041;5973444;5360903;14472;5866291;6027275;6624;0;2
FR;2;2021-12-31;3011;8344;54990;176;2172;61233;392;0;0;5909052;5981788;5415893;14648;5868463;6088508;7016;0;2
FR;2;2022-01-01;231;689;2857;7;204;3352;29;0;0;5909283;5982477;5418750;14655;5868667;6091860;7045;0;2
FR;2;2022-01-02;1503;4852;29522;76;1166;33409;218;0;0;5910786;5987329;5448272;14731;5869833;6125269;7263;0;2
FR;2;2022-01-03;9603;35405;266541;806;8502;293920;1673;0;0;5920389;6022734;5714813;15537;5878335;6419189;8936;0;2
FR;2;2022-01-04;12854;45422;342100;1068;9971;377059;2458;0;1;5933243;6068156;6056913;16605;5888306;6796248;11394;0;3
FR;2;2022-01-05;11273;38624;294213;884;8631;323848;2154;0;2;5944516;6106780;6351126;17489;5896937;7120096;13548;0;5
FR;2;2022-01-06;13655;43495;331953;1298;9942;364761;2979;0;1;5958171;6150275;6683079;18787;5906879;7484857;16527;0;6
FR;2;2022-01-07;14225;47622;361116;1271;11243;396460;3160;0;0;5972396;6197897;7044195;20058;5918122;7881317;19687;0;6
FR;2;2022-01-08;7946;28138;201269;515;7208;221702;1528;0;2;5980342;6226035;7245464;20573;5925330;8103019;21215;0;8
FR;2;2022-01-09;2749;8954;62528;137;2074;69495;493;0;0;5983091;6234989;7307992;20710;5927404;8172514;21708;0;8
FR;2;2022-01-10;10100;31910;232501;858;8907;255077;2458;0;0;5993191;6266899;7540493;21568;5936311;8427591;24166;0;8
FR;2;2022-01-11;11468;36250;265933;1029;10066;290641;3380;0;1;6004659;6303149;7806426;22597;5946377;8718232;27546;0;9
FR;2;2022-01-12;8765;29792;206334;863;8721;226175;2798;0;5;6013424;6332941;8012760;23460;5955098;8944407;30344;0;14
FR;2;2022-01-13;9387;31333;224504;831;9038;244849;3462;0;4;6022811;6364274;8237264;24291;5964136;9189256;33806;0;18
FR;2;2022-01-14;9741;35589;254550;920;9850;277655;3983;0;1;6032552;6399863;8491814;25211;5973986;9466911;37789;0;19
FR;2;2022-01-15;5361;19449;140783;363;5324;153644;1928;0;0;6037913;6419312;8632597;25574;5979310;9620555;39717;0;19
FR;2;2022-01-16;1512;5462;35891;81;1618;39822;424;0;0;6039425;6424774;8668488;25655;5980928;9660377;40141;0;19
FR;2;2022-01-17;5546;19267;135417;601;6603;147260;2264;0;2;6044971;6444041;8803905;26256;5987531;9807637;42405;0;21
FR;2;2022-01-18;6423;21486;148642;647;7525;160466;3311;0;0;6051394;6465527;8952547;26903;5995056;9968103;45716;0;21
FR;2;2022-01-19;4397;16309;105108;552;6209;113700;2410;0;1;6055791;6481836;9057655;27455;6001265;10081803;48126;0;22
FR;2;2022-01-20;4873;17577;115303;603;7071;123695;3111;0;2;6060664;6499413;9172958;28058;6008336;10205498;51237;0;24
FR;2;2022-01-21;5198;20040;137355;679;7171;147771;3454;0;1;6065862;6519453;9310313;28737;6015507;10353269;54691;0;25
FR;2;2022-01-22;3034;10950;74262;260;3956;80330;1428;0;0;6068896;6530403;9384575;28997;6019463;10433599;56119;0;25
FR;2;2022-01-23;724;2709;15242;41;1057;16825;238;0;0;6069620;6533112;9399817;29038;6020520;10450424;56357;0;25
FR;2;2022-01-24;3290;12802;75082;431;5844;81025;1994;0;2;6072910;6545914;9474899;29469;6026364;10531449;58351;0;27
FR;2;2022-01-25;3575;14405;79631;496;6648;85459;2879;0;4;6076485;6560319;9554530;29965;6033012;10616908;61230;0;31
FR;2;2022-01-26;2515;10705;58984;363;5330;63037;1958;0;1;6079000;6571024;9613514;30328;6038342;10679945;63188;0;32
FR;2;2022-01-27;2683;11379;64180;389;5737;67960;2461;0;1;6081683;6582403;9677694;30717;6044079;10747905;65649;0;33
FR;2;2022-01-28;3551;18271;91727;429;8615;98913;3400;0;1;6085234;6600674;9769421;31146;6052694;10846818;69049;0;34
FR;2;2022-01-29;1894;9239;48853;164;4171;52929;1375;0;1;6087128;6609913;9818274;31310;6056865;10899747;70424;0;35
FR;2;2022-01-30;464;2209;9455;38;1051;10585;203;0;0;6087592;6612122;9827729;31348;6057916;10910332;70627;0;35
FR;2;2022-01-31;1890;9559;43833;209;4715;47327;1887;0;2;6089482;6621681;9871562;31557;6062631;10957659;72514;0;37
FR;2;2022-02-01;1916;10025;47031;279;4802;50082;2709;0;0;6091398;6631706;9918593;31836;6067433;11007741;75223;0;37
FR;2;2022-02-02;1614;8980;41122;250;4195;44152;2189;0;1;6093012;6640686;9959715;32086;6071628;11051893;77412;0;38
FR;2;2022-02-03;1728;8937;40526;205;4374;42916;2641;0;2;6094740;6649623;10000241;32291;6076002;11094809;80053;0;40
FR;2;2022-02-04;2151;15176;66649;299;7383;71328;3671;0;1;6096891;6664799;10066890;32590;6083385;11166137;83724;0;41
FR;2;2022-02-05;1360;8522;35946;132;4216;39224;1370;0;0;6098251;6673321;10102836;32722;6087601;11205361;85094;0;41
FR;2;2022-02-06;275;1762;6129;16;840;6900;217;0;0;6098526;6675083;10108965;32738;6088441;11212261;85311;0;41
FR;2;2022-02-07;1352;9551;37758;134;4536;41292;1889;0;2;6099878;6684634;10146723;32872;6092977;11253553;87200;0;43
FR;2;2022-02-08;1299;9832;40955;173;4644;43749;2741;0;1;6101177;6694466;10187678;33045;6097621;11297302;89941;0;44
FR;2;2022-02-09;1160;8841;37040;174;3804;40465;1901;0;2;6102337;6703307;10224718;33219;6101425;11337767;91842;0;46
FR;2;2022-02-10;1029;7999;33837;204;3604;36510;2051;0;1;6103366;6711306;10258555;33423;6105029;11374277;93893;0;47
FR;2;2022-02-11;1391;12086;53347;223;5282;57700;2888;0;0;6104757;6723392;10311902;33646;6110311;11431977;96781;0;47
FR;2;2022-02-12;754;6535;27987;86;2793;30807;1112;0;2;6105511;6729927;10339889;33732;6113104;11462784;97893;0;49
FR;2;2022-02-13;200;1340;4836;20;562;5577;141;0;0;6105711;6731267;10344725;33752;6113666;11468361;98034;0;49
FR;2;2022-02-14;835;6731;30273;91;2598;33232;1398;0;1;6106546;6737998;10374998;33843;6116264;11501593;99432;0;50
FR;2;2022-02-15;774;6473;28050;140;2801;29991;1967;0;2;6107320;6744471;10403048;33983;6119065;11531584;101399;0;52
FR;2;2022-02-16;657;5361;22067;124;2526;23632;1569;0;3;6107977;6749832;10425115;34107;6121591;11555216;102968;0;55
FR;2;2022-02-17;518;3786;14152;98;2131;14617;1406;0;2;6108495;6753618;10439267;34205;6123722;11569833;104374;0;57
FR;2;2022-02-18;723;5368;20442;134;3039;21129;1895;0;0;6109218;6758986;10459709;34339;6126761;11590962;106269;0;57
FR;2;2022-02-19;430;3061;10532;66;1699;11246;753;0;2;6109648;6762047;10470241;34405;6128460;11602208;107022;0;59
FR;2;2022-02-20;102;518;1463;3;314;1611;100;0;0;6109750;6762565;10471704;34408;6128774;11603819;107122;0;59
FR;2;2022-02-21;422;2685;9122;65;1569;9499;930;0;0;6110172;6765250;10480826;34473;6130343;11613318;108052;0;59
FR;2;2022-02-22;392;2567;8894;77;1621;8797;1180;0;0;6110564;6767817;10489720;34550;6131964;11622115;109232;0;59
FR;2;2022-02-23;432;2604;8992;82;1522;9268;1022;0;0;6110996;6770421;10498712;34632;6133486;11631383;110254;0;59
FR;2;2022-02-24;314;2038;6802;82;1250;6832;870;0;0;6111310;6772459;10505514;34714;6134736;11638215;111124;0;59
FR;2;2022-02-25;457;3207;11419;107;1977;11283;1559;0;3;6111767;6775666;10516933;34821;6136713;11649498;112683;0;62
FR;2;2022-02-26;297;1892;6037;49;1161;6344;587;0;1;6112064;6777558;10522970;34870;6137874;11655842;113270;0;63
FR;2;2022-02-27;76;313;907;5;214;950;98;0;0;6112140;6777871;10523877;34875;6138088;11656792;113368;0;63
FR;2;2022-02-28;330;1688;5525;53;1087;5531;733;0;0;6112470;6779559;10529402;34928;6139175;11662323;114101;0;63
FR;2;2022-03-01;279;1569;5483;46;952;5200;964;0;2;6112749;6781128;10534885;34974;6140127;11667523;115065;0;65
FR;2;2022-03-02;298;1445;5248;45;877;5092;815;0;1;6113047;6782573;10540133;35019;6141004;11672615;115880;0;66
FR;2;2022-03-03;226;1112;3709;42;721;3486;668;0;1;6113273;6783685;10543842;35061;6141725;11676101;116548;0;67
FR;2;2022-03-04;243;1469;4859;74;983;4506;949;0;1;6113516;6785154;10548701;35135;6142708;11680607;117497;0;68
FR;2;2022-03-05;174;906;2980;34;612;2724;561;0;0;6113690;6786060;10551681;35169;6143320;11683331;118058;0;68
FR;2;2022-03-06;42;183;280;5;105;320;52;0;0;6113732;6786243;10551961;35174;6143425;11683651;118110;0;68
FR;2;2022-03-07;156;659;1987;70;491;1777;472;0;0;6113888;6786902;10553948;35244;6143916;11685428;118582;0;68
FR;2;2022-03-08;144;670;2272;53;461;1907;619;0;0;6114032;6787572;10556220;35297;6144377;11687335;119201;0;68
FR;2;2022-03-09;156;708;2349;37;473;2050;616;0;0;6114188;6788280;10558569;35334;6144850;11689385;119817;0;68
FR;2;2022-03-10;123;603;1695;35;445;1470;456;0;1;6114311;6788883;10560264;35369;6145295;11690855;120273;0;69
FR;2;2022-03-11;172;757;2769;57;505;2368;737;0;1;6114483;6789640;10563033;35426;6145800;11693223;121010;0;70
FR;2;2022-03-12;149;484;1787;27;331;1556;450;0;0;6114632;6790124;10564820;35453;6146131;11694779;121460;0;70
FR;2;2022-03-13;25;75;203;30;45;204;69;0;0;6114657;6790199;10565023;35483;6146176;11694983;121529;0;70
FR;2;2022-03-14;129;470;1572;529;333;1301;951;0;0;6114786;6790669;10566595;36012;6146509;11696284;122480;0;70
FR;2;2022-03-15;138;441;1713;691;333;1333;1186;0;1;6114924;6791110;10568308;36703;6146842;11697617;123666;0;71
FR;2;2022-03-16;142;476;2013;1616;331;1593;2160;0;2;6115066;6791586;10570321;38319;6147173;11699210;125826;0;73
FR;2;2022-03-17;94;413;1408;1192;273;1144;1576;0;0;6115160;6791999;10571729;39511;6147446;11700354;127402;0;73
FR;2;2022-03-18;147;496;2025;1795;335;1668;2313;0;1;6115307;6792495;10573754;41306;6147781;11702022;129715;0;74
FR;2;2022-03-19;108;321;1210;941;219;1015;1259;0;0;6115415;6792816;10574964;42247;6148000;11703037;130974;0;74
FR;2;2022-03-20;13;77;191;59;39;168;115;0;0;6115428;6792893;10575155;42306;6148039;11703205;131089;0;74
FR;2;2022-03-21;97;307;1218;1483;180;1081;1760;0;1;6115525;6793200;10576373;43789;6148219;11704286;132849;0;75
FR;2;2022-03-22;118;390;1531;1830;244;1292;2218;0;0;6115643;6793590;10577904;45619;6148463;11705578;135067;0;75
FR;2;2022-03-23;137;361;1676;3032;232;1471;3374;0;6;6115780;6793951;10579580;48651;6148695;11707049;138441;0;81
FR;2;2022-03-24;117;293;1183;1548;186;1001;1814;0;8;6115897;6794244;10580763;50199;6148881;11708050;140255;0;89
FR;2;2022-03-25;119;361;1806;2451;238;1476;2837;0;8;6116016;6794605;10582569;52650;6149119;11709526;143092;0;97
FR;2;2022-03-26;79;247;1204;1222;138;952;1531;0;5;6116095;6794852;10583773;53872;6149257;11710478;144623;0;102
FR;2;2022-03-27;19;36;154;100;19;133;144;0;0;6116114;6794888;10583927;53972;6149276;11710611;144767;0;102
FR;2;2022-03-28;94;288;1138;1602;187;995;1834;0;6;6116208;6795176;10585065;55574;6149463;11711606;146601;0;108
FR;2;2022-03-29;108;258;1325;2467;167;1105;2760;0;4;6116316;6795434;10586390;58041;6149630;11712711;149361;0;112
FR;2;2022-03-30;91;312;1489;3185;163;1320;3422;0;2;6116407;6795746;10587879;61226;6149793;11714031;152783;0;114
FR;2;2022-03-31;104;284;1276;2332;172;1091;2616;0;3;6116511;6796030;10589155;63558;6149965;11715122;155399;0;117
FR;2;2022-04-01;123;324;1567;2349;164;1322;2667;0;7;6116634;6796354;10590722;65907;6150129;11716444;158066;0;124
FR;2;2022-04-02;81;161;845;891;83;737;1052;0;1;6116715;6796515;10591567;66798;6150212;11717181;159118;0;125
FR;2;2022-04-03;16;53;128;113;27;142;133;0;1;6116731;6796568;10591695;66911;6150239;11717323;159251;0;126
FR;2;2022-04-04;113;240;989;1447;142;798;1693;0;5;6116844;6796808;10592684;68358;6150381;11718121;160944;0;131
FR;2;2022-04-05;143;298;1317;2914;158;1145;3143;0;17;6116987;6797106;10594001;71272;6150539;11719266;164087;0;148
FR;2;2022-04-06;89;260;1306;2523;128;1130;2687;0;10;6117076;6797366;10595307;73795;6150667;11720396;166774;0;158
FR;2;2022-04-07;120;230;1303;2682;141;1042;2958;0;8;6117196;6797596;10596610;76477;6150808;11721438;169732;0;166
FR;2;2022-04-08;126;344;1634;3352;180;1327;3642;0;12;6117322;6797940;10598244;79829;6150988;11722765;173374;0;178
FR;2;2022-04-09;90;219;900;1046;144;732;1288;0;4;6117412;6798159;10599144;80875;6151132;11723497;174662;0;182
FR;2;2022-04-10;37;48;143;162;45;119;200;0;1;6117449;6798207;10599287;81037;6151177;11723616;174862;0;183
FR;2;2022-04-11;88;195;892;1560;121;782;1718;0;6;6117537;6798402;10600179;82597;6151298;11724398;176580;0;189
FR;2;2022-04-12;176;273;1183;2770;175;1062;2903;0;8;6117713;6798675;10601362;85367;6151473;11725460;179483;0;197
FR;2;2022-04-13;147;231;1125;2477;110;989;2671;0;11;6117860;6798906;10602487;87844;6151583;11726449;182154;0;208
FR;2;2022-04-14;115;226;1085;2677;113;919;2911;0;18;6117975;6799132;10603572;90521;6151696;11727368;185065;0;226
FR;2;2022-04-15;114;259;1219;2293;129;1076;2533;0;7;6118089;6799391;10604791;92814;6151825;11728444;187598;0;233
FR;2;2022-04-16;67;108;548;549;68;459;675;0;9;6118156;6799499;10605339;93363;6151893;11728903;188273;0;242
FR;2;2022-04-17;15;27;57;53;16;53;71;0;0;6118171;6799526;10605396;93416;6151909;11728956;188344;0;242
FR;2;2022-04-18;12;35;121;70;18;116;95;0;0;6118183;6799561;10605517;93486;6151927;11729072;188439;0;242
FR;2;2022-04-19;112;237;1120;1731;149;951;1915;0;9;6118295;6799798;10606637;95217;6152076;11730023;190354;0;251
FR;2;2022-04-20;95;241;1110;2172;125;934;2366;0;14;6118390;6800039;10607747;97389;6152201;11730957;192720;0;265
FR;2;2022-04-21;111;233;983;1912;125;838;2141;0;10;6118501;6800272;10608730;99301;6152326;11731795;194861;0;275
FR;2;2022-04-22;100;276;1242;2093;141;1023;2431;0;11;6118601;6800548;10609972;101394;6152467;11732818;197292;0;286
FR;2;2022-04-23;67;156;645;762;107;574;862;0;8;6118668;6800704;10610617;102156;6152574;11733392;198154;0;294
FR;2;2022-04-24;12;30;101;68;12;79;100;0;0;6118680;6800734;10610718;102224;6152586;11733471;198254;0;294
FR;2;2022-04-25;103;204;821;1315;104;711;1513;0;15;6118783;6800938;10611539;103539;6152690;11734182;199767;0;309
FR;2;2022-04-26;108;184;1041;2018;118;878;2216;0;18;6118891;6801122;10612580;105557;6152808;11735060;201983;0;327
FR;2;2022-04-27;98;181;860;1783;122;764;1805;0;7;6118989;6801303;10613440;107340;6152930;11735824;203788;0;334
FR;2;2022-04-28;93;214;950;1931;128;843;2087;0;12;6119082;6801517;10614390;109271;6153058;11736667;205875;0;346
FR;2;2022-04-29;81;280;1131;1696;131;1040;1875;0;11;6119163;6801797;10615521;110967;6153189;11737707;207750;0;357
FR;2;2022-04-30;66;126;471;540;79;430;628;0;9;6119229;6801923;10615992;111507;6153268;11738137;208378;0;366
FR;2;2022-05-01;23;24;84;49;20;85;61;0;1;6119252;6801947;10616076;111556;6153288;11738222;208439;0;367
FR;2;2022-05-02;115;232;762;1216;141;660;1374;0;5;6119367;6802179;10616838;112772;6153429;11738882;209813;0;372
FR;2;2022-05-03;152;233;999;1780;156;938;1894;0;14;6119519;6802412;10617837;114552;6153585;11739820;211707;0;386
FR;2;2022-05-04;90;226;924;1810;116;867;1821;0;13;6119609;6802638;10618761;116362;6153701;11740687;213528;0;399
FR;2;2022-05-05;127;197;856;1732;146;773;1848;0;10;6119736;6802835;10619617;118094;6153847;11741460;215376;0;409
FR;2;2022-05-06;133;246;1100;1855;139;1016;2052;0;16;6119869;6803081;10620717;119949;6153986;11742476;217428;0;425
FR;2;2022-05-07;40;99;470;504;61;406;593;0;4;6119909;6803180;10621187;120453;6154047;11742882;218021;0;429
FR;2;2022-05-08;48;54;107;70;41;102;100;0;0;6119957;6803234;10621294;120523;6154088;11742984;218121;0;429
FR;2;2022-05-09;101;174;654;986;103;604;1130;0;9;6120058;6803408;10621948;121509;6154191;11743588;219251;0;438
FR;2;2022-05-10;121;252;938;1841;155;893;1965;0;23;6120179;6803660;10622886;123350;6154346;11744481;221216;0;461
FR;2;2022-05-11;103;179;813;1873;117;792;1862;0;8;6120282;6803839;10623699;125223;6154463;11745273;223078;0;469
FR;2;2022-05-12;111;173;845;2096;115;803;2213;0;21;6120393;6804012;10624544;127319;6154578;11746076;225291;0;490
FR;2;2022-05-13;100;235;969;2097;121;900;2273;0;13;6120493;6804247;10625513;129416;6154699;11746976;227564;0;503
FR;2;2022-05-14;76;124;451;553;93;411;632;0;6;6120569;6804371;10625964;129969;6154792;11747387;228196;0;509
FR;2;2022-05-15;24;39;94;88;20;108;95;0;1;6120593;6804410;10626058;130057;6154812;11747495;228291;0;510
FR;2;2022-05-16;102;170;601;925;115;537;1037;0;11;6120695;6804580;10626659;130982;6154927;11748032;229328;0;521
FR;2;2022-05-17;95;184;690;1685;119;658;1737;0;8;6120790;6804764;10627349;132667;6155046;11748690;231065;0;529
FR;2;2022-05-18;80;181;643;1431;97;648;1486;0;10;6120870;6804945;10627992;134098;6155143;11749338;232551;0;539
FR;2;2022-05-19;73;161;709;1831;81;751;1817;0;12;6120943;6805106;10628701;135929;6155224;11750089;234368;0;551
FR;2;2022-05-20;107;180;874;1701;110;779;1849;0;17;6121050;6805286;10629575;137630;6155334;11750868;236217;0;568
FR;2;2022-05-21;48;96;398;517;71;339;581;0;8;6121098;6805382;10629973;138147;6155405;11751207;236798;0;576
FR;2;2022-05-22;8;23;69;37;18;57;56;0;0;6121106;6805405;10630042;138184;6155423;11751264;236854;0;576
FR;2;2022-05-23;86;133;498;931;100;469;967;0;7;6121192;6805538;10630540;139115;6155523;11751733;237821;0;583
FR;2;2022-05-24;87;164;627;1626;103;615;1680;0;17;6121279;6805702;10631167;140741;6155626;11752348;239501;0;600
FR;2;2022-05-25;72;146;539;1148;90;494;1259;0;5;6121351;6805848;10631706;141889;6155716;11752842;240760;0;605
FR;2;2022-05-26;11;31;77;45;13;85;56;0;1;6121362;6805879;10631783;141934;6155729;11752927;240816;0;606
FR;2;2022-05-27;44;124;456;818;68;438;893;0;9;6121406;6806003;10632239;142752;6155797;11753365;241709;0;615
FR;2;2022-05-28;28;60;221;244;29;221;266;0;1;6121434;6806063;10632460;142996;6155826;11753586;241975;0;616
FR;2;2022-05-29;13;34;43;25;22;51;28;0;0;6121447;6806097;10632503;143021;6155848;11753637;242003;0;616
FR;2;2022-05-30;65;109;424;755;60;409;806;0;6;6121512;6806206;10632927;143776;6155908;11754046;242809;0;622
FR;2;2022-05-31;76;135;564;1277;92;511;1303;0;12;6121588;6806341;10633491;145053;6156000;11754557;244112;0;634
FR;2;2022-06-01;59;158;562;1075;84;541;1170;0;6;6121647;6806499;10634053;146128;6156084;11755098;245282;0;640
FR;2;2022-06-02;92;178;625;1413;109;592;1519;0;12;6121739;6806677;10634678;147541;6156193;11755690;246801;0;652
FR;2;2022-06-03;71;156;668;1604;95;595;1693;0;19;6121810;6806833;10635346;149145;6156288;11756285;248494;0;671
FR;2;2022-06-04;69;93;283;433;66;269;475;0;11;6121879;6806926;10635629;149578;6156354;11756554;248969;0;682
FR;2;2022-06-05;12;17;63;57;16;47;74;0;1;6121891;6806943;10635692;149635;6156370;11756601;249043;0;683
FR;2;2022-06-06;12;39;92;76;28;92;80;0;4;6121903;6806982;10635784;149711;6156398;11756693;249123;0;687
FR;2;2022-06-07;99;222;667;1535;154;577;1661;0;10;6122002;6807204;10636451;151246;6156552;11757270;250784;0;697
FR;2;2022-06-08;70;118;476;1166;76;411;1262;0;5;6122072;6807322;10636927;152412;6156628;11757681;252046;0;702
FR;2;2022-06-09;93;166;613;1922;107;571;1927;0;18;6122165;6807488;10637540;154334;6156735;11758252;253973;0;720
FR;2;2022-06-10;91;168;650;1683;107;622;1774;0;23;6122256;6807656;10638190;156017;6156842;11758874;255747;0;743
FR;2;2022-06-11;44;84;287;529;41;258;583;0;5;6122300;6807740;10638477;156546;6156883;11759132;256330;0;748
FR;2;2022-06-12;18;38;58;78;27;60;78;0;0;6122318;6807778;10638535;156624;6156910;11759192;256408;0;748
FR;2;2022-06-13;39;119;395;953;63;378;1021;0;6;6122357;6807897;10638930;157577;6156973;11759570;257429;0;754
FR;2;2022-06-14;68;157;599;2088;101;537;2189;0;14;6122425;6808054;10639529;159665;6157074;11760107;259618;0;768
FR;2;2022-06-15;78;104;520;1503;84;444;1638;0;10;6122503;6808158;10640049;161168;6157158;11760551;261256;0;778
FR;2;2022-06-16;127;127;496;1411;122;423;1526;0;12;6122630;6808285;10640545;162579;6157280;11760974;262782;0;790
FR;2;2022-06-17;73;137;589;1817;87;516;1921;0;16;6122703;6808422;10641134;164396;6157367;11761490;264703;0;806
FR;2;2022-06-18;76;93;224;578;81;196;629;0;4;6122779;6808515;10641358;164974;6157448;11761686;265332;0;810
FR;2;2022-06-19;11;17;53;71;7;41;90;0;2;6122790;6808532;10641411;165045;6157455;11761727;265422;0;812
FR;2;2022-06-20;62;125;401;1028;72;392;1105;0;10;6122852;6808657;10641812;166073;6157527;11762119;266527;0;822
FR;2;2022-06-21;107;115;526;2125;104;455;2162;0;22;6122959;6808772;10642338;168198;6157631;11762574;268689;0;844
FR;2;2022-06-22;39;110;462;1889;57;415;1971;0;25;6122998;6808882;10642800;170087;6157688;11762989;270660;0;869
FR;2;2022-06-23;58;108;537;2282;67;452;2400;0;30;6123056;6808990;10643337;172369;6157755;11763441;273060;0;899
FR;2;2022-06-24;66;122;709;3198;65;571;3338;0;38;6123122;6809112;10644046;175567;6157820;11764012;276398;0;937
FR;2;2022-06-25;30;90;298;987;55;254;1040;0;13;6123152;6809202;10644344;176554;6157875;11764266;277438;0;950
FR;2;2022-06-26;30;27;131;194;29;97;236;0;5;6123182;6809229;10644475;176748;6157904;11764363;277674;0;955
FR;2;2022-06-27;79;137;582;2489;94;483;2622;0;39;6123261;6809366;10645057;179237;6157998;11764846;280296;0;994
FR;2;2022-06-28;108;140;812;4817;80;650;4894;0;54;6123369;6809506;10645869;184054;6158078;11765496;285190;0;1048
FR;2;2022-06-29;73;150;776;4433;80;637;4529;0;56;6123442;6809656;10646645;188487;6158158;11766133;289719;0;1104
FR;2;2022-06-30;72;133;832;5177;71;618;5397;0;79;6123514;6809789;10647477;193664;6158229;11766751;295116;0;1183
FR;2;2022-07-01;113;161;1153;6691;95;853;6944;0;92;6123627;6809950;10648630;200355;6158324;11767604;302060;0;1275
FR;2;2022-07-02;69;132;474;1976;82;392;2067;0;27;6123696;6810082;10649104;202331;6158406;11767996;304127;0;1302
FR;2;2022-07-03;23;30;146;334;21;130;357;0;8;6123719;6810112;10649250;202665;6158427;11768126;304484;0;1310
FR;2;2022-07-04;120;183;775;3785;111;612;3972;0;49;6123839;6810295;10650025;206450;6158538;11768738;308456;0;1359
FR;2;2022-07-05;119;187;1121;6818;120;828;6999;0;85;6123958;6810482;10651146;213268;6158658;11769566;315455;0;1444
FR;2;2022-07-06;92;150;951;5807;93;697;5933;0;84;6124050;6810632;10652097;219075;6158751;11770263;321388;0;1528
FR;2;2022-07-07;81;185;1020;6501;115;751;6732;0;101;6124131;6810817;10653117;225576;6158866;11771014;328120;0;1629
FR;2;2022-07-08;65;122;1095;7044;51;758;7235;0;123;6124196;6810939;10654212;232620;6158917;11771772;335355;0;1752
FR;2;2022-07-09;34;62;418;1869;31;299;1920;0;33;6124230;6811001;10654630;234489;6158948;11772071;337275;0;1785
FR;2;2022-07-10;6;17;97;315;8;83;327;0;5;6124236;6811018;10654727;234804;6158956;11772154;337602;0;1790
FR;2;2022-07-11;68;120;683;3825;75;540;3901;0;67;6124304;6811138;10655410;238629;6159031;11772694;341503;0;1857
FR;2;2022-07-12;102;180;1054;6517;107;809;6725;0;119;6124406;6811318;10656464;245146;6159138;11773503;348228;0;1976
FR;2;2022-07-13;64;127;879;4664;75;591;4830;0;78;6124470;6811445;10657343;249810;6159213;11774094;353058;0;2054
FR;2;2022-07-14;6;13;88;249;8;59;268;0;8;6124476;6811458;10657431;250059;6159221;11774153;353326;0;2062
FR;2;2022-07-15;61;129;739;3793;53;560;3959;0;75;6124537;6811587;10658170;253852;6159274;11774713;357285;0;2137
FR;2;2022-07-16;27;54;289;1029;30;242;1075;0;25;6124564;6811641;10658459;254881;6159304;11774955;358360;0;2162
FR;2;2022-07-17;5;12;78;201;6;67;207;0;6;6124569;6811653;10658537;255082;6159310;11775022;358567;0;2168
FR;2;2022-07-18;57;103;514;2509;61;384;2648;0;59;6124626;6811756;10659051;257591;6159371;11775406;361215;0;2227
FR;2;2022-07-19;66;133;770;4254;72;555;4443;0;72;6124692;6811889;10659821;261845;6159443;11775961;365658;0;2299
FR;2;2022-07-20;59;117;582;3179;68;430;3278;0;87;6124751;6812006;10660403;265024;6159511;11776391;368936;0;2386
FR;2;2022-07-21;60;110;671;3680;73;485;3797;0;105;6124811;6812116;10661074;268704;6159584;11776876;372733;0;2491
FR;2;2022-07-22;51;99;698;3548;48;506;3697;0;80;6124862;6812215;10661772;272252;6159632;11777382;376430;0;2571
FR;2;2022-07-23;39;97;290;1173;52;229;1226;0;37;6124901;6812312;10662062;273425;6159684;11777611;377656;0;2608
FR;2;2022-07-24;14;24;69;201;19;68;203;0;7;6124915;6812336;10662131;273626;6159703;11777679;377859;0;2615
FR;2;2022-07-25;50;71;405;1938;60;300;2000;0;56;6124965;6812407;10662536;275564;6159763;11777979;379859;0;2671
FR;2;2022-07-26;57;133;606;3423;66;477;3496;0;113;6125022;6812540;10663142;278987;6159829;11778456;383355;0;2784
FR;2;2022-07-27;42;81;457;2782;50;361;2801;0;89;6125064;6812621;10663599;281769;6159879;11778817;386156;0;2873
FR;2;2022-07-28;29;75;450;2486;36;357;2490;0;78;6125093;6812696;10664049;284255;6159915;11779174;388646;0;2951
FR;2;2022-07-29;68;88;535;2857;63;347;2978;0;73;6125161;6812784;10664584;287112;6159978;11779521;391624;0;3024
FR;2;2022-07-30;22;39;162;775;32;110;794;0;24;6125183;6812823;10664746;287887;6160010;11779631;392418;0;3048
FR;2;2022-07-31;6;13;27;104;12;21;110;0;2;6125189;6812836;10664773;287991;6160022;11779652;392528;0;3050
FR;2;2022-08-01;38;105;323;1261;73;260;1343;0;29;6125227;6812941;10665096;289252;6160095;11779912;393871;0;3079
FR;2;2022-08-02;49;75;325;2061;50;247;2097;0;78;6125276;6813016;10665421;291313;6160145;11780159;395968;0;3157
FR;2;2022-08-03;29;53;259;1611;25;187;1617;0;57;6125305;6813069;10665680;292924;6160170;11780346;397585;0;3214
FR;2;2022-08-04;40;65;306;1692;39;240;1701;0;66;6125345;6813134;10665986;294616;6160209;11780586;399286;0;3280
FR;2;2022-08-05;33;94;328;1880;67;236;1911;0;60;6125378;6813228;10666314;296496;6160276;11780822;401197;0;3340
FR;2;2022-08-06;22;41;106;365;29;82;372;0;10;6125400;6813269;10666420;296861;6160305;11780904;401569;0;3350
FR;2;2022-08-07;7;8;15;69;5;16;71;0;3;6125407;6813277;10666435;296930;6160310;11780920;401640;0;3353
FR;2;2022-08-08;19;35;218;877;22;146;915;0;33;6125426;6813312;10666653;297807;6160332;11781066;402555;0;3386
FR;2;2022-08-09;29;52;279;1475;41;238;1471;0;50;6125455;6813364;10666932;299282;6160373;11781304;404026;0;3436
FR;2;2022-08-10;16;21;213;1134;18;150;1155;0;46;6125471;6813385;10667145;300416;6160391;11781454;405181;0;3482
FR;2;2022-08-11;21;41;174;1039;26;117;1048;0;40;6125492;6813426;10667319;301455;6160417;11781571;406229;0;3522
FR;2;2022-08-12;36;49;184;1046;37;140;1069;0;35;6125528;6813475;10667503;302501;6160454;11781711;407298;0;3557
FR;2;2022-08-13;9;19;47;149;15;53;137;0;5;6125537;6813494;10667550;302650;6160469;11781764;407435;0;3562
FR;2;2022-08-14;1;2;12;52;1;11;54;0;1;6125538;6813496;10667562;302702;6160470;11781775;407489;0;3563
FR;2;2022-08-15;0;5;32;22;2;21;21;0;3;6125538;6813501;10667594;302724;6160472;11781796;407510;0;3566
FR;2;2022-08-16;27;33;144;681;34;120;678;0;33;6125565;6813534;10667738;303405;6160506;11781916;408188;0;3599
FR;2;2022-08-17;17;26;109;738;18;88;744;0;34;6125582;6813560;10667847;304143;6160524;11782004;408932;0;3633
FR;2;2022-08-18;14;28;160;836;12;107;852;0;42;6125596;6813588;10668007;304979;6160536;11782111;409784;0;3675
FR;2;2022-08-19;8;38;118;706;31;88;706;0;33;6125604;6813626;10668125;305685;6160567;11782199;410490;0;3708
FR;2;2022-08-20;6;26;61;197;16;52;201;0;8;6125610;6813652;10668186;305882;6160583;11782251;410691;0;3716
FR;2;2022-08-21;4;14;15;19;6;13;31;0;0;6125614;6813666;10668201;305901;6160589;11782264;410722;0;3716
FR;2;2022-08-22;11;25;116;395;17;73;451;0;13;6125625;6813691;10668317;306296;6160606;11782337;411173;0;3729
FR;2;2022-08-23;11;41;134;671;22;112;679;0;38;6125636;6813732;10668451;306967;6160628;11782449;411852;0;3767
FR;2;2022-08-24;11;28;87;466;21;80;472;0;18;6125647;6813760;10668538;307433;6160649;11782529;412324;0;3785
FR;2;2022-08-25;8;32;109;481;16;69;516;0;17;6125655;6813792;10668647;307914;6160665;11782598;412840;0;3802
FR;2;2022-08-26;15;46;117;720;36;91;713;0;32;6125670;6813838;10668764;308634;6160701;11782689;413553;0;3834
FR;2;2022-08-27;10;19;47;156;16;42;164;0;2;6125680;6813857;10668811;308790;6160717;11782731;413717;0;3836
FR;2;2022-08-28;1;5;5;15;1;7;16;0;1;6125681;6813862;10668816;308805;6160718;11782738;413733;0;3837
FR;2;2022-08-29;24;43;93;400;29;87;396;0;24;6125705;6813905;10668909;309205;6160747;11782825;414129;0;3861
FR;2;2022-08-30;31;54;154;791;34;119;798;0;29;6125736;6813959;10669063;309996;6160781;11782944;414927;0;3890
FR;2;2022-08-31;19;35;85;392;22;79;393;0;25;6125755;6813994;10669148;310388;6160803;11783023;415320;0;3915
FR;2;2022-09-01;19;42;139;600;24;122;609;0;36;6125774;6814036;10669287;310988;6160827;11783145;415929;0;3951
FR;2;2022-09-02;34;56;146;744;34;158;748;0;32;6125808;6814092;10669433;311732;6160861;11783303;416677;0;3983
FR;2;2022-09-03;17;20;83;205;11;67;213;0;7;6125825;6814112;10669516;311937;6160872;11783370;416890;0;3990
FR;2;2022-09-04;8;5;9;31;2;10;30;0;3;6125833;6814117;10669525;311968;6160874;11783380;416920;0;3993
FR;2;2022-09-05;29;31;126;367;23;98;397;0;24;6125862;6814148;10669651;312335;6160897;11783478;417317;0;4017
FR;2;2022-09-06;43;62;158;761;42;153;767;0;36;6125905;6814210;10669809;313096;6160939;11783631;418084;0;4053
FR;2;2022-09-07;21;20;74;375;16;49;387;0;22;6125926;6814230;10669883;313471;6160955;11783680;418471;0;4075
FR;2;2022-09-08;31;57;109;636;40;100;646;0;22;6125957;6814287;10669992;314107;6160995;11783780;419117;0;4097
FR;2;2022-09-09;18;24;126;753;21;74;746;0;46;6125975;6814311;10670118;314860;6161016;11783854;419863;0;4143
FR;2;2022-09-10;14;24;57;117;16;48;131;0;4;6125989;6814335;10670175;314977;6161032;11783902;419994;0;4147
FR;2;2022-09-11;12;5;11;11;3;13;13;0;0;6126001;6814340;10670186;314988;6161035;11783915;420007;0;4147
FR;2;2022-09-12;20;31;69;340;26;55;352;0;16;6126021;6814371;10670255;315328;6161061;11783970;420359;0;4163
FR;2;2022-09-13;15;34;125;670;13;99;674;0;40;6126036;6814405;10670380;315998;6161074;11784069;421033;0;4203
FR;2;2022-09-14;19;21;81;480;19;59;478;0;36;6126055;6814426;10670461;316478;6161093;11784128;421511;0;4239
FR;2;2022-09-15;22;43;126;486;25;102;493;0;47;6126077;6814469;10670587;316964;6161118;11784230;422004;0;4286
FR;2;2022-09-16;21;31;124;563;17;89;585;0;39;6126098;6814500;10670711;317527;6161135;11784319;422589;0;4325
FR;2;2022-09-17;6;20;56;160;15;52;147;0;13;6126104;6814520;10670767;317687;6161150;11784371;422736;0;4338
FR;2;2022-09-18;4;7;13;37;6;10;37;0;3;6126108;6814527;10670780;317724;6161156;11784381;422773;0;4341
FR;2;2022-09-19;26;24;114;353;16;87;381;0;22;6126134;6814551;10670894;318077;6161172;11784468;423154;0;4363
FR;2;2022-09-20;27;27;117;624;21;84;639;0;38;6126161;6814578;10671011;318701;6161193;11784552;423793;0;4401
FR;2;2022-09-21;15;30;100;393;15;78;418;0;22;6126176;6814608;10671111;319094;6161208;11784630;424211;0;4423
FR;2;2022-09-22;16;39;124;581;18;95;619;0;28;6126192;6814647;10671235;319675;6161226;11784725;424830;0;4451
FR;2;2022-09-23;21;38;135;555;22;111;570;0;39;6126213;6814685;10671370;320230;6161248;11784836;425400;0;4490
FR;2;2022-09-24;10;8;51;190;6;36;201;0;6;6126223;6814693;10671421;320420;6161254;11784872;425601;0;4496
FR;2;2022-09-25;9;11;14;29;11;11;33;0;5;6126232;6814704;10671435;320449;6161265;11784883;425634;0;4501
FR;2;2022-09-26;22;41;106;447;27;79;458;0;20;6126254;6814745;10671541;320896;6161292;11784962;426092;0;4521
FR;2;2022-09-27;30;46;161;906;35;108;861;0;52;6126284;6814791;10671702;321802;6161327;11785070;426953;0;4573
FR;2;2022-09-28;15;31;93;421;18;74;439;0;23;6126299;6814822;10671795;322223;6161345;11785144;427392;0;4596
FR;2;2022-09-29;26;48;114;618;23;110;630;0;33;6126325;6814870;10671909;322841;6161368;11785254;428022;0;4629
FR;2;2022-09-30;25;44;111;520;44;84;533;0;31;6126350;6814914;10672020;323361;6161412;11785338;428555;0;4660
FR;2;2022-10-01;11;20;51;128;20;36;129;0;8;6126361;6814934;10672071;323489;6161432;11785374;428684;0;4668
FR;2;2022-10-02;0;5;8;21;4;5;25;0;2;6126361;6814939;10672079;323510;6161436;11785379;428709;0;4670
FR;2;2022-10-03;22;30;83;291;26;66;306;0;22;6126383;6814969;10672162;323801;6161462;11785445;429015;0;4692
FR;2;2022-10-04;17;21;106;602;19;71;621;0;46;6126400;6814990;10672268;324403;6161481;11785516;429636;0;4738
FR;2;2022-10-05;20;29;75;491;24;67;488;0;54;6126420;6815019;10672343;324894;6161505;11785583;430124;0;4792
FR;2;2022-10-06;30;23;74;442;17;71;428;0;65;6126450;6815042;10672417;325336;6161522;11785654;430552;0;4857
FR;2;2022-10-07;21;30;86;499;26;66;503;0;42;6126471;6815072;10672503;325835;6161548;11785720;431055;0;4899
FR;2;2022-10-08;12;8;23;114;3;24;108;0;12;6126483;6815080;10672526;325949;6161551;11785744;431163;0;4911
FR;2;2022-10-09;1;8;15;17;6;11;22;0;5;6126484;6815088;10672541;325966;6161557;11785755;431185;0;4916
FR;2;2022-10-10;18;24;47;223;22;49;218;0;21;6126502;6815112;10672588;326189;6161579;11785804;431403;0;4937
FR;2;2022-10-11;16;15;47;253;11;39;240;0;52;6126518;6815127;10672635;326442;6161590;11785843;431643;0;4989
FR;2;2022-10-12;8;18;52;290;14;36;305;0;56;6126526;6815145;10672687;326732;6161604;11785879;431948;0;5045
FR;2;2022-10-13;11;14;48;271;9;48;261;0;26;6126537;6815159;10672735;327003;6161613;11785927;432209;0;5071
FR;2;2022-10-14;12;29;36;229;17;40;230;0;29;6126549;6815188;10672771;327232;6161630;11785967;432439;0;5100
FR;2;2022-10-15;4;10;22;111;4;17;113;0;15;6126553;6815198;10672793;327343;6161634;11785984;432552;0;5115
FR;2;2022-10-16;0;6;4;11;5;7;8;0;1;6126553;6815204;10672797;327354;6161639;11785991;432560;0;5116
FR;2;2022-10-17;15;17;31;121;16;26;131;0;29;6126568;6815221;10672828;327475;6161655;11786017;432691;0;5145
FR;2;2022-10-18;13;11;68;181;5;34;217;0;41;6126581;6815232;10672896;327656;6161660;11786051;432908;0;5186
FR;2;2022-10-19;8;17;36;182;12;30;184;0;42;6126589;6815249;10672932;327838;6161672;11786081;433092;0;5228
FR;2;2022-10-20;11;29;41;200;15;40;196;0;52;6126600;6815278;10672973;328038;6161687;11786121;433288;0;5280
FR;2;2022-10-21;6;15;60;232;6;53;222;0;30;6126606;6815293;10673033;328270;6161693;11786174;433510;0;5310
FR;2;2022-10-22;8;7;25;101;2;23;102;0;20;6126614;6815300;10673058;328371;6161695;11786197;433612;0;5330
FR;2;2022-10-23;0;3;1;5;3;0;6;0;2;6126614;6815303;10673059;328376;6161698;11786197;433618;0;5332
FR;2;2022-10-24;12;12;16;109;12;16;112;0;20;6126626;6815315;10673075;328485;6161710;11786213;433730;0;5352
FR;2;2022-10-25;12;7;23;138;6;15;145;0;51;6126638;6815322;10673098;328623;6161716;11786228;433875;0;5403
FR;2;2022-10-26;4;3;16;90;2;11;95;0;27;6126642;6815325;10673114;328713;6161718;11786239;433970;0;5430
FR;2;2022-10-27;7;9;18;88;9;20;71;0;27;6126649;6815334;10673132;328801;6161727;11786259;434041;0;5457
FR;2;2022-10-28;5;3;15;91;3;7;92;0;27;6126654;6815337;10673147;328892;6161730;11786266;434133;0;5484
FR;2;2022-10-29;7;8;18;33;6;14;37;0;8;6126661;6815345;10673165;328925;6161736;11786280;434170;0;5492
FR;2;2022-10-30;3;7;5;8;5;2;5;0;1;6126664;6815352;10673170;328933;6161741;11786282;434175;0;5493
FR;2;2022-10-31;2;8;6;49;6;10;48;0;11;6126666;6815360;10673176;328982;6161747;11786292;434223;0;5504
FR;2;2022-11-01;0;0;7;1;0;5;3;0;0;6126666;6815360;10673183;328983;6161747;11786297;434226;0;5504
FR;2;2022-11-02;6;5;12;44;5;12;45;0;11;6126672;6815365;10673195;329027;6161752;11786309;434271;0;5515
FR;2;2022-11-03;6;7;15;77;6;10;74;0;18;6126678;6815372;10673210;329104;6161758;11786319;434345;0;5533
FR;2;2022-11-04;7;12;14;85;10;14;92;0;10;6126685;6815384;10673224;329189;6161768;11786333;434437;0;5543
FR;2;2022-11-05;0;11;12;38;6;16;35;0;6;6126685;6815395;10673236;329227;6161774;11786349;434472;0;5549
FR;2;2022-11-06;0;2;2;1;0;4;0;0;2;6126685;6815397;10673238;329228;6161774;11786353;434472;0;5551
FR;2;2022-11-07;11;7;14;66;5;13;65;0;20;6126696;6815404;10673252;329294;6161779;11786366;434537;0;5571
FR;2;2022-11-08;11;6;18;58;4;14;65;0;27;6126707;6815410;10673270;329352;6161783;11786380;434602;0;5598
FR;2;2022-11-09;4;5;17;56;2;17;50;0;28;6126711;6815415;10673287;329408;6161785;11786397;434652;0;5626
FR;2;2022-11-10;7;10;17;74;7;14;76;0;14;6126718;6815425;10673304;329482;6161792;11786411;434728;0;5640
FR;2;2022-11-11;0;3;7;3;0;8;4;0;0;6126718;6815428;10673311;329485;6161792;11786419;434732;0;5640
FR;2;2022-11-12;2;5;7;19;4;7;19;0;4;6126720;6815433;10673318;329504;6161796;11786426;434751;0;5644
FR;2;2022-11-13;3;2;3;2;1;4;1;0;0;6126723;6815435;10673321;329506;6161797;11786430;434752;0;5644
FR;2;2022-11-14;4;6;13;29;3;10;33;0;7;6126727;6815441;10673334;329535;6161800;11786440;434785;0;5651
FR;2;2022-11-15;8;12;14;35;13;17;32;0;7;6126735;6815453;10673348;329570;6161813;11786457;434817;0;5658
FR;2;2022-11-16;4;3;4;45;3;4;46;0;18;6126739;6815456;10673352;329615;6161816;11786461;434863;0;5676
FR;2;2022-11-17;2;6;11;53;5;8;52;0;22;6126741;6815462;10673363;329668;6161821;11786469;434915;0;5698
FR;2;2022-11-18;3;4;7;41;4;6;44;0;10;6126744;6815466;10673370;329709;6161825;11786475;434959;0;5708
FR;2;2022-11-19;3;2;2;25;2;3;18;0;5;6126747;6815468;10673372;329734;6161827;11786478;434977;0;5713
FR;2;2022-11-20;0;2;6;9;2;6;10;0;26;6126747;6815470;10673378;329743;6161829;11786484;434987;0;5739
FR;2;2022-11-21;6;10;9;31;7;8;34;0;22;6126753;6815480;10673387;329774;6161836;11786492;435021;0;5761
FR;2;2022-11-22;8;8;20;65;6;21;70;0;71;6126761;6815488;10673407;329839;6161842;11786513;435091;0;5832
FR;2;2022-11-23;7;6;8;68;3;5;73;0;8;6126768;6815494;10673415;329907;6161845;11786518;435164;0;5840
FR;2;2022-11-24;2;2;11;50;2;7;57;0;10;6126770;6815496;10673426;329957;6161847;11786525;435221;0;5850
FR;2;2022-11-25;11;8;11;25;11;13;26;0;8;6126781;6815504;10673437;329982;6161858;11786538;435247;0;5858
FR;2;2022-11-26;1;5;4;8;4;7;6;0;0;6126782;6815509;10673441;329990;6161862;11786545;435253;0;5858
FR;2;2022-11-27;2;2;12;2;0;11;4;0;1;6126784;6815511;10673453;329992;6161862;11786556;435257;0;5859
FR;2;2022-11-28;0;2;7;35;1;5;37;0;5;6126784;6815513;10673460;330027;6161863;11786561;435294;0;5864
FR;2;2022-11-29;1;1;9;24;0;3;30;0;8;6126785;6815514;10673469;330051;6161863;11786564;435324;0;5872
FR;2;2022-11-30;2;1;9;47;0;10;44;0;21;6126787;6815515;10673478;330098;6161863;11786574;435368;0;5893
FR;2;2022-12-01;2;7;4;60;4;12;51;0;24;6126789;6815522;10673482;330158;6161867;11786586;435419;0;5917
FR;2;2022-12-02;1;2;12;51;2;10;51;0;27;6126790;6815524;10673494;330209;6161869;11786596;435470;0;5944
FR;2;2022-12-03;1;3;7;19;1;7;18;0;10;6126791;6815527;10673501;330228;6161870;11786603;435488;0;5954
FR;2;2022-12-04;0;0;0;4;0;0;4;0;0;6126791;6815527;10673501;330232;6161870;11786603;435492;0;5954
FR;2;2022-12-05;3;3;7;50;6;4;43;0;16;6126794;6815530;10673508;330282;6161876;11786607;435535;0;5970
FR;2;2022-12-06;3;4;13;44;3;6;46;0;17;6126797;6815534;10673521;330326;6161879;11786613;435581;0;5987
FR;2;2022-12-07;1;3;9;42;2;7;44;0;11;6126798;6815537;10673530;330368;6161881;11786620;435625;0;5998
FR;2;2022-12-08;0;2;11;44;0;6;49;0;16;6126798;6815539;10673541;330412;6161881;11786626;435674;0;6014
FR;2;2022-12-09;0;1;11;52;0;8;56;0;16;6126798;6815540;10673552;330464;6161881;11786634;435730;0;6030
FR;2;2022-12-10;0;1;8;49;0;1;48;0;9;6126798;6815541;10673560;330513;6161881;11786635;435778;0;6039
FR;2;2022-12-11;0;0;2;2;0;2;1;0;3;6126798;6815541;10673562;330515;6161881;11786637;435779;0;6042
FR;2;2022-12-12;0;0;6;36;0;6;35;0;10;6126798;6815541;10673568;330551;6161881;11786643;435814;0;6052
FR;2;2022-12-13;0;2;1;37;1;1;36;0;14;6126798;6815543;10673569;330588;6161882;11786644;435850;0;6066
FR;2;2022-12-14;0;2;6;25;2;2;30;0;13;6126798;6815545;10673575;330613;6161884;11786646;435880;0;6079
FR;2;2022-12-15;0;4;10;43;4;7;44;0;17;6126798;6815549;10673585;330656;6161888;11786653;435924;0;6096
FR;2;2022-12-16;2;4;15;55;3;11;59;0;15;6126800;6815553;10673600;330711;6161891;11786664;435983;0;6111
FR;2;2022-12-17;1;3;6;44;3;1;39;0;5;6126801;6815556;10673606;330755;6161894;11786665;436022;0;6116
FR;2;2022-12-18;1;0;0;0;0;0;0;0;1;6126802;6815556;10673606;330755;6161894;11786665;436022;0;6117
FR;2;2022-12-19;5;1;1;30;0;2;24;0;23;6126807;6815557;10673607;330785;6161894;11786667;436046;0;6140
FR;2;2022-12-20;0;1;3;34;0;2;36;0;24;6126807;6815558;10673610;330819;6161894;11786669;436082;0;6164
FR;2;2022-12-21;0;0;2;13;0;2;13;0;8;6126807;6815558;10673612;330832;6161894;11786671;436095;0;6172
FR;2;2022-12-22;0;4;2;26;2;3;26;0;10;6126807;6815562;10673614;330858;6161896;11786674;436121;0;6182
FR;2;2022-12-23;1;4;4;13;2;5;13;0;4;6126808;6815566;10673618;330871;6161898;11786679;436134;0;6186
FR;2;2022-12-24;0;0;1;1;0;1;1;0;0;6126808;6815566;10673619;330872;6161898;11786680;436135;0;6186
FR;2;2022-12-25;0;1;1;2;0;1;3;0;0;6126808;6815567;10673620;330874;6161898;11786681;436138;0;6186
FR;2;2022-12-26;0;0;4;11;0;2;11;0;3;6126808;6815567;10673624;330885;6161898;11786683;436149;0;6189
FR;2;2022-12-27;0;1;5;5;1;3;7;0;4;6126808;6815568;10673629;330890;6161899;11786686;436156;0;6193
FR;2;2022-12-28;0;2;2;13;2;1;14;0;5;6126808;6815570;10673631;330903;6161901;11786687;436170;0;6198
FR;2;2022-12-29;1;0;3;15;0;1;17;0;5;6126809;6815570;10673634;330918;6161901;11786688;436187;0;6203
FR;2;2022-12-30;0;0;1;6;0;1;5;0;1;6126809;6815570;10673635;330924;6161901;11786689;436192;0;6204
FR;2;2022-12-31;0;0;1;2;0;1;2;0;1;6126809;6815570;10673636;330926;6161901;11786690;436194;0;6205
FR;2;2023-01-01;0;0;0;0;0;0;0;0;0;6126809;6815570;10673636;330926;6161901;11786690;436194;0;6205
FR;2;2023-01-02;1;0;4;17;0;1;20;0;2;6126810;6815570;10673640;330943;6161901;11786691;436214;0;6207
FR;3;2020-12-27;0;0;0;0;0;0;0;0;0;0;0;0;0;0;0;0;0;0
FR;3;2020-12-28;0;0;0;0;0;0;0;0;0;0;0;0;0;0;0;0;0;0
FR;3;2020-12-29;0;0;0;0;0;0;0;0;0;0;0;0;0;0;0;0;0;0
FR;3;2020-12-30;0;0;0;0;0;0;0;0;0;0;0;0;0;0;0;0;0;0
FR;3;2020-12-31;0;0;0;0;0;0;0;0;0;0;0;0;0;0;0;0;0;0
FR;3;2021-01-01;0;0;0;0;0;0;0;0;0;0;0;0;0;0;0;0;0;0
FR;3;2021-01-02;0;0;0;0;0;0;0;0;0;0;0;0;0;0;0;0;0;0
FR;3;2021-01-03;0;0;0;0;0;0;0;0;0;0;0;0;0;0;0;0;0;0
FR;3;2021-01-04;0;0;0;0;0;0;0;0;0;0;0;0;0;0;0;0;0;0
FR;3;2021-01-05;0;0;0;0;0;0;0;0;0;0;0;0;0;0;0;0;0;0
FR;3;2021-01-06;0;0;0;0;0;0;0;0;0;0;0;0;0;0;0;0;0;0
FR;3;2021-01-07;0;0;0;0;0;0;0;0;0;0;0;0;0;0;0;0;0;0
FR;3;2021-01-08;0;0;0;0;0;0;0;0;0;0;0;0;0;0;0;0;0;0
FR;3;2021-01-09;0;0;0;0;0;0;0;0;0;0;0;0;0;0;0;0;0;0
FR;3;2021-01-10;0;0;0;0;0;0;0;0;0;0;0;0;0;0;0;0;0;0
FR;3;2021-01-11;0;0;0;0;0;0;0;0;0;0;0;0;0;0;0;0;0;0
FR;3;2021-01-12;0;0;0;0;0;0;0;0;0;0;0;0;0;0;0;0;0;0
FR;3;2021-01-13;0;0;0;0;0;0;0;0;0;0;0;0;0;0;0;0;0;0
FR;3;2021-01-14;0;0;0;0;0;0;0;0;0;0;0;0;0;0;0;0;0;0
FR;3;2021-01-15;0;0;0;0;0;0;0;0;0;0;0;0;0;0;0;0;0;0
FR;3;2021-01-16;0;0;0;0;0;0;0;0;0;0;0;0;0;0;0;0;0;0
FR;3;2021-01-17;0;0;0;0;0;0;0;0;0;0;0;0;0;0;0;0;0;0
FR;3;2021-01-18;0;0;0;0;0;0;0;0;0;0;0;0;0;0;0;0;0;0
FR;3;2021-01-19;0;0;0;0;0;0;0;0;0;0;0;0;0;0;0;0;0;0
FR;3;2021-01-20;0;0;0;0;0;0;0;0;0;0;0;0;0;0;0;0;0;0
FR;3;2021-01-21;0;0;0;0;0;0;0;0;0;0;0;0;0;0;0;0;0;0
FR;3;2021-01-22;0;0;0;0;0;0;0;0;0;0;0;0;0;0;0;0;0;0
FR;3;2021-01-23;0;0;0;0;0;0;0;0;0;0;0;0;0;0;0;0;0;0
FR;3;2021-01-24;0;0;0;0;0;0;0;0;0;0;0;0;0;0;0;0;0;0
FR;3;2021-01-25;0;0;0;0;0;0;0;0;0;0;0;0;0;0;0;0;0;0
FR;3;2021-01-26;0;0;0;0;0;0;0;0;0;0;0;0;0;0;0;0;0;0
FR;3;2021-01-27;0;0;0;0;0;0;0;0;0;0;0;0;0;0;0;0;0;0
FR;3;2021-01-28;0;0;0;0;0;0;0;0;0;0;0;0;0;0;0;0;0;0
FR;3;2021-01-29;0;0;0;0;0;0;0;0;0;0;0;0;0;0;0;0;0;0
FR;3;2021-01-30;0;0;0;0;0;0;0;0;0;0;0;0;0;0;0;0;0;0
FR;3;2021-01-31;0;0;0;0;0;0;0;0;0;0;0;0;0;0;0;0;0;0
FR;3;2021-02-01;0;0;0;0;0;0;0;0;0;0;0;0;0;0;0;0;0;0
FR;3;2021-02-02;0;0;0;0;0;0;0;0;0;0;0;0;0;0;0;0;0;0
FR;3;2021-02-03;0;0;0;0;0;0;0;0;0;0;0;0;0;0;0;0;0;0
FR;3;2021-02-04;0;0;0;0;0;0;0;0;0;0;0;0;0;0;0;0;0;0
FR;3;2021-02-05;0;0;0;0;0;0;0;0;0;0;0;0;0;0;0;0;0;0
FR;3;2021-02-06;1488;0;0;0;106;0;0;0;0;1488;0;0;0;106;0;0;0;0
FR;3;2021-02-07;1423;2;0;0;87;0;0;0;0;2911;2;0;0;193;0;0;0;0
FR;3;2021-02-08;2789;1;0;0;177;0;0;0;0;5700;3;0;0;370;0;0;0;0
FR;3;2021-02-09;6786;0;0;0;502;0;0;0;0;12486;3;0;0;872;0;0;0;0
FR;3;2021-02-10;9611;0;0;0;695;0;0;0;0;22097;3;0;0;1567;0;0;0;0
FR;3;2021-02-11;13620;4;0;0;920;0;0;0;0;35717;7;0;0;2487;0;0;0;0
FR;3;2021-02-12;13410;0;0;0;907;0;0;0;0;49127;7;0;0;3394;0;0;0;0
FR;3;2021-02-13;3799;1;0;0;218;0;0;0;0;52926;8;0;0;3612;0;0;0;0
FR;3;2021-02-14;975;1;0;0;53;0;0;0;0;53901;9;0;0;3665;0;0;0;0
FR;3;2021-02-15;10495;2;0;0;719;0;0;0;0;64396;11;0;0;4384;0;0;0;0
FR;3;2021-02-16;12556;5;0;0;871;0;0;0;0;76952;16;0;0;5255;0;0;0;0
FR;3;2021-02-17;11158;1;0;0;716;0;0;0;0;88110;17;0;0;5971;0;0;0;0
FR;3;2021-02-18;14943;2;0;0;985;0;0;0;0;103053;19;0;0;6956;0;0;0;0
FR;3;2021-02-19;14364;1;0;0;846;0;0;0;0;117417;20;0;0;7802;0;0;0;0
FR;3;2021-02-20;3330;0;0;0;178;0;0;0;0;120747;20;0;0;7980;0;0;0;0
FR;3;2021-02-21;619;0;0;0;35;0;0;0;0;121366;20;0;0;8015;0;0;0;0
FR;3;2021-02-22;9171;1;0;0;654;0;0;0;0;130537;21;0;0;8669;0;0;0;0
FR;3;2021-02-23;11405;5;0;0;759;0;0;0;0;141942;26;0;0;9428;0;0;0;0
FR;3;2021-02-24;14305;1;0;0;829;0;0;0;0;156247;27;0;0;10257;0;0;0;0
FR;3;2021-02-25;44935;3;0;0;1814;0;0;0;0;201182;30;0;0;12071;0;0;0;0
FR;3;2021-02-26;61890;10;0;0;2200;0;0;0;0;263072;40;0;0;14271;0;0;0;0
FR;3;2021-02-27;34810;14;0;0;1028;0;0;0;0;297882;54;0;0;15299;0;0;0;0
FR;3;2021-02-28;2464;0;0;0;114;0;0;0;0;300346;54;0;0;15413;0;0;0;0
FR;3;2021-03-01;20520;21;0;0;1067;0;0;0;0;320866;75;0;0;16480;0;0;0;0
FR;3;2021-03-02;38878;25;0;0;1789;0;0;0;0;359744;100;0;0;18269;0;0;0;0
FR;3;2021-03-03;48748;19;0;0;2132;0;0;0;0;408492;119;0;0;20401;0;0;0;0
FR;3;2021-03-04;82229;25;0;0;3194;0;0;0;0;490721;144;0;0;23595;0;0;0;0
FR;3;2021-03-05;118136;41;0;0;4691;0;0;0;0;608857;185;0;0;28286;0;0;0;0
FR;3;2021-03-06;120726;65;1;0;3560;0;0;0;0;729583;250;1;0;31846;0;0;0;0
FR;3;2021-03-07;55185;23;0;0;1729;0;0;0;0;784768;273;1;0;33575;0;0;0;0
FR;3;2021-03-08;42814;29;0;0;2074;0;0;0;0;827582;302;1;0;35649;0;0;0;0
FR;3;2021-03-09;78979;49;0;0;3285;0;0;0;0;906561;351;1;0;38934;0;0;0;0
FR;3;2021-03-10;80984;65;0;0;3241;0;0;0;0;987545;416;1;0;42175;0;0;0;0
FR;3;2021-03-11;128447;64;0;0;4765;0;0;0;0;1115992;480;1;0;46940;0;0;0;0
FR;3;2021-03-12;182722;120;0;0;6277;0;0;0;0;1298714;600;1;0;53217;0;0;0;0
FR;3;2021-03-13;132163;86;0;0;3525;0;0;0;0;1430877;686;1;0;56742;0;0;0;0
FR;3;2021-03-14;14058;6;0;0;550;0;0;0;0;1444935;692;1;0;57292;0;0;0;0
FR;3;2021-03-15;52237;80;0;0;2095;0;0;0;0;1497172;772;1;0;59387;0;0;0;0
FR;3;2021-03-16;1219;49;0;0;103;0;0;0;0;1498391;821;1;0;59490;0;0;0;0
FR;3;2021-03-17;950;55;0;0;94;0;0;0;0;1499341;876;1;0;59584;0;0;0;0
FR;3;2021-03-18;1575;41;0;0;101;0;0;0;0;1500916;917;1;0;59685;0;0;0;0
FR;3;2021-03-19;70459;55;0;0;2059;0;0;0;0;1571375;972;1;0;61744;0;0;0;0
FR;3;2021-03-20;65241;49;0;0;1701;0;0;0;0;1636616;1021;1;0;63445;0;0;0;0
FR;3;2021-03-21;5761;8;0;0;199;0;0;0;0;1642377;1029;1;0;63644;0;0;0;0
FR;3;2021-03-22;37510;47;0;0;1051;0;0;0;0;1679887;1076;1;0;64695;0;0;0;0
FR;3;2021-03-23;84669;87;0;0;2286;0;0;0;0;1764556;1163;1;0;66981;0;0;0;0
FR;3;2021-03-24;90954;97;0;0;2489;0;0;0;0;1855510;1260;1;0;69470;0;0;0;0
FR;3;2021-03-25;150070;145;0;0;3788;0;0;0;0;2005580;1405;1;0;73258;0;0;0;0
FR;3;2021-03-26;165429;158;0;0;4150;0;0;0;0;2171009;1563;1;0;77408;0;0;0;0
FR;3;2021-03-27;68466;101;0;0;2004;0;0;0;0;2239475;1664;1;0;79412;0;0;0;0
FR;3;2021-03-28;6479;20;0;0;237;0;0;0;0;2245954;1684;1;0;79649;0;0;0;0
FR;3;2021-03-29;54169;81;0;0;1479;0;0;0;0;2300123;1765;1;0;81128;0;0;0;0
FR;3;2021-03-30;93183;103;0;0;2565;0;0;0;0;2393306;1868;1;0;83693;0;0;0;0
FR;3;2021-03-31;63544;112;0;0;1966;0;0;0;0;2456850;1980;1;0;85659;0;0;0;0
FR;3;2021-04-01;86134;112;0;0;2492;0;0;0;0;2542984;2092;1;0;88151;0;0;0;0
FR;3;2021-04-02;86912;187;0;0;2766;0;0;0;0;2629896;2279;1;0;90917;0;0;0;0
FR;3;2021-04-03;35875;131;0;0;1162;0;0;0;0;2665771;2410;1;0;92079;0;0;0;0
FR;3;2021-04-04;3577;19;0;0;164;0;0;0;0;2669348;2429;1;0;92243;0;0;0;0
FR;3;2021-04-05;4492;38;0;0;236;0;0;0;0;2673840;2467;1;0;92479;0;0;0;0
FR;3;2021-04-06;29758;104;0;0;1091;0;0;0;0;2703598;2571;1;0;93570;0;0;0;0
FR;3;2021-04-07;32348;108;0;0;1047;0;0;0;0;2735946;2679;1;0;94617;0;0;0;0
FR;3;2021-04-08;78826;268;0;0;2615;0;0;0;0;2814772;2947;1;0;97232;0;0;0;0
FR;3;2021-04-09;161760;447;0;0;5175;0;0;0;0;2976532;3394;1;0;102407;0;0;0;0
FR;3;2021-04-10;75764;360;0;0;2693;0;0;0;0;3052296;3754;1;0;105100;0;0;0;0
FR;3;2021-04-11;7315;47;0;0;306;0;0;0;0;3059611;3801;1;0;105406;0;0;0;0
FR;3;2021-04-12;51485;213;0;0;1734;0;0;0;0;3111096;4014;1;0;107140;0;0;0;0
FR;3;2021-04-13;86236;359;0;0;2906;0;0;0;0;3197332;4373;1;0;110046;0;0;0;0
FR;3;2021-04-14;67843;377;0;0;2429;0;0;0;0;3265175;4750;1;0;112475;0;0;0;0
FR;3;2021-04-15;93243;401;0;0;3439;0;0;0;0;3358418;5151;1;0;115914;0;0;0;0
FR;3;2021-04-16;112530;625;0;0;4341;0;0;0;0;3470948;5776;1;0;120255;0;0;0;0
FR;3;2021-04-17;53319;365;1;0;2272;0;0;0;0;3524267;6141;2;0;122527;0;0;0;0
FR;3;2021-04-18;9751;49;0;0;423;0;0;0;0;3534018;6190;2;0;122950;0;0;0;0
FR;3;2021-04-19;25116;283;0;0;1089;0;0;0;0;3559134;6473;2;0;124039;0;0;0;0
FR;3;2021-04-20;45675;432;0;0;1903;0;0;0;0;3604809;6905;2;0;125942;0;0;0;0
FR;3;2021-04-21;38985;543;0;0;1887;0;0;0;0;3643794;7448;2;0;127829;0;0;0;0
FR;3;2021-04-22;54723;870;0;0;2822;0;0;0;0;3698517;8318;2;0;130651;0;0;0;0
FR;3;2021-04-23;70493;1089;0;0;3690;0;0;0;0;3769010;9407;2;0;134341;0;0;0;0
FR;3;2021-04-24;37253;1091;0;0;2479;0;0;0;0;3806263;10498;2;0;136820;0;0;0;0
FR;3;2021-04-25;6213;159;0;0;447;0;0;0;0;3812476;10657;2;0;137267;0;0;0;0
FR;3;2021-04-26;19790;694;0;0;1429;0;0;0;0;3832266;11351;2;0;138696;0;0;0;0
FR;3;2021-04-27;34485;1327;0;0;2585;0;0;0;0;3866751;12678;2;0;141281;0;0;0;0
FR;3;2021-04-28;28972;2031;0;0;3148;0;0;0;0;3895723;14709;2;0;144429;0;0;0;0
FR;3;2021-04-29;45394;6110;0;0;7928;0;0;0;0;3941117;20819;2;0;152357;0;0;0;0
FR;3;2021-04-30;55465;9095;1;0;11490;0;0;0;0;3996582;29914;3;0;163847;0;0;0;0
FR;3;2021-05-01;9518;2056;0;0;2487;0;0;0;0;4006100;31970;3;0;166334;0;0;0;0
FR;3;2021-05-02;3081;469;0;0;614;0;0;0;0;4009181;32439;3;0;166948;0;0;0;0
FR;3;2021-05-03;13064;3938;0;0;4505;0;0;0;0;4022245;36377;3;0;171453;0;0;0;0
FR;3;2021-05-04;23121;8376;0;0;9442;0;0;0;0;4045366;44753;3;0;180895;0;0;0;0
FR;3;2021-05-05;18765;10812;0;0;11750;0;0;0;0;4064131;55565;3;0;192645;0;0;0;0
FR;3;2021-05-06;34632;21218;0;0;22765;0;0;0;0;4098763;76783;3;0;215410;0;0;0;0
FR;3;2021-05-07;44210;28868;0;0;31172;0;0;0;0;4142973;105651;3;0;246582;0;0;0;0
FR;3;2021-05-08;6785;9190;0;0;9553;0;0;0;0;4149758;114841;3;0;256135;0;0;0;0
FR;3;2021-05-09;1797;2671;0;0;2771;0;0;0;0;4151555;117512;3;0;258906;0;0;0;0
FR;3;2021-05-10;15001;12891;0;0;13581;0;0;0;0;4166556;130403;3;0;272487;0;0;0;0
FR;3;2021-05-11;27100;26248;0;0;27519;0;0;0;0;4193656;156651;3;0;300006;0;0;0;0
FR;3;2021-05-12;17272;28094;0;0;29029;0;0;0;0;4210928;184745;3;0;329035;0;0;0;0
FR;3;2021-05-13;2285;3513;0;0;3633;0;0;0;0;4213213;188258;3;0;332668;0;0;0;0
FR;3;2021-05-14;14521;26062;0;0;26841;0;0;0;0;4227734;214320;3;0;359509;0;0;0;0
FR;3;2021-05-15;7233;21060;0;0;21487;0;0;0;0;4234967;235380;3;0;380996;0;0;0;0
FR;3;2021-05-16;977;2643;0;0;2688;0;0;0;0;4235944;238023;3;0;383684;0;0;0;0
FR;3;2021-05-17;7966;20205;0;0;20650;0;0;0;0;4243910;258228;3;0;404334;0;0;0;0
FR;3;2021-05-18;13417;30117;0;0;30876;0;0;0;0;4257327;288345;3;0;435210;0;0;0;0
FR;3;2021-05-19;9276;30579;0;0;31171;0;0;0;0;4266603;318924;3;0;466381;0;0;0;0
FR;3;2021-05-20;12806;53801;3;0;54726;0;0;0;0;4279409;372725;6;0;521107;0;0;0;0
FR;3;2021-05-21;12770;66152;2;0;67078;0;0;0;0;4292179;438877;8;0;588185;0;0;0;0
FR;3;2021-05-22;4966;33740;1;0;34121;0;0;0;0;4297145;472617;9;0;622306;0;0;0;0
FR;3;2021-05-23;651;2668;0;0;2700;0;0;0;0;4297796;475285;9;0;625006;0;0;0;0
FR;3;2021-05-24;885;4788;0;0;4832;0;0;0;0;4298681;480073;9;0;629838;0;0;0;0
FR;3;2021-05-25;5312;46661;1;0;47058;0;0;0;0;4303993;526734;10;0;676896;0;0;0;0
FR;3;2021-05-26;4980;52138;1;0;52609;0;0;0;0;4308973;578872;11;0;729505;0;0;0;0
FR;3;2021-05-27;6336;78987;3;0;79596;0;0;0;0;4315309;657859;14;0;809101;0;0;0;0
FR;3;2021-05-28;7545;100262;2;0;101061;0;0;0;0;4322854;758121;16;0;910162;0;0;0;0
FR;3;2021-05-29;3349;61129;1;0;61509;0;0;0;0;4326203;819250;17;0;971671;0;0;0;0
FR;3;2021-05-30;551;8095;0;0;8144;0;0;0;0;4326754;827345;17;0;979815;0;0;0;0
FR;3;2021-05-31;2442;35501;3;0;35766;0;0;0;0;4329196;862846;20;0;1015581;0;0;0;0
FR;3;2021-06-01;3414;64863;10;0;65311;0;0;0;0;4332610;927709;30;0;1080892;0;0;0;0
FR;3;2021-06-02;2735;58896;6;0;59229;0;0;0;0;4335345;986605;36;0;1140121;0;0;0;0
FR;3;2021-06-03;3495;87223;10;0;87757;0;0;0;0;4338840;1073828;46;0;1227878;0;0;0;0
FR;3;2021-06-04;4121;105804;22;0;106464;0;0;0;0;4342961;1179632;68;0;1334342;0;0;0;0
FR;3;2021-06-05;1983;52581;4;0;52896;0;0;0;0;4344944;1232213;72;0;1387238;0;0;0;0
FR;3;2021-06-06;511;5284;1;0;5331;0;0;0;0;4345455;1237497;73;0;1392569;0;0;0;0
FR;3;2021-06-07;1486;30733;11;0;30913;0;0;0;0;4346941;1268230;84;0;1423482;0;0;0;0
FR;3;2021-06-08;2065;47414;18;0;47758;0;0;0;0;4349006;1315644;102;0;1471240;0;0;0;0
FR;3;2021-06-09;1794;41839;13;0;42144;0;0;0;0;4350800;1357483;115;0;1513384;0;0;0;0
FR;3;2021-06-10;2257;67682;17;0;68078;0;0;0;0;4353057;1425165;132;0;1581462;0;0;0;0
FR;3;2021-06-11;2490;96624;34;0;97097;0;0;0;0;4355547;1521789;166;0;1678559;0;0;0;0
FR;3;2021-06-12;1178;40571;6;0;40802;0;0;0;0;4356725;1562360;172;0;1719361;0;0;0;0
FR;3;2021-06-13;283;3624;3;0;3659;0;0;0;0;4357008;1565984;175;0;1723020;0;0;0;0
FR;3;2021-06-14;1048;42325;17;0;42493;0;0;0;0;4358056;1608309;192;0;1765513;0;0;0;0
FR;3;2021-06-15;1379;80366;20;0;80669;0;0;0;0;4359435;1688675;212;0;1846182;0;0;0;0
FR;3;2021-06-16;1262;65502;20;0;65775;0;0;0;0;4360697;1754177;232;0;1911957;0;0;0;0
FR;3;2021-06-17;1667;102263;41;0;102645;0;0;0;0;4362364;1856440;273;0;2014602;0;0;0;0
FR;3;2021-06-18;1872;118440;63;0;118904;0;0;0;0;4364236;1974880;336;0;2133506;0;0;0;0
FR;3;2021-06-19;803;39461;22;0;39654;0;0;0;0;4365039;2014341;358;0;2173160;0;0;0;0
FR;3;2021-06-20;161;3200;0;0;3228;0;0;0;0;4365200;2017541;358;0;2176388;0;0;0;0
FR;3;2021-06-21;774;39077;16;0;39235;0;0;0;0;4365974;2056618;374;0;2215623;0;0;0;0
FR;3;2021-06-22;1065;70043;52;0;70313;0;0;0;0;4367039;2126661;426;0;2285936;0;0;0;0
FR;3;2021-06-23;945;50834;39;0;51106;0;0;0;0;4367984;2177495;465;0;2337042;0;0;0;0
FR;3;2021-06-24;1310;77287;48;0;77660;0;0;0;0;4369294;2254782;513;0;2414702;0;0;0;0
FR;3;2021-06-25;1410;90790;73;0;91223;0;0;0;0;4370704;2345572;586;0;2505925;0;0;0;0
FR;3;2021-06-26;632;33114;29;0;33307;0;0;0;0;4371336;2378686;615;0;2539232;0;0;0;0
FR;3;2021-06-27;167;3785;1;0;3809;0;0;0;0;4371503;2382471;616;0;2543041;0;0;0;0
FR;3;2021-06-28;655;29971;27;0;30165;0;0;0;0;4372158;2412442;643;0;2573206;0;0;0;0
FR;3;2021-06-29;856;56619;95;0;56862;0;0;0;0;4373014;2469061;738;0;2630068;0;0;0;0
FR;3;2021-06-30;905;45208;93;0;45477;0;0;0;0;4373919;2514269;831;0;2675545;0;0;0;0
FR;3;2021-07-01;1164;66082;108;0;66432;0;0;0;0;4375083;2580351;939;0;2741977;0;0;0;0
FR;3;2021-07-02;1305;90506;170;0;90984;0;0;0;0;4376388;2670857;1109;0;2832961;0;0;0;0
FR;3;2021-07-03;602;31177;51;0;31378;0;0;0;0;4376990;2702034;1160;0;2864339;0;0;0;0
FR;3;2021-07-04;144;3982;3;0;4012;0;0;0;0;4377134;2706016;1163;0;2868351;0;0;0;0
FR;3;2021-07-05;613;33618;60;0;33817;0;0;0;0;4377747;2739634;1223;0;2902168;0;0;0;0
FR;3;2021-07-06;964;55927;88;0;56239;0;0;0;0;4378711;2795561;1311;0;2958407;0;0;0;0
FR;3;2021-07-07;873;42960;80;0;43257;0;0;0;0;4379584;2838521;1391;0;3001664;0;0;0;0
FR;3;2021-07-08;1127;60798;99;0;61205;0;0;0;0;4380711;2899319;1490;0;3062869;0;0;0;0
FR;3;2021-07-09;1261;68934;128;0;69403;0;0;0;0;4381972;2968253;1618;0;3132272;0;0;0;0
FR;3;2021-07-10;643;25024;59;0;25221;0;0;0;0;4382615;2993277;1677;0;3157493;0;0;0;0
FR;3;2021-07-11;132;3183;4;0;3209;0;0;0;0;4382747;2996460;1681;0;3160702;0;0;0;0
FR;3;2021-07-12;662;23625;59;0;23838;0;0;0;0;4383409;3020085;1740;0;3184540;0;0;0;0
FR;3;2021-07-13;1648;34471;90;0;34959;0;0;0;0;4385057;3054556;1830;0;3219499;0;0;0;0
FR;3;2021-07-14;271;2474;2;0;2531;0;0;0;0;4385328;3057030;1832;0;3222030;0;0;0;0
FR;3;2021-07-15;1940;30432;85;0;31007;0;0;0;0;4387268;3087462;1917;0;3253037;0;0;0;0
FR;3;2021-07-16;2520;38652;122;0;39386;0;0;0;0;4389788;3126114;2039;0;3292423;0;0;0;0
FR;3;2021-07-17;1051;13721;26;0;14029;0;0;0;0;4390839;3139835;2065;0;3306452;0;0;0;0
FR;3;2021-07-18;266;2558;3;0;2606;0;0;0;0;4391105;3142393;2068;0;3309058;0;0;0;0
FR;3;2021-07-19;1280;16906;38;0;17274;0;0;0;0;4392385;3159299;2106;0;3326332;0;0;0;0
FR;3;2021-07-20;1823;26944;98;0;27486;0;0;0;0;4394208;3186243;2204;0;3353818;0;0;0;0
FR;3;2021-07-21;1651;19508;44;0;20013;0;0;0;0;4395859;3205751;2248;0;3373831;0;0;0;0
FR;3;2021-07-22;1856;27651;83;0;28216;0;0;0;0;4397715;3233402;2331;0;3402047;0;0;0;0
FR;3;2021-07-23;2216;30226;117;0;30964;0;0;0;0;4399931;3263628;2448;0;3433011;0;0;0;0
FR;3;2021-07-24;827;6936;25;0;7159;0;0;0;0;4400758;3270564;2473;0;3440170;0;0;0;0
FR;3;2021-07-25;210;1293;1;0;1348;0;0;0;0;4400968;3271857;2474;0;3441518;0;0;0;0
FR;3;2021-07-26;932;10523;28;0;10830;0;0;0;0;4401900;3282380;2502;0;3452348;0;0;0;0
FR;3;2021-07-27;1170;16808;56;0;17172;0;0;0;0;4403070;3299188;2558;0;3469520;0;0;0;0
FR;3;2021-07-28;989;12002;40;0;12314;0;0;0;0;4404059;3311190;2598;0;3481834;0;0;0;0
FR;3;2021-07-29;1127;15693;63;0;16107;0;0;0;0;4405186;3326883;2661;0;3497941;0;0;0;0
FR;3;2021-07-30;1129;17998;79;0;18372;0;0;0;0;4406315;3344881;2740;0;3516313;0;0;0;0
FR;3;2021-07-31;406;3712;15;0;3836;0;0;0;0;4406721;3348593;2755;0;3520149;0;0;0;0
FR;3;2021-08-01;117;450;1;0;472;0;0;0;0;4406838;3349043;2756;0;3520621;0;0;0;0
FR;3;2021-08-02;423;5030;22;0;5151;0;0;0;0;4407261;3354073;2778;0;3525772;0;0;0;0
FR;3;2021-08-03;498;7471;27;0;7606;0;0;0;0;4407759;3361544;2805;0;3533378;0;0;0;0
FR;3;2021-08-04;440;4831;26;0;4977;0;0;0;0;4408199;3366375;2831;0;3538355;0;0;0;0
FR;3;2021-08-05;433;3655;13;0;3766;0;0;0;0;4408632;3370030;2844;0;3542121;0;0;0;0
FR;3;2021-08-06;456;4703;30;0;4805;0;0;0;0;4409088;3374733;2874;0;3546926;0;0;0;0
FR;3;2021-08-07;214;1901;11;0;1947;0;0;0;0;4409302;3376634;2885;0;3548873;0;0;0;0
FR;3;2021-08-08;250;424;2;0;457;0;0;0;0;4409552;3377058;2887;0;3549330;0;0;0;0
FR;3;2021-08-09;318;2380;11;0;2451;0;0;0;0;4409870;3379438;2898;0;3551781;0;0;0;0
FR;3;2021-08-10;368;3749;15;0;3838;0;0;0;0;4410238;3383187;2913;0;3555619;0;0;0;0
FR;3;2021-08-11;291;2645;15;0;2705;0;0;0;0;4410529;3385832;2928;0;3558324;0;0;0;0
FR;3;2021-08-12;279;2571;13;0;2659;0;0;0;0;4410808;3388403;2941;0;3560983;0;0;0;0
FR;3;2021-08-13;278;2256;16;0;2341;0;0;0;0;4411086;3390659;2957;0;3563324;0;0;0;0
FR;3;2021-08-14;172;879;1;0;910;0;0;0;0;4411258;3391538;2958;0;3564234;0;0;0;0
FR;3;2021-08-15;56;175;0;0;184;0;0;0;0;4411314;3391713;2958;0;3564418;0;0;0;0
FR;3;2021-08-16;126;1017;8;0;1056;0;0;0;0;4411440;3392730;2966;0;3565474;0;0;0;0
FR;3;2021-08-17;191;1432;8;0;1473;0;0;0;0;4411631;3394162;2974;0;3566947;0;0;0;0
FR;3;2021-08-18;204;1314;10;0;1356;0;0;0;0;4411835;3395476;2984;0;3568303;0;0;0;0
FR;3;2021-08-19;165;1373;10;0;1420;0;0;0;0;4412000;3396849;2994;0;3569723;0;0;0;0
FR;3;2021-08-20;167;1597;16;0;1659;0;0;0;0;4412167;3398446;3010;0;3571382;0;0;0;0
FR;3;2021-08-21;93;581;2;0;596;0;0;0;0;4412260;3399027;3012;0;3571978;0;0;0;0
FR;3;2021-08-22;42;191;1;0;194;0;0;0;0;4412302;3399218;3013;0;3572172;0;0;0;0
FR;3;2021-08-23;141;882;7;0;927;0;0;0;0;4412443;3400100;3020;0;3573099;0;0;0;0
FR;3;2021-08-24;125;927;10;0;959;0;0;0;0;4412568;3401027;3030;0;3574058;0;0;0;0
FR;3;2021-08-25;137;821;3;0;850;0;0;0;0;4412705;3401848;3033;0;3574908;0;0;0;0
FR;3;2021-08-26;172;830;9;0;878;0;0;0;0;4412877;3402678;3042;0;3575786;0;0;0;0
FR;3;2021-08-27;178;936;9;0;989;0;0;0;0;4413055;3403614;3051;0;3576775;0;0;0;0
FR;3;2021-08-28;101;371;4;0;388;0;0;0;0;4413156;3403985;3055;0;3577163;0;0;0;0
FR;3;2021-08-29;128;128;1;0;161;0;0;0;0;4413284;3404113;3056;0;3577324;0;0;0;0
FR;3;2021-08-30;100;565;0;0;472;110;0;0;0;4413384;3404678;3056;0;3577796;110;0;0;0
FR;3;2021-08-31;134;687;7;0;591;135;0;0;0;4413518;3405365;3063;0;3578387;245;0;0;0
FR;3;2021-09-01;122;458;5;0;380;107;0;0;0;4413640;3405823;3068;0;3578767;352;0;0;0
FR;3;2021-09-02;100;595;22;0;531;105;0;0;0;4413740;3406418;3090;0;3579298;457;0;0;0
FR;3;2021-09-03;116;557;17;0;480;118;0;0;0;4413856;3406975;3107;0;3579778;575;0;0;0
FR;3;2021-09-04;55;293;3;0;254;50;0;0;0;4413911;3407268;3110;0;3580032;625;0;0;0
FR;3;2021-09-05;52;67;5;0;56;26;0;0;0;4413963;3407335;3115;0;3580088;651;0;0;0
FR;3;2021-09-06;118;367;4;0;261;130;0;0;0;4414081;3407702;3119;0;3580349;781;0;0;0
FR;3;2021-09-07;124;434;14;0;349;117;0;0;0;4414205;3408136;3133;0;3580698;898;0;0;0
FR;3;2021-09-08;121;342;2;0;271;88;0;0;0;4414326;3408478;3135;0;3580969;986;0;0;0
FR;3;2021-09-09;94;379;8;0;299;103;0;0;0;4414420;3408857;3143;0;3581268;1089;0;0;0
FR;3;2021-09-10;101;399;3;0;329;93;0;0;0;4414521;3409256;3146;0;3581597;1182;0;0;0
FR;3;2021-09-11;78;232;4;0;177;65;0;0;0;4414599;3409488;3150;0;3581774;1247;0;0;0
FR;3;2021-09-12;37;48;1;0;37;16;0;0;0;4414636;3409536;3151;0;3581811;1263;0;0;0
FR;3;2021-09-13;78;301;7;0;217;103;1;0;0;4414714;3409837;3158;0;3582028;1366;1;0;0
FR;3;2021-09-14;75;274;6;0;194;94;0;0;0;4414789;3410111;3164;0;3582222;1460;1;0;0
FR;3;2021-09-15;63;254;3;0;259;6;0;0;0;4414852;3410365;3167;0;3582481;1466;1;0;0
FR;3;2021-09-16;65;320;6;0;331;6;0;0;0;4414917;3410685;3173;0;3582812;1472;1;0;0
FR;3;2021-09-17;52;328;3;0;340;6;0;0;0;4414969;3411013;3176;0;3583152;1478;1;0;0
FR;3;2021-09-18;37;172;1;0;176;1;0;0;0;4415006;3411185;3177;0;3583328;1479;1;0;0
FR;3;2021-09-19;29;31;2;0;34;1;0;0;0;4415035;3411216;3179;0;3583362;1480;1;0;0
FR;3;2021-09-20;81;190;0;0;198;1;0;0;0;4415116;3411406;3179;0;3583560;1481;1;0;0
FR;3;2021-09-21;60;272;7;0;276;8;0;0;0;4415176;3411678;3186;0;3583836;1489;1;0;0
FR;3;2021-09-22;66;229;6;0;242;7;0;0;0;4415242;3411907;3192;0;3584078;1496;1;0;0
FR;3;2021-09-23;37;259;11;0;263;7;0;0;0;4415279;3412166;3203;0;3584341;1503;1;0;0
FR;3;2021-09-24;29;320;12;0;318;18;0;0;0;4415308;3412486;3215;0;3584659;1521;1;0;0
FR;3;2021-09-25;31;144;3;0;150;3;0;0;0;4415339;3412630;3218;0;3584809;1524;1;0;0
FR;3;2021-09-26;16;57;1;0;59;1;0;0;0;4415355;3412687;3219;0;3584868;1525;1;0;0
FR;3;2021-09-27;48;283;3;0;286;5;0;0;0;4415403;3412970;3222;0;3585154;1530;1;0;0
FR;3;2021-09-28;49;245;6;0;253;8;0;0;0;4415452;3413215;3228;0;3585407;1538;1;0;0
FR;3;2021-09-29;39;219;10;0;223;15;0;0;0;4415491;3413434;3238;0;3585630;1553;1;0;0
FR;3;2021-09-30;40;200;8;0;204;11;0;0;0;4415531;3413634;3246;0;3585834;1564;1;0;0
FR;3;2021-10-01;23;159;6;0;161;8;0;0;0;4415554;3413793;3252;0;3585995;1572;1;0;0
FR;3;2021-10-02;17;86;0;0;87;0;0;0;0;4415571;3413879;3252;0;3586082;1572;1;0;0
FR;3;2021-10-03;19;19;1;0;19;2;0;0;0;4415590;3413898;3253;0;3586101;1574;1;0;0
FR;3;2021-10-04;33;157;4;0;162;4;0;0;0;4415623;3414055;3257;0;3586263;1578;1;0;0
FR;3;2021-10-05;17;148;10;0;153;12;0;0;0;4415640;3414203;3267;0;3586416;1590;1;0;0
FR;3;2021-10-06;33;143;9;0;151;10;0;0;0;4415673;3414346;3276;0;3586567;1600;1;0;0
FR;3;2021-10-07;20;131;6;0;129;6;0;0;0;4415693;3414477;3282;0;3586696;1606;1;0;0
FR;3;2021-10-08;25;136;10;0;141;9;0;0;0;4415718;3414613;3292;0;3586837;1615;1;0;0
FR;3;2021-10-09;17;72;1;0;73;1;0;0;0;4415735;3414685;3293;0;3586910;1616;1;0;0
FR;3;2021-10-10;13;17;2;0;16;3;0;0;0;4415748;3414702;3295;0;3586926;1619;1;0;0
FR;3;2021-10-11;17;115;4;0;120;5;0;0;0;4415765;3414817;3299;0;3587046;1624;1;0;0
FR;3;2021-10-12;22;99;5;0;99;5;0;0;0;4415787;3414916;3304;0;3587145;1629;1;0;0
FR;3;2021-10-13;25;114;9;0;121;7;0;0;0;4415812;3415030;3313;0;3587266;1636;1;0;0
FR;3;2021-10-14;19;139;3;0;140;4;0;0;0;4415831;3415169;3316;0;3587406;1640;1;0;0
FR;3;2021-10-15;23;141;8;0;140;13;0;0;0;4415854;3415310;3324;0;3587546;1653;1;0;0
FR;3;2021-10-16;13;66;6;0;65;8;0;0;0;4415867;3415376;3330;0;3587611;1661;1;0;0
FR;3;2021-10-17;12;24;0;0;26;0;0;0;0;4415879;3415400;3330;0;3587637;1661;1;0;0
FR;3;2021-10-18;18;112;2;0;117;2;0;0;0;4415897;3415512;3332;0;3587754;1663;1;0;0
FR;3;2021-10-19;18;112;19;0;113;21;0;0;0;4415915;3415624;3351;0;3587867;1684;1;0;0
FR;3;2021-10-20;26;127;6;0;129;7;0;0;0;4415941;3415751;3357;0;3587996;1691;1;0;0
FR;3;2021-10-21;28;120;17;0;120;13;0;0;0;4415969;3415871;3374;0;3588116;1704;1;0;0
FR;3;2021-10-22;24;106;18;0;105;21;0;0;0;4415993;3415977;3392;0;3588221;1725;1;0;0
FR;3;2021-10-23;17;53;3;0;53;2;0;0;0;4416010;3416030;3395;0;3588274;1727;1;0;0
FR;3;2021-10-24;7;36;0;0;34;0;0;0;0;4416017;3416066;3395;0;3588308;1727;1;0;0
FR;3;2021-10-25;26;141;7;0;145;7;0;0;0;4416043;3416207;3402;0;3588453;1734;1;0;0
FR;3;2021-10-26;25;96;22;0;93;19;0;0;0;4416068;3416303;3424;0;3588546;1753;1;0;0
FR;3;2021-10-27;19;92;9;0;94;9;0;0;0;4416087;3416395;3433;0;3588640;1762;1;0;0
FR;3;2021-10-28;23;113;33;0;110;36;0;0;0;4416110;3416508;3466;0;3588750;1798;1;0;0
FR;3;2021-10-29;12;100;64;0;94;54;0;0;0;4416122;3416608;3530;0;3588844;1852;1;0;0
FR;3;2021-10-30;11;62;11;1;62;10;0;0;0;4416133;3416670;3541;1;3588906;1862;1;0;0
FR;3;2021-10-31;8;25;1;0;25;1;0;0;0;4416141;3416695;3542;1;3588931;1863;1;0;0
FR;3;2021-11-01;11;22;2;0;23;1;0;0;0;4416152;3416717;3544;1;3588954;1864;1;0;0
FR;3;2021-11-02;11;101;10;0;101;12;0;0;0;4416163;3416818;3554;1;3589055;1876;1;0;0
FR;3;2021-11-03;20;107;10;0;115;10;0;0;0;4416183;3416925;3564;1;3589170;1886;1;0;0
FR;3;2021-11-04;20;89;5;0;94;4;0;0;0;4416203;3417014;3569;1;3589264;1890;1;0;0
FR;3;2021-11-05;19;119;9;1;125;6;1;0;0;4416222;3417133;3578;2;3589389;1896;2;0;0
FR;3;2021-11-06;11;55;3;0;57;3;0;0;0;4416233;3417188;3581;2;3589446;1899;2;0;0
FR;3;2021-11-07;6;23;1;0;24;1;0;0;0;4416239;3417211;3582;2;3589470;1900;2;0;0
FR;3;2021-11-08;11;128;7;0;133;5;0;0;0;4416250;3417339;3589;2;3589603;1905;2;0;0
FR;3;2021-11-09;15;123;6;0;125;6;0;0;0;4416265;3417462;3595;2;3589728;1911;2;0;0
FR;3;2021-11-10;14;136;14;0;134;15;0;0;0;4416279;3417598;3609;2;3589862;1926;2;0;0
FR;3;2021-11-11;11;49;3;0;51;3;0;0;0;4416290;3417647;3612;2;3589913;1929;2;0;0
FR;3;2021-11-12;15;127;6;0;130;4;0;0;0;4416305;3417774;3618;2;3590043;1933;2;0;0
FR;3;2021-11-13;7;67;9;0;62;10;0;0;0;4416312;3417841;3627;2;3590105;1943;2;0;0
FR;3;2021-11-14;3;24;1;0;24;1;0;0;0;4416315;3417865;3628;2;3590129;1944;2;0;0
FR;3;2021-11-15;6;162;11;0;159;12;0;0;0;4416321;3418027;3639;2;3590288;1956;2;0;0
FR;3;2021-11-16;9;125;11;0;120;10;0;0;0;4416330;3418152;3650;2;3590408;1966;2;0;0
FR;3;2021-11-17;8;134;11;0;135;8;0;0;0;4416338;3418286;3661;2;3590543;1974;2;0;0
FR;3;2021-11-18;16;134;10;0;135;11;0;0;0;4416354;3418420;3671;2;3590678;1985;2;0;0
FR;3;2021-11-19;12;180;23;0;175;28;0;0;0;4416366;3418600;3694;2;3590853;2013;2;0;0
FR;3;2021-11-20;6;100;6;0;101;6;0;0;0;4416372;3418700;3700;2;3590954;2019;2;0;0
FR;3;2021-11-21;3;25;4;0;24;4;0;0;0;4416375;3418725;3704;2;3590978;2023;2;0;0
FR;3;2021-11-22;11;187;11;0;187;11;0;0;0;4416386;3418912;3715;2;3591165;2034;2;0;0
FR;3;2021-11-23;9;184;16;0;182;15;0;0;0;4416395;3419096;3731;2;3591347;2049;2;0;0
FR;3;2021-11-24;11;187;9;0;179;17;0;0;0;4416406;3419283;3740;2;3591526;2066;2;0;0
FR;3;2021-11-25;12;204;11;0;200;11;0;0;0;4416418;3419487;3751;2;3591726;2077;2;0;0
FR;3;2021-11-26;10;256;35;0;255;33;1;0;0;4416428;3419743;3786;2;3591981;2110;3;0;0
FR;3;2021-11-27;8;128;20;0;127;21;0;0;0;4416436;3419871;3806;2;3592108;2131;3;0;0
FR;3;2021-11-28;3;57;7;0;58;7;0;0;0;4416439;3419928;3813;2;3592166;2138;3;0;0
FR;3;2021-11-29;5;221;22;0;216;23;1;0;0;4416444;3420149;3835;2;3592382;2161;4;0;0
FR;3;2021-11-30;8;295;30;0;294;33;0;0;0;4416452;3420444;3865;2;3592676;2194;4;0;0
FR;3;2021-12-01;30;321;38;0;319;40;2;0;0;4416482;3420765;3903;2;3592995;2234;6;0;0
FR;3;2021-12-02;9;348;33;0;344;36;0;0;0;4416491;3421113;3936;2;3593339;2270;6;0;0
FR;3;2021-12-03;6;380;37;0;374;38;0;0;0;4416497;3421493;3973;2;3593713;2308;6;0;0
FR;3;2021-12-04;3;209;26;0;205;28;0;0;0;4416500;3421702;3999;2;3593918;2336;6;0;0
FR;3;2021-12-05;1;61;5;0;61;5;0;0;0;4416501;3421763;4004;2;3593979;2341;6;0;0
FR;3;2021-12-06;7;371;14;0;370;15;0;0;0;4416508;3422134;4018;2;3594349;2356;6;0;0
FR;3;2021-12-07;6;424;20;0;418;24;1;0;0;4416514;3422558;4038;2;3594767;2380;7;0;0
FR;3;2021-12-08;8;385;29;0;377;30;1;0;0;4416522;3422943;4067;2;3595144;2410;8;0;0
FR;3;2021-12-09;3;439;17;0;426;22;1;0;0;4416525;3423382;4084;2;3595570;2432;9;0;0
FR;3;2021-12-10;10;460;29;0;457;25;0;0;0;4416535;3423842;4113;2;3596027;2457;9;0;0
FR;3;2021-12-11;4;303;10;0;300;9;2;0;0;4416539;3424145;4123;2;3596327;2466;11;0;0
FR;3;2021-12-12;1;99;3;0;99;3;0;0;0;4416540;3424244;4126;2;3596426;2469;11;0;0
FR;3;2021-12-13;2;446;19;0;440;21;0;0;0;4416542;3424690;4145;2;3596866;2490;11;0;0
FR;3;2021-12-14;8;559;18;0;547;21;1;0;0;4416550;3425249;4163;2;3597413;2511;12;0;0
FR;3;2021-12-15;10;532;17;0;519;21;0;0;0;4416560;3425781;4180;2;3597932;2532;12;0;0
FR;3;2021-12-16;10;550;19;0;544;18;3;0;0;4416570;3426331;4199;2;3598476;2550;15;0;0
FR;3;2021-12-17;5;615;18;0;611;19;0;0;0;4416575;3426946;4217;2;3599087;2569;15;0;0
FR;3;2021-12-18;5;354;4;0;348;5;1;0;0;4416580;3427300;4221;2;3599435;2574;16;0;0
FR;3;2021-12-19;3;182;2;0;180;2;0;0;0;4416583;3427482;4223;2;3599615;2576;16;0;0
FR;3;2021-12-20;9;586;23;0;580;28;0;0;0;4416592;3428068;4246;2;3600195;2604;16;0;0
FR;3;2021-12-21;5;673;10;0;665;13;2;0;0;4416597;3428741;4256;2;3600860;2617;18;0;0
FR;3;2021-12-22;10;627;9;0;621;10;1;0;0;4416607;3429368;4265;2;3601481;2627;19;0;0
FR;3;2021-12-23;3;556;8;0;554;8;0;0;0;4416610;3429924;4273;2;3602035;2635;19;0;0
FR;3;2021-12-24;2;236;3;0;231;6;0;0;0;4416612;3430160;4276;2;3602266;2641;19;0;0
FR;3;2021-12-25;0;24;0;0;24;0;0;0;0;4416612;3430184;4276;2;3602290;2641;19;0;0
FR;3;2021-12-26;0;88;1;0;88;1;0;0;0;4416612;3430272;4277;2;3602378;2642;19;0;0
FR;3;2021-12-27;7;465;17;0;462;20;1;0;0;4416619;3430737;4294;2;3602840;2662;20;0;0
FR;3;2021-12-28;3;587;6;0;586;5;0;0;0;4416622;3431324;4300;2;3603426;2667;20;0;0
FR;3;2021-12-29;5;498;14;0;493;16;0;0;0;4416627;3431822;4314;2;3603919;2683;20;0;0
FR;3;2021-12-30;3;524;7;0;517;10;2;0;0;4416630;3432346;4321;2;3604436;2693;22;0;0
FR;3;2021-12-31;0;185;5;0;181;7;0;0;0;4416630;3432531;4326;2;3604617;2700;22;0;0
FR;3;2022-01-01;0;26;0;0;24;2;0;0;0;4416630;3432557;4326;2;3604641;2702;22;0;0
FR;3;2022-01-02;0;77;0;0;77;0;0;0;0;4416630;3432634;4326;2;3604718;2702;22;0;0
FR;3;2022-01-03;4;502;17;0;491;21;3;0;0;4416634;3433136;4343;2;3605209;2723;25;0;0
FR;3;2022-01-04;7;548;9;0;547;8;0;0;0;4416641;3433684;4352;2;3605756;2731;25;0;0
FR;3;2022-01-05;5;499;10;0;491;14;1;0;0;4416646;3434183;4362;2;3606247;2745;26;0;0
FR;3;2022-01-06;6;471;9;0;466;10;1;0;0;4416652;3434654;4371;2;3606713;2755;27;0;0
FR;3;2022-01-07;2;496;11;0;490;13;1;0;1;4416654;3435150;4382;2;3607203;2768;28;0;1
FR;3;2022-01-08;6;253;4;0;250;5;0;0;0;4416660;3435403;4386;2;3607453;2773;28;0;1
FR;3;2022-01-09;0;117;0;0;117;0;0;0;0;4416660;3435520;4386;2;3607570;2773;28;0;1
FR;3;2022-01-10;2;433;12;0;431;12;0;0;0;4416662;3435953;4398;2;3608001;2785;28;0;1
FR;3;2022-01-11;3;463;1;0;462;1;0;0;0;4416665;3436416;4399;2;3608463;2786;28;0;1
FR;3;2022-01-12;4;400;9;0;397;10;2;0;0;4416669;3436816;4408;2;3608860;2796;30;0;1
FR;3;2022-01-13;3;392;11;0;390;12;1;0;0;4416672;3437208;4419;2;3609250;2808;31;0;1
FR;3;2022-01-14;4;425;10;0;419;13;1;0;0;4416676;3437633;4429;2;3609669;2821;32;0;1
FR;3;2022-01-15;0;281;2;0;277;3;0;0;0;4416676;3437914;4431;2;3609946;2824;32;0;1
FR;3;2022-01-16;1;108;1;0;106;1;1;0;0;4416677;3438022;4432;2;3610052;2825;33;0;1
FR;3;2022-01-17;2;326;8;0;323;9;1;0;0;4416679;3438348;4440;2;3610375;2834;34;0;1
FR;3;2022-01-18;2;364;1;0;360;2;1;0;0;4416681;3438712;4441;2;3610735;2836;35;0;1
FR;3;2022-01-19;2;326;5;0;320;10;0;0;0;4416683;3439038;4446;2;3611055;2846;35;0;1
FR;3;2022-01-20;1;352;5;0;351;3;2;0;0;4416684;3439390;4451;2;3611406;2849;37;0;1
FR;3;2022-01-21;4;346;5;0;340;7;2;0;0;4416688;3439736;4456;2;3611746;2856;39;0;1
FR;3;2022-01-22;2;223;1;0;219;2;3;0;0;4416690;3439959;4457;2;3611965;2858;42;0;1
FR;3;2022-01-23;0;78;0;0;76;1;1;0;0;4416690;3440037;4457;2;3612041;2859;43;0;1
FR;3;2022-01-24;2;322;1;0;314;6;2;0;0;4416692;3440359;4458;2;3612355;2865;45;0;1
FR;3;2022-01-25;0;175;0;0;172;0;1;0;0;4416692;3440534;4458;2;3612527;2865;46;0;1
FR;3;2022-01-26;0;77;0;0;77;0;0;0;0;4416692;3440611;4458;2;3612604;2865;46;0;1
FR;3;2022-01-27;0;52;0;0;52;0;0;0;0;4416692;3440663;4458;2;3612656;2865;46;0;1
FR;3;2022-01-28;0;116;0;0;115;0;0;0;0;4416692;3440779;4458;2;3612771;2865;46;0;1
FR;3;2022-01-29;0;98;0;0;98;0;0;0;0;4416692;3440877;4458;2;3612869;2865;46;0;1
FR;3;2022-01-30;0;50;0;0;50;0;0;0;0;4416692;3440927;4458;2;3612919;2865;46;0;1
FR;3;2022-01-31;0;91;0;0;91;0;0;0;0;4416692;3441018;4458;2;3613010;2865;46;0;1
FR;3;2022-02-01;0;98;0;0;96;1;0;0;0;4416692;3441116;4458;2;3613106;2866;46;0;1
FR;3;2022-02-02;0;85;0;0;83;0;0;0;0;4416692;3441201;4458;2;3613189;2866;46;0;1
FR;3;2022-02-03;0;94;0;0;92;0;0;0;0;4416692;3441295;4458;2;3613281;2866;46;0;1
FR;3;2022-02-04;0;113;0;0;110;0;1;0;0;4416692;3441408;4458;2;3613391;2866;47;0;1
FR;3;2022-02-05;0;70;0;0;70;0;0;0;0;4416692;3441478;4458;2;3613461;2866;47;0;1
FR;3;2022-02-06;0;10;0;0;10;0;0;0;0;4416692;3441488;4458;2;3613471;2866;47;0;1
FR;3;2022-02-07;0;76;0;0;76;0;0;0;0;4416692;3441564;4458;2;3613547;2866;47;0;1
FR;3;2022-02-08;0;0;0;0;0;0;0;0;0;4416692;3441564;4458;2;3613547;2866;47;0;1
FR;3;2022-02-09;0;0;0;0;0;0;0;0;0;4416692;3441564;4458;2;3613547;2866;47;0;1
FR;3;2022-02-10;0;0;0;0;0;0;0;0;0;4416692;3441564;4458;2;3613547;2866;47;0;1
FR;3;2022-02-11;0;0;0;0;0;0;0;0;0;4416692;3441564;4458;2;3613547;2866;47;0;1
FR;3;2022-02-12;0;0;0;0;0;0;0;0;0;4416692;3441564;4458;2;3613547;2866;47;0;1
FR;3;2022-02-13;0;0;0;0;0;0;0;0;0;4416692;3441564;4458;2;3613547;2866;47;0;1
FR;3;2022-02-14;0;0;0;0;0;0;0;0;0;4416692;3441564;4458;2;3613547;2866;47;0;1
FR;3;2022-02-15;0;0;0;0;0;0;0;0;0;4416692;3441564;4458;2;3613547;2866;47;0;1
FR;3;2022-02-16;0;0;0;0;0;0;0;0;0;4416692;3441564;4458;2;3613547;2866;47;0;1
FR;3;2022-02-17;0;0;0;0;0;0;0;0;0;4416692;3441564;4458;2;3613547;2866;47;0;1
FR;3;2022-02-18;0;0;0;0;0;0;0;0;0;4416692;3441564;4458;2;3613547;2866;47;0;1
FR;3;2022-02-19;0;0;0;0;0;0;0;0;0;4416692;3441564;4458;2;3613547;2866;47;0;1
FR;3;2022-02-20;0;0;0;0;0;0;0;0;0;4416692;3441564;4458;2;3613547;2866;47;0;1
FR;3;2022-02-21;2;0;0;0;0;0;0;0;0;4416694;3441564;4458;2;3613547;2866;47;0;1
FR;3;2022-02-22;0;0;0;0;0;0;0;0;0;4416694;3441564;4458;2;3613547;2866;47;0;1
FR;3;2022-02-23;0;0;0;0;0;0;0;0;0;4416694;3441564;4458;2;3613547;2866;47;0;1
FR;3;2022-02-24;0;0;0;0;0;0;0;0;0;4416694;3441564;4458;2;3613547;2866;47;0;1
FR;3;2022-02-25;0;0;0;0;0;0;0;0;0;4416694;3441564;4458;2;3613547;2866;47;0;1
FR;3;2022-02-26;0;0;0;0;0;0;0;0;0;4416694;3441564;4458;2;3613547;2866;47;0;1
FR;3;2022-02-27;0;0;0;0;0;0;0;0;0;4416694;3441564;4458;2;3613547;2866;47;0;1
FR;3;2022-02-28;1;0;0;0;0;0;0;0;0;4416695;3441564;4458;2;3613547;2866;47;0;1
FR;3;2022-03-01;1;0;0;0;0;0;0;0;0;4416696;3441564;4458;2;3613547;2866;47;0;1
FR;3;2022-03-02;0;0;0;0;0;0;0;0;0;4416696;3441564;4458;2;3613547;2866;47;0;1
FR;3;2022-03-03;0;0;0;0;0;0;0;0;0;4416696;3441564;4458;2;3613547;2866;47;0;1
FR;3;2022-03-04;0;0;0;0;0;0;0;0;0;4416696;3441564;4458;2;3613547;2866;47;0;1
FR;3;2022-03-05;0;0;0;0;0;0;0;0;0;4416696;3441564;4458;2;3613547;2866;47;0;1
FR;3;2022-03-06;1;0;0;0;0;0;0;0;0;4416697;3441564;4458;2;3613547;2866;47;0;1
FR;3;2022-03-07;0;0;0;0;0;0;0;0;0;4416697;3441564;4458;2;3613547;2866;47;0;1
FR;3;2022-03-08;1;0;0;0;0;0;0;0;0;4416698;3441564;4458;2;3613547;2866;47;0;1
FR;3;2022-03-09;0;0;0;0;0;0;0;0;0;4416698;3441564;4458;2;3613547;2866;47;0;1
FR;3;2022-03-10;0;0;0;0;0;0;0;0;0;4416698;3441564;4458;2;3613547;2866;47;0;1
FR;3;2022-03-11;0;0;0;0;0;0;0;0;0;4416698;3441564;4458;2;3613547;2866;47;0;1
FR;3;2022-03-12;0;0;0;0;0;0;0;0;0;4416698;3441564;4458;2;3613547;2866;47;0;1
FR;3;2022-03-13;0;0;0;0;0;0;0;0;0;4416698;3441564;4458;2;3613547;2866;47;0;1
FR;3;2022-03-14;0;0;0;0;0;0;0;0;0;4416698;3441564;4458;2;3613547;2866;47;0;1
FR;3;2022-03-15;0;0;0;0;0;0;0;0;0;4416698;3441564;4458;2;3613547;2866;47;0;1
FR;3;2022-03-16;0;0;0;0;0;0;0;0;0;4416698;3441564;4458;2;3613547;2866;47;0;1
FR;3;2022-03-17;0;0;0;0;0;0;0;0;0;4416698;3441564;4458;2;3613547;2866;47;0;1
FR;3;2022-03-18;0;0;0;0;0;0;0;0;0;4416698;3441564;4458;2;3613547;2866;47;0;1
FR;3;2022-03-19;0;0;0;0;0;0;0;0;0;4416698;3441564;4458;2;3613547;2866;47;0;1
FR;3;2022-03-20;1;0;0;0;0;0;0;0;0;4416699;3441564;4458;2;3613547;2866;47;0;1
FR;3;2022-03-21;0;0;0;0;0;0;0;0;0;4416699;3441564;4458;2;3613547;2866;47;0;1
FR;3;2022-03-22;0;0;0;0;0;0;0;0;0;4416699;3441564;4458;2;3613547;2866;47;0;1
FR;3;2022-03-23;1;0;0;0;0;0;0;0;0;4416700;3441564;4458;2;3613547;2866;47;0;1
FR;3;2022-03-24;0;0;0;0;0;0;0;0;0;4416700;3441564;4458;2;3613547;2866;47;0;1
FR;3;2022-03-25;1;0;0;0;0;0;0;0;0;4416701;3441564;4458;2;3613547;2866;47;0;1
FR;3;2022-03-26;0;0;0;0;0;0;0;0;0;4416701;3441564;4458;2;3613547;2866;47;0;1
FR;3;2022-03-27;0;0;0;0;0;0;0;0;0;4416701;3441564;4458;2;3613547;2866;47;0;1
FR;3;2022-03-28;0;0;0;0;0;0;0;0;0;4416701;3441564;4458;2;3613547;2866;47;0;1
FR;3;2022-03-29;0;0;0;0;0;0;0;0;0;4416701;3441564;4458;2;3613547;2866;47;0;1
FR;3;2022-03-30;0;0;0;0;0;0;0;0;0;4416701;3441564;4458;2;3613547;2866;47;0;1
FR;3;2022-03-31;0;0;0;0;0;0;0;0;0;4416701;3441564;4458;2;3613547;2866;47;0;1
FR;3;2022-04-01;0;0;0;0;0;0;0;0;0;4416701;3441564;4458;2;3613547;2866;47;0;1
FR;3;2022-04-02;0;0;0;0;0;0;0;0;0;4416701;3441564;4458;2;3613547;2866;47;0;1
FR;3;2022-04-03;0;0;0;0;0;0;0;0;0;4416701;3441564;4458;2;3613547;2866;47;0;1
FR;3;2022-04-04;0;0;0;0;0;0;0;0;0;4416701;3441564;4458;2;3613547;2866;47;0;1
FR;3;2022-04-05;0;0;0;0;0;0;0;0;0;4416701;3441564;4458;2;3613547;2866;47;0;1
FR;3;2022-04-06;0;0;0;0;0;0;0;0;0;4416701;3441564;4458;2;3613547;2866;47;0;1
FR;3;2022-04-07;0;0;0;0;0;0;0;0;0;4416701;3441564;4458;2;3613547;2866;47;0;1
FR;3;2022-04-08;0;0;0;0;0;0;0;0;0;4416701;3441564;4458;2;3613547;2866;47;0;1
FR;3;2022-04-09;0;0;0;0;0;0;0;0;0;4416701;3441564;4458;2;3613547;2866;47;0;1
FR;3;2022-04-10;0;0;0;0;0;0;0;0;0;4416701;3441564;4458;2;3613547;2866;47;0;1
FR;3;2022-04-11;0;0;0;0;0;0;0;0;0;4416701;3441564;4458;2;3613547;2866;47;0;1
FR;3;2022-04-12;0;0;0;0;0;0;0;0;0;4416701;3441564;4458;2;3613547;2866;47;0;1
FR;3;2022-04-13;0;0;0;0;0;0;0;0;0;4416701;3441564;4458;2;3613547;2866;47;0;1
FR;3;2022-04-14;0;0;0;0;0;0;0;0;0;4416701;3441564;4458;2;3613547;2866;47;0;1
FR;3;2022-04-15;1;0;0;0;0;0;0;0;0;4416702;3441564;4458;2;3613547;2866;47;0;1
FR;3;2022-04-16;0;0;0;0;0;0;0;0;0;4416702;3441564;4458;2;3613547;2866;47;0;1
FR;3;2022-04-17;0;0;0;0;0;0;0;0;0;4416702;3441564;4458;2;3613547;2866;47;0;1
FR;3;2022-04-18;0;0;0;0;0;0;0;0;0;4416702;3441564;4458;2;3613547;2866;47;0;1
FR;3;2022-04-19;0;0;0;0;0;0;0;0;0;4416702;3441564;4458;2;3613547;2866;47;0;1
FR;3;2022-04-20;0;0;0;0;0;0;0;0;0;4416702;3441564;4458;2;3613547;2866;47;0;1
FR;3;2022-04-21;0;0;0;0;0;0;0;0;0;4416702;3441564;4458;2;3613547;2866;47;0;1
FR;3;2022-04-22;0;0;0;0;0;0;0;0;0;4416702;3441564;4458;2;3613547;2866;47;0;1
FR;3;2022-04-23;0;0;0;0;0;0;0;0;0;4416702;3441564;4458;2;3613547;2866;47;0;1
FR;3;2022-04-24;0;0;0;0;0;0;0;0;0;4416702;3441564;4458;2;3613547;2866;47;0;1
FR;3;2022-04-25;0;0;0;0;0;0;0;0;0;4416702;3441564;4458;2;3613547;2866;47;0;1
FR;3;2022-04-26;0;0;0;0;0;0;0;0;0;4416702;3441564;4458;2;3613547;2866;47;0;1
FR;3;2022-04-27;0;0;0;0;0;0;0;0;0;4416702;3441564;4458;2;3613547;2866;47;0;1
FR;3;2022-04-28;0;0;0;0;0;0;0;0;0;4416702;3441564;4458;2;3613547;2866;47;0;1
FR;3;2022-04-29;0;0;0;0;0;0;0;0;0;4416702;3441564;4458;2;3613547;2866;47;0;1
FR;3;2022-04-30;0;0;0;0;0;0;0;0;0;4416702;3441564;4458;2;3613547;2866;47;0;1
FR;3;2022-05-01;0;0;0;0;0;0;0;0;0;4416702;3441564;4458;2;3613547;2866;47;0;1
FR;3;2022-05-02;0;0;0;0;0;0;0;0;0;4416702;3441564;4458;2;3613547;2866;47;0;1
FR;3;2022-05-03;0;0;0;0;0;0;0;0;0;4416702;3441564;4458;2;3613547;2866;47;0;1
FR;3;2022-05-04;0;0;0;0;0;0;0;0;0;4416702;3441564;4458;2;3613547;2866;47;0;1
FR;3;2022-05-05;0;0;0;0;0;0;0;0;0;4416702;3441564;4458;2;3613547;2866;47;0;1
FR;3;2022-05-06;0;0;0;0;0;0;0;0;0;4416702;3441564;4458;2;3613547;2866;47;0;1
FR;3;2022-05-07;0;0;0;0;0;0;0;0;0;4416702;3441564;4458;2;3613547;2866;47;0;1
FR;3;2022-05-08;0;0;0;0;0;0;0;0;0;4416702;3441564;4458;2;3613547;2866;47;0;1
FR;3;2022-05-09;0;0;0;0;0;0;0;0;0;4416702;3441564;4458;2;3613547;2866;47;0;1
FR;3;2022-05-10;0;0;0;0;0;0;0;0;0;4416702;3441564;4458;2;3613547;2866;47;0;1
FR;3;2022-05-11;0;0;0;0;0;0;0;0;0;4416702;3441564;4458;2;3613547;2866;47;0;1
FR;3;2022-05-12;0;0;0;0;0;0;0;0;0;4416702;3441564;4458;2;3613547;2866;47;0;1
FR;3;2022-05-13;0;0;0;0;0;0;0;0;0;4416702;3441564;4458;2;3613547;2866;47;0;1
FR;3;2022-05-14;1;0;0;0;0;0;0;0;0;4416703;3441564;4458;2;3613547;2866;47;0;1
FR;3;2022-05-15;0;0;0;0;0;0;0;0;0;4416703;3441564;4458;2;3613547;2866;47;0;1
FR;3;2022-05-16;0;0;0;0;0;0;0;0;0;4416703;3441564;4458;2;3613547;2866;47;0;1
FR;3;2022-05-17;0;0;0;0;0;0;0;0;0;4416703;3441564;4458;2;3613547;2866;47;0;1
FR;3;2022-05-18;0;0;0;0;0;0;0;0;0;4416703;3441564;4458;2;3613547;2866;47;0;1
FR;3;2022-05-19;0;0;0;0;0;0;0;0;0;4416703;3441564;4458;2;3613547;2866;47;0;1
FR;3;2022-05-20;0;0;0;0;0;0;0;0;0;4416703;3441564;4458;2;3613547;2866;47;0;1
FR;3;2022-05-21;0;0;0;0;0;0;0;0;0;4416703;3441564;4458;2;3613547;2866;47;0;1
FR;3;2022-05-22;0;0;0;0;0;0;0;0;0;4416703;3441564;4458;2;3613547;2866;47;0;1
FR;3;2022-05-23;0;0;0;0;0;0;0;0;0;4416703;3441564;4458;2;3613547;2866;47;0;1
FR;3;2022-05-24;0;0;0;0;0;0;0;0;0;4416703;3441564;4458;2;3613547;2866;47;0;1
FR;3;2022-05-25;0;0;0;0;0;0;0;0;0;4416703;3441564;4458;2;3613547;2866;47;0;1
FR;3;2022-05-26;0;0;0;0;0;0;0;0;0;4416703;3441564;4458;2;3613547;2866;47;0;1
FR;3;2022-05-27;0;0;0;0;0;0;0;0;0;4416703;3441564;4458;2;3613547;2866;47;0;1
FR;3;2022-05-28;0;0;0;0;0;0;0;0;0;4416703;3441564;4458;2;3613547;2866;47;0;1
FR;3;2022-05-29;0;0;0;0;0;0;0;0;0;4416703;3441564;4458;2;3613547;2866;47;0;1
FR;3;2022-05-30;0;0;0;0;0;0;0;0;0;4416703;3441564;4458;2;3613547;2866;47;0;1
FR;3;2022-05-31;0;0;0;0;0;0;0;0;0;4416703;3441564;4458;2;3613547;2866;47;0;1
FR;3;2022-06-01;0;0;0;0;0;0;0;0;0;4416703;3441564;4458;2;3613547;2866;47;0;1
FR;3;2022-06-02;0;0;0;0;0;0;0;0;0;4416703;3441564;4458;2;3613547;2866;47;0;1
FR;3;2022-06-03;0;0;0;0;0;0;0;0;0;4416703;3441564;4458;2;3613547;2866;47;0;1
FR;3;2022-06-04;0;0;0;0;0;0;0;0;0;4416703;3441564;4458;2;3613547;2866;47;0;1
FR;3;2022-06-05;0;0;0;0;0;0;0;0;0;4416703;3441564;4458;2;3613547;2866;47;0;1
FR;3;2022-06-06;0;0;0;0;0;0;0;0;0;4416703;3441564;4458;2;3613547;2866;47;0;1
FR;3;2022-06-07;0;0;0;0;0;0;0;0;0;4416703;3441564;4458;2;3613547;2866;47;0;1
FR;3;2022-06-08;0;0;0;0;0;0;0;0;0;4416703;3441564;4458;2;3613547;2866;47;0;1
FR;3;2022-06-09;0;0;0;0;0;0;0;0;0;4416703;3441564;4458;2;3613547;2866;47;0;1
FR;3;2022-06-10;0;0;0;0;0;0;0;0;0;4416703;3441564;4458;2;3613547;2866;47;0;1
FR;3;2022-06-11;0;0;0;0;0;0;0;0;0;4416703;3441564;4458;2;3613547;2866;47;0;1
FR;3;2022-06-12;0;0;0;0;0;0;0;0;0;4416703;3441564;4458;2;3613547;2866;47;0;1
FR;3;2022-06-13;1;0;0;0;0;0;0;0;0;4416704;3441564;4458;2;3613547;2866;47;0;1
FR;3;2022-06-14;0;0;0;0;0;0;0;0;0;4416704;3441564;4458;2;3613547;2866;47;0;1
FR;3;2022-06-15;0;0;0;0;0;0;0;0;0;4416704;3441564;4458;2;3613547;2866;47;0;1
FR;3;2022-06-16;0;0;0;0;0;0;0;0;0;4416704;3441564;4458;2;3613547;2866;47;0;1
FR;3;2022-06-17;0;0;0;0;0;0;0;0;0;4416704;3441564;4458;2;3613547;2866;47;0;1
FR;3;2022-06-18;0;0;0;0;0;0;0;0;0;4416704;3441564;4458;2;3613547;2866;47;0;1
FR;3;2022-06-19;0;0;0;0;0;0;0;0;0;4416704;3441564;4458;2;3613547;2866;47;0;1
FR;3;2022-06-20;0;0;0;0;0;0;0;0;0;4416704;3441564;4458;2;3613547;2866;47;0;1
FR;3;2022-06-21;0;0;0;0;0;0;0;0;0;4416704;3441564;4458;2;3613547;2866;47;0;1
FR;3;2022-06-22;0;0;0;0;0;0;0;0;0;4416704;3441564;4458;2;3613547;2866;47;0;1
FR;3;2022-06-23;0;0;0;0;0;0;0;0;0;4416704;3441564;4458;2;3613547;2866;47;0;1
FR;3;2022-06-24;0;0;0;0;0;0;0;0;0;4416704;3441564;4458;2;3613547;2866;47;0;1
FR;3;2022-06-25;0;0;0;0;0;0;0;0;0;4416704;3441564;4458;2;3613547;2866;47;0;1
FR;3;2022-06-26;0;0;0;0;0;0;0;0;0;4416704;3441564;4458;2;3613547;2866;47;0;1
FR;3;2022-06-27;0;0;0;0;0;0;0;0;0;4416704;3441564;4458;2;3613547;2866;47;0;1
FR;3;2022-06-28;0;0;0;0;0;0;0;0;0;4416704;3441564;4458;2;3613547;2866;47;0;1
FR;3;2022-06-29;1;0;0;0;0;0;0;0;0;4416705;3441564;4458;2;3613547;2866;47;0;1
FR;3;2022-06-30;0;0;0;0;0;0;0;0;0;4416705;3441564;4458;2;3613547;2866;47;0;1
FR;3;2022-07-01;0;0;0;0;0;0;0;0;0;4416705;3441564;4458;2;3613547;2866;47;0;1
FR;3;2022-07-02;0;0;0;0;0;0;0;0;0;4416705;3441564;4458;2;3613547;2866;47;0;1
FR;3;2022-07-03;0;0;0;0;0;0;0;0;0;4416705;3441564;4458;2;3613547;2866;47;0;1
FR;3;2022-07-04;0;0;0;0;0;0;0;0;0;4416705;3441564;4458;2;3613547;2866;47;0;1
FR;3;2022-07-05;0;0;0;0;0;0;0;0;0;4416705;3441564;4458;2;3613547;2866;47;0;1
FR;3;2022-07-06;0;0;0;0;0;0;0;0;0;4416705;3441564;4458;2;3613547;2866;47;0;1
FR;3;2022-07-07;0;0;0;0;0;0;0;0;0;4416705;3441564;4458;2;3613547;2866;47;0;1
FR;3;2022-07-08;0;0;0;0;0;0;0;0;0;4416705;3441564;4458;2;3613547;2866;47;0;1
FR;3;2022-07-09;0;0;0;0;0;0;0;0;0;4416705;3441564;4458;2;3613547;2866;47;0;1
FR;3;2022-07-10;0;0;0;0;0;0;0;0;0;4416705;3441564;4458;2;3613547;2866;47;0;1
FR;3;2022-07-11;0;0;0;0;0;0;0;0;0;4416705;3441564;4458;2;3613547;2866;47;0;1
FR;3;2022-07-12;0;0;0;0;0;0;0;0;0;4416705;3441564;4458;2;3613547;2866;47;0;1
FR;3;2022-07-13;0;0;0;0;0;0;0;0;0;4416705;3441564;4458;2;3613547;2866;47;0;1
FR;3;2022-07-14;0;0;0;0;0;0;0;0;0;4416705;3441564;4458;2;3613547;2866;47;0;1
FR;3;2022-07-15;0;0;0;0;0;0;0;0;0;4416705;3441564;4458;2;3613547;2866;47;0;1
FR;3;2022-07-16;0;0;0;0;0;0;0;0;0;4416705;3441564;4458;2;3613547;2866;47;0;1
FR;3;2022-07-17;0;0;0;0;0;0;0;0;0;4416705;3441564;4458;2;3613547;2866;47;0;1
FR;3;2022-07-18;0;0;0;0;0;0;0;0;0;4416705;3441564;4458;2;3613547;2866;47;0;1
FR;3;2022-07-19;0;0;0;0;0;0;0;0;0;4416705;3441564;4458;2;3613547;2866;47;0;1
FR;3;2022-07-20;0;0;0;0;0;0;0;0;0;4416705;3441564;4458;2;3613547;2866;47;0;1
FR;3;2022-07-21;0;0;0;0;0;0;0;0;0;4416705;3441564;4458;2;3613547;2866;47;0;1
FR;3;2022-07-22;0;0;0;0;0;0;0;0;0;4416705;3441564;4458;2;3613547;2866;47;0;1
FR;3;2022-07-23;0;0;0;0;0;0;0;0;0;4416705;3441564;4458;2;3613547;2866;47;0;1
FR;3;2022-07-24;0;0;0;0;0;0;0;0;0;4416705;3441564;4458;2;3613547;2866;47;0;1
FR;3;2022-07-25;0;0;0;0;0;0;0;0;0;4416705;3441564;4458;2;3613547;2866;47;0;1
FR;3;2022-07-26;0;0;0;0;0;0;0;0;0;4416705;3441564;4458;2;3613547;2866;47;0;1
FR;3;2022-07-27;0;0;0;0;0;0;0;0;0;4416705;3441564;4458;2;3613547;2866;47;0;1
FR;3;2022-07-28;0;0;0;0;0;0;0;0;0;4416705;3441564;4458;2;3613547;2866;47;0;1
FR;3;2022-07-29;0;0;0;0;0;0;0;0;0;4416705;3441564;4458;2;3613547;2866;47;0;1
FR;3;2022-07-30;0;0;0;0;0;0;0;0;0;4416705;3441564;4458;2;3613547;2866;47;0;1
FR;3;2022-07-31;0;0;0;0;0;0;0;0;0;4416705;3441564;4458;2;3613547;2866;47;0;1
FR;3;2022-08-01;0;0;0;0;0;0;0;0;0;4416705;3441564;4458;2;3613547;2866;47;0;1
FR;3;2022-08-02;0;0;0;0;0;0;0;0;0;4416705;3441564;4458;2;3613547;2866;47;0;1
FR;3;2022-08-03;0;0;0;0;0;0;0;0;0;4416705;3441564;4458;2;3613547;2866;47;0;1
FR;3;2022-08-04;0;0;0;0;0;0;0;0;0;4416705;3441564;4458;2;3613547;2866;47;0;1
FR;3;2022-08-05;0;0;0;0;0;0;0;0;0;4416705;3441564;4458;2;3613547;2866;47;0;1
FR;3;2022-08-06;0;0;0;0;0;0;0;0;0;4416705;3441564;4458;2;3613547;2866;47;0;1
FR;3;2022-08-07;0;0;0;0;0;0;0;0;0;4416705;3441564;4458;2;3613547;2866;47;0;1
FR;3;2022-08-08;0;0;0;0;0;0;0;0;0;4416705;3441564;4458;2;3613547;2866;47;0;1
FR;3;2022-08-09;0;0;0;0;0;0;0;0;0;4416705;3441564;4458;2;3613547;2866;47;0;1
FR;3;2022-08-10;0;0;0;0;0;0;0;0;0;4416705;3441564;4458;2;3613547;2866;47;0;1
FR;3;2022-08-11;0;0;0;0;0;0;0;0;0;4416705;3441564;4458;2;3613547;2866;47;0;1
FR;3;2022-08-12;0;0;0;0;0;0;0;0;0;4416705;3441564;4458;2;3613547;2866;47;0;1
FR;3;2022-08-13;0;0;0;0;0;0;0;0;0;4416705;3441564;4458;2;3613547;2866;47;0;1
FR;3;2022-08-14;0;0;0;0;0;0;0;0;0;4416705;3441564;4458;2;3613547;2866;47;0;1
FR;3;2022-08-15;0;0;0;0;0;0;0;0;0;4416705;3441564;4458;2;3613547;2866;47;0;1
FR;3;2022-08-16;0;0;0;0;0;0;0;0;0;4416705;3441564;4458;2;3613547;2866;47;0;1
FR;3;2022-08-17;0;0;0;0;0;0;0;0;0;4416705;3441564;4458;2;3613547;2866;47;0;1
FR;3;2022-08-18;0;0;0;0;0;0;0;0;0;4416705;3441564;4458;2;3613547;2866;47;0;1
FR;3;2022-08-19;0;0;0;0;0;0;0;0;0;4416705;3441564;4458;2;3613547;2866;47;0;1
FR;3;2022-08-20;0;0;0;0;0;0;0;0;0;4416705;3441564;4458;2;3613547;2866;47;0;1
FR;3;2022-08-21;0;0;0;0;0;0;0;0;0;4416705;3441564;4458;2;3613547;2866;47;0;1
FR;3;2022-08-22;0;0;0;0;0;0;0;0;0;4416705;3441564;4458;2;3613547;2866;47;0;1
FR;3;2022-08-23;0;0;0;0;0;0;0;0;0;4416705;3441564;4458;2;3613547;2866;47;0;1
FR;3;2022-08-24;0;0;0;0;0;0;0;0;0;4416705;3441564;4458;2;3613547;2866;47;0;1
FR;3;2022-08-25;0;0;0;0;0;0;0;0;0;4416705;3441564;4458;2;3613547;2866;47;0;1
FR;3;2022-08-26;0;0;0;0;0;0;0;0;0;4416705;3441564;4458;2;3613547;2866;47;0;1
FR;3;2022-08-27;0;0;0;0;0;0;0;0;0;4416705;3441564;4458;2;3613547;2866;47;0;1
FR;3;2022-08-28;0;0;0;0;0;0;0;0;0;4416705;3441564;4458;2;3613547;2866;47;0;1
FR;3;2022-08-29;0;0;0;0;0;0;0;0;0;4416705;3441564;4458;2;3613547;2866;47;0;1
FR;3;2022-08-30;0;0;0;0;0;0;0;0;0;4416705;3441564;4458;2;3613547;2866;47;0;1
FR;3;2022-08-31;0;0;0;0;0;0;0;0;0;4416705;3441564;4458;2;3613547;2866;47;0;1
FR;3;2022-09-01;0;0;0;0;0;0;0;0;0;4416705;3441564;4458;2;3613547;2866;47;0;1
FR;3;2022-09-02;0;0;0;0;0;0;0;0;0;4416705;3441564;4458;2;3613547;2866;47;0;1
FR;3;2022-09-03;0;0;0;0;0;0;0;0;0;4416705;3441564;4458;2;3613547;2866;47;0;1
FR;3;2022-09-04;0;0;0;0;0;0;0;0;0;4416705;3441564;4458;2;3613547;2866;47;0;1
FR;3;2022-09-05;0;0;0;0;0;0;0;0;0;4416705;3441564;4458;2;3613547;2866;47;0;1
FR;3;2022-09-06;0;0;0;0;0;0;0;0;0;4416705;3441564;4458;2;3613547;2866;47;0;1
FR;3;2022-09-07;0;0;0;0;0;0;0;0;0;4416705;3441564;4458;2;3613547;2866;47;0;1
FR;3;2022-09-08;0;0;0;0;0;0;0;0;0;4416705;3441564;4458;2;3613547;2866;47;0;1
FR;3;2022-09-09;0;0;0;0;0;0;0;0;0;4416705;3441564;4458;2;3613547;2866;47;0;1
FR;3;2022-09-10;0;0;0;0;0;0;0;0;0;4416705;3441564;4458;2;3613547;2866;47;0;1
FR;3;2022-09-11;0;0;0;0;0;0;0;0;0;4416705;3441564;4458;2;3613547;2866;47;0;1
FR;3;2022-09-12;0;0;0;0;0;0;0;0;0;4416705;3441564;4458;2;3613547;2866;47;0;1
FR;3;2022-09-13;0;0;0;0;0;0;0;0;0;4416705;3441564;4458;2;3613547;2866;47;0;1
FR;3;2022-09-14;0;0;0;0;0;0;0;0;0;4416705;3441564;4458;2;3613547;2866;47;0;1
FR;3;2022-09-15;0;0;0;0;0;0;0;0;0;4416705;3441564;4458;2;3613547;2866;47;0;1
FR;3;2022-09-16;0;0;0;0;0;0;0;0;0;4416705;3441564;4458;2;3613547;2866;47;0;1
FR;3;2022-09-17;0;0;0;0;0;0;0;0;0;4416705;3441564;4458;2;3613547;2866;47;0;1
FR;3;2022-09-18;0;0;0;0;0;0;0;0;0;4416705;3441564;4458;2;3613547;2866;47;0;1
FR;3;2022-09-19;0;0;0;0;0;0;0;0;0;4416705;3441564;4458;2;3613547;2866;47;0;1
FR;3;2022-09-20;0;0;0;0;0;0;0;0;0;4416705;3441564;4458;2;3613547;2866;47;0;1
FR;3;2022-09-21;0;0;0;0;0;0;0;0;0;4416705;3441564;4458;2;3613547;2866;47;0;1
FR;3;2022-09-22;0;0;0;0;0;0;0;0;0;4416705;3441564;4458;2;3613547;2866;47;0;1
FR;3;2022-09-23;0;0;0;0;0;0;0;0;0;4416705;3441564;4458;2;3613547;2866;47;0;1
FR;3;2022-09-24;0;0;0;0;0;0;0;0;0;4416705;3441564;4458;2;3613547;2866;47;0;1
FR;3;2022-09-25;0;0;0;0;0;0;0;0;0;4416705;3441564;4458;2;3613547;2866;47;0;1
FR;3;2022-09-26;0;0;0;0;0;0;0;0;0;4416705;3441564;4458;2;3613547;2866;47;0;1
FR;3;2022-09-27;0;0;0;0;0;0;0;0;0;4416705;3441564;4458;2;3613547;2866;47;0;1
FR;3;2022-09-28;0;0;0;0;0;0;0;0;0;4416705;3441564;4458;2;3613547;2866;47;0;1
FR;3;2022-09-29;0;0;0;0;0;0;0;0;0;4416705;3441564;4458;2;3613547;2866;47;0;1
FR;3;2022-09-30;0;0;0;0;0;0;0;0;0;4416705;3441564;4458;2;3613547;2866;47;0;1
FR;3;2022-10-01;0;0;0;0;0;0;0;0;0;4416705;3441564;4458;2;3613547;2866;47;0;1
FR;3;2022-10-02;0;0;0;0;0;0;0;0;0;4416705;3441564;4458;2;3613547;2866;47;0;1
FR;3;2022-10-03;0;0;0;0;0;0;0;0;0;4416705;3441564;4458;2;3613547;2866;47;0;1
FR;3;2022-10-04;0;0;0;0;0;0;0;0;0;4416705;3441564;4458;2;3613547;2866;47;0;1
FR;3;2022-10-05;0;0;0;0;0;0;0;0;0;4416705;3441564;4458;2;3613547;2866;47;0;1
FR;3;2022-10-06;0;0;0;0;0;0;0;0;0;4416705;3441564;4458;2;3613547;2866;47;0;1
FR;3;2022-10-07;0;0;0;0;0;0;0;0;0;4416705;3441564;4458;2;3613547;2866;47;0;1
FR;3;2022-10-08;0;0;0;0;0;0;0;0;0;4416705;3441564;4458;2;3613547;2866;47;0;1
FR;3;2022-10-09;0;0;0;0;0;0;0;0;0;4416705;3441564;4458;2;3613547;2866;47;0;1
FR;3;2022-10-10;0;0;0;0;0;0;0;0;0;4416705;3441564;4458;2;3613547;2866;47;0;1
FR;3;2022-10-11;0;0;0;0;0;0;0;0;0;4416705;3441564;4458;2;3613547;2866;47;0;1
FR;3;2022-10-12;0;0;0;0;0;0;0;0;0;4416705;3441564;4458;2;3613547;2866;47;0;1
FR;3;2022-10-13;0;0;0;0;0;0;0;0;0;4416705;3441564;4458;2;3613547;2866;47;0;1
FR;3;2022-10-14;0;0;0;0;0;0;0;0;0;4416705;3441564;4458;2;3613547;2866;47;0;1
FR;3;2022-10-15;0;0;0;0;0;0;0;0;0;4416705;3441564;4458;2;3613547;2866;47;0;1
FR;3;2022-10-16;0;0;0;0;0;0;0;0;0;4416705;3441564;4458;2;3613547;2866;47;0;1
FR;3;2022-10-17;0;0;0;0;0;0;0;0;0;4416705;3441564;4458;2;3613547;2866;47;0;1
FR;3;2022-10-18;0;0;0;0;0;0;0;0;0;4416705;3441564;4458;2;3613547;2866;47;0;1
FR;3;2022-10-19;0;0;0;0;0;0;0;0;0;4416705;3441564;4458;2;3613547;2866;47;0;1
FR;3;2022-10-20;0;0;0;0;0;0;0;0;0;4416705;3441564;4458;2;3613547;2866;47;0;1
FR;3;2022-10-21;0;0;0;0;0;0;0;0;0;4416705;3441564;4458;2;3613547;2866;47;0;1
FR;3;2022-10-22;0;0;0;0;0;0;0;0;0;4416705;3441564;4458;2;3613547;2866;47;0;1
FR;3;2022-10-23;0;0;0;0;0;0;0;0;0;4416705;3441564;4458;2;3613547;2866;47;0;1
FR;3;2022-10-24;0;0;0;0;0;0;0;0;0;4416705;3441564;4458;2;3613547;2866;47;0;1
FR;3;2022-10-25;0;0;0;0;0;0;0;0;0;4416705;3441564;4458;2;3613547;2866;47;0;1
FR;3;2022-10-26;0;0;0;0;0;0;0;0;0;4416705;3441564;4458;2;3613547;2866;47;0;1
FR;3;2022-10-27;0;0;0;0;0;0;0;0;0;4416705;3441564;4458;2;3613547;2866;47;0;1
FR;3;2022-10-28;0;0;0;0;0;0;0;0;0;4416705;3441564;4458;2;3613547;2866;47;0;1
FR;3;2022-10-29;0;0;0;0;0;0;0;0;0;4416705;3441564;4458;2;3613547;2866;47;0;1
FR;3;2022-10-30;0;0;0;0;0;0;0;0;0;4416705;3441564;4458;2;3613547;2866;47;0;1
FR;3;2022-10-31;0;0;0;0;0;0;0;0;0;4416705;3441564;4458;2;3613547;2866;47;0;1
FR;3;2022-11-01;0;0;0;0;0;0;0;0;0;4416705;3441564;4458;2;3613547;2866;47;0;1
FR;3;2022-11-02;0;0;0;0;0;0;0;0;0;4416705;3441564;4458;2;3613547;2866;47;0;1
FR;3;2022-11-03;0;0;0;0;0;0;0;0;0;4416705;3441564;4458;2;3613547;2866;47;0;1
FR;3;2022-11-04;0;0;0;0;0;0;0;0;0;4416705;3441564;4458;2;3613547;2866;47;0;1
FR;3;2022-11-05;0;0;0;0;0;0;0;0;0;4416705;3441564;4458;2;3613547;2866;47;0;1
FR;3;2022-11-06;0;0;0;0;0;0;0;0;0;4416705;3441564;4458;2;3613547;2866;47;0;1
FR;3;2022-11-07;0;0;0;0;0;0;0;0;0;4416705;3441564;4458;2;3613547;2866;47;0;1
FR;3;2022-11-08;1;0;0;0;0;0;0;0;0;4416706;3441564;4458;2;3613547;2866;47;0;1
FR;3;2022-11-09;0;0;0;0;0;0;0;0;0;4416706;3441564;4458;2;3613547;2866;47;0;1
FR;3;2022-11-10;0;0;0;0;0;0;0;0;0;4416706;3441564;4458;2;3613547;2866;47;0;1
FR;3;2022-11-11;0;0;0;0;0;0;0;0;0;4416706;3441564;4458;2;3613547;2866;47;0;1
FR;3;2022-11-12;0;0;0;0;0;0;0;0;0;4416706;3441564;4458;2;3613547;2866;47;0;1
FR;3;2022-11-13;0;0;0;0;0;0;0;0;0;4416706;3441564;4458;2;3613547;2866;47;0;1
FR;3;2022-11-14;0;0;0;0;0;0;0;0;0;4416706;3441564;4458;2;3613547;2866;47;0;1
FR;3;2022-11-15;0;0;0;0;0;0;0;0;0;4416706;3441564;4458;2;3613547;2866;47;0;1
FR;3;2022-11-16;0;0;0;0;0;0;0;0;0;4416706;3441564;4458;2;3613547;2866;47;0;1
FR;3;2022-11-17;0;0;0;0;0;0;0;0;0;4416706;3441564;4458;2;3613547;2866;47;0;1
FR;3;2022-11-18;0;0;0;0;0;0;0;0;0;4416706;3441564;4458;2;3613547;2866;47;0;1
FR;3;2022-11-19;0;0;0;0;0;0;0;0;0;4416706;3441564;4458;2;3613547;2866;47;0;1
FR;3;2022-11-20;0;0;0;0;0;0;0;0;0;4416706;3441564;4458;2;3613547;2866;47;0;1
FR;3;2022-11-21;0;0;0;0;0;0;0;0;0;4416706;3441564;4458;2;3613547;2866;47;0;1
FR;3;2022-11-22;0;0;0;0;0;0;0;0;0;4416706;3441564;4458;2;3613547;2866;47;0;1
FR;3;2022-11-23;0;0;0;0;0;0;0;0;0;4416706;3441564;4458;2;3613547;2866;47;0;1
FR;3;2022-11-24;0;0;0;0;0;0;0;0;0;4416706;3441564;4458;2;3613547;2866;47;0;1
FR;3;2022-11-25;0;0;0;0;0;0;0;0;0;4416706;3441564;4458;2;3613547;2866;47;0;1
FR;3;2022-11-26;0;0;0;0;0;0;0;0;0;4416706;3441564;4458;2;3613547;2866;47;0;1
FR;3;2022-11-27;0;0;0;0;0;0;0;0;0;4416706;3441564;4458;2;3613547;2866;47;0;1
FR;3;2022-11-28;0;0;0;0;0;0;0;0;0;4416706;3441564;4458;2;3613547;2866;47;0;1
FR;3;2022-11-29;0;0;0;0;0;0;0;0;0;4416706;3441564;4458;2;3613547;2866;47;0;1
FR;3;2022-11-30;0;0;0;0;0;0;0;0;0;4416706;3441564;4458;2;3613547;2866;47;0;1
FR;3;2022-12-01;0;0;0;0;0;0;0;0;0;4416706;3441564;4458;2;3613547;2866;47;0;1
FR;3;2022-12-02;0;0;0;0;0;0;0;0;0;4416706;3441564;4458;2;3613547;2866;47;0;1
FR;3;2022-12-03;0;0;0;0;0;0;0;0;0;4416706;3441564;4458;2;3613547;2866;47;0;1
FR;3;2022-12-04;0;0;0;0;0;0;0;0;0;4416706;3441564;4458;2;3613547;2866;47;0;1
FR;3;2022-12-05;0;0;0;0;0;0;0;0;0;4416706;3441564;4458;2;3613547;2866;47;0;1
FR;3;2022-12-06;0;0;0;0;0;0;0;0;0;4416706;3441564;4458;2;3613547;2866;47;0;1
FR;3;2022-12-07;0;0;0;0;0;0;0;0;0;4416706;3441564;4458;2;3613547;2866;47;0;1
FR;3;2022-12-08;0;0;0;0;0;0;0;0;0;4416706;3441564;4458;2;3613547;2866;47;0;1
FR;3;2022-12-09;0;0;0;0;0;0;0;0;0;4416706;3441564;4458;2;3613547;2866;47;0;1
FR;3;2022-12-10;0;0;0;0;0;0;0;0;0;4416706;3441564;4458;2;3613547;2866;47;0;1
FR;3;2022-12-11;0;0;0;0;0;0;0;0;0;4416706;3441564;4458;2;3613547;2866;47;0;1
FR;3;2022-12-12;0;0;0;0;0;0;0;0;0;4416706;3441564;4458;2;3613547;2866;47;0;1
FR;3;2022-12-13;0;0;0;0;0;0;0;0;0;4416706;3441564;4458;2;3613547;2866;47;0;1
FR;3;2022-12-14;0;0;0;0;0;0;0;0;0;4416706;3441564;4458;2;3613547;2866;47;0;1
FR;3;2022-12-15;0;0;0;0;0;0;0;0;0;4416706;3441564;4458;2;3613547;2866;47;0;1
FR;3;2022-12-16;0;0;0;0;0;0;0;0;0;4416706;3441564;4458;2;3613547;2866;47;0;1
FR;3;2022-12-17;0;0;0;0;0;0;0;0;0;4416706;3441564;4458;2;3613547;2866;47;0;1
FR;3;2022-12-18;0;0;0;0;0;0;0;0;0;4416706;3441564;4458;2;3613547;2866;47;0;1
FR;3;2022-12-19;0;0;0;0;0;0;0;0;0;4416706;3441564;4458;2;3613547;2866;47;0;1
FR;3;2022-12-20;0;0;0;0;0;0;0;0;0;4416706;3441564;4458;2;3613547;2866;47;0;1
FR;3;2022-12-21;0;0;0;0;0;0;0;0;0;4416706;3441564;4458;2;3613547;2866;47;0;1
FR;3;2022-12-22;0;0;0;0;0;0;0;0;0;4416706;3441564;4458;2;3613547;2866;47;0;1
FR;3;2022-12-23;0;0;0;0;0;0;0;0;0;4416706;3441564;4458;2;3613547;2866;47;0;1
FR;3;2022-12-24;0;0;0;0;0;0;0;0;0;4416706;3441564;4458;2;3613547;2866;47;0;1
FR;3;2022-12-25;0;0;0;0;0;0;0;0;0;4416706;3441564;4458;2;3613547;2866;47;0;1
FR;3;2022-12-26;0;0;0;0;0;0;0;0;0;4416706;3441564;4458;2;3613547;2866;47;0;1
FR;3;2022-12-27;0;0;0;0;0;0;0;0;0;4416706;3441564;4458;2;3613547;2866;47;0;1
FR;3;2022-12-28;0;0;0;0;0;0;0;0;0;4416706;3441564;4458;2;3613547;2866;47;0;1
FR;3;2022-12-29;0;0;0;0;0;0;0;0;0;4416706;3441564;4458;2;3613547;2866;47;0;1
FR;3;2022-12-30;0;0;0;0;0;0;0;0;0;4416706;3441564;4458;2;3613547;2866;47;0;1
FR;3;2022-12-31;0;0;0;0;0;0;0;0;0;4416706;3441564;4458;2;3613547;2866;47;0;1
FR;3;2023-01-01;0;0;0;0;0;0;0;0;0;4416706;3441564;4458;2;3613547;2866;47;0;1
FR;3;2023-01-02;0;0;0;0;0;0;0;0;0;4416706;3441564;4458;2;3613547;2866;47;0;1
FR;4;2020-12-27;0;0;0;0;0;0;0;0;0;0;0;0;0;0;0;0;0;0
FR;4;2020-12-28;0;0;0;0;0;0;0;0;0;0;0;0;0;0;0;0;0;0
FR;4;2020-12-29;0;0;0;0;0;0;0;0;0;0;0;0;0;0;0;0;0;0
FR;4;2020-12-30;0;0;0;0;0;0;0;0;0;0;0;0;0;0;0;0;0;0
FR;4;2020-12-31;0;0;0;0;0;0;0;0;0;0;0;0;0;0;0;0;0;0
FR;4;2021-01-01;0;0;0;0;0;0;0;0;0;0;0;0;0;0;0;0;0;0
FR;4;2021-01-02;0;0;0;0;0;0;0;0;0;0;0;0;0;0;0;0;0;0
FR;4;2021-01-03;0;0;0;0;0;0;0;0;0;0;0;0;0;0;0;0;0;0
FR;4;2021-01-04;0;0;0;0;0;0;0;0;0;0;0;0;0;0;0;0;0;0
FR;4;2021-01-05;0;0;0;0;0;0;0;0;0;0;0;0;0;0;0;0;0;0
FR;4;2021-01-06;0;0;0;0;0;0;0;0;0;0;0;0;0;0;0;0;0;0
FR;4;2021-01-07;0;0;0;0;0;0;0;0;0;0;0;0;0;0;0;0;0;0
FR;4;2021-01-08;0;0;0;0;0;0;0;0;0;0;0;0;0;0;0;0;0;0
FR;4;2021-01-09;0;0;0;0;0;0;0;0;0;0;0;0;0;0;0;0;0;0
FR;4;2021-01-10;0;0;0;0;0;0;0;0;0;0;0;0;0;0;0;0;0;0
FR;4;2021-01-11;0;0;0;0;0;0;0;0;0;0;0;0;0;0;0;0;0;0
FR;4;2021-01-12;0;0;0;0;0;0;0;0;0;0;0;0;0;0;0;0;0;0
FR;4;2021-01-13;0;0;0;0;0;0;0;0;0;0;0;0;0;0;0;0;0;0
FR;4;2021-01-14;0;0;0;0;0;0;0;0;0;0;0;0;0;0;0;0;0;0
FR;4;2021-01-15;0;0;0;0;0;0;0;0;0;0;0;0;0;0;0;0;0;0
FR;4;2021-01-16;0;0;0;0;0;0;0;0;0;0;0;0;0;0;0;0;0;0
FR;4;2021-01-17;0;0;0;0;0;0;0;0;0;0;0;0;0;0;0;0;0;0
FR;4;2021-01-18;0;0;0;0;0;0;0;0;0;0;0;0;0;0;0;0;0;0
FR;4;2021-01-19;0;0;0;0;0;0;0;0;0;0;0;0;0;0;0;0;0;0
FR;4;2021-01-20;0;0;0;0;0;0;0;0;0;0;0;0;0;0;0;0;0;0
FR;4;2021-01-21;0;0;0;0;0;0;0;0;0;0;0;0;0;0;0;0;0;0
FR;4;2021-01-22;0;0;0;0;0;0;0;0;0;0;0;0;0;0;0;0;0;0
FR;4;2021-01-23;0;0;0;0;0;0;0;0;0;0;0;0;0;0;0;0;0;0
FR;4;2021-01-24;0;0;0;0;0;0;0;0;0;0;0;0;0;0;0;0;0;0
FR;4;2021-01-25;0;0;0;0;0;0;0;0;0;0;0;0;0;0;0;0;0;0
FR;4;2021-01-26;0;0;0;0;0;0;0;0;0;0;0;0;0;0;0;0;0;0
FR;4;2021-01-27;0;0;0;0;0;0;0;0;0;0;0;0;0;0;0;0;0;0
FR;4;2021-01-28;0;0;0;0;0;0;0;0;0;0;0;0;0;0;0;0;0;0
FR;4;2021-01-29;0;0;0;0;0;0;0;0;0;0;0;0;0;0;0;0;0;0
FR;4;2021-01-30;0;0;0;0;0;0;0;0;0;0;0;0;0;0;0;0;0;0
FR;4;2021-01-31;0;0;0;0;0;0;0;0;0;0;0;0;0;0;0;0;0;0
FR;4;2021-02-01;0;0;0;0;0;0;0;0;0;0;0;0;0;0;0;0;0;0
FR;4;2021-02-02;0;0;0;0;0;0;0;0;0;0;0;0;0;0;0;0;0;0
FR;4;2021-02-03;0;0;0;0;0;0;0;0;0;0;0;0;0;0;0;0;0;0
FR;4;2021-02-04;0;0;0;0;0;0;0;0;0;0;0;0;0;0;0;0;0;0
FR;4;2021-02-05;0;0;0;0;0;0;0;0;0;0;0;0;0;0;0;0;0;0
FR;4;2021-02-06;0;0;0;0;0;0;0;0;0;0;0;0;0;0;0;0;0;0
FR;4;2021-02-07;0;0;0;0;0;0;0;0;0;0;0;0;0;0;0;0;0;0
FR;4;2021-02-08;0;0;0;0;0;0;0;0;0;0;0;0;0;0;0;0;0;0
FR;4;2021-02-09;0;0;0;0;0;0;0;0;0;0;0;0;0;0;0;0;0;0
FR;4;2021-02-10;0;0;0;0;0;0;0;0;0;0;0;0;0;0;0;0;0;0
FR;4;2021-02-11;0;0;0;0;0;0;0;0;0;0;0;0;0;0;0;0;0;0
FR;4;2021-02-12;0;0;0;0;0;0;0;0;0;0;0;0;0;0;0;0;0;0
FR;4;2021-02-13;0;0;0;0;0;0;0;0;0;0;0;0;0;0;0;0;0;0
FR;4;2021-02-14;0;0;0;0;0;0;0;0;0;0;0;0;0;0;0;0;0;0
FR;4;2021-02-15;0;0;0;0;0;0;0;0;0;0;0;0;0;0;0;0;0;0
FR;4;2021-02-16;0;0;0;0;0;0;0;0;0;0;0;0;0;0;0;0;0;0
FR;4;2021-02-17;0;0;0;0;0;0;0;0;0;0;0;0;0;0;0;0;0;0
FR;4;2021-02-18;0;0;0;0;0;0;0;0;0;0;0;0;0;0;0;0;0;0
FR;4;2021-02-19;0;0;0;0;0;0;0;0;0;0;0;0;0;0;0;0;0;0
FR;4;2021-02-20;0;0;0;0;0;0;0;0;0;0;0;0;0;0;0;0;0;0
FR;4;2021-02-21;0;0;0;0;0;0;0;0;0;0;0;0;0;0;0;0;0;0
FR;4;2021-02-22;0;0;0;0;0;0;0;0;0;0;0;0;0;0;0;0;0;0
FR;4;2021-02-23;0;0;0;0;0;0;0;0;0;0;0;0;0;0;0;0;0;0
FR;4;2021-02-24;0;0;0;0;0;0;0;0;0;0;0;0;0;0;0;0;0;0
FR;4;2021-02-25;0;0;0;0;0;0;0;0;0;0;0;0;0;0;0;0;0;0
FR;4;2021-02-26;0;0;0;0;0;0;0;0;0;0;0;0;0;0;0;0;0;0
FR;4;2021-02-27;0;0;0;0;0;0;0;0;0;0;0;0;0;0;0;0;0;0
FR;4;2021-02-28;0;0;0;0;0;0;0;0;0;0;0;0;0;0;0;0;0;0
FR;4;2021-03-01;0;0;0;0;0;0;0;0;0;0;0;0;0;0;0;0;0;0
FR;4;2021-03-02;0;0;0;0;0;0;0;0;0;0;0;0;0;0;0;0;0;0
FR;4;2021-03-03;0;0;0;0;0;0;0;0;0;0;0;0;0;0;0;0;0;0
FR;4;2021-03-04;0;0;0;0;0;0;0;0;0;0;0;0;0;0;0;0;0;0
FR;4;2021-03-05;0;0;0;0;0;0;0;0;0;0;0;0;0;0;0;0;0;0
FR;4;2021-03-06;0;0;0;0;0;0;0;0;0;0;0;0;0;0;0;0;0;0
FR;4;2021-03-07;0;0;0;0;0;0;0;0;0;0;0;0;0;0;0;0;0;0
FR;4;2021-03-08;0;0;0;0;0;0;0;0;0;0;0;0;0;0;0;0;0;0
FR;4;2021-03-09;0;0;0;0;0;0;0;0;0;0;0;0;0;0;0;0;0;0
FR;4;2021-03-10;0;0;0;0;0;0;0;0;0;0;0;0;0;0;0;0;0;0
FR;4;2021-03-11;0;0;0;0;0;0;0;0;0;0;0;0;0;0;0;0;0;0
FR;4;2021-03-12;0;0;0;0;0;0;0;0;0;0;0;0;0;0;0;0;0;0
FR;4;2021-03-13;0;0;0;0;0;0;0;0;0;0;0;0;0;0;0;0;0;0
FR;4;2021-03-14;0;0;0;0;0;0;0;0;0;0;0;0;0;0;0;0;0;0
FR;4;2021-03-15;0;0;0;0;0;0;0;0;0;0;0;0;0;0;0;0;0;0
FR;4;2021-03-16;0;0;0;0;0;0;0;0;0;0;0;0;0;0;0;0;0;0
FR;4;2021-03-17;0;0;0;0;0;0;0;0;0;0;0;0;0;0;0;0;0;0
FR;4;2021-03-18;0;0;0;0;0;0;0;0;0;0;0;0;0;0;0;0;0;0
FR;4;2021-03-19;0;0;0;0;0;0;0;0;0;0;0;0;0;0;0;0;0;0
FR;4;2021-03-20;0;0;0;0;0;0;0;0;0;0;0;0;0;0;0;0;0;0
FR;4;2021-03-21;0;0;0;0;0;0;0;0;0;0;0;0;0;0;0;0;0;0
FR;4;2021-03-22;0;0;0;0;0;0;0;0;0;0;0;0;0;0;0;0;0;0
FR;4;2021-03-23;0;0;0;0;0;0;0;0;0;0;0;0;0;0;0;0;0;0
FR;4;2021-03-24;0;0;0;0;0;0;0;0;0;0;0;0;0;0;0;0;0;0
FR;4;2021-03-25;0;0;0;0;0;0;0;0;0;0;0;0;0;0;0;0;0;0
FR;4;2021-03-26;0;0;0;0;0;0;0;0;0;0;0;0;0;0;0;0;0;0
FR;4;2021-03-27;0;0;0;0;0;0;0;0;0;0;0;0;0;0;0;0;0;0
FR;4;2021-03-28;0;0;0;0;0;0;0;0;0;0;0;0;0;0;0;0;0;0
FR;4;2021-03-29;0;0;0;0;0;0;0;0;0;0;0;0;0;0;0;0;0;0
FR;4;2021-03-30;0;0;0;0;0;0;0;0;0;0;0;0;0;0;0;0;0;0
FR;4;2021-03-31;0;0;0;0;0;0;0;0;0;0;0;0;0;0;0;0;0;0
FR;4;2021-04-01;0;0;0;0;0;0;0;0;0;0;0;0;0;0;0;0;0;0
FR;4;2021-04-02;0;0;0;0;0;0;0;0;0;0;0;0;0;0;0;0;0;0
FR;4;2021-04-03;0;0;0;0;0;0;0;0;0;0;0;0;0;0;0;0;0;0
FR;4;2021-04-04;0;0;0;0;0;0;0;0;0;0;0;0;0;0;0;0;0;0
FR;4;2021-04-05;0;0;0;0;0;0;0;0;0;0;0;0;0;0;0;0;0;0
FR;4;2021-04-06;0;0;0;0;0;0;0;0;0;0;0;0;0;0;0;0;0;0
FR;4;2021-04-07;0;0;0;0;0;0;0;0;0;0;0;0;0;0;0;0;0;0
FR;4;2021-04-08;0;0;0;0;0;0;0;0;0;0;0;0;0;0;0;0;0;0
FR;4;2021-04-09;0;0;0;0;0;0;0;0;0;0;0;0;0;0;0;0;0;0
FR;4;2021-04-10;0;0;0;0;0;0;0;0;0;0;0;0;0;0;0;0;0;0
FR;4;2021-04-11;0;0;0;0;0;0;0;0;0;0;0;0;0;0;0;0;0;0
FR;4;2021-04-12;0;0;0;0;0;0;0;0;0;0;0;0;0;0;0;0;0;0
FR;4;2021-04-13;0;0;0;0;0;0;0;0;0;0;0;0;0;0;0;0;0;0
FR;4;2021-04-14;0;0;0;0;0;0;0;0;0;0;0;0;0;0;0;0;0;0
FR;4;2021-04-15;0;0;0;0;0;0;0;0;0;0;0;0;0;0;0;0;0;0
FR;4;2021-04-16;0;0;0;0;0;0;0;0;0;0;0;0;0;0;0;0;0;0
FR;4;2021-04-17;0;0;0;0;0;0;0;0;0;0;0;0;0;0;0;0;0;0
FR;4;2021-04-18;0;0;0;0;0;0;0;0;0;0;0;0;0;0;0;0;0;0
FR;4;2021-04-19;0;0;0;0;0;0;0;0;0;0;0;0;0;0;0;0;0;0
FR;4;2021-04-20;0;0;0;0;0;0;0;0;0;0;0;0;0;0;0;0;0;0
FR;4;2021-04-21;0;0;0;0;0;0;0;0;0;0;0;0;0;0;0;0;0;0
FR;4;2021-04-22;0;0;0;0;0;0;0;0;0;0;0;0;0;0;0;0;0;0
FR;4;2021-04-23;3694;0;0;0;3653;0;0;0;0;3694;0;0;0;3653;0;0;0;0
FR;4;2021-04-24;1569;1;0;0;1558;0;0;0;0;5263;1;0;0;5211;0;0;0;0
FR;4;2021-04-25;125;0;0;0;125;0;0;0;0;5388;1;0;0;5336;0;0;0;0
FR;4;2021-04-26;2871;1;0;0;2860;0;0;0;0;8259;2;0;0;8196;0;0;0;0
FR;4;2021-04-27;9520;3;0;0;9501;0;0;0;0;17779;5;0;0;17697;0;0;0;0
FR;4;2021-04-28;9909;6;0;0;9884;0;0;0;0;27688;11;0;0;27581;0;0;0;0
FR;4;2021-04-29;15996;8;0;0;15980;0;0;0;0;43684;19;0;0;43561;0;0;0;0
FR;4;2021-04-30;19234;10;0;0;19205;0;0;0;0;62918;29;0;0;62766;0;0;0;0
FR;4;2021-05-01;1994;6;0;0;1992;0;0;0;0;64912;35;0;0;64758;0;0;0;0
FR;4;2021-05-02;484;0;0;0;481;0;0;0;0;65396;35;0;0;65239;0;0;0;0
FR;4;2021-05-03;5067;2;0;0;5060;0;0;0;0;70463;37;0;0;70299;0;0;0;0
FR;4;2021-05-04;8410;11;0;0;8399;0;0;0;0;78873;48;0;0;78698;0;0;0;0
FR;4;2021-05-05;6191;7;0;0;6186;0;0;0;0;85064;55;0;0;84884;0;0;0;0
FR;4;2021-05-06;11388;11;0;0;11385;0;0;0;0;96452;66;0;0;96269;0;0;0;0
FR;4;2021-05-07;19126;9;0;0;19087;0;0;0;0;115578;75;0;0;115356;0;0;0;0
FR;4;2021-05-08;2378;6;0;0;2382;0;0;0;0;117956;81;0;0;117738;0;0;0;0
FR;4;2021-05-09;690;3;0;0;691;0;0;0;0;118646;84;0;0;118429;0;0;0;0
FR;4;2021-05-10;7244;5;1;0;7241;0;0;0;0;125890;89;1;0;125670;0;0;0;0
FR;4;2021-05-11;14325;12;0;0;14305;0;0;0;0;140215;101;1;0;139975;0;0;0;0
FR;4;2021-05-12;10176;15;0;0;10179;0;0;0;0;150391;116;1;0;150154;0;0;0;0
FR;4;2021-05-13;1583;4;0;0;1584;0;0;0;0;151974;120;1;0;151738;0;0;0;0
FR;4;2021-05-14;7769;7;0;0;7763;0;0;0;0;159743;127;1;0;159501;0;0;0;0
FR;4;2021-05-15;3721;8;1;0;3720;0;0;0;0;163464;135;2;0;163221;0;0;0;0
FR;4;2021-05-16;417;1;0;0;417;0;0;0;0;163881;136;2;0;163638;0;0;0;0
FR;4;2021-05-17;4481;7;0;0;4480;0;0;0;0;168362;143;2;0;168118;0;0;0;0
FR;4;2021-05-18;8769;10;0;0;8769;0;0;0;0;177131;153;2;0;176887;0;0;0;0
FR;4;2021-05-19;5698;7;0;0;5700;0;0;0;0;182829;160;2;0;182587;0;0;0;0
FR;4;2021-05-20;9487;8;0;0;9479;0;0;0;0;192316;168;2;0;192066;0;0;0;0
FR;4;2021-05-21;12814;30;0;0;12821;0;0;0;0;205130;198;2;0;204887;0;0;0;0
FR;4;2021-05-22;5061;15;0;0;5068;0;0;0;0;210191;213;2;0;209955;0;0;0;0
FR;4;2021-05-23;497;4;0;0;500;0;0;0;0;210688;217;2;0;210455;0;0;0;0
FR;4;2021-05-24;1059;7;0;0;1063;0;0;0;0;211747;224;2;0;211518;0;0;0;0
FR;4;2021-05-25;7634;16;0;0;7640;0;0;0;0;219381;240;2;0;219158;0;0;0;0
FR;4;2021-05-26;7730;16;0;0;7739;0;0;0;0;227111;256;2;0;226897;0;0;0;0
FR;4;2021-05-27;14336;35;0;0;14345;0;0;0;0;241447;291;2;0;241242;0;0;0;0
FR;4;2021-05-28;26593;82;1;0;26634;0;0;0;0;268040;373;3;0;267876;0;0;0;0
FR;4;2021-05-29;11385;18;0;0;11385;0;0;0;0;279425;391;3;0;279261;0;0;0;0
FR;4;2021-05-30;974;7;0;0;973;0;0;0;0;280399;398;3;0;280234;0;0;0;0
FR;4;2021-05-31;12699;21;0;0;12699;0;0;0;0;293098;419;3;0;292933;0;0;0;0
FR;4;2021-06-01;20280;48;1;0;20298;0;0;0;0;313378;467;4;0;313231;0;0;0;0
FR;4;2021-06-02;14524;33;0;0;14537;0;0;0;0;327902;500;4;0;327768;0;0;0;0
FR;4;2021-06-03;19435;24;1;0;19433;0;0;0;0;347337;524;5;0;347201;0;0;0;0
FR;4;2021-06-04;22518;48;0;0;22536;0;0;0;0;369855;572;5;0;369737;0;0;0;0
FR;4;2021-06-05;9715;32;0;0;9719;0;0;0;0;379570;604;5;0;379456;0;0;0;0
FR;4;2021-06-06;1041;1;0;0;1037;0;0;0;0;380611;605;5;0;380493;0;0;0;0
FR;4;2021-06-07;9230;19;0;0;9237;0;0;0;0;389841;624;5;0;389730;0;0;0;0
FR;4;2021-06-08;14614;32;0;0;14626;0;0;0;0;404455;656;5;0;404356;0;0;0;0
FR;4;2021-06-09;12214;25;0;0;12222;0;0;0;0;416669;681;5;0;416578;0;0;0;0
FR;4;2021-06-10;15406;30;0;0;15414;0;0;0;0;432075;711;5;0;431992;0;0;0;0
FR;4;2021-06-11;16987;57;0;0;17014;0;0;0;0;449062;768;5;0;449006;0;0;0;0
FR;4;2021-06-12;7452;27;0;0;7477;0;0;0;0;456514;795;5;0;456483;0;0;0;0
FR;4;2021-06-13;908;3;0;0;910;0;0;0;0;457422;798;5;0;457393;0;0;0;0
FR;4;2021-06-14;6651;27;0;0;6661;0;0;0;0;464073;825;5;0;464054;0;0;0;0
FR;4;2021-06-15;10894;39;0;0;10911;0;0;0;0;474967;864;5;0;474965;0;0;0;0
FR;4;2021-06-16;8909;17;0;0;8917;0;0;0;0;483876;881;5;0;483882;0;0;0;0
FR;4;2021-06-17;10901;37;0;0;10913;0;0;0;0;494777;918;5;0;494795;0;0;0;0
FR;4;2021-06-18;12427;45;0;0;12454;0;0;0;0;507204;963;5;0;507249;0;0;0;0
FR;4;2021-06-19;5567;25;0;0;5587;0;0;0;0;512771;988;5;0;512836;0;0;0;0
FR;4;2021-06-20;827;5;0;0;831;0;0;0;0;513598;993;5;0;513667;0;0;0;0
FR;4;2021-06-21;5103;21;0;0;5103;0;0;0;0;518701;1014;5;0;518770;0;0;0;0
FR;4;2021-06-22;7914;29;2;0;7932;0;0;0;0;526615;1043;7;0;526702;0;0;0;0
FR;4;2021-06-23;7104;43;2;0;7131;0;0;0;0;533719;1086;9;0;533833;0;0;0;0
FR;4;2021-06-24;8655;46;1;0;8687;0;0;0;0;542374;1132;10;0;542520;0;0;0;0
FR;4;2021-06-25;10177;41;2;0;10209;0;0;0;0;552551;1173;12;0;552729;0;0;0;0
FR;4;2021-06-26;4853;21;0;0;4870;0;0;0;0;557404;1194;12;0;557599;0;0;0;0
FR;4;2021-06-27;768;4;0;0;770;0;0;0;0;558172;1198;12;0;558369;0;0;0;0
FR;4;2021-06-28;4834;16;1;0;4842;0;0;0;0;563006;1214;13;0;563211;0;0;0;0
FR;4;2021-06-29;7110;28;2;0;7119;0;0;0;0;570116;1242;15;0;570330;0;0;0;0
FR;4;2021-06-30;6726;40;2;0;6754;0;0;0;0;576842;1282;17;0;577084;0;0;0;0
FR;4;2021-07-01;8212;42;0;0;8234;0;0;0;0;585054;1324;17;0;585318;0;0;0;0
FR;4;2021-07-02;9429;53;1;0;9469;0;0;0;0;594483;1377;18;0;594787;0;0;0;0
FR;4;2021-07-03;4846;20;0;0;4861;0;0;0;0;599329;1397;18;0;599648;0;0;0;0
FR;4;2021-07-04;690;5;0;0;692;0;0;0;0;600019;1402;18;0;600340;0;0;0;0
FR;4;2021-07-05;4771;19;2;0;4782;0;0;0;0;604790;1421;20;0;605122;0;0;0;0
FR;4;2021-07-06;7728;29;4;0;7741;0;0;0;0;612518;1450;24;0;612863;0;0;0;0
FR;4;2021-07-07;7084;34;2;0;7097;0;0;0;0;619602;1484;26;0;619960;0;0;0;0
FR;4;2021-07-08;9232;40;2;0;9255;0;0;0;0;628834;1524;28;0;629215;0;0;0;0
FR;4;2021-07-09;10281;34;1;0;10304;0;0;0;0;639115;1558;29;0;639519;0;0;0;0
FR;4;2021-07-10;4639;14;2;0;4646;0;0;0;0;643754;1572;31;0;644165;0;0;0;0
FR;4;2021-07-11;583;4;1;0;581;0;0;0;0;644337;1576;32;0;644746;0;0;0;0
FR;4;2021-07-12;5877;29;0;0;5899;0;0;0;0;650214;1605;32;0;650645;0;0;0;0
FR;4;2021-07-13;14231;29;0;0;14249;0;0;0;0;664445;1634;32;0;664894;0;0;0;0
FR;4;2021-07-14;2291;15;0;0;2291;0;0;0;0;666736;1649;32;0;667185;0;0;0;0
FR;4;2021-07-15;18238;37;0;0;18255;0;0;0;0;684974;1686;32;0;685440;0;0;0;0
FR;4;2021-07-16;22837;71;2;0;22887;0;0;0;0;707811;1757;34;0;708327;0;0;0;0
FR;4;2021-07-17;9740;20;0;0;9749;0;0;0;0;717551;1777;34;0;718076;0;0;0;0
FR;4;2021-07-18;1358;5;0;0;1361;0;0;0;0;718909;1782;34;0;719437;0;0;0;0
FR;4;2021-07-19;12991;30;1;0;13016;0;0;0;0;731900;1812;35;0;732453;0;0;0;0
FR;4;2021-07-20;17343;26;1;0;17359;0;0;0;0;749243;1838;36;0;749812;0;0;0;0
FR;4;2021-07-21;15622;33;0;0;15642;0;0;0;0;764865;1871;36;0;765454;0;0;0;0
FR;4;2021-07-22;18246;44;2;0;18270;0;0;0;0;783111;1915;38;0;783724;0;0;0;0
FR;4;2021-07-23;20418;57;7;0;20451;0;0;0;0;803529;1972;45;0;804175;0;0;0;0
FR;4;2021-07-24;9289;33;0;0;9304;0;0;0;0;812818;2005;45;0;813479;0;0;0;0
FR;4;2021-07-25;1354;11;0;0;1356;0;0;0;0;814172;2016;45;0;814835;0;0;0;0
FR;4;2021-07-26;11043;23;0;0;11050;0;0;0;0;825215;2039;45;0;825885;0;0;0;0
FR;4;2021-07-27;14686;35;3;0;14706;0;0;0;0;839901;2074;48;0;840591;0;0;0;0
FR;4;2021-07-28;12933;26;2;0;12950;0;0;0;0;852834;2100;50;0;853541;0;0;0;0
FR;4;2021-07-29;14093;54;4;0;14134;0;0;0;0;866927;2154;54;0;867675;0;0;0;0
FR;4;2021-07-30;15501;46;2;0;15532;0;0;0;0;882428;2200;56;0;883207;0;0;0;0
FR;4;2021-07-31;6845;14;2;0;6855;0;0;0;0;889273;2214;58;0;890062;0;0;0;0
FR;4;2021-08-01;906;1;0;0;901;0;0;0;0;890179;2215;58;0;890963;0;0;0;0
FR;4;2021-08-02;7918;31;0;0;7919;0;0;0;0;898097;2246;58;0;898882;0;0;0;0
FR;4;2021-08-03;10802;31;2;0;10798;0;0;0;0;908899;2277;60;0;909680;0;0;0;0
FR;4;2021-08-04;9748;29;0;0;9747;0;0;0;0;918647;2306;60;0;919427;0;0;0;0
FR;4;2021-08-05;9827;42;0;0;9833;0;0;0;0;928474;2348;60;0;929260;0;0;0;0
FR;4;2021-08-06;10201;30;3;0;10198;0;0;0;0;938675;2378;63;0;939458;0;0;0;0
FR;4;2021-08-07;5100;30;1;0;5116;0;0;0;0;943775;2408;64;0;944574;0;0;0;0
FR;4;2021-08-08;1223;13;0;0;1226;0;0;0;0;944998;2421;64;0;945800;0;0;0;0
FR;4;2021-08-09;6350;31;0;0;6343;0;0;0;0;951348;2452;64;0;952143;0;0;0;0
FR;4;2021-08-10;8753;18;0;0;8724;0;0;0;0;960101;2470;64;0;960867;0;0;0;0
FR;4;2021-08-11;7944;34;4;0;7933;0;0;0;0;968045;2504;68;0;968800;0;0;0;0
FR;4;2021-08-12;8585;31;1;0;8573;0;0;0;0;976630;2535;69;0;977373;0;0;0;0
FR;4;2021-08-13;7559;25;0;1;7546;0;0;0;0;984189;2560;69;1;984919;0;0;0;0
FR;4;2021-08-14;3792;20;0;0;3776;0;0;0;0;987981;2580;69;1;988695;0;0;0;0
FR;4;2021-08-15;771;5;0;0;773;0;0;0;0;988752;2585;69;1;989468;0;0;0;0
FR;4;2021-08-16;4009;17;0;0;4004;0;0;0;0;992761;2602;69;1;993472;0;0;0;0
FR;4;2021-08-17;5630;17;1;0;5620;0;0;0;0;998391;2619;70;1;999092;0;0;0;0
FR;4;2021-08-18;5169;37;0;0;5186;0;0;0;0;1003560;2656;70;1;1004278;0;0;0;0
FR;4;2021-08-19;5487;34;3;0;5501;0;0;0;0;1009047;2690;73;1;1009779;0;0;0;0
FR;4;2021-08-20;5225;25;1;0;5235;0;0;0;0;1014272;2715;74;1;1015014;0;0;0;0
FR;4;2021-08-21;2311;22;1;0;2327;0;0;0;0;1016583;2737;75;1;1017341;0;0;0;0
FR;4;2021-08-22;414;2;0;0;415;0;0;0;0;1016997;2739;75;1;1017756;0;0;0;0
FR;4;2021-08-23;2935;21;1;0;2943;0;0;0;0;1019932;2760;76;1;1020699;0;0;0;0
FR;4;2021-08-24;3758;15;0;0;3761;0;0;0;0;1023690;2775;76;1;1024460;0;0;0;0
FR;4;2021-08-25;3545;25;1;0;3561;0;0;0;0;1027235;2800;77;1;1028021;0;0;0;0
FR;4;2021-08-26;3715;21;2;0;3727;0;0;0;0;1030950;2821;79;1;1031748;0;0;0;0
FR;4;2021-08-27;3617;31;2;0;3635;0;0;0;0;1034567;2852;81;1;1035383;0;0;0;0
FR;4;2021-08-28;1730;10;1;0;1735;0;0;0;0;1036297;2862;82;1;1037118;0;0;0;0
FR;4;2021-08-29;385;7;1;0;389;0;0;0;0;1036682;2869;83;1;1037507;0;0;0;0
FR;4;2021-08-30;2010;25;0;0;2018;16;0;0;0;1038692;2894;83;1;1039525;16;0;0;0
FR;4;2021-08-31;2486;21;0;0;2493;14;0;0;0;1041178;2915;83;1;1042018;30;0;0;0
FR;4;2021-09-01;2085;38;1;0;2096;22;0;0;0;1043263;2953;84;1;1044114;52;0;0;0
FR;4;2021-09-02;2307;31;4;0;2320;18;0;0;0;1045570;2984;88;1;1046434;70;0;0;0
FR;4;2021-09-03;2364;44;5;0;2373;36;0;0;0;1047934;3028;93;1;1048807;106;0;0;0
FR;4;2021-09-04;1374;18;0;0;1381;9;0;0;0;1049308;3046;93;1;1050188;115;0;0;0
FR;4;2021-09-05;433;2;0;0;433;2;0;0;0;1049741;3048;93;1;1050621;117;0;0;0
FR;4;2021-09-06;1713;62;0;0;1750;24;0;0;0;1051454;3110;93;1;1052371;141;0;0;0
FR;4;2021-09-07;1680;18;0;0;1689;8;0;0;0;1053134;3128;93;1;1054060;149;0;0;0
FR;4;2021-09-08;1286;26;3;0;1291;19;0;0;0;1054420;3154;96;1;1055351;168;0;0;0
FR;4;2021-09-09;1392;23;2;0;1402;9;0;0;0;1055812;3177;98;1;1056753;177;0;0;0
FR;4;2021-09-10;1521;31;2;0;1525;23;1;0;0;1057333;3208;100;1;1058278;200;1;0;0
FR;4;2021-09-11;745;11;0;0;748;3;0;0;0;1058078;3219;100;1;1059026;203;1;0;0
FR;4;2021-09-12;169;4;0;0;170;3;0;0;0;1058247;3223;100;1;1059196;206;1;0;0
FR;4;2021-09-13;1324;22;1;0;1327;16;0;0;0;1059571;3245;101;1;1060523;222;1;0;0
FR;4;2021-09-14;1503;9;2;0;1505;7;0;0;0;1061074;3254;103;1;1062028;229;1;0;0
FR;4;2021-09-15;1095;28;1;0;1098;25;0;0;0;1062169;3282;104;1;1063126;254;1;0;0
FR;4;2021-09-16;1105;22;2;0;1109;15;0;0;0;1063274;3304;106;1;1064235;269;1;0;0
FR;4;2021-09-17;897;21;1;0;904;12;0;0;0;1064171;3325;107;1;1065139;281;1;0;0
FR;4;2021-09-18;464;7;1;0;465;6;0;0;0;1064635;3332;108;1;1065604;287;1;0;0
FR;4;2021-09-19;182;3;0;0;183;2;0;0;0;1064817;3335;108;1;1065787;289;1;0;0
FR;4;2021-09-20;452;19;0;0;458;13;0;0;0;1065269;3354;108;1;1066245;302;1;0;0
FR;4;2021-09-21;432;11;0;0;434;7;0;0;0;1065701;3365;108;1;1066679;309;1;0;0
FR;4;2021-09-22;376;19;2;0;383;13;0;0;0;1066077;3384;110;1;1067062;322;1;0;0
FR;4;2021-09-23;485;15;1;0;486;14;0;0;0;1066562;3399;111;1;1067548;336;1;0;0
FR;4;2021-09-24;414;13;2;0;418;9;0;0;0;1066976;3412;113;1;1067966;345;1;0;0
FR;4;2021-09-25;280;10;1;0;281;5;0;0;0;1067256;3422;114;1;1068247;350;1;0;0
FR;4;2021-09-26;74;2;0;0;75;1;0;0;0;1067330;3424;114;1;1068322;351;1;0;0
FR;4;2021-09-27;269;10;1;0;270;8;0;0;0;1067599;3434;115;1;1068592;359;1;0;0
FR;4;2021-09-28;319;8;0;0;319;8;0;0;0;1067918;3442;115;1;1068911;367;1;0;0
FR;4;2021-09-29;378;19;1;0;380;13;0;0;0;1068296;3461;116;1;1069291;380;1;0;0
FR;4;2021-09-30;365;41;0;0;379;22;0;0;0;1068661;3502;116;1;1069670;402;1;0;0
FR;4;2021-10-01;411;56;0;0;413;50;0;0;0;1069072;3558;116;1;1070083;452;1;0;0
FR;4;2021-10-02;196;22;1;0;198;13;0;0;0;1069268;3580;117;1;1070281;465;1;0;0
FR;4;2021-10-03;86;1;0;0;87;0;0;0;0;1069354;3581;117;1;1070368;465;1;0;0
FR;4;2021-10-04;363;20;1;0;367;16;0;0;0;1069717;3601;118;1;1070735;481;1;0;0
FR;4;2021-10-05;286;19;2;0;288;15;0;0;0;1070003;3620;120;1;1071023;496;1;0;0
FR;4;2021-10-06;249;23;1;0;254;18;0;0;0;1070252;3643;121;1;1071277;514;1;0;0
FR;4;2021-10-07;267;25;2;0;272;13;0;0;0;1070519;3668;123;1;1071549;527;1;0;0
FR;4;2021-10-08;357;24;2;0;360;20;0;0;0;1070876;3692;125;1;1071909;547;1;0;0
FR;4;2021-10-09;194;6;6;0;195;7;0;0;0;1071070;3698;131;1;1072104;554;1;0;0
FR;4;2021-10-10;97;3;2;0;99;3;0;0;0;1071167;3701;133;1;1072203;557;1;0;0
FR;4;2021-10-11;251;15;1;0;252;14;0;0;0;1071418;3716;134;1;1072455;571;1;0;0
FR;4;2021-10-12;211;14;0;0;211;13;0;0;0;1071629;3730;134;1;1072666;584;1;0;0
FR;4;2021-10-13;221;28;1;0;224;25;0;0;0;1071850;3758;135;1;1072890;609;1;0;0
FR;4;2021-10-14;315;21;4;0;319;15;0;0;0;1072165;3779;139;1;1073209;624;1;0;0
FR;4;2021-10-15;322;24;5;0;323;25;0;0;0;1072487;3803;144;1;1073532;649;1;0;0
FR;4;2021-10-16;166;6;2;0;166;6;0;0;0;1072653;3809;146;1;1073698;655;1;0;0
FR;4;2021-10-17;70;2;0;0;71;1;0;0;0;1072723;3811;146;1;1073769;656;1;0;0
FR;4;2021-10-18;281;16;1;0;283;13;0;0;0;1073004;3827;147;1;1074052;669;1;0;0
FR;4;2021-10-19;216;14;2;0;216;15;0;0;0;1073220;3841;149;1;1074268;684;1;0;0
FR;4;2021-10-20;231;27;4;0;234;15;0;0;0;1073451;3868;153;1;1074502;699;1;0;0
FR;4;2021-10-21;243;18;0;0;245;14;0;0;0;1073694;3886;153;1;1074747;713;1;0;0
FR;4;2021-10-22;217;25;2;0;219;20;1;0;0;1073911;3911;155;1;1074966;733;2;0;0
FR;4;2021-10-23;117;16;1;0;118;15;0;0;0;1074028;3927;156;1;1075084;748;2;0;0
FR;4;2021-10-24;39;4;0;0;39;1;0;0;0;1074067;3931;156;1;1075123;749;2;0;0
FR;4;2021-10-25;218;7;2;0;218;9;0;0;0;1074285;3938;158;1;1075341;758;2;0;0
FR;4;2021-10-26;200;14;0;0;202;12;0;0;0;1074485;3952;158;1;1075543;770;2;0;0
FR;4;2021-10-27;196;12;4;0;196;12;2;0;0;1074681;3964;162;1;1075739;782;4;0;0
FR;4;2021-10-28;186;18;5;0;186;22;0;0;0;1074867;3982;167;1;1075925;804;4;0;0
FR;4;2021-10-29;225;17;2;0;226;15;0;0;0;1075092;3999;169;1;1076151;819;4;0;0
FR;4;2021-10-30;103;2;1;0;104;2;0;0;0;1075195;4001;170;1;1076255;821;4;0;0
FR;4;2021-10-31;59;3;2;0;60;3;0;0;0;1075254;4004;172;1;1076315;824;4;0;0
FR;4;2021-11-01;75;27;4;0;76;24;3;0;0;1075329;4031;176;1;1076391;848;7;0;0
FR;4;2021-11-02;162;21;2;0;163;21;0;0;0;1075491;4052;178;1;1076554;869;7;0;0
FR;4;2021-11-03;132;21;8;1;133;19;6;0;0;1075623;4073;186;2;1076687;888;13;0;0
FR;4;2021-11-04;187;15;1;0;188;12;1;0;0;1075810;4088;187;2;1076875;900;14;0;0
FR;4;2021-11-05;130;17;1;0;131;16;0;0;0;1075940;4105;188;2;1077006;916;14;0;0
FR;4;2021-11-06;81;6;1;0;81;6;0;0;0;1076021;4111;189;2;1077087;922;14;0;0
FR;4;2021-11-07;81;2;2;0;81;4;0;0;0;1076102;4113;191;2;1077168;926;14;0;0
FR;4;2021-11-08;161;20;1;0;162;20;0;0;0;1076263;4133;192;2;1077330;946;14;0;0
FR;4;2021-11-09;158;14;3;0;158;16;0;0;0;1076421;4147;195;2;1077488;962;14;0;0
FR;4;2021-11-10;121;30;6;0;121;32;2;0;0;1076542;4177;201;2;1077609;994;16;0;0
FR;4;2021-11-11;100;10;1;0;100;11;0;0;0;1076642;4187;202;2;1077709;1005;16;0;0
FR;4;2021-11-12;106;19;2;0;107;18;1;0;0;1076748;4206;204;2;1077816;1023;17;0;0
FR;4;2021-11-13;74;15;2;0;75;14;0;0;0;1076822;4221;206;2;1077891;1037;17;0;0
FR;4;2021-11-14;55;5;4;0;56;8;0;0;0;1076877;4226;210;2;1077947;1045;17;0;0
FR;4;2021-11-15;99;26;2;0;101;24;2;0;0;1076976;4252;212;2;1078048;1069;19;0;0
FR;4;2021-11-16;108;14;3;0;108;17;0;0;0;1077084;4266;215;2;1078156;1086;19;0;0
FR;4;2021-11-17;120;30;4;0;120;30;1;0;0;1077204;4296;219;2;1078276;1116;20;0;0
FR;4;2021-11-18;103;34;14;0;105;43;1;0;0;1077307;4330;233;2;1078381;1159;21;0;0
FR;4;2021-11-19;88;21;3;0;88;22;1;0;0;1077395;4351;236;2;1078469;1181;22;0;0
FR;4;2021-11-20;77;8;1;0;77;8;0;0;0;1077472;4359;237;2;1078546;1189;22;0;0
FR;4;2021-11-21;69;7;2;0;69;9;0;0;0;1077541;4366;239;2;1078615;1198;22;0;0
FR;4;2021-11-22;109;28;9;0;110;33;2;0;0;1077650;4394;248;2;1078725;1231;24;0;0
FR;4;2021-11-23;78;31;6;0;79;29;2;0;0;1077728;4425;254;2;1078804;1260;26;0;0
FR;4;2021-11-24;90;23;11;0;92;24;4;0;0;1077818;4448;265;2;1078896;1284;30;0;0
FR;4;2021-11-25;93;28;19;0;94;35;5;0;0;1077911;4476;284;2;1078990;1319;35;0;0
FR;4;2021-11-26;85;43;12;0;89;45;3;0;0;1077996;4519;296;2;1079079;1364;38;0;0
FR;4;2021-11-27;41;22;15;0;41;25;10;0;0;1078037;4541;311;2;1079120;1389;48;0;0
FR;4;2021-11-28;51;8;0;0;52;7;0;0;0;1078088;4549;311;2;1079172;1396;48;0;0
FR;4;2021-11-29;90;31;16;0;90;40;2;0;0;1078178;4580;327;2;1079262;1436;50;0;0
FR;4;2021-11-30;75;37;13;0;75;42;2;0;0;1078253;4617;340;2;1079337;1478;52;0;0
FR;4;2021-12-01;88;60;19;0;88;67;11;0;0;1078341;4677;359;2;1079425;1545;63;0;0
FR;4;2021-12-02;111;48;21;0;115;56;3;0;0;1078452;4725;380;2;1079540;1601;66;0;0
FR;4;2021-12-03;103;36;15;0;103;44;4;0;0;1078555;4761;395;2;1079643;1645;70;0;0
FR;4;2021-12-04;72;31;18;0;74;44;1;0;0;1078627;4792;413;2;1079717;1689;71;0;0
FR;4;2021-12-05;63;7;1;0;64;7;0;0;0;1078690;4799;414;2;1079781;1696;71;0;0
FR;4;2021-12-06;110;46;19;0;110;59;3;0;0;1078800;4845;433;2;1079891;1755;74;0;0
FR;4;2021-12-07;85;37;9;0;88;36;3;0;0;1078885;4882;442;2;1079979;1791;77;0;0
FR;4;2021-12-08;71;31;17;0;73;38;7;0;0;1078956;4913;459;2;1080052;1829;84;0;0
FR;4;2021-12-09;65;32;10;1;65;39;3;0;0;1079021;4945;469;3;1080117;1868;87;0;0
FR;4;2021-12-10;63;64;20;0;64;68;10;0;0;1079084;5009;489;3;1080181;1936;97;0;0
FR;4;2021-12-11;29;34;7;0;29;34;3;0;0;1079113;5043;496;3;1080210;1970;100;0;0
FR;4;2021-12-12;29;12;3;0;29;15;0;0;0;1079142;5055;499;3;1080239;1985;100;0;0
FR;4;2021-12-13;75;41;14;0;77;50;2;0;0;1079217;5096;513;3;1080316;2035;102;0;0
FR;4;2021-12-14;61;43;17;0;62;54;2;0;0;1079278;5139;530;3;1080378;2089;104;0;0
FR;4;2021-12-15;68;64;29;0;68;85;6;0;0;1079346;5203;559;3;1080446;2174;110;0;0
FR;4;2021-12-16;34;45;19;0;35;58;4;0;0;1079380;5248;578;3;1080481;2232;114;0;0
FR;4;2021-12-17;39;55;11;0;39;59;6;0;0;1079419;5303;589;3;1080520;2291;120;0;0
FR;4;2021-12-18;49;30;2;0;50;31;0;0;0;1079468;5333;591;3;1080570;2322;120;0;0
FR;4;2021-12-19;16;4;1;0;17;4;0;0;0;1079484;5337;592;3;1080587;2326;120;0;0
FR;4;2021-12-20;44;38;10;0;45;41;6;0;0;1079528;5375;602;3;1080632;2367;126;0;0
FR;4;2021-12-21;31;32;17;0;33;39;5;0;0;1079559;5407;619;3;1080665;2406;131;0;0
FR;4;2021-12-22;37;38;10;0;38;38;7;0;0;1079596;5445;629;3;1080703;2444;138;0;0
FR;4;2021-12-23;40;45;8;0;40;49;2;0;0;1079636;5490;637;3;1080743;2493;140;0;0
FR;4;2021-12-24;23;28;10;0;25;31;4;0;0;1079659;5518;647;3;1080768;2524;144;0;0
FR;4;2021-12-25;7;3;3;0;7;4;2;0;0;1079666;5521;650;3;1080775;2528;146;0;0
FR;4;2021-12-26;5;3;1;0;6;2;0;0;0;1079671;5524;651;3;1080781;2530;146;0;0
FR;4;2021-12-27;31;41;9;0;32;43;4;0;0;1079702;5565;660;3;1080813;2573;150;0;0
FR;4;2021-12-28;27;28;7;0;29;29;4;0;0;1079729;5593;667;3;1080842;2602;154;0;0
FR;4;2021-12-29;56;25;11;0;57;30;5;0;0;1079785;5618;678;3;1080899;2632;159;0;0
FR;4;2021-12-30;48;19;12;0;51;22;5;0;0;1079833;5637;690;3;1080950;2654;164;0;0
FR;4;2021-12-31;19;6;8;0;20;11;2;0;0;1079852;5643;698;3;1080970;2665;166;0;0
FR;4;2022-01-01;6;4;5;0;6;7;1;0;0;1079858;5647;703;3;1080976;2672;167;0;0
FR;4;2022-01-02;42;5;16;0;42;20;1;0;0;1079900;5652;719;3;1081018;2692;168;0;0
FR;4;2022-01-03;44;55;23;1;46;63;10;0;0;1079944;5707;742;4;1081064;2755;178;0;0
FR;4;2022-01-04;37;28;15;0;38;33;7;0;0;1079981;5735;757;4;1081102;2788;185;0;0
FR;4;2022-01-05;51;24;19;0;57;27;9;0;0;1080032;5759;776;4;1081159;2815;194;0;0
FR;4;2022-01-06;49;23;24;0;49;39;8;0;0;1080081;5782;800;4;1081208;2854;202;0;0
FR;4;2022-01-07;31;20;16;0;33;21;12;0;0;1080112;5802;816;4;1081241;2875;214;0;0
FR;4;2022-01-08;13;6;10;0;14;12;3;0;0;1080125;5808;826;4;1081255;2887;217;0;0
FR;4;2022-01-09;19;2;3;0;20;4;0;0;0;1080144;5810;829;4;1081275;2891;217;0;0
FR;4;2022-01-10;51;22;19;0;51;36;4;0;0;1080195;5832;848;4;1081326;2927;221;0;0
FR;4;2022-01-11;29;31;12;0;33;35;1;0;0;1080224;5863;860;4;1081359;2962;222;0;0
FR;4;2022-01-12;34;21;13;0;36;23;9;0;0;1080258;5884;873;4;1081395;2985;231;0;0
FR;4;2022-01-13;55;20;27;0;56;38;8;0;0;1080313;5904;900;4;1081451;3023;239;0;0
FR;4;2022-01-14;24;30;13;0;25;33;7;0;0;1080337;5934;913;4;1081476;3056;246;0;0
FR;4;2022-01-15;13;6;8;0;14;12;1;0;0;1080350;5940;921;4;1081490;3068;247;0;0
FR;4;2022-01-16;12;9;14;0;12;22;1;0;0;1080362;5949;935;4;1081502;3090;248;0;0
FR;4;2022-01-17;27;19;14;0;27;27;5;0;0;1080389;5968;949;4;1081529;3117;253;0;0
FR;4;2022-01-18;17;13;10;0;17;20;3;0;0;1080406;5981;959;4;1081546;3137;256;0;0
FR;4;2022-01-19;32;23;13;0;32;34;1;0;0;1080438;6004;972;4;1081578;3171;257;0;0
FR;4;2022-01-20;33;34;13;0;35;39;5;0;0;1080471;6038;985;4;1081613;3210;262;0;0
FR;4;2022-01-21;11;12;20;1;11;17;15;0;1;1080482;6050;1005;5;1081624;3227;277;0;1
FR;4;2022-01-22;30;13;3;0;30;14;2;0;0;1080512;6063;1008;5;1081654;3241;279;0;1
FR;4;2022-01-23;8;2;5;0;8;7;0;0;0;1080520;6065;1013;5;1081662;3248;279;0;1
FR;4;2022-01-24;14;21;8;0;15;27;1;0;0;1080534;6086;1021;5;1081677;3275;280;0;1
FR;4;2022-01-25;22;32;10;1;23;38;3;0;0;1080556;6118;1031;6;1081700;3313;283;0;1
FR;4;2022-01-26;19;17;9;1;20;21;4;0;0;1080575;6135;1040;7;1081720;3334;287;0;1
FR;4;2022-01-27;21;19;8;0;22;25;1;0;0;1080596;6154;1048;7;1081742;3359;288;0;1
FR;4;2022-01-28;13;23;8;0;14;26;4;0;0;1080609;6177;1056;7;1081756;3385;292;0;1
FR;4;2022-01-29;17;6;5;0;17;10;0;0;0;1080626;6183;1061;7;1081773;3395;292;0;1
FR;4;2022-01-30;18;3;2;0;18;5;0;0;0;1080644;6186;1063;7;1081791;3400;292;0;1
FR;4;2022-01-31;22;28;8;0;22;32;2;0;0;1080666;6214;1071;7;1081813;3432;294;0;1
FR;4;2022-02-01;13;24;12;0;15;24;9;0;0;1080679;6238;1083;7;1081828;3456;303;0;1
FR;4;2022-02-02;18;11;14;2;18;20;7;0;0;1080697;6249;1097;9;1081846;3476;310;0;1
FR;4;2022-02-03;15;24;10;0;17;28;4;0;0;1080712;6273;1107;9;1081863;3504;314;0;1
FR;4;2022-02-04;7;5;7;0;7;9;3;0;0;1080719;6278;1114;9;1081870;3513;317;0;1
FR;4;2022-02-05;7;14;1;0;8;13;1;0;0;1080726;6292;1115;9;1081878;3526;318;0;1
FR;4;2022-02-06;7;4;4;0;7;7;1;0;0;1080733;6296;1119;9;1081885;3533;319;0;1
FR;4;2022-02-07;15;19;8;0;17;19;6;0;0;1080748;6315;1127;9;1081902;3552;325;0;1
FR;4;2022-02-08;19;21;13;1;21;22;10;0;0;1080767;6336;1140;10;1081923;3574;335;0;1
FR;4;2022-02-09;17;12;9;0;18;17;2;0;0;1080784;6348;1149;10;1081941;3591;337;0;1
FR;4;2022-02-10;23;23;10;0;24;25;7;0;0;1080807;6371;1159;10;1081965;3616;344;0;1
FR;4;2022-02-11;18;15;8;0;18;20;3;0;0;1080825;6386;1167;10;1081983;3636;347;0;1
FR;4;2022-02-12;24;6;3;0;26;7;0;0;0;1080849;6392;1170;10;1082009;3643;347;0;1
FR;4;2022-02-13;7;3;3;0;7;6;0;0;0;1080856;6395;1173;10;1082016;3649;347;0;1
FR;4;2022-02-14;20;10;10;0;20;16;4;0;0;1080876;6405;1183;10;1082036;3665;351;0;1
FR;4;2022-02-15;18;7;2;0;18;8;0;0;0;1080894;6412;1185;10;1082054;3673;351;0;1
FR;4;2022-02-16;16;10;11;0;16;17;3;0;0;1080910;6422;1196;10;1082070;3690;354;0;1
FR;4;2022-02-17;11;4;5;0;11;7;2;0;0;1080921;6426;1201;10;1082081;3697;356;0;1
FR;4;2022-02-18;16;15;8;0;16;21;2;0;0;1080937;6441;1209;10;1082097;3718;358;0;1
FR;4;2022-02-19;16;4;2;0;17;5;0;0;0;1080953;6445;1211;10;1082114;3723;358;0;1
FR;4;2022-02-20;8;3;0;0;9;2;0;0;0;1080961;6448;1211;10;1082123;3725;358;0;1
FR;4;2022-02-21;23;4;4;0;23;6;2;0;0;1080984;6452;1215;10;1082146;3731;360;0;1
FR;4;2022-02-22;8;5;10;0;9;10;4;0;0;1080992;6457;1225;10;1082155;3741;364;0;1
FR;4;2022-02-23;17;6;10;0;17;10;5;0;0;1081009;6463;1235;10;1082172;3751;369;0;1
FR;4;2022-02-24;11;5;4;0;11;7;2;0;0;1081020;6468;1239;10;1082183;3758;371;0;1
FR;4;2022-02-25;16;5;7;0;16;6;6;0;0;1081036;6473;1246;10;1082199;3764;377;0;1
FR;4;2022-02-26;27;3;0;0;27;3;0;0;0;1081063;6476;1246;10;1082226;3767;377;0;1
FR;4;2022-02-27;9;0;1;0;9;1;0;0;0;1081072;6476;1247;10;1082235;3768;377;0;1
FR;4;2022-02-28;18;3;2;0;19;3;1;0;0;1081090;6479;1249;10;1082254;3771;378;0;1
FR;4;2022-03-01;8;4;7;0;8;5;5;0;0;1081098;6483;1256;10;1082262;3776;383;0;1
FR;4;2022-03-02;16;2;5;0;16;6;1;0;0;1081114;6485;1261;10;1082278;3782;384;0;1
FR;4;2022-03-03;17;5;3;0;17;6;1;0;0;1081131;6490;1264;10;1082295;3788;385;0;1
FR;4;2022-03-04;7;8;2;1;7;6;3;0;0;1081138;6498;1266;11;1082302;3794;388;0;1
FR;4;2022-03-05;9;2;0;0;9;2;0;0;0;1081147;6500;1266;11;1082311;3796;388;0;1
FR;4;2022-03-06;4;0;1;0;4;1;0;0;0;1081151;6500;1267;11;1082315;3797;388;0;1
FR;4;2022-03-07;10;6;2;0;10;5;2;0;0;1081161;6506;1269;11;1082325;3802;390;0;1
FR;4;2022-03-08;15;3;0;0;15;3;0;0;0;1081176;6509;1269;11;1082340;3805;390;0;1
FR;4;2022-03-09;9;7;2;0;11;7;0;0;0;1081185;6516;1271;11;1082351;3812;390;0;1
FR;4;2022-03-10;5;1;6;0;5;3;4;0;0;1081190;6517;1277;11;1082356;3815;394;0;1
FR;4;2022-03-11;10;4;5;0;12;2;5;0;0;1081200;6521;1282;11;1082368;3817;399;0;1
FR;4;2022-03-12;10;2;0;0;11;0;0;0;0;1081210;6523;1282;11;1082379;3817;399;0;1
FR;4;2022-03-13;6;2;1;0;7;2;0;0;0;1081216;6525;1283;11;1082386;3819;399;0;1
FR;4;2022-03-14;4;3;1;0;5;3;0;0;0;1081220;6528;1284;11;1082391;3822;399;0;1
FR;4;2022-03-15;8;6;3;0;10;5;2;0;0;1081228;6534;1287;11;1082401;3827;401;0;1
FR;4;2022-03-16;7;3;3;0;7;3;3;0;0;1081235;6537;1290;11;1082408;3830;404;0;1
FR;4;2022-03-17;3;4;1;0;3;5;0;0;0;1081238;6541;1291;11;1082411;3835;404;0;1
FR;4;2022-03-18;9;3;0;0;9;3;0;0;0;1081247;6544;1291;11;1082420;3838;404;0;1
FR;4;2022-03-19;1;1;1;0;1;2;0;0;0;1081248;6545;1292;11;1082421;3840;404;0;1
FR;4;2022-03-20;2;0;2;0;2;1;1;0;0;1081250;6545;1294;11;1082423;3841;405;0;1
FR;4;2022-03-21;6;4;1;0;6;5;0;0;0;1081256;6549;1295;11;1082429;3846;405;0;1
FR;4;2022-03-22;4;2;2;0;4;3;1;0;0;1081260;6551;1297;11;1082433;3849;406;0;1
FR;4;2022-03-23;6;4;5;0;6;8;1;0;0;1081266;6555;1302;11;1082439;3857;407;0;1
FR;4;2022-03-24;2;5;3;1;2;7;2;0;0;1081268;6560;1305;12;1082441;3864;409;0;1
FR;4;2022-03-25;3;1;2;0;3;1;2;0;0;1081271;6561;1307;12;1082444;3865;411;0;1
FR;4;2022-03-26;5;5;0;0;5;5;0;0;0;1081276;6566;1307;12;1082449;3870;411;0;1
FR;4;2022-03-27;1;0;3;0;1;2;1;0;0;1081277;6566;1310;12;1082450;3872;412;0;1
FR;4;2022-03-28;6;1;3;0;7;3;0;0;0;1081283;6567;1313;12;1082457;3875;412;0;1
FR;4;2022-03-29;9;0;4;1;9;0;2;0;0;1081292;6567;1317;13;1082466;3875;414;0;1
FR;4;2022-03-30;3;4;0;0;3;4;0;0;0;1081295;6571;1317;13;1082469;3879;414;0;1
FR;4;2022-03-31;3;3;2;1;3;4;1;0;0;1081298;6574;1319;14;1082472;3883;415;0;1
FR;4;2022-04-01;15;3;5;0;15;6;2;0;0;1081313;6577;1324;14;1082487;3889;417;0;1
FR;4;2022-04-02;4;4;0;0;5;3;0;0;0;1081317;6581;1324;14;1082492;3892;417;0;1
FR;4;2022-04-03;0;1;0;0;0;1;0;0;0;1081317;6582;1324;14;1082492;3893;417;0;1
FR;4;2022-04-04;4;4;4;0;5;5;2;0;0;1081321;6586;1328;14;1082497;3898;419;0;1
FR;4;2022-04-05;4;3;2;1;5;3;2;0;0;1081325;6589;1330;15;1082502;3901;421;0;1
FR;4;2022-04-06;6;1;0;0;6;1;0;0;0;1081331;6590;1330;15;1082508;3902;421;0;1
FR;4;2022-04-07;3;2;3;2;3;5;0;0;0;1081334;6592;1333;17;1082511;3907;421;0;1
FR;4;2022-04-08;4;2;1;0;4;2;1;0;0;1081338;6594;1334;17;1082515;3909;422;0;1
FR;4;2022-04-09;0;0;1;1;0;1;1;0;0;1081338;6594;1335;18;1082515;3910;423;0;1
FR;4;2022-04-10;2;2;0;0;2;2;0;0;0;1081340;6596;1335;18;1082517;3912;423;0;1
FR;4;2022-04-11;4;3;4;0;4;5;2;0;0;1081344;6599;1339;18;1082521;3917;425;0;1
FR;4;2022-04-12;5;1;4;0;5;2;3;0;0;1081349;6600;1343;18;1082526;3919;428;0;1
FR;4;2022-04-13;5;8;2;0;5;10;0;0;0;1081354;6608;1345;18;1082531;3929;428;0;1
FR;4;2022-04-14;6;4;2;1;7;5;1;0;0;1081360;6612;1347;19;1082538;3934;429;0;1
FR;4;2022-04-15;7;9;1;0;7;10;0;0;0;1081367;6621;1348;19;1082545;3944;429;0;1
FR;4;2022-04-16;1;0;0;0;1;0;0;0;0;1081368;6621;1348;19;1082546;3944;429;0;1
FR;4;2022-04-17;3;2;1;0;3;3;0;0;0;1081371;6623;1349;19;1082549;3947;429;0;1
FR;4;2022-04-18;2;2;6;0;2;4;4;0;0;1081373;6625;1355;19;1082551;3951;433;0;1
FR;4;2022-04-19;2;0;1;0;2;0;1;0;0;1081375;6625;1356;19;1082553;3951;434;0;1
FR;4;2022-04-20;15;4;1;1;16;3;1;0;0;1081390;6629;1357;20;1082569;3954;435;0;1
FR;4;2022-04-21;7;1;0;0;7;1;0;0;0;1081397;6630;1357;20;1082576;3955;435;0;1
FR;4;2022-04-22;1;1;2;0;1;2;1;0;0;1081398;6631;1359;20;1082577;3957;436;0;1
FR;4;2022-04-23;2;3;3;0;2;6;0;0;0;1081400;6634;1362;20;1082579;3963;436;0;1
FR;4;2022-04-24;0;3;0;0;0;3;0;0;0;1081400;6637;1362;20;1082579;3966;436;0;1
FR;4;2022-04-25;3;5;3;0;3;8;0;0;0;1081403;6642;1365;20;1082582;3974;436;0;1
FR;4;2022-04-26;5;6;1;0;5;6;1;0;0;1081408;6648;1366;20;1082587;3980;437;0;1
FR;4;2022-04-27;4;1;1;1;5;1;1;0;0;1081412;6649;1367;21;1082592;3981;438;0;1
FR;4;2022-04-28;3;5;5;1;3;7;4;0;0;1081415;6654;1372;22;1082595;3988;442;0;1
FR;4;2022-04-29;6;3;0;0;6;2;0;0;0;1081421;6657;1372;22;1082601;3990;442;0;1
FR;4;2022-04-30;2;1;1;0;2;2;0;0;0;1081423;6658;1373;22;1082603;3992;442;0;1
FR;4;2022-05-01;0;0;0;0;0;0;0;0;0;1081423;6658;1373;22;1082603;3992;442;0;1
FR;4;2022-05-02;5;16;6;0;5;19;3;0;0;1081428;6674;1379;22;1082608;4011;445;0;1
FR;4;2022-05-03;2;6;2;0;2;7;1;0;0;1081430;6680;1381;22;1082610;4018;446;0;1
FR;4;2022-05-04;7;4;1;0;7;4;1;0;0;1081437;6684;1382;22;1082617;4022;447;0;1
FR;4;2022-05-05;3;2;1;1;4;1;2;0;0;1081440;6686;1383;23;1082621;4023;449;0;1
FR;4;2022-05-06;5;3;1;0;6;2;1;0;0;1081445;6689;1384;23;1082627;4025;450;0;1
FR;4;2022-05-07;0;0;0;0;0;0;0;0;0;1081445;6689;1384;23;1082627;4025;450;0;1
FR;4;2022-05-08;1;1;0;0;1;1;0;0;0;1081446;6690;1384;23;1082628;4026;450;0;1
FR;4;2022-05-09;5;1;0;1;5;1;1;0;0;1081451;6691;1384;24;1082633;4027;451;0;1
FR;4;2022-05-10;3;1;0;2;3;3;0;0;0;1081454;6692;1384;26;1082636;4030;451;0;1
FR;4;2022-05-11;3;2;4;0;3;5;1;0;0;1081457;6694;1388;26;1082639;4035;452;0;1
FR;4;2022-05-12;7;4;2;1;7;5;1;0;1;1081464;6698;1390;27;1082646;4040;453;0;2
FR;4;2022-05-13;1;0;2;0;1;2;0;0;0;1081465;6698;1392;27;1082647;4042;453;0;2
FR;4;2022-05-14;0;2;0;0;0;2;0;0;0;1081465;6700;1392;27;1082647;4044;453;0;2
FR;4;2022-05-15;2;2;0;0;4;0;0;0;0;1081467;6702;1392;27;1082651;4044;453;0;2
FR;4;2022-05-16;5;2;2;0;5;2;2;0;0;1081472;6704;1394;27;1082656;4046;455;0;2
FR;4;2022-05-17;5;1;2;0;5;3;0;0;0;1081477;6705;1396;27;1082661;4049;455;0;2
FR;4;2022-05-18;3;6;0;0;3;6;0;0;0;1081480;6711;1396;27;1082664;4055;455;0;2
FR;4;2022-05-19;2;3;3;0;2;5;1;0;0;1081482;6714;1399;27;1082666;4060;456;0;2
FR;4;2022-05-20;4;2;3;0;4;2;3;0;0;1081486;6716;1402;27;1082670;4062;459;0;2
FR;4;2022-05-21;2;0;1;0;2;1;0;0;0;1081488;6716;1403;27;1082672;4063;459;0;2
FR;4;2022-05-22;0;0;1;0;0;1;0;0;0;1081488;6716;1404;27;1082672;4064;459;0;2
FR;4;2022-05-23;0;0;2;0;0;0;2;0;0;1081488;6716;1406;27;1082672;4064;461;0;2
FR;4;2022-05-24;2;4;1;0;2;5;0;0;0;1081490;6720;1407;27;1082674;4069;461;0;2
FR;4;2022-05-25;1;4;1;0;3;3;0;0;0;1081491;6724;1408;27;1082677;4072;461;0;2
FR;4;2022-05-26;5;0;1;0;5;1;0;0;0;1081496;6724;1409;27;1082682;4073;461;0;2
FR;4;2022-05-27;0;2;1;1;0;3;1;0;0;1081496;6726;1410;28;1082682;4076;462;0;2
FR;4;2022-05-28;1;0;0;0;1;0;0;0;0;1081497;6726;1410;28;1082683;4076;462;0;2
FR;4;2022-05-29;1;0;1;0;1;1;0;0;0;1081498;6726;1411;28;1082684;4077;462;0;2
FR;4;2022-05-30;3;4;2;0;3;5;1;0;0;1081501;6730;1413;28;1082687;4082;463;0;2
FR;4;2022-05-31;2;1;0;0;2;1;0;0;0;1081503;6731;1413;28;1082689;4083;463;0;2
FR;4;2022-06-01;3;11;7;0;3;15;3;0;0;1081506;6742;1420;28;1082692;4098;466;0;2
FR;4;2022-06-02;6;7;3;0;6;7;2;0;0;1081512;6749;1423;28;1082698;4105;468;0;2
FR;4;2022-06-03;2;6;4;1;2;7;4;0;0;1081514;6755;1427;29;1082700;4112;472;0;2
FR;4;2022-06-04;0;1;1;1;0;1;2;0;0;1081514;6756;1428;30;1082700;4113;474;0;2
FR;4;2022-06-05;0;0;0;0;0;0;0;0;0;1081514;6756;1428;30;1082700;4113;474;0;2
FR;4;2022-06-06;7;0;3;0;7;2;1;0;0;1081521;6756;1431;30;1082707;4115;475;0;2
FR;4;2022-06-07;6;2;0;1;6;2;1;0;0;1081527;6758;1431;31;1082713;4117;476;0;2
FR;4;2022-06-08;0;5;3;0;1;7;0;0;0;1081527;6763;1434;31;1082714;4124;476;0;2
FR;4;2022-06-09;1;2;0;0;2;1;0;0;0;1081528;6765;1434;31;1082716;4125;476;0;2
FR;4;2022-06-10;3;0;3;0;3;1;2;0;0;1081531;6765;1437;31;1082719;4126;478;0;2
FR;4;2022-06-11;1;0;0;0;1;0;0;0;0;1081532;6765;1437;31;1082720;4126;478;0;2
FR;4;2022-06-12;4;0;0;0;4;0;0;0;0;1081536;6765;1437;31;1082724;4126;478;0;2
FR;4;2022-06-13;5;2;3;0;6;2;1;0;0;1081541;6767;1440;31;1082730;4128;479;0;2
FR;4;2022-06-14;4;3;0;0;5;2;0;0;0;1081545;6770;1440;31;1082735;4130;479;0;2
FR;4;2022-06-15;8;3;4;0;8;3;4;0;0;1081553;6773;1444;31;1082743;4133;483;0;2
FR;4;2022-06-16;2;3;1;1;3;2;1;0;1;1081555;6776;1445;32;1082746;4135;484;0;3
FR;4;2022-06-17;6;1;0;0;6;1;0;0;0;1081561;6777;1445;32;1082752;4136;484;0;3
FR;4;2022-06-18;0;0;0;0;0;0;0;0;0;1081561;6777;1445;32;1082752;4136;484;0;3
FR;4;2022-06-19;3;0;0;0;3;0;0;0;0;1081564;6777;1445;32;1082755;4136;484;0;3
FR;4;2022-06-20;5;2;2;1;5;3;2;0;0;1081569;6779;1447;33;1082760;4139;486;0;3
FR;4;2022-06-21;5;2;4;1;6;4;2;0;0;1081574;6781;1451;34;1082766;4143;488;0;3
FR;4;2022-06-22;3;2;1;3;4;2;1;0;0;1081577;6783;1452;37;1082770;4145;489;0;3
FR;4;2022-06-23;3;3;3;0;3;5;1;0;0;1081580;6786;1455;37;1082773;4150;490;0;3
FR;4;2022-06-24;3;0;2;0;3;0;2;0;0;1081583;6786;1457;37;1082776;4150;492;0;3
FR;4;2022-06-25;2;0;1;1;2;1;1;0;0;1081585;6786;1458;38;1082778;4151;493;0;3
FR;4;2022-06-26;0;0;1;0;0;1;0;0;0;1081585;6786;1459;38;1082778;4152;493;0;3
FR;4;2022-06-27;2;2;0;3;2;2;3;0;0;1081587;6788;1459;41;1082780;4154;496;0;3
FR;4;2022-06-28;0;4;2;1;0;5;2;0;0;1081587;6792;1461;42;1082780;4159;498;0;3
FR;4;2022-06-29;1;2;0;0;1;2;0;0;0;1081588;6794;1461;42;1082781;4161;498;0;3
FR;4;2022-06-30;2;0;0;0;2;0;0;0;0;1081590;6794;1461;42;1082783;4161;498;0;3
FR;4;2022-07-01;2;4;8;0;2;4;8;0;0;1081592;6798;1469;42;1082785;4165;506;0;3
FR;4;2022-07-02;0;1;0;0;1;0;0;0;0;1081592;6799;1469;42;1082786;4165;506;0;3
FR;4;2022-07-03;0;0;0;0;0;0;0;0;0;1081592;6799;1469;42;1082786;4165;506;0;3
FR;4;2022-07-04;3;1;0;0;3;1;0;0;0;1081595;6800;1469;42;1082789;4166;506;0;3
FR;4;2022-07-05;2;0;2;0;2;2;0;0;0;1081597;6800;1471;42;1082791;4168;506;0;3
FR;4;2022-07-06;5;0;1;1;5;0;1;0;1;1081602;6800;1472;43;1082796;4168;507;0;4
FR;4;2022-07-07;1;0;2;1;1;0;3;0;0;1081603;6800;1474;44;1082797;4168;510;0;4
FR;4;2022-07-08;3;1;0;0;3;1;0;0;0;1081606;6801;1474;44;1082800;4169;510;0;4
FR;4;2022-07-09;2;2;1;0;2;3;0;0;0;1081608;6803;1475;44;1082802;4172;510;0;4
FR;4;2022-07-10;2;0;1;0;2;0;0;0;0;1081610;6803;1476;44;1082804;4172;510;0;4
FR;4;2022-07-11;2;0;2;0;2;0;1;0;0;1081612;6803;1478;44;1082806;4172;511;0;4
FR;4;2022-07-12;0;0;2;0;0;2;0;0;0;1081612;6803;1480;44;1082806;4174;511;0;4
FR;4;2022-07-13;2;2;3;0;2;2;3;0;0;1081614;6805;1483;44;1082808;4176;514;0;4
FR;4;2022-07-14;6;0;1;0;6;0;1;0;0;1081620;6805;1484;44;1082814;4176;515;0;4
FR;4;2022-07-15;11;2;0;0;11;2;0;0;0;1081631;6807;1484;44;1082825;4178;515;0;4
FR;4;2022-07-16;4;0;0;2;4;0;2;0;0;1081635;6807;1484;46;1082829;4178;517;0;4
FR;4;2022-07-17;1;0;1;1;1;0;2;0;0;1081636;6807;1485;47;1082830;4178;519;0;4
FR;4;2022-07-18;3;3;2;0;3;3;2;0;0;1081639;6810;1487;47;1082833;4181;521;0;4
FR;4;2022-07-19;4;0;1;0;4;1;0;0;0;1081643;6810;1488;47;1082837;4182;521;0;4
FR;4;2022-07-20;10;0;1;0;10;1;0;0;0;1081653;6810;1489;47;1082847;4183;521;0;4
FR;4;2022-07-21;2;3;1;0;2;3;1;0;0;1081655;6813;1490;47;1082849;4186;522;0;4
FR;4;2022-07-22;4;0;3;0;4;1;2;0;0;1081659;6813;1493;47;1082853;4187;524;0;4
FR;4;2022-07-23;1;2;0;0;1;1;0;0;0;1081660;6815;1493;47;1082854;4188;524;0;4
FR;4;2022-07-24;0;0;0;0;0;0;0;0;0;1081660;6815;1493;47;1082854;4188;524;0;4
FR;4;2022-07-25;6;0;2;0;6;2;0;0;0;1081666;6815;1495;47;1082860;4190;524;0;4
FR;4;2022-07-26;2;0;0;0;2;0;0;0;0;1081668;6815;1495;47;1082862;4190;524;0;4
FR;4;2022-07-27;3;1;0;0;3;0;0;0;0;1081671;6816;1495;47;1082865;4190;524;0;4
FR;4;2022-07-28;11;0;0;0;11;0;0;0;0;1081682;6816;1495;47;1082876;4190;524;0;4
FR;4;2022-07-29;3;0;2;0;3;1;1;0;0;1081685;6816;1497;47;1082879;4191;525;0;4
FR;4;2022-07-30;4;0;2;0;4;0;2;0;0;1081689;6816;1499;47;1082883;4191;527;0;4
FR;4;2022-07-31;0;0;0;0;0;0;0;0;0;1081689;6816;1499;47;1082883;4191;527;0;4
FR;4;2022-08-01;2;0;3;0;2;2;1;0;0;1081691;6816;1502;47;1082885;4193;528;0;4
FR;4;2022-08-02;6;0;0;0;6;0;0;0;0;1081697;6816;1502;47;1082891;4193;528;0;4
FR;4;2022-08-03;2;2;1;0;2;2;1;0;0;1081699;6818;1503;47;1082893;4195;529;0;4
FR;4;2022-08-04;4;2;0;1;4;2;1;0;0;1081703;6820;1503;48;1082897;4197;530;0;4
FR;4;2022-08-05;2;0;1;0;2;0;1;0;0;1081705;6820;1504;48;1082899;4197;531;0;4
FR;4;2022-08-06;2;0;0;0;2;0;0;0;0;1081707;6820;1504;48;1082901;4197;531;0;4
FR;4;2022-08-07;5;0;0;0;5;0;0;0;0;1081712;6820;1504;48;1082906;4197;531;0;4
FR;4;2022-08-08;1;0;1;1;1;1;1;0;0;1081713;6820;1505;49;1082907;4198;532;0;4
FR;4;2022-08-09;1;1;2;2;1;2;3;0;0;1081714;6821;1507;51;1082908;4200;535;0;4
FR;4;2022-08-10;6;1;1;0;7;1;0;0;0;1081720;6822;1508;51;1082915;4201;535;0;4
FR;4;2022-08-11;2;0;1;0;2;1;0;0;0;1081722;6822;1509;51;1082917;4202;535;0;4
FR;4;2022-08-12;4;0;1;0;4;0;1;0;0;1081726;6822;1510;51;1082921;4202;536;0;4
FR;4;2022-08-13;1;0;0;0;1;0;0;0;0;1081727;6822;1510;51;1082922;4202;536;0;4
FR;4;2022-08-14;0;0;0;0;0;0;0;0;0;1081727;6822;1510;51;1082922;4202;536;0;4
FR;4;2022-08-15;1;2;3;0;1;2;3;0;0;1081728;6824;1513;51;1082923;4204;539;0;4
FR;4;2022-08-16;0;0;1;0;0;1;0;0;0;1081728;6824;1514;51;1082923;4205;539;0;4
FR;4;2022-08-17;2;0;0;0;2;0;0;0;0;1081730;6824;1514;51;1082925;4205;539;0;4
FR;4;2022-08-18;3;0;0;0;3;0;0;0;0;1081733;6824;1514;51;1082928;4205;539;0;4
FR;4;2022-08-19;5;0;0;0;5;0;0;0;0;1081738;6824;1514;51;1082933;4205;539;0;4
FR;4;2022-08-20;1;1;0;0;2;0;0;0;0;1081739;6825;1514;51;1082935;4205;539;0;4
FR;4;2022-08-21;1;0;0;0;1;0;0;0;0;1081740;6825;1514;51;1082936;4205;539;0;4
FR;4;2022-08-22;4;9;0;0;4;9;0;0;0;1081744;6834;1514;51;1082940;4214;539;0;4
FR;4;2022-08-23;3;3;3;0;3;4;2;0;0;1081747;6837;1517;51;1082943;4218;541;0;4
FR;4;2022-08-24;6;0;0;1;6;0;1;0;0;1081753;6837;1517;52;1082949;4218;542;0;4
FR;4;2022-08-25;1;3;1;0;1;3;1;0;0;1081754;6840;1518;52;1082950;4221;543;0;4
FR;4;2022-08-26;2;0;0;1;2;0;1;0;0;1081756;6840;1518;53;1082952;4221;544;0;4
FR;4;2022-08-27;1;0;0;0;1;0;0;0;0;1081757;6840;1518;53;1082953;4221;544;0;4
FR;4;2022-08-28;0;1;0;0;0;0;0;0;0;1081757;6841;1518;53;1082953;4221;544;0;4
FR;4;2022-08-29;8;0;0;0;8;0;0;0;0;1081765;6841;1518;53;1082961;4221;544;0;4
FR;4;2022-08-30;5;0;0;0;5;0;0;0;0;1081770;6841;1518;53;1082966;4221;544;0;4
FR;4;2022-08-31;2;1;0;0;2;1;0;0;0;1081772;6842;1518;53;1082968;4222;544;0;4
FR;4;2022-09-01;3;8;2;0;4;7;2;0;0;1081775;6850;1520;53;1082972;4229;546;0;4
FR;4;2022-09-02;2;1;1;0;2;2;0;0;0;1081777;6851;1521;53;1082974;4231;546;0;4
FR;4;2022-09-03;3;0;0;0;3;0;0;0;0;1081780;6851;1521;53;1082977;4231;546;0;4
FR;4;2022-09-04;1;0;0;0;1;0;0;0;0;1081781;6851;1521;53;1082978;4231;546;0;4
FR;4;2022-09-05;2;2;0;0;2;2;0;0;0;1081783;6853;1521;53;1082980;4233;546;0;4
FR;4;2022-09-06;1;0;0;0;1;0;0;0;0;1081784;6853;1521;53;1082981;4233;546;0;4
FR;4;2022-09-07;1;0;1;1;1;1;1;0;0;1081785;6853;1522;54;1082982;4234;547;0;4
FR;4;2022-09-08;3;0;0;0;3;0;0;0;0;1081788;6853;1522;54;1082985;4234;547;0;4
FR;4;2022-09-09;2;0;0;0;2;0;0;0;0;1081790;6853;1522;54;1082987;4234;547;0;4
FR;4;2022-09-10;0;0;0;3;0;1;2;0;0;1081790;6853;1522;57;1082987;4235;549;0;4
FR;4;2022-09-11;2;0;0;0;2;0;0;0;0;1081792;6853;1522;57;1082989;4235;549;0;4
FR;4;2022-09-12;1;1;1;0;1;1;1;0;0;1081793;6854;1523;57;1082990;4236;550;0;4
FR;4;2022-09-13;1;0;0;0;1;0;0;0;0;1081794;6854;1523;57;1082991;4236;550;0;4
FR;4;2022-09-14;2;0;0;0;2;0;0;0;0;1081796;6854;1523;57;1082993;4236;550;0;4
FR;4;2022-09-15;4;0;0;0;4;0;0;0;0;1081800;6854;1523;57;1082997;4236;550;0;4
FR;4;2022-09-16;0;0;0;0;0;0;0;0;0;1081800;6854;1523;57;1082997;4236;550;0;4
FR;4;2022-09-17;2;0;0;0;2;0;0;0;0;1081802;6854;1523;57;1082999;4236;550;0;4
FR;4;2022-09-18;0;1;0;0;0;1;0;0;0;1081802;6855;1523;57;1082999;4237;550;0;4
FR;4;2022-09-19;2;0;2;0;2;2;0;0;0;1081804;6855;1525;57;1083001;4239;550;0;4
FR;4;2022-09-20;4;0;0;0;4;0;0;0;0;1081808;6855;1525;57;1083005;4239;550;0;4
FR;4;2022-09-21;2;1;0;0;2;1;0;0;0;1081810;6856;1525;57;1083007;4240;550;0;4
FR;4;2022-09-22;1;1;0;0;1;1;0;0;0;1081811;6857;1525;57;1083008;4241;550;0;4
FR;4;2022-09-23;2;3;0;0;3;2;0;0;0;1081813;6860;1525;57;1083011;4243;550;0;4
FR;4;2022-09-24;1;0;0;0;1;0;0;0;0;1081814;6860;1525;57;1083012;4243;550;0;4
FR;4;2022-09-25;0;0;0;0;0;0;0;0;0;1081814;6860;1525;57;1083012;4243;550;0;4
FR;4;2022-09-26;2;0;1;0;2;0;1;0;0;1081816;6860;1526;57;1083014;4243;551;0;4
FR;4;2022-09-27;1;0;1;1;1;0;2;0;0;1081817;6860;1527;58;1083015;4243;553;0;4
FR;4;2022-09-28;3;0;2;0;3;2;0;0;0;1081820;6860;1529;58;1083018;4245;553;0;4
FR;4;2022-09-29;3;0;1;1;3;1;1;0;0;1081823;6860;1530;59;1083021;4246;554;0;4
FR;4;2022-09-30;1;0;0;0;1;0;0;0;0;1081824;6860;1530;59;1083022;4246;554;0;4
FR;4;2022-10-01;1;1;0;0;2;0;0;0;0;1081825;6861;1530;59;1083024;4246;554;0;4
FR;4;2022-10-02;0;1;0;0;0;1;0;0;0;1081825;6862;1530;59;1083024;4247;554;0;4
FR;4;2022-10-03;2;2;1;1;3;2;1;0;0;1081827;6864;1531;60;1083027;4249;555;0;4
FR;4;2022-10-04;2;0;0;0;2;0;0;0;0;1081829;6864;1531;60;1083029;4249;555;0;4
FR;4;2022-10-05;0;1;0;0;0;1;0;0;0;1081829;6865;1531;60;1083029;4250;555;0;4
FR;4;2022-10-06;2;0;0;0;2;0;0;0;0;1081831;6865;1531;60;1083031;4250;555;0;4
FR;4;2022-10-07;3;0;1;0;3;0;1;0;0;1081834;6865;1532;60;1083034;4250;556;0;4
FR;4;2022-10-08;3;1;0;0;3;0;0;0;0;1081837;6866;1532;60;1083037;4250;556;0;4
FR;4;2022-10-09;0;0;0;0;0;0;0;0;0;1081837;6866;1532;60;1083037;4250;556;0;4
FR;4;2022-10-10;4;0;2;3;4;2;1;0;2;1081841;6866;1534;63;1083041;4252;557;0;6
FR;4;2022-10-11;1;2;0;0;1;1;0;0;0;1081842;6868;1534;63;1083042;4253;557;0;6
FR;4;2022-10-12;0;0;0;0;0;0;0;0;0;1081842;6868;1534;63;1083042;4253;557;0;6
FR;4;2022-10-13;5;0;0;0;5;0;0;0;0;1081847;6868;1534;63;1083047;4253;557;0;6
FR;4;2022-10-14;1;0;0;0;1;0;0;0;0;1081848;6868;1534;63;1083048;4253;557;0;6
FR;4;2022-10-15;0;1;0;0;0;1;0;0;0;1081848;6869;1534;63;1083048;4254;557;0;6
FR;4;2022-10-16;0;0;0;0;0;0;0;0;0;1081848;6869;1534;63;1083048;4254;557;0;6
FR;4;2022-10-17;2;0;1;0;2;1;0;0;0;1081850;6869;1535;63;1083050;4255;557;0;6
FR;4;2022-10-18;1;0;0;1;1;0;1;0;0;1081851;6869;1535;64;1083051;4255;558;0;6
FR;4;2022-10-19;1;0;0;2;1;0;2;0;3;1081852;6869;1535;66;1083052;4255;560;0;9
FR;4;2022-10-20;4;1;0;0;4;1;0;0;0;1081856;6870;1535;66;1083056;4256;560;0;9
FR;4;2022-10-21;1;0;0;0;1;0;0;0;0;1081857;6870;1535;66;1083057;4256;560;0;9
FR;4;2022-10-22;1;0;0;0;1;0;0;0;0;1081858;6870;1535;66;1083058;4256;560;0;9
FR;4;2022-10-23;0;0;0;0;0;0;0;0;0;1081858;6870;1535;66;1083058;4256;560;0;9
FR;4;2022-10-24;1;0;0;0;1;0;0;0;0;1081859;6870;1535;66;1083059;4256;560;0;9
FR;4;2022-10-25;1;0;0;0;1;0;0;0;0;1081860;6870;1535;66;1083060;4256;560;0;9
FR;4;2022-10-26;2;1;0;0;2;1;0;0;0;1081862;6871;1535;66;1083062;4257;560;0;9
FR;4;2022-10-27;3;1;1;0;3;0;1;0;0;1081865;6872;1536;66;1083065;4257;561;0;9
FR;4;2022-10-28;0;0;0;0;0;0;0;0;0;1081865;6872;1536;66;1083065;4257;561;0;9
FR;4;2022-10-29;1;0;0;3;1;0;3;0;3;1081866;6872;1536;69;1083066;4257;564;0;12
FR;4;2022-10-30;1;0;0;0;1;0;0;0;0;1081867;6872;1536;69;1083067;4257;564;0;12
FR;4;2022-10-31;1;0;0;0;1;0;0;0;0;1081868;6872;1536;69;1083068;4257;564;0;12
FR;4;2022-11-01;1;5;0;0;1;5;0;0;0;1081869;6877;1536;69;1083069;4262;564;0;12
FR;4;2022-11-02;0;0;2;2;0;1;3;0;0;1081869;6877;1538;71;1083069;4263;567;0;12
FR;4;2022-11-03;1;0;0;0;1;0;0;0;0;1081870;6877;1538;71;1083070;4263;567;0;12
FR;4;2022-11-04;4;1;0;0;4;0;0;0;0;1081874;6878;1538;71;1083074;4263;567;0;12
FR;4;2022-11-05;0;0;0;0;0;0;0;0;0;1081874;6878;1538;71;1083074;4263;567;0;12
FR;4;2022-11-06;2;0;0;0;2;0;0;0;0;1081876;6878;1538;71;1083076;4263;567;0;12
FR;4;2022-11-07;2;0;0;0;2;0;0;0;0;1081878;6878;1538;71;1083078;4263;567;0;12
FR;4;2022-11-08;7;0;0;0;7;0;0;0;0;1081885;6878;1538;71;1083085;4263;567;0;12
FR;4;2022-11-09;0;0;0;0;0;0;0;0;0;1081885;6878;1538;71;1083085;4263;567;0;12
FR;4;2022-11-10;0;0;0;0;0;0;0;0;0;1081885;6878;1538;71;1083085;4263;567;0;12
FR;4;2022-11-11;1;0;0;0;1;0;0;0;0;1081886;6878;1538;71;1083086;4263;567;0;12
FR;4;2022-11-12;3;1;0;0;3;1;0;0;0;1081889;6879;1538;71;1083089;4264;567;0;12
FR;4;2022-11-13;0;0;0;0;0;0;0;0;0;1081889;6879;1538;71;1083089;4264;567;0;12
FR;4;2022-11-14;0;0;0;0;0;0;0;0;0;1081889;6879;1538;71;1083089;4264;567;0;12
FR;4;2022-11-15;3;0;0;0;3;0;0;0;0;1081892;6879;1538;71;1083092;4264;567;0;12
FR;4;2022-11-16;1;1;0;0;1;1;0;0;0;1081893;6880;1538;71;1083093;4265;567;0;12
FR;4;2022-11-17;0;0;0;0;0;0;0;0;0;1081893;6880;1538;71;1083093;4265;567;0;12
FR;4;2022-11-18;5;0;1;0;5;0;1;0;0;1081898;6880;1539;71;1083098;4265;568;0;12
FR;4;2022-11-19;0;0;0;0;0;0;0;0;0;1081898;6880;1539;71;1083098;4265;568;0;12
FR;4;2022-11-20;0;0;0;0;0;0;0;0;0;1081898;6880;1539;71;1083098;4265;568;0;12
FR;4;2022-11-21;0;0;0;0;0;0;0;0;0;1081898;6880;1539;71;1083098;4265;568;0;12
FR;4;2022-11-22;0;1;1;0;0;2;0;0;0;1081898;6881;1540;71;1083098;4267;568;0;12
FR;4;2022-11-23;1;0;0;0;1;0;0;0;1;1081899;6881;1540;71;1083099;4267;568;0;13
FR;4;2022-11-24;0;2;0;0;0;2;0;0;0;1081899;6883;1540;71;1083099;4269;568;0;13
FR;4;2022-11-25;3;3;0;0;3;3;0;0;0;1081902;6886;1540;71;1083102;4272;568;0;13
FR;4;2022-11-26;1;0;0;0;1;0;0;0;0;1081903;6886;1540;71;1083103;4272;568;0;13
FR;4;2022-11-27;0;0;0;0;0;0;0;0;0;1081903;6886;1540;71;1083103;4272;568;0;13
FR;4;2022-11-28;3;0;0;0;3;0;0;0;0;1081906;6886;1540;71;1083106;4272;568;0;13
FR;4;2022-11-29;2;0;0;0;2;0;0;0;0;1081908;6886;1540;71;1083108;4272;568;0;13
FR;4;2022-11-30;0;0;0;0;0;0;0;0;0;1081908;6886;1540;71;1083108;4272;568;0;13
FR;4;2022-12-01;1;2;2;0;2;2;1;0;0;1081909;6888;1542;71;1083110;4274;569;0;13
FR;4;2022-12-02;2;1;0;1;2;1;0;0;1;1081911;6889;1542;72;1083112;4275;569;0;14
FR;4;2022-12-03;1;0;0;0;1;0;0;0;0;1081912;6889;1542;72;1083113;4275;569;0;14
FR;4;2022-12-04;0;0;0;0;0;0;0;0;0;1081912;6889;1542;72;1083113;4275;569;0;14
FR;4;2022-12-05;1;0;0;0;1;0;0;0;0;1081913;6889;1542;72;1083114;4275;569;0;14
FR;4;2022-12-06;1;0;0;0;1;0;0;0;0;1081914;6889;1542;72;1083115;4275;569;0;14
FR;4;2022-12-07;2;0;0;0;2;0;0;0;0;1081916;6889;1542;72;1083117;4275;569;0;14
FR;4;2022-12-08;1;0;0;0;1;0;0;0;0;1081917;6889;1542;72;1083118;4275;569;0;14
FR;4;2022-12-09;1;0;0;0;1;0;0;0;0;1081918;6889;1542;72;1083119;4275;569;0;14
FR;4;2022-12-10;1;0;0;0;1;0;0;0;0;1081919;6889;1542;72;1083120;4275;569;0;14
FR;4;2022-12-11;0;0;0;0;0;0;0;0;0;1081919;6889;1542;72;1083120;4275;569;0;14
FR;4;2022-12-12;0;1;0;5;0;1;5;0;0;1081919;6890;1542;77;1083120;4276;574;0;14
FR;4;2022-12-13;1;0;0;0;1;0;0;0;0;1081920;6890;1542;77;1083121;4276;574;0;14
FR;4;2022-12-14;0;0;0;0;0;0;0;0;0;1081920;6890;1542;77;1083121;4276;574;0;14
FR;4;2022-12-15;1;0;0;0;1;0;0;0;0;1081921;6890;1542;77;1083122;4276;574;0;14
FR;4;2022-12-16;1;0;0;0;1;0;0;0;0;1081922;6890;1542;77;1083123;4276;574;0;14
FR;4;2022-12-17;0;0;1;0;0;0;1;0;0;1081922;6890;1543;77;1083123;4276;575;0;14
FR;4;2022-12-18;0;0;0;0;0;0;0;0;0;1081922;6890;1543;77;1083123;4276;575;0;14
FR;4;2022-12-19;1;0;0;0;1;0;0;0;0;1081923;6890;1543;77;1083124;4276;575;0;14
FR;4;2022-12-20;3;1;0;0;3;1;0;0;0;1081926;6891;1543;77;1083127;4277;575;0;14
FR;4;2022-12-21;2;0;0;0;2;0;0;0;0;1081928;6891;1543;77;1083129;4277;575;0;14
FR;4;2022-12-22;0;1;0;0;0;1;0;0;0;1081928;6892;1543;77;1083129;4278;575;0;14
FR;4;2022-12-23;3;0;0;0;3;0;0;0;0;1081931;6892;1543;77;1083132;4278;575;0;14
FR;4;2022-12-24;0;0;0;0;0;0;0;0;0;1081931;6892;1543;77;1083132;4278;575;0;14
FR;4;2022-12-25;0;0;0;0;0;0;0;0;0;1081931;6892;1543;77;1083132;4278;575;0;14
FR;4;2022-12-26;1;2;0;0;1;1;0;0;0;1081932;6894;1543;77;1083133;4279;575;0;14
FR;4;2022-12-27;1;0;0;0;1;0;0;0;0;1081933;6894;1543;77;1083134;4279;575;0;14
FR;4;2022-12-28;0;0;0;0;0;0;0;0;0;1081933;6894;1543;77;1083134;4279;575;0;14
FR;4;2022-12-29;0;0;0;0;0;0;0;0;0;1081933;6894;1543;77;1083134;4279;575;0;14
FR;4;2022-12-30;1;0;0;0;1;0;0;0;0;1081934;6894;1543;77;1083135;4279;575;0;14
FR;4;2022-12-31;0;0;0;0;0;0;0;0;0;1081934;6894;1543;77;1083135;4279;575;0;14
FR;4;2023-01-01;0;0;0;0;0;0;0;0;0;1081934;6894;1543;77;1083135;4279;575;0;14
FR;4;2023-01-02;1;0;0;0;1;0;0;0;0;1081935;6894;1543;77;1083136;4279;575;0;14
FR;5;2020-12-27;0;0;0;0;0;0;0;0;0;0;0;0;0;0;0;0;0;0
FR;5;2020-12-28;0;0;0;0;0;0;0;0;0;0;0;0;0;0;0;0;0;0
FR;5;2020-12-29;0;0;0;0;0;0;0;0;0;0;0;0;0;0;0;0;0;0
FR;5;2020-12-30;0;0;0;0;0;0;0;0;0;0;0;0;0;0;0;0;0;0
FR;5;2020-12-31;0;0;0;0;0;0;0;0;0;0;0;0;0;0;0;0;0;0
FR;5;2021-01-01;0;0;0;0;0;0;0;0;0;0;0;0;0;0;0;0;0;0
FR;5;2021-01-02;0;0;0;0;0;0;0;0;0;0;0;0;0;0;0;0;0;0
FR;5;2021-01-03;0;0;0;0;0;0;0;0;0;0;0;0;0;0;0;0;0;0
FR;5;2021-01-04;0;0;0;0;0;0;0;0;0;0;0;0;0;0;0;0;0;0
FR;5;2021-01-05;0;0;0;0;0;0;0;0;0;0;0;0;0;0;0;0;0;0
FR;5;2021-01-06;0;0;0;0;0;0;0;0;0;0;0;0;0;0;0;0;0;0
FR;5;2021-01-07;0;0;0;0;0;0;0;0;0;0;0;0;0;0;0;0;0;0
FR;5;2021-01-08;0;0;0;0;0;0;0;0;0;0;0;0;0;0;0;0;0;0
FR;5;2021-01-09;0;0;0;0;0;0;0;0;0;0;0;0;0;0;0;0;0;0
FR;5;2021-01-10;0;0;0;0;0;0;0;0;0;0;0;0;0;0;0;0;0;0
FR;5;2021-01-11;0;0;0;0;0;0;0;0;0;0;0;0;0;0;0;0;0;0
FR;5;2021-01-12;0;0;0;0;0;0;0;0;0;0;0;0;0;0;0;0;0;0
FR;5;2021-01-13;0;0;0;0;0;0;0;0;0;0;0;0;0;0;0;0;0;0
FR;5;2021-01-14;0;0;0;0;0;0;0;0;0;0;0;0;0;0;0;0;0;0
FR;5;2021-01-15;0;0;0;0;0;0;0;0;0;0;0;0;0;0;0;0;0;0
FR;5;2021-01-16;0;0;0;0;0;0;0;0;0;0;0;0;0;0;0;0;0;0
FR;5;2021-01-17;0;0;0;0;0;0;0;0;0;0;0;0;0;0;0;0;0;0
FR;5;2021-01-18;0;0;0;0;0;0;0;0;0;0;0;0;0;0;0;0;0;0
FR;5;2021-01-19;0;0;0;0;0;0;0;0;0;0;0;0;0;0;0;0;0;0
FR;5;2021-01-20;0;0;0;0;0;0;0;0;0;0;0;0;0;0;0;0;0;0
FR;5;2021-01-21;0;0;0;0;0;0;0;0;0;0;0;0;0;0;0;0;0;0
FR;5;2021-01-22;0;0;0;0;0;0;0;0;0;0;0;0;0;0;0;0;0;0
FR;5;2021-01-23;0;0;0;0;0;0;0;0;0;0;0;0;0;0;0;0;0;0
FR;5;2021-01-24;0;0;0;0;0;0;0;0;0;0;0;0;0;0;0;0;0;0
FR;5;2021-01-25;0;0;0;0;0;0;0;0;0;0;0;0;0;0;0;0;0;0
FR;5;2021-01-26;0;0;0;0;0;0;0;0;0;0;0;0;0;0;0;0;0;0
FR;5;2021-01-27;0;0;0;0;0;0;0;0;0;0;0;0;0;0;0;0;0;0
FR;5;2021-01-28;0;0;0;0;0;0;0;0;0;0;0;0;0;0;0;0;0;0
FR;5;2021-01-29;0;0;0;0;0;0;0;0;0;0;0;0;0;0;0;0;0;0
FR;5;2021-01-30;0;0;0;0;0;0;0;0;0;0;0;0;0;0;0;0;0;0
FR;5;2021-01-31;0;0;0;0;0;0;0;0;0;0;0;0;0;0;0;0;0;0
FR;5;2021-02-01;0;0;0;0;0;0;0;0;0;0;0;0;0;0;0;0;0;0
FR;5;2021-02-02;0;0;0;0;0;0;0;0;0;0;0;0;0;0;0;0;0;0
FR;5;2021-02-03;0;0;0;0;0;0;0;0;0;0;0;0;0;0;0;0;0;0
FR;5;2021-02-04;0;0;0;0;0;0;0;0;0;0;0;0;0;0;0;0;0;0
FR;5;2021-02-05;0;0;0;0;0;0;0;0;0;0;0;0;0;0;0;0;0;0
FR;5;2021-02-06;0;0;0;0;0;0;0;0;0;0;0;0;0;0;0;0;0;0
FR;5;2021-02-07;0;0;0;0;0;0;0;0;0;0;0;0;0;0;0;0;0;0
FR;5;2021-02-08;0;0;0;0;0;0;0;0;0;0;0;0;0;0;0;0;0;0
FR;5;2021-02-09;0;0;0;0;0;0;0;0;0;0;0;0;0;0;0;0;0;0
FR;5;2021-02-10;0;0;0;0;0;0;0;0;0;0;0;0;0;0;0;0;0;0
FR;5;2021-02-11;0;0;0;0;0;0;0;0;0;0;0;0;0;0;0;0;0;0
FR;5;2021-02-12;0;0;0;0;0;0;0;0;0;0;0;0;0;0;0;0;0;0
FR;5;2021-02-13;0;0;0;0;0;0;0;0;0;0;0;0;0;0;0;0;0;0
FR;5;2021-02-14;0;0;0;0;0;0;0;0;0;0;0;0;0;0;0;0;0;0
FR;5;2021-02-15;0;0;0;0;0;0;0;0;0;0;0;0;0;0;0;0;0;0
FR;5;2021-02-16;0;0;0;0;0;0;0;0;0;0;0;0;0;0;0;0;0;0
FR;5;2021-02-17;0;0;0;0;0;0;0;0;0;0;0;0;0;0;0;0;0;0
FR;5;2021-02-18;0;0;0;0;0;0;0;0;0;0;0;0;0;0;0;0;0;0
FR;5;2021-02-19;0;0;0;0;0;0;0;0;0;0;0;0;0;0;0;0;0;0
FR;5;2021-02-20;0;0;0;0;0;0;0;0;0;0;0;0;0;0;0;0;0;0
FR;5;2021-02-21;0;0;0;0;0;0;0;0;0;0;0;0;0;0;0;0;0;0
FR;5;2021-02-22;0;0;0;0;0;0;0;0;0;0;0;0;0;0;0;0;0;0
FR;5;2021-02-23;0;0;0;0;0;0;0;0;0;0;0;0;0;0;0;0;0;0
FR;5;2021-02-24;0;0;0;0;0;0;0;0;0;0;0;0;0;0;0;0;0;0
FR;5;2021-02-25;0;0;0;0;0;0;0;0;0;0;0;0;0;0;0;0;0;0
FR;5;2021-02-26;0;0;0;0;0;0;0;0;0;0;0;0;0;0;0;0;0;0
FR;5;2021-02-27;0;0;0;0;0;0;0;0;0;0;0;0;0;0;0;0;0;0
FR;5;2021-02-28;0;0;0;0;0;0;0;0;0;0;0;0;0;0;0;0;0;0
FR;5;2021-03-01;0;0;0;0;0;0;0;0;0;0;0;0;0;0;0;0;0;0
FR;5;2021-03-02;0;0;0;0;0;0;0;0;0;0;0;0;0;0;0;0;0;0
FR;5;2021-03-03;0;0;0;0;0;0;0;0;0;0;0;0;0;0;0;0;0;0
FR;5;2021-03-04;0;0;0;0;0;0;0;0;0;0;0;0;0;0;0;0;0;0
FR;5;2021-03-05;0;0;0;0;0;0;0;0;0;0;0;0;0;0;0;0;0;0
FR;5;2021-03-06;0;0;0;0;0;0;0;0;0;0;0;0;0;0;0;0;0;0
FR;5;2021-03-07;0;0;0;0;0;0;0;0;0;0;0;0;0;0;0;0;0;0
FR;5;2021-03-08;0;0;0;0;0;0;0;0;0;0;0;0;0;0;0;0;0;0
FR;5;2021-03-09;0;0;0;0;0;0;0;0;0;0;0;0;0;0;0;0;0;0
FR;5;2021-03-10;0;0;0;0;0;0;0;0;0;0;0;0;0;0;0;0;0;0
FR;5;2021-03-11;0;0;0;0;0;0;0;0;0;0;0;0;0;0;0;0;0;0
FR;5;2021-03-12;0;0;0;0;0;0;0;0;0;0;0;0;0;0;0;0;0;0
FR;5;2021-03-13;0;0;0;0;0;0;0;0;0;0;0;0;0;0;0;0;0;0
FR;5;2021-03-14;0;0;0;0;0;0;0;0;0;0;0;0;0;0;0;0;0;0
FR;5;2021-03-15;0;0;0;0;0;0;0;0;0;0;0;0;0;0;0;0;0;0
FR;5;2021-03-16;0;0;0;0;0;0;0;0;0;0;0;0;0;0;0;0;0;0
FR;5;2021-03-17;0;0;0;0;0;0;0;0;0;0;0;0;0;0;0;0;0;0
FR;5;2021-03-18;0;0;0;0;0;0;0;0;0;0;0;0;0;0;0;0;0;0
FR;5;2021-03-19;0;0;0;0;0;0;0;0;0;0;0;0;0;0;0;0;0;0
FR;5;2021-03-20;0;0;0;0;0;0;0;0;0;0;0;0;0;0;0;0;0;0
FR;5;2021-03-21;0;0;0;0;0;0;0;0;0;0;0;0;0;0;0;0;0;0
FR;5;2021-03-22;0;0;0;0;0;0;0;0;0;0;0;0;0;0;0;0;0;0
FR;5;2021-03-23;0;0;0;0;0;0;0;0;0;0;0;0;0;0;0;0;0;0
FR;5;2021-03-24;0;0;0;0;0;0;0;0;0;0;0;0;0;0;0;0;0;0
FR;5;2021-03-25;0;0;0;0;0;0;0;0;0;0;0;0;0;0;0;0;0;0
FR;5;2021-03-26;0;0;0;0;0;0;0;0;0;0;0;0;0;0;0;0;0;0
FR;5;2021-03-27;0;0;0;0;0;0;0;0;0;0;0;0;0;0;0;0;0;0
FR;5;2021-03-28;0;0;0;0;0;0;0;0;0;0;0;0;0;0;0;0;0;0
FR;5;2021-03-29;0;0;0;0;0;0;0;0;0;0;0;0;0;0;0;0;0;0
FR;5;2021-03-30;0;0;0;0;0;0;0;0;0;0;0;0;0;0;0;0;0;0
FR;5;2021-03-31;0;0;0;0;0;0;0;0;0;0;0;0;0;0;0;0;0;0
FR;5;2021-04-01;0;0;0;0;0;0;0;0;0;0;0;0;0;0;0;0;0;0
FR;5;2021-04-02;0;0;0;0;0;0;0;0;0;0;0;0;0;0;0;0;0;0
FR;5;2021-04-03;0;0;0;0;0;0;0;0;0;0;0;0;0;0;0;0;0;0
FR;5;2021-04-04;0;0;0;0;0;0;0;0;0;0;0;0;0;0;0;0;0;0
FR;5;2021-04-05;0;0;0;0;0;0;0;0;0;0;0;0;0;0;0;0;0;0
FR;5;2021-04-06;0;0;0;0;0;0;0;0;0;0;0;0;0;0;0;0;0;0
FR;5;2021-04-07;0;0;0;0;0;0;0;0;0;0;0;0;0;0;0;0;0;0
FR;5;2021-04-08;0;0;0;0;0;0;0;0;0;0;0;0;0;0;0;0;0;0
FR;5;2021-04-09;0;0;0;0;0;0;0;0;0;0;0;0;0;0;0;0;0;0
FR;5;2021-04-10;0;0;0;0;0;0;0;0;0;0;0;0;0;0;0;0;0;0
FR;5;2021-04-11;0;0;0;0;0;0;0;0;0;0;0;0;0;0;0;0;0;0
FR;5;2021-04-12;0;0;0;0;0;0;0;0;0;0;0;0;0;0;0;0;0;0
FR;5;2021-04-13;0;0;0;0;0;0;0;0;0;0;0;0;0;0;0;0;0;0
FR;5;2021-04-14;0;0;0;0;0;0;0;0;0;0;0;0;0;0;0;0;0;0
FR;5;2021-04-15;0;0;0;0;0;0;0;0;0;0;0;0;0;0;0;0;0;0
FR;5;2021-04-16;0;0;0;0;0;0;0;0;0;0;0;0;0;0;0;0;0;0
FR;5;2021-04-17;0;0;0;0;0;0;0;0;0;0;0;0;0;0;0;0;0;0
FR;5;2021-04-18;0;0;0;0;0;0;0;0;0;0;0;0;0;0;0;0;0;0
FR;5;2021-04-19;0;0;0;0;0;0;0;0;0;0;0;0;0;0;0;0;0;0
FR;5;2021-04-20;0;0;0;0;0;0;0;0;0;0;0;0;0;0;0;0;0;0
FR;5;2021-04-21;0;0;0;0;0;0;0;0;0;0;0;0;0;0;0;0;0;0
FR;5;2021-04-22;0;0;0;0;0;0;0;0;0;0;0;0;0;0;0;0;0;0
FR;5;2021-04-23;0;0;0;0;0;0;0;0;0;0;0;0;0;0;0;0;0;0
FR;5;2021-04-24;0;0;0;0;0;0;0;0;0;0;0;0;0;0;0;0;0;0
FR;5;2021-04-25;0;0;0;0;0;0;0;0;0;0;0;0;0;0;0;0;0;0
FR;5;2021-04-26;0;0;0;0;0;0;0;0;0;0;0;0;0;0;0;0;0;0
FR;5;2021-04-27;0;0;0;0;0;0;0;0;0;0;0;0;0;0;0;0;0;0
FR;5;2021-04-28;0;0;0;0;0;0;0;0;0;0;0;0;0;0;0;0;0;0
FR;5;2021-04-29;0;0;0;0;0;0;0;0;0;0;0;0;0;0;0;0;0;0
FR;5;2021-04-30;0;0;0;0;0;0;0;0;0;0;0;0;0;0;0;0;0;0
FR;5;2021-05-01;0;0;0;0;0;0;0;0;0;0;0;0;0;0;0;0;0;0
FR;5;2021-05-02;0;0;0;0;0;0;0;0;0;0;0;0;0;0;0;0;0;0
FR;5;2021-05-03;0;0;0;0;0;0;0;0;0;0;0;0;0;0;0;0;0;0
FR;5;2021-05-04;0;0;0;0;0;0;0;0;0;0;0;0;0;0;0;0;0;0
FR;5;2021-05-05;0;0;0;0;0;0;0;0;0;0;0;0;0;0;0;0;0;0
FR;5;2021-05-06;0;0;0;0;0;0;0;0;0;0;0;0;0;0;0;0;0;0
FR;5;2021-05-07;0;0;0;0;0;0;0;0;0;0;0;0;0;0;0;0;0;0
FR;5;2021-05-08;0;0;0;0;0;0;0;0;0;0;0;0;0;0;0;0;0;0
FR;5;2021-05-09;0;0;0;0;0;0;0;0;0;0;0;0;0;0;0;0;0;0
FR;5;2021-05-10;0;0;0;0;0;0;0;0;0;0;0;0;0;0;0;0;0;0
FR;5;2021-05-11;0;0;0;0;0;0;0;0;0;0;0;0;0;0;0;0;0;0
FR;5;2021-05-12;0;0;0;0;0;0;0;0;0;0;0;0;0;0;0;0;0;0
FR;5;2021-05-13;0;0;0;0;0;0;0;0;0;0;0;0;0;0;0;0;0;0
FR;5;2021-05-14;0;0;0;0;0;0;0;0;0;0;0;0;0;0;0;0;0;0
FR;5;2021-05-15;0;0;0;0;0;0;0;0;0;0;0;0;0;0;0;0;0;0
FR;5;2021-05-16;0;0;0;0;0;0;0;0;0;0;0;0;0;0;0;0;0;0
FR;5;2021-05-17;0;0;0;0;0;0;0;0;0;0;0;0;0;0;0;0;0;0
FR;5;2021-05-18;0;0;0;0;0;0;0;0;0;0;0;0;0;0;0;0;0;0
FR;5;2021-05-19;0;0;0;0;0;0;0;0;0;0;0;0;0;0;0;0;0;0
FR;5;2021-05-20;0;0;0;0;0;0;0;0;0;0;0;0;0;0;0;0;0;0
FR;5;2021-05-21;0;0;0;0;0;0;0;0;0;0;0;0;0;0;0;0;0;0
FR;5;2021-05-22;0;0;0;0;0;0;0;0;0;0;0;0;0;0;0;0;0;0
FR;5;2021-05-23;0;0;0;0;0;0;0;0;0;0;0;0;0;0;0;0;0;0
FR;5;2021-05-24;0;0;0;0;0;0;0;0;0;0;0;0;0;0;0;0;0;0
FR;5;2021-05-25;0;0;0;0;0;0;0;0;0;0;0;0;0;0;0;0;0;0
FR;5;2021-05-26;0;0;0;0;0;0;0;0;0;0;0;0;0;0;0;0;0;0
FR;5;2021-05-27;0;0;0;0;0;0;0;0;0;0;0;0;0;0;0;0;0;0
FR;5;2021-05-28;0;0;0;0;0;0;0;0;0;0;0;0;0;0;0;0;0;0
FR;5;2021-05-29;0;0;0;0;0;0;0;0;0;0;0;0;0;0;0;0;0;0
FR;5;2021-05-30;0;0;0;0;0;0;0;0;0;0;0;0;0;0;0;0;0;0
FR;5;2021-05-31;0;0;0;0;0;0;0;0;0;0;0;0;0;0;0;0;0;0
FR;5;2021-06-01;0;0;0;0;0;0;0;0;0;0;0;0;0;0;0;0;0;0
FR;5;2021-06-02;0;0;0;0;0;0;0;0;0;0;0;0;0;0;0;0;0;0
FR;5;2021-06-03;0;0;0;0;0;0;0;0;0;0;0;0;0;0;0;0;0;0
FR;5;2021-06-04;0;0;0;0;0;0;0;0;0;0;0;0;0;0;0;0;0;0
FR;5;2021-06-05;0;0;0;0;0;0;0;0;0;0;0;0;0;0;0;0;0;0
FR;5;2021-06-06;0;0;0;0;0;0;0;0;0;0;0;0;0;0;0;0;0;0
FR;5;2021-06-07;0;0;0;0;0;0;0;0;0;0;0;0;0;0;0;0;0;0
FR;5;2021-06-08;0;0;0;0;0;0;0;0;0;0;0;0;0;0;0;0;0;0
FR;5;2021-06-09;0;0;0;0;0;0;0;0;0;0;0;0;0;0;0;0;0;0
FR;5;2021-06-10;0;0;0;0;0;0;0;0;0;0;0;0;0;0;0;0;0;0
FR;5;2021-06-11;0;0;0;0;0;0;0;0;0;0;0;0;0;0;0;0;0;0
FR;5;2021-06-12;0;0;0;0;0;0;0;0;0;0;0;0;0;0;0;0;0;0
FR;5;2021-06-13;0;0;0;0;0;0;0;0;0;0;0;0;0;0;0;0;0;0
FR;5;2021-06-14;0;0;0;0;0;0;0;0;0;0;0;0;0;0;0;0;0;0
FR;5;2021-06-15;0;0;0;0;0;0;0;0;0;0;0;0;0;0;0;0;0;0
FR;5;2021-06-16;0;0;0;0;0;0;0;0;0;0;0;0;0;0;0;0;0;0
FR;5;2021-06-17;0;0;0;0;0;0;0;0;0;0;0;0;0;0;0;0;0;0
FR;5;2021-06-18;0;0;0;0;0;0;0;0;0;0;0;0;0;0;0;0;0;0
FR;5;2021-06-19;0;0;0;0;0;0;0;0;0;0;0;0;0;0;0;0;0;0
FR;5;2021-06-20;0;0;0;0;0;0;0;0;0;0;0;0;0;0;0;0;0;0
FR;5;2021-06-21;0;0;0;0;0;0;0;0;0;0;0;0;0;0;0;0;0;0
FR;5;2021-06-22;0;0;0;0;0;0;0;0;0;0;0;0;0;0;0;0;0;0
FR;5;2021-06-23;0;0;0;0;0;0;0;0;0;0;0;0;0;0;0;0;0;0
FR;5;2021-06-24;0;0;0;0;0;0;0;0;0;0;0;0;0;0;0;0;0;0
FR;5;2021-06-25;0;0;0;0;0;0;0;0;0;0;0;0;0;0;0;0;0;0
FR;5;2021-06-26;0;0;0;0;0;0;0;0;0;0;0;0;0;0;0;0;0;0
FR;5;2021-06-27;0;0;0;0;0;0;0;0;0;0;0;0;0;0;0;0;0;0
FR;5;2021-06-28;0;0;0;0;0;0;0;0;0;0;0;0;0;0;0;0;0;0
FR;5;2021-06-29;0;0;0;0;0;0;0;0;0;0;0;0;0;0;0;0;0;0
FR;5;2021-06-30;0;0;0;0;0;0;0;0;0;0;0;0;0;0;0;0;0;0
FR;5;2021-07-01;0;0;0;0;0;0;0;0;0;0;0;0;0;0;0;0;0;0
FR;5;2021-07-02;0;0;0;0;0;0;0;0;0;0;0;0;0;0;0;0;0;0
FR;5;2021-07-03;0;0;0;0;0;0;0;0;0;0;0;0;0;0;0;0;0;0
FR;5;2021-07-04;0;0;0;0;0;0;0;0;0;0;0;0;0;0;0;0;0;0
FR;5;2021-07-05;0;0;0;0;0;0;0;0;0;0;0;0;0;0;0;0;0;0
FR;5;2021-07-06;0;0;0;0;0;0;0;0;0;0;0;0;0;0;0;0;0;0
FR;5;2021-07-07;0;0;0;0;0;0;0;0;0;0;0;0;0;0;0;0;0;0
FR;5;2021-07-08;0;0;0;0;0;0;0;0;0;0;0;0;0;0;0;0;0;0
FR;5;2021-07-09;0;0;0;0;0;0;0;0;0;0;0;0;0;0;0;0;0;0
FR;5;2021-07-10;0;0;0;0;0;0;0;0;0;0;0;0;0;0;0;0;0;0
FR;5;2021-07-11;0;0;0;0;0;0;0;0;0;0;0;0;0;0;0;0;0;0
FR;5;2021-07-12;0;0;0;0;0;0;0;0;0;0;0;0;0;0;0;0;0;0
FR;5;2021-07-13;0;0;0;0;0;0;0;0;0;0;0;0;0;0;0;0;0;0
FR;5;2021-07-14;0;0;0;0;0;0;0;0;0;0;0;0;0;0;0;0;0;0
FR;5;2021-07-15;0;0;0;0;0;0;0;0;0;0;0;0;0;0;0;0;0;0
FR;5;2021-07-16;0;0;0;0;0;0;0;0;0;0;0;0;0;0;0;0;0;0
FR;5;2021-07-17;0;0;0;0;0;0;0;0;0;0;0;0;0;0;0;0;0;0
FR;5;2021-07-18;0;0;0;0;0;0;0;0;0;0;0;0;0;0;0;0;0;0
FR;5;2021-07-19;0;0;0;0;0;0;0;0;0;0;0;0;0;0;0;0;0;0
FR;5;2021-07-20;0;0;0;0;0;0;0;0;0;0;0;0;0;0;0;0;0;0
FR;5;2021-07-21;0;0;0;0;0;0;0;0;0;0;0;0;0;0;0;0;0;0
FR;5;2021-07-22;0;0;0;0;0;0;0;0;0;0;0;0;0;0;0;0;0;0
FR;5;2021-07-23;0;0;0;0;0;0;0;0;0;0;0;0;0;0;0;0;0;0
FR;5;2021-07-24;0;0;0;0;0;0;0;0;0;0;0;0;0;0;0;0;0;0
FR;5;2021-07-25;0;0;0;0;0;0;0;0;0;0;0;0;0;0;0;0;0;0
FR;5;2021-07-26;0;0;0;0;0;0;0;0;0;0;0;0;0;0;0;0;0;0
FR;5;2021-07-27;0;0;0;0;0;0;0;0;0;0;0;0;0;0;0;0;0;0
FR;5;2021-07-28;0;0;0;0;0;0;0;0;0;0;0;0;0;0;0;0;0;0
FR;5;2021-07-29;0;0;0;0;0;0;0;0;0;0;0;0;0;0;0;0;0;0
FR;5;2021-07-30;0;0;0;0;0;0;0;0;0;0;0;0;0;0;0;0;0;0
FR;5;2021-07-31;0;0;0;0;0;0;0;0;0;0;0;0;0;0;0;0;0;0
FR;5;2021-08-01;0;0;0;0;0;0;0;0;0;0;0;0;0;0;0;0;0;0
FR;5;2021-08-02;0;0;0;0;0;0;0;0;0;0;0;0;0;0;0;0;0;0
FR;5;2021-08-03;0;0;0;0;0;0;0;0;0;0;0;0;0;0;0;0;0;0
FR;5;2021-08-04;0;0;0;0;0;0;0;0;0;0;0;0;0;0;0;0;0;0
FR;5;2021-08-05;0;0;0;0;0;0;0;0;0;0;0;0;0;0;0;0;0;0
FR;5;2021-08-06;0;0;0;0;0;0;0;0;0;0;0;0;0;0;0;0;0;0
FR;5;2021-08-07;0;0;0;0;0;0;0;0;0;0;0;0;0;0;0;0;0;0
FR;5;2021-08-08;0;0;0;0;0;0;0;0;0;0;0;0;0;0;0;0;0;0
FR;5;2021-08-09;0;0;0;0;0;0;0;0;0;0;0;0;0;0;0;0;0;0
FR;5;2021-08-10;0;0;0;0;0;0;0;0;0;0;0;0;0;0;0;0;0;0
FR;5;2021-08-11;0;0;0;0;0;0;0;0;0;0;0;0;0;0;0;0;0;0
FR;5;2021-08-12;0;0;0;0;0;0;0;0;0;0;0;0;0;0;0;0;0;0
FR;5;2021-08-13;0;0;0;0;0;0;0;0;0;0;0;0;0;0;0;0;0;0
FR;5;2021-08-14;0;0;0;0;0;0;0;0;0;0;0;0;0;0;0;0;0;0
FR;5;2021-08-15;0;0;0;0;0;0;0;0;0;0;0;0;0;0;0;0;0;0
FR;5;2021-08-16;0;0;0;0;0;0;0;0;0;0;0;0;0;0;0;0;0;0
FR;5;2021-08-17;0;0;0;0;0;0;0;0;0;0;0;0;0;0;0;0;0;0
FR;5;2021-08-18;0;0;0;0;0;0;0;0;0;0;0;0;0;0;0;0;0;0
FR;5;2021-08-19;0;0;0;0;0;0;0;0;0;0;0;0;0;0;0;0;0;0
FR;5;2021-08-20;0;0;0;0;0;0;0;0;0;0;0;0;0;0;0;0;0;0
FR;5;2021-08-21;0;0;0;0;0;0;0;0;0;0;0;0;0;0;0;0;0;0
FR;5;2021-08-22;0;0;0;0;0;0;0;0;0;0;0;0;0;0;0;0;0;0
FR;5;2021-08-23;0;0;0;0;0;0;0;0;0;0;0;0;0;0;0;0;0;0
FR;5;2021-08-24;0;0;0;0;0;0;0;0;0;0;0;0;0;0;0;0;0;0
FR;5;2021-08-25;0;0;0;0;0;0;0;0;0;0;0;0;0;0;0;0;0;0
FR;5;2021-08-26;0;0;0;0;0;0;0;0;0;0;0;0;0;0;0;0;0;0
FR;5;2021-08-27;0;0;0;0;0;0;0;0;0;0;0;0;0;0;0;0;0;0
FR;5;2021-08-28;0;0;0;0;0;0;0;0;0;0;0;0;0;0;0;0;0;0
FR;5;2021-08-29;0;0;0;0;0;0;0;0;0;0;0;0;0;0;0;0;0;0
FR;5;2021-08-30;0;0;0;0;0;0;0;0;0;0;0;0;0;0;0;0;0;0
FR;5;2021-08-31;0;0;0;0;0;0;0;0;0;0;0;0;0;0;0;0;0;0
FR;5;2021-09-01;0;0;0;0;0;0;0;0;0;0;0;0;0;0;0;0;0;0
FR;5;2021-09-02;0;0;0;0;0;0;0;0;0;0;0;0;0;0;0;0;0;0
FR;5;2021-09-03;0;0;0;0;0;0;0;0;0;0;0;0;0;0;0;0;0;0
FR;5;2021-09-04;0;0;0;0;0;0;0;0;0;0;0;0;0;0;0;0;0;0
FR;5;2021-09-05;0;0;0;0;0;0;0;0;0;0;0;0;0;0;0;0;0;0
FR;5;2021-09-06;0;0;0;0;0;0;0;0;0;0;0;0;0;0;0;0;0;0
FR;5;2021-09-07;0;0;0;0;0;0;0;0;0;0;0;0;0;0;0;0;0;0
FR;5;2021-09-08;0;0;0;0;0;0;0;0;0;0;0;0;0;0;0;0;0;0
FR;5;2021-09-09;0;0;0;0;0;0;0;0;0;0;0;0;0;0;0;0;0;0
FR;5;2021-09-10;0;0;0;0;0;0;0;0;0;0;0;0;0;0;0;0;0;0
FR;5;2021-09-11;0;0;0;0;0;0;0;0;0;0;0;0;0;0;0;0;0;0
FR;5;2021-09-12;0;0;0;0;0;0;0;0;0;0;0;0;0;0;0;0;0;0
FR;5;2021-09-13;0;0;0;0;0;0;0;0;0;0;0;0;0;0;0;0;0;0
FR;5;2021-09-14;0;0;0;0;0;0;0;0;0;0;0;0;0;0;0;0;0;0
FR;5;2021-09-15;0;0;0;0;0;0;0;0;0;0;0;0;0;0;0;0;0;0
FR;5;2021-09-16;0;0;0;0;0;0;0;0;0;0;0;0;0;0;0;0;0;0
FR;5;2021-09-17;0;0;0;0;0;0;0;0;0;0;0;0;0;0;0;0;0;0
FR;5;2021-09-18;0;0;0;0;0;0;0;0;0;0;0;0;0;0;0;0;0;0
FR;5;2021-09-19;0;0;0;0;0;0;0;0;0;0;0;0;0;0;0;0;0;0
FR;5;2021-09-20;0;0;0;0;0;0;0;0;0;0;0;0;0;0;0;0;0;0
FR;5;2021-09-21;0;0;0;0;0;0;0;0;0;0;0;0;0;0;0;0;0;0
FR;5;2021-09-22;0;0;0;0;0;0;0;0;0;0;0;0;0;0;0;0;0;0
FR;5;2021-09-23;0;0;0;0;0;0;0;0;0;0;0;0;0;0;0;0;0;0
FR;5;2021-09-24;0;0;0;0;0;0;0;0;0;0;0;0;0;0;0;0;0;0
FR;5;2021-09-25;0;0;0;0;0;0;0;0;0;0;0;0;0;0;0;0;0;0
FR;5;2021-09-26;0;0;0;0;0;0;0;0;0;0;0;0;0;0;0;0;0;0
FR;5;2021-09-27;0;0;0;0;0;0;0;0;0;0;0;0;0;0;0;0;0;0
FR;5;2021-09-28;0;0;0;0;0;0;0;0;0;0;0;0;0;0;0;0;0;0
FR;5;2021-09-29;0;0;0;0;0;0;0;0;0;0;0;0;0;0;0;0;0;0
FR;5;2021-09-30;0;0;0;0;0;0;0;0;0;0;0;0;0;0;0;0;0;0
FR;5;2021-10-01;0;0;0;0;0;0;0;0;0;0;0;0;0;0;0;0;0;0
FR;5;2021-10-02;0;0;0;0;0;0;0;0;0;0;0;0;0;0;0;0;0;0
FR;5;2021-10-03;0;0;0;0;0;0;0;0;0;0;0;0;0;0;0;0;0;0
FR;5;2021-10-04;0;0;0;0;0;0;0;0;0;0;0;0;0;0;0;0;0;0
FR;5;2021-10-05;0;0;0;0;0;0;0;0;0;0;0;0;0;0;0;0;0;0
FR;5;2021-10-06;0;0;0;0;0;0;0;0;0;0;0;0;0;0;0;0;0;0
FR;5;2021-10-07;0;0;0;0;0;0;0;0;0;0;0;0;0;0;0;0;0;0
FR;5;2021-10-08;0;0;0;0;0;0;0;0;0;0;0;0;0;0;0;0;0;0
FR;5;2021-10-09;0;0;0;0;0;0;0;0;0;0;0;0;0;0;0;0;0;0
FR;5;2021-10-10;0;0;0;0;0;0;0;0;0;0;0;0;0;0;0;0;0;0
FR;5;2021-10-11;0;0;0;0;0;0;0;0;0;0;0;0;0;0;0;0;0;0
FR;5;2021-10-12;0;0;0;0;0;0;0;0;0;0;0;0;0;0;0;0;0;0
FR;5;2021-10-13;0;0;0;0;0;0;0;0;0;0;0;0;0;0;0;0;0;0
FR;5;2021-10-14;0;0;0;0;0;0;0;0;0;0;0;0;0;0;0;0;0;0
FR;5;2021-10-15;0;0;0;0;0;0;0;0;0;0;0;0;0;0;0;0;0;0
FR;5;2021-10-16;0;0;0;0;0;0;0;0;0;0;0;0;0;0;0;0;0;0
FR;5;2021-10-17;0;0;0;0;0;0;0;0;0;0;0;0;0;0;0;0;0;0
FR;5;2021-10-18;0;0;0;0;0;0;0;0;0;0;0;0;0;0;0;0;0;0
FR;5;2021-10-19;0;0;0;0;0;0;0;0;0;0;0;0;0;0;0;0;0;0
FR;5;2021-10-20;0;0;0;0;0;0;0;0;0;0;0;0;0;0;0;0;0;0
FR;5;2021-10-21;0;0;0;0;0;0;0;0;0;0;0;0;0;0;0;0;0;0
FR;5;2021-10-22;0;0;0;0;0;0;0;0;0;0;0;0;0;0;0;0;0;0
FR;5;2021-10-23;0;0;0;0;0;0;0;0;0;0;0;0;0;0;0;0;0;0
FR;5;2021-10-24;0;0;0;0;0;0;0;0;0;0;0;0;0;0;0;0;0;0
FR;5;2021-10-25;0;0;0;0;0;0;0;0;0;0;0;0;0;0;0;0;0;0
FR;5;2021-10-26;0;0;0;0;0;0;0;0;0;0;0;0;0;0;0;0;0;0
FR;5;2021-10-27;0;0;0;0;0;0;0;0;0;0;0;0;0;0;0;0;0;0
FR;5;2021-10-28;0;0;0;0;0;0;0;0;0;0;0;0;0;0;0;0;0;0
FR;5;2021-10-29;0;0;0;0;0;0;0;0;0;0;0;0;0;0;0;0;0;0
FR;5;2021-10-30;0;0;0;0;0;0;0;0;0;0;0;0;0;0;0;0;0;0
FR;5;2021-10-31;0;0;0;0;0;0;0;0;0;0;0;0;0;0;0;0;0;0
FR;5;2021-11-01;0;0;0;0;0;0;0;0;0;0;0;0;0;0;0;0;0;0
FR;5;2021-11-02;0;0;0;0;0;0;0;0;0;0;0;0;0;0;0;0;0;0
FR;5;2021-11-03;0;0;0;0;0;0;0;0;0;0;0;0;0;0;0;0;0;0
FR;5;2021-11-04;0;0;0;0;0;0;0;0;0;0;0;0;0;0;0;0;0;0
FR;5;2021-11-05;0;0;0;0;0;0;0;0;0;0;0;0;0;0;0;0;0;0
FR;5;2021-11-06;0;0;0;0;0;0;0;0;0;0;0;0;0;0;0;0;0;0
FR;5;2021-11-07;0;0;0;0;0;0;0;0;0;0;0;0;0;0;0;0;0;0
FR;5;2021-11-08;0;0;0;0;0;0;0;0;0;0;0;0;0;0;0;0;0;0
FR;5;2021-11-09;0;0;0;0;0;0;0;0;0;0;0;0;0;0;0;0;0;0
FR;5;2021-11-10;0;0;0;0;0;0;0;0;0;0;0;0;0;0;0;0;0;0
FR;5;2021-11-11;0;0;0;0;0;0;0;0;0;0;0;0;0;0;0;0;0;0
FR;5;2021-11-12;0;0;0;0;0;0;0;0;0;0;0;0;0;0;0;0;0;0
FR;5;2021-11-13;0;0;0;0;0;0;0;0;0;0;0;0;0;0;0;0;0;0
FR;5;2021-11-14;0;0;0;0;0;0;0;0;0;0;0;0;0;0;0;0;0;0
FR;5;2021-11-15;0;0;0;0;0;0;0;0;0;0;0;0;0;0;0;0;0;0
FR;5;2021-11-16;0;0;0;0;0;0;0;0;0;0;0;0;0;0;0;0;0;0
FR;5;2021-11-17;0;0;0;0;0;0;0;0;0;0;0;0;0;0;0;0;0;0
FR;5;2021-11-18;0;0;0;0;0;0;0;0;0;0;0;0;0;0;0;0;0;0
FR;5;2021-11-19;0;0;0;0;0;0;0;0;0;0;0;0;0;0;0;0;0;0
FR;5;2021-11-20;0;0;0;0;0;0;0;0;0;0;0;0;0;0;0;0;0;0
FR;5;2021-11-21;0;0;0;0;0;0;0;0;0;0;0;0;0;0;0;0;0;0
FR;5;2021-11-22;0;0;0;0;0;0;0;0;0;0;0;0;0;0;0;0;0;0
FR;5;2021-11-23;0;0;0;0;0;0;0;0;0;0;0;0;0;0;0;0;0;0
FR;5;2021-11-24;0;0;0;0;0;0;0;0;0;0;0;0;0;0;0;0;0;0
FR;5;2021-11-25;0;0;0;0;0;0;0;0;0;0;0;0;0;0;0;0;0;0
FR;5;2021-11-26;0;0;0;0;0;0;0;0;0;0;0;0;0;0;0;0;0;0
FR;5;2021-11-27;0;0;0;0;0;0;0;0;0;0;0;0;0;0;0;0;0;0
FR;5;2021-11-28;0;0;0;0;0;0;0;0;0;0;0;0;0;0;0;0;0;0
FR;5;2021-11-29;0;0;0;0;0;0;0;0;0;0;0;0;0;0;0;0;0;0
FR;5;2021-11-30;0;0;0;0;0;0;0;0;0;0;0;0;0;0;0;0;0;0
FR;5;2021-12-01;0;0;0;0;0;0;0;0;0;0;0;0;0;0;0;0;0;0
FR;5;2021-12-02;0;0;0;0;0;0;0;0;0;0;0;0;0;0;0;0;0;0
FR;5;2021-12-03;0;0;0;0;0;0;0;0;0;0;0;0;0;0;0;0;0;0
FR;5;2021-12-04;0;0;0;0;0;0;0;0;0;0;0;0;0;0;0;0;0;0
FR;5;2021-12-05;0;0;0;0;0;0;0;0;0;0;0;0;0;0;0;0;0;0
FR;5;2021-12-06;0;0;0;0;0;0;0;0;0;0;0;0;0;0;0;0;0;0
FR;5;2021-12-07;0;0;0;0;0;0;0;0;0;0;0;0;0;0;0;0;0;0
FR;5;2021-12-08;0;0;0;0;0;0;0;0;0;0;0;0;0;0;0;0;0;0
FR;5;2021-12-09;0;0;0;0;0;0;0;0;0;0;0;0;0;0;0;0;0;0
FR;5;2021-12-10;0;0;0;0;0;0;0;0;0;0;0;0;0;0;0;0;0;0
FR;5;2021-12-11;0;0;0;0;0;0;0;0;0;0;0;0;0;0;0;0;0;0
FR;5;2021-12-12;0;0;0;0;0;0;0;0;0;0;0;0;0;0;0;0;0;0
FR;5;2021-12-13;0;0;0;0;0;0;0;0;0;0;0;0;0;0;0;0;0;0
FR;5;2021-12-14;33;45;77;0;27;88;1;0;0;33;45;77;0;27;88;1;0;0
FR;5;2021-12-15;196;44;37;0;42;49;0;0;0;229;89;114;0;69;137;1;0;0
FR;5;2021-12-16;181;21;44;0;38;48;0;0;0;410;110;158;0;107;185;1;0;0
FR;5;2021-12-17;313;16;72;0;34;74;2;0;0;723;126;230;0;141;259;3;0;0
FR;5;2021-12-18;766;24;22;0;67;29;0;0;0;1489;150;252;0;208;288;3;0;0
FR;5;2021-12-19;585;15;15;0;67;17;0;0;0;2074;165;267;0;275;305;3;0;0
FR;5;2021-12-20;1225;31;34;0;134;37;2;0;0;3299;196;301;0;409;342;5;0;0
FR;5;2021-12-21;1535;22;54;1;141;60;0;0;0;4834;218;355;1;550;402;5;0;0
FR;5;2021-12-22;4069;40;37;0;420;46;2;0;0;8903;258;392;1;970;448;7;0;0
FR;5;2021-12-23;3042;16;21;0;304;25;0;0;0;11945;274;413;1;1274;473;7;0;0
FR;5;2021-12-24;761;18;9;0;103;14;0;0;0;12706;292;422;1;1377;487;7;0;0
FR;5;2021-12-25;61;5;2;0;9;3;0;0;0;12767;297;424;1;1386;490;7;0;0
FR;5;2021-12-26;623;6;3;0;101;4;0;0;0;13390;303;427;1;1487;494;7;0;0
FR;5;2021-12-27;4085;25;21;0;458;23;1;0;0;17475;328;448;1;1945;517;8;0;0
FR;5;2021-12-28;5204;23;41;1;512;43;2;0;0;22679;351;489;2;2457;560;10;0;0
FR;5;2021-12-29;8105;34;66;2;886;69;1;0;0;30784;385;555;4;3343;629;11;0;0
FR;5;2021-12-30;5173;18;33;0;525;39;0;0;0;35957;403;588;4;3868;668;11;0;0
FR;5;2021-12-31;1553;8;10;0;182;11;0;0;0;37510;411;598;4;4050;679;11;0;0
FR;5;2022-01-01;186;2;2;0;24;3;0;0;0;37696;413;600;4;4074;682;11;0;0
FR;5;2022-01-02;1489;1;1;0;151;1;0;0;0;39185;414;601;4;4225;683;11;0;0
FR;5;2022-01-03;3068;36;34;0;321;33;1;0;0;42253;450;635;4;4546;716;12;0;0
FR;5;2022-01-04;3034;39;33;0;320;42;3;0;0;45287;489;668;4;4866;758;15;0;0
FR;5;2022-01-05;19324;203;97;1;2114;108;0;0;0;64611;692;765;5;6980;866;15;0;0
FR;5;2022-01-06;3748;134;122;0;507;142;2;0;0;68359;826;887;5;7487;1008;17;0;0
FR;5;2022-01-07;5006;202;48;2;702;56;1;0;0;73365;1028;935;7;8189;1064;18;0;0
FR;5;2022-01-08;13659;514;45;0;1998;52;0;0;0;87024;1542;980;7;10187;1116;18;0;0
FR;5;2022-01-09;5754;399;15;0;1113;20;1;0;0;92778;1941;995;7;11300;1136;19;0;0
FR;5;2022-01-10;3455;326;25;0;732;29;0;0;0;96233;2267;1020;7;12032;1165;19;0;0
FR;5;2022-01-11;3671;284;38;0;662;41;1;0;0;99904;2551;1058;7;12694;1206;20;0;0
FR;5;2022-01-12;22650;3005;89;0;5296;112;2;0;0;122554;5556;1147;7;17990;1318;22;0;0
FR;5;2022-01-13;4039;623;29;0;1052;31;2;0;0;126593;6179;1176;7;19042;1349;24;0;0
FR;5;2022-01-14;4843;583;45;0;1115;52;1;0;0;131436;6762;1221;7;20157;1401;25;0;0
FR;5;2022-01-15;14686;1746;38;3;3373;49;3;0;0;146122;8508;1259;10;23530;1450;28;0;0
FR;5;2022-01-16;4728;666;3;0;1260;5;0;0;0;150850;9174;1262;10;24790;1455;28;0;0
FR;5;2022-01-17;2297;718;26;0;986;29;0;0;0;153147;9892;1288;10;25776;1484;28;0;0
FR;5;2022-01-18;2431;870;30;0;1141;40;0;0;0;155578;10762;1318;10;26917;1524;28;0;0
FR;5;2022-01-19;18482;6423;74;2;8363;142;3;0;0;174060;17185;1392;12;35280;1666;31;0;0
FR;5;2022-01-20;1920;1067;25;0;1295;34;2;0;0;175980;18252;1417;12;36575;1700;33;0;0
FR;5;2022-01-21;3077;1372;47;1;1675;59;2;0;0;179057;19624;1464;13;38250;1759;35;0;0
FR;5;2022-01-22;10720;3454;33;1;4670;43;1;0;0;189777;23078;1497;14;42920;1802;36;0;0
FR;5;2022-01-23;2629;1415;6;0;1788;10;0;0;0;192406;24493;1503;14;44708;1812;36;0;0
FR;5;2022-01-24;1161;1340;19;0;1446;23;1;0;0;193567;25833;1522;14;46154;1835;37;0;0
FR;5;2022-01-25;1220;1549;20;2;1681;31;3;0;0;194787;27382;1542;16;47835;1866;40;0;0
FR;5;2022-01-26;10750;12032;50;1;13298;89;1;0;1;205537;39414;1592;17;61133;1955;41;0;1
FR;5;2022-01-27;1291;1693;10;0;1838;17;0;0;0;206828;41107;1602;17;62971;1972;41;0;1
FR;5;2022-01-28;1699;3346;16;0;3566;19;1;0;0;208527;44453;1618;17;66537;1991;42;0;1
FR;5;2022-01-29;6241;8041;68;0;8855;96;2;0;0;214768;52494;1686;17;75392;2087;44;0;1
FR;5;2022-01-30;1509;2950;5;0;3185;18;0;0;0;216277;55444;1691;17;78577;2105;44;0;1
FR;5;2022-01-31;589;1773;23;0;1837;24;3;0;0;216866;57217;1714;17;80414;2129;47;0;1
FR;5;2022-02-01;712;1706;10;0;1791;15;0;0;0;217578;58923;1724;17;82205;2144;47;0;1
FR;5;2022-02-02;6958;15655;52;0;16603;94;0;0;0;224536;74578;1776;17;98808;2238;47;0;1
FR;5;2022-02-03;491;1691;14;0;1748;13;5;0;0;225027;76269;1790;17;100556;2251;52;0;1
FR;5;2022-02-04;945;3002;19;0;3123;31;0;0;0;225972;79271;1809;17;103679;2282;52;0;1
FR;5;2022-02-05;3535;8919;23;0;9517;37;0;0;0;229507;88190;1832;17;113196;2319;52;0;1
FR;5;2022-02-06;737;2397;10;0;2556;19;0;0;0;230244;90587;1842;17;115752;2338;52;0;1
FR;5;2022-02-07;884;1596;23;0;1715;25;2;0;0;231128;92183;1865;17;117467;2363;54;0;1
FR;5;2022-02-08;725;1287;18;0;1407;20;2;0;0;231853;93470;1883;17;118874;2383;56;0;1
FR;5;2022-02-09;4544;12880;44;0;13608;76;1;0;0;236397;106350;1927;17;132482;2459;57;0;1
FR;5;2022-02-10;646;1059;14;0;1166;15;0;0;0;237043;107409;1941;17;133648;2474;57;0;1
FR;5;2022-02-11;793;2032;16;0;2163;21;1;0;0;237836;109441;1957;17;135811;2495;58;0;1
FR;5;2022-02-12;2286;6812;33;0;7279;53;0;0;0;240122;116253;1990;17;143090;2548;58;0;1
FR;5;2022-02-13;464;1540;8;0;1653;8;1;0;0;240586;117793;1998;17;144743;2556;59;0;1
FR;5;2022-02-14;678;1288;10;0;1407;13;1;0;0;241264;119081;2008;17;146150;2569;60;0;1
FR;5;2022-02-15;482;886;9;0;968;14;1;0;0;241746;119967;2017;17;147118;2583;61;0;1
FR;5;2022-02-16;2980;9124;41;1;9676;58;2;0;0;244726;129091;2058;18;156794;2641;63;0;1
FR;5;2022-02-17;436;809;6;0;876;7;1;0;0;245162;129900;2064;18;157670;2648;64;0;1
FR;5;2022-02-18;649;1408;13;0;1535;17;0;0;0;245811;131308;2077;18;159205;2665;64;0;1
FR;5;2022-02-19;1373;4315;16;0;4623;28;0;0;0;247184;135623;2093;18;163828;2693;64;0;1
FR;5;2022-02-20;247;879;6;0;941;8;0;0;0;247431;136502;2099;18;164769;2701;64;0;1
FR;5;2022-02-21;221;607;2;0;661;4;1;0;0;247652;137109;2101;18;165430;2705;65;0;1
FR;5;2022-02-22;262;545;17;0;592;17;1;0;0;247914;137654;2118;18;166022;2722;66;0;1
FR;5;2022-02-23;1909;6926;23;1;7346;43;0;0;0;249823;144580;2141;19;173368;2765;66;0;1
FR;5;2022-02-24;182;374;6;1;421;7;1;0;0;250005;144954;2147;20;173789;2772;67;0;1
FR;5;2022-02-25;336;950;13;0;1027;12;2;0;0;250341;145904;2160;20;174816;2784;69;0;1
FR;5;2022-02-26;972;3071;11;0;3333;15;2;0;0;251313;148975;2171;20;178149;2799;71;0;1
FR;5;2022-02-27;151;506;0;0;549;3;0;0;0;251464;149481;2171;20;178698;2802;71;0;1
FR;5;2022-02-28;162;369;1;0;408;1;0;0;0;251626;149850;2172;20;179106;2803;71;0;1
FR;5;2022-03-01;130;280;6;0;315;7;1;0;0;251756;150130;2178;20;179421;2810;72;0;1
FR;5;2022-03-02;1241;4156;28;3;4497;40;3;0;0;252997;154286;2206;23;183918;2850;75;0;1
FR;5;2022-03-03;121;251;5;0;271;10;1;0;0;253118;154537;2211;23;184189;2860;76;0;1
FR;5;2022-03-04;197;488;13;0;538;14;2;0;0;253315;155025;2224;23;184727;2874;78;0;1
FR;5;2022-03-05;677;1990;8;0;2244;16;2;0;0;253992;157015;2232;23;186971;2890;80;0;1
FR;5;2022-03-06;108;260;0;0;310;0;0;0;0;254100;157275;2232;23;187281;2890;80;0;1
FR;5;2022-03-07;71;228;5;0;254;3;2;0;0;254171;157503;2237;23;187535;2893;82;0;1
FR;5;2022-03-08;46;134;7;1;141;8;3;0;0;254217;157637;2244;24;187676;2901;85;0;1
FR;5;2022-03-09;910;3078;24;0;3408;36;0;0;0;255127;160715;2268;24;191084;2937;85;0;1
FR;5;2022-03-10;82;202;9;0;215;13;3;0;0;255209;160917;2277;24;191299;2950;88;0;1
FR;5;2022-03-11;148;369;13;1;427;15;0;0;0;255357;161286;2290;25;191726;2965;88;0;1
FR;5;2022-03-12;758;1613;13;1;1976;30;0;0;0;256115;162899;2303;26;193702;2995;88;0;1
FR;5;2022-03-13;78;100;0;0;133;0;0;0;0;256193;162999;2303;26;193835;2995;88;0;1
FR;5;2022-03-14;67;119;7;1;139;7;1;0;0;256260;163118;2310;27;193974;3002;89;0;1
FR;5;2022-03-15;83;99;4;0;119;7;1;0;0;256343;163217;2314;27;194093;3009;90;0;1
FR;5;2022-03-16;882;1827;15;3;2228;36;7;0;0;257225;165044;2329;30;196321;3045;97;0;1
FR;5;2022-03-17;68;123;8;4;151;10;4;0;0;257293;165167;2337;34;196472;3055;101;0;1
FR;5;2022-03-18;172;318;13;4;390;18;4;0;0;257465;165485;2350;38;196862;3073;105;0;1
FR;5;2022-03-19;752;1163;12;5;1555;33;8;0;0;258217;166648;2362;43;198417;3106;113;0;1
FR;5;2022-03-20;45;93;1;0;119;1;0;0;0;258262;166741;2363;43;198536;3107;113;0;1
FR;5;2022-03-21;71;120;10;6;136;15;8;0;0;258333;166861;2373;49;198672;3122;121;0;1
FR;5;2022-03-22;56;119;8;7;143;9;6;0;0;258389;166980;2381;56;198815;3131;127;0;1
FR;5;2022-03-23;805;1461;14;8;1878;36;9;0;0;259194;168441;2395;64;200693;3167;136;0;1
FR;5;2022-03-24;71;93;8;7;118;7;10;0;0;259265;168534;2403;71;200811;3174;146;0;1
FR;5;2022-03-25;222;293;14;8;388;18;9;0;0;259487;168827;2417;79;201199;3192;155;0;1
FR;5;2022-03-26;707;853;12;5;1273;26;6;0;1;260194;169680;2429;84;202472;3218;161;0;2
FR;5;2022-03-27;75;81;0;0;124;3;0;0;0;260269;169761;2429;84;202596;3221;161;0;2
FR;5;2022-03-28;81;93;1;2;132;3;2;0;0;260350;169854;2430;86;202728;3224;163;0;2
FR;5;2022-03-29;71;82;10;4;113;12;5;0;0;260421;169936;2440;90;202841;3236;168;0;2
FR;5;2022-03-30;823;1116;16;13;1606;29;14;0;0;261244;171052;2456;103;204447;3265;182;0;2
FR;5;2022-03-31;102;125;1;4;173;6;4;0;0;261346;171177;2457;107;204620;3271;186;0;2
FR;5;2022-04-01;114;86;7;12;135;11;12;0;1;261460;171263;2464;119;204755;3282;198;0;3
FR;5;2022-04-02;330;349;3;3;535;15;4;0;0;261790;171612;2467;122;205290;3297;202;0;3
FR;5;2022-04-03;54;59;1;0;88;1;0;0;0;261844;171671;2468;122;205378;3298;202;0;3
FR;5;2022-04-04;40;57;4;1;70;8;2;0;0;261884;171728;2472;123;205448;3306;204;0;3
FR;5;2022-04-05;53;60;6;6;75;9;5;0;0;261937;171788;2478;129;205523;3315;209;0;3
FR;5;2022-04-06;421;439;7;14;678;16;14;0;0;262358;172227;2485;143;206201;3331;223;0;3
FR;5;2022-04-07;45;69;5;7;89;7;10;0;0;262403;172296;2490;150;206290;3338;233;0;3
FR;5;2022-04-08;134;112;12;13;174;14;15;0;0;262537;172408;2502;163;206464;3352;248;0;3
FR;5;2022-04-09;311;324;2;5;511;17;5;0;0;262848;172732;2504;168;206975;3369;253;0;3
FR;5;2022-04-10;44;31;2;0;61;2;1;0;0;262892;172763;2506;168;207036;3371;254;0;3
FR;5;2022-04-11;50;60;3;2;78;4;3;0;0;262942;172823;2509;170;207114;3375;257;0;3
FR;5;2022-04-12;59;54;3;3;78;5;3;0;0;263001;172877;2512;173;207192;3380;260;0;3
FR;5;2022-04-13;382;413;3;8;606;16;8;0;0;263383;173290;2515;181;207798;3396;268;0;3
FR;5;2022-04-14;48;53;5;5;70;9;3;0;0;263431;173343;2520;186;207868;3405;271;0;3
FR;5;2022-04-15;91;109;4;4;150;5;6;0;0;263522;173452;2524;190;208018;3410;277;0;3
FR;5;2022-04-16;188;184;2;1;265;13;1;0;0;263710;173636;2526;191;208283;3423;278;0;3
FR;5;2022-04-17;12;11;1;0;17;1;0;0;0;263722;173647;2527;191;208300;3424;278;0;3
FR;5;2022-04-18;9;10;2;0;11;3;1;0;0;263731;173657;2529;191;208311;3427;279;0;3
FR;5;2022-04-19;75;71;6;1;96;6;4;0;0;263806;173728;2535;192;208407;3433;283;0;3
FR;5;2022-04-20;361;349;9;6;522;12;7;0;0;264167;174077;2544;198;208929;3445;290;0;3
FR;5;2022-04-21;42;64;9;10;71;12;14;0;0;264209;174141;2553;208;209000;3457;304;0;3
FR;5;2022-04-22;113;96;5;4;144;5;5;0;0;264322;174237;2558;212;209144;3462;309;0;3
FR;5;2022-04-23;209;193;4;2;284;11;3;0;0;264531;174430;2562;214;209428;3473;312;0;3
FR;5;2022-04-24;37;35;0;0;50;3;0;0;0;264568;174465;2562;214;209478;3476;312;0;3
FR;5;2022-04-25;69;65;1;1;102;4;1;0;0;264637;174530;2563;215;209580;3480;313;0;3
FR;5;2022-04-26;60;63;2;1;85;5;1;0;0;264697;174593;2565;216;209665;3485;314;0;3
FR;5;2022-04-27;335;316;3;7;463;14;8;0;0;265032;174909;2568;223;210128;3499;322;0;3
FR;5;2022-04-28;81;54;4;5;81;8;7;0;0;265113;174963;2572;228;210209;3507;329;0;3
FR;5;2022-04-29;117;84;5;19;117;12;17;0;0;265230;175047;2577;247;210326;3519;346;0;3
FR;5;2022-04-30;183;114;2;3;184;10;4;0;0;265413;175161;2579;250;210510;3529;350;0;3
FR;5;2022-05-01;11;7;0;0;11;0;0;0;0;265424;175168;2579;250;210521;3529;350;0;3
FR;5;2022-05-02;52;28;4;5;48;2;7;0;0;265476;175196;2583;255;210569;3531;357;0;3
FR;5;2022-05-03;87;57;2;4;84;11;4;0;0;265563;175253;2585;259;210653;3542;361;0;3
FR;5;2022-05-04;278;205;1;2;324;7;2;0;0;265841;175458;2586;261;210977;3549;363;0;3
FR;5;2022-05-05;62;32;3;4;46;5;4;0;0;265903;175490;2589;265;211023;3554;367;0;3
FR;5;2022-05-06;105;65;2;3;106;5;3;0;0;266008;175555;2591;268;211129;3559;370;0;3
FR;5;2022-05-07;171;117;2;10;180;13;7;0;0;266179;175672;2593;278;211309;3572;377;0;3
FR;5;2022-05-08;8;8;0;0;9;2;0;0;0;266187;175680;2593;278;211318;3574;377;0;3
FR;5;2022-05-09;44;34;15;3;51;16;4;0;0;266231;175714;2608;281;211369;3590;381;0;3
FR;5;2022-05-10;54;49;3;4;67;5;5;0;0;266285;175763;2611;285;211436;3595;386;0;3
FR;5;2022-05-11;327;237;12;7;344;21;11;0;0;266612;176000;2623;292;211780;3616;397;0;3
FR;5;2022-05-12;46;34;2;2;46;2;3;0;0;266658;176034;2625;294;211826;3618;400;0;3
FR;5;2022-05-13;109;83;3;8;119;8;7;0;0;266767;176117;2628;302;211945;3626;407;0;3
FR;5;2022-05-14;209;131;0;1;212;8;0;0;0;266976;176248;2628;303;212157;3634;407;0;3
FR;5;2022-05-15;22;9;2;0;18;1;1;0;0;266998;176257;2630;303;212175;3635;408;0;3
FR;5;2022-05-16;52;34;4;5;53;4;5;0;0;267050;176291;2634;308;212228;3639;413;0;3
FR;5;2022-05-17;72;40;5;0;68;2;3;0;0;267122;176331;2639;308;212296;3641;416;0;3
FR;5;2022-05-18;289;215;4;4;330;8;6;0;0;267411;176546;2643;312;212626;3649;422;0;3
FR;5;2022-05-19;45;35;5;3;42;3;4;0;0;267456;176581;2648;315;212668;3652;426;0;3
FR;5;2022-05-20;76;63;3;10;92;1;11;0;0;267532;176644;2651;325;212760;3653;437;0;3
FR;5;2022-05-21;242;166;2;3;268;17;1;0;0;267774;176810;2653;328;213028;3670;438;0;3
FR;5;2022-05-22;20;14;2;5;20;2;6;0;0;267794;176824;2655;333;213048;3672;444;0;3
FR;5;2022-05-23;42;31;4;3;42;6;3;0;0;267836;176855;2659;336;213090;3678;447;0;3
FR;5;2022-05-24;47;45;3;2;60;5;2;0;0;267883;176900;2662;338;213150;3683;449;0;3
FR;5;2022-05-25;329;257;4;1;385;16;1;0;0;268212;177157;2666;339;213535;3699;450;0;3
FR;5;2022-05-26;17;5;0;1;9;2;0;0;1;268229;177162;2666;340;213544;3701;450;0;4
FR;5;2022-05-27;99;54;4;4;89;9;3;0;0;268328;177216;2670;344;213633;3710;453;0;4
FR;5;2022-05-28;100;78;5;3;106;10;3;0;0;268428;177294;2675;347;213739;3720;456;0;4
FR;5;2022-05-29;14;14;1;0;18;2;0;0;0;268442;177308;2676;347;213757;3722;456;0;4
FR;5;2022-05-30;56;41;2;1;54;2;2;0;0;268498;177349;2678;348;213811;3724;458;0;4
FR;5;2022-05-31;57;43;1;8;62;1;8;0;0;268555;177392;2679;356;213873;3725;466;0;4
FR;5;2022-06-01;257;241;9;2;301;25;5;0;0;268812;177633;2688;358;214174;3750;471;0;4
FR;5;2022-06-02;63;61;5;0;73;9;1;0;0;268875;177694;2693;358;214247;3759;472;0;4
FR;5;2022-06-03;82;71;4;5;88;10;6;0;0;268957;177765;2697;363;214335;3769;478;0;4
FR;5;2022-06-04;157;109;2;1;187;9;1;0;0;269114;177874;2699;364;214522;3778;479;0;4
FR;5;2022-06-05;18;11;0;0;21;1;0;0;0;269132;177885;2699;364;214543;3779;479;0;4
FR;5;2022-06-06;16;12;0;1;15;0;1;0;0;269148;177897;2699;365;214558;3779;480;0;4
FR;5;2022-06-07;50;56;1;1;76;2;1;0;0;269198;177953;2700;366;214634;3781;481;0;4
FR;5;2022-06-08;283;225;3;4;332;17;2;0;0;269481;178178;2703;370;214966;3798;483;0;4
FR;5;2022-06-09;52;41;6;3;57;7;2;0;1;269533;178219;2709;373;215023;3805;485;0;5
FR;5;2022-06-10;81;72;1;1;105;6;1;0;0;269614;178291;2710;374;215128;3811;486;0;5
FR;5;2022-06-11;173;141;3;3;202;10;4;0;0;269787;178432;2713;377;215330;3821;490;0;5
FR;5;2022-06-12;17;16;0;0;19;2;0;0;0;269804;178448;2713;377;215349;3823;490;0;5
FR;5;2022-06-13;56;47;9;3;70;10;6;0;0;269860;178495;2722;380;215419;3833;496;0;5
FR;5;2022-06-14;59;56;1;4;64;6;4;0;0;269919;178551;2723;384;215483;3839;500;0;5
FR;5;2022-06-15;266;260;5;2;363;27;1;0;0;270185;178811;2728;386;215846;3866;501;0;5
FR;5;2022-06-16;47;30;5;2;44;5;2;0;0;270232;178841;2733;388;215890;3871;503;0;5
FR;5;2022-06-17;100;67;5;5;102;10;5;0;0;270332;178908;2738;393;215992;3881;508;0;5
FR;5;2022-06-18;146;95;10;2;152;26;2;0;1;270478;179003;2748;395;216144;3907;510;0;6
FR;5;2022-06-19;26;15;0;1;18;4;1;0;0;270504;179018;2748;396;216162;3911;511;0;6
FR;5;2022-06-20;56;50;8;0;62;11;2;0;0;270560;179068;2756;396;216224;3922;513;0;6
FR;5;2022-06-21;52;73;5;3;90;7;5;0;1;270612;179141;2761;399;216314;3929;518;0;7
FR;5;2022-06-22;224;247;7;9;347;33;10;0;0;270836;179388;2768;408;216661;3962;528;0;7
FR;5;2022-06-23;50;38;2;5;43;6;6;0;0;270886;179426;2770;413;216704;3968;534;0;7
FR;5;2022-06-24;91;70;12;5;101;16;8;0;0;270977;179496;2782;418;216805;3984;542;0;7
FR;5;2022-06-25;154;124;3;7;185;14;8;0;1;271131;179620;2785;425;216990;3998;550;0;8
FR;5;2022-06-26;26;19;2;0;29;5;0;0;0;271157;179639;2787;425;217019;4003;550;0;8
FR;5;2022-06-27;57;60;5;7;78;11;9;0;0;271214;179699;2792;432;217097;4014;559;0;8
FR;5;2022-06-28;70;49;8;2;69;14;5;0;0;271284;179748;2800;434;217166;4028;564;0;8
FR;5;2022-06-29;297;268;9;21;391;34;23;0;0;271581;180016;2809;455;217557;4062;587;0;8
FR;5;2022-06-30;89;57;10;12;89;17;11;0;0;271670;180073;2819;467;217646;4079;598;0;8
FR;5;2022-07-01;127;65;7;11;118;12;11;0;2;271797;180138;2826;478;217764;4091;609;0;10
FR;5;2022-07-02;191;132;4;0;209;22;0;0;0;271988;180270;2830;478;217973;4113;609;0;10
FR;5;2022-07-03;30;25;1;0;36;4;0;0;0;272018;180295;2831;478;218009;4117;609;0;10
FR;5;2022-07-04;103;64;2;5;102;6;5;0;1;272121;180359;2833;483;218111;4123;614;0;11
FR;5;2022-07-05;104;72;3;8;107;13;8;0;1;272225;180431;2836;491;218218;4136;622;0;12
FR;5;2022-07-06;277;168;9;36;289;27;36;0;0;272502;180599;2845;527;218507;4163;658;0;12
FR;5;2022-07-07;88;68;6;9;88;13;11;0;0;272590;180667;2851;536;218595;4176;669;0;12
FR;5;2022-07-08;152;120;7;14;146;25;13;0;1;272742;180787;2858;550;218741;4201;682;0;13
FR;5;2022-07-09;116;68;1;8;100;10;8;0;0;272858;180855;2859;558;218841;4211;690;0;13
FR;5;2022-07-10;15;6;0;0;10;1;0;0;0;272873;180861;2859;558;218851;4212;690;0;13
FR;5;2022-07-11;92;72;10;2;98;19;3;0;0;272965;180933;2869;560;218949;4231;693;0;13
FR;5;2022-07-12;67;63;5;10;81;7;12;0;0;273032;180996;2874;570;219030;4238;705;0;13
FR;5;2022-07-13;169;118;10;19;196;16;23;0;0;273201;181114;2884;589;219226;4254;728;0;13
FR;5;2022-07-14;8;4;0;0;7;0;0;0;0;273209;181118;2884;589;219233;4254;728;0;13
FR;5;2022-07-15;74;66;5;14;86;15;15;0;0;273283;181184;2889;603;219319;4269;743;0;13
FR;5;2022-07-16;54;44;3;0;71;3;2;0;0;273337;181228;2892;603;219390;4272;745;0;13
FR;5;2022-07-17;10;7;3;0;10;2;2;0;0;273347;181235;2895;603;219400;4274;747;0;13
FR;5;2022-07-18;60;47;0;4;70;4;3;0;0;273407;181282;2895;607;219470;4278;750;0;13
FR;5;2022-07-19;63;42;5;3;63;7;4;0;0;273470;181324;2900;610;219533;4285;754;0;13
FR;5;2022-07-20;119;106;4;11;141;14;9;0;0;273589;181430;2904;621;219674;4299;763;0;13
FR;5;2022-07-21;38;43;2;10;52;5;10;0;0;273627;181473;2906;631;219726;4304;773;0;13
FR;5;2022-07-22;48;69;11;13;75;23;11;0;1;273675;181542;2917;644;219801;4327;784;0;14
FR;5;2022-07-23;59;78;2;1;95;11;2;0;0;273734;181620;2919;645;219896;4338;786;0;14
FR;5;2022-07-24;11;9;3;1;12;3;1;0;0;273745;181629;2922;646;219908;4341;787;0;14
FR;5;2022-07-25;53;48;2;7;57;8;8;0;0;273798;181677;2924;653;219965;4349;795;0;14
FR;5;2022-07-26;58;52;5;41;70;6;44;0;0;273856;181729;2929;694;220035;4355;839;0;14
FR;5;2022-07-27;106;118;4;4;161;13;4;0;0;273962;181847;2933;698;220196;4368;843;0;14
FR;5;2022-07-28;39;35;2;2;47;6;1;0;0;274001;181882;2935;700;220243;4374;844;0;14
FR;5;2022-07-29;56;74;3;14;90;8;10;0;0;274057;181956;2938;714;220333;4382;854;0;14
FR;5;2022-07-30;55;53;5;1;75;7;2;0;0;274112;182009;2943;715;220408;4389;856;0;14
FR;5;2022-07-31;7;11;1;0;13;1;0;0;0;274119;182020;2944;715;220421;4390;856;0;14
FR;5;2022-08-01;39;53;1;2;62;6;2;0;0;274158;182073;2945;717;220483;4396;858;0;14
FR;5;2022-08-02;32;43;8;7;47;8;7;0;1;274190;182116;2953;724;220530;4404;865;0;15
FR;5;2022-08-03;54;51;4;10;70;9;8;0;0;274244;182167;2957;734;220600;4413;873;0;15
FR;5;2022-08-04;20;18;1;6;22;1;6;0;0;274264;182185;2958;740;220622;4414;879;0;15
FR;5;2022-08-05;35;26;3;3;39;3;3;0;0;274299;182211;2961;743;220661;4417;882;0;15
FR;5;2022-08-06;23;26;1;0;31;1;0;0;0;274322;182237;2962;743;220692;4418;882;0;15
FR;5;2022-08-07;2;2;1;0;1;1;1;0;0;274324;182239;2963;743;220693;4419;883;0;15
FR;5;2022-08-08;26;19;1;2;24;2;1;0;0;274350;182258;2964;745;220717;4421;884;0;15
FR;5;2022-08-09;26;28;3;3;35;3;3;0;0;274376;182286;2967;748;220752;4424;887;0;15
FR;5;2022-08-10;47;47;2;0;56;5;0;0;0;274423;182333;2969;748;220808;4429;887;0;15
FR;5;2022-08-11;19;36;2;2;42;5;2;0;0;274442;182369;2971;750;220850;4434;889;0;15
FR;5;2022-08-12;27;28;2;0;39;2;0;0;0;274469;182397;2973;750;220889;4436;889;0;15
FR;5;2022-08-13;16;18;0;0;24;0;0;0;0;274485;182415;2973;750;220913;4436;889;0;15
FR;5;2022-08-14;2;3;0;0;4;0;0;0;0;274487;182418;2973;750;220917;4436;889;0;15
FR;5;2022-08-15;2;5;0;0;5;0;0;0;0;274489;182423;2973;750;220922;4436;889;0;15
FR;5;2022-08-16;33;26;3;0;28;6;0;0;0;274522;182449;2976;750;220950;4442;889;0;15
FR;5;2022-08-17;52;55;2;1;72;1;1;0;0;274574;182504;2978;751;221022;4443;890;0;15
FR;5;2022-08-18;26;18;8;17;25;10;16;0;0;274600;182522;2986;768;221047;4453;906;0;15
FR;5;2022-08-19;25;33;1;2;41;2;2;0;0;274625;182555;2987;770;221088;4455;908;0;15
FR;5;2022-08-20;25;27;2;1;33;4;2;0;0;274650;182582;2989;771;221121;4459;910;0;15
FR;5;2022-08-21;7;4;1;0;7;1;0;0;0;274657;182586;2990;771;221128;4460;910;0;15
FR;5;2022-08-22;39;26;1;6;42;2;5;0;1;274696;182612;2991;777;221170;4462;915;0;16
FR;5;2022-08-23;27;26;1;1;32;2;1;0;0;274723;182638;2992;778;221202;4464;916;0;16
FR;5;2022-08-24;50;43;0;0;62;0;0;0;0;274773;182681;2992;778;221264;4464;916;0;16
FR;5;2022-08-25;27;26;3;1;31;2;0;0;1;274800;182707;2995;779;221295;4466;916;0;17
FR;5;2022-08-26;48;39;7;2;58;5;4;0;0;274848;182746;3002;781;221353;4471;920;0;17
FR;5;2022-08-27;46;28;1;0;46;3;1;0;0;274894;182774;3003;781;221399;4474;921;0;17
FR;5;2022-08-28;5;6;0;0;6;0;0;0;0;274899;182780;3003;781;221405;4474;921;0;17
FR;5;2022-08-29;58;44;1;1;66;4;1;0;0;274957;182824;3004;782;221471;4478;922;0;17
FR;5;2022-08-30;45;23;12;29;40;10;30;0;1;275002;182847;3016;811;221511;4488;952;0;18
FR;5;2022-08-31;53;47;6;1;58;11;1;0;0;275055;182894;3022;812;221569;4499;953;0;18
FR;5;2022-09-01;16;8;1;4;13;1;4;0;0;275071;182902;3023;816;221582;4500;957;0;18
FR;5;2022-09-02;42;23;8;2;35;9;3;0;0;275113;182925;3031;818;221617;4509;960;0;18
FR;5;2022-09-03;69;37;2;0;58;2;0;0;0;275182;182962;3033;818;221675;4511;960;0;18
FR;5;2022-09-04;12;7;1;0;8;3;0;0;0;275194;182969;3034;818;221683;4514;960;0;18
FR;5;2022-09-05;7;4;1;0;4;1;0;0;0;275201;182973;3035;818;221687;4515;960;0;18
FR;5;2022-09-06;21;14;3;15;17;2;14;0;2;275222;182987;3038;833;221704;4517;974;0;20
FR;5;2022-09-07;79;53;1;1;76;3;1;0;0;275301;183040;3039;834;221780;4520;975;0;20
FR;5;2022-09-08;9;4;0;4;7;0;4;0;0;275310;183044;3039;838;221787;4520;979;0;20
FR;5;2022-09-09;40;11;9;2;14;10;3;0;0;275350;183055;3048;840;221801;4530;982;0;20
FR;5;2022-09-10;40;45;1;1;50;8;1;0;0;275390;183100;3049;841;221851;4538;983;0;20
FR;5;2022-09-11;3;3;0;0;3;1;0;0;0;275393;183103;3049;841;221854;4539;983;0;20
FR;5;2022-09-12;7;5;2;2;7;2;2;0;0;275400;183108;3051;843;221861;4541;985;0;20
FR;5;2022-09-13;9;6;0;1;4;3;1;0;0;275409;183114;3051;844;221865;4544;986;0;20
FR;5;2022-09-14;52;47;4;6;55;9;5;0;0;275461;183161;3055;850;221920;4553;991;0;20
FR;5;2022-09-15;11;13;2;3;11;5;3;0;0;275472;183174;3057;853;221931;4558;994;0;20
FR;5;2022-09-16;25;33;1;4;38;3;3;0;0;275497;183207;3058;857;221969;4561;997;0;20
FR;5;2022-09-17;60;43;1;1;51;5;1;0;0;275557;183250;3059;858;222020;4566;998;0;20
FR;5;2022-09-18;9;6;0;1;10;1;0;0;0;275566;183256;3059;859;222030;4567;998;0;20
FR;5;2022-09-19;22;17;2;1;20;5;2;0;0;275588;183273;3061;860;222050;4572;1000;0;20
FR;5;2022-09-20;15;11;3;3;15;1;4;0;0;275603;183284;3064;863;222065;4573;1004;0;20
FR;5;2022-09-21;68;45;9;0;65;13;0;0;0;275671;183329;3073;863;222130;4586;1004;0;20
FR;5;2022-09-22;12;6;4;24;6;4;23;0;1;275683;183335;3077;887;222136;4590;1027;0;21
FR;5;2022-09-23;20;25;2;3;23;8;3;0;0;275703;183360;3079;890;222159;4598;1030;0;21
FR;5;2022-09-24;44;51;1;8;65;5;8;0;0;275747;183411;3080;898;222224;4603;1038;0;21
FR;5;2022-09-25;6;12;0;0;13;1;0;0;0;275753;183423;3080;898;222237;4604;1038;0;21
FR;5;2022-09-26;15;7;0;2;12;0;1;0;1;275768;183430;3080;900;222249;4604;1039;0;22
FR;5;2022-09-27;7;12;4;9;14;4;9;0;1;275775;183442;3084;909;222263;4608;1048;0;23
FR;5;2022-09-28;65;64;5;0;88;7;0;0;0;275840;183506;3089;909;222351;4615;1048;0;23
FR;5;2022-09-29;17;9;1;0;15;1;1;0;1;275857;183515;3090;909;222366;4616;1049;0;24
FR;5;2022-09-30;28;46;2;2;53;4;3;0;0;275885;183561;3092;911;222419;4620;1052;0;24
FR;5;2022-10-01;40;35;5;5;48;8;7;0;0;275925;183596;3097;916;222467;4628;1059;0;24
FR;5;2022-10-02;1;9;1;0;10;1;0;0;0;275926;183605;3098;916;222477;4629;1059;0;24
FR;5;2022-10-03;7;6;3;0;5;4;0;0;0;275933;183611;3101;916;222482;4633;1059;0;24
FR;5;2022-10-04;11;8;1;3;11;2;3;0;0;275944;183619;3102;919;222493;4635;1062;0;24
FR;5;2022-10-05;57;62;2;2;79;13;2;0;0;276001;183681;3104;921;222572;4648;1064;0;24
FR;5;2022-10-06;12;10;1;4;15;2;4;0;0;276013;183691;3105;925;222587;4650;1068;0;24
FR;5;2022-10-07;21;31;1;0;34;5;0;0;0;276034;183722;3106;925;222621;4655;1068;0;24
FR;5;2022-10-08;33;51;1;0;54;7;0;0;0;276067;183773;3107;925;222675;4662;1068;0;24
FR;5;2022-10-09;7;10;0;0;11;1;0;0;0;276074;183783;3107;925;222686;4663;1068;0;24
FR;5;2022-10-10;14;6;0;1;8;1;1;0;0;276088;183789;3107;926;222694;4664;1069;0;24
FR;5;2022-10-11;6;13;2;1;14;2;2;0;0;276094;183802;3109;927;222708;4666;1071;0;24
FR;5;2022-10-12;39;57;3;2;69;8;2;0;0;276133;183859;3112;929;222777;4674;1073;0;24
FR;5;2022-10-13;11;16;2;0;18;4;0;0;0;276144;183875;3114;929;222795;4678;1073;0;24
FR;5;2022-10-14;21;21;1;0;20;5;0;0;0;276165;183896;3115;929;222815;4683;1073;0;24
FR;5;2022-10-15;19;26;10;0;24;11;2;0;0;276184;183922;3125;929;222839;4694;1075;0;24
FR;5;2022-10-16;3;1;0;0;1;1;0;0;0;276187;183923;3125;929;222840;4695;1075;0;24
FR;5;2022-10-17;8;8;2;1;8;3;1;0;2;276195;183931;3127;930;222848;4698;1076;0;26
FR;5;2022-10-18;6;7;0;2;8;0;2;0;0;276201;183938;3127;932;222856;4698;1078;0;26
FR;5;2022-10-19;38;43;8;0;52;11;0;0;1;276239;183981;3135;932;222908;4709;1078;0;27
FR;5;2022-10-20;18;15;2;1;16;3;1;0;0;276257;183996;3137;933;222924;4712;1079;0;27
FR;5;2022-10-21;22;15;6;0;19;8;1;0;2;276279;184011;3143;933;222943;4720;1080;0;29
FR;5;2022-10-22;34;29;2;12;32;5;12;0;0;276313;184040;3145;945;222975;4725;1092;0;29
FR;5;2022-10-23;9;3;0;0;4;0;0;0;0;276322;184043;3145;945;222979;4725;1092;0;29
FR;5;2022-10-24;14;7;6;7;9;9;8;0;0;276336;184050;3151;952;222988;4734;1100;0;29
FR;5;2022-10-25;12;9;6;3;9;8;3;0;2;276348;184059;3157;955;222997;4742;1103;0;31
FR;5;2022-10-26;34;22;6;0;29;10;0;0;0;276382;184081;3163;955;223026;4752;1103;0;31
FR;5;2022-10-27;16;4;4;0;11;4;0;0;0;276398;184085;3167;955;223037;4756;1103;0;31
FR;5;2022-10-28;19;13;5;3;14;6;4;0;0;276417;184098;3172;958;223051;4762;1107;0;31
FR;5;2022-10-29;21;13;0;0;17;3;0;0;0;276438;184111;3172;958;223068;4765;1107;0;31
FR;5;2022-10-30;1;4;2;0;4;3;0;0;0;276439;184115;3174;958;223072;4768;1107;0;31
FR;5;2022-10-31;14;11;2;1;12;3;1;0;0;276453;184126;3176;959;223084;4771;1108;0;31
FR;5;2022-11-01;3;3;0;1;3;0;1;0;0;276456;184129;3176;960;223087;4771;1109;0;31
FR;5;2022-11-02;23;17;5;4;23;5;5;0;0;276479;184146;3181;964;223110;4776;1114;0;31
FR;5;2022-11-03;22;4;1;1;11;1;1;0;0;276501;184150;3182;965;223121;4777;1115;0;31
FR;5;2022-11-04;19;18;1;0;18;2;0;0;0;276520;184168;3183;965;223139;4779;1115;0;31
FR;5;2022-11-05;25;16;1;0;21;1;0;0;0;276545;184184;3184;965;223160;4780;1115;0;31
FR;5;2022-11-06;1;7;0;0;7;0;0;0;0;276546;184191;3184;965;223167;4780;1115;0;31
FR;5;2022-11-07;4;3;3;0;3;3;0;0;0;276550;184194;3187;965;223170;4783;1115;0;31
FR;5;2022-11-08;11;7;1;2;8;1;1;0;0;276561;184201;3188;967;223178;4784;1116;0;31
FR;5;2022-11-09;28;29;6;1;32;6;1;0;0;276589;184230;3194;968;223210;4790;1117;0;31
FR;5;2022-11-10;11;16;1;0;17;1;0;0;0;276600;184246;3195;968;223227;4791;1117;0;31
FR;5;2022-11-11;2;4;0;1;6;0;1;0;0;276602;184250;3195;969;223233;4791;1118;0;31
FR;5;2022-11-12;19;10;5;9;18;6;9;0;2;276621;184260;3200;978;223251;4797;1127;0;33
FR;5;2022-11-13;2;2;0;1;2;0;1;0;0;276623;184262;3200;979;223253;4797;1128;0;33
FR;5;2022-11-14;8;10;0;1;9;3;0;0;0;276631;184272;3200;980;223262;4800;1128;0;33
FR;5;2022-11-15;8;6;4;3;6;4;3;0;0;276639;184278;3204;983;223268;4804;1131;0;33
FR;5;2022-11-16;29;28;2;1;32;5;0;0;0;276668;184306;3206;984;223300;4809;1131;0;33
FR;5;2022-11-17;6;15;2;0;15;3;0;0;0;276674;184321;3208;984;223315;4812;1131;0;33
FR;5;2022-11-18;16;17;6;0;19;8;0;0;0;276690;184338;3214;984;223334;4820;1131;0;33
FR;5;2022-11-19;18;27;2;0;28;6;0;0;0;276708;184365;3216;984;223362;4826;1131;0;33
FR;5;2022-11-20;6;3;0;0;5;0;0;0;0;276714;184368;3216;984;223367;4826;1131;0;33
FR;5;2022-11-21;8;5;0;2;4;2;1;0;0;276722;184373;3216;986;223371;4828;1132;0;33
FR;5;2022-11-22;9;3;0;1;4;0;1;0;0;276731;184376;3216;987;223375;4828;1133;0;33
FR;5;2022-11-23;34;25;6;1;27;13;0;0;0;276765;184401;3222;988;223402;4841;1133;0;33
FR;5;2022-11-24;3;7;2;1;8;1;2;0;0;276768;184408;3224;989;223410;4842;1135;0;33
FR;5;2022-11-25;15;20;2;0;25;3;0;0;1;276783;184428;3226;989;223435;4845;1135;0;34
FR;5;2022-11-26;22;19;4;0;20;8;0;0;0;276805;184447;3230;989;223455;4853;1135;0;34
FR;5;2022-11-27;7;0;1;0;2;1;0;0;0;276812;184447;3231;989;223457;4854;1135;0;34
FR;5;2022-11-28;7;11;3;0;11;5;0;0;0;276819;184458;3234;989;223468;4859;1135;0;34
FR;5;2022-11-29;10;9;1;0;11;3;0;0;1;276829;184467;3235;989;223479;4862;1135;0;35
FR;5;2022-11-30;34;48;12;0;55;17;1;0;0;276863;184515;3247;989;223534;4879;1136;0;35
FR;5;2022-12-01;4;8;2;0;8;3;0;0;0;276867;184523;3249;989;223542;4882;1136;0;35
FR;5;2022-12-02;1;5;2;1;4;3;1;0;0;276868;184528;3251;990;223546;4885;1137;0;35
FR;5;2022-12-03;3;3;8;1;5;8;1;0;0;276871;184531;3259;991;223551;4893;1138;0;35
FR;5;2022-12-04;3;2;1;0;2;2;0;0;0;276874;184533;3260;991;223553;4895;1138;0;35
FR;5;2022-12-05;0;1;0;0;0;1;0;0;0;276874;184534;3260;991;223553;4896;1138;0;35
FR;5;2022-12-06;4;1;0;0;1;0;0;0;1;276878;184535;3260;991;223554;4896;1138;0;36
FR;5;2022-12-07;5;8;1;0;9;1;0;0;0;276883;184543;3261;991;223563;4897;1138;0;36
FR;5;2022-12-08;2;2;0;0;2;0;0;0;0;276885;184545;3261;991;223565;4897;1138;0;36
FR;5;2022-12-09;3;8;0;0;6;2;0;0;0;276888;184553;3261;991;223571;4899;1138;0;36
FR;5;2022-12-10;4;7;2;1;8;2;1;0;0;276892;184560;3263;992;223579;4901;1139;0;36
FR;5;2022-12-11;2;0;0;0;0;0;0;0;0;276894;184560;3263;992;223579;4901;1139;0;36
FR;5;2022-12-12;0;0;0;0;0;0;0;0;0;276894;184560;3263;992;223579;4901;1139;0;36
FR;5;2022-12-13;2;3;0;0;4;1;0;0;0;276896;184563;3263;992;223583;4902;1139;0;36
FR;5;2022-12-14;1;2;0;9;2;1;8;0;3;276897;184565;3263;1001;223585;4903;1147;0;39
FR;5;2022-12-15;0;2;0;0;2;0;0;0;0;276897;184567;3263;1001;223587;4903;1147;0;39
FR;5;2022-12-16;3;2;2;0;3;3;0;0;0;276900;184569;3265;1001;223590;4906;1147;0;39
FR;5;2022-12-17;3;3;3;0;3;2;1;0;0;276903;184572;3268;1001;223593;4908;1148;0;39
FR;5;2022-12-18;3;0;0;1;0;0;1;0;1;276906;184572;3268;1002;223593;4908;1149;0;40
FR;5;2022-12-19;1;0;0;2;0;0;2;0;0;276907;184572;3268;1004;223593;4908;1151;0;40
FR;5;2022-12-20;0;1;3;0;1;3;0;0;0;276907;184573;3271;1004;223594;4911;1151;0;40
FR;5;2022-12-21;2;4;0;0;4;0;0;0;0;276909;184577;3271;1004;223598;4911;1151;0;40
FR;5;2022-12-22;2;1;0;0;1;0;0;0;0;276911;184578;3271;1004;223599;4911;1151;0;40
FR;5;2022-12-23;3;1;0;0;1;0;0;0;0;276914;184579;3271;1004;223600;4911;1151;0;40
FR;5;2022-12-24;0;1;0;0;1;0;0;0;0;276914;184580;3271;1004;223601;4911;1151;0;40
FR;5;2022-12-25;0;1;0;0;0;1;0;0;0;276914;184581;3271;1004;223601;4912;1151;0;40
FR;5;2022-12-26;2;0;0;0;0;0;0;0;0;276916;184581;3271;1004;223601;4912;1151;0;40
FR;5;2022-12-27;0;3;0;0;3;0;0;0;0;276916;184584;3271;1004;223604;4912;1151;0;40
FR;5;2022-12-28;5;2;3;0;2;3;2;0;0;276921;184586;3274;1004;223606;4915;1153;0;40
FR;5;2022-12-29;3;2;2;0;3;2;0;0;0;276924;184588;3276;1004;223609;4917;1153;0;40
FR;5;2022-12-30;0;1;1;0;1;1;0;0;0;276924;184589;3277;1004;223610;4918;1153;0;40
FR;5;2022-12-31;0;0;0;0;0;0;0;0;0;276924;184589;3277;1004;223610;4918;1153;0;40
FR;5;2023-01-01;0;0;0;0;0;0;0;0;0;276924;184589;3277;1004;223610;4918;1153;0;40
FR;5;2023-01-02;1;1;1;0;1;1;0;0;0;276925;184590;3278;1004;223611;4919;1153;0;40
FR;6;2020-12-27;0;0;0;0;0;0;0;0;0;0;0;0;0;0;0;0;0;0
FR;6;2020-12-28;0;0;0;0;0;0;0;0;0;0;0;0;0;0;0;0;0;0
FR;6;2020-12-29;0;0;0;0;0;0;0;0;0;0;0;0;0;0;0;0;0;0
FR;6;2020-12-30;0;0;0;0;0;0;0;0;0;0;0;0;0;0;0;0;0;0
FR;6;2020-12-31;0;0;0;0;0;0;0;0;0;0;0;0;0;0;0;0;0;0
FR;6;2021-01-01;0;0;0;0;0;0;0;0;0;0;0;0;0;0;0;0;0;0
FR;6;2021-01-02;0;0;0;0;0;0;0;0;0;0;0;0;0;0;0;0;0;0
FR;6;2021-01-03;0;0;0;0;0;0;0;0;0;0;0;0;0;0;0;0;0;0
FR;6;2021-01-04;0;0;0;0;0;0;0;0;0;0;0;0;0;0;0;0;0;0
FR;6;2021-01-05;0;0;0;0;0;0;0;0;0;0;0;0;0;0;0;0;0;0
FR;6;2021-01-06;0;0;0;0;0;0;0;0;0;0;0;0;0;0;0;0;0;0
FR;6;2021-01-07;0;0;0;0;0;0;0;0;0;0;0;0;0;0;0;0;0;0
FR;6;2021-01-08;0;0;0;0;0;0;0;0;0;0;0;0;0;0;0;0;0;0
FR;6;2021-01-09;0;0;0;0;0;0;0;0;0;0;0;0;0;0;0;0;0;0
FR;6;2021-01-10;0;0;0;0;0;0;0;0;0;0;0;0;0;0;0;0;0;0
FR;6;2021-01-11;0;0;0;0;0;0;0;0;0;0;0;0;0;0;0;0;0;0
FR;6;2021-01-12;0;0;0;0;0;0;0;0;0;0;0;0;0;0;0;0;0;0
FR;6;2021-01-13;0;0;0;0;0;0;0;0;0;0;0;0;0;0;0;0;0;0
FR;6;2021-01-14;0;0;0;0;0;0;0;0;0;0;0;0;0;0;0;0;0;0
FR;6;2021-01-15;0;0;0;0;0;0;0;0;0;0;0;0;0;0;0;0;0;0
FR;6;2021-01-16;0;0;0;0;0;0;0;0;0;0;0;0;0;0;0;0;0;0
FR;6;2021-01-17;0;0;0;0;0;0;0;0;0;0;0;0;0;0;0;0;0;0
FR;6;2021-01-18;0;0;0;0;0;0;0;0;0;0;0;0;0;0;0;0;0;0
FR;6;2021-01-19;0;0;0;0;0;0;0;0;0;0;0;0;0;0;0;0;0;0
FR;6;2021-01-20;0;0;0;0;0;0;0;0;0;0;0;0;0;0;0;0;0;0
FR;6;2021-01-21;0;0;0;0;0;0;0;0;0;0;0;0;0;0;0;0;0;0
FR;6;2021-01-22;0;0;0;0;0;0;0;0;0;0;0;0;0;0;0;0;0;0
FR;6;2021-01-23;0;0;0;0;0;0;0;0;0;0;0;0;0;0;0;0;0;0
FR;6;2021-01-24;0;0;0;0;0;0;0;0;0;0;0;0;0;0;0;0;0;0
FR;6;2021-01-25;0;0;0;0;0;0;0;0;0;0;0;0;0;0;0;0;0;0
FR;6;2021-01-26;0;0;0;0;0;0;0;0;0;0;0;0;0;0;0;0;0;0
FR;6;2021-01-27;0;0;0;0;0;0;0;0;0;0;0;0;0;0;0;0;0;0
FR;6;2021-01-28;0;0;0;0;0;0;0;0;0;0;0;0;0;0;0;0;0;0
FR;6;2021-01-29;0;0;0;0;0;0;0;0;0;0;0;0;0;0;0;0;0;0
FR;6;2021-01-30;0;0;0;0;0;0;0;0;0;0;0;0;0;0;0;0;0;0
FR;6;2021-01-31;0;0;0;0;0;0;0;0;0;0;0;0;0;0;0;0;0;0
FR;6;2021-02-01;0;0;0;0;0;0;0;0;0;0;0;0;0;0;0;0;0;0
FR;6;2021-02-02;0;0;0;0;0;0;0;0;0;0;0;0;0;0;0;0;0;0
FR;6;2021-02-03;0;0;0;0;0;0;0;0;0;0;0;0;0;0;0;0;0;0
FR;6;2021-02-04;0;0;0;0;0;0;0;0;0;0;0;0;0;0;0;0;0;0
FR;6;2021-02-05;0;0;0;0;0;0;0;0;0;0;0;0;0;0;0;0;0;0
FR;6;2021-02-06;0;0;0;0;0;0;0;0;0;0;0;0;0;0;0;0;0;0
FR;6;2021-02-07;0;0;0;0;0;0;0;0;0;0;0;0;0;0;0;0;0;0
FR;6;2021-02-08;0;0;0;0;0;0;0;0;0;0;0;0;0;0;0;0;0;0
FR;6;2021-02-09;0;0;0;0;0;0;0;0;0;0;0;0;0;0;0;0;0;0
FR;6;2021-02-10;0;0;0;0;0;0;0;0;0;0;0;0;0;0;0;0;0;0
FR;6;2021-02-11;0;0;0;0;0;0;0;0;0;0;0;0;0;0;0;0;0;0
FR;6;2021-02-12;0;0;0;0;0;0;0;0;0;0;0;0;0;0;0;0;0;0
FR;6;2021-02-13;0;0;0;0;0;0;0;0;0;0;0;0;0;0;0;0;0;0
FR;6;2021-02-14;0;0;0;0;0;0;0;0;0;0;0;0;0;0;0;0;0;0
FR;6;2021-02-15;0;0;0;0;0;0;0;0;0;0;0;0;0;0;0;0;0;0
FR;6;2021-02-16;0;0;0;0;0;0;0;0;0;0;0;0;0;0;0;0;0;0
FR;6;2021-02-17;0;0;0;0;0;0;0;0;0;0;0;0;0;0;0;0;0;0
FR;6;2021-02-18;0;0;0;0;0;0;0;0;0;0;0;0;0;0;0;0;0;0
FR;6;2021-02-19;0;0;0;0;0;0;0;0;0;0;0;0;0;0;0;0;0;0
FR;6;2021-02-20;0;0;0;0;0;0;0;0;0;0;0;0;0;0;0;0;0;0
FR;6;2021-02-21;0;0;0;0;0;0;0;0;0;0;0;0;0;0;0;0;0;0
FR;6;2021-02-22;0;0;0;0;0;0;0;0;0;0;0;0;0;0;0;0;0;0
FR;6;2021-02-23;0;0;0;0;0;0;0;0;0;0;0;0;0;0;0;0;0;0
FR;6;2021-02-24;0;0;0;0;0;0;0;0;0;0;0;0;0;0;0;0;0;0
FR;6;2021-02-25;0;0;0;0;0;0;0;0;0;0;0;0;0;0;0;0;0;0
FR;6;2021-02-26;0;0;0;0;0;0;0;0;0;0;0;0;0;0;0;0;0;0
FR;6;2021-02-27;0;0;0;0;0;0;0;0;0;0;0;0;0;0;0;0;0;0
FR;6;2021-02-28;0;0;0;0;0;0;0;0;0;0;0;0;0;0;0;0;0;0
FR;6;2021-03-01;0;0;0;0;0;0;0;0;0;0;0;0;0;0;0;0;0;0
FR;6;2021-03-02;0;0;0;0;0;0;0;0;0;0;0;0;0;0;0;0;0;0
FR;6;2021-03-03;0;0;0;0;0;0;0;0;0;0;0;0;0;0;0;0;0;0
FR;6;2021-03-04;0;0;0;0;0;0;0;0;0;0;0;0;0;0;0;0;0;0
FR;6;2021-03-05;0;0;0;0;0;0;0;0;0;0;0;0;0;0;0;0;0;0
FR;6;2021-03-06;0;0;0;0;0;0;0;0;0;0;0;0;0;0;0;0;0;0
FR;6;2021-03-07;0;0;0;0;0;0;0;0;0;0;0;0;0;0;0;0;0;0
FR;6;2021-03-08;0;0;0;0;0;0;0;0;0;0;0;0;0;0;0;0;0;0
FR;6;2021-03-09;0;0;0;0;0;0;0;0;0;0;0;0;0;0;0;0;0;0
FR;6;2021-03-10;0;0;0;0;0;0;0;0;0;0;0;0;0;0;0;0;0;0
FR;6;2021-03-11;0;0;0;0;0;0;0;0;0;0;0;0;0;0;0;0;0;0
FR;6;2021-03-12;0;0;0;0;0;0;0;0;0;0;0;0;0;0;0;0;0;0
FR;6;2021-03-13;0;0;0;0;0;0;0;0;0;0;0;0;0;0;0;0;0;0
FR;6;2021-03-14;0;0;0;0;0;0;0;0;0;0;0;0;0;0;0;0;0;0
FR;6;2021-03-15;0;0;0;0;0;0;0;0;0;0;0;0;0;0;0;0;0;0
FR;6;2021-03-16;0;0;0;0;0;0;0;0;0;0;0;0;0;0;0;0;0;0
FR;6;2021-03-17;0;0;0;0;0;0;0;0;0;0;0;0;0;0;0;0;0;0
FR;6;2021-03-18;0;0;0;0;0;0;0;0;0;0;0;0;0;0;0;0;0;0
FR;6;2021-03-19;0;0;0;0;0;0;0;0;0;0;0;0;0;0;0;0;0;0
FR;6;2021-03-20;0;0;0;0;0;0;0;0;0;0;0;0;0;0;0;0;0;0
FR;6;2021-03-21;0;0;0;0;0;0;0;0;0;0;0;0;0;0;0;0;0;0
FR;6;2021-03-22;0;0;0;0;0;0;0;0;0;0;0;0;0;0;0;0;0;0
FR;6;2021-03-23;0;0;0;0;0;0;0;0;0;0;0;0;0;0;0;0;0;0
FR;6;2021-03-24;0;0;0;0;0;0;0;0;0;0;0;0;0;0;0;0;0;0
FR;6;2021-03-25;0;0;0;0;0;0;0;0;0;0;0;0;0;0;0;0;0;0
FR;6;2021-03-26;0;0;0;0;0;0;0;0;0;0;0;0;0;0;0;0;0;0
FR;6;2021-03-27;0;0;0;0;0;0;0;0;0;0;0;0;0;0;0;0;0;0
FR;6;2021-03-28;0;0;0;0;0;0;0;0;0;0;0;0;0;0;0;0;0;0
FR;6;2021-03-29;0;0;0;0;0;0;0;0;0;0;0;0;0;0;0;0;0;0
FR;6;2021-03-30;0;0;0;0;0;0;0;0;0;0;0;0;0;0;0;0;0;0
FR;6;2021-03-31;0;0;0;0;0;0;0;0;0;0;0;0;0;0;0;0;0;0
FR;6;2021-04-01;0;0;0;0;0;0;0;0;0;0;0;0;0;0;0;0;0;0
FR;6;2021-04-02;0;0;0;0;0;0;0;0;0;0;0;0;0;0;0;0;0;0
FR;6;2021-04-03;0;0;0;0;0;0;0;0;0;0;0;0;0;0;0;0;0;0
FR;6;2021-04-04;0;0;0;0;0;0;0;0;0;0;0;0;0;0;0;0;0;0
FR;6;2021-04-05;0;0;0;0;0;0;0;0;0;0;0;0;0;0;0;0;0;0
FR;6;2021-04-06;0;0;0;0;0;0;0;0;0;0;0;0;0;0;0;0;0;0
FR;6;2021-04-07;0;0;0;0;0;0;0;0;0;0;0;0;0;0;0;0;0;0
FR;6;2021-04-08;0;0;0;0;0;0;0;0;0;0;0;0;0;0;0;0;0;0
FR;6;2021-04-09;0;0;0;0;0;0;0;0;0;0;0;0;0;0;0;0;0;0
FR;6;2021-04-10;0;0;0;0;0;0;0;0;0;0;0;0;0;0;0;0;0;0
FR;6;2021-04-11;0;0;0;0;0;0;0;0;0;0;0;0;0;0;0;0;0;0
FR;6;2021-04-12;0;0;0;0;0;0;0;0;0;0;0;0;0;0;0;0;0;0
FR;6;2021-04-13;0;0;0;0;0;0;0;0;0;0;0;0;0;0;0;0;0;0
FR;6;2021-04-14;0;0;0;0;0;0;0;0;0;0;0;0;0;0;0;0;0;0
FR;6;2021-04-15;0;0;0;0;0;0;0;0;0;0;0;0;0;0;0;0;0;0
FR;6;2021-04-16;0;0;0;0;0;0;0;0;0;0;0;0;0;0;0;0;0;0
FR;6;2021-04-17;0;0;0;0;0;0;0;0;0;0;0;0;0;0;0;0;0;0
FR;6;2021-04-18;0;0;0;0;0;0;0;0;0;0;0;0;0;0;0;0;0;0
FR;6;2021-04-19;0;0;0;0;0;0;0;0;0;0;0;0;0;0;0;0;0;0
FR;6;2021-04-20;0;0;0;0;0;0;0;0;0;0;0;0;0;0;0;0;0;0
FR;6;2021-04-21;0;0;0;0;0;0;0;0;0;0;0;0;0;0;0;0;0;0
FR;6;2021-04-22;0;0;0;0;0;0;0;0;0;0;0;0;0;0;0;0;0;0
FR;6;2021-04-23;0;0;0;0;0;0;0;0;0;0;0;0;0;0;0;0;0;0
FR;6;2021-04-24;0;0;0;0;0;0;0;0;0;0;0;0;0;0;0;0;0;0
FR;6;2021-04-25;0;0;0;0;0;0;0;0;0;0;0;0;0;0;0;0;0;0
FR;6;2021-04-26;0;0;0;0;0;0;0;0;0;0;0;0;0;0;0;0;0;0
FR;6;2021-04-27;0;0;0;0;0;0;0;0;0;0;0;0;0;0;0;0;0;0
FR;6;2021-04-28;0;0;0;0;0;0;0;0;0;0;0;0;0;0;0;0;0;0
FR;6;2021-04-29;0;0;0;0;0;0;0;0;0;0;0;0;0;0;0;0;0;0
FR;6;2021-04-30;0;0;0;0;0;0;0;0;0;0;0;0;0;0;0;0;0;0
FR;6;2021-05-01;0;0;0;0;0;0;0;0;0;0;0;0;0;0;0;0;0;0
FR;6;2021-05-02;0;0;0;0;0;0;0;0;0;0;0;0;0;0;0;0;0;0
FR;6;2021-05-03;0;0;0;0;0;0;0;0;0;0;0;0;0;0;0;0;0;0
FR;6;2021-05-04;0;0;0;0;0;0;0;0;0;0;0;0;0;0;0;0;0;0
FR;6;2021-05-05;0;0;0;0;0;0;0;0;0;0;0;0;0;0;0;0;0;0
FR;6;2021-05-06;0;0;0;0;0;0;0;0;0;0;0;0;0;0;0;0;0;0
FR;6;2021-05-07;0;0;0;0;0;0;0;0;0;0;0;0;0;0;0;0;0;0
FR;6;2021-05-08;0;0;0;0;0;0;0;0;0;0;0;0;0;0;0;0;0;0
FR;6;2021-05-09;0;0;0;0;0;0;0;0;0;0;0;0;0;0;0;0;0;0
FR;6;2021-05-10;0;0;0;0;0;0;0;0;0;0;0;0;0;0;0;0;0;0
FR;6;2021-05-11;0;0;0;0;0;0;0;0;0;0;0;0;0;0;0;0;0;0
FR;6;2021-05-12;0;0;0;0;0;0;0;0;0;0;0;0;0;0;0;0;0;0
FR;6;2021-05-13;0;0;0;0;0;0;0;0;0;0;0;0;0;0;0;0;0;0
FR;6;2021-05-14;0;0;0;0;0;0;0;0;0;0;0;0;0;0;0;0;0;0
FR;6;2021-05-15;0;0;0;0;0;0;0;0;0;0;0;0;0;0;0;0;0;0
FR;6;2021-05-16;0;0;0;0;0;0;0;0;0;0;0;0;0;0;0;0;0;0
FR;6;2021-05-17;0;0;0;0;0;0;0;0;0;0;0;0;0;0;0;0;0;0
FR;6;2021-05-18;0;0;0;0;0;0;0;0;0;0;0;0;0;0;0;0;0;0
FR;6;2021-05-19;0;0;0;0;0;0;0;0;0;0;0;0;0;0;0;0;0;0
FR;6;2021-05-20;0;0;0;0;0;0;0;0;0;0;0;0;0;0;0;0;0;0
FR;6;2021-05-21;0;0;0;0;0;0;0;0;0;0;0;0;0;0;0;0;0;0
FR;6;2021-05-22;0;0;0;0;0;0;0;0;0;0;0;0;0;0;0;0;0;0
FR;6;2021-05-23;0;0;0;0;0;0;0;0;0;0;0;0;0;0;0;0;0;0
FR;6;2021-05-24;0;0;0;0;0;0;0;0;0;0;0;0;0;0;0;0;0;0
FR;6;2021-05-25;0;0;0;0;0;0;0;0;0;0;0;0;0;0;0;0;0;0
FR;6;2021-05-26;0;0;0;0;0;0;0;0;0;0;0;0;0;0;0;0;0;0
FR;6;2021-05-27;0;0;0;0;0;0;0;0;0;0;0;0;0;0;0;0;0;0
FR;6;2021-05-28;0;0;0;0;0;0;0;0;0;0;0;0;0;0;0;0;0;0
FR;6;2021-05-29;0;0;0;0;0;0;0;0;0;0;0;0;0;0;0;0;0;0
FR;6;2021-05-30;0;0;0;0;0;0;0;0;0;0;0;0;0;0;0;0;0;0
FR;6;2021-05-31;0;0;0;0;0;0;0;0;0;0;0;0;0;0;0;0;0;0
FR;6;2021-06-01;0;0;0;0;0;0;0;0;0;0;0;0;0;0;0;0;0;0
FR;6;2021-06-02;0;0;0;0;0;0;0;0;0;0;0;0;0;0;0;0;0;0
FR;6;2021-06-03;0;0;0;0;0;0;0;0;0;0;0;0;0;0;0;0;0;0
FR;6;2021-06-04;0;0;0;0;0;0;0;0;0;0;0;0;0;0;0;0;0;0
FR;6;2021-06-05;0;0;0;0;0;0;0;0;0;0;0;0;0;0;0;0;0;0
FR;6;2021-06-06;0;0;0;0;0;0;0;0;0;0;0;0;0;0;0;0;0;0
FR;6;2021-06-07;0;0;0;0;0;0;0;0;0;0;0;0;0;0;0;0;0;0
FR;6;2021-06-08;0;0;0;0;0;0;0;0;0;0;0;0;0;0;0;0;0;0
FR;6;2021-06-09;0;0;0;0;0;0;0;0;0;0;0;0;0;0;0;0;0;0
FR;6;2021-06-10;0;0;0;0;0;0;0;0;0;0;0;0;0;0;0;0;0;0
FR;6;2021-06-11;0;0;0;0;0;0;0;0;0;0;0;0;0;0;0;0;0;0
FR;6;2021-06-12;0;0;0;0;0;0;0;0;0;0;0;0;0;0;0;0;0;0
FR;6;2021-06-13;0;0;0;0;0;0;0;0;0;0;0;0;0;0;0;0;0;0
FR;6;2021-06-14;0;0;0;0;0;0;0;0;0;0;0;0;0;0;0;0;0;0
FR;6;2021-06-15;0;0;0;0;0;0;0;0;0;0;0;0;0;0;0;0;0;0
FR;6;2021-06-16;0;0;0;0;0;0;0;0;0;0;0;0;0;0;0;0;0;0
FR;6;2021-06-17;0;0;0;0;0;0;0;0;0;0;0;0;0;0;0;0;0;0
FR;6;2021-06-18;0;0;0;0;0;0;0;0;0;0;0;0;0;0;0;0;0;0
FR;6;2021-06-19;0;0;0;0;0;0;0;0;0;0;0;0;0;0;0;0;0;0
FR;6;2021-06-20;0;0;0;0;0;0;0;0;0;0;0;0;0;0;0;0;0;0
FR;6;2021-06-21;0;0;0;0;0;0;0;0;0;0;0;0;0;0;0;0;0;0
FR;6;2021-06-22;0;0;0;0;0;0;0;0;0;0;0;0;0;0;0;0;0;0
FR;6;2021-06-23;0;0;0;0;0;0;0;0;0;0;0;0;0;0;0;0;0;0
FR;6;2021-06-24;0;0;0;0;0;0;0;0;0;0;0;0;0;0;0;0;0;0
FR;6;2021-06-25;0;0;0;0;0;0;0;0;0;0;0;0;0;0;0;0;0;0
FR;6;2021-06-26;0;0;0;0;0;0;0;0;0;0;0;0;0;0;0;0;0;0
FR;6;2021-06-27;0;0;0;0;0;0;0;0;0;0;0;0;0;0;0;0;0;0
FR;6;2021-06-28;0;0;0;0;0;0;0;0;0;0;0;0;0;0;0;0;0;0
FR;6;2021-06-29;0;0;0;0;0;0;0;0;0;0;0;0;0;0;0;0;0;0
FR;6;2021-06-30;0;0;0;0;0;0;0;0;0;0;0;0;0;0;0;0;0;0
FR;6;2021-07-01;0;0;0;0;0;0;0;0;0;0;0;0;0;0;0;0;0;0
FR;6;2021-07-02;0;0;0;0;0;0;0;0;0;0;0;0;0;0;0;0;0;0
FR;6;2021-07-03;0;0;0;0;0;0;0;0;0;0;0;0;0;0;0;0;0;0
FR;6;2021-07-04;0;0;0;0;0;0;0;0;0;0;0;0;0;0;0;0;0;0
FR;6;2021-07-05;0;0;0;0;0;0;0;0;0;0;0;0;0;0;0;0;0;0
FR;6;2021-07-06;0;0;0;0;0;0;0;0;0;0;0;0;0;0;0;0;0;0
FR;6;2021-07-07;0;0;0;0;0;0;0;0;0;0;0;0;0;0;0;0;0;0
FR;6;2021-07-08;0;0;0;0;0;0;0;0;0;0;0;0;0;0;0;0;0;0
FR;6;2021-07-09;0;0;0;0;0;0;0;0;0;0;0;0;0;0;0;0;0;0
FR;6;2021-07-10;0;0;0;0;0;0;0;0;0;0;0;0;0;0;0;0;0;0
FR;6;2021-07-11;0;0;0;0;0;0;0;0;0;0;0;0;0;0;0;0;0;0
FR;6;2021-07-12;0;0;0;0;0;0;0;0;0;0;0;0;0;0;0;0;0;0
FR;6;2021-07-13;0;0;0;0;0;0;0;0;0;0;0;0;0;0;0;0;0;0
FR;6;2021-07-14;0;0;0;0;0;0;0;0;0;0;0;0;0;0;0;0;0;0
FR;6;2021-07-15;0;0;0;0;0;0;0;0;0;0;0;0;0;0;0;0;0;0
FR;6;2021-07-16;0;0;0;0;0;0;0;0;0;0;0;0;0;0;0;0;0;0
FR;6;2021-07-17;0;0;0;0;0;0;0;0;0;0;0;0;0;0;0;0;0;0
FR;6;2021-07-18;0;0;0;0;0;0;0;0;0;0;0;0;0;0;0;0;0;0
FR;6;2021-07-19;0;0;0;0;0;0;0;0;0;0;0;0;0;0;0;0;0;0
FR;6;2021-07-20;0;0;0;0;0;0;0;0;0;0;0;0;0;0;0;0;0;0
FR;6;2021-07-21;0;0;0;0;0;0;0;0;0;0;0;0;0;0;0;0;0;0
FR;6;2021-07-22;0;0;0;0;0;0;0;0;0;0;0;0;0;0;0;0;0;0
FR;6;2021-07-23;0;0;0;0;0;0;0;0;0;0;0;0;0;0;0;0;0;0
FR;6;2021-07-24;0;0;0;0;0;0;0;0;0;0;0;0;0;0;0;0;0;0
FR;6;2021-07-25;0;0;0;0;0;0;0;0;0;0;0;0;0;0;0;0;0;0
FR;6;2021-07-26;0;0;0;0;0;0;0;0;0;0;0;0;0;0;0;0;0;0
FR;6;2021-07-27;0;0;0;0;0;0;0;0;0;0;0;0;0;0;0;0;0;0
FR;6;2021-07-28;0;0;0;0;0;0;0;0;0;0;0;0;0;0;0;0;0;0
FR;6;2021-07-29;0;0;0;0;0;0;0;0;0;0;0;0;0;0;0;0;0;0
FR;6;2021-07-30;0;0;0;0;0;0;0;0;0;0;0;0;0;0;0;0;0;0
FR;6;2021-07-31;0;0;0;0;0;0;0;0;0;0;0;0;0;0;0;0;0;0
FR;6;2021-08-01;0;0;0;0;0;0;0;0;0;0;0;0;0;0;0;0;0;0
FR;6;2021-08-02;0;0;0;0;0;0;0;0;0;0;0;0;0;0;0;0;0;0
FR;6;2021-08-03;0;0;0;0;0;0;0;0;0;0;0;0;0;0;0;0;0;0
FR;6;2021-08-04;0;0;0;0;0;0;0;0;0;0;0;0;0;0;0;0;0;0
FR;6;2021-08-05;0;0;0;0;0;0;0;0;0;0;0;0;0;0;0;0;0;0
FR;6;2021-08-06;0;0;0;0;0;0;0;0;0;0;0;0;0;0;0;0;0;0
FR;6;2021-08-07;0;0;0;0;0;0;0;0;0;0;0;0;0;0;0;0;0;0
FR;6;2021-08-08;0;0;0;0;0;0;0;0;0;0;0;0;0;0;0;0;0;0
FR;6;2021-08-09;0;0;0;0;0;0;0;0;0;0;0;0;0;0;0;0;0;0
FR;6;2021-08-10;0;0;0;0;0;0;0;0;0;0;0;0;0;0;0;0;0;0
FR;6;2021-08-11;0;0;0;0;0;0;0;0;0;0;0;0;0;0;0;0;0;0
FR;6;2021-08-12;0;0;0;0;0;0;0;0;0;0;0;0;0;0;0;0;0;0
FR;6;2021-08-13;0;0;0;0;0;0;0;0;0;0;0;0;0;0;0;0;0;0
FR;6;2021-08-14;0;0;0;0;0;0;0;0;0;0;0;0;0;0;0;0;0;0
FR;6;2021-08-15;0;0;0;0;0;0;0;0;0;0;0;0;0;0;0;0;0;0
FR;6;2021-08-16;0;0;0;0;0;0;0;0;0;0;0;0;0;0;0;0;0;0
FR;6;2021-08-17;0;0;0;0;0;0;0;0;0;0;0;0;0;0;0;0;0;0
FR;6;2021-08-18;0;0;0;0;0;0;0;0;0;0;0;0;0;0;0;0;0;0
FR;6;2021-08-19;0;0;0;0;0;0;0;0;0;0;0;0;0;0;0;0;0;0
FR;6;2021-08-20;0;0;0;0;0;0;0;0;0;0;0;0;0;0;0;0;0;0
FR;6;2021-08-21;0;0;0;0;0;0;0;0;0;0;0;0;0;0;0;0;0;0
FR;6;2021-08-22;0;0;0;0;0;0;0;0;0;0;0;0;0;0;0;0;0;0
FR;6;2021-08-23;0;0;0;0;0;0;0;0;0;0;0;0;0;0;0;0;0;0
FR;6;2021-08-24;0;0;0;0;0;0;0;0;0;0;0;0;0;0;0;0;0;0
FR;6;2021-08-25;0;0;0;0;0;0;0;0;0;0;0;0;0;0;0;0;0;0
FR;6;2021-08-26;0;0;0;0;0;0;0;0;0;0;0;0;0;0;0;0;0;0
FR;6;2021-08-27;0;0;0;0;0;0;0;0;0;0;0;0;0;0;0;0;0;0
FR;6;2021-08-28;0;0;0;0;0;0;0;0;0;0;0;0;0;0;0;0;0;0
FR;6;2021-08-29;0;0;0;0;0;0;0;0;0;0;0;0;0;0;0;0;0;0
FR;6;2021-08-30;0;0;0;0;0;0;0;0;0;0;0;0;0;0;0;0;0;0
FR;6;2021-08-31;0;0;0;0;0;0;0;0;0;0;0;0;0;0;0;0;0;0
FR;6;2021-09-01;0;0;0;0;0;0;0;0;0;0;0;0;0;0;0;0;0;0
FR;6;2021-09-02;0;0;0;0;0;0;0;0;0;0;0;0;0;0;0;0;0;0
FR;6;2021-09-03;0;0;0;0;0;0;0;0;0;0;0;0;0;0;0;0;0;0
FR;6;2021-09-04;0;0;0;0;0;0;0;0;0;0;0;0;0;0;0;0;0;0
FR;6;2021-09-05;0;0;0;0;0;0;0;0;0;0;0;0;0;0;0;0;0;0
FR;6;2021-09-06;0;0;0;0;0;0;0;0;0;0;0;0;0;0;0;0;0;0
FR;6;2021-09-07;0;0;0;0;0;0;0;0;0;0;0;0;0;0;0;0;0;0
FR;6;2021-09-08;0;0;0;0;0;0;0;0;0;0;0;0;0;0;0;0;0;0
FR;6;2021-09-09;0;0;0;0;0;0;0;0;0;0;0;0;0;0;0;0;0;0
FR;6;2021-09-10;0;0;0;0;0;0;0;0;0;0;0;0;0;0;0;0;0;0
FR;6;2021-09-11;0;0;0;0;0;0;0;0;0;0;0;0;0;0;0;0;0;0
FR;6;2021-09-12;0;0;0;0;0;0;0;0;0;0;0;0;0;0;0;0;0;0
FR;6;2021-09-13;0;0;0;0;0;0;0;0;0;0;0;0;0;0;0;0;0;0
FR;6;2021-09-14;0;0;0;0;0;0;0;0;0;0;0;0;0;0;0;0;0;0
FR;6;2021-09-15;0;0;0;0;0;0;0;0;0;0;0;0;0;0;0;0;0;0
FR;6;2021-09-16;0;0;0;0;0;0;0;0;0;0;0;0;0;0;0;0;0;0
FR;6;2021-09-17;0;0;0;0;0;0;0;0;0;0;0;0;0;0;0;0;0;0
FR;6;2021-09-18;0;0;0;0;0;0;0;0;0;0;0;0;0;0;0;0;0;0
FR;6;2021-09-19;0;0;0;0;0;0;0;0;0;0;0;0;0;0;0;0;0;0
FR;6;2021-09-20;0;0;0;0;0;0;0;0;0;0;0;0;0;0;0;0;0;0
FR;6;2021-09-21;0;0;0;0;0;0;0;0;0;0;0;0;0;0;0;0;0;0
FR;6;2021-09-22;0;0;0;0;0;0;0;0;0;0;0;0;0;0;0;0;0;0
FR;6;2021-09-23;0;0;0;0;0;0;0;0;0;0;0;0;0;0;0;0;0;0
FR;6;2021-09-24;0;0;0;0;0;0;0;0;0;0;0;0;0;0;0;0;0;0
FR;6;2021-09-25;0;0;0;0;0;0;0;0;0;0;0;0;0;0;0;0;0;0
FR;6;2021-09-26;0;0;0;0;0;0;0;0;0;0;0;0;0;0;0;0;0;0
FR;6;2021-09-27;0;0;0;0;0;0;0;0;0;0;0;0;0;0;0;0;0;0
FR;6;2021-09-28;0;0;0;0;0;0;0;0;0;0;0;0;0;0;0;0;0;0
FR;6;2021-09-29;0;0;0;0;0;0;0;0;0;0;0;0;0;0;0;0;0;0
FR;6;2021-09-30;0;0;0;0;0;0;0;0;0;0;0;0;0;0;0;0;0;0
FR;6;2021-10-01;0;0;0;0;0;0;0;0;0;0;0;0;0;0;0;0;0;0
FR;6;2021-10-02;0;0;0;0;0;0;0;0;0;0;0;0;0;0;0;0;0;0
FR;6;2021-10-03;0;0;0;0;0;0;0;0;0;0;0;0;0;0;0;0;0;0
FR;6;2021-10-04;0;0;0;0;0;0;0;0;0;0;0;0;0;0;0;0;0;0
FR;6;2021-10-05;0;0;0;0;0;0;0;0;0;0;0;0;0;0;0;0;0;0
FR;6;2021-10-06;0;0;0;0;0;0;0;0;0;0;0;0;0;0;0;0;0;0
FR;6;2021-10-07;0;0;0;0;0;0;0;0;0;0;0;0;0;0;0;0;0;0
FR;6;2021-10-08;0;0;0;0;0;0;0;0;0;0;0;0;0;0;0;0;0;0
FR;6;2021-10-09;0;0;0;0;0;0;0;0;0;0;0;0;0;0;0;0;0;0
FR;6;2021-10-10;0;0;0;0;0;0;0;0;0;0;0;0;0;0;0;0;0;0
FR;6;2021-10-11;0;0;0;0;0;0;0;0;0;0;0;0;0;0;0;0;0;0
FR;6;2021-10-12;0;0;0;0;0;0;0;0;0;0;0;0;0;0;0;0;0;0
FR;6;2021-10-13;0;0;0;0;0;0;0;0;0;0;0;0;0;0;0;0;0;0
FR;6;2021-10-14;0;0;0;0;0;0;0;0;0;0;0;0;0;0;0;0;0;0
FR;6;2021-10-15;0;0;0;0;0;0;0;0;0;0;0;0;0;0;0;0;0;0
FR;6;2021-10-16;0;0;0;0;0;0;0;0;0;0;0;0;0;0;0;0;0;0
FR;6;2021-10-17;0;0;0;0;0;0;0;0;0;0;0;0;0;0;0;0;0;0
FR;6;2021-10-18;0;0;0;0;0;0;0;0;0;0;0;0;0;0;0;0;0;0
FR;6;2021-10-19;0;0;0;0;0;0;0;0;0;0;0;0;0;0;0;0;0;0
FR;6;2021-10-20;0;0;0;0;0;0;0;0;0;0;0;0;0;0;0;0;0;0
FR;6;2021-10-21;0;0;0;0;0;0;0;0;0;0;0;0;0;0;0;0;0;0
FR;6;2021-10-22;0;0;0;0;0;0;0;0;0;0;0;0;0;0;0;0;0;0
FR;6;2021-10-23;0;0;0;0;0;0;0;0;0;0;0;0;0;0;0;0;0;0
FR;6;2021-10-24;0;0;0;0;0;0;0;0;0;0;0;0;0;0;0;0;0;0
FR;6;2021-10-25;0;0;0;0;0;0;0;0;0;0;0;0;0;0;0;0;0;0
FR;6;2021-10-26;0;0;0;0;0;0;0;0;0;0;0;0;0;0;0;0;0;0
FR;6;2021-10-27;0;0;0;0;0;0;0;0;0;0;0;0;0;0;0;0;0;0
FR;6;2021-10-28;0;0;0;0;0;0;0;0;0;0;0;0;0;0;0;0;0;0
FR;6;2021-10-29;0;0;0;0;0;0;0;0;0;0;0;0;0;0;0;0;0;0
FR;6;2021-10-30;0;0;0;0;0;0;0;0;0;0;0;0;0;0;0;0;0;0
FR;6;2021-10-31;0;0;0;0;0;0;0;0;0;0;0;0;0;0;0;0;0;0
FR;6;2021-11-01;0;0;0;0;0;0;0;0;0;0;0;0;0;0;0;0;0;0
FR;6;2021-11-02;0;0;0;0;0;0;0;0;0;0;0;0;0;0;0;0;0;0
FR;6;2021-11-03;0;0;0;0;0;0;0;0;0;0;0;0;0;0;0;0;0;0
FR;6;2021-11-04;0;0;0;0;0;0;0;0;0;0;0;0;0;0;0;0;0;0
FR;6;2021-11-05;0;0;0;0;0;0;0;0;0;0;0;0;0;0;0;0;0;0
FR;6;2021-11-06;0;0;0;0;0;0;0;0;0;0;0;0;0;0;0;0;0;0
FR;6;2021-11-07;0;0;0;0;0;0;0;0;0;0;0;0;0;0;0;0;0;0
FR;6;2021-11-08;0;0;0;0;0;0;0;0;0;0;0;0;0;0;0;0;0;0
FR;6;2021-11-09;0;0;0;0;0;0;0;0;0;0;0;0;0;0;0;0;0;0
FR;6;2021-11-10;0;0;0;0;0;0;0;0;0;0;0;0;0;0;0;0;0;0
FR;6;2021-11-11;0;0;0;0;0;0;0;0;0;0;0;0;0;0;0;0;0;0
FR;6;2021-11-12;0;0;0;0;0;0;0;0;0;0;0;0;0;0;0;0;0;0
FR;6;2021-11-13;0;0;0;0;0;0;0;0;0;0;0;0;0;0;0;0;0;0
FR;6;2021-11-14;0;0;0;0;0;0;0;0;0;0;0;0;0;0;0;0;0;0
FR;6;2021-11-15;0;0;0;0;0;0;0;0;0;0;0;0;0;0;0;0;0;0
FR;6;2021-11-16;0;0;0;0;0;0;0;0;0;0;0;0;0;0;0;0;0;0
FR;6;2021-11-17;0;0;0;0;0;0;0;0;0;0;0;0;0;0;0;0;0;0
FR;6;2021-11-18;0;0;0;0;0;0;0;0;0;0;0;0;0;0;0;0;0;0
FR;6;2021-11-19;0;0;0;0;0;0;0;0;0;0;0;0;0;0;0;0;0;0
FR;6;2021-11-20;0;0;0;0;0;0;0;0;0;0;0;0;0;0;0;0;0;0
FR;6;2021-11-21;0;0;0;0;0;0;0;0;0;0;0;0;0;0;0;0;0;0
FR;6;2021-11-22;0;0;0;0;0;0;0;0;0;0;0;0;0;0;0;0;0;0
FR;6;2021-11-23;0;0;0;0;0;0;0;0;0;0;0;0;0;0;0;0;0;0
FR;6;2021-11-24;0;0;0;0;0;0;0;0;0;0;0;0;0;0;0;0;0;0
FR;6;2021-11-25;0;0;0;0;0;0;0;0;0;0;0;0;0;0;0;0;0;0
FR;6;2021-11-26;0;0;0;0;0;0;0;0;0;0;0;0;0;0;0;0;0;0
FR;6;2021-11-27;0;0;0;0;0;0;0;0;0;0;0;0;0;0;0;0;0;0
FR;6;2021-11-28;0;0;0;0;0;0;0;0;0;0;0;0;0;0;0;0;0;0
FR;6;2021-11-29;0;0;0;0;0;0;0;0;0;0;0;0;0;0;0;0;0;0
FR;6;2021-11-30;0;0;0;0;0;0;0;0;0;0;0;0;0;0;0;0;0;0
FR;6;2021-12-01;0;0;0;0;0;0;0;0;0;0;0;0;0;0;0;0;0;0
FR;6;2021-12-02;0;0;0;0;0;0;0;0;0;0;0;0;0;0;0;0;0;0
FR;6;2021-12-03;0;0;0;0;0;0;0;0;0;0;0;0;0;0;0;0;0;0
FR;6;2021-12-04;0;0;0;0;0;0;0;0;0;0;0;0;0;0;0;0;0;0
FR;6;2021-12-05;0;0;0;0;0;0;0;0;0;0;0;0;0;0;0;0;0;0
FR;6;2021-12-06;0;0;0;0;0;0;0;0;0;0;0;0;0;0;0;0;0;0
FR;6;2021-12-07;0;0;0;0;0;0;0;0;0;0;0;0;0;0;0;0;0;0
FR;6;2021-12-08;0;0;0;0;0;0;0;0;0;0;0;0;0;0;0;0;0;0
FR;6;2021-12-09;0;0;0;0;0;0;0;0;0;0;0;0;0;0;0;0;0;0
FR;6;2021-12-10;0;0;0;0;0;0;0;0;0;0;0;0;0;0;0;0;0;0
FR;6;2021-12-11;0;0;0;0;0;0;0;0;0;0;0;0;0;0;0;0;0;0
FR;6;2021-12-12;0;0;0;0;0;0;0;0;0;0;0;0;0;0;0;0;0;0
FR;6;2021-12-13;0;0;0;0;0;0;0;0;0;0;0;0;0;0;0;0;0;0
FR;6;2021-12-14;0;0;0;0;0;0;0;0;0;0;0;0;0;0;0;0;0;0
FR;6;2021-12-15;0;0;0;0;0;0;0;0;0;0;0;0;0;0;0;0;0;0
FR;6;2021-12-16;0;0;0;0;0;0;0;0;0;0;0;0;0;0;0;0;0;0
FR;6;2021-12-17;0;0;0;0;0;0;0;0;0;0;0;0;0;0;0;0;0;0
FR;6;2021-12-18;0;0;0;0;0;0;0;0;0;0;0;0;0;0;0;0;0;0
FR;6;2021-12-19;0;0;0;0;0;0;0;0;0;0;0;0;0;0;0;0;0;0
FR;6;2021-12-20;0;0;0;0;0;0;0;0;0;0;0;0;0;0;0;0;0;0
FR;6;2021-12-21;0;0;0;0;0;0;0;0;0;0;0;0;0;0;0;0;0;0
FR;6;2021-12-22;0;0;0;0;0;0;0;0;0;0;0;0;0;0;0;0;0;0
FR;6;2021-12-23;0;0;0;0;0;0;0;0;0;0;0;0;0;0;0;0;0;0
FR;6;2021-12-24;0;0;0;0;0;0;0;0;0;0;0;0;0;0;0;0;0;0
FR;6;2021-12-25;0;0;0;0;0;0;0;0;0;0;0;0;0;0;0;0;0;0
FR;6;2021-12-26;0;0;0;0;0;0;0;0;0;0;0;0;0;0;0;0;0;0
FR;6;2021-12-27;0;0;0;0;0;0;0;0;0;0;0;0;0;0;0;0;0;0
FR;6;2021-12-28;0;0;0;0;0;0;0;0;0;0;0;0;0;0;0;0;0;0
FR;6;2021-12-29;0;0;0;0;0;0;0;0;0;0;0;0;0;0;0;0;0;0
FR;6;2021-12-30;0;0;0;0;0;0;0;0;0;0;0;0;0;0;0;0;0;0
FR;6;2021-12-31;0;0;0;0;0;0;0;0;0;0;0;0;0;0;0;0;0;0
FR;6;2022-01-01;0;0;0;0;0;0;0;0;0;0;0;0;0;0;0;0;0;0
FR;6;2022-01-02;0;0;0;0;0;0;0;0;0;0;0;0;0;0;0;0;0;0
FR;6;2022-01-03;0;0;0;0;0;0;0;0;0;0;0;0;0;0;0;0;0;0
FR;6;2022-01-04;0;0;0;0;0;0;0;0;0;0;0;0;0;0;0;0;0;0
FR;6;2022-01-05;0;0;0;0;0;0;0;0;0;0;0;0;0;0;0;0;0;0
FR;6;2022-01-06;0;0;0;0;0;0;0;0;0;0;0;0;0;0;0;0;0;0
FR;6;2022-01-07;0;0;0;0;0;0;0;0;0;0;0;0;0;0;0;0;0;0
FR;6;2022-01-08;0;0;0;0;0;0;0;0;0;0;0;0;0;0;0;0;0;0
FR;6;2022-01-09;0;0;0;0;0;0;0;0;0;0;0;0;0;0;0;0;0;0
FR;6;2022-01-10;0;0;0;0;0;0;0;0;0;0;0;0;0;0;0;0;0;0
FR;6;2022-01-11;0;0;0;0;0;0;0;0;0;0;0;0;0;0;0;0;0;0
FR;6;2022-01-12;0;0;0;0;0;0;0;0;0;0;0;0;0;0;0;0;0;0
FR;6;2022-01-13;0;0;0;0;0;0;0;0;0;0;0;0;0;0;0;0;0;0
FR;6;2022-01-14;0;0;0;0;0;0;0;0;0;0;0;0;0;0;0;0;0;0
FR;6;2022-01-15;0;0;0;0;0;0;0;0;0;0;0;0;0;0;0;0;0;0
FR;6;2022-01-16;0;0;0;0;0;0;0;0;0;0;0;0;0;0;0;0;0;0
FR;6;2022-01-17;0;0;0;0;0;0;0;0;0;0;0;0;0;0;0;0;0;0
FR;6;2022-01-18;0;0;0;0;0;0;0;0;0;0;0;0;0;0;0;0;0;0
FR;6;2022-01-19;0;0;0;0;0;0;0;0;0;0;0;0;0;0;0;0;0;0
FR;6;2022-01-20;0;0;0;0;0;0;0;0;0;0;0;0;0;0;0;0;0;0
FR;6;2022-01-21;0;0;0;0;0;0;0;0;0;0;0;0;0;0;0;0;0;0
FR;6;2022-01-22;0;0;0;0;0;0;0;0;0;0;0;0;0;0;0;0;0;0
FR;6;2022-01-23;0;0;0;0;0;0;0;0;0;0;0;0;0;0;0;0;0;0
FR;6;2022-01-24;0;0;0;0;0;0;0;0;0;0;0;0;0;0;0;0;0;0
FR;6;2022-01-25;0;0;0;0;0;0;0;0;0;0;0;0;0;0;0;0;0;0
FR;6;2022-01-26;0;0;0;0;0;0;0;0;0;0;0;0;0;0;0;0;0;0
FR;6;2022-01-27;0;0;0;0;0;0;0;0;0;0;0;0;0;0;0;0;0;0
FR;6;2022-01-28;0;0;0;0;0;0;0;0;0;0;0;0;0;0;0;0;0;0
FR;6;2022-01-29;0;0;0;0;0;0;0;0;0;0;0;0;0;0;0;0;0;0
FR;6;2022-01-30;0;0;0;0;0;0;0;0;0;0;0;0;0;0;0;0;0;0
FR;6;2022-01-31;0;0;0;0;0;0;0;0;0;0;0;0;0;0;0;0;0;0
FR;6;2022-02-01;0;0;0;0;0;0;0;0;0;0;0;0;0;0;0;0;0;0
FR;6;2022-02-02;0;0;0;0;0;0;0;0;0;0;0;0;0;0;0;0;0;0
FR;6;2022-02-03;0;0;0;0;0;0;0;0;0;0;0;0;0;0;0;0;0;0
FR;6;2022-02-04;0;0;0;0;0;0;0;0;0;0;0;0;0;0;0;0;0;0
FR;6;2022-02-05;0;0;0;0;0;0;0;0;0;0;0;0;0;0;0;0;0;0
FR;6;2022-02-06;0;0;0;0;0;0;0;0;0;0;0;0;0;0;0;0;0;0
FR;6;2022-02-07;0;0;0;0;0;0;0;0;0;0;0;0;0;0;0;0;0;0
FR;6;2022-02-08;0;0;0;0;0;0;0;0;0;0;0;0;0;0;0;0;0;0
FR;6;2022-02-09;0;0;0;0;0;0;0;0;0;0;0;0;0;0;0;0;0;0
FR;6;2022-02-10;0;0;0;0;0;0;0;0;0;0;0;0;0;0;0;0;0;0
FR;6;2022-02-11;0;0;0;0;0;0;0;0;0;0;0;0;0;0;0;0;0;0
FR;6;2022-02-12;0;0;0;0;0;0;0;0;0;0;0;0;0;0;0;0;0;0
FR;6;2022-02-13;0;0;0;0;0;0;0;0;0;0;0;0;0;0;0;0;0;0
FR;6;2022-02-14;0;0;0;0;0;0;0;0;0;0;0;0;0;0;0;0;0;0
FR;6;2022-02-15;0;0;0;0;0;0;0;0;0;0;0;0;0;0;0;0;0;0
FR;6;2022-02-16;0;0;0;0;0;0;0;0;0;0;0;0;0;0;0;0;0;0
FR;6;2022-02-17;0;0;0;0;0;0;0;0;0;0;0;0;0;0;0;0;0;0
FR;6;2022-02-18;0;0;0;0;0;0;0;0;0;0;0;0;0;0;0;0;0;0
FR;6;2022-02-19;0;0;0;0;0;0;0;0;0;0;0;0;0;0;0;0;0;0
FR;6;2022-02-20;0;0;0;0;0;0;0;0;0;0;0;0;0;0;0;0;0;0
FR;6;2022-02-21;0;0;0;0;0;0;0;0;0;0;0;0;0;0;0;0;0;0
FR;6;2022-02-22;0;0;0;0;0;0;0;0;0;0;0;0;0;0;0;0;0;0
FR;6;2022-02-23;0;0;0;0;0;0;0;0;0;0;0;0;0;0;0;0;0;0
FR;6;2022-02-24;0;0;0;0;0;0;0;0;0;0;0;0;0;0;0;0;0;0
FR;6;2022-02-25;0;0;0;0;0;0;0;0;0;0;0;0;0;0;0;0;0;0
FR;6;2022-02-26;1;0;0;0;0;0;0;0;0;1;0;0;0;0;0;0;0;0
FR;6;2022-02-27;0;0;0;0;0;0;0;0;0;1;0;0;0;0;0;0;0;0
FR;6;2022-02-28;0;0;0;0;0;0;0;0;0;1;0;0;0;0;0;0;0;0
FR;6;2022-03-01;3;0;0;0;0;0;0;0;0;4;0;0;0;0;0;0;0;0
FR;6;2022-03-02;97;9;2;0;15;7;0;0;0;101;9;2;0;15;7;0;0;0
FR;6;2022-03-03;0;0;0;0;0;0;0;0;0;101;9;2;0;15;7;0;0;0
FR;6;2022-03-04;92;4;0;0;8;4;0;0;0;193;13;2;0;23;11;0;0;0
FR;6;2022-03-05;391;23;2;0;60;14;0;0;0;584;36;4;0;83;25;0;0;0
FR;6;2022-03-06;7;1;0;0;2;0;0;0;0;591;37;4;0;85;25;0;0;0
FR;6;2022-03-07;337;19;0;0;51;13;0;0;0;928;56;4;0;136;38;0;0;0
FR;6;2022-03-08;230;14;0;0;47;5;0;0;0;1158;70;4;0;183;43;0;0;0
FR;6;2022-03-09;519;29;2;0;84;21;1;0;0;1677;99;6;0;267;64;1;0;0
FR;6;2022-03-10;206;19;0;1;54;12;1;0;0;1883;118;6;1;321;76;2;0;0
FR;6;2022-03-11;331;22;6;0;53;21;0;0;0;2214;140;12;1;374;97;2;0;0
FR;6;2022-03-12;518;25;1;0;83;20;0;0;0;2732;165;13;1;457;117;2;0;0
FR;6;2022-03-13;40;2;0;0;2;1;0;0;0;2772;167;13;1;459;118;2;0;0
FR;6;2022-03-14;201;4;2;0;39;3;1;0;0;2973;171;15;1;498;121;3;0;0
FR;6;2022-03-15;112;11;2;0;29;9;0;0;0;3085;182;17;1;527;130;3;0;0
FR;6;2022-03-16;310;17;2;1;49;15;1;0;0;3395;199;19;2;576;145;4;0;0
FR;6;2022-03-17;117;6;1;2;14;4;2;0;0;3512;205;20;4;590;149;6;0;0
FR;6;2022-03-18;215;10;0;0;40;6;0;0;0;3727;215;20;4;630;155;6;0;0
FR;6;2022-03-19;307;19;2;0;89;9;0;0;0;4034;234;22;4;719;164;6;0;0
FR;6;2022-03-20;15;5;0;0;5;1;0;0;0;4049;239;22;4;724;165;6;0;0
FR;6;2022-03-21;132;23;1;0;47;4;0;0;0;4181;262;23;4;771;169;6;0;0
FR;6;2022-03-22;97;15;0;0;34;4;0;0;0;4278;277;23;4;805;173;6;0;0
FR;6;2022-03-23;226;108;3;0;154;14;1;0;0;4504;385;26;4;959;187;7;0;0
FR;6;2022-03-24;100;15;1;3;32;4;3;0;0;4604;400;27;7;991;191;10;0;0
FR;6;2022-03-25;203;141;2;1;179;15;2;0;0;4807;541;29;8;1170;206;12;0;0
FR;6;2022-03-26;331;295;7;1;384;19;1;0;0;5138;836;36;9;1554;225;13;0;0
FR;6;2022-03-27;32;30;1;0;37;1;1;0;0;5170;866;37;9;1591;226;14;0;0
FR;6;2022-03-28;201;208;8;1;234;17;3;0;0;5371;1074;45;10;1825;243;17;0;0
FR;6;2022-03-29;124;189;12;2;206;12;9;0;0;5495;1263;57;12;2031;255;26;0;0
FR;6;2022-03-30;305;476;10;2;548;22;6;0;0;5800;1739;67;14;2579;277;32;0;0
FR;6;2022-03-31;123;140;10;0;160;14;5;0;0;5923;1879;77;14;2739;291;37;0;0
FR;6;2022-04-01;195;150;11;2;178;23;3;0;0;6118;2029;88;16;2917;314;40;0;0
FR;6;2022-04-02;206;241;9;1;280;13;8;0;0;6324;2270;97;17;3197;327;48;0;0
FR;6;2022-04-03;17;21;0;0;26;1;0;0;0;6341;2291;97;17;3223;328;48;0;0
FR;6;2022-04-04;137;114;6;1;131;9;5;0;0;6478;2405;103;18;3354;337;53;0;0
FR;6;2022-04-05;146;88;15;1;105;11;8;0;0;6624;2493;118;19;3459;348;61;0;0
FR;6;2022-04-06;204;245;22;26;291;27;33;0;0;6828;2738;140;45;3750;375;94;0;0
FR;6;2022-04-07;127;96;15;9;115;17;14;0;0;6955;2834;155;54;3865;392;108;0;0
FR;6;2022-04-08;199;171;16;3;214;17;9;0;1;7154;3005;171;57;4079;409;117;0;1
FR;6;2022-04-09;145;139;6;12;171;13;4;0;0;7299;3144;177;69;4250;422;121;0;1
FR;6;2022-04-10;10;20;3;0;25;1;3;0;0;7309;3164;180;69;4275;423;124;0;1
FR;6;2022-04-11;101;106;4;0;128;5;3;0;0;7410;3270;184;69;4403;428;127;0;1
FR;6;2022-04-12;136;75;5;8;114;10;10;0;0;7546;3345;189;77;4517;438;137;0;1
FR;6;2022-04-13;162;175;7;5;208;13;8;0;0;7708;3520;196;82;4725;451;145;0;1
FR;6;2022-04-14;100;103;5;10;121;8;10;0;0;7808;3623;201;92;4846;459;155;0;1
FR;6;2022-04-15;158;149;11;7;167;19;14;0;1;7966;3772;212;99;5013;478;169;0;2
FR;6;2022-04-16;127;132;5;0;162;14;2;0;0;8093;3904;217;99;5175;492;171;0;2
FR;6;2022-04-17;8;9;4;0;10;4;0;0;0;8101;3913;221;99;5185;496;171;0;2
FR;6;2022-04-18;8;15;3;0;15;4;0;0;0;8109;3928;224;99;5200;500;171;0;2
FR;6;2022-04-19;97;112;4;3;130;3;7;0;0;8206;4040;228;102;5330;503;178;0;2
FR;6;2022-04-20;178;227;8;7;269;15;3;0;0;8384;4267;236;109;5599;518;181;0;2
FR;6;2022-04-21;111;93;8;4;110;11;7;0;0;8495;4360;244;113;5709;529;188;0;2
FR;6;2022-04-22;138;160;13;12;190;13;13;0;0;8633;4520;257;125;5899;542;201;0;2
FR;6;2022-04-23;106;129;1;1;161;7;1;0;0;8739;4649;258;126;6060;549;202;0;2
FR;6;2022-04-24;5;21;1;0;22;0;1;0;0;8744;4670;259;126;6082;549;203;0;2
FR;6;2022-04-25;90;128;3;8;150;11;9;0;0;8834;4798;262;134;6232;560;212;0;2
FR;6;2022-04-26;101;128;19;2;151;17;13;0;0;8935;4926;281;136;6383;577;225;0;2
FR;6;2022-04-27;197;159;21;1;222;27;11;0;1;9132;5085;302;137;6605;604;236;0;3
FR;6;2022-04-28;109;87;7;1;123;8;7;0;0;9241;5172;309;138;6728;612;243;0;3
FR;6;2022-04-29;191;169;16;2;215;20;6;0;0;9432;5341;325;140;6943;632;249;0;3
FR;6;2022-04-30;133;125;7;1;168;24;2;0;0;9565;5466;332;141;7111;656;251;0;3
FR;6;2022-05-01;7;6;0;0;8;0;0;0;0;9572;5472;332;141;7119;656;251;0;3
FR;6;2022-05-02;94;65;3;4;88;3;4;0;0;9666;5537;335;145;7207;659;255;0;3
FR;6;2022-05-03;136;93;11;2;125;7;9;0;0;9802;5630;346;147;7332;666;264;0;3
FR;6;2022-05-04;167;118;25;12;161;29;12;0;1;9969;5748;371;159;7493;695;276;0;4
FR;6;2022-05-05;101;70;8;3;96;12;6;0;0;10070;5818;379;162;7589;707;282;0;4
FR;6;2022-05-06;152;110;10;9;155;16;11;0;0;10222;5928;389;171;7744;723;293;0;4
FR;6;2022-05-07;139;93;13;3;136;23;8;0;0;10361;6021;402;174;7880;746;301;0;4
FR;6;2022-05-08;20;8;6;5;16;7;5;0;0;10381;6029;408;179;7896;753;306;0;4
FR;6;2022-05-09;86;78;9;7;95;13;6;0;0;10467;6107;417;186;7991;766;312;0;4
FR;6;2022-05-10;112;80;15;7;110;12;13;0;0;10579;6187;432;193;8101;778;325;0;4
FR;6;2022-05-11;130;124;11;14;163;20;6;0;0;10709;6311;443;207;8264;798;331;0;4
FR;6;2022-05-12;105;76;7;5;96;15;6;0;1;10814;6387;450;212;8360;813;337;0;5
FR;6;2022-05-13;155;97;17;21;137;22;16;0;0;10969;6484;467;233;8497;835;353;0;5
FR;6;2022-05-14;81;60;6;7;84;15;2;0;0;11050;6544;473;240;8581;850;355;0;5
FR;6;2022-05-15;12;7;0;0;14;0;0;0;0;11062;6551;473;240;8595;850;355;0;5
FR;6;2022-05-16;65;54;6;2;69;12;3;0;0;11127;6605;479;242;8664;862;358;0;5
FR;6;2022-05-17;123;77;5;7;92;11;8;0;0;11250;6682;484;249;8756;873;366;0;5
FR;6;2022-05-18;131;116;5;1;159;13;3;0;0;11381;6798;489;250;8915;886;369;0;5
FR;6;2022-05-19;124;57;6;8;96;9;8;0;0;11505;6855;495;258;9011;895;377;0;5
FR;6;2022-05-20;125;115;13;3;151;18;10;0;0;11630;6970;508;261;9162;913;387;0;5
FR;6;2022-05-21;92;69;14;3;93;12;8;0;0;11722;7039;522;264;9255;925;395;0;5
FR;6;2022-05-22;19;12;5;0;21;4;1;0;0;11741;7051;527;264;9276;929;396;0;5
FR;6;2022-05-23;77;72;4;2;90;7;2;0;0;11818;7123;531;266;9366;936;398;0;5
FR;6;2022-05-24;117;98;8;2;132;16;4;0;0;11935;7221;539;268;9498;952;402;0;5
FR;6;2022-05-25;139;129;6;3;170;11;6;0;0;12074;7350;545;271;9668;963;408;0;5
FR;6;2022-05-26;7;9;3;0;5;9;0;0;0;12081;7359;548;271;9673;972;408;0;5
FR;6;2022-05-27;127;105;15;11;137;18;18;0;1;12208;7464;563;282;9810;990;426;0;6
FR;6;2022-05-28;54;75;1;5;89;8;5;0;0;12262;7539;564;287;9899;998;431;0;6
FR;6;2022-05-29;8;10;0;0;10;1;0;0;0;12270;7549;564;287;9909;999;431;0;6
FR;6;2022-05-30;70;70;7;4;86;4;9;0;0;12340;7619;571;291;9995;1003;440;0;6
FR;6;2022-05-31;87;102;10;2;122;14;7;0;0;12427;7721;581;293;10117;1017;447;0;6
FR;6;2022-06-01;97;89;10;1;111;11;6;0;0;12524;7810;591;294;10228;1028;453;0;6
FR;6;2022-06-02;91;60;6;3;80;9;6;0;0;12615;7870;597;297;10308;1037;459;0;6
FR;6;2022-06-03;126;102;13;7;129;21;8;0;0;12741;7972;610;304;10437;1058;467;0;6
FR;6;2022-06-04;63;51;10;0;64;12;3;0;0;12804;8023;620;304;10501;1070;470;0;6
FR;6;2022-06-05;16;15;2;1;18;4;1;0;0;12820;8038;622;305;10519;1074;471;0;6
FR;6;2022-06-06;9;6;0;0;8;0;0;0;0;12829;8044;622;305;10527;1074;471;0;6
FR;6;2022-06-07;79;90;3;4;117;8;6;0;0;12908;8134;625;309;10644;1082;477;0;6
FR;6;2022-06-08;92;110;13;5;130;20;6;0;0;13000;8244;638;314;10774;1102;483;0;6
FR;6;2022-06-09;75;81;15;3;106;15;8;0;0;13075;8325;653;317;10880;1117;491;0;6
FR;6;2022-06-10;116;93;26;10;121;22;13;0;0;13191;8418;679;327;11001;1139;504;0;6
FR;6;2022-06-11;83;62;6;10;82;12;11;0;0;13274;8480;685;337;11083;1151;515;0;6
FR;6;2022-06-12;6;14;1;0;16;2;0;0;0;13280;8494;686;337;11099;1153;515;0;6
FR;6;2022-06-13;74;59;18;1;68;7;4;0;0;13354;8553;704;338;11167;1160;519;0;6
FR;6;2022-06-14;98;100;8;5;116;16;8;0;0;13452;8653;712;343;11283;1176;527;0;6
FR;6;2022-06-15;80;86;7;8;114;15;10;0;0;13532;8739;719;351;11397;1191;537;0;6
FR;6;2022-06-16;53;40;11;7;45;14;6;0;0;13585;8779;730;358;11442;1205;543;0;6
FR;6;2022-06-17;86;85;3;13;109;11;5;0;0;13671;8864;733;371;11551;1216;548;0;6
FR;6;2022-06-18;71;62;13;0;87;21;1;0;0;13742;8926;746;371;11638;1237;549;0;6
FR;6;2022-06-19;6;6;3;0;7;4;1;0;0;13748;8932;749;371;11645;1241;550;0;6
FR;6;2022-06-20;42;41;4;1;55;6;1;0;0;13790;8973;753;372;11700;1247;551;0;6
FR;6;2022-06-21;59;73;10;7;82;17;7;0;0;13849;9046;763;379;11782;1264;558;0;6
FR;6;2022-06-22;86;85;8;2;98;17;3;0;0;13935;9131;771;381;11880;1281;561;0;6
FR;6;2022-06-23;64;39;13;7;41;15;10;0;0;13999;9170;784;388;11921;1296;571;0;6
FR;6;2022-06-24;77;85;7;14;95;20;16;0;0;14076;9255;791;402;12016;1316;587;0;6
FR;6;2022-06-25;67;61;4;3;77;8;5;0;0;14143;9316;795;405;12093;1324;592;0;6
FR;6;2022-06-26;6;7;1;0;10;1;0;0;0;14149;9323;796;405;12103;1325;592;0;6
FR;6;2022-06-27;51;50;4;9;62;12;7;0;0;14200;9373;800;414;12165;1337;599;0;6
FR;6;2022-06-28;68;47;6;3;53;15;5;0;0;14268;9420;806;417;12218;1352;604;0;6
FR;6;2022-06-29;98;117;26;37;115;19;35;0;5;14366;9537;832;454;12333;1371;639;0;11
FR;6;2022-06-30;84;60;33;10;61;12;7;0;0;14450;9597;865;464;12394;1383;646;0;11
FR;6;2022-07-01;115;94;25;33;102;18;27;0;1;14565;9691;890;497;12496;1401;673;0;12
FR;6;2022-07-02;58;67;26;2;64;37;6;0;0;14623;9758;916;499;12560;1438;679;0;12
FR;6;2022-07-03;11;4;4;3;5;4;3;0;0;14634;9762;920;502;12565;1442;682;0;12
FR;6;2022-07-04;61;43;3;23;55;13;20;0;0;14695;9805;923;525;12620;1455;702;0;12
FR;6;2022-07-05;65;53;19;67;60;27;63;0;0;14760;9858;942;592;12680;1482;765;0;12
FR;6;2022-07-06;94;64;7;11;77;12;17;0;0;14854;9922;949;603;12757;1494;782;0;12
FR;6;2022-07-07;99;79;42;37;99;14;34;0;4;14953;10001;991;640;12856;1508;816;0;16
FR;6;2022-07-08;139;87;42;27;116;10;25;0;3;15092;10088;1033;667;12972;1518;841;0;19
FR;6;2022-07-09;53;51;16;29;51;27;33;0;1;15145;10139;1049;696;13023;1545;874;0;20
FR;6;2022-07-10;3;7;8;0;9;9;0;0;0;15148;10146;1057;696;13032;1554;874;0;20
FR;6;2022-07-11;54;44;5;4;47;12;4;0;0;15202;10190;1062;700;13079;1566;878;0;20
FR;6;2022-07-12;70;72;12;23;87;12;27;0;0;15272;10262;1074;723;13166;1578;905;0;20
FR;6;2022-07-13;84;65;14;21;71;25;22;0;0;15356;10327;1088;744;13237;1603;927;0;20
FR;6;2022-07-14;4;3;1;0;4;1;0;0;0;15360;10330;1089;744;13241;1604;927;0;20
FR;6;2022-07-15;74;59;9;57;85;16;45;0;0;15434;10389;1098;801;13326;1620;972;0;20
FR;6;2022-07-16;27;31;17;0;37;17;3;0;0;15461;10420;1115;801;13363;1637;975;0;20
FR;6;2022-07-17;3;7;0;0;8;0;0;0;0;15464;10427;1115;801;13371;1637;975;0;20
FR;6;2022-07-18;37;62;11;14;60;15;14;0;6;15501;10489;1126;815;13431;1652;989;0;26
FR;6;2022-07-19;54;48;4;19;60;6;21;0;1;15555;10537;1130;834;13491;1658;1010;0;27
FR;6;2022-07-20;53;70;7;22;75;11;27;0;0;15608;10607;1137;856;13566;1669;1037;0;27
FR;6;2022-07-21;51;61;4;7;56;11;9;0;0;15659;10668;1141;863;13622;1680;1046;0;27
FR;6;2022-07-22;55;74;7;26;82;8;16;0;2;15714;10742;1148;889;13704;1688;1062;0;29
FR;6;2022-07-23;38;40;6;10;40;6;9;0;1;15752;10782;1154;899;13744;1694;1071;0;30
FR;6;2022-07-24;11;14;1;3;19;3;3;0;0;15763;10796;1155;902;13763;1697;1074;0;30
FR;6;2022-07-25;60;44;8;12;41;9;13;0;1;15823;10840;1163;914;13804;1706;1087;0;31
FR;6;2022-07-26;47;64;14;6;62;10;13;0;0;15870;10904;1177;920;13866;1716;1100;0;31
FR;6;2022-07-27;54;78;15;11;81;17;15;0;8;15924;10982;1192;931;13947;1733;1115;0;39
FR;6;2022-07-28;30;48;4;6;50;8;7;0;1;15954;11030;1196;937;13997;1741;1122;0;40
FR;6;2022-07-29;43;71;10;38;60;24;36;0;1;15997;11101;1206;975;14057;1765;1158;0;41
FR;6;2022-07-30;26;48;4;15;49;7;15;0;0;16023;11149;1210;990;14106;1772;1173;0;41
FR;6;2022-07-31;0;1;1;0;1;0;1;0;0;16023;11150;1211;990;14107;1772;1174;0;41
FR;6;2022-08-01;39;36;14;8;32;10;6;0;1;16062;11186;1225;998;14139;1782;1180;0;42
FR;6;2022-08-02;37;46;10;14;52;6;16;0;0;16099;11232;1235;1012;14191;1788;1196;0;42
FR;6;2022-08-03;29;52;7;16;53;11;19;0;0;16128;11284;1242;1028;14244;1799;1215;0;42
FR;6;2022-08-04;25;21;4;9;20;6;10;0;1;16153;11305;1246;1037;14264;1805;1225;0;43
FR;6;2022-08-05;43;45;1;7;53;5;7;0;0;16196;11350;1247;1044;14317;1810;1232;0;43
FR;6;2022-08-06;17;27;1;3;33;2;4;0;0;16213;11377;1248;1047;14350;1812;1236;0;43
FR;6;2022-08-07;1;2;0;0;2;0;0;0;0;16214;11379;1248;1047;14352;1812;1236;0;43
FR;6;2022-08-08;24;33;1;0;40;1;0;0;0;16238;11412;1249;1047;14392;1813;1236;0;43
FR;6;2022-08-09;22;30;6;3;29;3;3;0;0;16260;11442;1255;1050;14421;1816;1239;0;43
FR;6;2022-08-10;32;36;5;9;38;5;9;0;5;16292;11478;1260;1059;14459;1821;1248;0;48
FR;6;2022-08-11;33;33;1;1;40;1;0;0;1;16325;11511;1261;1060;14499;1822;1248;0;49
FR;6;2022-08-12;50;44;6;2;50;15;3;0;1;16375;11555;1267;1062;14549;1837;1251;0;50
FR;6;2022-08-13;9;20;0;0;22;1;0;0;0;16384;11575;1267;1062;14571;1838;1251;0;50
FR;6;2022-08-14;3;1;0;0;2;0;0;0;0;16387;11576;1267;1062;14573;1838;1251;0;50
FR;6;2022-08-15;2;3;1;0;4;0;1;0;0;16389;11579;1268;1062;14577;1838;1252;0;50
FR;6;2022-08-16;35;66;21;7;66;7;2;0;0;16424;11645;1289;1069;14643;1845;1254;0;50
FR;6;2022-08-17;32;44;10;9;41;10;6;0;7;16456;11689;1299;1078;14684;1855;1260;0;57
FR;6;2022-08-18;29;55;14;4;61;4;0;0;1;16485;11744;1313;1082;14745;1859;1260;0;58
FR;6;2022-08-19;30;45;5;4;47;3;2;0;1;16515;11789;1318;1086;14792;1862;1262;0;59
FR;6;2022-08-20;26;29;3;0;29;8;1;0;0;16541;11818;1321;1086;14821;1870;1263;0;59
FR;6;2022-08-21;1;5;2;0;5;0;0;0;0;16542;11823;1323;1086;14826;1870;1263;0;59
FR;6;2022-08-22;20;42;15;1;45;0;0;0;0;16562;11865;1338;1087;14871;1870;1263;0;59
FR;6;2022-08-23;34;45;6;7;47;6;4;0;2;16596;11910;1344;1094;14918;1876;1267;0;61
FR;6;2022-08-24;34;30;6;3;36;6;2;0;3;16630;11940;1350;1097;14954;1882;1269;0;64
FR;6;2022-08-25;25;27;1;1;29;5;1;0;0;16655;11967;1351;1098;14983;1887;1270;0;64
FR;6;2022-08-26;38;44;4;4;51;7;7;0;0;16693;12011;1355;1102;15034;1894;1277;0;64
FR;6;2022-08-27;19;21;7;3;22;8;4;0;0;16712;12032;1362;1105;15056;1902;1281;0;64
FR;6;2022-08-28;6;3;0;6;3;1;1;0;4;16718;12035;1362;1111;15059;1903;1282;0;68
FR;6;2022-08-29;26;22;2;6;29;3;6;0;0;16744;12057;1364;1117;15088;1906;1288;0;68
FR;6;2022-08-30;28;35;4;12;33;8;13;0;0;16772;12092;1368;1129;15121;1914;1301;0;68
FR;6;2022-08-31;35;38;2;11;46;3;12;0;0;16807;12130;1370;1140;15167;1917;1313;0;68
FR;6;2022-09-01;17;11;5;1;13;4;3;0;0;16824;12141;1375;1141;15180;1921;1316;0;68
FR;6;2022-09-02;19;14;2;1;13;3;2;0;0;16843;12155;1377;1142;15193;1924;1318;0;68
FR;6;2022-09-03;10;3;1;5;4;2;5;0;0;16853;12158;1378;1147;15197;1926;1323;0;68
FR;6;2022-09-04;4;1;0;0;1;0;0;0;0;16857;12159;1378;1147;15198;1926;1323;0;68
FR;6;2022-09-05;8;7;0;0;10;0;0;0;0;16865;12166;1378;1147;15208;1926;1323;0;68
FR;6;2022-09-06;7;9;7;12;8;6;15;0;0;16872;12175;1385;1159;15216;1932;1338;0;68
FR;6;2022-09-07;3;8;1;0;8;1;0;0;0;16875;12183;1386;1159;15224;1933;1338;0;68
FR;6;2022-09-08;6;4;0;2;3;1;2;0;0;16881;12187;1386;1161;15227;1934;1340;0;68
FR;6;2022-09-09;7;9;2;7;9;3;8;0;0;16888;12196;1388;1168;15236;1937;1348;0;68
FR;6;2022-09-10;3;4;1;0;3;1;1;0;0;16891;12200;1389;1168;15239;1938;1349;0;68
FR;6;2022-09-11;1;3;0;0;3;0;0;0;0;16892;12203;1389;1168;15242;1938;1349;0;68
FR;6;2022-09-12;10;4;1;0;3;3;0;0;0;16902;12207;1390;1168;15245;1941;1349;0;68
FR;6;2022-09-13;7;2;3;0;2;2;2;0;0;16909;12209;1393;1168;15247;1943;1351;0;68
FR;6;2022-09-14;9;8;2;0;7;4;0;0;0;16918;12217;1395;1168;15254;1947;1351;0;68
FR;6;2022-09-15;8;13;5;5;9;9;3;0;2;16926;12230;1400;1173;15263;1956;1354;0;70
FR;6;2022-09-16;25;39;1;1;47;4;1;0;2;16951;12269;1401;1174;15310;1960;1355;0;72
FR;6;2022-09-17;24;22;0;6;24;5;3;0;2;16975;12291;1401;1180;15334;1965;1358;0;74
FR;6;2022-09-18;5;4;0;0;4;1;0;0;0;16980;12295;1401;1180;15338;1966;1358;0;74
FR;6;2022-09-19;30;30;2;1;31;5;1;0;0;17010;12325;1403;1181;15369;1971;1359;0;74
FR;6;2022-09-20;34;25;1;4;29;6;2;0;1;17044;12350;1404;1185;15398;1977;1361;0;75
FR;6;2022-09-21;21;9;3;3;7;7;5;0;3;17065;12359;1407;1188;15405;1984;1366;0;78
FR;6;2022-09-22;19;28;1;22;32;3;21;0;1;17084;12387;1408;1210;15437;1987;1387;0;79
FR;6;2022-09-23;28;41;5;9;47;9;2;0;0;17112;12428;1413;1219;15484;1996;1389;0;79
FR;6;2022-09-24;16;16;4;2;21;6;2;0;0;17128;12444;1417;1221;15505;2002;1391;0;79
FR;6;2022-09-25;3;14;0;0;14;1;0;0;0;17131;12458;1417;1221;15519;2003;1391;0;79
FR;6;2022-09-26;16;13;0;18;12;5;18;0;2;17147;12471;1417;1239;15531;2008;1409;0;81
FR;6;2022-09-27;32;19;2;3;23;4;4;0;0;17179;12490;1419;1242;15554;2012;1413;0;81
FR;6;2022-09-28;27;10;9;11;16;5;17;0;2;17206;12500;1428;1253;15570;2017;1430;0;83
FR;6;2022-09-29;13;13;10;34;16;6;33;0;7;17219;12513;1438;1287;15586;2023;1463;0;90
FR;6;2022-09-30;34;24;5;6;33;5;3;0;0;17253;12537;1443;1293;15619;2028;1466;0;90
FR;6;2022-10-01;17;12;5;8;9;8;8;0;2;17270;12549;1448;1301;15628;2036;1474;0;92
FR;6;2022-10-02;3;0;0;0;1;0;0;0;0;17273;12549;1448;1301;15629;2036;1474;0;92
FR;6;2022-10-03;11;10;3;5;11;4;6;0;0;17284;12559;1451;1306;15640;2040;1480;0;92
FR;6;2022-10-04;19;17;4;28;21;3;30;0;3;17303;12576;1455;1334;15661;2043;1510;0;95
FR;6;2022-10-05;11;12;3;2;9;7;4;0;0;17314;12588;1458;1336;15670;2050;1514;0;95
FR;6;2022-10-06;19;13;4;6;17;2;10;0;0;17333;12601;1462;1342;15687;2052;1524;0;95
FR;6;2022-10-07;27;26;5;24;25;10;16;0;5;17360;12627;1467;1366;15712;2062;1540;0;100
FR;6;2022-10-08;18;13;0;0;16;0;0;0;0;17378;12640;1467;1366;15728;2062;1540;0;100
FR;6;2022-10-09;7;3;4;27;3;4;30;0;6;17385;12643;1471;1393;15731;2066;1570;0;106
FR;6;2022-10-10;15;14;1;16;16;6;13;0;0;17400;12657;1472;1409;15747;2072;1583;0;106
FR;6;2022-10-11;21;23;3;11;21;8;13;0;3;17421;12680;1475;1420;15768;2080;1596;0;109
FR;6;2022-10-12;20;16;7;19;18;3;24;0;7;17441;12696;1482;1439;15786;2083;1620;0;116
FR;6;2022-10-13;28;15;2;36;23;0;38;0;6;17469;12711;1484;1475;15809;2083;1658;0;122
FR;6;2022-10-14;29;23;5;49;23;11;45;0;13;17498;12734;1489;1524;15832;2094;1703;0;135
FR;6;2022-10-15;13;9;0;22;8;4;21;0;6;17511;12743;1489;1546;15840;2098;1724;0;141
FR;6;2022-10-16;4;5;0;6;2;3;6;0;0;17515;12748;1489;1552;15842;2101;1730;0;141
FR;6;2022-10-17;14;14;2;10;14;1;12;0;2;17529;12762;1491;1562;15856;2102;1742;0;143
FR;6;2022-10-18;12;19;9;26;19;4;18;0;11;17541;12781;1500;1588;15875;2106;1760;0;154
FR;6;2022-10-19;10;20;6;16;20;5;19;0;5;17551;12801;1506;1604;15895;2111;1779;0;159
FR;6;2022-10-20;16;15;12;57;18;5;67;0;13;17567;12816;1518;1661;15913;2116;1846;0;172
FR;6;2022-10-21;16;21;9;34;22;11;37;0;10;17583;12837;1527;1695;15935;2127;1883;0;182
FR;6;2022-10-22;19;14;1;4;17;3;4;0;0;17602;12851;1528;1699;15952;2130;1887;0;182
FR;6;2022-10-23;3;2;1;0;3;0;1;0;0;17605;12853;1529;1699;15955;2130;1888;0;182
FR;6;2022-10-24;12;14;2;7;14;6;5;0;2;17617;12867;1531;1706;15969;2136;1893;0;184
FR;6;2022-10-25;20;13;6;17;16;7;19;0;4;17637;12880;1537;1723;15985;2143;1912;0;188
FR;6;2022-10-26;17;9;4;13;12;4;15;0;5;17654;12889;1541;1736;15997;2147;1927;0;193
FR;6;2022-10-27;20;7;8;37;10;6;36;0;14;17674;12896;1549;1773;16007;2153;1963;0;207
FR;6;2022-10-28;21;27;3;4;28;6;5;0;1;17695;12923;1552;1777;16035;2159;1968;0;208
FR;6;2022-10-29;7;11;5;11;10;6;14;0;12;17702;12934;1557;1788;16045;2165;1982;0;220
FR;6;2022-10-30;2;5;0;0;5;0;0;0;0;17704;12939;1557;1788;16050;2165;1982;0;220
FR;6;2022-10-31;20;14;2;13;17;4;12;0;3;17724;12953;1559;1801;16067;2169;1994;0;223
FR;6;2022-11-01;2;1;1;0;1;1;0;0;0;17726;12954;1560;1801;16068;2170;1994;0;223
FR;6;2022-11-02;15;25;9;21;26;11;19;0;12;17741;12979;1569;1822;16094;2181;2013;0;235
FR;6;2022-11-03;17;17;11;39;20;8;43;0;9;17758;12996;1580;1861;16114;2189;2056;0;244
FR;6;2022-11-04;19;22;9;16;27;5;16;0;10;17777;13018;1589;1877;16141;2194;2072;0;254
FR;6;2022-11-05;9;16;2;4;17;4;6;0;0;17786;13034;1591;1881;16158;2198;2078;0;254
FR;6;2022-11-06;5;1;0;0;1;0;0;0;0;17791;13035;1591;1881;16159;2198;2078;0;254
FR;6;2022-11-07;18;10;6;17;12;4;18;0;11;17809;13045;1597;1898;16171;2202;2096;0;265
FR;6;2022-11-08;18;10;2;3;8;5;5;0;4;17827;13055;1599;1901;16179;2207;2101;0;269
FR;6;2022-11-09;16;22;1;6;21;4;5;0;4;17843;13077;1600;1907;16200;2211;2106;0;273
FR;6;2022-11-10;10;10;4;12;8;5;11;0;10;17853;13087;1604;1919;16208;2216;2117;0;283
FR;6;2022-11-11;3;1;0;0;1;1;0;0;0;17856;13088;1604;1919;16209;2217;2117;0;283
FR;6;2022-11-12;4;11;1;7;11;2;5;0;9;17860;13099;1605;1926;16220;2219;2122;0;292
FR;6;2022-11-13;1;1;0;1;1;0;1;0;0;17861;13100;1605;1927;16221;2219;2123;0;292
FR;6;2022-11-14;13;10;7;32;14;8;33;0;14;17874;13110;1612;1959;16235;2227;2156;0;306
FR;6;2022-11-15;7;18;1;11;16;4;7;0;2;17881;13128;1613;1970;16251;2231;2163;0;308
FR;6;2022-11-16;16;15;9;32;17;3;42;0;9;17897;13143;1622;2002;16268;2234;2205;0;317
FR;6;2022-11-17;10;8;1;29;8;2;28;0;5;17907;13151;1623;2031;16276;2236;2233;0;322
FR;6;2022-11-18;20;12;5;23;16;4;25;0;7;17927;13163;1628;2054;16292;2240;2258;0;329
FR;6;2022-11-19;5;13;0;2;11;3;2;0;1;17932;13176;1628;2056;16303;2243;2260;0;330
FR;6;2022-11-20;2;1;2;0;1;2;0;0;0;17934;13177;1630;2056;16304;2245;2260;0;330
FR;6;2022-11-21;22;13;1;14;14;6;11;0;3;17956;13190;1631;2070;16318;2251;2271;0;333
FR;6;2022-11-22;14;9;0;4;11;1;3;0;1;17970;13199;1631;2074;16329;2252;2274;0;334
FR;6;2022-11-23;14;15;15;23;17;9;31;0;8;17984;13214;1646;2097;16346;2261;2305;0;342
FR;6;2022-11-24;14;17;1;11;19;5;10;0;7;17998;13231;1647;2108;16365;2266;2315;0;349
FR;6;2022-11-25;23;15;5;50;15;5;47;0;5;18021;13246;1652;2158;16380;2271;2362;0;354
FR;6;2022-11-26;9;5;2;4;3;2;5;0;1;18030;13251;1654;2162;16383;2273;2367;0;355
FR;6;2022-11-27;1;4;0;0;4;0;0;0;0;18031;13255;1654;2162;16387;2273;2367;0;355
FR;6;2022-11-28;9;11;6;22;11;3;24;0;11;18040;13266;1660;2184;16398;2276;2391;0;366
FR;6;2022-11-29;15;10;1;12;14;1;8;0;7;18055;13276;1661;2196;16412;2277;2399;0;373
FR;6;2022-11-30;18;20;8;23;19;12;22;0;8;18073;13296;1669;2219;16431;2289;2421;0;381
FR;6;2022-12-01;12;8;7;20;10;4;24;0;9;18085;13304;1676;2239;16441;2293;2445;0;390
FR;6;2022-12-02;16;9;12;36;12;8;42;0;1;18101;13313;1688;2275;16453;2301;2487;0;391
FR;6;2022-12-03;13;3;13;20;6;5;28;0;13;18114;13316;1701;2295;16459;2306;2515;0;404
FR;6;2022-12-04;3;1;0;2;1;0;2;0;0;18117;13317;1701;2297;16460;2306;2517;0;404
FR;6;2022-12-05;11;10;7;16;11;4;19;0;8;18128;13327;1708;2313;16471;2310;2536;0;412
FR;6;2022-12-06;10;19;3;30;12;11;28;0;3;18138;13346;1711;2343;16483;2321;2564;0;415
FR;6;2022-12-07;17;8;10;56;10;8;57;0;30;18155;13354;1721;2399;16493;2329;2621;0;445
FR;6;2022-12-08;9;13;8;18;11;7;21;0;12;18164;13367;1729;2417;16504;2336;2642;0;457
FR;6;2022-12-09;15;9;5;29;12;4;30;0;6;18179;13376;1734;2446;16516;2340;2672;0;463
FR;6;2022-12-10;12;9;6;9;7;4;14;0;7;18191;13385;1740;2455;16523;2344;2686;0;470
FR;6;2022-12-11;4;2;1;0;2;1;0;0;0;18195;13387;1741;2455;16525;2345;2686;0;470
FR;6;2022-12-12;16;10;8;36;14;9;33;0;17;18211;13397;1749;2491;16539;2354;2719;0;487
FR;6;2022-12-13;17;21;12;66;16;18;65;0;14;18228;13418;1761;2557;16555;2372;2784;0;501
FR;6;2022-12-14;14;13;8;53;11;12;53;0;14;18242;13431;1769;2610;16566;2384;2837;0;515
FR;6;2022-12-15;12;15;14;38;13;9;44;0;9;18254;13446;1783;2648;16579;2393;2881;0;524
FR;6;2022-12-16;18;14;15;39;15;14;39;0;13;18272;13460;1798;2687;16594;2407;2920;0;537
FR;6;2022-12-17;11;10;15;28;8;15;29;0;8;18283;13470;1813;2715;16602;2422;2949;0;545
FR;6;2022-12-18;7;4;0;2;5;0;2;0;0;18290;13474;1813;2717;16607;2422;2951;0;545
FR;6;2022-12-19;12;8;9;29;8;12;29;0;15;18302;13482;1822;2746;16615;2434;2980;0;560
FR;6;2022-12-20;17;23;11;23;17;19;22;0;21;18319;13505;1833;2769;16632;2453;3002;0;581
FR;6;2022-12-21;23;16;9;19;13;13;17;0;5;18342;13521;1842;2788;16645;2466;3019;0;586
FR;6;2022-12-22;13;14;9;21;15;13;18;0;11;18355;13535;1851;2809;16660;2479;3037;0;597
FR;6;2022-12-23;10;19;11;7;14;17;7;0;3;18365;13554;1862;2816;16674;2496;3044;0;600
FR;6;2022-12-24;3;5;2;0;5;1;2;0;0;18368;13559;1864;2816;16679;2497;3046;0;600
FR;6;2022-12-25;0;0;0;0;0;0;0;0;0;18368;13559;1864;2816;16679;2497;3046;0;600
FR;6;2022-12-26;8;12;12;11;10;18;11;0;3;18376;13571;1876;2827;16689;2515;3057;0;603
FR;6;2022-12-27;17;13;15;8;12;19;8;0;0;18393;13584;1891;2835;16701;2534;3065;0;603
FR;6;2022-12-28;15;19;6;8;18;9;9;0;4;18408;13603;1897;2843;16719;2543;3074;0;607
FR;6;2022-12-29;14;12;7;8;10;9;9;0;7;18422;13615;1904;2851;16729;2552;3083;0;614
FR;6;2022-12-30;20;18;13;8;19;13;11;0;4;18442;13633;1917;2859;16748;2565;3094;0;618
FR;6;2022-12-31;5;1;6;0;4;6;0;0;0;18447;13634;1923;2859;16752;2571;3094;0;618
FR;6;2023-01-01;2;1;0;3;0;3;0;0;1;18449;13635;1923;2862;16752;2574;3094;0;619
FR;6;2023-01-02;9;14;2;3;10;7;3;0;0;18458;13649;1925;2865;16762;2581;3097;0;619
FR;8;2020-12-27;0;0;0;0;0;0;0;0;0;0;0;0;0;0;0;0;0;0
FR;8;2020-12-28;0;0;0;0;0;0;0;0;0;0;0;0;0;0;0;0;0;0
FR;8;2020-12-29;0;0;0;0;0;0;0;0;0;0;0;0;0;0;0;0;0;0
FR;8;2020-12-30;0;0;0;0;0;0;0;0;0;0;0;0;0;0;0;0;0;0
FR;8;2020-12-31;0;0;0;0;0;0;0;0;0;0;0;0;0;0;0;0;0;0
FR;8;2021-01-01;0;0;0;0;0;0;0;0;0;0;0;0;0;0;0;0;0;0
FR;8;2021-01-02;0;0;0;0;0;0;0;0;0;0;0;0;0;0;0;0;0;0
FR;8;2021-01-03;0;0;0;0;0;0;0;0;0;0;0;0;0;0;0;0;0;0
FR;8;2021-01-04;0;0;0;0;0;0;0;0;0;0;0;0;0;0;0;0;0;0
FR;8;2021-01-05;0;0;0;0;0;0;0;0;0;0;0;0;0;0;0;0;0;0
FR;8;2021-01-06;0;0;0;0;0;0;0;0;0;0;0;0;0;0;0;0;0;0
FR;8;2021-01-07;0;0;0;0;0;0;0;0;0;0;0;0;0;0;0;0;0;0
FR;8;2021-01-08;0;0;0;0;0;0;0;0;0;0;0;0;0;0;0;0;0;0
FR;8;2021-01-09;0;0;0;0;0;0;0;0;0;0;0;0;0;0;0;0;0;0
FR;8;2021-01-10;0;0;0;0;0;0;0;0;0;0;0;0;0;0;0;0;0;0
FR;8;2021-01-11;0;0;0;0;0;0;0;0;0;0;0;0;0;0;0;0;0;0
FR;8;2021-01-12;0;0;0;0;0;0;0;0;0;0;0;0;0;0;0;0;0;0
FR;8;2021-01-13;0;0;0;0;0;0;0;0;0;0;0;0;0;0;0;0;0;0
FR;8;2021-01-14;0;0;0;0;0;0;0;0;0;0;0;0;0;0;0;0;0;0
FR;8;2021-01-15;0;0;0;0;0;0;0;0;0;0;0;0;0;0;0;0;0;0
FR;8;2021-01-16;0;0;0;0;0;0;0;0;0;0;0;0;0;0;0;0;0;0
FR;8;2021-01-17;0;0;0;0;0;0;0;0;0;0;0;0;0;0;0;0;0;0
FR;8;2021-01-18;0;0;0;0;0;0;0;0;0;0;0;0;0;0;0;0;0;0
FR;8;2021-01-19;0;0;0;0;0;0;0;0;0;0;0;0;0;0;0;0;0;0
FR;8;2021-01-20;0;0;0;0;0;0;0;0;0;0;0;0;0;0;0;0;0;0
FR;8;2021-01-21;0;0;0;0;0;0;0;0;0;0;0;0;0;0;0;0;0;0
FR;8;2021-01-22;0;0;0;0;0;0;0;0;0;0;0;0;0;0;0;0;0;0
FR;8;2021-01-23;0;0;0;0;0;0;0;0;0;0;0;0;0;0;0;0;0;0
FR;8;2021-01-24;0;0;0;0;0;0;0;0;0;0;0;0;0;0;0;0;0;0
FR;8;2021-01-25;0;0;0;0;0;0;0;0;0;0;0;0;0;0;0;0;0;0
FR;8;2021-01-26;0;0;0;0;0;0;0;0;0;0;0;0;0;0;0;0;0;0
FR;8;2021-01-27;0;0;0;0;0;0;0;0;0;0;0;0;0;0;0;0;0;0
FR;8;2021-01-28;0;0;0;0;0;0;0;0;0;0;0;0;0;0;0;0;0;0
FR;8;2021-01-29;0;0;0;0;0;0;0;0;0;0;0;0;0;0;0;0;0;0
FR;8;2021-01-30;0;0;0;0;0;0;0;0;0;0;0;0;0;0;0;0;0;0
FR;8;2021-01-31;0;0;0;0;0;0;0;0;0;0;0;0;0;0;0;0;0;0
FR;8;2021-02-01;0;0;0;0;0;0;0;0;0;0;0;0;0;0;0;0;0;0
FR;8;2021-02-02;0;0;0;0;0;0;0;0;0;0;0;0;0;0;0;0;0;0
FR;8;2021-02-03;0;0;0;0;0;0;0;0;0;0;0;0;0;0;0;0;0;0
FR;8;2021-02-04;0;0;0;0;0;0;0;0;0;0;0;0;0;0;0;0;0;0
FR;8;2021-02-05;0;0;0;0;0;0;0;0;0;0;0;0;0;0;0;0;0;0
FR;8;2021-02-06;0;0;0;0;0;0;0;0;0;0;0;0;0;0;0;0;0;0
FR;8;2021-02-07;0;0;0;0;0;0;0;0;0;0;0;0;0;0;0;0;0;0
FR;8;2021-02-08;0;0;0;0;0;0;0;0;0;0;0;0;0;0;0;0;0;0
FR;8;2021-02-09;0;0;0;0;0;0;0;0;0;0;0;0;0;0;0;0;0;0
FR;8;2021-02-10;0;0;0;0;0;0;0;0;0;0;0;0;0;0;0;0;0;0
FR;8;2021-02-11;0;0;0;0;0;0;0;0;0;0;0;0;0;0;0;0;0;0
FR;8;2021-02-12;0;0;0;0;0;0;0;0;0;0;0;0;0;0;0;0;0;0
FR;8;2021-02-13;0;0;0;0;0;0;0;0;0;0;0;0;0;0;0;0;0;0
FR;8;2021-02-14;0;0;0;0;0;0;0;0;0;0;0;0;0;0;0;0;0;0
FR;8;2021-02-15;0;0;0;0;0;0;0;0;0;0;0;0;0;0;0;0;0;0
FR;8;2021-02-16;0;0;0;0;0;0;0;0;0;0;0;0;0;0;0;0;0;0
FR;8;2021-02-17;0;0;0;0;0;0;0;0;0;0;0;0;0;0;0;0;0;0
FR;8;2021-02-18;0;0;0;0;0;0;0;0;0;0;0;0;0;0;0;0;0;0
FR;8;2021-02-19;0;0;0;0;0;0;0;0;0;0;0;0;0;0;0;0;0;0
FR;8;2021-02-20;0;0;0;0;0;0;0;0;0;0;0;0;0;0;0;0;0;0
FR;8;2021-02-21;0;0;0;0;0;0;0;0;0;0;0;0;0;0;0;0;0;0
FR;8;2021-02-22;0;0;0;0;0;0;0;0;0;0;0;0;0;0;0;0;0;0
FR;8;2021-02-23;0;0;0;0;0;0;0;0;0;0;0;0;0;0;0;0;0;0
FR;8;2021-02-24;0;0;0;0;0;0;0;0;0;0;0;0;0;0;0;0;0;0
FR;8;2021-02-25;0;0;0;0;0;0;0;0;0;0;0;0;0;0;0;0;0;0
FR;8;2021-02-26;0;0;0;0;0;0;0;0;0;0;0;0;0;0;0;0;0;0
FR;8;2021-02-27;0;0;0;0;0;0;0;0;0;0;0;0;0;0;0;0;0;0
FR;8;2021-02-28;0;0;0;0;0;0;0;0;0;0;0;0;0;0;0;0;0;0
FR;8;2021-03-01;0;0;0;0;0;0;0;0;0;0;0;0;0;0;0;0;0;0
FR;8;2021-03-02;0;0;0;0;0;0;0;0;0;0;0;0;0;0;0;0;0;0
FR;8;2021-03-03;0;0;0;0;0;0;0;0;0;0;0;0;0;0;0;0;0;0
FR;8;2021-03-04;0;0;0;0;0;0;0;0;0;0;0;0;0;0;0;0;0;0
FR;8;2021-03-05;0;0;0;0;0;0;0;0;0;0;0;0;0;0;0;0;0;0
FR;8;2021-03-06;0;0;0;0;0;0;0;0;0;0;0;0;0;0;0;0;0;0
FR;8;2021-03-07;0;0;0;0;0;0;0;0;0;0;0;0;0;0;0;0;0;0
FR;8;2021-03-08;0;0;0;0;0;0;0;0;0;0;0;0;0;0;0;0;0;0
FR;8;2021-03-09;0;0;0;0;0;0;0;0;0;0;0;0;0;0;0;0;0;0
FR;8;2021-03-10;0;0;0;0;0;0;0;0;0;0;0;0;0;0;0;0;0;0
FR;8;2021-03-11;0;0;0;0;0;0;0;0;0;0;0;0;0;0;0;0;0;0
FR;8;2021-03-12;0;0;0;0;0;0;0;0;0;0;0;0;0;0;0;0;0;0
FR;8;2021-03-13;0;0;0;0;0;0;0;0;0;0;0;0;0;0;0;0;0;0
FR;8;2021-03-14;0;0;0;0;0;0;0;0;0;0;0;0;0;0;0;0;0;0
FR;8;2021-03-15;0;0;0;0;0;0;0;0;0;0;0;0;0;0;0;0;0;0
FR;8;2021-03-16;0;0;0;0;0;0;0;0;0;0;0;0;0;0;0;0;0;0
FR;8;2021-03-17;0;0;0;0;0;0;0;0;0;0;0;0;0;0;0;0;0;0
FR;8;2021-03-18;0;0;0;0;0;0;0;0;0;0;0;0;0;0;0;0;0;0
FR;8;2021-03-19;0;0;0;0;0;0;0;0;0;0;0;0;0;0;0;0;0;0
FR;8;2021-03-20;0;0;0;0;0;0;0;0;0;0;0;0;0;0;0;0;0;0
FR;8;2021-03-21;0;0;0;0;0;0;0;0;0;0;0;0;0;0;0;0;0;0
FR;8;2021-03-22;0;0;0;0;0;0;0;0;0;0;0;0;0;0;0;0;0;0
FR;8;2021-03-23;0;0;0;0;0;0;0;0;0;0;0;0;0;0;0;0;0;0
FR;8;2021-03-24;0;0;0;0;0;0;0;0;0;0;0;0;0;0;0;0;0;0
FR;8;2021-03-25;0;0;0;0;0;0;0;0;0;0;0;0;0;0;0;0;0;0
FR;8;2021-03-26;0;0;0;0;0;0;0;0;0;0;0;0;0;0;0;0;0;0
FR;8;2021-03-27;0;0;0;0;0;0;0;0;0;0;0;0;0;0;0;0;0;0
FR;8;2021-03-28;0;0;0;0;0;0;0;0;0;0;0;0;0;0;0;0;0;0
FR;8;2021-03-29;0;0;0;0;0;0;0;0;0;0;0;0;0;0;0;0;0;0
FR;8;2021-03-30;0;0;0;0;0;0;0;0;0;0;0;0;0;0;0;0;0;0
FR;8;2021-03-31;0;0;0;0;0;0;0;0;0;0;0;0;0;0;0;0;0;0
FR;8;2021-04-01;0;0;0;0;0;0;0;0;0;0;0;0;0;0;0;0;0;0
FR;8;2021-04-02;0;0;0;0;0;0;0;0;0;0;0;0;0;0;0;0;0;0
FR;8;2021-04-03;0;0;0;0;0;0;0;0;0;0;0;0;0;0;0;0;0;0
FR;8;2021-04-04;0;0;0;0;0;0;0;0;0;0;0;0;0;0;0;0;0;0
FR;8;2021-04-05;0;0;0;0;0;0;0;0;0;0;0;0;0;0;0;0;0;0
FR;8;2021-04-06;0;0;0;0;0;0;0;0;0;0;0;0;0;0;0;0;0;0
FR;8;2021-04-07;0;0;0;0;0;0;0;0;0;0;0;0;0;0;0;0;0;0
FR;8;2021-04-08;0;0;0;0;0;0;0;0;0;0;0;0;0;0;0;0;0;0
FR;8;2021-04-09;0;0;0;0;0;0;0;0;0;0;0;0;0;0;0;0;0;0
FR;8;2021-04-10;0;0;0;0;0;0;0;0;0;0;0;0;0;0;0;0;0;0
FR;8;2021-04-11;0;0;0;0;0;0;0;0;0;0;0;0;0;0;0;0;0;0
FR;8;2021-04-12;0;0;0;0;0;0;0;0;0;0;0;0;0;0;0;0;0;0
FR;8;2021-04-13;0;0;0;0;0;0;0;0;0;0;0;0;0;0;0;0;0;0
FR;8;2021-04-14;0;0;0;0;0;0;0;0;0;0;0;0;0;0;0;0;0;0
FR;8;2021-04-15;0;0;0;0;0;0;0;0;0;0;0;0;0;0;0;0;0;0
FR;8;2021-04-16;0;0;0;0;0;0;0;0;0;0;0;0;0;0;0;0;0;0
FR;8;2021-04-17;0;0;0;0;0;0;0;0;0;0;0;0;0;0;0;0;0;0
FR;8;2021-04-18;0;0;0;0;0;0;0;0;0;0;0;0;0;0;0;0;0;0
FR;8;2021-04-19;0;0;0;0;0;0;0;0;0;0;0;0;0;0;0;0;0;0
FR;8;2021-04-20;0;0;0;0;0;0;0;0;0;0;0;0;0;0;0;0;0;0
FR;8;2021-04-21;0;0;0;0;0;0;0;0;0;0;0;0;0;0;0;0;0;0
FR;8;2021-04-22;0;0;0;0;0;0;0;0;0;0;0;0;0;0;0;0;0;0
FR;8;2021-04-23;0;0;0;0;0;0;0;0;0;0;0;0;0;0;0;0;0;0
FR;8;2021-04-24;0;0;0;0;0;0;0;0;0;0;0;0;0;0;0;0;0;0
FR;8;2021-04-25;0;0;0;0;0;0;0;0;0;0;0;0;0;0;0;0;0;0
FR;8;2021-04-26;0;0;0;0;0;0;0;0;0;0;0;0;0;0;0;0;0;0
FR;8;2021-04-27;0;0;0;0;0;0;0;0;0;0;0;0;0;0;0;0;0;0
FR;8;2021-04-28;0;0;0;0;0;0;0;0;0;0;0;0;0;0;0;0;0;0
FR;8;2021-04-29;0;0;0;0;0;0;0;0;0;0;0;0;0;0;0;0;0;0
FR;8;2021-04-30;0;0;0;0;0;0;0;0;0;0;0;0;0;0;0;0;0;0
FR;8;2021-05-01;0;0;0;0;0;0;0;0;0;0;0;0;0;0;0;0;0;0
FR;8;2021-05-02;0;0;0;0;0;0;0;0;0;0;0;0;0;0;0;0;0;0
FR;8;2021-05-03;0;0;0;0;0;0;0;0;0;0;0;0;0;0;0;0;0;0
FR;8;2021-05-04;0;0;0;0;0;0;0;0;0;0;0;0;0;0;0;0;0;0
FR;8;2021-05-05;0;0;0;0;0;0;0;0;0;0;0;0;0;0;0;0;0;0
FR;8;2021-05-06;0;0;0;0;0;0;0;0;0;0;0;0;0;0;0;0;0;0
FR;8;2021-05-07;0;0;0;0;0;0;0;0;0;0;0;0;0;0;0;0;0;0
FR;8;2021-05-08;0;0;0;0;0;0;0;0;0;0;0;0;0;0;0;0;0;0
FR;8;2021-05-09;0;0;0;0;0;0;0;0;0;0;0;0;0;0;0;0;0;0
FR;8;2021-05-10;0;0;0;0;0;0;0;0;0;0;0;0;0;0;0;0;0;0
FR;8;2021-05-11;0;0;0;0;0;0;0;0;0;0;0;0;0;0;0;0;0;0
FR;8;2021-05-12;0;0;0;0;0;0;0;0;0;0;0;0;0;0;0;0;0;0
FR;8;2021-05-13;0;0;0;0;0;0;0;0;0;0;0;0;0;0;0;0;0;0
FR;8;2021-05-14;0;0;0;0;0;0;0;0;0;0;0;0;0;0;0;0;0;0
FR;8;2021-05-15;0;0;0;0;0;0;0;0;0;0;0;0;0;0;0;0;0;0
FR;8;2021-05-16;0;0;0;0;0;0;0;0;0;0;0;0;0;0;0;0;0;0
FR;8;2021-05-17;0;0;0;0;0;0;0;0;0;0;0;0;0;0;0;0;0;0
FR;8;2021-05-18;0;0;0;0;0;0;0;0;0;0;0;0;0;0;0;0;0;0
FR;8;2021-05-19;0;0;0;0;0;0;0;0;0;0;0;0;0;0;0;0;0;0
FR;8;2021-05-20;0;0;0;0;0;0;0;0;0;0;0;0;0;0;0;0;0;0
FR;8;2021-05-21;0;0;0;0;0;0;0;0;0;0;0;0;0;0;0;0;0;0
FR;8;2021-05-22;0;0;0;0;0;0;0;0;0;0;0;0;0;0;0;0;0;0
FR;8;2021-05-23;0;0;0;0;0;0;0;0;0;0;0;0;0;0;0;0;0;0
FR;8;2021-05-24;0;0;0;0;0;0;0;0;0;0;0;0;0;0;0;0;0;0
FR;8;2021-05-25;0;0;0;0;0;0;0;0;0;0;0;0;0;0;0;0;0;0
FR;8;2021-05-26;0;0;0;0;0;0;0;0;0;0;0;0;0;0;0;0;0;0
FR;8;2021-05-27;0;0;0;0;0;0;0;0;0;0;0;0;0;0;0;0;0;0
FR;8;2021-05-28;0;0;0;0;0;0;0;0;0;0;0;0;0;0;0;0;0;0
FR;8;2021-05-29;0;0;0;0;0;0;0;0;0;0;0;0;0;0;0;0;0;0
FR;8;2021-05-30;0;0;0;0;0;0;0;0;0;0;0;0;0;0;0;0;0;0
FR;8;2021-05-31;0;0;0;0;0;0;0;0;0;0;0;0;0;0;0;0;0;0
FR;8;2021-06-01;0;0;0;0;0;0;0;0;0;0;0;0;0;0;0;0;0;0
FR;8;2021-06-02;0;0;0;0;0;0;0;0;0;0;0;0;0;0;0;0;0;0
FR;8;2021-06-03;0;0;0;0;0;0;0;0;0;0;0;0;0;0;0;0;0;0
FR;8;2021-06-04;0;0;0;0;0;0;0;0;0;0;0;0;0;0;0;0;0;0
FR;8;2021-06-05;0;0;0;0;0;0;0;0;0;0;0;0;0;0;0;0;0;0
FR;8;2021-06-06;0;0;0;0;0;0;0;0;0;0;0;0;0;0;0;0;0;0
FR;8;2021-06-07;0;0;0;0;0;0;0;0;0;0;0;0;0;0;0;0;0;0
FR;8;2021-06-08;0;0;0;0;0;0;0;0;0;0;0;0;0;0;0;0;0;0
FR;8;2021-06-09;0;0;0;0;0;0;0;0;0;0;0;0;0;0;0;0;0;0
FR;8;2021-06-10;0;0;0;0;0;0;0;0;0;0;0;0;0;0;0;0;0;0
FR;8;2021-06-11;0;0;0;0;0;0;0;0;0;0;0;0;0;0;0;0;0;0
FR;8;2021-06-12;0;0;0;0;0;0;0;0;0;0;0;0;0;0;0;0;0;0
FR;8;2021-06-13;0;0;0;0;0;0;0;0;0;0;0;0;0;0;0;0;0;0
FR;8;2021-06-14;0;0;0;0;0;0;0;0;0;0;0;0;0;0;0;0;0;0
FR;8;2021-06-15;0;0;0;0;0;0;0;0;0;0;0;0;0;0;0;0;0;0
FR;8;2021-06-16;0;0;0;0;0;0;0;0;0;0;0;0;0;0;0;0;0;0
FR;8;2021-06-17;0;0;0;0;0;0;0;0;0;0;0;0;0;0;0;0;0;0
FR;8;2021-06-18;0;0;0;0;0;0;0;0;0;0;0;0;0;0;0;0;0;0
FR;8;2021-06-19;0;0;0;0;0;0;0;0;0;0;0;0;0;0;0;0;0;0
FR;8;2021-06-20;0;0;0;0;0;0;0;0;0;0;0;0;0;0;0;0;0;0
FR;8;2021-06-21;0;0;0;0;0;0;0;0;0;0;0;0;0;0;0;0;0;0
FR;8;2021-06-22;0;0;0;0;0;0;0;0;0;0;0;0;0;0;0;0;0;0
FR;8;2021-06-23;0;0;0;0;0;0;0;0;0;0;0;0;0;0;0;0;0;0
FR;8;2021-06-24;0;0;0;0;0;0;0;0;0;0;0;0;0;0;0;0;0;0
FR;8;2021-06-25;0;0;0;0;0;0;0;0;0;0;0;0;0;0;0;0;0;0
FR;8;2021-06-26;0;0;0;0;0;0;0;0;0;0;0;0;0;0;0;0;0;0
FR;8;2021-06-27;0;0;0;0;0;0;0;0;0;0;0;0;0;0;0;0;0;0
FR;8;2021-06-28;0;0;0;0;0;0;0;0;0;0;0;0;0;0;0;0;0;0
FR;8;2021-06-29;0;0;0;0;0;0;0;0;0;0;0;0;0;0;0;0;0;0
FR;8;2021-06-30;0;0;0;0;0;0;0;0;0;0;0;0;0;0;0;0;0;0
FR;8;2021-07-01;0;0;0;0;0;0;0;0;0;0;0;0;0;0;0;0;0;0
FR;8;2021-07-02;0;0;0;0;0;0;0;0;0;0;0;0;0;0;0;0;0;0
FR;8;2021-07-03;0;0;0;0;0;0;0;0;0;0;0;0;0;0;0;0;0;0
FR;8;2021-07-04;0;0;0;0;0;0;0;0;0;0;0;0;0;0;0;0;0;0
FR;8;2021-07-05;0;0;0;0;0;0;0;0;0;0;0;0;0;0;0;0;0;0
FR;8;2021-07-06;0;0;0;0;0;0;0;0;0;0;0;0;0;0;0;0;0;0
FR;8;2021-07-07;0;0;0;0;0;0;0;0;0;0;0;0;0;0;0;0;0;0
FR;8;2021-07-08;0;0;0;0;0;0;0;0;0;0;0;0;0;0;0;0;0;0
FR;8;2021-07-09;0;0;0;0;0;0;0;0;0;0;0;0;0;0;0;0;0;0
FR;8;2021-07-10;0;0;0;0;0;0;0;0;0;0;0;0;0;0;0;0;0;0
FR;8;2021-07-11;0;0;0;0;0;0;0;0;0;0;0;0;0;0;0;0;0;0
FR;8;2021-07-12;0;0;0;0;0;0;0;0;0;0;0;0;0;0;0;0;0;0
FR;8;2021-07-13;0;0;0;0;0;0;0;0;0;0;0;0;0;0;0;0;0;0
FR;8;2021-07-14;0;0;0;0;0;0;0;0;0;0;0;0;0;0;0;0;0;0
FR;8;2021-07-15;0;0;0;0;0;0;0;0;0;0;0;0;0;0;0;0;0;0
FR;8;2021-07-16;0;0;0;0;0;0;0;0;0;0;0;0;0;0;0;0;0;0
FR;8;2021-07-17;0;0;0;0;0;0;0;0;0;0;0;0;0;0;0;0;0;0
FR;8;2021-07-18;0;0;0;0;0;0;0;0;0;0;0;0;0;0;0;0;0;0
FR;8;2021-07-19;0;0;0;0;0;0;0;0;0;0;0;0;0;0;0;0;0;0
FR;8;2021-07-20;0;0;0;0;0;0;0;0;0;0;0;0;0;0;0;0;0;0
FR;8;2021-07-21;0;0;0;0;0;0;0;0;0;0;0;0;0;0;0;0;0;0
FR;8;2021-07-22;0;0;0;0;0;0;0;0;0;0;0;0;0;0;0;0;0;0
FR;8;2021-07-23;0;0;0;0;0;0;0;0;0;0;0;0;0;0;0;0;0;0
FR;8;2021-07-24;0;0;0;0;0;0;0;0;0;0;0;0;0;0;0;0;0;0
FR;8;2021-07-25;0;0;0;0;0;0;0;0;0;0;0;0;0;0;0;0;0;0
FR;8;2021-07-26;0;0;0;0;0;0;0;0;0;0;0;0;0;0;0;0;0;0
FR;8;2021-07-27;0;0;0;0;0;0;0;0;0;0;0;0;0;0;0;0;0;0
FR;8;2021-07-28;0;0;0;0;0;0;0;0;0;0;0;0;0;0;0;0;0;0
FR;8;2021-07-29;0;0;0;0;0;0;0;0;0;0;0;0;0;0;0;0;0;0
FR;8;2021-07-30;0;0;0;0;0;0;0;0;0;0;0;0;0;0;0;0;0;0
FR;8;2021-07-31;0;0;0;0;0;0;0;0;0;0;0;0;0;0;0;0;0;0
FR;8;2021-08-01;0;0;0;0;0;0;0;0;0;0;0;0;0;0;0;0;0;0
FR;8;2021-08-02;0;0;0;0;0;0;0;0;0;0;0;0;0;0;0;0;0;0
FR;8;2021-08-03;0;0;0;0;0;0;0;0;0;0;0;0;0;0;0;0;0;0
FR;8;2021-08-04;0;0;0;0;0;0;0;0;0;0;0;0;0;0;0;0;0;0
FR;8;2021-08-05;0;0;0;0;0;0;0;0;0;0;0;0;0;0;0;0;0;0
FR;8;2021-08-06;0;0;0;0;0;0;0;0;0;0;0;0;0;0;0;0;0;0
FR;8;2021-08-07;0;0;0;0;0;0;0;0;0;0;0;0;0;0;0;0;0;0
FR;8;2021-08-08;0;0;0;0;0;0;0;0;0;0;0;0;0;0;0;0;0;0
FR;8;2021-08-09;0;0;0;0;0;0;0;0;0;0;0;0;0;0;0;0;0;0
FR;8;2021-08-10;0;0;0;0;0;0;0;0;0;0;0;0;0;0;0;0;0;0
FR;8;2021-08-11;0;0;0;0;0;0;0;0;0;0;0;0;0;0;0;0;0;0
FR;8;2021-08-12;0;0;0;0;0;0;0;0;0;0;0;0;0;0;0;0;0;0
FR;8;2021-08-13;0;0;0;0;0;0;0;0;0;0;0;0;0;0;0;0;0;0
FR;8;2021-08-14;0;0;0;0;0;0;0;0;0;0;0;0;0;0;0;0;0;0
FR;8;2021-08-15;0;0;0;0;0;0;0;0;0;0;0;0;0;0;0;0;0;0
FR;8;2021-08-16;0;0;0;0;0;0;0;0;0;0;0;0;0;0;0;0;0;0
FR;8;2021-08-17;0;0;0;0;0;0;0;0;0;0;0;0;0;0;0;0;0;0
FR;8;2021-08-18;0;0;0;0;0;0;0;0;0;0;0;0;0;0;0;0;0;0
FR;8;2021-08-19;0;0;0;0;0;0;0;0;0;0;0;0;0;0;0;0;0;0
FR;8;2021-08-20;0;0;0;0;0;0;0;0;0;0;0;0;0;0;0;0;0;0
FR;8;2021-08-21;0;0;0;0;0;0;0;0;0;0;0;0;0;0;0;0;0;0
FR;8;2021-08-22;0;0;0;0;0;0;0;0;0;0;0;0;0;0;0;0;0;0
FR;8;2021-08-23;0;0;0;0;0;0;0;0;0;0;0;0;0;0;0;0;0;0
FR;8;2021-08-24;0;0;0;0;0;0;0;0;0;0;0;0;0;0;0;0;0;0
FR;8;2021-08-25;0;0;0;0;0;0;0;0;0;0;0;0;0;0;0;0;0;0
FR;8;2021-08-26;0;0;0;0;0;0;0;0;0;0;0;0;0;0;0;0;0;0
FR;8;2021-08-27;0;0;0;0;0;0;0;0;0;0;0;0;0;0;0;0;0;0
FR;8;2021-08-28;0;0;0;0;0;0;0;0;0;0;0;0;0;0;0;0;0;0
FR;8;2021-08-29;0;0;0;0;0;0;0;0;0;0;0;0;0;0;0;0;0;0
FR;8;2021-08-30;0;0;0;0;0;0;0;0;0;0;0;0;0;0;0;0;0;0
FR;8;2021-08-31;0;0;0;0;0;0;0;0;0;0;0;0;0;0;0;0;0;0
FR;8;2021-09-01;0;0;0;0;0;0;0;0;0;0;0;0;0;0;0;0;0;0
FR;8;2021-09-02;0;0;0;0;0;0;0;0;0;0;0;0;0;0;0;0;0;0
FR;8;2021-09-03;0;0;0;0;0;0;0;0;0;0;0;0;0;0;0;0;0;0
FR;8;2021-09-04;0;0;0;0;0;0;0;0;0;0;0;0;0;0;0;0;0;0
FR;8;2021-09-05;0;0;0;0;0;0;0;0;0;0;0;0;0;0;0;0;0;0
FR;8;2021-09-06;0;0;0;0;0;0;0;0;0;0;0;0;0;0;0;0;0;0
FR;8;2021-09-07;0;0;0;0;0;0;0;0;0;0;0;0;0;0;0;0;0;0
FR;8;2021-09-08;0;0;0;0;0;0;0;0;0;0;0;0;0;0;0;0;0;0
FR;8;2021-09-09;0;0;0;0;0;0;0;0;0;0;0;0;0;0;0;0;0;0
FR;8;2021-09-10;0;0;0;0;0;0;0;0;0;0;0;0;0;0;0;0;0;0
FR;8;2021-09-11;0;0;0;0;0;0;0;0;0;0;0;0;0;0;0;0;0;0
FR;8;2021-09-12;0;0;0;0;0;0;0;0;0;0;0;0;0;0;0;0;0;0
FR;8;2021-09-13;0;0;0;0;0;0;0;0;0;0;0;0;0;0;0;0;0;0
FR;8;2021-09-14;0;0;0;0;0;0;0;0;0;0;0;0;0;0;0;0;0;0
FR;8;2021-09-15;0;0;0;0;0;0;0;0;0;0;0;0;0;0;0;0;0;0
FR;8;2021-09-16;0;0;0;0;0;0;0;0;0;0;0;0;0;0;0;0;0;0
FR;8;2021-09-17;0;0;0;0;0;0;0;0;0;0;0;0;0;0;0;0;0;0
FR;8;2021-09-18;0;0;0;0;0;0;0;0;0;0;0;0;0;0;0;0;0;0
FR;8;2021-09-19;0;0;0;0;0;0;0;0;0;0;0;0;0;0;0;0;0;0
FR;8;2021-09-20;0;0;0;0;0;0;0;0;0;0;0;0;0;0;0;0;0;0
FR;8;2021-09-21;0;0;0;0;0;0;0;0;0;0;0;0;0;0;0;0;0;0
FR;8;2021-09-22;0;0;0;0;0;0;0;0;0;0;0;0;0;0;0;0;0;0
FR;8;2021-09-23;0;0;0;0;0;0;0;0;0;0;0;0;0;0;0;0;0;0
FR;8;2021-09-24;0;0;0;0;0;0;0;0;0;0;0;0;0;0;0;0;0;0
FR;8;2021-09-25;0;0;0;0;0;0;0;0;0;0;0;0;0;0;0;0;0;0
FR;8;2021-09-26;0;0;0;0;0;0;0;0;0;0;0;0;0;0;0;0;0;0
FR;8;2021-09-27;0;0;0;0;0;0;0;0;0;0;0;0;0;0;0;0;0;0
FR;8;2021-09-28;0;0;0;0;0;0;0;0;0;0;0;0;0;0;0;0;0;0
FR;8;2021-09-29;0;0;0;0;0;0;0;0;0;0;0;0;0;0;0;0;0;0
FR;8;2021-09-30;0;0;0;0;0;0;0;0;0;0;0;0;0;0;0;0;0;0
FR;8;2021-10-01;0;0;0;0;0;0;0;0;0;0;0;0;0;0;0;0;0;0
FR;8;2021-10-02;0;0;0;0;0;0;0;0;0;0;0;0;0;0;0;0;0;0
FR;8;2021-10-03;0;0;0;0;0;0;0;0;0;0;0;0;0;0;0;0;0;0
FR;8;2021-10-04;0;0;0;0;0;0;0;0;0;0;0;0;0;0;0;0;0;0
FR;8;2021-10-05;0;0;0;0;0;0;0;0;0;0;0;0;0;0;0;0;0;0
FR;8;2021-10-06;0;0;0;0;0;0;0;0;0;0;0;0;0;0;0;0;0;0
FR;8;2021-10-07;0;0;0;0;0;0;0;0;0;0;0;0;0;0;0;0;0;0
FR;8;2021-10-08;0;0;0;0;0;0;0;0;0;0;0;0;0;0;0;0;0;0
FR;8;2021-10-09;0;0;0;0;0;0;0;0;0;0;0;0;0;0;0;0;0;0
FR;8;2021-10-10;0;0;0;0;0;0;0;0;0;0;0;0;0;0;0;0;0;0
FR;8;2021-10-11;0;0;0;0;0;0;0;0;0;0;0;0;0;0;0;0;0;0
FR;8;2021-10-12;0;0;0;0;0;0;0;0;0;0;0;0;0;0;0;0;0;0
FR;8;2021-10-13;0;0;0;0;0;0;0;0;0;0;0;0;0;0;0;0;0;0
FR;8;2021-10-14;0;0;0;0;0;0;0;0;0;0;0;0;0;0;0;0;0;0
FR;8;2021-10-15;0;0;0;0;0;0;0;0;0;0;0;0;0;0;0;0;0;0
FR;8;2021-10-16;0;0;0;0;0;0;0;0;0;0;0;0;0;0;0;0;0;0
FR;8;2021-10-17;0;0;0;0;0;0;0;0;0;0;0;0;0;0;0;0;0;0
FR;8;2021-10-18;0;0;0;0;0;0;0;0;0;0;0;0;0;0;0;0;0;0
FR;8;2021-10-19;0;0;0;0;0;0;0;0;0;0;0;0;0;0;0;0;0;0
FR;8;2021-10-20;0;0;0;0;0;0;0;0;0;0;0;0;0;0;0;0;0;0
FR;8;2021-10-21;0;0;0;0;0;0;0;0;0;0;0;0;0;0;0;0;0;0
FR;8;2021-10-22;0;0;0;0;0;0;0;0;0;0;0;0;0;0;0;0;0;0
FR;8;2021-10-23;0;0;0;0;0;0;0;0;0;0;0;0;0;0;0;0;0;0
FR;8;2021-10-24;0;0;0;0;0;0;0;0;0;0;0;0;0;0;0;0;0;0
FR;8;2021-10-25;0;0;0;0;0;0;0;0;0;0;0;0;0;0;0;0;0;0
FR;8;2021-10-26;0;0;0;0;0;0;0;0;0;0;0;0;0;0;0;0;0;0
FR;8;2021-10-27;0;0;0;0;0;0;0;0;0;0;0;0;0;0;0;0;0;0
FR;8;2021-10-28;0;0;0;0;0;0;0;0;0;0;0;0;0;0;0;0;0;0
FR;8;2021-10-29;0;0;0;0;0;0;0;0;0;0;0;0;0;0;0;0;0;0
FR;8;2021-10-30;0;0;0;0;0;0;0;0;0;0;0;0;0;0;0;0;0;0
FR;8;2021-10-31;0;0;0;0;0;0;0;0;0;0;0;0;0;0;0;0;0;0
FR;8;2021-11-01;0;0;0;0;0;0;0;0;0;0;0;0;0;0;0;0;0;0
FR;8;2021-11-02;0;0;0;0;0;0;0;0;0;0;0;0;0;0;0;0;0;0
FR;8;2021-11-03;0;0;0;0;0;0;0;0;0;0;0;0;0;0;0;0;0;0
FR;8;2021-11-04;0;0;0;0;0;0;0;0;0;0;0;0;0;0;0;0;0;0
FR;8;2021-11-05;0;0;0;0;0;0;0;0;0;0;0;0;0;0;0;0;0;0
FR;8;2021-11-06;0;0;0;0;0;0;0;0;0;0;0;0;0;0;0;0;0;0
FR;8;2021-11-07;0;0;0;0;0;0;0;0;0;0;0;0;0;0;0;0;0;0
FR;8;2021-11-08;0;0;0;0;0;0;0;0;0;0;0;0;0;0;0;0;0;0
FR;8;2021-11-09;0;0;0;0;0;0;0;0;0;0;0;0;0;0;0;0;0;0
FR;8;2021-11-10;0;0;0;0;0;0;0;0;0;0;0;0;0;0;0;0;0;0
FR;8;2021-11-11;0;0;0;0;0;0;0;0;0;0;0;0;0;0;0;0;0;0
FR;8;2021-11-12;0;0;0;0;0;0;0;0;0;0;0;0;0;0;0;0;0;0
FR;8;2021-11-13;0;0;0;0;0;0;0;0;0;0;0;0;0;0;0;0;0;0
FR;8;2021-11-14;0;0;0;0;0;0;0;0;0;0;0;0;0;0;0;0;0;0
FR;8;2021-11-15;0;0;0;0;0;0;0;0;0;0;0;0;0;0;0;0;0;0
FR;8;2021-11-16;0;0;0;0;0;0;0;0;0;0;0;0;0;0;0;0;0;0
FR;8;2021-11-17;0;0;0;0;0;0;0;0;0;0;0;0;0;0;0;0;0;0
FR;8;2021-11-18;0;0;0;0;0;0;0;0;0;0;0;0;0;0;0;0;0;0
FR;8;2021-11-19;0;0;0;0;0;0;0;0;0;0;0;0;0;0;0;0;0;0
FR;8;2021-11-20;0;0;0;0;0;0;0;0;0;0;0;0;0;0;0;0;0;0
FR;8;2021-11-21;0;0;0;0;0;0;0;0;0;0;0;0;0;0;0;0;0;0
FR;8;2021-11-22;0;0;0;0;0;0;0;0;0;0;0;0;0;0;0;0;0;0
FR;8;2021-11-23;0;0;0;0;0;0;0;0;0;0;0;0;0;0;0;0;0;0
FR;8;2021-11-24;0;0;0;0;0;0;0;0;0;0;0;0;0;0;0;0;0;0
FR;8;2021-11-25;0;0;0;0;0;0;0;0;0;0;0;0;0;0;0;0;0;0
FR;8;2021-11-26;0;0;0;0;0;0;0;0;0;0;0;0;0;0;0;0;0;0
FR;8;2021-11-27;0;0;0;0;0;0;0;0;0;0;0;0;0;0;0;0;0;0
FR;8;2021-11-28;0;0;0;0;0;0;0;0;0;0;0;0;0;0;0;0;0;0
FR;8;2021-11-29;0;0;0;0;0;0;0;0;0;0;0;0;0;0;0;0;0;0
FR;8;2021-11-30;0;0;0;0;0;0;0;0;0;0;0;0;0;0;0;0;0;0
FR;8;2021-12-01;0;0;0;0;0;0;0;0;0;0;0;0;0;0;0;0;0;0
FR;8;2021-12-02;0;0;0;0;0;0;0;0;0;0;0;0;0;0;0;0;0;0
FR;8;2021-12-03;0;0;0;0;0;0;0;0;0;0;0;0;0;0;0;0;0;0
FR;8;2021-12-04;0;0;0;0;0;0;0;0;0;0;0;0;0;0;0;0;0;0
FR;8;2021-12-05;0;0;0;0;0;0;0;0;0;0;0;0;0;0;0;0;0;0
FR;8;2021-12-06;0;0;0;0;0;0;0;0;0;0;0;0;0;0;0;0;0;0
FR;8;2021-12-07;0;0;0;0;0;0;0;0;0;0;0;0;0;0;0;0;0;0
FR;8;2021-12-08;0;0;0;0;0;0;0;0;0;0;0;0;0;0;0;0;0;0
FR;8;2021-12-09;0;0;0;0;0;0;0;0;0;0;0;0;0;0;0;0;0;0
FR;8;2021-12-10;0;0;0;0;0;0;0;0;0;0;0;0;0;0;0;0;0;0
FR;8;2021-12-11;0;0;0;0;0;0;0;0;0;0;0;0;0;0;0;0;0;0
FR;8;2021-12-12;0;0;0;0;0;0;0;0;0;0;0;0;0;0;0;0;0;0
FR;8;2021-12-13;0;0;0;0;0;0;0;0;0;0;0;0;0;0;0;0;0;0
FR;8;2021-12-14;0;0;0;0;0;0;0;0;0;0;0;0;0;0;0;0;0;0
FR;8;2021-12-15;0;0;0;0;0;0;0;0;0;0;0;0;0;0;0;0;0;0
FR;8;2021-12-16;0;0;0;0;0;0;0;0;0;0;0;0;0;0;0;0;0;0
FR;8;2021-12-17;0;0;0;0;0;0;0;0;0;0;0;0;0;0;0;0;0;0
FR;8;2021-12-18;0;0;0;0;0;0;0;0;0;0;0;0;0;0;0;0;0;0
FR;8;2021-12-19;0;0;0;0;0;0;0;0;0;0;0;0;0;0;0;0;0;0
FR;8;2021-12-20;0;0;0;0;0;0;0;0;0;0;0;0;0;0;0;0;0;0
FR;8;2021-12-21;0;0;0;0;0;0;0;0;0;0;0;0;0;0;0;0;0;0
FR;8;2021-12-22;0;0;0;0;0;0;0;0;0;0;0;0;0;0;0;0;0;0
FR;8;2021-12-23;0;0;0;0;0;0;0;0;0;0;0;0;0;0;0;0;0;0
FR;8;2021-12-24;0;0;0;0;0;0;0;0;0;0;0;0;0;0;0;0;0;0
FR;8;2021-12-25;0;0;0;0;0;0;0;0;0;0;0;0;0;0;0;0;0;0
FR;8;2021-12-26;0;0;0;0;0;0;0;0;0;0;0;0;0;0;0;0;0;0
FR;8;2021-12-27;0;0;0;0;0;0;0;0;0;0;0;0;0;0;0;0;0;0
FR;8;2021-12-28;0;0;0;0;0;0;0;0;0;0;0;0;0;0;0;0;0;0
FR;8;2021-12-29;0;0;0;0;0;0;0;0;0;0;0;0;0;0;0;0;0;0
FR;8;2021-12-30;0;0;0;0;0;0;0;0;0;0;0;0;0;0;0;0;0;0
FR;8;2021-12-31;0;0;0;0;0;0;0;0;0;0;0;0;0;0;0;0;0;0
FR;8;2022-01-01;0;0;0;0;0;0;0;0;0;0;0;0;0;0;0;0;0;0
FR;8;2022-01-02;0;0;0;0;0;0;0;0;0;0;0;0;0;0;0;0;0;0
FR;8;2022-01-03;0;0;0;0;0;0;0;0;0;0;0;0;0;0;0;0;0;0
FR;8;2022-01-04;0;0;0;0;0;0;0;0;0;0;0;0;0;0;0;0;0;0
FR;8;2022-01-05;0;0;0;0;0;0;0;0;0;0;0;0;0;0;0;0;0;0
FR;8;2022-01-06;0;0;0;0;0;0;0;0;0;0;0;0;0;0;0;0;0;0
FR;8;2022-01-07;0;0;0;0;0;0;0;0;0;0;0;0;0;0;0;0;0;0
FR;8;2022-01-08;0;0;0;0;0;0;0;0;0;0;0;0;0;0;0;0;0;0
FR;8;2022-01-09;0;0;0;0;0;0;0;0;0;0;0;0;0;0;0;0;0;0
FR;8;2022-01-10;0;0;0;0;0;0;0;0;0;0;0;0;0;0;0;0;0;0
FR;8;2022-01-11;0;0;0;0;0;0;0;0;0;0;0;0;0;0;0;0;0;0
FR;8;2022-01-12;0;0;0;0;0;0;0;0;0;0;0;0;0;0;0;0;0;0
FR;8;2022-01-13;0;0;0;0;0;0;0;0;0;0;0;0;0;0;0;0;0;0
FR;8;2022-01-14;0;0;0;0;0;0;0;0;0;0;0;0;0;0;0;0;0;0
FR;8;2022-01-15;0;0;0;0;0;0;0;0;0;0;0;0;0;0;0;0;0;0
FR;8;2022-01-16;0;0;0;0;0;0;0;0;0;0;0;0;0;0;0;0;0;0
FR;8;2022-01-17;0;0;0;0;0;0;0;0;0;0;0;0;0;0;0;0;0;0
FR;8;2022-01-18;0;0;0;0;0;0;0;0;0;0;0;0;0;0;0;0;0;0
FR;8;2022-01-19;0;0;0;0;0;0;0;0;0;0;0;0;0;0;0;0;0;0
FR;8;2022-01-20;0;0;0;0;0;0;0;0;0;0;0;0;0;0;0;0;0;0
FR;8;2022-01-21;0;0;0;0;0;0;0;0;0;0;0;0;0;0;0;0;0;0
FR;8;2022-01-22;0;0;0;0;0;0;0;0;0;0;0;0;0;0;0;0;0;0
FR;8;2022-01-23;0;0;0;0;0;0;0;0;0;0;0;0;0;0;0;0;0;0
FR;8;2022-01-24;0;0;0;0;0;0;0;0;0;0;0;0;0;0;0;0;0;0
FR;8;2022-01-25;0;0;0;0;0;0;0;0;0;0;0;0;0;0;0;0;0;0
FR;8;2022-01-26;0;0;0;0;0;0;0;0;0;0;0;0;0;0;0;0;0;0
FR;8;2022-01-27;0;0;0;0;0;0;0;0;0;0;0;0;0;0;0;0;0;0
FR;8;2022-01-28;0;0;0;0;0;0;0;0;0;0;0;0;0;0;0;0;0;0
FR;8;2022-01-29;0;0;0;0;0;0;0;0;0;0;0;0;0;0;0;0;0;0
FR;8;2022-01-30;0;0;0;0;0;0;0;0;0;0;0;0;0;0;0;0;0;0
FR;8;2022-01-31;0;0;0;0;0;0;0;0;0;0;0;0;0;0;0;0;0;0
FR;8;2022-02-01;0;0;0;0;0;0;0;0;0;0;0;0;0;0;0;0;0;0
FR;8;2022-02-02;0;0;0;0;0;0;0;0;0;0;0;0;0;0;0;0;0;0
FR;8;2022-02-03;0;0;0;0;0;0;0;0;0;0;0;0;0;0;0;0;0;0
FR;8;2022-02-04;0;0;0;0;0;0;0;0;0;0;0;0;0;0;0;0;0;0
FR;8;2022-02-05;0;0;0;0;0;0;0;0;0;0;0;0;0;0;0;0;0;0
FR;8;2022-02-06;0;0;0;0;0;0;0;0;0;0;0;0;0;0;0;0;0;0
FR;8;2022-02-07;0;0;0;0;0;0;0;0;0;0;0;0;0;0;0;0;0;0
FR;8;2022-02-08;0;0;0;0;0;0;0;0;0;0;0;0;0;0;0;0;0;0
FR;8;2022-02-09;0;0;0;0;0;0;0;0;0;0;0;0;0;0;0;0;0;0
FR;8;2022-02-10;0;0;0;0;0;0;0;0;0;0;0;0;0;0;0;0;0;0
FR;8;2022-02-11;0;0;0;0;0;0;0;0;0;0;0;0;0;0;0;0;0;0
FR;8;2022-02-12;0;0;0;0;0;0;0;0;0;0;0;0;0;0;0;0;0;0
FR;8;2022-02-13;0;0;0;0;0;0;0;0;0;0;0;0;0;0;0;0;0;0
FR;8;2022-02-14;0;0;0;0;0;0;0;0;0;0;0;0;0;0;0;0;0;0
FR;8;2022-02-15;0;0;0;0;0;0;0;0;0;0;0;0;0;0;0;0;0;0
FR;8;2022-02-16;0;0;0;0;0;0;0;0;0;0;0;0;0;0;0;0;0;0
FR;8;2022-02-17;0;0;0;0;0;0;0;0;0;0;0;0;0;0;0;0;0;0
FR;8;2022-02-18;0;0;0;0;0;0;0;0;0;0;0;0;0;0;0;0;0;0
FR;8;2022-02-19;0;0;0;0;0;0;0;0;0;0;0;0;0;0;0;0;0;0
FR;8;2022-02-20;0;0;0;0;0;0;0;0;0;0;0;0;0;0;0;0;0;0
FR;8;2022-02-21;0;0;0;0;0;0;0;0;0;0;0;0;0;0;0;0;0;0
FR;8;2022-02-22;0;0;0;0;0;0;0;0;0;0;0;0;0;0;0;0;0;0
FR;8;2022-02-23;0;0;0;0;0;0;0;0;0;0;0;0;0;0;0;0;0;0
FR;8;2022-02-24;0;0;0;0;0;0;0;0;0;0;0;0;0;0;0;0;0;0
FR;8;2022-02-25;0;0;0;0;0;0;0;0;0;0;0;0;0;0;0;0;0;0
FR;8;2022-02-26;0;0;0;0;0;0;0;0;0;0;0;0;0;0;0;0;0;0
FR;8;2022-02-27;0;0;0;0;0;0;0;0;0;0;0;0;0;0;0;0;0;0
FR;8;2022-02-28;0;0;0;0;0;0;0;0;0;0;0;0;0;0;0;0;0;0
FR;8;2022-03-01;0;0;0;0;0;0;0;0;0;0;0;0;0;0;0;0;0;0
FR;8;2022-03-02;0;0;0;0;0;0;0;0;0;0;0;0;0;0;0;0;0;0
FR;8;2022-03-03;0;0;0;0;0;0;0;0;0;0;0;0;0;0;0;0;0;0
FR;8;2022-03-04;0;0;0;0;0;0;0;0;0;0;0;0;0;0;0;0;0;0
FR;8;2022-03-05;0;0;0;0;0;0;0;0;0;0;0;0;0;0;0;0;0;0
FR;8;2022-03-06;0;0;0;0;0;0;0;0;0;0;0;0;0;0;0;0;0;0
FR;8;2022-03-07;0;0;0;0;0;0;0;0;0;0;0;0;0;0;0;0;0;0
FR;8;2022-03-08;0;0;0;0;0;0;0;0;0;0;0;0;0;0;0;0;0;0
FR;8;2022-03-09;0;0;0;0;0;0;0;0;0;0;0;0;0;0;0;0;0;0
FR;8;2022-03-10;0;0;0;0;0;0;0;0;0;0;0;0;0;0;0;0;0;0
FR;8;2022-03-11;0;0;0;0;0;0;0;0;0;0;0;0;0;0;0;0;0;0
FR;8;2022-03-12;0;0;0;0;0;0;0;0;0;0;0;0;0;0;0;0;0;0
FR;8;2022-03-13;0;0;0;0;0;0;0;0;0;0;0;0;0;0;0;0;0;0
FR;8;2022-03-14;0;0;0;0;0;0;0;0;0;0;0;0;0;0;0;0;0;0
FR;8;2022-03-15;0;0;0;0;0;0;0;0;0;0;0;0;0;0;0;0;0;0
FR;8;2022-03-16;0;0;0;0;0;0;0;0;0;0;0;0;0;0;0;0;0;0
FR;8;2022-03-17;0;0;0;0;0;0;0;0;0;0;0;0;0;0;0;0;0;0
FR;8;2022-03-18;0;0;0;0;0;0;0;0;0;0;0;0;0;0;0;0;0;0
FR;8;2022-03-19;0;0;0;0;0;0;0;0;0;0;0;0;0;0;0;0;0;0
FR;8;2022-03-20;0;0;0;0;0;0;0;0;0;0;0;0;0;0;0;0;0;0
FR;8;2022-03-21;0;0;0;0;0;0;0;0;0;0;0;0;0;0;0;0;0;0
FR;8;2022-03-22;0;0;0;0;0;0;0;0;0;0;0;0;0;0;0;0;0;0
FR;8;2022-03-23;0;0;0;0;0;0;0;0;0;0;0;0;0;0;0;0;0;0
FR;8;2022-03-24;0;0;0;0;0;0;0;0;0;0;0;0;0;0;0;0;0;0
FR;8;2022-03-25;0;0;0;0;0;0;0;0;0;0;0;0;0;0;0;0;0;0
FR;8;2022-03-26;0;0;0;0;0;0;0;0;0;0;0;0;0;0;0;0;0;0
FR;8;2022-03-27;0;0;0;0;0;0;0;0;0;0;0;0;0;0;0;0;0;0
FR;8;2022-03-28;0;0;0;0;0;0;0;0;0;0;0;0;0;0;0;0;0;0
FR;8;2022-03-29;0;0;0;0;0;0;0;0;0;0;0;0;0;0;0;0;0;0
FR;8;2022-03-30;0;0;0;0;0;0;0;0;0;0;0;0;0;0;0;0;0;0
FR;8;2022-03-31;0;0;0;0;0;0;0;0;0;0;0;0;0;0;0;0;0;0
FR;8;2022-04-01;0;0;0;0;0;0;0;0;0;0;0;0;0;0;0;0;0;0
FR;8;2022-04-02;0;0;0;0;0;0;0;0;0;0;0;0;0;0;0;0;0;0
FR;8;2022-04-03;0;0;0;0;0;0;0;0;0;0;0;0;0;0;0;0;0;0
FR;8;2022-04-04;0;0;0;0;0;0;0;0;0;0;0;0;0;0;0;0;0;0
FR;8;2022-04-05;0;0;0;0;0;0;0;0;0;0;0;0;0;0;0;0;0;0
FR;8;2022-04-06;0;0;0;0;0;0;0;0;0;0;0;0;0;0;0;0;0;0
FR;8;2022-04-07;0;0;0;0;0;0;0;0;0;0;0;0;0;0;0;0;0;0
FR;8;2022-04-08;0;0;0;0;0;0;0;0;0;0;0;0;0;0;0;0;0;0
FR;8;2022-04-09;0;0;0;0;0;0;0;0;0;0;0;0;0;0;0;0;0;0
FR;8;2022-04-10;0;0;0;0;0;0;0;0;0;0;0;0;0;0;0;0;0;0
FR;8;2022-04-11;0;0;0;0;0;0;0;0;0;0;0;0;0;0;0;0;0;0
FR;8;2022-04-12;0;0;0;0;0;0;0;0;0;0;0;0;0;0;0;0;0;0
FR;8;2022-04-13;0;0;0;0;0;0;0;0;0;0;0;0;0;0;0;0;0;0
FR;8;2022-04-14;0;0;0;0;0;0;0;0;0;0;0;0;0;0;0;0;0;0
FR;8;2022-04-15;0;0;0;0;0;0;0;0;0;0;0;0;0;0;0;0;0;0
FR;8;2022-04-16;0;0;0;0;0;0;0;0;0;0;0;0;0;0;0;0;0;0
FR;8;2022-04-17;0;0;0;0;0;0;0;0;0;0;0;0;0;0;0;0;0;0
FR;8;2022-04-18;0;0;0;0;0;0;0;0;0;0;0;0;0;0;0;0;0;0
FR;8;2022-04-19;0;0;0;0;0;0;0;0;0;0;0;0;0;0;0;0;0;0
FR;8;2022-04-20;0;0;0;0;0;0;0;0;0;0;0;0;0;0;0;0;0;0
FR;8;2022-04-21;0;0;0;0;0;0;0;0;0;0;0;0;0;0;0;0;0;0
FR;8;2022-04-22;0;0;0;0;0;0;0;0;0;0;0;0;0;0;0;0;0;0
FR;8;2022-04-23;0;0;0;0;0;0;0;0;0;0;0;0;0;0;0;0;0;0
FR;8;2022-04-24;0;0;0;0;0;0;0;0;0;0;0;0;0;0;0;0;0;0
FR;8;2022-04-25;0;0;0;0;0;0;0;0;0;0;0;0;0;0;0;0;0;0
FR;8;2022-04-26;0;0;0;0;0;0;0;0;0;0;0;0;0;0;0;0;0;0
FR;8;2022-04-27;0;0;0;0;0;0;0;0;0;0;0;0;0;0;0;0;0;0
FR;8;2022-04-28;0;0;0;0;0;0;0;0;0;0;0;0;0;0;0;0;0;0
FR;8;2022-04-29;0;0;0;0;0;0;0;0;0;0;0;0;0;0;0;0;0;0
FR;8;2022-04-30;0;0;0;0;0;0;0;0;0;0;0;0;0;0;0;0;0;0
FR;8;2022-05-01;0;0;0;0;0;0;0;0;0;0;0;0;0;0;0;0;0;0
FR;8;2022-05-02;0;0;0;0;0;0;0;0;0;0;0;0;0;0;0;0;0;0
FR;8;2022-05-03;0;0;0;0;0;0;0;0;0;0;0;0;0;0;0;0;0;0
FR;8;2022-05-04;0;0;0;0;0;0;0;0;0;0;0;0;0;0;0;0;0;0
FR;8;2022-05-05;0;0;0;0;0;0;0;0;0;0;0;0;0;0;0;0;0;0
FR;8;2022-05-06;0;0;0;0;0;0;0;0;0;0;0;0;0;0;0;0;0;0
FR;8;2022-05-07;0;0;0;0;0;0;0;0;0;0;0;0;0;0;0;0;0;0
FR;8;2022-05-08;0;0;0;0;0;0;0;0;0;0;0;0;0;0;0;0;0;0
FR;8;2022-05-09;0;0;0;0;0;0;0;0;0;0;0;0;0;0;0;0;0;0
FR;8;2022-05-10;0;0;0;0;0;0;0;0;0;0;0;0;0;0;0;0;0;0
FR;8;2022-05-11;0;0;0;0;0;0;0;0;0;0;0;0;0;0;0;0;0;0
FR;8;2022-05-12;0;0;0;0;0;0;0;0;0;0;0;0;0;0;0;0;0;0
FR;8;2022-05-13;0;0;0;0;0;0;0;0;0;0;0;0;0;0;0;0;0;0
FR;8;2022-05-14;0;0;0;0;0;0;0;0;0;0;0;0;0;0;0;0;0;0
FR;8;2022-05-15;0;0;0;0;0;0;0;0;0;0;0;0;0;0;0;0;0;0
FR;8;2022-05-16;0;0;0;0;0;0;0;0;0;0;0;0;0;0;0;0;0;0
FR;8;2022-05-17;0;0;0;0;0;0;0;0;0;0;0;0;0;0;0;0;0;0
FR;8;2022-05-18;0;0;0;0;0;0;0;0;0;0;0;0;0;0;0;0;0;0
FR;8;2022-05-19;0;0;0;0;0;0;0;0;0;0;0;0;0;0;0;0;0;0
FR;8;2022-05-20;0;0;0;0;0;0;0;0;0;0;0;0;0;0;0;0;0;0
FR;8;2022-05-21;0;0;0;0;0;0;0;0;0;0;0;0;0;0;0;0;0;0
FR;8;2022-05-22;0;0;0;0;0;0;0;0;0;0;0;0;0;0;0;0;0;0
FR;8;2022-05-23;0;0;0;0;0;0;0;0;0;0;0;0;0;0;0;0;0;0
FR;8;2022-05-24;0;0;0;0;0;0;0;0;0;0;0;0;0;0;0;0;0;0
FR;8;2022-05-25;0;0;0;0;0;0;0;0;0;0;0;0;0;0;0;0;0;0
FR;8;2022-05-26;0;0;0;0;0;0;0;0;0;0;0;0;0;0;0;0;0;0
FR;8;2022-05-27;0;0;0;0;0;0;0;0;0;0;0;0;0;0;0;0;0;0
FR;8;2022-05-28;0;0;0;0;0;0;0;0;0;0;0;0;0;0;0;0;0;0
FR;8;2022-05-29;0;0;0;0;0;0;0;0;0;0;0;0;0;0;0;0;0;0
FR;8;2022-05-30;0;0;0;0;0;0;0;0;0;0;0;0;0;0;0;0;0;0
FR;8;2022-05-31;0;0;0;0;0;0;0;0;0;0;0;0;0;0;0;0;0;0
FR;8;2022-06-01;0;0;0;0;0;0;0;0;0;0;0;0;0;0;0;0;0;0
FR;8;2022-06-02;0;0;0;0;0;0;0;0;0;0;0;0;0;0;0;0;0;0
FR;8;2022-06-03;0;0;0;0;0;0;0;0;0;0;0;0;0;0;0;0;0;0
FR;8;2022-06-04;0;0;0;0;0;0;0;0;0;0;0;0;0;0;0;0;0;0
FR;8;2022-06-05;0;0;0;0;0;0;0;0;0;0;0;0;0;0;0;0;0;0
FR;8;2022-06-06;0;0;0;0;0;0;0;0;0;0;0;0;0;0;0;0;0;0
FR;8;2022-06-07;0;0;0;0;0;0;0;0;0;0;0;0;0;0;0;0;0;0
FR;8;2022-06-08;0;0;0;0;0;0;0;0;0;0;0;0;0;0;0;0;0;0
FR;8;2022-06-09;0;0;0;0;0;0;0;0;0;0;0;0;0;0;0;0;0;0
FR;8;2022-06-10;0;0;0;0;0;0;0;0;0;0;0;0;0;0;0;0;0;0
FR;8;2022-06-11;0;0;0;0;0;0;0;0;0;0;0;0;0;0;0;0;0;0
FR;8;2022-06-12;0;0;0;0;0;0;0;0;0;0;0;0;0;0;0;0;0;0
FR;8;2022-06-13;0;0;0;0;0;0;0;0;0;0;0;0;0;0;0;0;0;0
FR;8;2022-06-14;0;0;0;0;0;0;0;0;0;0;0;0;0;0;0;0;0;0
FR;8;2022-06-15;0;0;0;0;0;0;0;0;0;0;0;0;0;0;0;0;0;0
FR;8;2022-06-16;0;0;0;0;0;0;0;0;0;0;0;0;0;0;0;0;0;0
FR;8;2022-06-17;0;0;0;0;0;0;0;0;0;0;0;0;0;0;0;0;0;0
FR;8;2022-06-18;0;0;0;0;0;0;0;0;0;0;0;0;0;0;0;0;0;0
FR;8;2022-06-19;0;0;0;0;0;0;0;0;0;0;0;0;0;0;0;0;0;0
FR;8;2022-06-20;0;0;0;0;0;0;0;0;0;0;0;0;0;0;0;0;0;0
FR;8;2022-06-21;0;0;0;0;0;0;0;0;0;0;0;0;0;0;0;0;0;0
FR;8;2022-06-22;0;0;0;0;0;0;0;0;0;0;0;0;0;0;0;0;0;0
FR;8;2022-06-23;0;0;0;0;0;0;0;0;0;0;0;0;0;0;0;0;0;0
FR;8;2022-06-24;0;0;0;0;0;0;0;0;0;0;0;0;0;0;0;0;0;0
FR;8;2022-06-25;0;0;0;0;0;0;0;0;0;0;0;0;0;0;0;0;0;0
FR;8;2022-06-26;0;0;0;0;0;0;0;0;0;0;0;0;0;0;0;0;0;0
FR;8;2022-06-27;0;0;0;0;0;0;0;0;0;0;0;0;0;0;0;0;0;0
FR;8;2022-06-28;0;0;0;0;0;0;0;0;0;0;0;0;0;0;0;0;0;0
FR;8;2022-06-29;0;0;0;0;0;0;0;0;0;0;0;0;0;0;0;0;0;0
FR;8;2022-06-30;0;0;0;0;0;0;0;0;0;0;0;0;0;0;0;0;0;0
FR;8;2022-07-01;0;0;0;0;0;0;0;0;0;0;0;0;0;0;0;0;0;0
FR;8;2022-07-02;0;0;0;0;0;0;0;0;0;0;0;0;0;0;0;0;0;0
FR;8;2022-07-03;0;0;0;0;0;0;0;0;0;0;0;0;0;0;0;0;0;0
FR;8;2022-07-04;0;0;0;0;0;0;0;0;0;0;0;0;0;0;0;0;0;0
FR;8;2022-07-05;0;0;0;0;0;0;0;0;0;0;0;0;0;0;0;0;0;0
FR;8;2022-07-06;0;0;0;0;0;0;0;0;0;0;0;0;0;0;0;0;0;0
FR;8;2022-07-07;0;0;0;0;0;0;0;0;0;0;0;0;0;0;0;0;0;0
FR;8;2022-07-08;0;0;0;0;0;0;0;0;0;0;0;0;0;0;0;0;0;0
FR;8;2022-07-09;0;0;0;0;0;0;0;0;0;0;0;0;0;0;0;0;0;0
FR;8;2022-07-10;0;0;0;0;0;0;0;0;0;0;0;0;0;0;0;0;0;0
FR;8;2022-07-11;0;0;0;0;0;0;0;0;0;0;0;0;0;0;0;0;0;0
FR;8;2022-07-12;0;0;0;0;0;0;0;0;0;0;0;0;0;0;0;0;0;0
FR;8;2022-07-13;0;0;0;0;0;0;0;0;0;0;0;0;0;0;0;0;0;0
FR;8;2022-07-14;0;0;0;0;0;0;0;0;0;0;0;0;0;0;0;0;0;0
FR;8;2022-07-15;0;0;0;0;0;0;0;0;0;0;0;0;0;0;0;0;0;0
FR;8;2022-07-16;0;0;0;0;0;0;0;0;0;0;0;0;0;0;0;0;0;0
FR;8;2022-07-17;0;0;0;0;0;0;0;0;0;0;0;0;0;0;0;0;0;0
FR;8;2022-07-18;0;0;0;0;0;0;0;0;0;0;0;0;0;0;0;0;0;0
FR;8;2022-07-19;0;0;0;0;0;0;0;0;0;0;0;0;0;0;0;0;0;0
FR;8;2022-07-20;0;0;0;0;0;0;0;0;0;0;0;0;0;0;0;0;0;0
FR;8;2022-07-21;0;0;0;0;0;0;0;0;0;0;0;0;0;0;0;0;0;0
FR;8;2022-07-22;0;0;0;0;0;0;0;0;0;0;0;0;0;0;0;0;0;0
FR;8;2022-07-23;0;0;0;0;0;0;0;0;0;0;0;0;0;0;0;0;0;0
FR;8;2022-07-24;0;0;0;0;0;0;0;0;0;0;0;0;0;0;0;0;0;0
FR;8;2022-07-25;0;0;0;0;0;0;0;0;0;0;0;0;0;0;0;0;0;0
FR;8;2022-07-26;0;0;0;0;0;0;0;0;0;0;0;0;0;0;0;0;0;0
FR;8;2022-07-27;0;0;0;0;0;0;0;0;0;0;0;0;0;0;0;0;0;0
FR;8;2022-07-28;0;0;0;0;0;0;0;0;0;0;0;0;0;0;0;0;0;0
FR;8;2022-07-29;0;0;0;0;0;0;0;0;0;0;0;0;0;0;0;0;0;0
FR;8;2022-07-30;0;0;0;0;0;0;0;0;0;0;0;0;0;0;0;0;0;0
FR;8;2022-07-31;0;0;0;0;0;0;0;0;0;0;0;0;0;0;0;0;0;0
FR;8;2022-08-01;0;0;0;0;0;0;0;0;0;0;0;0;0;0;0;0;0;0
FR;8;2022-08-02;0;0;0;0;0;0;0;0;0;0;0;0;0;0;0;0;0;0
FR;8;2022-08-03;0;0;0;0;0;0;0;0;0;0;0;0;0;0;0;0;0;0
FR;8;2022-08-04;0;0;0;0;0;0;0;0;0;0;0;0;0;0;0;0;0;0
FR;8;2022-08-05;0;0;0;0;0;0;0;0;0;0;0;0;0;0;0;0;0;0
FR;8;2022-08-06;0;0;0;0;0;0;0;0;0;0;0;0;0;0;0;0;0;0
FR;8;2022-08-07;0;0;0;0;0;0;0;0;0;0;0;0;0;0;0;0;0;0
FR;8;2022-08-08;0;0;0;0;0;0;0;0;0;0;0;0;0;0;0;0;0;0
FR;8;2022-08-09;0;0;0;0;0;0;0;0;0;0;0;0;0;0;0;0;0;0
FR;8;2022-08-10;0;0;0;0;0;0;0;0;0;0;0;0;0;0;0;0;0;0
FR;8;2022-08-11;0;0;0;0;0;0;0;0;0;0;0;0;0;0;0;0;0;0
FR;8;2022-08-12;0;0;0;0;0;0;0;0;0;0;0;0;0;0;0;0;0;0
FR;8;2022-08-13;0;0;0;0;0;0;0;0;0;0;0;0;0;0;0;0;0;0
FR;8;2022-08-14;0;0;0;0;0;0;0;0;0;0;0;0;0;0;0;0;0;0
FR;8;2022-08-15;0;0;0;0;0;0;0;0;0;0;0;0;0;0;0;0;0;0
FR;8;2022-08-16;0;0;0;0;0;0;0;0;0;0;0;0;0;0;0;0;0;0
FR;8;2022-08-17;0;0;0;0;0;0;0;0;0;0;0;0;0;0;0;0;0;0
FR;8;2022-08-18;0;0;0;0;0;0;0;0;0;0;0;0;0;0;0;0;0;0
FR;8;2022-08-19;0;0;0;0;0;0;0;0;0;0;0;0;0;0;0;0;0;0
FR;8;2022-08-20;0;0;0;0;0;0;0;0;0;0;0;0;0;0;0;0;0;0
FR;8;2022-08-21;0;0;0;0;0;0;0;0;0;0;0;0;0;0;0;0;0;0
FR;8;2022-08-22;0;0;0;0;0;0;0;0;0;0;0;0;0;0;0;0;0;0
FR;8;2022-08-23;0;0;0;0;0;0;0;0;0;0;0;0;0;0;0;0;0;0
FR;8;2022-08-24;0;0;0;0;0;0;0;0;0;0;0;0;0;0;0;0;0;0
FR;8;2022-08-25;0;0;0;0;0;0;0;0;0;0;0;0;0;0;0;0;0;0
FR;8;2022-08-26;0;0;0;0;0;0;0;0;0;0;0;0;0;0;0;0;0;0
FR;8;2022-08-27;0;0;0;0;0;0;0;0;0;0;0;0;0;0;0;0;0;0
FR;8;2022-08-28;0;0;0;0;0;0;0;0;0;0;0;0;0;0;0;0;0;0
FR;8;2022-08-29;0;0;0;0;0;0;0;0;0;0;0;0;0;0;0;0;0;0
FR;8;2022-08-30;0;0;0;0;0;0;0;0;0;0;0;0;0;0;0;0;0;0
FR;8;2022-08-31;0;0;0;0;0;0;0;0;0;0;0;0;0;0;0;0;0;0
FR;8;2022-09-01;0;0;0;0;0;0;0;0;0;0;0;0;0;0;0;0;0;0
FR;8;2022-09-02;0;0;0;0;0;0;0;0;0;0;0;0;0;0;0;0;0;0
FR;8;2022-09-03;0;0;0;0;0;0;0;0;0;0;0;0;0;0;0;0;0;0
FR;8;2022-09-04;0;0;0;0;0;0;0;0;0;0;0;0;0;0;0;0;0;0
FR;8;2022-09-05;0;0;0;0;0;0;0;0;0;0;0;0;0;0;0;0;0;0
FR;8;2022-09-06;0;0;0;0;0;0;0;0;0;0;0;0;0;0;0;0;0;0
FR;8;2022-09-07;0;0;0;0;0;0;0;0;0;0;0;0;0;0;0;0;0;0
FR;8;2022-09-08;0;0;0;0;0;0;0;0;0;0;0;0;0;0;0;0;0;0
FR;8;2022-09-09;0;0;0;0;0;0;0;0;0;0;0;0;0;0;0;0;0;0
FR;8;2022-09-10;0;0;0;0;0;0;0;0;0;0;0;0;0;0;0;0;0;0
FR;8;2022-09-11;0;0;0;0;0;0;0;0;0;0;0;0;0;0;0;0;0;0
FR;8;2022-09-12;0;0;0;0;0;0;0;0;0;0;0;0;0;0;0;0;0;0
FR;8;2022-09-13;0;0;0;0;0;0;0;0;0;0;0;0;0;0;0;0;0;0
FR;8;2022-09-14;0;0;0;0;0;0;0;0;0;0;0;0;0;0;0;0;0;0
FR;8;2022-09-15;0;0;0;0;0;0;0;0;0;0;0;0;0;0;0;0;0;0
FR;8;2022-09-16;0;0;0;0;0;0;0;0;0;0;0;0;0;0;0;0;0;0
FR;8;2022-09-17;0;0;0;0;0;0;0;0;0;0;0;0;0;0;0;0;0;0
FR;8;2022-09-18;0;0;0;0;0;0;0;0;0;0;0;0;0;0;0;0;0;0
FR;8;2022-09-19;0;0;0;0;0;0;0;0;0;0;0;0;0;0;0;0;0;0
FR;8;2022-09-20;0;0;0;0;0;0;0;0;0;0;0;0;0;0;0;0;0;0
FR;8;2022-09-21;0;0;0;0;0;0;0;0;0;0;0;0;0;0;0;0;0;0
FR;8;2022-09-22;0;0;0;0;0;0;0;0;0;0;0;0;0;0;0;0;0;0
FR;8;2022-09-23;0;0;0;0;0;0;0;0;0;0;0;0;0;0;0;0;0;0
FR;8;2022-09-24;0;0;0;0;0;0;0;0;0;0;0;0;0;0;0;0;0;0
FR;8;2022-09-25;0;0;0;0;0;0;0;0;0;0;0;0;0;0;0;0;0;0
FR;8;2022-09-26;0;0;0;0;0;0;0;0;0;0;0;0;0;0;0;0;0;0
FR;8;2022-09-27;0;0;0;0;0;0;0;0;0;0;0;0;0;0;0;0;0;0
FR;8;2022-09-28;0;0;0;0;0;0;0;0;0;0;0;0;0;0;0;0;0;0
FR;8;2022-09-29;0;0;0;0;0;0;0;0;0;0;0;0;0;0;0;0;0;0
FR;8;2022-09-30;0;0;0;0;0;0;0;0;0;0;0;0;0;0;0;0;0;0
FR;8;2022-10-01;0;0;0;0;0;0;0;0;0;0;0;0;0;0;0;0;0;0
FR;8;2022-10-02;0;0;0;0;0;0;0;0;0;0;0;0;0;0;0;0;0;0
FR;8;2022-10-03;0;0;0;0;0;0;0;0;0;0;0;0;0;0;0;0;0;0
FR;8;2022-10-04;0;0;0;0;0;0;0;0;0;0;0;0;0;0;0;0;0;0
FR;8;2022-10-05;0;0;0;0;0;0;0;0;0;0;0;0;0;0;0;0;0;0
FR;8;2022-10-06;7;17;113;859;8;82;865;1057;110;7;17;113;859;8;82;865;1057;110
FR;8;2022-10-07;72;101;842;8010;62;699;8064;9843;1073;79;118;955;8869;70;781;8929;10900;1183
FR;8;2022-10-08;35;115;610;4055;50;516;4107;5308;676;114;233;1565;12924;120;1297;13036;16208;1859
FR;8;2022-10-09;17;22;145;885;13;132;913;1233;184;131;255;1710;13809;133;1429;13949;17441;2043
FR;8;2022-10-10;117;192;1342;12681;106;1026;12920;16218;2251;248;447;3052;26490;239;2455;26869;33659;4294
FR;8;2022-10-11;179;261;2475;26915;135;2010;27187;33949;4715;427;708;5527;53405;374;4465;54056;67608;9009
FR;8;2022-10-12;153;255;1830;18230;149;1441;18465;23463;3533;580;963;7357;71635;523;5906;72521;91071;12542
FR;8;2022-10-13;206;278;2508;28042;175;1901;28406;35539;5204;786;1241;9865;99677;698;7807;100927;126610;17746
FR;8;2022-10-14;254;419;3271;36232;242;2555;36658;45558;6303;1040;1660;13136;135909;940;10362;137585;172168;24049
FR;8;2022-10-15;102;181;1203;8802;78;1001;8931;11782;1830;1142;1841;14339;144711;1018;11363;146516;183950;25879
FR;8;2022-10-16;34;54;248;1520;26;215;1555;2177;402;1176;1895;14587;146231;1044;11578;148071;186127;26281
FR;8;2022-10-17;157;310;2097;21767;173;1624;22075;28255;4534;1333;2205;16684;167998;1217;13202;170146;214382;30815
FR;8;2022-10-18;269;347;3354;37839;224;2652;38222;50763;9816;1602;2552;20038;205837;1441;15854;208368;265145;40631
FR;8;2022-10-19;193;313;2627;28292;182;2185;28609;38687;7832;1795;2865;22665;234129;1623;18039;236977;303832;48463
FR;8;2022-10-20;251;363;3575;41170;222;2652;41779;55649;11133;2046;3228;26240;275299;1845;20691;278756;359481;59596
FR;8;2022-10-21;325;489;4452;49378;276;3466;49978;66248;12707;2371;3717;30692;324677;2121;24157;328734;425729;72303
FR;8;2022-10-22;124;168;1230;10658;111;926;10847;14730;2939;2495;3885;31922;335335;2232;25083;339581;440459;75242
FR;8;2022-10-23;49;53;266;1760;48;197;1839;2606;569;2544;3938;32188;337095;2280;25280;341420;443065;75811
FR;8;2022-10-24;230;311;2474;24029;173;2071;24329;33499;7049;2774;4249;34662;361124;2453;27351;365749;476564;82860
FR;8;2022-10-25;306;412;4076;43400;255;3130;43999;61218;13986;3080;4661;38738;404524;2708;30481;409748;537782;96846
FR;8;2022-10-26;225;339;2861;28640;182;2364;28947;41262;9863;3305;5000;41599;433164;2890;32845;438695;579044;106709
FR;8;2022-10-27;273;415;3321;36136;242;2627;36608;51141;11841;3578;5415;44920;469300;3132;35472;475303;630185;118550
FR;8;2022-10-28;327;461;3825;39421;256;2858;40153;55022;11942;3905;5876;48745;508721;3388;38330;515456;685207;130492
FR;8;2022-10-29;109;165;1072;8222;94;801;8367;11851;2666;4014;6041;49817;516943;3482;39131;523823;697058;133158
FR;8;2022-10-30;40;53;209;1334;38;180;1379;2047;484;4054;6094;50026;518277;3520;39311;525202;699105;133642
FR;8;2022-10-31;195;256;1660;14519;140;1274;14783;21128;5053;4249;6350;51686;532796;3660;40585;539985;720233;138695
FR;8;2022-11-01;24;39;133;952;21;167;968;1589;452;4273;6389;51819;533748;3681;40752;540953;721822;139147
FR;8;2022-11-02;193;368;2370;23282;202;1968;23678;34993;9280;4466;6757;54189;557030;3883;42720;564631;756815;148427
FR;8;2022-11-03;308;415;3474;36879;254;2599;37516;54513;14299;4774;7172;57663;593909;4137;45319;602147;811328;162726
FR;8;2022-11-04;352;494;3779;40182;258;2971;40701;57933;14150;5126;7666;61442;634091;4395;48290;642848;869261;176876
FR;8;2022-11-05;113;182;1102;8754;117;849;8921;12870;3065;5239;7848;62544;642845;4512;49139;651769;882131;179941
FR;8;2022-11-06;41;56;223;1403;38;205;1436;2241;590;5280;7904;62767;644248;4550;49344;653205;884372;180531
FR;8;2022-11-07;229;274;2314;24714;200;1785;25296;37404;10255;5509;8178;65081;668962;4750;51129;678501;921776;190786
FR;8;2022-11-08;337;499;4321;48311;300;3251;49254;71369;18703;5846;8677;69402;717273;5050;54380;727755;993145;209489
FR;8;2022-11-09;257;366;2874;29146;207;2258;29824;44408;12242;6103;9043;72276;746419;5257;56638;757579;1037553;221731
FR;8;2022-11-10;361;529;3941;40179;302;3011;41094;60343;16100;6464;9572;76217;786598;5559;59649;798673;1097896;237831
FR;8;2022-11-11;39;64;242;1473;31;206;1518;2661;924;6503;9636;76459;788071;5590;59855;800191;1100557;238755
FR;8;2022-11-12;84;165;881;6429;79;686;6633;9890;2552;6587;9801;77340;794500;5669;60541;806824;1110447;241307
FR;8;2022-11-13;36;54;211;1108;34;171;1160;1916;579;6623;9855;77551;795608;5703;60712;807984;1112363;241886
FR;8;2022-11-14;225;302;2226;22375;162;1714;22910;34940;10242;6848;10157;79777;817983;5865;62426;830894;1147303;252128
FR;8;2022-11-15;337;419;3752;42251;252;2854;43156;64605;18464;7185;10576;83529;860234;6117;65280;874050;1211908;270592
FR;8;2022-11-16;297;346;2607;26437;212;2141;26903;41563;12435;7482;10922;86136;886671;6329;67421;900953;1253471;283027
FR;8;2022-11-17;359;425;3365;36755;284;2598;37338;56469;16434;7841;11347;89501;923426;6613;70019;938291;1309940;299461
FR;8;2022-11-18;341;461;4057;42235;281;2964;43084;63493;17341;8182;11808;93558;965661;6894;72983;981375;1373433;316802
FR;8;2022-11-19;120;178;1198;8948;115;837;9132;13766;3760;8302;11986;94756;974609;7009;73820;990507;1387199;320562
FR;8;2022-11-20;33;48;260;1584;33;216;1651;2648;777;8335;12034;95016;976193;7042;74036;992158;1389847;321339
FR;8;2022-11-21;211;299;2063;20011;172;1583;20536;31914;9731;8546;12333;97079;996204;7214;75619;1012694;1421761;331070
FR;8;2022-11-22;333;405;3453;37451;244;2655;37949;57905;17190;8879;12738;100532;1033655;7458;78274;1050643;1479666;348260
FR;8;2022-11-23;225;314;2404;24384;176;2008;24814;39090;12187;9104;13052;102936;1058039;7634;80282;1075457;1518756;360447
FR;8;2022-11-24;346;376;3360;34794;227;2569;35486;54996;16843;9450;13428;106296;1092833;7861;82851;1110943;1573752;377290
FR;8;2022-11-25;307;414;3624;37640;275;2613;38434;57623;16452;9757;13842;109920;1130473;8136;85464;1149377;1631375;393742
FR;8;2022-11-26;166;194;1176;8794;126;896;8952;13649;3770;9923;14036;111096;1139267;8262;86360;1158329;1645024;397512
FR;8;2022-11-27;44;40;226;1541;33;180;1556;2467;721;9967;14076;111322;1140808;8295;86540;1159885;1647491;398233
FR;8;2022-11-28;178;295;2297;23243;167;1688;23895;37070;11413;10145;14371;113619;1164051;8462;88228;1183780;1684561;409646
FR;8;2022-11-29;290;424;3943;43865;214;2919;44526;68761;21193;10435;14795;117562;1207916;8676;91147;1228306;1753322;430839
FR;8;2022-11-30;279;404;3342;34756;222;2521;35495;54480;16346;10714;15199;120904;1242672;8898;93668;1263801;1807802;447185
FR;8;2022-12-01;324;463;4426;49010;264;3069;49800;77048;24017;11038;15662;125330;1291682;9162;96737;1313601;1884850;471202
FR;8;2022-12-02;397;513;5408;58267;298;3716;59441;89486;26141;11435;16175;130738;1349949;9460;100453;1373042;1974336;497343
FR;8;2022-12-03;172;215;1908;16805;107;1317;17221;25751;7177;11607;16390;132646;1366754;9567;101770;1390263;2000087;504520
FR;8;2022-12-04;53;89;487;4038;59;402;4098;6258;1746;11660;16479;133133;1370792;9626;102172;1394361;2006345;506266
FR;8;2022-12-05;272;391;3823;42226;241;2486;43148;66619;20837;11932;16870;136956;1413018;9867;104658;1437509;2072964;527103
FR;8;2022-12-06;413;535;6278;74065;290;4199;75473;117370;37454;12345;17405;143234;1487083;10157;108857;1512982;2190334;564557
FR;8;2022-12-07;347;423;4885;54818;253;3212;55919;87263;27939;12692;17828;148119;1541901;10410;112069;1568901;2277597;592496
FR;8;2022-12-08;449;523;6388;75098;285;4156;76670;119814;38732;13141;18351;154507;1616999;10695;116225;1645571;2397411;631228
FR;8;2022-12-09;537;598;7959;90611;350;5152;92364;142356;44575;13678;18949;162466;1707610;11045;121377;1737935;2539767;675803
FR;8;2022-12-10;257;293;3328;31627;160;2076;32475;48578;13937;13935;19242;165794;1739237;11205;123453;1770410;2588345;689740
FR;8;2022-12-11;87;101;931;7837;65;635;8055;11847;3137;14022;19343;166725;1747074;11270;124088;1778465;2600192;692877
FR;8;2022-12-12;346;451;5821;64071;244;3692;65588;102888;33411;14368;19794;172546;1811145;11514;127780;1844053;2703080;726288
FR;8;2022-12-13;520;598;8372;98711;344;5162;101121;159366;52751;14888;20392;180918;1909856;11858;132942;1945174;2862446;779039
FR;8;2022-12-14;439;522;6310;69711;293;4128;71257;112626;36978;15327;20914;187228;1979567;12151;137070;2016431;2975072;816017
FR;8;2022-12-15;476;631;8066;91109;346;5056;93277;147929;49260;15803;21545;195294;2070676;12497;142126;2109708;3123001;865277
FR;8;2022-12-16;559;696;8794;99743;368;5634;101853;160810;52951;16362;22241;204088;2170419;12865;147760;2211561;3283811;918228
FR;8;2022-12-17;228;302;3127;29915;180;1989;30686;46500;13719;16590;22543;207215;2200334;13045;149749;2242247;3330311;931947
FR;8;2022-12-18;65;89;722;5923;43;491;6070;9214;2624;16655;22632;207937;2206257;13088;150240;2248317;3339525;934571
FR;8;2022-12-19;390;445;5300;53437;258;3321;54979;87093;28612;17045;23077;213237;2259694;13346;153561;2303296;3426618;963183
FR;8;2022-12-20;541;561;7274;75972;326;4703;78031;125860;42806;17586;23638;220511;2335666;13672;158264;2381327;3552478;1005989
FR;8;2022-12-21;399;467;4896;48281;274;3260;49540;80627;27639;17985;24105;225407;2383947;13946;161524;2430867;3633105;1033628
FR;8;2022-12-22;444;511;4499;43674;301;3098;44871;73566;25445;18429;24616;229906;2427621;14247;164622;2475738;3706671;1059073
FR;8;2022-12-23;290;374;2833;24736;237;2019;25403;41647;14112;18719;24990;232739;2452357;14484;166641;2501141;3748318;1073185
FR;8;2022-12-24;68;67;385;2506;39;286;2617;4063;1144;18787;25057;233124;2454863;14523;166927;2503758;3752381;1074329
FR;8;2022-12-25;27;26;98;527;21;75;546;878;254;18814;25083;233222;2455390;14544;167002;2504304;3753259;1074583
FR;8;2022-12-26;231;265;2130;15893;165;1483;16531;26390;8284;19045;25348;235352;2471283;14709;168485;2520835;3779649;1082867
FR;8;2022-12-27;371;440;3703;32107;249;2486;33180;54670;18857;19416;25788;239055;2503390;14958;170971;2554015;3834319;1101724
FR;8;2022-12-28;327;332;2884;24363;184;2001;24945;41115;14050;19743;26120;241939;2527753;15142;172972;2578960;3875434;1115774
FR;8;2022-12-29;282;395;3097;25152;216;2111;26086;43143;14822;20025;26515;245036;2552905;15358;175083;2605046;3918577;1130596
FR;8;2022-12-30;275;324;2397;18339;201;1641;18949;31012;10318;20300;26839;247433;2571244;15559;176724;2623995;3949589;1140914
FR;8;2022-12-31;83;114;439;2888;69;354;3031;4638;1233;20383;26953;247872;2574132;15628;177078;2627026;3954227;1142147
FR;8;2023-01-01;14;27;100;634;11;78;654;945;212;20397;26980;247972;2574766;15639;177156;2627680;3955172;1142359
FR;8;2023-01-02;224;354;2168;17679;202;1521;18128;31002;11276;20621;27334;250140;2592445;15841;178677;2645808;3986174;1153635
FR;9;2020-12-27;0;0;0;0;0;0;0;0;0;0;0;0;0;0;0;0;0;0
FR;9;2020-12-28;0;0;0;0;0;0;0;0;0;0;0;0;0;0;0;0;0;0
FR;9;2020-12-29;0;0;0;0;0;0;0;0;0;0;0;0;0;0;0;0;0;0
FR;9;2020-12-30;0;0;0;0;0;0;0;0;0;0;0;0;0;0;0;0;0;0
FR;9;2020-12-31;0;0;0;0;0;0;0;0;0;0;0;0;0;0;0;0;0;0
FR;9;2021-01-01;0;0;0;0;0;0;0;0;0;0;0;0;0;0;0;0;0;0
FR;9;2021-01-02;0;0;0;0;0;0;0;0;0;0;0;0;0;0;0;0;0;0
FR;9;2021-01-03;0;0;0;0;0;0;0;0;0;0;0;0;0;0;0;0;0;0
FR;9;2021-01-04;0;0;0;0;0;0;0;0;0;0;0;0;0;0;0;0;0;0
FR;9;2021-01-05;0;0;0;0;0;0;0;0;0;0;0;0;0;0;0;0;0;0
FR;9;2021-01-06;0;0;0;0;0;0;0;0;0;0;0;0;0;0;0;0;0;0
FR;9;2021-01-07;0;0;0;0;0;0;0;0;0;0;0;0;0;0;0;0;0;0
FR;9;2021-01-08;0;0;0;0;0;0;0;0;0;0;0;0;0;0;0;0;0;0
FR;9;2021-01-09;0;0;0;0;0;0;0;0;0;0;0;0;0;0;0;0;0;0
FR;9;2021-01-10;0;0;0;0;0;0;0;0;0;0;0;0;0;0;0;0;0;0
FR;9;2021-01-11;0;0;0;0;0;0;0;0;0;0;0;0;0;0;0;0;0;0
FR;9;2021-01-12;0;0;0;0;0;0;0;0;0;0;0;0;0;0;0;0;0;0
FR;9;2021-01-13;0;0;0;0;0;0;0;0;0;0;0;0;0;0;0;0;0;0
FR;9;2021-01-14;0;0;0;0;0;0;0;0;0;0;0;0;0;0;0;0;0;0
FR;9;2021-01-15;0;0;0;0;0;0;0;0;0;0;0;0;0;0;0;0;0;0
FR;9;2021-01-16;0;0;0;0;0;0;0;0;0;0;0;0;0;0;0;0;0;0
FR;9;2021-01-17;0;0;0;0;0;0;0;0;0;0;0;0;0;0;0;0;0;0
FR;9;2021-01-18;0;0;0;0;0;0;0;0;0;0;0;0;0;0;0;0;0;0
FR;9;2021-01-19;0;0;0;0;0;0;0;0;0;0;0;0;0;0;0;0;0;0
FR;9;2021-01-20;0;0;0;0;0;0;0;0;0;0;0;0;0;0;0;0;0;0
FR;9;2021-01-21;0;0;0;0;0;0;0;0;0;0;0;0;0;0;0;0;0;0
FR;9;2021-01-22;0;0;0;0;0;0;0;0;0;0;0;0;0;0;0;0;0;0
FR;9;2021-01-23;0;0;0;0;0;0;0;0;0;0;0;0;0;0;0;0;0;0
FR;9;2021-01-24;0;0;0;0;0;0;0;0;0;0;0;0;0;0;0;0;0;0
FR;9;2021-01-25;0;0;0;0;0;0;0;0;0;0;0;0;0;0;0;0;0;0
FR;9;2021-01-26;0;0;0;0;0;0;0;0;0;0;0;0;0;0;0;0;0;0
FR;9;2021-01-27;0;0;0;0;0;0;0;0;0;0;0;0;0;0;0;0;0;0
FR;9;2021-01-28;0;0;0;0;0;0;0;0;0;0;0;0;0;0;0;0;0;0
FR;9;2021-01-29;0;0;0;0;0;0;0;0;0;0;0;0;0;0;0;0;0;0
FR;9;2021-01-30;0;0;0;0;0;0;0;0;0;0;0;0;0;0;0;0;0;0
FR;9;2021-01-31;0;0;0;0;0;0;0;0;0;0;0;0;0;0;0;0;0;0
FR;9;2021-02-01;0;0;0;0;0;0;0;0;0;0;0;0;0;0;0;0;0;0
FR;9;2021-02-02;0;0;0;0;0;0;0;0;0;0;0;0;0;0;0;0;0;0
FR;9;2021-02-03;0;0;0;0;0;0;0;0;0;0;0;0;0;0;0;0;0;0
FR;9;2021-02-04;0;0;0;0;0;0;0;0;0;0;0;0;0;0;0;0;0;0
FR;9;2021-02-05;0;0;0;0;0;0;0;0;0;0;0;0;0;0;0;0;0;0
FR;9;2021-02-06;0;0;0;0;0;0;0;0;0;0;0;0;0;0;0;0;0;0
FR;9;2021-02-07;0;0;0;0;0;0;0;0;0;0;0;0;0;0;0;0;0;0
FR;9;2021-02-08;0;0;0;0;0;0;0;0;0;0;0;0;0;0;0;0;0;0
FR;9;2021-02-09;0;0;0;0;0;0;0;0;0;0;0;0;0;0;0;0;0;0
FR;9;2021-02-10;0;0;0;0;0;0;0;0;0;0;0;0;0;0;0;0;0;0
FR;9;2021-02-11;0;0;0;0;0;0;0;0;0;0;0;0;0;0;0;0;0;0
FR;9;2021-02-12;0;0;0;0;0;0;0;0;0;0;0;0;0;0;0;0;0;0
FR;9;2021-02-13;0;0;0;0;0;0;0;0;0;0;0;0;0;0;0;0;0;0
FR;9;2021-02-14;0;0;0;0;0;0;0;0;0;0;0;0;0;0;0;0;0;0
FR;9;2021-02-15;0;0;0;0;0;0;0;0;0;0;0;0;0;0;0;0;0;0
FR;9;2021-02-16;0;0;0;0;0;0;0;0;0;0;0;0;0;0;0;0;0;0
FR;9;2021-02-17;0;0;0;0;0;0;0;0;0;0;0;0;0;0;0;0;0;0
FR;9;2021-02-18;0;0;0;0;0;0;0;0;0;0;0;0;0;0;0;0;0;0
FR;9;2021-02-19;0;0;0;0;0;0;0;0;0;0;0;0;0;0;0;0;0;0
FR;9;2021-02-20;0;0;0;0;0;0;0;0;0;0;0;0;0;0;0;0;0;0
FR;9;2021-02-21;0;0;0;0;0;0;0;0;0;0;0;0;0;0;0;0;0;0
FR;9;2021-02-22;0;0;0;0;0;0;0;0;0;0;0;0;0;0;0;0;0;0
FR;9;2021-02-23;0;0;0;0;0;0;0;0;0;0;0;0;0;0;0;0;0;0
FR;9;2021-02-24;0;0;0;0;0;0;0;0;0;0;0;0;0;0;0;0;0;0
FR;9;2021-02-25;0;0;0;0;0;0;0;0;0;0;0;0;0;0;0;0;0;0
FR;9;2021-02-26;0;0;0;0;0;0;0;0;0;0;0;0;0;0;0;0;0;0
FR;9;2021-02-27;0;0;0;0;0;0;0;0;0;0;0;0;0;0;0;0;0;0
FR;9;2021-02-28;0;0;0;0;0;0;0;0;0;0;0;0;0;0;0;0;0;0
FR;9;2021-03-01;0;0;0;0;0;0;0;0;0;0;0;0;0;0;0;0;0;0
FR;9;2021-03-02;0;0;0;0;0;0;0;0;0;0;0;0;0;0;0;0;0;0
FR;9;2021-03-03;0;0;0;0;0;0;0;0;0;0;0;0;0;0;0;0;0;0
FR;9;2021-03-04;0;0;0;0;0;0;0;0;0;0;0;0;0;0;0;0;0;0
FR;9;2021-03-05;0;0;0;0;0;0;0;0;0;0;0;0;0;0;0;0;0;0
FR;9;2021-03-06;0;0;0;0;0;0;0;0;0;0;0;0;0;0;0;0;0;0
FR;9;2021-03-07;0;0;0;0;0;0;0;0;0;0;0;0;0;0;0;0;0;0
FR;9;2021-03-08;0;0;0;0;0;0;0;0;0;0;0;0;0;0;0;0;0;0
FR;9;2021-03-09;0;0;0;0;0;0;0;0;0;0;0;0;0;0;0;0;0;0
FR;9;2021-03-10;0;0;0;0;0;0;0;0;0;0;0;0;0;0;0;0;0;0
FR;9;2021-03-11;0;0;0;0;0;0;0;0;0;0;0;0;0;0;0;0;0;0
FR;9;2021-03-12;0;0;0;0;0;0;0;0;0;0;0;0;0;0;0;0;0;0
FR;9;2021-03-13;0;0;0;0;0;0;0;0;0;0;0;0;0;0;0;0;0;0
FR;9;2021-03-14;0;0;0;0;0;0;0;0;0;0;0;0;0;0;0;0;0;0
FR;9;2021-03-15;0;0;0;0;0;0;0;0;0;0;0;0;0;0;0;0;0;0
FR;9;2021-03-16;0;0;0;0;0;0;0;0;0;0;0;0;0;0;0;0;0;0
FR;9;2021-03-17;0;0;0;0;0;0;0;0;0;0;0;0;0;0;0;0;0;0
FR;9;2021-03-18;0;0;0;0;0;0;0;0;0;0;0;0;0;0;0;0;0;0
FR;9;2021-03-19;0;0;0;0;0;0;0;0;0;0;0;0;0;0;0;0;0;0
FR;9;2021-03-20;0;0;0;0;0;0;0;0;0;0;0;0;0;0;0;0;0;0
FR;9;2021-03-21;0;0;0;0;0;0;0;0;0;0;0;0;0;0;0;0;0;0
FR;9;2021-03-22;0;0;0;0;0;0;0;0;0;0;0;0;0;0;0;0;0;0
FR;9;2021-03-23;0;0;0;0;0;0;0;0;0;0;0;0;0;0;0;0;0;0
FR;9;2021-03-24;0;0;0;0;0;0;0;0;0;0;0;0;0;0;0;0;0;0
FR;9;2021-03-25;0;0;0;0;0;0;0;0;0;0;0;0;0;0;0;0;0;0
FR;9;2021-03-26;0;0;0;0;0;0;0;0;0;0;0;0;0;0;0;0;0;0
FR;9;2021-03-27;0;0;0;0;0;0;0;0;0;0;0;0;0;0;0;0;0;0
FR;9;2021-03-28;0;0;0;0;0;0;0;0;0;0;0;0;0;0;0;0;0;0
FR;9;2021-03-29;0;0;0;0;0;0;0;0;0;0;0;0;0;0;0;0;0;0
FR;9;2021-03-30;0;0;0;0;0;0;0;0;0;0;0;0;0;0;0;0;0;0
FR;9;2021-03-31;0;0;0;0;0;0;0;0;0;0;0;0;0;0;0;0;0;0
FR;9;2021-04-01;0;0;0;0;0;0;0;0;0;0;0;0;0;0;0;0;0;0
FR;9;2021-04-02;0;0;0;0;0;0;0;0;0;0;0;0;0;0;0;0;0;0
FR;9;2021-04-03;0;0;0;0;0;0;0;0;0;0;0;0;0;0;0;0;0;0
FR;9;2021-04-04;0;0;0;0;0;0;0;0;0;0;0;0;0;0;0;0;0;0
FR;9;2021-04-05;0;0;0;0;0;0;0;0;0;0;0;0;0;0;0;0;0;0
FR;9;2021-04-06;0;0;0;0;0;0;0;0;0;0;0;0;0;0;0;0;0;0
FR;9;2021-04-07;0;0;0;0;0;0;0;0;0;0;0;0;0;0;0;0;0;0
FR;9;2021-04-08;0;0;0;0;0;0;0;0;0;0;0;0;0;0;0;0;0;0
FR;9;2021-04-09;0;0;0;0;0;0;0;0;0;0;0;0;0;0;0;0;0;0
FR;9;2021-04-10;0;0;0;0;0;0;0;0;0;0;0;0;0;0;0;0;0;0
FR;9;2021-04-11;0;0;0;0;0;0;0;0;0;0;0;0;0;0;0;0;0;0
FR;9;2021-04-12;0;0;0;0;0;0;0;0;0;0;0;0;0;0;0;0;0;0
FR;9;2021-04-13;0;0;0;0;0;0;0;0;0;0;0;0;0;0;0;0;0;0
FR;9;2021-04-14;0;0;0;0;0;0;0;0;0;0;0;0;0;0;0;0;0;0
FR;9;2021-04-15;0;0;0;0;0;0;0;0;0;0;0;0;0;0;0;0;0;0
FR;9;2021-04-16;0;0;0;0;0;0;0;0;0;0;0;0;0;0;0;0;0;0
FR;9;2021-04-17;0;0;0;0;0;0;0;0;0;0;0;0;0;0;0;0;0;0
FR;9;2021-04-18;0;0;0;0;0;0;0;0;0;0;0;0;0;0;0;0;0;0
FR;9;2021-04-19;0;0;0;0;0;0;0;0;0;0;0;0;0;0;0;0;0;0
FR;9;2021-04-20;0;0;0;0;0;0;0;0;0;0;0;0;0;0;0;0;0;0
FR;9;2021-04-21;0;0;0;0;0;0;0;0;0;0;0;0;0;0;0;0;0;0
FR;9;2021-04-22;0;0;0;0;0;0;0;0;0;0;0;0;0;0;0;0;0;0
FR;9;2021-04-23;0;0;0;0;0;0;0;0;0;0;0;0;0;0;0;0;0;0
FR;9;2021-04-24;0;0;0;0;0;0;0;0;0;0;0;0;0;0;0;0;0;0
FR;9;2021-04-25;0;0;0;0;0;0;0;0;0;0;0;0;0;0;0;0;0;0
FR;9;2021-04-26;0;0;0;0;0;0;0;0;0;0;0;0;0;0;0;0;0;0
FR;9;2021-04-27;0;0;0;0;0;0;0;0;0;0;0;0;0;0;0;0;0;0
FR;9;2021-04-28;0;0;0;0;0;0;0;0;0;0;0;0;0;0;0;0;0;0
FR;9;2021-04-29;0;0;0;0;0;0;0;0;0;0;0;0;0;0;0;0;0;0
FR;9;2021-04-30;0;0;0;0;0;0;0;0;0;0;0;0;0;0;0;0;0;0
FR;9;2021-05-01;0;0;0;0;0;0;0;0;0;0;0;0;0;0;0;0;0;0
FR;9;2021-05-02;0;0;0;0;0;0;0;0;0;0;0;0;0;0;0;0;0;0
FR;9;2021-05-03;0;0;0;0;0;0;0;0;0;0;0;0;0;0;0;0;0;0
FR;9;2021-05-04;0;0;0;0;0;0;0;0;0;0;0;0;0;0;0;0;0;0
FR;9;2021-05-05;0;0;0;0;0;0;0;0;0;0;0;0;0;0;0;0;0;0
FR;9;2021-05-06;0;0;0;0;0;0;0;0;0;0;0;0;0;0;0;0;0;0
FR;9;2021-05-07;0;0;0;0;0;0;0;0;0;0;0;0;0;0;0;0;0;0
FR;9;2021-05-08;0;0;0;0;0;0;0;0;0;0;0;0;0;0;0;0;0;0
FR;9;2021-05-09;0;0;0;0;0;0;0;0;0;0;0;0;0;0;0;0;0;0
FR;9;2021-05-10;0;0;0;0;0;0;0;0;0;0;0;0;0;0;0;0;0;0
FR;9;2021-05-11;0;0;0;0;0;0;0;0;0;0;0;0;0;0;0;0;0;0
FR;9;2021-05-12;0;0;0;0;0;0;0;0;0;0;0;0;0;0;0;0;0;0
FR;9;2021-05-13;0;0;0;0;0;0;0;0;0;0;0;0;0;0;0;0;0;0
FR;9;2021-05-14;0;0;0;0;0;0;0;0;0;0;0;0;0;0;0;0;0;0
FR;9;2021-05-15;0;0;0;0;0;0;0;0;0;0;0;0;0;0;0;0;0;0
FR;9;2021-05-16;0;0;0;0;0;0;0;0;0;0;0;0;0;0;0;0;0;0
FR;9;2021-05-17;0;0;0;0;0;0;0;0;0;0;0;0;0;0;0;0;0;0
FR;9;2021-05-18;0;0;0;0;0;0;0;0;0;0;0;0;0;0;0;0;0;0
FR;9;2021-05-19;0;0;0;0;0;0;0;0;0;0;0;0;0;0;0;0;0;0
FR;9;2021-05-20;0;0;0;0;0;0;0;0;0;0;0;0;0;0;0;0;0;0
FR;9;2021-05-21;0;0;0;0;0;0;0;0;0;0;0;0;0;0;0;0;0;0
FR;9;2021-05-22;0;0;0;0;0;0;0;0;0;0;0;0;0;0;0;0;0;0
FR;9;2021-05-23;0;0;0;0;0;0;0;0;0;0;0;0;0;0;0;0;0;0
FR;9;2021-05-24;0;0;0;0;0;0;0;0;0;0;0;0;0;0;0;0;0;0
FR;9;2021-05-25;0;0;0;0;0;0;0;0;0;0;0;0;0;0;0;0;0;0
FR;9;2021-05-26;0;0;0;0;0;0;0;0;0;0;0;0;0;0;0;0;0;0
FR;9;2021-05-27;0;0;0;0;0;0;0;0;0;0;0;0;0;0;0;0;0;0
FR;9;2021-05-28;0;0;0;0;0;0;0;0;0;0;0;0;0;0;0;0;0;0
FR;9;2021-05-29;0;0;0;0;0;0;0;0;0;0;0;0;0;0;0;0;0;0
FR;9;2021-05-30;0;0;0;0;0;0;0;0;0;0;0;0;0;0;0;0;0;0
FR;9;2021-05-31;0;0;0;0;0;0;0;0;0;0;0;0;0;0;0;0;0;0
FR;9;2021-06-01;0;0;0;0;0;0;0;0;0;0;0;0;0;0;0;0;0;0
FR;9;2021-06-02;0;0;0;0;0;0;0;0;0;0;0;0;0;0;0;0;0;0
FR;9;2021-06-03;0;0;0;0;0;0;0;0;0;0;0;0;0;0;0;0;0;0
FR;9;2021-06-04;0;0;0;0;0;0;0;0;0;0;0;0;0;0;0;0;0;0
FR;9;2021-06-05;0;0;0;0;0;0;0;0;0;0;0;0;0;0;0;0;0;0
FR;9;2021-06-06;0;0;0;0;0;0;0;0;0;0;0;0;0;0;0;0;0;0
FR;9;2021-06-07;0;0;0;0;0;0;0;0;0;0;0;0;0;0;0;0;0;0
FR;9;2021-06-08;0;0;0;0;0;0;0;0;0;0;0;0;0;0;0;0;0;0
FR;9;2021-06-09;0;0;0;0;0;0;0;0;0;0;0;0;0;0;0;0;0;0
FR;9;2021-06-10;0;0;0;0;0;0;0;0;0;0;0;0;0;0;0;0;0;0
FR;9;2021-06-11;0;0;0;0;0;0;0;0;0;0;0;0;0;0;0;0;0;0
FR;9;2021-06-12;0;0;0;0;0;0;0;0;0;0;0;0;0;0;0;0;0;0
FR;9;2021-06-13;0;0;0;0;0;0;0;0;0;0;0;0;0;0;0;0;0;0
FR;9;2021-06-14;0;0;0;0;0;0;0;0;0;0;0;0;0;0;0;0;0;0
FR;9;2021-06-15;0;0;0;0;0;0;0;0;0;0;0;0;0;0;0;0;0;0
FR;9;2021-06-16;0;0;0;0;0;0;0;0;0;0;0;0;0;0;0;0;0;0
FR;9;2021-06-17;0;0;0;0;0;0;0;0;0;0;0;0;0;0;0;0;0;0
FR;9;2021-06-18;0;0;0;0;0;0;0;0;0;0;0;0;0;0;0;0;0;0
FR;9;2021-06-19;0;0;0;0;0;0;0;0;0;0;0;0;0;0;0;0;0;0
FR;9;2021-06-20;0;0;0;0;0;0;0;0;0;0;0;0;0;0;0;0;0;0
FR;9;2021-06-21;0;0;0;0;0;0;0;0;0;0;0;0;0;0;0;0;0;0
FR;9;2021-06-22;0;0;0;0;0;0;0;0;0;0;0;0;0;0;0;0;0;0
FR;9;2021-06-23;0;0;0;0;0;0;0;0;0;0;0;0;0;0;0;0;0;0
FR;9;2021-06-24;0;0;0;0;0;0;0;0;0;0;0;0;0;0;0;0;0;0
FR;9;2021-06-25;0;0;0;0;0;0;0;0;0;0;0;0;0;0;0;0;0;0
FR;9;2021-06-26;0;0;0;0;0;0;0;0;0;0;0;0;0;0;0;0;0;0
FR;9;2021-06-27;0;0;0;0;0;0;0;0;0;0;0;0;0;0;0;0;0;0
FR;9;2021-06-28;0;0;0;0;0;0;0;0;0;0;0;0;0;0;0;0;0;0
FR;9;2021-06-29;0;0;0;0;0;0;0;0;0;0;0;0;0;0;0;0;0;0
FR;9;2021-06-30;0;0;0;0;0;0;0;0;0;0;0;0;0;0;0;0;0;0
FR;9;2021-07-01;0;0;0;0;0;0;0;0;0;0;0;0;0;0;0;0;0;0
FR;9;2021-07-02;0;0;0;0;0;0;0;0;0;0;0;0;0;0;0;0;0;0
FR;9;2021-07-03;0;0;0;0;0;0;0;0;0;0;0;0;0;0;0;0;0;0
FR;9;2021-07-04;0;0;0;0;0;0;0;0;0;0;0;0;0;0;0;0;0;0
FR;9;2021-07-05;0;0;0;0;0;0;0;0;0;0;0;0;0;0;0;0;0;0
FR;9;2021-07-06;0;0;0;0;0;0;0;0;0;0;0;0;0;0;0;0;0;0
FR;9;2021-07-07;0;0;0;0;0;0;0;0;0;0;0;0;0;0;0;0;0;0
FR;9;2021-07-08;0;0;0;0;0;0;0;0;0;0;0;0;0;0;0;0;0;0
FR;9;2021-07-09;0;0;0;0;0;0;0;0;0;0;0;0;0;0;0;0;0;0
FR;9;2021-07-10;0;0;0;0;0;0;0;0;0;0;0;0;0;0;0;0;0;0
FR;9;2021-07-11;0;0;0;0;0;0;0;0;0;0;0;0;0;0;0;0;0;0
FR;9;2021-07-12;0;0;0;0;0;0;0;0;0;0;0;0;0;0;0;0;0;0
FR;9;2021-07-13;0;0;0;0;0;0;0;0;0;0;0;0;0;0;0;0;0;0
FR;9;2021-07-14;0;0;0;0;0;0;0;0;0;0;0;0;0;0;0;0;0;0
FR;9;2021-07-15;0;0;0;0;0;0;0;0;0;0;0;0;0;0;0;0;0;0
FR;9;2021-07-16;0;0;0;0;0;0;0;0;0;0;0;0;0;0;0;0;0;0
FR;9;2021-07-17;0;0;0;0;0;0;0;0;0;0;0;0;0;0;0;0;0;0
FR;9;2021-07-18;0;0;0;0;0;0;0;0;0;0;0;0;0;0;0;0;0;0
FR;9;2021-07-19;0;0;0;0;0;0;0;0;0;0;0;0;0;0;0;0;0;0
FR;9;2021-07-20;0;0;0;0;0;0;0;0;0;0;0;0;0;0;0;0;0;0
FR;9;2021-07-21;0;0;0;0;0;0;0;0;0;0;0;0;0;0;0;0;0;0
FR;9;2021-07-22;0;0;0;0;0;0;0;0;0;0;0;0;0;0;0;0;0;0
FR;9;2021-07-23;0;0;0;0;0;0;0;0;0;0;0;0;0;0;0;0;0;0
FR;9;2021-07-24;0;0;0;0;0;0;0;0;0;0;0;0;0;0;0;0;0;0
FR;9;2021-07-25;0;0;0;0;0;0;0;0;0;0;0;0;0;0;0;0;0;0
FR;9;2021-07-26;0;0;0;0;0;0;0;0;0;0;0;0;0;0;0;0;0;0
FR;9;2021-07-27;0;0;0;0;0;0;0;0;0;0;0;0;0;0;0;0;0;0
FR;9;2021-07-28;0;0;0;0;0;0;0;0;0;0;0;0;0;0;0;0;0;0
FR;9;2021-07-29;0;0;0;0;0;0;0;0;0;0;0;0;0;0;0;0;0;0
FR;9;2021-07-30;0;0;0;0;0;0;0;0;0;0;0;0;0;0;0;0;0;0
FR;9;2021-07-31;0;0;0;0;0;0;0;0;0;0;0;0;0;0;0;0;0;0
FR;9;2021-08-01;0;0;0;0;0;0;0;0;0;0;0;0;0;0;0;0;0;0
FR;9;2021-08-02;0;0;0;0;0;0;0;0;0;0;0;0;0;0;0;0;0;0
FR;9;2021-08-03;0;0;0;0;0;0;0;0;0;0;0;0;0;0;0;0;0;0
FR;9;2021-08-04;0;0;0;0;0;0;0;0;0;0;0;0;0;0;0;0;0;0
FR;9;2021-08-05;0;0;0;0;0;0;0;0;0;0;0;0;0;0;0;0;0;0
FR;9;2021-08-06;0;0;0;0;0;0;0;0;0;0;0;0;0;0;0;0;0;0
FR;9;2021-08-07;0;0;0;0;0;0;0;0;0;0;0;0;0;0;0;0;0;0
FR;9;2021-08-08;0;0;0;0;0;0;0;0;0;0;0;0;0;0;0;0;0;0
FR;9;2021-08-09;0;0;0;0;0;0;0;0;0;0;0;0;0;0;0;0;0;0
FR;9;2021-08-10;0;0;0;0;0;0;0;0;0;0;0;0;0;0;0;0;0;0
FR;9;2021-08-11;0;0;0;0;0;0;0;0;0;0;0;0;0;0;0;0;0;0
FR;9;2021-08-12;0;0;0;0;0;0;0;0;0;0;0;0;0;0;0;0;0;0
FR;9;2021-08-13;0;0;0;0;0;0;0;0;0;0;0;0;0;0;0;0;0;0
FR;9;2021-08-14;0;0;0;0;0;0;0;0;0;0;0;0;0;0;0;0;0;0
FR;9;2021-08-15;0;0;0;0;0;0;0;0;0;0;0;0;0;0;0;0;0;0
FR;9;2021-08-16;0;0;0;0;0;0;0;0;0;0;0;0;0;0;0;0;0;0
FR;9;2021-08-17;0;0;0;0;0;0;0;0;0;0;0;0;0;0;0;0;0;0
FR;9;2021-08-18;0;0;0;0;0;0;0;0;0;0;0;0;0;0;0;0;0;0
FR;9;2021-08-19;0;0;0;0;0;0;0;0;0;0;0;0;0;0;0;0;0;0
FR;9;2021-08-20;0;0;0;0;0;0;0;0;0;0;0;0;0;0;0;0;0;0
FR;9;2021-08-21;0;0;0;0;0;0;0;0;0;0;0;0;0;0;0;0;0;0
FR;9;2021-08-22;0;0;0;0;0;0;0;0;0;0;0;0;0;0;0;0;0;0
FR;9;2021-08-23;0;0;0;0;0;0;0;0;0;0;0;0;0;0;0;0;0;0
FR;9;2021-08-24;0;0;0;0;0;0;0;0;0;0;0;0;0;0;0;0;0;0
FR;9;2021-08-25;0;0;0;0;0;0;0;0;0;0;0;0;0;0;0;0;0;0
FR;9;2021-08-26;0;0;0;0;0;0;0;0;0;0;0;0;0;0;0;0;0;0
FR;9;2021-08-27;0;0;0;0;0;0;0;0;0;0;0;0;0;0;0;0;0;0
FR;9;2021-08-28;0;0;0;0;0;0;0;0;0;0;0;0;0;0;0;0;0;0
FR;9;2021-08-29;0;0;0;0;0;0;0;0;0;0;0;0;0;0;0;0;0;0
FR;9;2021-08-30;0;0;0;0;0;0;0;0;0;0;0;0;0;0;0;0;0;0
FR;9;2021-08-31;0;0;0;0;0;0;0;0;0;0;0;0;0;0;0;0;0;0
FR;9;2021-09-01;0;0;0;0;0;0;0;0;0;0;0;0;0;0;0;0;0;0
FR;9;2021-09-02;0;0;0;0;0;0;0;0;0;0;0;0;0;0;0;0;0;0
FR;9;2021-09-03;0;0;0;0;0;0;0;0;0;0;0;0;0;0;0;0;0;0
FR;9;2021-09-04;0;0;0;0;0;0;0;0;0;0;0;0;0;0;0;0;0;0
FR;9;2021-09-05;0;0;0;0;0;0;0;0;0;0;0;0;0;0;0;0;0;0
FR;9;2021-09-06;0;0;0;0;0;0;0;0;0;0;0;0;0;0;0;0;0;0
FR;9;2021-09-07;0;0;0;0;0;0;0;0;0;0;0;0;0;0;0;0;0;0
FR;9;2021-09-08;0;0;0;0;0;0;0;0;0;0;0;0;0;0;0;0;0;0
FR;9;2021-09-09;0;0;0;0;0;0;0;0;0;0;0;0;0;0;0;0;0;0
FR;9;2021-09-10;0;0;0;0;0;0;0;0;0;0;0;0;0;0;0;0;0;0
FR;9;2021-09-11;0;0;0;0;0;0;0;0;0;0;0;0;0;0;0;0;0;0
FR;9;2021-09-12;0;0;0;0;0;0;0;0;0;0;0;0;0;0;0;0;0;0
FR;9;2021-09-13;0;0;0;0;0;0;0;0;0;0;0;0;0;0;0;0;0;0
FR;9;2021-09-14;0;0;0;0;0;0;0;0;0;0;0;0;0;0;0;0;0;0
FR;9;2021-09-15;0;0;0;0;0;0;0;0;0;0;0;0;0;0;0;0;0;0
FR;9;2021-09-16;0;0;0;0;0;0;0;0;0;0;0;0;0;0;0;0;0;0
FR;9;2021-09-17;0;0;0;0;0;0;0;0;0;0;0;0;0;0;0;0;0;0
FR;9;2021-09-18;0;0;0;0;0;0;0;0;0;0;0;0;0;0;0;0;0;0
FR;9;2021-09-19;0;0;0;0;0;0;0;0;0;0;0;0;0;0;0;0;0;0
FR;9;2021-09-20;0;0;0;0;0;0;0;0;0;0;0;0;0;0;0;0;0;0
FR;9;2021-09-21;0;0;0;0;0;0;0;0;0;0;0;0;0;0;0;0;0;0
FR;9;2021-09-22;0;0;0;0;0;0;0;0;0;0;0;0;0;0;0;0;0;0
FR;9;2021-09-23;0;0;0;0;0;0;0;0;0;0;0;0;0;0;0;0;0;0
FR;9;2021-09-24;0;0;0;0;0;0;0;0;0;0;0;0;0;0;0;0;0;0
FR;9;2021-09-25;0;0;0;0;0;0;0;0;0;0;0;0;0;0;0;0;0;0
FR;9;2021-09-26;0;0;0;0;0;0;0;0;0;0;0;0;0;0;0;0;0;0
FR;9;2021-09-27;0;0;0;0;0;0;0;0;0;0;0;0;0;0;0;0;0;0
FR;9;2021-09-28;0;0;0;0;0;0;0;0;0;0;0;0;0;0;0;0;0;0
FR;9;2021-09-29;0;0;0;0;0;0;0;0;0;0;0;0;0;0;0;0;0;0
FR;9;2021-09-30;0;0;0;0;0;0;0;0;0;0;0;0;0;0;0;0;0;0
FR;9;2021-10-01;0;0;0;0;0;0;0;0;0;0;0;0;0;0;0;0;0;0
FR;9;2021-10-02;0;0;0;0;0;0;0;0;0;0;0;0;0;0;0;0;0;0
FR;9;2021-10-03;0;0;0;0;0;0;0;0;0;0;0;0;0;0;0;0;0;0
FR;9;2021-10-04;0;0;0;0;0;0;0;0;0;0;0;0;0;0;0;0;0;0
FR;9;2021-10-05;0;0;0;0;0;0;0;0;0;0;0;0;0;0;0;0;0;0
FR;9;2021-10-06;0;0;0;0;0;0;0;0;0;0;0;0;0;0;0;0;0;0
FR;9;2021-10-07;0;0;0;0;0;0;0;0;0;0;0;0;0;0;0;0;0;0
FR;9;2021-10-08;0;0;0;0;0;0;0;0;0;0;0;0;0;0;0;0;0;0
FR;9;2021-10-09;0;0;0;0;0;0;0;0;0;0;0;0;0;0;0;0;0;0
FR;9;2021-10-10;0;0;0;0;0;0;0;0;0;0;0;0;0;0;0;0;0;0
FR;9;2021-10-11;0;0;0;0;0;0;0;0;0;0;0;0;0;0;0;0;0;0
FR;9;2021-10-12;0;0;0;0;0;0;0;0;0;0;0;0;0;0;0;0;0;0
FR;9;2021-10-13;0;0;0;0;0;0;0;0;0;0;0;0;0;0;0;0;0;0
FR;9;2021-10-14;0;0;0;0;0;0;0;0;0;0;0;0;0;0;0;0;0;0
FR;9;2021-10-15;0;0;0;0;0;0;0;0;0;0;0;0;0;0;0;0;0;0
FR;9;2021-10-16;0;0;0;0;0;0;0;0;0;0;0;0;0;0;0;0;0;0
FR;9;2021-10-17;0;0;0;0;0;0;0;0;0;0;0;0;0;0;0;0;0;0
FR;9;2021-10-18;0;0;0;0;0;0;0;0;0;0;0;0;0;0;0;0;0;0
FR;9;2021-10-19;0;0;0;0;0;0;0;0;0;0;0;0;0;0;0;0;0;0
FR;9;2021-10-20;0;0;0;0;0;0;0;0;0;0;0;0;0;0;0;0;0;0
FR;9;2021-10-21;0;0;0;0;0;0;0;0;0;0;0;0;0;0;0;0;0;0
FR;9;2021-10-22;0;0;0;0;0;0;0;0;0;0;0;0;0;0;0;0;0;0
FR;9;2021-10-23;0;0;0;0;0;0;0;0;0;0;0;0;0;0;0;0;0;0
FR;9;2021-10-24;0;0;0;0;0;0;0;0;0;0;0;0;0;0;0;0;0;0
FR;9;2021-10-25;0;0;0;0;0;0;0;0;0;0;0;0;0;0;0;0;0;0
FR;9;2021-10-26;0;0;0;0;0;0;0;0;0;0;0;0;0;0;0;0;0;0
FR;9;2021-10-27;0;0;0;0;0;0;0;0;0;0;0;0;0;0;0;0;0;0
FR;9;2021-10-28;0;0;0;0;0;0;0;0;0;0;0;0;0;0;0;0;0;0
FR;9;2021-10-29;0;0;0;0;0;0;0;0;0;0;0;0;0;0;0;0;0;0
FR;9;2021-10-30;0;0;0;0;0;0;0;0;0;0;0;0;0;0;0;0;0;0
FR;9;2021-10-31;0;0;0;0;0;0;0;0;0;0;0;0;0;0;0;0;0;0
FR;9;2021-11-01;0;0;0;0;0;0;0;0;0;0;0;0;0;0;0;0;0;0
FR;9;2021-11-02;0;0;0;0;0;0;0;0;0;0;0;0;0;0;0;0;0;0
FR;9;2021-11-03;0;0;0;0;0;0;0;0;0;0;0;0;0;0;0;0;0;0
FR;9;2021-11-04;0;0;0;0;0;0;0;0;0;0;0;0;0;0;0;0;0;0
FR;9;2021-11-05;0;0;0;0;0;0;0;0;0;0;0;0;0;0;0;0;0;0
FR;9;2021-11-06;0;0;0;0;0;0;0;0;0;0;0;0;0;0;0;0;0;0
FR;9;2021-11-07;0;0;0;0;0;0;0;0;0;0;0;0;0;0;0;0;0;0
FR;9;2021-11-08;0;0;0;0;0;0;0;0;0;0;0;0;0;0;0;0;0;0
FR;9;2021-11-09;0;0;0;0;0;0;0;0;0;0;0;0;0;0;0;0;0;0
FR;9;2021-11-10;0;0;0;0;0;0;0;0;0;0;0;0;0;0;0;0;0;0
FR;9;2021-11-11;0;0;0;0;0;0;0;0;0;0;0;0;0;0;0;0;0;0
FR;9;2021-11-12;0;0;0;0;0;0;0;0;0;0;0;0;0;0;0;0;0;0
FR;9;2021-11-13;0;0;0;0;0;0;0;0;0;0;0;0;0;0;0;0;0;0
FR;9;2021-11-14;0;0;0;0;0;0;0;0;0;0;0;0;0;0;0;0;0;0
FR;9;2021-11-15;0;0;0;0;0;0;0;0;0;0;0;0;0;0;0;0;0;0
FR;9;2021-11-16;0;0;0;0;0;0;0;0;0;0;0;0;0;0;0;0;0;0
FR;9;2021-11-17;0;0;0;0;0;0;0;0;0;0;0;0;0;0;0;0;0;0
FR;9;2021-11-18;0;0;0;0;0;0;0;0;0;0;0;0;0;0;0;0;0;0
FR;9;2021-11-19;0;0;0;0;0;0;0;0;0;0;0;0;0;0;0;0;0;0
FR;9;2021-11-20;0;0;0;0;0;0;0;0;0;0;0;0;0;0;0;0;0;0
FR;9;2021-11-21;0;0;0;0;0;0;0;0;0;0;0;0;0;0;0;0;0;0
FR;9;2021-11-22;0;0;0;0;0;0;0;0;0;0;0;0;0;0;0;0;0;0
FR;9;2021-11-23;0;0;0;0;0;0;0;0;0;0;0;0;0;0;0;0;0;0
FR;9;2021-11-24;0;0;0;0;0;0;0;0;0;0;0;0;0;0;0;0;0;0
FR;9;2021-11-25;0;0;0;0;0;0;0;0;0;0;0;0;0;0;0;0;0;0
FR;9;2021-11-26;0;0;0;0;0;0;0;0;0;0;0;0;0;0;0;0;0;0
FR;9;2021-11-27;0;0;0;0;0;0;0;0;0;0;0;0;0;0;0;0;0;0
FR;9;2021-11-28;0;0;0;0;0;0;0;0;0;0;0;0;0;0;0;0;0;0
FR;9;2021-11-29;0;0;0;0;0;0;0;0;0;0;0;0;0;0;0;0;0;0
FR;9;2021-11-30;0;0;0;0;0;0;0;0;0;0;0;0;0;0;0;0;0;0
FR;9;2021-12-01;0;0;0;0;0;0;0;0;0;0;0;0;0;0;0;0;0;0
FR;9;2021-12-02;0;0;0;0;0;0;0;0;0;0;0;0;0;0;0;0;0;0
FR;9;2021-12-03;0;0;0;0;0;0;0;0;0;0;0;0;0;0;0;0;0;0
FR;9;2021-12-04;0;0;0;0;0;0;0;0;0;0;0;0;0;0;0;0;0;0
FR;9;2021-12-05;0;0;0;0;0;0;0;0;0;0;0;0;0;0;0;0;0;0
FR;9;2021-12-06;0;0;0;0;0;0;0;0;0;0;0;0;0;0;0;0;0;0
FR;9;2021-12-07;0;0;0;0;0;0;0;0;0;0;0;0;0;0;0;0;0;0
FR;9;2021-12-08;0;0;0;0;0;0;0;0;0;0;0;0;0;0;0;0;0;0
FR;9;2021-12-09;0;0;0;0;0;0;0;0;0;0;0;0;0;0;0;0;0;0
FR;9;2021-12-10;0;0;0;0;0;0;0;0;0;0;0;0;0;0;0;0;0;0
FR;9;2021-12-11;0;0;0;0;0;0;0;0;0;0;0;0;0;0;0;0;0;0
FR;9;2021-12-12;0;0;0;0;0;0;0;0;0;0;0;0;0;0;0;0;0;0
FR;9;2021-12-13;0;0;0;0;0;0;0;0;0;0;0;0;0;0;0;0;0;0
FR;9;2021-12-14;0;0;0;0;0;0;0;0;0;0;0;0;0;0;0;0;0;0
FR;9;2021-12-15;0;0;0;0;0;0;0;0;0;0;0;0;0;0;0;0;0;0
FR;9;2021-12-16;0;0;0;0;0;0;0;0;0;0;0;0;0;0;0;0;0;0
FR;9;2021-12-17;0;0;0;0;0;0;0;0;0;0;0;0;0;0;0;0;0;0
FR;9;2021-12-18;0;0;0;0;0;0;0;0;0;0;0;0;0;0;0;0;0;0
FR;9;2021-12-19;0;0;0;0;0;0;0;0;0;0;0;0;0;0;0;0;0;0
FR;9;2021-12-20;0;0;0;0;0;0;0;0;0;0;0;0;0;0;0;0;0;0
FR;9;2021-12-21;0;0;0;0;0;0;0;0;0;0;0;0;0;0;0;0;0;0
FR;9;2021-12-22;0;0;0;0;0;0;0;0;0;0;0;0;0;0;0;0;0;0
FR;9;2021-12-23;0;0;0;0;0;0;0;0;0;0;0;0;0;0;0;0;0;0
FR;9;2021-12-24;0;0;0;0;0;0;0;0;0;0;0;0;0;0;0;0;0;0
FR;9;2021-12-25;0;0;0;0;0;0;0;0;0;0;0;0;0;0;0;0;0;0
FR;9;2021-12-26;0;0;0;0;0;0;0;0;0;0;0;0;0;0;0;0;0;0
FR;9;2021-12-27;0;0;0;0;0;0;0;0;0;0;0;0;0;0;0;0;0;0
FR;9;2021-12-28;0;0;0;0;0;0;0;0;0;0;0;0;0;0;0;0;0;0
FR;9;2021-12-29;0;0;0;0;0;0;0;0;0;0;0;0;0;0;0;0;0;0
FR;9;2021-12-30;0;0;0;0;0;0;0;0;0;0;0;0;0;0;0;0;0;0
FR;9;2021-12-31;0;0;0;0;0;0;0;0;0;0;0;0;0;0;0;0;0;0
FR;9;2022-01-01;0;0;0;0;0;0;0;0;0;0;0;0;0;0;0;0;0;0
FR;9;2022-01-02;0;0;0;0;0;0;0;0;0;0;0;0;0;0;0;0;0;0
FR;9;2022-01-03;0;0;0;0;0;0;0;0;0;0;0;0;0;0;0;0;0;0
FR;9;2022-01-04;0;0;0;0;0;0;0;0;0;0;0;0;0;0;0;0;0;0
FR;9;2022-01-05;0;0;0;0;0;0;0;0;0;0;0;0;0;0;0;0;0;0
FR;9;2022-01-06;0;0;0;0;0;0;0;0;0;0;0;0;0;0;0;0;0;0
FR;9;2022-01-07;0;0;0;0;0;0;0;0;0;0;0;0;0;0;0;0;0;0
FR;9;2022-01-08;0;0;0;0;0;0;0;0;0;0;0;0;0;0;0;0;0;0
FR;9;2022-01-09;0;0;0;0;0;0;0;0;0;0;0;0;0;0;0;0;0;0
FR;9;2022-01-10;0;0;0;0;0;0;0;0;0;0;0;0;0;0;0;0;0;0
FR;9;2022-01-11;0;0;0;0;0;0;0;0;0;0;0;0;0;0;0;0;0;0
FR;9;2022-01-12;0;0;0;0;0;0;0;0;0;0;0;0;0;0;0;0;0;0
FR;9;2022-01-13;0;0;0;0;0;0;0;0;0;0;0;0;0;0;0;0;0;0
FR;9;2022-01-14;0;0;0;0;0;0;0;0;0;0;0;0;0;0;0;0;0;0
FR;9;2022-01-15;0;0;0;0;0;0;0;0;0;0;0;0;0;0;0;0;0;0
FR;9;2022-01-16;0;0;0;0;0;0;0;0;0;0;0;0;0;0;0;0;0;0
FR;9;2022-01-17;0;0;0;0;0;0;0;0;0;0;0;0;0;0;0;0;0;0
FR;9;2022-01-18;0;0;0;0;0;0;0;0;0;0;0;0;0;0;0;0;0;0
FR;9;2022-01-19;0;0;0;0;0;0;0;0;0;0;0;0;0;0;0;0;0;0
FR;9;2022-01-20;0;0;0;0;0;0;0;0;0;0;0;0;0;0;0;0;0;0
FR;9;2022-01-21;0;0;0;0;0;0;0;0;0;0;0;0;0;0;0;0;0;0
FR;9;2022-01-22;0;0;0;0;0;0;0;0;0;0;0;0;0;0;0;0;0;0
FR;9;2022-01-23;0;0;0;0;0;0;0;0;0;0;0;0;0;0;0;0;0;0
FR;9;2022-01-24;0;0;0;0;0;0;0;0;0;0;0;0;0;0;0;0;0;0
FR;9;2022-01-25;0;0;0;0;0;0;0;0;0;0;0;0;0;0;0;0;0;0
FR;9;2022-01-26;0;0;0;0;0;0;0;0;0;0;0;0;0;0;0;0;0;0
FR;9;2022-01-27;0;0;0;0;0;0;0;0;0;0;0;0;0;0;0;0;0;0
FR;9;2022-01-28;0;0;0;0;0;0;0;0;0;0;0;0;0;0;0;0;0;0
FR;9;2022-01-29;0;0;0;0;0;0;0;0;0;0;0;0;0;0;0;0;0;0
FR;9;2022-01-30;0;0;0;0;0;0;0;0;0;0;0;0;0;0;0;0;0;0
FR;9;2022-01-31;0;0;0;0;0;0;0;0;0;0;0;0;0;0;0;0;0;0
FR;9;2022-02-01;0;0;0;0;0;0;0;0;0;0;0;0;0;0;0;0;0;0
FR;9;2022-02-02;0;0;0;0;0;0;0;0;0;0;0;0;0;0;0;0;0;0
FR;9;2022-02-03;0;0;0;0;0;0;0;0;0;0;0;0;0;0;0;0;0;0
FR;9;2022-02-04;0;0;0;0;0;0;0;0;0;0;0;0;0;0;0;0;0;0
FR;9;2022-02-05;0;0;0;0;0;0;0;0;0;0;0;0;0;0;0;0;0;0
FR;9;2022-02-06;0;0;0;0;0;0;0;0;0;0;0;0;0;0;0;0;0;0
FR;9;2022-02-07;0;0;0;0;0;0;0;0;0;0;0;0;0;0;0;0;0;0
FR;9;2022-02-08;0;0;0;0;0;0;0;0;0;0;0;0;0;0;0;0;0;0
FR;9;2022-02-09;0;0;0;0;0;0;0;0;0;0;0;0;0;0;0;0;0;0
FR;9;2022-02-10;0;0;0;0;0;0;0;0;0;0;0;0;0;0;0;0;0;0
FR;9;2022-02-11;0;0;0;0;0;0;0;0;0;0;0;0;0;0;0;0;0;0
FR;9;2022-02-12;0;0;0;0;0;0;0;0;0;0;0;0;0;0;0;0;0;0
FR;9;2022-02-13;0;0;0;0;0;0;0;0;0;0;0;0;0;0;0;0;0;0
FR;9;2022-02-14;0;0;0;0;0;0;0;0;0;0;0;0;0;0;0;0;0;0
FR;9;2022-02-15;0;0;0;0;0;0;0;0;0;0;0;0;0;0;0;0;0;0
FR;9;2022-02-16;0;0;0;0;0;0;0;0;0;0;0;0;0;0;0;0;0;0
FR;9;2022-02-17;0;0;0;0;0;0;0;0;0;0;0;0;0;0;0;0;0;0
FR;9;2022-02-18;0;0;0;0;0;0;0;0;0;0;0;0;0;0;0;0;0;0
FR;9;2022-02-19;0;0;0;0;0;0;0;0;0;0;0;0;0;0;0;0;0;0
FR;9;2022-02-20;0;0;0;0;0;0;0;0;0;0;0;0;0;0;0;0;0;0
FR;9;2022-02-21;0;0;0;0;0;0;0;0;0;0;0;0;0;0;0;0;0;0
FR;9;2022-02-22;0;0;0;0;0;0;0;0;0;0;0;0;0;0;0;0;0;0
FR;9;2022-02-23;0;0;0;0;0;0;0;0;0;0;0;0;0;0;0;0;0;0
FR;9;2022-02-24;0;0;0;0;0;0;0;0;0;0;0;0;0;0;0;0;0;0
FR;9;2022-02-25;0;0;0;0;0;0;0;0;0;0;0;0;0;0;0;0;0;0
FR;9;2022-02-26;0;0;0;0;0;0;0;0;0;0;0;0;0;0;0;0;0;0
FR;9;2022-02-27;0;0;0;0;0;0;0;0;0;0;0;0;0;0;0;0;0;0
FR;9;2022-02-28;0;0;0;0;0;0;0;0;0;0;0;0;0;0;0;0;0;0
FR;9;2022-03-01;0;0;0;0;0;0;0;0;0;0;0;0;0;0;0;0;0;0
FR;9;2022-03-02;0;0;0;0;0;0;0;0;0;0;0;0;0;0;0;0;0;0
FR;9;2022-03-03;0;0;0;0;0;0;0;0;0;0;0;0;0;0;0;0;0;0
FR;9;2022-03-04;0;0;0;0;0;0;0;0;0;0;0;0;0;0;0;0;0;0
FR;9;2022-03-05;0;0;0;0;0;0;0;0;0;0;0;0;0;0;0;0;0;0
FR;9;2022-03-06;0;0;0;0;0;0;0;0;0;0;0;0;0;0;0;0;0;0
FR;9;2022-03-07;0;0;0;0;0;0;0;0;0;0;0;0;0;0;0;0;0;0
FR;9;2022-03-08;0;0;0;0;0;0;0;0;0;0;0;0;0;0;0;0;0;0
FR;9;2022-03-09;0;0;0;0;0;0;0;0;0;0;0;0;0;0;0;0;0;0
FR;9;2022-03-10;0;0;0;0;0;0;0;0;0;0;0;0;0;0;0;0;0;0
FR;9;2022-03-11;0;0;0;0;0;0;0;0;0;0;0;0;0;0;0;0;0;0
FR;9;2022-03-12;0;0;0;0;0;0;0;0;0;0;0;0;0;0;0;0;0;0
FR;9;2022-03-13;0;0;0;0;0;0;0;0;0;0;0;0;0;0;0;0;0;0
FR;9;2022-03-14;0;0;0;0;0;0;0;0;0;0;0;0;0;0;0;0;0;0
FR;9;2022-03-15;0;0;0;0;0;0;0;0;0;0;0;0;0;0;0;0;0;0
FR;9;2022-03-16;0;0;0;0;0;0;0;0;0;0;0;0;0;0;0;0;0;0
FR;9;2022-03-17;0;0;0;0;0;0;0;0;0;0;0;0;0;0;0;0;0;0
FR;9;2022-03-18;0;0;0;0;0;0;0;0;0;0;0;0;0;0;0;0;0;0
FR;9;2022-03-19;0;0;0;0;0;0;0;0;0;0;0;0;0;0;0;0;0;0
FR;9;2022-03-20;0;0;0;0;0;0;0;0;0;0;0;0;0;0;0;0;0;0
FR;9;2022-03-21;0;0;0;0;0;0;0;0;0;0;0;0;0;0;0;0;0;0
FR;9;2022-03-22;0;0;0;0;0;0;0;0;0;0;0;0;0;0;0;0;0;0
FR;9;2022-03-23;0;0;0;0;0;0;0;0;0;0;0;0;0;0;0;0;0;0
FR;9;2022-03-24;0;0;0;0;0;0;0;0;0;0;0;0;0;0;0;0;0;0
FR;9;2022-03-25;0;0;0;0;0;0;0;0;0;0;0;0;0;0;0;0;0;0
FR;9;2022-03-26;0;0;0;0;0;0;0;0;0;0;0;0;0;0;0;0;0;0
FR;9;2022-03-27;0;0;0;0;0;0;0;0;0;0;0;0;0;0;0;0;0;0
FR;9;2022-03-28;0;0;0;0;0;0;0;0;0;0;0;0;0;0;0;0;0;0
FR;9;2022-03-29;0;0;0;0;0;0;0;0;0;0;0;0;0;0;0;0;0;0
FR;9;2022-03-30;0;0;0;0;0;0;0;0;0;0;0;0;0;0;0;0;0;0
FR;9;2022-03-31;0;0;0;0;0;0;0;0;0;0;0;0;0;0;0;0;0;0
FR;9;2022-04-01;0;0;0;0;0;0;0;0;0;0;0;0;0;0;0;0;0;0
FR;9;2022-04-02;0;0;0;0;0;0;0;0;0;0;0;0;0;0;0;0;0;0
FR;9;2022-04-03;0;0;0;0;0;0;0;0;0;0;0;0;0;0;0;0;0;0
FR;9;2022-04-04;0;0;0;0;0;0;0;0;0;0;0;0;0;0;0;0;0;0
FR;9;2022-04-05;0;0;0;0;0;0;0;0;0;0;0;0;0;0;0;0;0;0
FR;9;2022-04-06;0;0;0;0;0;0;0;0;0;0;0;0;0;0;0;0;0;0
FR;9;2022-04-07;0;0;0;0;0;0;0;0;0;0;0;0;0;0;0;0;0;0
FR;9;2022-04-08;0;0;0;0;0;0;0;0;0;0;0;0;0;0;0;0;0;0
FR;9;2022-04-09;0;0;0;0;0;0;0;0;0;0;0;0;0;0;0;0;0;0
FR;9;2022-04-10;0;0;0;0;0;0;0;0;0;0;0;0;0;0;0;0;0;0
FR;9;2022-04-11;0;0;0;0;0;0;0;0;0;0;0;0;0;0;0;0;0;0
FR;9;2022-04-12;0;0;0;0;0;0;0;0;0;0;0;0;0;0;0;0;0;0
FR;9;2022-04-13;0;0;0;0;0;0;0;0;0;0;0;0;0;0;0;0;0;0
FR;9;2022-04-14;0;0;0;0;0;0;0;0;0;0;0;0;0;0;0;0;0;0
FR;9;2022-04-15;0;0;0;0;0;0;0;0;0;0;0;0;0;0;0;0;0;0
FR;9;2022-04-16;0;0;0;0;0;0;0;0;0;0;0;0;0;0;0;0;0;0
FR;9;2022-04-17;0;0;0;0;0;0;0;0;0;0;0;0;0;0;0;0;0;0
FR;9;2022-04-18;0;0;0;0;0;0;0;0;0;0;0;0;0;0;0;0;0;0
FR;9;2022-04-19;0;0;0;0;0;0;0;0;0;0;0;0;0;0;0;0;0;0
FR;9;2022-04-20;0;0;0;0;0;0;0;0;0;0;0;0;0;0;0;0;0;0
FR;9;2022-04-21;0;0;0;0;0;0;0;0;0;0;0;0;0;0;0;0;0;0
FR;9;2022-04-22;0;0;0;0;0;0;0;0;0;0;0;0;0;0;0;0;0;0
FR;9;2022-04-23;0;0;0;0;0;0;0;0;0;0;0;0;0;0;0;0;0;0
FR;9;2022-04-24;0;0;0;0;0;0;0;0;0;0;0;0;0;0;0;0;0;0
FR;9;2022-04-25;0;0;0;0;0;0;0;0;0;0;0;0;0;0;0;0;0;0
FR;9;2022-04-26;0;0;0;0;0;0;0;0;0;0;0;0;0;0;0;0;0;0
FR;9;2022-04-27;0;0;0;0;0;0;0;0;0;0;0;0;0;0;0;0;0;0
FR;9;2022-04-28;0;0;0;0;0;0;0;0;0;0;0;0;0;0;0;0;0;0
FR;9;2022-04-29;0;0;0;0;0;0;0;0;0;0;0;0;0;0;0;0;0;0
FR;9;2022-04-30;0;0;0;0;0;0;0;0;0;0;0;0;0;0;0;0;0;0
FR;9;2022-05-01;0;0;0;0;0;0;0;0;0;0;0;0;0;0;0;0;0;0
FR;9;2022-05-02;0;0;0;0;0;0;0;0;0;0;0;0;0;0;0;0;0;0
FR;9;2022-05-03;0;0;0;0;0;0;0;0;0;0;0;0;0;0;0;0;0;0
FR;9;2022-05-04;0;0;0;0;0;0;0;0;0;0;0;0;0;0;0;0;0;0
FR;9;2022-05-05;0;0;0;0;0;0;0;0;0;0;0;0;0;0;0;0;0;0
FR;9;2022-05-06;0;0;0;0;0;0;0;0;0;0;0;0;0;0;0;0;0;0
FR;9;2022-05-07;0;0;0;0;0;0;0;0;0;0;0;0;0;0;0;0;0;0
FR;9;2022-05-08;0;0;0;0;0;0;0;0;0;0;0;0;0;0;0;0;0;0
FR;9;2022-05-09;0;0;0;0;0;0;0;0;0;0;0;0;0;0;0;0;0;0
FR;9;2022-05-10;0;0;0;0;0;0;0;0;0;0;0;0;0;0;0;0;0;0
FR;9;2022-05-11;0;0;0;0;0;0;0;0;0;0;0;0;0;0;0;0;0;0
FR;9;2022-05-12;0;0;0;0;0;0;0;0;0;0;0;0;0;0;0;0;0;0
FR;9;2022-05-13;0;0;0;0;0;0;0;0;0;0;0;0;0;0;0;0;0;0
FR;9;2022-05-14;0;0;0;0;0;0;0;0;0;0;0;0;0;0;0;0;0;0
FR;9;2022-05-15;0;0;0;0;0;0;0;0;0;0;0;0;0;0;0;0;0;0
FR;9;2022-05-16;0;0;0;0;0;0;0;0;0;0;0;0;0;0;0;0;0;0
FR;9;2022-05-17;0;0;0;0;0;0;0;0;0;0;0;0;0;0;0;0;0;0
FR;9;2022-05-18;0;0;0;0;0;0;0;0;0;0;0;0;0;0;0;0;0;0
FR;9;2022-05-19;0;0;0;0;0;0;0;0;0;0;0;0;0;0;0;0;0;0
FR;9;2022-05-20;0;0;0;0;0;0;0;0;0;0;0;0;0;0;0;0;0;0
FR;9;2022-05-21;0;0;0;0;0;0;0;0;0;0;0;0;0;0;0;0;0;0
FR;9;2022-05-22;0;0;0;0;0;0;0;0;0;0;0;0;0;0;0;0;0;0
FR;9;2022-05-23;0;0;0;0;0;0;0;0;0;0;0;0;0;0;0;0;0;0
FR;9;2022-05-24;0;0;0;0;0;0;0;0;0;0;0;0;0;0;0;0;0;0
FR;9;2022-05-25;0;0;0;0;0;0;0;0;0;0;0;0;0;0;0;0;0;0
FR;9;2022-05-26;0;0;0;0;0;0;0;0;0;0;0;0;0;0;0;0;0;0
FR;9;2022-05-27;0;0;0;0;0;0;0;0;0;0;0;0;0;0;0;0;0;0
FR;9;2022-05-28;0;0;0;0;0;0;0;0;0;0;0;0;0;0;0;0;0;0
FR;9;2022-05-29;0;0;0;0;0;0;0;0;0;0;0;0;0;0;0;0;0;0
FR;9;2022-05-30;0;0;0;0;0;0;0;0;0;0;0;0;0;0;0;0;0;0
FR;9;2022-05-31;0;0;0;0;0;0;0;0;0;0;0;0;0;0;0;0;0;0
FR;9;2022-06-01;0;0;0;0;0;0;0;0;0;0;0;0;0;0;0;0;0;0
FR;9;2022-06-02;0;0;0;0;0;0;0;0;0;0;0;0;0;0;0;0;0;0
FR;9;2022-06-03;0;0;0;0;0;0;0;0;0;0;0;0;0;0;0;0;0;0
FR;9;2022-06-04;0;0;0;0;0;0;0;0;0;0;0;0;0;0;0;0;0;0
FR;9;2022-06-05;0;0;0;0;0;0;0;0;0;0;0;0;0;0;0;0;0;0
FR;9;2022-06-06;0;0;0;0;0;0;0;0;0;0;0;0;0;0;0;0;0;0
FR;9;2022-06-07;0;0;0;0;0;0;0;0;0;0;0;0;0;0;0;0;0;0
FR;9;2022-06-08;0;0;0;0;0;0;0;0;0;0;0;0;0;0;0;0;0;0
FR;9;2022-06-09;0;0;0;0;0;0;0;0;0;0;0;0;0;0;0;0;0;0
FR;9;2022-06-10;0;0;0;0;0;0;0;0;0;0;0;0;0;0;0;0;0;0
FR;9;2022-06-11;0;0;0;0;0;0;0;0;0;0;0;0;0;0;0;0;0;0
FR;9;2022-06-12;0;0;0;0;0;0;0;0;0;0;0;0;0;0;0;0;0;0
FR;9;2022-06-13;0;0;0;0;0;0;0;0;0;0;0;0;0;0;0;0;0;0
FR;9;2022-06-14;0;0;0;0;0;0;0;0;0;0;0;0;0;0;0;0;0;0
FR;9;2022-06-15;0;0;0;0;0;0;0;0;0;0;0;0;0;0;0;0;0;0
FR;9;2022-06-16;0;0;0;0;0;0;0;0;0;0;0;0;0;0;0;0;0;0
FR;9;2022-06-17;0;0;0;0;0;0;0;0;0;0;0;0;0;0;0;0;0;0
FR;9;2022-06-18;0;0;0;0;0;0;0;0;0;0;0;0;0;0;0;0;0;0
FR;9;2022-06-19;0;0;0;0;0;0;0;0;0;0;0;0;0;0;0;0;0;0
FR;9;2022-06-20;0;0;0;0;0;0;0;0;0;0;0;0;0;0;0;0;0;0
FR;9;2022-06-21;0;0;0;0;0;0;0;0;0;0;0;0;0;0;0;0;0;0
FR;9;2022-06-22;0;0;0;0;0;0;0;0;0;0;0;0;0;0;0;0;0;0
FR;9;2022-06-23;0;0;0;0;0;0;0;0;0;0;0;0;0;0;0;0;0;0
FR;9;2022-06-24;0;0;0;0;0;0;0;0;0;0;0;0;0;0;0;0;0;0
FR;9;2022-06-25;0;0;0;0;0;0;0;0;0;0;0;0;0;0;0;0;0;0
FR;9;2022-06-26;0;0;0;0;0;0;0;0;0;0;0;0;0;0;0;0;0;0
FR;9;2022-06-27;0;0;0;0;0;0;0;0;0;0;0;0;0;0;0;0;0;0
FR;9;2022-06-28;0;0;0;0;0;0;0;0;0;0;0;0;0;0;0;0;0;0
FR;9;2022-06-29;0;0;0;0;0;0;0;0;0;0;0;0;0;0;0;0;0;0
FR;9;2022-06-30;0;0;0;0;0;0;0;0;0;0;0;0;0;0;0;0;0;0
FR;9;2022-07-01;0;0;0;0;0;0;0;0;0;0;0;0;0;0;0;0;0;0
FR;9;2022-07-02;0;0;0;0;0;0;0;0;0;0;0;0;0;0;0;0;0;0
FR;9;2022-07-03;0;0;0;0;0;0;0;0;0;0;0;0;0;0;0;0;0;0
FR;9;2022-07-04;0;0;0;0;0;0;0;0;0;0;0;0;0;0;0;0;0;0
FR;9;2022-07-05;0;0;0;0;0;0;0;0;0;0;0;0;0;0;0;0;0;0
FR;9;2022-07-06;0;0;0;0;0;0;0;0;0;0;0;0;0;0;0;0;0;0
FR;9;2022-07-07;0;0;0;0;0;0;0;0;0;0;0;0;0;0;0;0;0;0
FR;9;2022-07-08;0;0;0;0;0;0;0;0;0;0;0;0;0;0;0;0;0;0
FR;9;2022-07-09;0;0;0;0;0;0;0;0;0;0;0;0;0;0;0;0;0;0
FR;9;2022-07-10;0;0;0;0;0;0;0;0;0;0;0;0;0;0;0;0;0;0
FR;9;2022-07-11;0;0;0;0;0;0;0;0;0;0;0;0;0;0;0;0;0;0
FR;9;2022-07-12;0;0;0;0;0;0;0;0;0;0;0;0;0;0;0;0;0;0
FR;9;2022-07-13;0;0;0;0;0;0;0;0;0;0;0;0;0;0;0;0;0;0
FR;9;2022-07-14;0;0;0;0;0;0;0;0;0;0;0;0;0;0;0;0;0;0
FR;9;2022-07-15;0;0;0;0;0;0;0;0;0;0;0;0;0;0;0;0;0;0
FR;9;2022-07-16;0;0;0;0;0;0;0;0;0;0;0;0;0;0;0;0;0;0
FR;9;2022-07-17;0;0;0;0;0;0;0;0;0;0;0;0;0;0;0;0;0;0
FR;9;2022-07-18;0;0;0;0;0;0;0;0;0;0;0;0;0;0;0;0;0;0
FR;9;2022-07-19;0;0;0;0;0;0;0;0;0;0;0;0;0;0;0;0;0;0
FR;9;2022-07-20;0;0;0;0;0;0;0;0;0;0;0;0;0;0;0;0;0;0
FR;9;2022-07-21;0;0;0;0;0;0;0;0;0;0;0;0;0;0;0;0;0;0
FR;9;2022-07-22;0;0;0;0;0;0;0;0;0;0;0;0;0;0;0;0;0;0
FR;9;2022-07-23;0;0;0;0;0;0;0;0;0;0;0;0;0;0;0;0;0;0
FR;9;2022-07-24;0;0;0;0;0;0;0;0;0;0;0;0;0;0;0;0;0;0
FR;9;2022-07-25;0;0;0;0;0;0;0;0;0;0;0;0;0;0;0;0;0;0
FR;9;2022-07-26;0;0;0;0;0;0;0;0;0;0;0;0;0;0;0;0;0;0
FR;9;2022-07-27;0;0;0;0;0;0;0;0;0;0;0;0;0;0;0;0;0;0
FR;9;2022-07-28;0;0;0;0;0;0;0;0;0;0;0;0;0;0;0;0;0;0
FR;9;2022-07-29;0;0;0;0;0;0;0;0;0;0;0;0;0;0;0;0;0;0
FR;9;2022-07-30;0;0;0;0;0;0;0;0;0;0;0;0;0;0;0;0;0;0
FR;9;2022-07-31;0;0;0;0;0;0;0;0;0;0;0;0;0;0;0;0;0;0
FR;9;2022-08-01;0;0;0;0;0;0;0;0;0;0;0;0;0;0;0;0;0;0
FR;9;2022-08-02;0;0;0;0;0;0;0;0;0;0;0;0;0;0;0;0;0;0
FR;9;2022-08-03;0;0;0;0;0;0;0;0;0;0;0;0;0;0;0;0;0;0
FR;9;2022-08-04;0;0;0;0;0;0;0;0;0;0;0;0;0;0;0;0;0;0
FR;9;2022-08-05;0;0;0;0;0;0;0;0;0;0;0;0;0;0;0;0;0;0
FR;9;2022-08-06;0;0;0;0;0;0;0;0;0;0;0;0;0;0;0;0;0;0
FR;9;2022-08-07;0;0;0;0;0;0;0;0;0;0;0;0;0;0;0;0;0;0
FR;9;2022-08-08;0;0;0;0;0;0;0;0;0;0;0;0;0;0;0;0;0;0
FR;9;2022-08-09;0;0;0;0;0;0;0;0;0;0;0;0;0;0;0;0;0;0
FR;9;2022-08-10;0;0;0;0;0;0;0;0;0;0;0;0;0;0;0;0;0;0
FR;9;2022-08-11;0;0;0;0;0;0;0;0;0;0;0;0;0;0;0;0;0;0
FR;9;2022-08-12;0;0;0;0;0;0;0;0;0;0;0;0;0;0;0;0;0;0
FR;9;2022-08-13;0;0;0;0;0;0;0;0;0;0;0;0;0;0;0;0;0;0
FR;9;2022-08-14;0;0;0;0;0;0;0;0;0;0;0;0;0;0;0;0;0;0
FR;9;2022-08-15;0;0;0;0;0;0;0;0;0;0;0;0;0;0;0;0;0;0
FR;9;2022-08-16;0;0;0;0;0;0;0;0;0;0;0;0;0;0;0;0;0;0
FR;9;2022-08-17;0;0;0;0;0;0;0;0;0;0;0;0;0;0;0;0;0;0
FR;9;2022-08-18;0;0;0;0;0;0;0;0;0;0;0;0;0;0;0;0;0;0
FR;9;2022-08-19;0;0;0;0;0;0;0;0;0;0;0;0;0;0;0;0;0;0
FR;9;2022-08-20;0;0;0;0;0;0;0;0;0;0;0;0;0;0;0;0;0;0
FR;9;2022-08-21;0;0;0;0;0;0;0;0;0;0;0;0;0;0;0;0;0;0
FR;9;2022-08-22;0;0;0;0;0;0;0;0;0;0;0;0;0;0;0;0;0;0
FR;9;2022-08-23;0;0;0;0;0;0;0;0;0;0;0;0;0;0;0;0;0;0
FR;9;2022-08-24;0;0;0;0;0;0;0;0;0;0;0;0;0;0;0;0;0;0
FR;9;2022-08-25;0;0;0;0;0;0;0;0;0;0;0;0;0;0;0;0;0;0
FR;9;2022-08-26;0;0;0;0;0;0;0;0;0;0;0;0;0;0;0;0;0;0
FR;9;2022-08-27;0;0;0;0;0;0;0;0;0;0;0;0;0;0;0;0;0;0
FR;9;2022-08-28;0;0;0;0;0;0;0;0;0;0;0;0;0;0;0;0;0;0
FR;9;2022-08-29;0;0;0;0;0;0;0;0;0;0;0;0;0;0;0;0;0;0
FR;9;2022-08-30;0;0;0;0;0;0;0;0;0;0;0;0;0;0;0;0;0;0
FR;9;2022-08-31;0;0;0;0;0;0;0;0;0;0;0;0;0;0;0;0;0;0
FR;9;2022-09-01;0;0;0;0;0;0;0;0;0;0;0;0;0;0;0;0;0;0
FR;9;2022-09-02;0;0;0;0;0;0;0;0;0;0;0;0;0;0;0;0;0;0
FR;9;2022-09-03;0;0;0;0;0;0;0;0;0;0;0;0;0;0;0;0;0;0
FR;9;2022-09-04;0;0;0;0;0;0;0;0;0;0;0;0;0;0;0;0;0;0
FR;9;2022-09-05;0;0;0;0;0;0;0;0;0;0;0;0;0;0;0;0;0;0
FR;9;2022-09-06;0;0;0;0;0;0;0;0;0;0;0;0;0;0;0;0;0;0
FR;9;2022-09-07;0;0;0;0;0;0;0;0;0;0;0;0;0;0;0;0;0;0
FR;9;2022-09-08;0;0;0;0;0;0;0;0;0;0;0;0;0;0;0;0;0;0
FR;9;2022-09-09;0;0;0;0;0;0;0;0;0;0;0;0;0;0;0;0;0;0
FR;9;2022-09-10;0;0;0;0;0;0;0;0;0;0;0;0;0;0;0;0;0;0
FR;9;2022-09-11;0;0;0;0;0;0;0;0;0;0;0;0;0;0;0;0;0;0
FR;9;2022-09-12;0;0;0;0;0;0;0;0;0;0;0;0;0;0;0;0;0;0
FR;9;2022-09-13;0;0;0;0;0;0;0;0;0;0;0;0;0;0;0;0;0;0
FR;9;2022-09-14;0;0;0;0;0;0;0;0;0;0;0;0;0;0;0;0;0;0
FR;9;2022-09-15;0;0;0;0;0;0;0;0;0;0;0;0;0;0;0;0;0;0
FR;9;2022-09-16;0;0;0;0;0;0;0;0;0;0;0;0;0;0;0;0;0;0
FR;9;2022-09-17;0;0;0;0;0;0;0;0;0;0;0;0;0;0;0;0;0;0
FR;9;2022-09-18;0;0;0;0;0;0;0;0;0;0;0;0;0;0;0;0;0;0
FR;9;2022-09-19;0;0;0;0;0;0;0;0;0;0;0;0;0;0;0;0;0;0
FR;9;2022-09-20;0;0;0;0;0;0;0;0;0;0;0;0;0;0;0;0;0;0
FR;9;2022-09-21;0;0;0;0;0;0;0;0;0;0;0;0;0;0;0;0;0;0
FR;9;2022-09-22;0;0;0;0;0;0;0;0;0;0;0;0;0;0;0;0;0;0
FR;9;2022-09-23;0;0;0;0;0;0;0;0;0;0;0;0;0;0;0;0;0;0
FR;9;2022-09-24;0;0;0;0;0;0;0;0;0;0;0;0;0;0;0;0;0;0
FR;9;2022-09-25;0;0;0;0;0;0;0;0;0;0;0;0;0;0;0;0;0;0
FR;9;2022-09-26;0;0;0;0;0;0;0;0;0;0;0;0;0;0;0;0;0;0
FR;9;2022-09-27;0;0;0;0;0;0;0;0;0;0;0;0;0;0;0;0;0;0
FR;9;2022-09-28;0;0;0;0;0;0;0;0;0;0;0;0;0;0;0;0;0;0
FR;9;2022-09-29;1;1;8;33;0;6;35;43;2;1;1;8;33;0;6;35;43;2
FR;9;2022-09-30;5;12;60;606;6;47;613;713;51;6;13;68;639;6;53;648;756;53
FR;9;2022-10-01;9;1;43;327;2;26;335;396;35;15;14;111;966;8;79;983;1152;88
FR;9;2022-10-02;1;1;5;50;0;4;51;66;11;16;15;116;1016;8;83;1034;1218;99
FR;9;2022-10-03;10;16;151;1713;10;129;1707;2073;234;26;31;267;2729;18;212;2741;3291;333
FR;9;2022-10-04;20;48;353;3952;18;228;4020;4702;450;46;79;620;6681;36;440;6761;7993;783
FR;9;2022-10-05;27;19;269;2997;16;203;3010;3655;433;73;98;889;9678;52;643;9771;11648;1216
FR;9;2022-10-06;23;34;399;4598;17;300;4631;5608;672;96;132;1288;14276;69;943;14402;17256;1888
FR;9;2022-10-07;29;50;499;5704;19;384;5718;7027;923;125;182;1787;19980;88;1327;20120;24283;2811
FR;9;2022-10-08;10;18;128;1090;8;86;1108;1388;190;135;200;1915;21070;96;1413;21228;25671;3001
FR;9;2022-10-09;1;7;22;197;1;29;198;277;50;136;207;1937;21267;97;1442;21426;25948;3051
FR;9;2022-10-10;11;26;207;2572;14;181;2576;3296;533;147;233;2144;23839;111;1623;24002;29244;3584
FR;9;2022-10-11;31;40;424;5043;27;312;5024;6197;851;178;273;2568;28882;138;1935;29026;35441;4435
FR;9;2022-10-12;22;26;297;2987;16;212;3044;3830;572;200;299;2865;31869;154;2147;32070;39271;5007
FR;9;2022-10-13;25;42;374;3980;16;245;4036;5027;740;225;341;3239;35849;170;2392;36106;44298;5747
FR;9;2022-10-14;27;26;381;4427;12;293;4411;5553;838;252;367;3620;40276;182;2685;40517;49851;6585
FR;9;2022-10-15;14;8;101;1051;7;79;1028;1307;198;266;375;3721;41327;189;2764;41545;51158;6783
FR;9;2022-10-16;4;1;9;131;2;12;125;167;28;270;376;3730;41458;191;2776;41670;51325;6811
FR;9;2022-10-17;4;22;165;1875;11;127;1883;2492;475;274;398;3895;43333;202;2903;43553;53817;7286
FR;9;2022-10-18;36;28;316;3429;17;235;3453;4652;955;310;426;4211;46762;219;3138;47006;58469;8241
FR;9;2022-10-19;22;19;262;2687;16;174;2717;3725;819;332;445;4473;49449;235;3312;49723;62194;9060
FR;9;2022-10-20;21;22;308;3625;8;232;3626;4798;932;353;467;4781;53074;243;3544;53349;66992;9992
FR;9;2022-10-21;14;31;324;3525;10;226;3543;4636;859;367;498;5105;56599;253;3770;56892;71628;10851
FR;9;2022-10-22;10;11;90;914;8;62;919;1193;207;377;509;5195;57513;261;3832;57811;72821;11058
FR;9;2022-10-23;2;2;17;99;2;10;104;147;33;379;511;5212;57612;263;3842;57915;72968;11091
FR;9;2022-10-24;7;17;158;1362;6;104;1430;1934;395;386;528;5370;58974;269;3946;59345;74902;11486
FR;9;2022-10-25;18;22;227;2837;16;188;2846;3908;871;404;550;5597;61811;285;4134;62191;78810;12357
FR;9;2022-10-26;14;16;169;1797;13;123;1810;2519;584;418;566;5766;63608;298;4257;64001;81329;12941
FR;9;2022-10-27;9;26;230;2291;15;173;2324;3170;662;427;592;5996;65899;313;4430;66325;84499;13603
FR;9;2022-10-28;18;27;224;2277;17;151;2303;3141;680;445;619;6220;68176;330;4581;68628;87640;14283
FR;9;2022-10-29;12;8;55;505;5;46;496;662;119;457;627;6275;68681;335;4627;69124;88302;14402
FR;9;2022-10-30;2;1;8;58;1;8;58;82;16;459;628;6283;68739;336;4635;69182;88384;14418
FR;9;2022-10-31;13;7;105;658;9;59;693;986;232;472;635;6388;69397;345;4694;69875;89370;14650
FR;9;2022-11-01;1;1;15;43;0;11;49;71;11;473;636;6403;69440;345;4705;69924;89441;14661
FR;9;2022-11-02;7;12;102;1025;4;76;1043;1574;451;480;648;6505;70465;349;4781;70967;91015;15112
FR;9;2022-11-03;17;17;155;1583;15;90;1631;2325;594;497;665;6660;72048;364;4871;72598;93340;15706
FR;9;2022-11-04;21;19;193;1746;15;120;1795;2521;601;518;684;6853;73794;379;4991;74393;95861;16307
FR;9;2022-11-05;8;10;58;403;9;39;424;573;107;526;694;6911;74197;388;5030;74817;96434;16414
FR;9;2022-11-06;5;4;5;62;6;2;61;88;25;531;698;6916;74259;394;5032;74878;96522;16439
FR;9;2022-11-07;16;19;88;923;16;109;929;1468;424;547;717;7004;75182;410;5141;75807;97990;16863
FR;9;2022-11-08;10;19;165;1800;13;133;1795;2635;702;557;736;7169;76982;423;5274;77602;100625;17565
FR;9;2022-11-09;16;16;123;1261;9;98;1322;1878;453;573;752;7292;78243;432;5372;78924;102503;18018
FR;9;2022-11-10;13;21;158;1620;13;137;1613;2272;518;586;773;7450;79863;445;5509;80537;104775;18536
FR;9;2022-11-11;1;1;13;81;1;6;83;123;34;587;774;7463;79944;446;5515;80620;104898;18570
FR;9;2022-11-12;5;8;44;259;7;19;278;395;97;592;782;7507;80203;453;5534;80898;105293;18667
FR;9;2022-11-13;2;0;4;30;0;4;31;51;16;594;782;7511;80233;453;5538;80929;105344;18683
FR;9;2022-11-14;11;12;56;707;11;44;722;1107;338;605;794;7567;80940;464;5582;81651;106451;19021
FR;9;2022-11-15;18;16;146;1322;7;103;1329;2074;636;623;810;7713;82262;471;5685;82980;108525;19657
FR;9;2022-11-16;10;4;99;979;7;58;997;1488;429;633;814;7812;83241;478;5743;83977;110013;20086
FR;9;2022-11-17;9;17;125;1079;11;77;1104;1686;500;642;831;7937;84320;489;5820;85081;111699;20586
FR;9;2022-11-18;7;16;119;1436;5;77;1451;2021;491;649;847;8056;85756;494;5897;86532;113720;21077
FR;9;2022-11-19;3;5;50;364;1;27;350;488;106;652;852;8106;86120;495;5924;86882;114208;21183
FR;9;2022-11-20;1;0;5;37;0;3;35;54;16;653;852;8111;86157;495;5927;86917;114262;21199
FR;9;2022-11-21;9;12;66;636;5;51;639;960;263;662;864;8177;86793;500;5978;87556;115222;21462
FR;9;2022-11-22;15;12;121;1037;13;74;1067;1591;448;677;876;8298;87830;513;6052;88623;116813;21910
FR;9;2022-11-23;7;10;68;720;5;33;747;1145;360;684;886;8366;88550;518;6085;89370;117958;22270
FR;9;2022-11-24;8;19;93;977;14;68;990;1470;406;692;905;8459;89527;532;6153;90360;119428;22676
FR;9;2022-11-25;8;10;106;1173;8;81;1189;1742;471;700;915;8565;90700;540;6234;91549;121170;23147
FR;9;2022-11-26;6;6;35;217;7;24;211;307;68;706;921;8600;90917;547;6258;91760;121477;23215
FR;9;2022-11-27;1;1;6;42;0;2;46;82;34;707;922;8606;90959;547;6260;91806;121559;23249
FR;9;2022-11-28;5;7;101;689;7;58;718;1110;329;712;929;8707;91648;554;6318;92524;122669;23578
FR;9;2022-11-29;6;17;139;1295;6;87;1322;1930;516;718;946;8846;92943;560;6405;93846;124599;24094
FR;9;2022-11-30;9;12;99;1026;5;76;1049;1599;469;727;958;8945;93969;565;6481;94895;126198;24563
FR;9;2022-12-01;16;14;111;1330;8;80;1315;1939;540;743;972;9056;95299;573;6561;96210;128137;25103
FR;9;2022-12-02;10;13;192;1815;10;107;1815;2626;698;753;985;9248;97114;583;6668;98025;130763;25801
FR;9;2022-12-03;7;9;79;618;5;40;632;886;208;760;994;9327;97732;588;6708;98657;131649;26009
FR;9;2022-12-04;9;4;15;105;5;8;105;153;40;769;998;9342;97837;593;6716;98762;131802;26049
FR;9;2022-12-05;19;24;144;1405;17;98;1420;2106;581;788;1022;9486;99242;610;6814;100182;133908;26630
FR;9;2022-12-06;30;21;261;2436;20;146;2530;3783;1089;818;1043;9747;101678;630;6960;102712;137691;27719
FR;9;2022-12-07;15;22;181;1843;20;112;1885;2819;814;833;1065;9928;103521;650;7072;104597;140510;28533
FR;9;2022-12-08;13;22;219;2383;15;123;2445;3647;1063;846;1087;10147;105904;665;7195;107042;144157;29596
FR;9;2022-12-09;14;25;287;2874;10;143;2973;4317;1193;860;1112;10434;108778;675;7338;110015;148474;30789
FR;9;2022-12-10;12;12;122;1319;4;56;1342;1812;408;872;1124;10556;110097;679;7394;111357;150286;31197
FR;9;2022-12-11;5;4;21;277;5;10;283;363;66;877;1128;10577;110374;684;7404;111640;150649;31263
FR;9;2022-12-12;17;13;215;1954;12;108;2028;2882;741;894;1141;10792;112328;696;7512;113668;153531;32004
FR;9;2022-12-13;27;22;316;3073;14;151;3208;4699;1329;921;1163;11108;115401;710;7663;116876;158230;33333
FR;9;2022-12-14;15;10;187;2315;8;92;2382;3472;981;936;1173;11295;117716;718;7755;119258;161702;34314
FR;9;2022-12-15;17;23;250;2601;12;138;2677;4060;1234;953;1196;11545;120317;730;7893;121935;165762;35548
FR;9;2022-12-16;14;29;290;3047;21;163;3133;4548;1243;967;1225;11835;123364;751;8056;125068;170310;36791
FR;9;2022-12-17;8;12;106;1188;7;49;1205;1653;395;975;1237;11941;124552;758;8105;126273;171963;37186
FR;9;2022-12-18;1;7;30;242;6;14;248;330;67;976;1244;11971;124794;764;8119;126521;172293;37253
FR;9;2022-12-19;20;21;149;1599;15;78;1631;2507;789;996;1265;12120;126393;779;8197;128152;174800;38042
FR;9;2022-12-20;21;19;232;2303;6;115;2345;3701;1230;1017;1284;12352;128696;785;8312;130497;178501;39272
FR;9;2022-12-21;6;14;139;1499;7;66;1550;2397;774;1023;1298;12491;130195;792;8378;132047;180898;40046
FR;9;2022-12-22;16;5;132;1354;8;65;1369;2048;606;1039;1303;12623;131549;800;8443;133416;182946;40652
FR;9;2022-12-23;11;14;76;727;8;50;729;1092;307;1050;1317;12699;132276;808;8493;134145;184038;40959
FR;9;2022-12-24;1;3;12;95;2;5;97;136;34;1051;1320;12711;132371;810;8498;134242;184174;40993
FR;9;2022-12-25;1;0;5;5;0;4;6;12;2;1052;1320;12716;132376;810;8502;134248;184186;40995
FR;9;2022-12-26;16;7;64;546;10;37;554;827;233;1068;1327;12780;132922;820;8539;134802;185013;41228
FR;9;2022-12-27;10;30;95;878;12;67;912;1413;428;1078;1357;12875;133800;832;8606;135714;186426;41656
FR;9;2022-12-28;7;7;79;714;6;40;731;1118;342;1085;1364;12954;134514;838;8646;136445;187544;41998
FR;9;2022-12-29;9;14;90;714;10;49;749;1120;315;1094;1378;13044;135228;848;8695;137194;188664;42313
FR;9;2022-12-30;11;16;69;576;9;41;597;861;220;1105;1394;13113;135804;857;8736;137791;189525;42533
FR;9;2022-12-31;2;3;16;134;2;11;137;186;37;1107;1397;13129;135938;859;8747;137928;189711;42570
FR;9;2023-01-01;0;2;3;17;1;4;17;26;5;1107;1399;13132;135955;860;8751;137945;189737;42575
FR;9;2023-01-02;10;9;55;580;4;37;573;930;318;1117;1408;13187;136535;864;8788;138518;190667;42893
FR;10;2020-12-27;0;0;0;0;0;0;0;0;0;0;0;0;0;0;0;0;0;0
FR;10;2020-12-28;0;0;0;0;0;0;0;0;0;0;0;0;0;0;0;0;0;0
FR;10;2020-12-29;0;0;0;0;0;0;0;0;0;0;0;0;0;0;0;0;0;0
FR;10;2020-12-30;0;0;0;0;0;0;0;0;0;0;0;0;0;0;0;0;0;0
FR;10;2020-12-31;0;0;0;0;0;0;0;0;0;0;0;0;0;0;0;0;0;0
FR;10;2021-01-01;0;0;0;0;0;0;0;0;0;0;0;0;0;0;0;0;0;0
FR;10;2021-01-02;0;0;0;0;0;0;0;0;0;0;0;0;0;0;0;0;0;0
FR;10;2021-01-03;0;0;0;0;0;0;0;0;0;0;0;0;0;0;0;0;0;0
FR;10;2021-01-04;0;0;0;0;0;0;0;0;0;0;0;0;0;0;0;0;0;0
FR;10;2021-01-05;0;0;0;0;0;0;0;0;0;0;0;0;0;0;0;0;0;0
FR;10;2021-01-06;0;0;0;0;0;0;0;0;0;0;0;0;0;0;0;0;0;0
FR;10;2021-01-07;0;0;0;0;0;0;0;0;0;0;0;0;0;0;0;0;0;0
FR;10;2021-01-08;0;0;0;0;0;0;0;0;0;0;0;0;0;0;0;0;0;0
FR;10;2021-01-09;0;0;0;0;0;0;0;0;0;0;0;0;0;0;0;0;0;0
FR;10;2021-01-10;0;0;0;0;0;0;0;0;0;0;0;0;0;0;0;0;0;0
FR;10;2021-01-11;0;0;0;0;0;0;0;0;0;0;0;0;0;0;0;0;0;0
FR;10;2021-01-12;0;0;0;0;0;0;0;0;0;0;0;0;0;0;0;0;0;0
FR;10;2021-01-13;0;0;0;0;0;0;0;0;0;0;0;0;0;0;0;0;0;0
FR;10;2021-01-14;0;0;0;0;0;0;0;0;0;0;0;0;0;0;0;0;0;0
FR;10;2021-01-15;0;0;0;0;0;0;0;0;0;0;0;0;0;0;0;0;0;0
FR;10;2021-01-16;0;0;0;0;0;0;0;0;0;0;0;0;0;0;0;0;0;0
FR;10;2021-01-17;0;0;0;0;0;0;0;0;0;0;0;0;0;0;0;0;0;0
FR;10;2021-01-18;0;0;0;0;0;0;0;0;0;0;0;0;0;0;0;0;0;0
FR;10;2021-01-19;0;0;0;0;0;0;0;0;0;0;0;0;0;0;0;0;0;0
FR;10;2021-01-20;0;0;0;0;0;0;0;0;0;0;0;0;0;0;0;0;0;0
FR;10;2021-01-21;0;0;0;0;0;0;0;0;0;0;0;0;0;0;0;0;0;0
FR;10;2021-01-22;0;0;0;0;0;0;0;0;0;0;0;0;0;0;0;0;0;0
FR;10;2021-01-23;0;0;0;0;0;0;0;0;0;0;0;0;0;0;0;0;0;0
FR;10;2021-01-24;0;0;0;0;0;0;0;0;0;0;0;0;0;0;0;0;0;0
FR;10;2021-01-25;0;0;0;0;0;0;0;0;0;0;0;0;0;0;0;0;0;0
FR;10;2021-01-26;0;0;0;0;0;0;0;0;0;0;0;0;0;0;0;0;0;0
FR;10;2021-01-27;0;0;0;0;0;0;0;0;0;0;0;0;0;0;0;0;0;0
FR;10;2021-01-28;0;0;0;0;0;0;0;0;0;0;0;0;0;0;0;0;0;0
FR;10;2021-01-29;0;0;0;0;0;0;0;0;0;0;0;0;0;0;0;0;0;0
FR;10;2021-01-30;0;0;0;0;0;0;0;0;0;0;0;0;0;0;0;0;0;0
FR;10;2021-01-31;0;0;0;0;0;0;0;0;0;0;0;0;0;0;0;0;0;0
FR;10;2021-02-01;0;0;0;0;0;0;0;0;0;0;0;0;0;0;0;0;0;0
FR;10;2021-02-02;0;0;0;0;0;0;0;0;0;0;0;0;0;0;0;0;0;0
FR;10;2021-02-03;0;0;0;0;0;0;0;0;0;0;0;0;0;0;0;0;0;0
FR;10;2021-02-04;0;0;0;0;0;0;0;0;0;0;0;0;0;0;0;0;0;0
FR;10;2021-02-05;0;0;0;0;0;0;0;0;0;0;0;0;0;0;0;0;0;0
FR;10;2021-02-06;0;0;0;0;0;0;0;0;0;0;0;0;0;0;0;0;0;0
FR;10;2021-02-07;0;0;0;0;0;0;0;0;0;0;0;0;0;0;0;0;0;0
FR;10;2021-02-08;0;0;0;0;0;0;0;0;0;0;0;0;0;0;0;0;0;0
FR;10;2021-02-09;0;0;0;0;0;0;0;0;0;0;0;0;0;0;0;0;0;0
FR;10;2021-02-10;0;0;0;0;0;0;0;0;0;0;0;0;0;0;0;0;0;0
FR;10;2021-02-11;0;0;0;0;0;0;0;0;0;0;0;0;0;0;0;0;0;0
FR;10;2021-02-12;0;0;0;0;0;0;0;0;0;0;0;0;0;0;0;0;0;0
FR;10;2021-02-13;0;0;0;0;0;0;0;0;0;0;0;0;0;0;0;0;0;0
FR;10;2021-02-14;0;0;0;0;0;0;0;0;0;0;0;0;0;0;0;0;0;0
FR;10;2021-02-15;0;0;0;0;0;0;0;0;0;0;0;0;0;0;0;0;0;0
FR;10;2021-02-16;0;0;0;0;0;0;0;0;0;0;0;0;0;0;0;0;0;0
FR;10;2021-02-17;0;0;0;0;0;0;0;0;0;0;0;0;0;0;0;0;0;0
FR;10;2021-02-18;0;0;0;0;0;0;0;0;0;0;0;0;0;0;0;0;0;0
FR;10;2021-02-19;0;0;0;0;0;0;0;0;0;0;0;0;0;0;0;0;0;0
FR;10;2021-02-20;0;0;0;0;0;0;0;0;0;0;0;0;0;0;0;0;0;0
FR;10;2021-02-21;0;0;0;0;0;0;0;0;0;0;0;0;0;0;0;0;0;0
FR;10;2021-02-22;0;0;0;0;0;0;0;0;0;0;0;0;0;0;0;0;0;0
FR;10;2021-02-23;0;0;0;0;0;0;0;0;0;0;0;0;0;0;0;0;0;0
FR;10;2021-02-24;0;0;0;0;0;0;0;0;0;0;0;0;0;0;0;0;0;0
FR;10;2021-02-25;0;0;0;0;0;0;0;0;0;0;0;0;0;0;0;0;0;0
FR;10;2021-02-26;0;0;0;0;0;0;0;0;0;0;0;0;0;0;0;0;0;0
FR;10;2021-02-27;0;0;0;0;0;0;0;0;0;0;0;0;0;0;0;0;0;0
FR;10;2021-02-28;0;0;0;0;0;0;0;0;0;0;0;0;0;0;0;0;0;0
FR;10;2021-03-01;0;0;0;0;0;0;0;0;0;0;0;0;0;0;0;0;0;0
FR;10;2021-03-02;0;0;0;0;0;0;0;0;0;0;0;0;0;0;0;0;0;0
FR;10;2021-03-03;0;0;0;0;0;0;0;0;0;0;0;0;0;0;0;0;0;0
FR;10;2021-03-04;0;0;0;0;0;0;0;0;0;0;0;0;0;0;0;0;0;0
FR;10;2021-03-05;0;0;0;0;0;0;0;0;0;0;0;0;0;0;0;0;0;0
FR;10;2021-03-06;0;0;0;0;0;0;0;0;0;0;0;0;0;0;0;0;0;0
FR;10;2021-03-07;0;0;0;0;0;0;0;0;0;0;0;0;0;0;0;0;0;0
FR;10;2021-03-08;0;0;0;0;0;0;0;0;0;0;0;0;0;0;0;0;0;0
FR;10;2021-03-09;0;0;0;0;0;0;0;0;0;0;0;0;0;0;0;0;0;0
FR;10;2021-03-10;0;0;0;0;0;0;0;0;0;0;0;0;0;0;0;0;0;0
FR;10;2021-03-11;0;0;0;0;0;0;0;0;0;0;0;0;0;0;0;0;0;0
FR;10;2021-03-12;0;0;0;0;0;0;0;0;0;0;0;0;0;0;0;0;0;0
FR;10;2021-03-13;0;0;0;0;0;0;0;0;0;0;0;0;0;0;0;0;0;0
FR;10;2021-03-14;0;0;0;0;0;0;0;0;0;0;0;0;0;0;0;0;0;0
FR;10;2021-03-15;0;0;0;0;0;0;0;0;0;0;0;0;0;0;0;0;0;0
FR;10;2021-03-16;0;0;0;0;0;0;0;0;0;0;0;0;0;0;0;0;0;0
FR;10;2021-03-17;0;0;0;0;0;0;0;0;0;0;0;0;0;0;0;0;0;0
FR;10;2021-03-18;0;0;0;0;0;0;0;0;0;0;0;0;0;0;0;0;0;0
FR;10;2021-03-19;0;0;0;0;0;0;0;0;0;0;0;0;0;0;0;0;0;0
FR;10;2021-03-20;0;0;0;0;0;0;0;0;0;0;0;0;0;0;0;0;0;0
FR;10;2021-03-21;0;0;0;0;0;0;0;0;0;0;0;0;0;0;0;0;0;0
FR;10;2021-03-22;0;0;0;0;0;0;0;0;0;0;0;0;0;0;0;0;0;0
FR;10;2021-03-23;0;0;0;0;0;0;0;0;0;0;0;0;0;0;0;0;0;0
FR;10;2021-03-24;0;0;0;0;0;0;0;0;0;0;0;0;0;0;0;0;0;0
FR;10;2021-03-25;0;0;0;0;0;0;0;0;0;0;0;0;0;0;0;0;0;0
FR;10;2021-03-26;0;0;0;0;0;0;0;0;0;0;0;0;0;0;0;0;0;0
FR;10;2021-03-27;0;0;0;0;0;0;0;0;0;0;0;0;0;0;0;0;0;0
FR;10;2021-03-28;0;0;0;0;0;0;0;0;0;0;0;0;0;0;0;0;0;0
FR;10;2021-03-29;0;0;0;0;0;0;0;0;0;0;0;0;0;0;0;0;0;0
FR;10;2021-03-30;0;0;0;0;0;0;0;0;0;0;0;0;0;0;0;0;0;0
FR;10;2021-03-31;0;0;0;0;0;0;0;0;0;0;0;0;0;0;0;0;0;0
FR;10;2021-04-01;0;0;0;0;0;0;0;0;0;0;0;0;0;0;0;0;0;0
FR;10;2021-04-02;0;0;0;0;0;0;0;0;0;0;0;0;0;0;0;0;0;0
FR;10;2021-04-03;0;0;0;0;0;0;0;0;0;0;0;0;0;0;0;0;0;0
FR;10;2021-04-04;0;0;0;0;0;0;0;0;0;0;0;0;0;0;0;0;0;0
FR;10;2021-04-05;0;0;0;0;0;0;0;0;0;0;0;0;0;0;0;0;0;0
FR;10;2021-04-06;0;0;0;0;0;0;0;0;0;0;0;0;0;0;0;0;0;0
FR;10;2021-04-07;0;0;0;0;0;0;0;0;0;0;0;0;0;0;0;0;0;0
FR;10;2021-04-08;0;0;0;0;0;0;0;0;0;0;0;0;0;0;0;0;0;0
FR;10;2021-04-09;0;0;0;0;0;0;0;0;0;0;0;0;0;0;0;0;0;0
FR;10;2021-04-10;0;0;0;0;0;0;0;0;0;0;0;0;0;0;0;0;0;0
FR;10;2021-04-11;0;0;0;0;0;0;0;0;0;0;0;0;0;0;0;0;0;0
FR;10;2021-04-12;0;0;0;0;0;0;0;0;0;0;0;0;0;0;0;0;0;0
FR;10;2021-04-13;0;0;0;0;0;0;0;0;0;0;0;0;0;0;0;0;0;0
FR;10;2021-04-14;0;0;0;0;0;0;0;0;0;0;0;0;0;0;0;0;0;0
FR;10;2021-04-15;0;0;0;0;0;0;0;0;0;0;0;0;0;0;0;0;0;0
FR;10;2021-04-16;0;0;0;0;0;0;0;0;0;0;0;0;0;0;0;0;0;0
FR;10;2021-04-17;0;0;0;0;0;0;0;0;0;0;0;0;0;0;0;0;0;0
FR;10;2021-04-18;0;0;0;0;0;0;0;0;0;0;0;0;0;0;0;0;0;0
FR;10;2021-04-19;0;0;0;0;0;0;0;0;0;0;0;0;0;0;0;0;0;0
FR;10;2021-04-20;0;0;0;0;0;0;0;0;0;0;0;0;0;0;0;0;0;0
FR;10;2021-04-21;0;0;0;0;0;0;0;0;0;0;0;0;0;0;0;0;0;0
FR;10;2021-04-22;0;0;0;0;0;0;0;0;0;0;0;0;0;0;0;0;0;0
FR;10;2021-04-23;0;0;0;0;0;0;0;0;0;0;0;0;0;0;0;0;0;0
FR;10;2021-04-24;0;0;0;0;0;0;0;0;0;0;0;0;0;0;0;0;0;0
FR;10;2021-04-25;0;0;0;0;0;0;0;0;0;0;0;0;0;0;0;0;0;0
FR;10;2021-04-26;0;0;0;0;0;0;0;0;0;0;0;0;0;0;0;0;0;0
FR;10;2021-04-27;0;0;0;0;0;0;0;0;0;0;0;0;0;0;0;0;0;0
FR;10;2021-04-28;0;0;0;0;0;0;0;0;0;0;0;0;0;0;0;0;0;0
FR;10;2021-04-29;0;0;0;0;0;0;0;0;0;0;0;0;0;0;0;0;0;0
FR;10;2021-04-30;0;0;0;0;0;0;0;0;0;0;0;0;0;0;0;0;0;0
FR;10;2021-05-01;0;0;0;0;0;0;0;0;0;0;0;0;0;0;0;0;0;0
FR;10;2021-05-02;0;0;0;0;0;0;0;0;0;0;0;0;0;0;0;0;0;0
FR;10;2021-05-03;0;0;0;0;0;0;0;0;0;0;0;0;0;0;0;0;0;0
FR;10;2021-05-04;0;0;0;0;0;0;0;0;0;0;0;0;0;0;0;0;0;0
FR;10;2021-05-05;0;0;0;0;0;0;0;0;0;0;0;0;0;0;0;0;0;0
FR;10;2021-05-06;0;0;0;0;0;0;0;0;0;0;0;0;0;0;0;0;0;0
FR;10;2021-05-07;0;0;0;0;0;0;0;0;0;0;0;0;0;0;0;0;0;0
FR;10;2021-05-08;0;0;0;0;0;0;0;0;0;0;0;0;0;0;0;0;0;0
FR;10;2021-05-09;0;0;0;0;0;0;0;0;0;0;0;0;0;0;0;0;0;0
FR;10;2021-05-10;0;0;0;0;0;0;0;0;0;0;0;0;0;0;0;0;0;0
FR;10;2021-05-11;0;0;0;0;0;0;0;0;0;0;0;0;0;0;0;0;0;0
FR;10;2021-05-12;0;0;0;0;0;0;0;0;0;0;0;0;0;0;0;0;0;0
FR;10;2021-05-13;0;0;0;0;0;0;0;0;0;0;0;0;0;0;0;0;0;0
FR;10;2021-05-14;0;0;0;0;0;0;0;0;0;0;0;0;0;0;0;0;0;0
FR;10;2021-05-15;0;0;0;0;0;0;0;0;0;0;0;0;0;0;0;0;0;0
FR;10;2021-05-16;0;0;0;0;0;0;0;0;0;0;0;0;0;0;0;0;0;0
FR;10;2021-05-17;0;0;0;0;0;0;0;0;0;0;0;0;0;0;0;0;0;0
FR;10;2021-05-18;0;0;0;0;0;0;0;0;0;0;0;0;0;0;0;0;0;0
FR;10;2021-05-19;0;0;0;0;0;0;0;0;0;0;0;0;0;0;0;0;0;0
FR;10;2021-05-20;0;0;0;0;0;0;0;0;0;0;0;0;0;0;0;0;0;0
FR;10;2021-05-21;0;0;0;0;0;0;0;0;0;0;0;0;0;0;0;0;0;0
FR;10;2021-05-22;0;0;0;0;0;0;0;0;0;0;0;0;0;0;0;0;0;0
FR;10;2021-05-23;0;0;0;0;0;0;0;0;0;0;0;0;0;0;0;0;0;0
FR;10;2021-05-24;0;0;0;0;0;0;0;0;0;0;0;0;0;0;0;0;0;0
FR;10;2021-05-25;0;0;0;0;0;0;0;0;0;0;0;0;0;0;0;0;0;0
FR;10;2021-05-26;0;0;0;0;0;0;0;0;0;0;0;0;0;0;0;0;0;0
FR;10;2021-05-27;0;0;0;0;0;0;0;0;0;0;0;0;0;0;0;0;0;0
FR;10;2021-05-28;0;0;0;0;0;0;0;0;0;0;0;0;0;0;0;0;0;0
FR;10;2021-05-29;0;0;0;0;0;0;0;0;0;0;0;0;0;0;0;0;0;0
FR;10;2021-05-30;0;0;0;0;0;0;0;0;0;0;0;0;0;0;0;0;0;0
FR;10;2021-05-31;0;0;0;0;0;0;0;0;0;0;0;0;0;0;0;0;0;0
FR;10;2021-06-01;0;0;0;0;0;0;0;0;0;0;0;0;0;0;0;0;0;0
FR;10;2021-06-02;0;0;0;0;0;0;0;0;0;0;0;0;0;0;0;0;0;0
FR;10;2021-06-03;0;0;0;0;0;0;0;0;0;0;0;0;0;0;0;0;0;0
FR;10;2021-06-04;0;0;0;0;0;0;0;0;0;0;0;0;0;0;0;0;0;0
FR;10;2021-06-05;0;0;0;0;0;0;0;0;0;0;0;0;0;0;0;0;0;0
FR;10;2021-06-06;0;0;0;0;0;0;0;0;0;0;0;0;0;0;0;0;0;0
FR;10;2021-06-07;0;0;0;0;0;0;0;0;0;0;0;0;0;0;0;0;0;0
FR;10;2021-06-08;0;0;0;0;0;0;0;0;0;0;0;0;0;0;0;0;0;0
FR;10;2021-06-09;0;0;0;0;0;0;0;0;0;0;0;0;0;0;0;0;0;0
FR;10;2021-06-10;0;0;0;0;0;0;0;0;0;0;0;0;0;0;0;0;0;0
FR;10;2021-06-11;0;0;0;0;0;0;0;0;0;0;0;0;0;0;0;0;0;0
FR;10;2021-06-12;0;0;0;0;0;0;0;0;0;0;0;0;0;0;0;0;0;0
FR;10;2021-06-13;0;0;0;0;0;0;0;0;0;0;0;0;0;0;0;0;0;0
FR;10;2021-06-14;0;0;0;0;0;0;0;0;0;0;0;0;0;0;0;0;0;0
FR;10;2021-06-15;0;0;0;0;0;0;0;0;0;0;0;0;0;0;0;0;0;0
FR;10;2021-06-16;0;0;0;0;0;0;0;0;0;0;0;0;0;0;0;0;0;0
FR;10;2021-06-17;0;0;0;0;0;0;0;0;0;0;0;0;0;0;0;0;0;0
FR;10;2021-06-18;0;0;0;0;0;0;0;0;0;0;0;0;0;0;0;0;0;0
FR;10;2021-06-19;0;0;0;0;0;0;0;0;0;0;0;0;0;0;0;0;0;0
FR;10;2021-06-20;0;0;0;0;0;0;0;0;0;0;0;0;0;0;0;0;0;0
FR;10;2021-06-21;0;0;0;0;0;0;0;0;0;0;0;0;0;0;0;0;0;0
FR;10;2021-06-22;0;0;0;0;0;0;0;0;0;0;0;0;0;0;0;0;0;0
FR;10;2021-06-23;0;0;0;0;0;0;0;0;0;0;0;0;0;0;0;0;0;0
FR;10;2021-06-24;0;0;0;0;0;0;0;0;0;0;0;0;0;0;0;0;0;0
FR;10;2021-06-25;0;0;0;0;0;0;0;0;0;0;0;0;0;0;0;0;0;0
FR;10;2021-06-26;0;0;0;0;0;0;0;0;0;0;0;0;0;0;0;0;0;0
FR;10;2021-06-27;0;0;0;0;0;0;0;0;0;0;0;0;0;0;0;0;0;0
FR;10;2021-06-28;0;0;0;0;0;0;0;0;0;0;0;0;0;0;0;0;0;0
FR;10;2021-06-29;0;0;0;0;0;0;0;0;0;0;0;0;0;0;0;0;0;0
FR;10;2021-06-30;0;0;0;0;0;0;0;0;0;0;0;0;0;0;0;0;0;0
FR;10;2021-07-01;0;0;0;0;0;0;0;0;0;0;0;0;0;0;0;0;0;0
FR;10;2021-07-02;0;0;0;0;0;0;0;0;0;0;0;0;0;0;0;0;0;0
FR;10;2021-07-03;0;0;0;0;0;0;0;0;0;0;0;0;0;0;0;0;0;0
FR;10;2021-07-04;0;0;0;0;0;0;0;0;0;0;0;0;0;0;0;0;0;0
FR;10;2021-07-05;0;0;0;0;0;0;0;0;0;0;0;0;0;0;0;0;0;0
FR;10;2021-07-06;0;0;0;0;0;0;0;0;0;0;0;0;0;0;0;0;0;0
FR;10;2021-07-07;0;0;0;0;0;0;0;0;0;0;0;0;0;0;0;0;0;0
FR;10;2021-07-08;0;0;0;0;0;0;0;0;0;0;0;0;0;0;0;0;0;0
FR;10;2021-07-09;0;0;0;0;0;0;0;0;0;0;0;0;0;0;0;0;0;0
FR;10;2021-07-10;0;0;0;0;0;0;0;0;0;0;0;0;0;0;0;0;0;0
FR;10;2021-07-11;0;0;0;0;0;0;0;0;0;0;0;0;0;0;0;0;0;0
FR;10;2021-07-12;0;0;0;0;0;0;0;0;0;0;0;0;0;0;0;0;0;0
FR;10;2021-07-13;0;0;0;0;0;0;0;0;0;0;0;0;0;0;0;0;0;0
FR;10;2021-07-14;0;0;0;0;0;0;0;0;0;0;0;0;0;0;0;0;0;0
FR;10;2021-07-15;0;0;0;0;0;0;0;0;0;0;0;0;0;0;0;0;0;0
FR;10;2021-07-16;0;0;0;0;0;0;0;0;0;0;0;0;0;0;0;0;0;0
FR;10;2021-07-17;0;0;0;0;0;0;0;0;0;0;0;0;0;0;0;0;0;0
FR;10;2021-07-18;0;0;0;0;0;0;0;0;0;0;0;0;0;0;0;0;0;0
FR;10;2021-07-19;0;0;0;0;0;0;0;0;0;0;0;0;0;0;0;0;0;0
FR;10;2021-07-20;0;0;0;0;0;0;0;0;0;0;0;0;0;0;0;0;0;0
FR;10;2021-07-21;0;0;0;0;0;0;0;0;0;0;0;0;0;0;0;0;0;0
FR;10;2021-07-22;0;0;0;0;0;0;0;0;0;0;0;0;0;0;0;0;0;0
FR;10;2021-07-23;0;0;0;0;0;0;0;0;0;0;0;0;0;0;0;0;0;0
FR;10;2021-07-24;0;0;0;0;0;0;0;0;0;0;0;0;0;0;0;0;0;0
FR;10;2021-07-25;0;0;0;0;0;0;0;0;0;0;0;0;0;0;0;0;0;0
FR;10;2021-07-26;0;0;0;0;0;0;0;0;0;0;0;0;0;0;0;0;0;0
FR;10;2021-07-27;0;0;0;0;0;0;0;0;0;0;0;0;0;0;0;0;0;0
FR;10;2021-07-28;0;0;0;0;0;0;0;0;0;0;0;0;0;0;0;0;0;0
FR;10;2021-07-29;0;0;0;0;0;0;0;0;0;0;0;0;0;0;0;0;0;0
FR;10;2021-07-30;0;0;0;0;0;0;0;0;0;0;0;0;0;0;0;0;0;0
FR;10;2021-07-31;0;0;0;0;0;0;0;0;0;0;0;0;0;0;0;0;0;0
FR;10;2021-08-01;0;0;0;0;0;0;0;0;0;0;0;0;0;0;0;0;0;0
FR;10;2021-08-02;0;0;0;0;0;0;0;0;0;0;0;0;0;0;0;0;0;0
FR;10;2021-08-03;0;0;0;0;0;0;0;0;0;0;0;0;0;0;0;0;0;0
FR;10;2021-08-04;0;0;0;0;0;0;0;0;0;0;0;0;0;0;0;0;0;0
FR;10;2021-08-05;0;0;0;0;0;0;0;0;0;0;0;0;0;0;0;0;0;0
FR;10;2021-08-06;0;0;0;0;0;0;0;0;0;0;0;0;0;0;0;0;0;0
FR;10;2021-08-07;0;0;0;0;0;0;0;0;0;0;0;0;0;0;0;0;0;0
FR;10;2021-08-08;0;0;0;0;0;0;0;0;0;0;0;0;0;0;0;0;0;0
FR;10;2021-08-09;0;0;0;0;0;0;0;0;0;0;0;0;0;0;0;0;0;0
FR;10;2021-08-10;0;0;0;0;0;0;0;0;0;0;0;0;0;0;0;0;0;0
FR;10;2021-08-11;0;0;0;0;0;0;0;0;0;0;0;0;0;0;0;0;0;0
FR;10;2021-08-12;0;0;0;0;0;0;0;0;0;0;0;0;0;0;0;0;0;0
FR;10;2021-08-13;0;0;0;0;0;0;0;0;0;0;0;0;0;0;0;0;0;0
FR;10;2021-08-14;0;0;0;0;0;0;0;0;0;0;0;0;0;0;0;0;0;0
FR;10;2021-08-15;0;0;0;0;0;0;0;0;0;0;0;0;0;0;0;0;0;0
FR;10;2021-08-16;0;0;0;0;0;0;0;0;0;0;0;0;0;0;0;0;0;0
FR;10;2021-08-17;0;0;0;0;0;0;0;0;0;0;0;0;0;0;0;0;0;0
FR;10;2021-08-18;0;0;0;0;0;0;0;0;0;0;0;0;0;0;0;0;0;0
FR;10;2021-08-19;0;0;0;0;0;0;0;0;0;0;0;0;0;0;0;0;0;0
FR;10;2021-08-20;0;0;0;0;0;0;0;0;0;0;0;0;0;0;0;0;0;0
FR;10;2021-08-21;0;0;0;0;0;0;0;0;0;0;0;0;0;0;0;0;0;0
FR;10;2021-08-22;0;0;0;0;0;0;0;0;0;0;0;0;0;0;0;0;0;0
FR;10;2021-08-23;0;0;0;0;0;0;0;0;0;0;0;0;0;0;0;0;0;0
FR;10;2021-08-24;0;0;0;0;0;0;0;0;0;0;0;0;0;0;0;0;0;0
FR;10;2021-08-25;0;0;0;0;0;0;0;0;0;0;0;0;0;0;0;0;0;0
FR;10;2021-08-26;0;0;0;0;0;0;0;0;0;0;0;0;0;0;0;0;0;0
FR;10;2021-08-27;0;0;0;0;0;0;0;0;0;0;0;0;0;0;0;0;0;0
FR;10;2021-08-28;0;0;0;0;0;0;0;0;0;0;0;0;0;0;0;0;0;0
FR;10;2021-08-29;0;0;0;0;0;0;0;0;0;0;0;0;0;0;0;0;0;0
FR;10;2021-08-30;0;0;0;0;0;0;0;0;0;0;0;0;0;0;0;0;0;0
FR;10;2021-08-31;0;0;0;0;0;0;0;0;0;0;0;0;0;0;0;0;0;0
FR;10;2021-09-01;0;0;0;0;0;0;0;0;0;0;0;0;0;0;0;0;0;0
FR;10;2021-09-02;0;0;0;0;0;0;0;0;0;0;0;0;0;0;0;0;0;0
FR;10;2021-09-03;0;0;0;0;0;0;0;0;0;0;0;0;0;0;0;0;0;0
FR;10;2021-09-04;0;0;0;0;0;0;0;0;0;0;0;0;0;0;0;0;0;0
FR;10;2021-09-05;0;0;0;0;0;0;0;0;0;0;0;0;0;0;0;0;0;0
FR;10;2021-09-06;0;0;0;0;0;0;0;0;0;0;0;0;0;0;0;0;0;0
FR;10;2021-09-07;0;0;0;0;0;0;0;0;0;0;0;0;0;0;0;0;0;0
FR;10;2021-09-08;0;0;0;0;0;0;0;0;0;0;0;0;0;0;0;0;0;0
FR;10;2021-09-09;0;0;0;0;0;0;0;0;0;0;0;0;0;0;0;0;0;0
FR;10;2021-09-10;0;0;0;0;0;0;0;0;0;0;0;0;0;0;0;0;0;0
FR;10;2021-09-11;0;0;0;0;0;0;0;0;0;0;0;0;0;0;0;0;0;0
FR;10;2021-09-12;0;0;0;0;0;0;0;0;0;0;0;0;0;0;0;0;0;0
FR;10;2021-09-13;0;0;0;0;0;0;0;0;0;0;0;0;0;0;0;0;0;0
FR;10;2021-09-14;0;0;0;0;0;0;0;0;0;0;0;0;0;0;0;0;0;0
FR;10;2021-09-15;0;0;0;0;0;0;0;0;0;0;0;0;0;0;0;0;0;0
FR;10;2021-09-16;0;0;0;0;0;0;0;0;0;0;0;0;0;0;0;0;0;0
FR;10;2021-09-17;0;0;0;0;0;0;0;0;0;0;0;0;0;0;0;0;0;0
FR;10;2021-09-18;0;0;0;0;0;0;0;0;0;0;0;0;0;0;0;0;0;0
FR;10;2021-09-19;0;0;0;0;0;0;0;0;0;0;0;0;0;0;0;0;0;0
FR;10;2021-09-20;0;0;0;0;0;0;0;0;0;0;0;0;0;0;0;0;0;0
FR;10;2021-09-21;0;0;0;0;0;0;0;0;0;0;0;0;0;0;0;0;0;0
FR;10;2021-09-22;0;0;0;0;0;0;0;0;0;0;0;0;0;0;0;0;0;0
FR;10;2021-09-23;0;0;0;0;0;0;0;0;0;0;0;0;0;0;0;0;0;0
FR;10;2021-09-24;0;0;0;0;0;0;0;0;0;0;0;0;0;0;0;0;0;0
FR;10;2021-09-25;0;0;0;0;0;0;0;0;0;0;0;0;0;0;0;0;0;0
FR;10;2021-09-26;0;0;0;0;0;0;0;0;0;0;0;0;0;0;0;0;0;0
FR;10;2021-09-27;0;0;0;0;0;0;0;0;0;0;0;0;0;0;0;0;0;0
FR;10;2021-09-28;0;0;0;0;0;0;0;0;0;0;0;0;0;0;0;0;0;0
FR;10;2021-09-29;0;0;0;0;0;0;0;0;0;0;0;0;0;0;0;0;0;0
FR;10;2021-09-30;0;0;0;0;0;0;0;0;0;0;0;0;0;0;0;0;0;0
FR;10;2021-10-01;0;0;0;0;0;0;0;0;0;0;0;0;0;0;0;0;0;0
FR;10;2021-10-02;0;0;0;0;0;0;0;0;0;0;0;0;0;0;0;0;0;0
FR;10;2021-10-03;0;0;0;0;0;0;0;0;0;0;0;0;0;0;0;0;0;0
FR;10;2021-10-04;0;0;0;0;0;0;0;0;0;0;0;0;0;0;0;0;0;0
FR;10;2021-10-05;0;0;0;0;0;0;0;0;0;0;0;0;0;0;0;0;0;0
FR;10;2021-10-06;0;0;0;0;0;0;0;0;0;0;0;0;0;0;0;0;0;0
FR;10;2021-10-07;0;0;0;0;0;0;0;0;0;0;0;0;0;0;0;0;0;0
FR;10;2021-10-08;0;0;0;0;0;0;0;0;0;0;0;0;0;0;0;0;0;0
FR;10;2021-10-09;0;0;0;0;0;0;0;0;0;0;0;0;0;0;0;0;0;0
FR;10;2021-10-10;0;0;0;0;0;0;0;0;0;0;0;0;0;0;0;0;0;0
FR;10;2021-10-11;0;0;0;0;0;0;0;0;0;0;0;0;0;0;0;0;0;0
FR;10;2021-10-12;0;0;0;0;0;0;0;0;0;0;0;0;0;0;0;0;0;0
FR;10;2021-10-13;0;0;0;0;0;0;0;0;0;0;0;0;0;0;0;0;0;0
FR;10;2021-10-14;0;0;0;0;0;0;0;0;0;0;0;0;0;0;0;0;0;0
FR;10;2021-10-15;0;0;0;0;0;0;0;0;0;0;0;0;0;0;0;0;0;0
FR;10;2021-10-16;0;0;0;0;0;0;0;0;0;0;0;0;0;0;0;0;0;0
FR;10;2021-10-17;0;0;0;0;0;0;0;0;0;0;0;0;0;0;0;0;0;0
FR;10;2021-10-18;0;0;0;0;0;0;0;0;0;0;0;0;0;0;0;0;0;0
FR;10;2021-10-19;0;0;0;0;0;0;0;0;0;0;0;0;0;0;0;0;0;0
FR;10;2021-10-20;0;0;0;0;0;0;0;0;0;0;0;0;0;0;0;0;0;0
FR;10;2021-10-21;0;0;0;0;0;0;0;0;0;0;0;0;0;0;0;0;0;0
FR;10;2021-10-22;0;0;0;0;0;0;0;0;0;0;0;0;0;0;0;0;0;0
FR;10;2021-10-23;0;0;0;0;0;0;0;0;0;0;0;0;0;0;0;0;0;0
FR;10;2021-10-24;0;0;0;0;0;0;0;0;0;0;0;0;0;0;0;0;0;0
FR;10;2021-10-25;0;0;0;0;0;0;0;0;0;0;0;0;0;0;0;0;0;0
FR;10;2021-10-26;0;0;0;0;0;0;0;0;0;0;0;0;0;0;0;0;0;0
FR;10;2021-10-27;0;0;0;0;0;0;0;0;0;0;0;0;0;0;0;0;0;0
FR;10;2021-10-28;0;0;0;0;0;0;0;0;0;0;0;0;0;0;0;0;0;0
FR;10;2021-10-29;0;0;0;0;0;0;0;0;0;0;0;0;0;0;0;0;0;0
FR;10;2021-10-30;0;0;0;0;0;0;0;0;0;0;0;0;0;0;0;0;0;0
FR;10;2021-10-31;0;0;0;0;0;0;0;0;0;0;0;0;0;0;0;0;0;0
FR;10;2021-11-01;0;0;0;0;0;0;0;0;0;0;0;0;0;0;0;0;0;0
FR;10;2021-11-02;0;0;0;0;0;0;0;0;0;0;0;0;0;0;0;0;0;0
FR;10;2021-11-03;0;0;0;0;0;0;0;0;0;0;0;0;0;0;0;0;0;0
FR;10;2021-11-04;0;0;0;0;0;0;0;0;0;0;0;0;0;0;0;0;0;0
FR;10;2021-11-05;0;0;0;0;0;0;0;0;0;0;0;0;0;0;0;0;0;0
FR;10;2021-11-06;0;0;0;0;0;0;0;0;0;0;0;0;0;0;0;0;0;0
FR;10;2021-11-07;0;0;0;0;0;0;0;0;0;0;0;0;0;0;0;0;0;0
FR;10;2021-11-08;0;0;0;0;0;0;0;0;0;0;0;0;0;0;0;0;0;0
FR;10;2021-11-09;0;0;0;0;0;0;0;0;0;0;0;0;0;0;0;0;0;0
FR;10;2021-11-10;0;0;0;0;0;0;0;0;0;0;0;0;0;0;0;0;0;0
FR;10;2021-11-11;0;0;0;0;0;0;0;0;0;0;0;0;0;0;0;0;0;0
FR;10;2021-11-12;0;0;0;0;0;0;0;0;0;0;0;0;0;0;0;0;0;0
FR;10;2021-11-13;0;0;0;0;0;0;0;0;0;0;0;0;0;0;0;0;0;0
FR;10;2021-11-14;0;0;0;0;0;0;0;0;0;0;0;0;0;0;0;0;0;0
FR;10;2021-11-15;0;0;0;0;0;0;0;0;0;0;0;0;0;0;0;0;0;0
FR;10;2021-11-16;0;0;0;0;0;0;0;0;0;0;0;0;0;0;0;0;0;0
FR;10;2021-11-17;0;0;0;0;0;0;0;0;0;0;0;0;0;0;0;0;0;0
FR;10;2021-11-18;0;0;0;0;0;0;0;0;0;0;0;0;0;0;0;0;0;0
FR;10;2021-11-19;0;0;0;0;0;0;0;0;0;0;0;0;0;0;0;0;0;0
FR;10;2021-11-20;0;0;0;0;0;0;0;0;0;0;0;0;0;0;0;0;0;0
FR;10;2021-11-21;0;0;0;0;0;0;0;0;0;0;0;0;0;0;0;0;0;0
FR;10;2021-11-22;0;0;0;0;0;0;0;0;0;0;0;0;0;0;0;0;0;0
FR;10;2021-11-23;0;0;0;0;0;0;0;0;0;0;0;0;0;0;0;0;0;0
FR;10;2021-11-24;0;0;0;0;0;0;0;0;0;0;0;0;0;0;0;0;0;0
FR;10;2021-11-25;0;0;0;0;0;0;0;0;0;0;0;0;0;0;0;0;0;0
FR;10;2021-11-26;0;0;0;0;0;0;0;0;0;0;0;0;0;0;0;0;0;0
FR;10;2021-11-27;0;0;0;0;0;0;0;0;0;0;0;0;0;0;0;0;0;0
FR;10;2021-11-28;0;0;0;0;0;0;0;0;0;0;0;0;0;0;0;0;0;0
FR;10;2021-11-29;0;0;0;0;0;0;0;0;0;0;0;0;0;0;0;0;0;0
FR;10;2021-11-30;0;0;0;0;0;0;0;0;0;0;0;0;0;0;0;0;0;0
FR;10;2021-12-01;0;0;0;0;0;0;0;0;0;0;0;0;0;0;0;0;0;0
FR;10;2021-12-02;0;0;0;0;0;0;0;0;0;0;0;0;0;0;0;0;0;0
FR;10;2021-12-03;0;0;0;0;0;0;0;0;0;0;0;0;0;0;0;0;0;0
FR;10;2021-12-04;0;0;0;0;0;0;0;0;0;0;0;0;0;0;0;0;0;0
FR;10;2021-12-05;0;0;0;0;0;0;0;0;0;0;0;0;0;0;0;0;0;0
FR;10;2021-12-06;0;0;0;0;0;0;0;0;0;0;0;0;0;0;0;0;0;0
FR;10;2021-12-07;0;0;0;0;0;0;0;0;0;0;0;0;0;0;0;0;0;0
FR;10;2021-12-08;0;0;0;0;0;0;0;0;0;0;0;0;0;0;0;0;0;0
FR;10;2021-12-09;0;0;0;0;0;0;0;0;0;0;0;0;0;0;0;0;0;0
FR;10;2021-12-10;0;0;0;0;0;0;0;0;0;0;0;0;0;0;0;0;0;0
FR;10;2021-12-11;0;0;0;0;0;0;0;0;0;0;0;0;0;0;0;0;0;0
FR;10;2021-12-12;0;0;0;0;0;0;0;0;0;0;0;0;0;0;0;0;0;0
FR;10;2021-12-13;0;0;0;0;0;0;0;0;0;0;0;0;0;0;0;0;0;0
FR;10;2021-12-14;0;0;0;0;0;0;0;0;0;0;0;0;0;0;0;0;0;0
FR;10;2021-12-15;0;0;0;0;0;0;0;0;0;0;0;0;0;0;0;0;0;0
FR;10;2021-12-16;0;0;0;0;0;0;0;0;0;0;0;0;0;0;0;0;0;0
FR;10;2021-12-17;0;0;0;0;0;0;0;0;0;0;0;0;0;0;0;0;0;0
FR;10;2021-12-18;0;0;0;0;0;0;0;0;0;0;0;0;0;0;0;0;0;0
FR;10;2021-12-19;0;0;0;0;0;0;0;0;0;0;0;0;0;0;0;0;0;0
FR;10;2021-12-20;0;0;0;0;0;0;0;0;0;0;0;0;0;0;0;0;0;0
FR;10;2021-12-21;0;0;0;0;0;0;0;0;0;0;0;0;0;0;0;0;0;0
FR;10;2021-12-22;0;0;0;0;0;0;0;0;0;0;0;0;0;0;0;0;0;0
FR;10;2021-12-23;0;0;0;0;0;0;0;0;0;0;0;0;0;0;0;0;0;0
FR;10;2021-12-24;0;0;0;0;0;0;0;0;0;0;0;0;0;0;0;0;0;0
FR;10;2021-12-25;0;0;0;0;0;0;0;0;0;0;0;0;0;0;0;0;0;0
FR;10;2021-12-26;0;0;0;0;0;0;0;0;0;0;0;0;0;0;0;0;0;0
FR;10;2021-12-27;0;0;0;0;0;0;0;0;0;0;0;0;0;0;0;0;0;0
FR;10;2021-12-28;0;0;0;0;0;0;0;0;0;0;0;0;0;0;0;0;0;0
FR;10;2021-12-29;0;0;0;0;0;0;0;0;0;0;0;0;0;0;0;0;0;0
FR;10;2021-12-30;0;0;0;0;0;0;0;0;0;0;0;0;0;0;0;0;0;0
FR;10;2021-12-31;0;0;0;0;0;0;0;0;0;0;0;0;0;0;0;0;0;0
FR;10;2022-01-01;0;0;0;0;0;0;0;0;0;0;0;0;0;0;0;0;0;0
FR;10;2022-01-02;0;0;0;0;0;0;0;0;0;0;0;0;0;0;0;0;0;0
FR;10;2022-01-03;0;0;0;0;0;0;0;0;0;0;0;0;0;0;0;0;0;0
FR;10;2022-01-04;0;0;0;0;0;0;0;0;0;0;0;0;0;0;0;0;0;0
FR;10;2022-01-05;0;0;0;0;0;0;0;0;0;0;0;0;0;0;0;0;0;0
FR;10;2022-01-06;0;0;0;0;0;0;0;0;0;0;0;0;0;0;0;0;0;0
FR;10;2022-01-07;0;0;0;0;0;0;0;0;0;0;0;0;0;0;0;0;0;0
FR;10;2022-01-08;0;0;0;0;0;0;0;0;0;0;0;0;0;0;0;0;0;0
FR;10;2022-01-09;0;0;0;0;0;0;0;0;0;0;0;0;0;0;0;0;0;0
FR;10;2022-01-10;0;0;0;0;0;0;0;0;0;0;0;0;0;0;0;0;0;0
FR;10;2022-01-11;0;0;0;0;0;0;0;0;0;0;0;0;0;0;0;0;0;0
FR;10;2022-01-12;0;0;0;0;0;0;0;0;0;0;0;0;0;0;0;0;0;0
FR;10;2022-01-13;0;0;0;0;0;0;0;0;0;0;0;0;0;0;0;0;0;0
FR;10;2022-01-14;0;0;0;0;0;0;0;0;0;0;0;0;0;0;0;0;0;0
FR;10;2022-01-15;0;0;0;0;0;0;0;0;0;0;0;0;0;0;0;0;0;0
FR;10;2022-01-16;0;0;0;0;0;0;0;0;0;0;0;0;0;0;0;0;0;0
FR;10;2022-01-17;0;0;0;0;0;0;0;0;0;0;0;0;0;0;0;0;0;0
FR;10;2022-01-18;0;0;0;0;0;0;0;0;0;0;0;0;0;0;0;0;0;0
FR;10;2022-01-19;0;0;0;0;0;0;0;0;0;0;0;0;0;0;0;0;0;0
FR;10;2022-01-20;0;0;0;0;0;0;0;0;0;0;0;0;0;0;0;0;0;0
FR;10;2022-01-21;0;0;0;0;0;0;0;0;0;0;0;0;0;0;0;0;0;0
FR;10;2022-01-22;0;0;0;0;0;0;0;0;0;0;0;0;0;0;0;0;0;0
FR;10;2022-01-23;0;0;0;0;0;0;0;0;0;0;0;0;0;0;0;0;0;0
FR;10;2022-01-24;0;0;0;0;0;0;0;0;0;0;0;0;0;0;0;0;0;0
FR;10;2022-01-25;0;0;0;0;0;0;0;0;0;0;0;0;0;0;0;0;0;0
FR;10;2022-01-26;0;0;0;0;0;0;0;0;0;0;0;0;0;0;0;0;0;0
FR;10;2022-01-27;0;0;0;0;0;0;0;0;0;0;0;0;0;0;0;0;0;0
FR;10;2022-01-28;0;0;0;0;0;0;0;0;0;0;0;0;0;0;0;0;0;0
FR;10;2022-01-29;0;0;0;0;0;0;0;0;0;0;0;0;0;0;0;0;0;0
FR;10;2022-01-30;0;0;0;0;0;0;0;0;0;0;0;0;0;0;0;0;0;0
FR;10;2022-01-31;0;0;0;0;0;0;0;0;0;0;0;0;0;0;0;0;0;0
FR;10;2022-02-01;0;0;0;0;0;0;0;0;0;0;0;0;0;0;0;0;0;0
FR;10;2022-02-02;0;0;0;0;0;0;0;0;0;0;0;0;0;0;0;0;0;0
FR;10;2022-02-03;0;0;0;0;0;0;0;0;0;0;0;0;0;0;0;0;0;0
FR;10;2022-02-04;0;0;0;0;0;0;0;0;0;0;0;0;0;0;0;0;0;0
FR;10;2022-02-05;0;0;0;0;0;0;0;0;0;0;0;0;0;0;0;0;0;0
FR;10;2022-02-06;0;0;0;0;0;0;0;0;0;0;0;0;0;0;0;0;0;0
FR;10;2022-02-07;0;0;0;0;0;0;0;0;0;0;0;0;0;0;0;0;0;0
FR;10;2022-02-08;0;0;0;0;0;0;0;0;0;0;0;0;0;0;0;0;0;0
FR;10;2022-02-09;0;0;0;0;0;0;0;0;0;0;0;0;0;0;0;0;0;0
FR;10;2022-02-10;0;0;0;0;0;0;0;0;0;0;0;0;0;0;0;0;0;0
FR;10;2022-02-11;0;0;0;0;0;0;0;0;0;0;0;0;0;0;0;0;0;0
FR;10;2022-02-12;0;0;0;0;0;0;0;0;0;0;0;0;0;0;0;0;0;0
FR;10;2022-02-13;0;0;0;0;0;0;0;0;0;0;0;0;0;0;0;0;0;0
FR;10;2022-02-14;0;0;0;0;0;0;0;0;0;0;0;0;0;0;0;0;0;0
FR;10;2022-02-15;0;0;0;0;0;0;0;0;0;0;0;0;0;0;0;0;0;0
FR;10;2022-02-16;0;0;0;0;0;0;0;0;0;0;0;0;0;0;0;0;0;0
FR;10;2022-02-17;0;0;0;0;0;0;0;0;0;0;0;0;0;0;0;0;0;0
FR;10;2022-02-18;0;0;0;0;0;0;0;0;0;0;0;0;0;0;0;0;0;0
FR;10;2022-02-19;0;0;0;0;0;0;0;0;0;0;0;0;0;0;0;0;0;0
FR;10;2022-02-20;0;0;0;0;0;0;0;0;0;0;0;0;0;0;0;0;0;0
FR;10;2022-02-21;0;0;0;0;0;0;0;0;0;0;0;0;0;0;0;0;0;0
FR;10;2022-02-22;0;0;0;0;0;0;0;0;0;0;0;0;0;0;0;0;0;0
FR;10;2022-02-23;0;0;0;0;0;0;0;0;0;0;0;0;0;0;0;0;0;0
FR;10;2022-02-24;0;0;0;0;0;0;0;0;0;0;0;0;0;0;0;0;0;0
FR;10;2022-02-25;0;0;0;0;0;0;0;0;0;0;0;0;0;0;0;0;0;0
FR;10;2022-02-26;0;0;0;0;0;0;0;0;0;0;0;0;0;0;0;0;0;0
FR;10;2022-02-27;0;0;0;0;0;0;0;0;0;0;0;0;0;0;0;0;0;0
FR;10;2022-02-28;0;0;0;0;0;0;0;0;0;0;0;0;0;0;0;0;0;0
FR;10;2022-03-01;0;0;0;0;0;0;0;0;0;0;0;0;0;0;0;0;0;0
FR;10;2022-03-02;0;0;0;0;0;0;0;0;0;0;0;0;0;0;0;0;0;0
FR;10;2022-03-03;0;0;0;0;0;0;0;0;0;0;0;0;0;0;0;0;0;0
FR;10;2022-03-04;0;0;0;0;0;0;0;0;0;0;0;0;0;0;0;0;0;0
FR;10;2022-03-05;0;0;0;0;0;0;0;0;0;0;0;0;0;0;0;0;0;0
FR;10;2022-03-06;0;0;0;0;0;0;0;0;0;0;0;0;0;0;0;0;0;0
FR;10;2022-03-07;0;0;0;0;0;0;0;0;0;0;0;0;0;0;0;0;0;0
FR;10;2022-03-08;0;0;0;0;0;0;0;0;0;0;0;0;0;0;0;0;0;0
FR;10;2022-03-09;0;0;0;0;0;0;0;0;0;0;0;0;0;0;0;0;0;0
FR;10;2022-03-10;0;0;0;0;0;0;0;0;0;0;0;0;0;0;0;0;0;0
FR;10;2022-03-11;0;0;0;0;0;0;0;0;0;0;0;0;0;0;0;0;0;0
FR;10;2022-03-12;0;0;0;0;0;0;0;0;0;0;0;0;0;0;0;0;0;0
FR;10;2022-03-13;0;0;0;0;0;0;0;0;0;0;0;0;0;0;0;0;0;0
FR;10;2022-03-14;0;0;0;0;0;0;0;0;0;0;0;0;0;0;0;0;0;0
FR;10;2022-03-15;0;0;0;0;0;0;0;0;0;0;0;0;0;0;0;0;0;0
FR;10;2022-03-16;0;0;0;0;0;0;0;0;0;0;0;0;0;0;0;0;0;0
FR;10;2022-03-17;0;0;0;0;0;0;0;0;0;0;0;0;0;0;0;0;0;0
FR;10;2022-03-18;0;0;0;0;0;0;0;0;0;0;0;0;0;0;0;0;0;0
FR;10;2022-03-19;0;0;0;0;0;0;0;0;0;0;0;0;0;0;0;0;0;0
FR;10;2022-03-20;0;0;0;0;0;0;0;0;0;0;0;0;0;0;0;0;0;0
FR;10;2022-03-21;0;0;0;0;0;0;0;0;0;0;0;0;0;0;0;0;0;0
FR;10;2022-03-22;0;0;0;0;0;0;0;0;0;0;0;0;0;0;0;0;0;0
FR;10;2022-03-23;0;0;0;0;0;0;0;0;0;0;0;0;0;0;0;0;0;0
FR;10;2022-03-24;0;0;0;0;0;0;0;0;0;0;0;0;0;0;0;0;0;0
FR;10;2022-03-25;0;0;0;0;0;0;0;0;0;0;0;0;0;0;0;0;0;0
FR;10;2022-03-26;0;0;0;0;0;0;0;0;0;0;0;0;0;0;0;0;0;0
FR;10;2022-03-27;0;0;0;0;0;0;0;0;0;0;0;0;0;0;0;0;0;0
FR;10;2022-03-28;0;0;0;0;0;0;0;0;0;0;0;0;0;0;0;0;0;0
FR;10;2022-03-29;0;0;0;0;0;0;0;0;0;0;0;0;0;0;0;0;0;0
FR;10;2022-03-30;0;0;0;0;0;0;0;0;0;0;0;0;0;0;0;0;0;0
FR;10;2022-03-31;0;0;0;0;0;0;0;0;0;0;0;0;0;0;0;0;0;0
FR;10;2022-04-01;0;0;0;0;0;0;0;0;0;0;0;0;0;0;0;0;0;0
FR;10;2022-04-02;0;0;0;0;0;0;0;0;0;0;0;0;0;0;0;0;0;0
FR;10;2022-04-03;0;0;0;0;0;0;0;0;0;0;0;0;0;0;0;0;0;0
FR;10;2022-04-04;0;0;0;0;0;0;0;0;0;0;0;0;0;0;0;0;0;0
FR;10;2022-04-05;0;0;0;0;0;0;0;0;0;0;0;0;0;0;0;0;0;0
FR;10;2022-04-06;0;0;0;0;0;0;0;0;0;0;0;0;0;0;0;0;0;0
FR;10;2022-04-07;0;0;0;0;0;0;0;0;0;0;0;0;0;0;0;0;0;0
FR;10;2022-04-08;0;0;0;0;0;0;0;0;0;0;0;0;0;0;0;0;0;0
FR;10;2022-04-09;0;0;0;0;0;0;0;0;0;0;0;0;0;0;0;0;0;0
FR;10;2022-04-10;0;0;0;0;0;0;0;0;0;0;0;0;0;0;0;0;0;0
FR;10;2022-04-11;0;0;0;0;0;0;0;0;0;0;0;0;0;0;0;0;0;0
FR;10;2022-04-12;0;0;0;0;0;0;0;0;0;0;0;0;0;0;0;0;0;0
FR;10;2022-04-13;0;0;0;0;0;0;0;0;0;0;0;0;0;0;0;0;0;0
FR;10;2022-04-14;0;0;0;0;0;0;0;0;0;0;0;0;0;0;0;0;0;0
FR;10;2022-04-15;0;0;0;0;0;0;0;0;0;0;0;0;0;0;0;0;0;0
FR;10;2022-04-16;0;0;0;0;0;0;0;0;0;0;0;0;0;0;0;0;0;0
FR;10;2022-04-17;0;0;0;0;0;0;0;0;0;0;0;0;0;0;0;0;0;0
FR;10;2022-04-18;0;0;0;0;0;0;0;0;0;0;0;0;0;0;0;0;0;0
FR;10;2022-04-19;0;0;0;0;0;0;0;0;0;0;0;0;0;0;0;0;0;0
FR;10;2022-04-20;0;0;0;0;0;0;0;0;0;0;0;0;0;0;0;0;0;0
FR;10;2022-04-21;0;0;0;0;0;0;0;0;0;0;0;0;0;0;0;0;0;0
FR;10;2022-04-22;0;0;0;0;0;0;0;0;0;0;0;0;0;0;0;0;0;0
FR;10;2022-04-23;0;0;0;0;0;0;0;0;0;0;0;0;0;0;0;0;0;0
FR;10;2022-04-24;0;0;0;0;0;0;0;0;0;0;0;0;0;0;0;0;0;0
FR;10;2022-04-25;0;0;0;0;0;0;0;0;0;0;0;0;0;0;0;0;0;0
FR;10;2022-04-26;0;0;0;0;0;0;0;0;0;0;0;0;0;0;0;0;0;0
FR;10;2022-04-27;0;0;0;0;0;0;0;0;0;0;0;0;0;0;0;0;0;0
FR;10;2022-04-28;0;0;0;0;0;0;0;0;0;0;0;0;0;0;0;0;0;0
FR;10;2022-04-29;0;0;0;0;0;0;0;0;0;0;0;0;0;0;0;0;0;0
FR;10;2022-04-30;0;0;0;0;0;0;0;0;0;0;0;0;0;0;0;0;0;0
FR;10;2022-05-01;0;0;0;0;0;0;0;0;0;0;0;0;0;0;0;0;0;0
FR;10;2022-05-02;0;0;0;0;0;0;0;0;0;0;0;0;0;0;0;0;0;0
FR;10;2022-05-03;0;0;0;0;0;0;0;0;0;0;0;0;0;0;0;0;0;0
FR;10;2022-05-04;0;0;0;0;0;0;0;0;0;0;0;0;0;0;0;0;0;0
FR;10;2022-05-05;0;0;0;0;0;0;0;0;0;0;0;0;0;0;0;0;0;0
FR;10;2022-05-06;0;0;0;0;0;0;0;0;0;0;0;0;0;0;0;0;0;0
FR;10;2022-05-07;0;0;0;0;0;0;0;0;0;0;0;0;0;0;0;0;0;0
FR;10;2022-05-08;0;0;0;0;0;0;0;0;0;0;0;0;0;0;0;0;0;0
FR;10;2022-05-09;0;0;0;0;0;0;0;0;0;0;0;0;0;0;0;0;0;0
FR;10;2022-05-10;0;0;0;0;0;0;0;0;0;0;0;0;0;0;0;0;0;0
FR;10;2022-05-11;0;0;0;0;0;0;0;0;0;0;0;0;0;0;0;0;0;0
FR;10;2022-05-12;0;0;0;0;0;0;0;0;0;0;0;0;0;0;0;0;0;0
FR;10;2022-05-13;0;0;0;0;0;0;0;0;0;0;0;0;0;0;0;0;0;0
FR;10;2022-05-14;0;0;0;0;0;0;0;0;0;0;0;0;0;0;0;0;0;0
FR;10;2022-05-15;0;0;0;0;0;0;0;0;0;0;0;0;0;0;0;0;0;0
FR;10;2022-05-16;0;0;0;0;0;0;0;0;0;0;0;0;0;0;0;0;0;0
FR;10;2022-05-17;0;0;0;0;0;0;0;0;0;0;0;0;0;0;0;0;0;0
FR;10;2022-05-18;0;0;0;0;0;0;0;0;0;0;0;0;0;0;0;0;0;0
FR;10;2022-05-19;0;0;0;0;0;0;0;0;0;0;0;0;0;0;0;0;0;0
FR;10;2022-05-20;0;0;0;0;0;0;0;0;0;0;0;0;0;0;0;0;0;0
FR;10;2022-05-21;0;0;0;0;0;0;0;0;0;0;0;0;0;0;0;0;0;0
FR;10;2022-05-22;0;0;0;0;0;0;0;0;0;0;0;0;0;0;0;0;0;0
FR;10;2022-05-23;0;0;0;0;0;0;0;0;0;0;0;0;0;0;0;0;0;0
FR;10;2022-05-24;0;0;0;0;0;0;0;0;0;0;0;0;0;0;0;0;0;0
FR;10;2022-05-25;0;0;0;0;0;0;0;0;0;0;0;0;0;0;0;0;0;0
FR;10;2022-05-26;0;0;0;0;0;0;0;0;0;0;0;0;0;0;0;0;0;0
FR;10;2022-05-27;0;0;0;0;0;0;0;0;0;0;0;0;0;0;0;0;0;0
FR;10;2022-05-28;0;0;0;0;0;0;0;0;0;0;0;0;0;0;0;0;0;0
FR;10;2022-05-29;0;0;0;0;0;0;0;0;0;0;0;0;0;0;0;0;0;0
FR;10;2022-05-30;0;0;0;0;0;0;0;0;0;0;0;0;0;0;0;0;0;0
FR;10;2022-05-31;0;0;0;0;0;0;0;0;0;0;0;0;0;0;0;0;0;0
FR;10;2022-06-01;0;0;0;0;0;0;0;0;0;0;0;0;0;0;0;0;0;0
FR;10;2022-06-02;0;0;0;0;0;0;0;0;0;0;0;0;0;0;0;0;0;0
FR;10;2022-06-03;0;0;0;0;0;0;0;0;0;0;0;0;0;0;0;0;0;0
FR;10;2022-06-04;0;0;0;0;0;0;0;0;0;0;0;0;0;0;0;0;0;0
FR;10;2022-06-05;0;0;0;0;0;0;0;0;0;0;0;0;0;0;0;0;0;0
FR;10;2022-06-06;0;0;0;0;0;0;0;0;0;0;0;0;0;0;0;0;0;0
FR;10;2022-06-07;0;0;0;0;0;0;0;0;0;0;0;0;0;0;0;0;0;0
FR;10;2022-06-08;0;0;0;0;0;0;0;0;0;0;0;0;0;0;0;0;0;0
FR;10;2022-06-09;0;0;0;0;0;0;0;0;0;0;0;0;0;0;0;0;0;0
FR;10;2022-06-10;0;0;0;0;0;0;0;0;0;0;0;0;0;0;0;0;0;0
FR;10;2022-06-11;0;0;0;0;0;0;0;0;0;0;0;0;0;0;0;0;0;0
FR;10;2022-06-12;0;0;0;0;0;0;0;0;0;0;0;0;0;0;0;0;0;0
FR;10;2022-06-13;0;0;0;0;0;0;0;0;0;0;0;0;0;0;0;0;0;0
FR;10;2022-06-14;0;0;0;0;0;0;0;0;0;0;0;0;0;0;0;0;0;0
FR;10;2022-06-15;0;0;0;0;0;0;0;0;0;0;0;0;0;0;0;0;0;0
FR;10;2022-06-16;0;0;0;0;0;0;0;0;0;0;0;0;0;0;0;0;0;0
FR;10;2022-06-17;0;0;0;0;0;0;0;0;0;0;0;0;0;0;0;0;0;0
FR;10;2022-06-18;0;0;0;0;0;0;0;0;0;0;0;0;0;0;0;0;0;0
FR;10;2022-06-19;0;0;0;0;0;0;0;0;0;0;0;0;0;0;0;0;0;0
FR;10;2022-06-20;0;0;0;0;0;0;0;0;0;0;0;0;0;0;0;0;0;0
FR;10;2022-06-21;0;0;0;0;0;0;0;0;0;0;0;0;0;0;0;0;0;0
FR;10;2022-06-22;0;0;0;0;0;0;0;0;0;0;0;0;0;0;0;0;0;0
FR;10;2022-06-23;0;0;0;0;0;0;0;0;0;0;0;0;0;0;0;0;0;0
FR;10;2022-06-24;0;0;0;0;0;0;0;0;0;0;0;0;0;0;0;0;0;0
FR;10;2022-06-25;0;0;0;0;0;0;0;0;0;0;0;0;0;0;0;0;0;0
FR;10;2022-06-26;0;0;0;0;0;0;0;0;0;0;0;0;0;0;0;0;0;0
FR;10;2022-06-27;0;0;0;0;0;0;0;0;0;0;0;0;0;0;0;0;0;0
FR;10;2022-06-28;0;0;0;0;0;0;0;0;0;0;0;0;0;0;0;0;0;0
FR;10;2022-06-29;0;0;0;0;0;0;0;0;0;0;0;0;0;0;0;0;0;0
FR;10;2022-06-30;0;0;0;0;0;0;0;0;0;0;0;0;0;0;0;0;0;0
FR;10;2022-07-01;0;0;0;0;0;0;0;0;0;0;0;0;0;0;0;0;0;0
FR;10;2022-07-02;0;0;0;0;0;0;0;0;0;0;0;0;0;0;0;0;0;0
FR;10;2022-07-03;0;0;0;0;0;0;0;0;0;0;0;0;0;0;0;0;0;0
FR;10;2022-07-04;0;0;0;0;0;0;0;0;0;0;0;0;0;0;0;0;0;0
FR;10;2022-07-05;0;0;0;0;0;0;0;0;0;0;0;0;0;0;0;0;0;0
FR;10;2022-07-06;0;0;0;0;0;0;0;0;0;0;0;0;0;0;0;0;0;0
FR;10;2022-07-07;0;0;0;0;0;0;0;0;0;0;0;0;0;0;0;0;0;0
FR;10;2022-07-08;0;0;0;0;0;0;0;0;0;0;0;0;0;0;0;0;0;0
FR;10;2022-07-09;0;0;0;0;0;0;0;0;0;0;0;0;0;0;0;0;0;0
FR;10;2022-07-10;0;0;0;0;0;0;0;0;0;0;0;0;0;0;0;0;0;0
FR;10;2022-07-11;0;0;0;0;0;0;0;0;0;0;0;0;0;0;0;0;0;0
FR;10;2022-07-12;0;0;0;0;0;0;0;0;0;0;0;0;0;0;0;0;0;0
FR;10;2022-07-13;0;0;0;0;0;0;0;0;0;0;0;0;0;0;0;0;0;0
FR;10;2022-07-14;0;0;0;0;0;0;0;0;0;0;0;0;0;0;0;0;0;0
FR;10;2022-07-15;0;0;0;0;0;0;0;0;0;0;0;0;0;0;0;0;0;0
FR;10;2022-07-16;0;0;0;0;0;0;0;0;0;0;0;0;0;0;0;0;0;0
FR;10;2022-07-17;0;0;0;0;0;0;0;0;0;0;0;0;0;0;0;0;0;0
FR;10;2022-07-18;0;0;0;0;0;0;0;0;0;0;0;0;0;0;0;0;0;0
FR;10;2022-07-19;0;0;0;0;0;0;0;0;0;0;0;0;0;0;0;0;0;0
FR;10;2022-07-20;0;0;0;0;0;0;0;0;0;0;0;0;0;0;0;0;0;0
FR;10;2022-07-21;0;0;0;0;0;0;0;0;0;0;0;0;0;0;0;0;0;0
FR;10;2022-07-22;0;0;0;0;0;0;0;0;0;0;0;0;0;0;0;0;0;0
FR;10;2022-07-23;0;0;0;0;0;0;0;0;0;0;0;0;0;0;0;0;0;0
FR;10;2022-07-24;0;0;0;0;0;0;0;0;0;0;0;0;0;0;0;0;0;0
FR;10;2022-07-25;0;0;0;0;0;0;0;0;0;0;0;0;0;0;0;0;0;0
FR;10;2022-07-26;0;0;0;0;0;0;0;0;0;0;0;0;0;0;0;0;0;0
FR;10;2022-07-27;0;0;0;0;0;0;0;0;0;0;0;0;0;0;0;0;0;0
FR;10;2022-07-28;0;0;0;0;0;0;0;0;0;0;0;0;0;0;0;0;0;0
FR;10;2022-07-29;0;0;0;0;0;0;0;0;0;0;0;0;0;0;0;0;0;0
FR;10;2022-07-30;0;0;0;0;0;0;0;0;0;0;0;0;0;0;0;0;0;0
FR;10;2022-07-31;0;0;0;0;0;0;0;0;0;0;0;0;0;0;0;0;0;0
FR;10;2022-08-01;0;0;0;0;0;0;0;0;0;0;0;0;0;0;0;0;0;0
FR;10;2022-08-02;0;0;0;0;0;0;0;0;0;0;0;0;0;0;0;0;0;0
FR;10;2022-08-03;0;0;0;0;0;0;0;0;0;0;0;0;0;0;0;0;0;0
FR;10;2022-08-04;0;0;0;0;0;0;0;0;0;0;0;0;0;0;0;0;0;0
FR;10;2022-08-05;0;0;0;0;0;0;0;0;0;0;0;0;0;0;0;0;0;0
FR;10;2022-08-06;0;0;0;0;0;0;0;0;0;0;0;0;0;0;0;0;0;0
FR;10;2022-08-07;0;0;0;0;0;0;0;0;0;0;0;0;0;0;0;0;0;0
FR;10;2022-08-08;0;0;0;0;0;0;0;0;0;0;0;0;0;0;0;0;0;0
FR;10;2022-08-09;0;0;0;0;0;0;0;0;0;0;0;0;0;0;0;0;0;0
FR;10;2022-08-10;0;0;0;0;0;0;0;0;0;0;0;0;0;0;0;0;0;0
FR;10;2022-08-11;0;0;0;0;0;0;0;0;0;0;0;0;0;0;0;0;0;0
FR;10;2022-08-12;0;0;0;0;0;0;0;0;0;0;0;0;0;0;0;0;0;0
FR;10;2022-08-13;0;0;0;0;0;0;0;0;0;0;0;0;0;0;0;0;0;0
FR;10;2022-08-14;0;0;0;0;0;0;0;0;0;0;0;0;0;0;0;0;0;0
FR;10;2022-08-15;0;0;0;0;0;0;0;0;0;0;0;0;0;0;0;0;0;0
FR;10;2022-08-16;0;0;0;0;0;0;0;0;0;0;0;0;0;0;0;0;0;0
FR;10;2022-08-17;0;0;0;0;0;0;0;0;0;0;0;0;0;0;0;0;0;0
FR;10;2022-08-18;0;0;0;0;0;0;0;0;0;0;0;0;0;0;0;0;0;0
FR;10;2022-08-19;0;0;0;0;0;0;0;0;0;0;0;0;0;0;0;0;0;0
FR;10;2022-08-20;0;0;0;0;0;0;0;0;0;0;0;0;0;0;0;0;0;0
FR;10;2022-08-21;0;0;0;0;0;0;0;0;0;0;0;0;0;0;0;0;0;0
FR;10;2022-08-22;0;0;0;0;0;0;0;0;0;0;0;0;0;0;0;0;0;0
FR;10;2022-08-23;0;0;0;0;0;0;0;0;0;0;0;0;0;0;0;0;0;0
FR;10;2022-08-24;0;0;0;0;0;0;0;0;0;0;0;0;0;0;0;0;0;0
FR;10;2022-08-25;0;0;0;0;0;0;0;0;0;0;0;0;0;0;0;0;0;0
FR;10;2022-08-26;0;0;0;0;0;0;0;0;0;0;0;0;0;0;0;0;0;0
FR;10;2022-08-27;0;0;0;0;0;0;0;0;0;0;0;0;0;0;0;0;0;0
FR;10;2022-08-28;0;0;0;0;0;0;0;0;0;0;0;0;0;0;0;0;0;0
FR;10;2022-08-29;0;0;0;0;0;0;0;0;0;0;0;0;0;0;0;0;0;0
FR;10;2022-08-30;0;0;0;0;0;0;0;0;0;0;0;0;0;0;0;0;0;0
FR;10;2022-08-31;0;0;0;0;0;0;0;0;0;0;0;0;0;0;0;0;0;0
FR;10;2022-09-01;0;0;0;0;0;0;0;0;0;0;0;0;0;0;0;0;0;0
FR;10;2022-09-02;0;0;0;0;0;0;0;0;0;0;0;0;0;0;0;0;0;0
FR;10;2022-09-03;0;0;0;0;0;0;0;0;0;0;0;0;0;0;0;0;0;0
FR;10;2022-09-04;0;0;0;0;0;0;0;0;0;0;0;0;0;0;0;0;0;0
FR;10;2022-09-05;0;0;0;0;0;0;0;0;0;0;0;0;0;0;0;0;0;0
FR;10;2022-09-06;0;0;0;0;0;0;0;0;0;0;0;0;0;0;0;0;0;0
FR;10;2022-09-07;0;0;0;0;0;0;0;0;0;0;0;0;0;0;0;0;0;0
FR;10;2022-09-08;0;0;0;0;0;0;0;0;0;0;0;0;0;0;0;0;0;0
FR;10;2022-09-09;0;0;0;0;0;0;0;0;0;0;0;0;0;0;0;0;0;0
FR;10;2022-09-10;0;0;0;0;0;0;0;0;0;0;0;0;0;0;0;0;0;0
FR;10;2022-09-11;0;0;0;0;0;0;0;0;0;0;0;0;0;0;0;0;0;0
FR;10;2022-09-12;0;0;0;0;0;0;0;0;0;0;0;0;0;0;0;0;0;0
FR;10;2022-09-13;0;0;0;0;0;0;0;0;0;0;0;0;0;0;0;0;0;0
FR;10;2022-09-14;0;0;0;0;0;0;0;0;0;0;0;0;0;0;0;0;0;0
FR;10;2022-09-15;0;0;0;0;0;0;0;0;0;0;0;0;0;0;0;0;0;0
FR;10;2022-09-16;0;0;0;0;0;0;0;0;0;0;0;0;0;0;0;0;0;0
FR;10;2022-09-17;0;0;0;0;0;0;0;0;0;0;0;0;0;0;0;0;0;0
FR;10;2022-09-18;0;0;0;0;0;0;0;0;0;0;0;0;0;0;0;0;0;0
FR;10;2022-09-19;0;0;0;0;0;0;0;0;0;0;0;0;0;0;0;0;0;0
FR;10;2022-09-20;0;0;0;0;0;0;0;0;0;0;0;0;0;0;0;0;0;0
FR;10;2022-09-21;0;0;0;0;0;0;0;0;0;0;0;0;0;0;0;0;0;0
FR;10;2022-09-22;0;0;0;0;0;0;0;0;0;0;0;0;0;0;0;0;0;0
FR;10;2022-09-23;0;0;0;0;0;0;0;0;0;0;0;0;0;0;0;0;0;0
FR;10;2022-09-24;0;0;0;0;0;0;0;0;0;0;0;0;0;0;0;0;0;0
FR;10;2022-09-25;0;0;0;0;0;0;0;0;0;0;0;0;0;0;0;0;0;0
FR;10;2022-09-26;0;0;0;0;0;0;0;0;0;0;0;0;0;0;0;0;0;0
FR;10;2022-09-27;0;0;0;0;0;0;0;0;0;0;0;0;0;0;0;0;0;0
FR;10;2022-09-28;0;0;0;0;0;0;0;0;0;0;0;0;0;0;0;0;0;0
FR;10;2022-09-29;0;0;0;0;0;0;0;0;0;0;0;0;0;0;0;0;0;0
FR;10;2022-09-30;0;0;0;0;0;0;0;0;0;0;0;0;0;0;0;0;0;0
FR;10;2022-10-01;0;0;0;0;0;0;0;0;0;0;0;0;0;0;0;0;0;0
FR;10;2022-10-02;0;0;0;0;0;0;0;0;0;0;0;0;0;0;0;0;0;0
FR;10;2022-10-03;0;0;0;0;0;0;0;0;0;0;0;0;0;0;0;0;0;0
FR;10;2022-10-04;0;0;0;0;0;0;0;0;0;0;0;0;0;0;0;0;0;0
FR;10;2022-10-05;0;0;0;0;0;0;0;0;0;0;0;0;0;0;0;0;0;0
FR;10;2022-10-06;0;0;0;0;0;0;0;0;0;0;0;0;0;0;0;0;0;0
FR;10;2022-10-07;0;0;0;0;0;0;0;0;0;0;0;0;0;0;0;0;0;0
FR;10;2022-10-08;0;0;0;0;0;0;0;0;0;0;0;0;0;0;0;0;0;0
FR;10;2022-10-09;0;0;0;0;0;0;0;0;0;0;0;0;0;0;0;0;0;0
FR;10;2022-10-10;0;0;0;0;0;0;0;0;0;0;0;0;0;0;0;0;0;0
FR;10;2022-10-11;0;0;0;0;0;0;0;0;0;0;0;0;0;0;0;0;0;0
FR;10;2022-10-12;0;0;0;0;0;0;0;0;0;0;0;0;0;0;0;0;0;0
FR;10;2022-10-13;0;0;0;0;0;0;0;0;0;0;0;0;0;0;0;0;0;0
FR;10;2022-10-14;0;0;0;0;0;0;0;0;0;0;0;0;0;0;0;0;0;0
FR;10;2022-10-15;0;0;0;0;0;0;0;0;0;0;0;0;0;0;0;0;0;0
FR;10;2022-10-16;0;0;0;0;0;0;0;0;0;0;0;0;0;0;0;0;0;0
FR;10;2022-10-17;0;0;0;0;0;0;0;0;0;0;0;0;0;0;0;0;0;0
FR;10;2022-10-18;0;0;0;0;0;0;0;0;0;0;0;0;0;0;0;0;0;0
FR;10;2022-10-19;0;0;0;0;0;0;0;0;0;0;0;0;0;0;0;0;0;0
FR;10;2022-10-20;0;0;0;0;0;0;0;0;0;0;0;0;0;0;0;0;0;0
FR;10;2022-10-21;0;0;0;0;0;0;0;0;0;0;0;0;0;0;0;0;0;0
FR;10;2022-10-22;0;0;0;0;0;0;0;0;0;0;0;0;0;0;0;0;0;0
FR;10;2022-10-23;0;0;0;0;0;0;0;0;0;0;0;0;0;0;0;0;0;0
FR;10;2022-10-24;0;0;0;0;0;0;0;0;0;0;0;0;0;0;0;0;0;0
FR;10;2022-10-25;0;0;0;0;0;0;0;0;0;0;0;0;0;0;0;0;0;0
FR;10;2022-10-26;0;0;0;0;0;0;0;0;0;0;0;0;0;0;0;0;0;0
FR;10;2022-10-27;0;0;0;0;0;0;0;0;0;0;0;0;0;0;0;0;0;0
FR;10;2022-10-28;0;0;0;0;0;0;0;0;0;0;0;0;0;0;0;0;0;0
FR;10;2022-10-29;0;0;0;0;0;0;0;0;0;0;0;0;0;0;0;0;0;0
FR;10;2022-10-30;0;0;0;0;0;0;0;0;0;0;0;0;0;0;0;0;0;0
FR;10;2022-10-31;0;0;0;0;0;0;0;0;0;0;0;0;0;0;0;0;0;0
FR;10;2022-11-01;0;0;0;0;0;0;0;0;0;0;0;0;0;0;0;0;0;0
FR;10;2022-11-02;0;0;0;0;0;0;0;0;0;0;0;0;0;0;0;0;0;0
FR;10;2022-11-03;0;0;0;0;0;0;0;0;0;0;0;0;0;0;0;0;0;0
FR;10;2022-11-04;0;0;0;0;0;0;0;0;0;0;0;0;0;0;0;0;0;0
FR;10;2022-11-05;0;0;0;0;0;0;0;0;0;0;0;0;0;0;0;0;0;0
FR;10;2022-11-06;0;0;0;0;0;0;0;0;0;0;0;0;0;0;0;0;0;0
FR;10;2022-11-07;0;0;0;0;0;0;0;0;0;0;0;0;0;0;0;0;0;0
FR;10;2022-11-08;0;0;0;0;0;0;0;0;0;0;0;0;0;0;0;0;0;0
FR;10;2022-11-09;0;0;0;0;0;0;0;0;0;0;0;0;0;0;0;0;0;0
FR;10;2022-11-10;0;0;0;0;0;0;0;0;0;0;0;0;0;0;0;0;0;0
FR;10;2022-11-11;0;0;0;0;0;0;0;0;0;0;0;0;0;0;0;0;0;0
FR;10;2022-11-12;0;0;0;0;0;0;0;0;0;0;0;0;0;0;0;0;0;0
FR;10;2022-11-13;0;0;0;0;0;0;0;0;0;0;0;0;0;0;0;0;0;0
FR;10;2022-11-14;0;0;0;0;0;0;0;0;0;0;0;0;0;0;0;0;0;0
FR;10;2022-11-15;0;0;0;0;0;0;0;0;0;0;0;0;0;0;0;0;0;0
FR;10;2022-11-16;0;0;0;0;0;0;0;0;0;0;0;0;0;0;0;0;0;0
FR;10;2022-11-17;0;0;0;0;0;0;0;0;0;0;0;0;0;0;0;0;0;0
FR;10;2022-11-18;0;0;0;0;0;0;0;0;0;0;0;0;0;0;0;0;0;0
FR;10;2022-11-19;0;0;0;0;0;0;0;0;0;0;0;0;0;0;0;0;0;0
FR;10;2022-11-20;0;0;0;0;0;0;0;0;0;0;0;0;0;0;0;0;0;0
FR;10;2022-11-21;0;0;0;0;0;0;0;0;0;0;0;0;0;0;0;0;0;0
FR;10;2022-11-22;0;0;0;0;0;0;0;0;0;0;0;0;0;0;0;0;0;0
FR;10;2022-11-23;0;0;0;0;0;0;0;0;0;0;0;0;0;0;0;0;0;0
FR;10;2022-11-24;0;0;0;0;0;0;0;0;0;0;0;0;0;0;0;0;0;0
FR;10;2022-11-25;0;0;0;0;0;0;0;0;0;0;0;0;0;0;0;0;0;0
FR;10;2022-11-26;0;0;0;0;0;0;0;0;0;0;0;0;0;0;0;0;0;0
FR;10;2022-11-27;0;0;0;0;0;0;0;0;0;0;0;0;0;0;0;0;0;0
FR;10;2022-11-28;0;0;0;0;0;0;0;0;0;0;0;0;0;0;0;0;0;0
FR;10;2022-11-29;0;0;0;0;0;0;0;0;0;0;0;0;0;0;0;0;0;0
FR;10;2022-11-30;0;0;0;0;0;0;0;0;0;0;0;0;0;0;0;0;0;0
FR;10;2022-12-01;0;0;0;0;0;0;0;0;0;0;0;0;0;0;0;0;0;0
FR;10;2022-12-02;0;0;0;0;0;0;0;0;0;0;0;0;0;0;0;0;0;0
FR;10;2022-12-03;0;0;0;0;0;0;0;0;0;0;0;0;0;0;0;0;0;0
FR;10;2022-12-04;0;0;0;0;0;0;0;0;0;0;0;0;0;0;0;0;0;0
FR;10;2022-12-05;0;0;0;0;0;0;0;0;0;0;0;0;0;0;0;0;0;0
FR;10;2022-12-06;0;0;0;0;0;0;0;0;0;0;0;0;0;0;0;0;0;0
FR;10;2022-12-07;0;0;0;0;0;0;0;0;0;0;0;0;0;0;0;0;0;0
FR;10;2022-12-08;0;0;0;0;0;0;0;0;0;0;0;0;0;0;0;0;0;0
FR;10;2022-12-09;0;0;0;0;0;0;0;0;0;0;0;0;0;0;0;0;0;0
FR;10;2022-12-10;0;0;0;0;0;0;0;0;0;0;0;0;0;0;0;0;0;0
FR;10;2022-12-11;0;0;0;0;0;0;0;0;0;0;0;0;0;0;0;0;0;0
FR;10;2022-12-12;0;0;0;0;0;0;0;0;0;0;0;0;0;0;0;0;0;0
FR;10;2022-12-13;0;0;0;0;0;0;0;0;0;0;0;0;0;0;0;0;0;0
FR;10;2022-12-14;0;0;0;0;0;0;0;0;0;0;0;0;0;0;0;0;0;0
FR;10;2022-12-15;0;0;0;0;0;0;0;0;0;0;0;0;0;0;0;0;0;0
FR;10;2022-12-16;0;0;0;0;0;0;0;0;0;0;0;0;0;0;0;0;0;0
FR;10;2022-12-17;0;0;0;0;0;0;0;0;0;0;0;0;0;0;0;0;0;0
FR;10;2022-12-18;0;0;0;0;0;0;0;0;0;0;0;0;0;0;0;0;0;0
FR;10;2022-12-19;0;0;0;0;0;0;0;0;0;0;0;0;0;0;0;0;0;0
FR;10;2022-12-20;0;0;0;0;0;0;0;0;0;0;0;0;0;0;0;0;0;0
FR;10;2022-12-21;0;0;0;0;0;0;0;0;0;0;0;0;0;0;0;0;0;0
FR;10;2022-12-22;0;0;0;1;0;0;1;0;0;0;0;0;1;0;0;1;0;0
FR;10;2022-12-23;0;0;1;14;0;2;14;0;7;0;0;1;15;0;2;15;0;7
FR;10;2022-12-24;0;0;0;3;0;0;3;0;1;0;0;1;18;0;2;18;0;8
FR;10;2022-12-25;0;0;0;0;0;0;0;0;0;0;0;1;18;0;2;18;0;8
FR;10;2022-12-26;3;1;11;35;0;8;39;0;5;3;1;12;53;0;10;57;0;13
FR;10;2022-12-27;1;1;13;34;1;11;36;0;10;4;2;25;87;1;21;93;0;23
FR;10;2022-12-28;0;0;2;15;0;1;14;0;3;4;2;27;102;1;22;107;0;26
FR;10;2022-12-29;0;0;6;48;0;1;48;0;17;4;2;33;150;1;23;155;0;43
FR;10;2022-12-30;0;1;4;33;0;7;31;0;6;4;3;37;183;1;30;186;0;49
FR;10;2022-12-31;0;0;3;12;0;4;10;0;4;4;3;40;195;1;34;196;0;53
FR;10;2023-01-01;0;0;1;6;0;0;7;0;2;4;3;41;201;1;34;203;0;55
FR;10;2023-01-02;0;2;4;36;0;5;35;0;20;4;5;45;237;1;39;238;0;75
FR;0;2020-12-27;616;0;0;0;55;0;0;0;0;616;0;0;0;55;0;0;0;0
FR;0;2020-12-28;702;1;0;0;43;0;0;0;0;1318;1;0;0;98;0;0;0;0
FR;0;2020-12-29;387;0;0;0;19;0;0;0;0;1705;1;0;0;117;0;0;0;0
FR;0;2020-12-30;450;0;0;0;18;0;0;0;0;2155;1;0;0;135;0;0;0;0
FR;0;2020-12-31;446;1;0;0;23;0;0;0;0;2601;2;0;0;158;0;0;0;0
FR;0;2021-01-01;1188;2;0;0;65;0;0;0;0;3789;4;0;0;223;0;0;0;0
FR;0;2021-01-02;366;4;0;0;29;0;0;0;0;4155;8;0;0;252;0;0;0;0
FR;0;2021-01-03;412;0;0;0;23;0;0;0;0;4567;8;0;0;275;0;0;0;0
FR;0;2021-01-04;2127;4;0;0;50;0;0;0;0;6694;12;0;0;325;0;0;0;0
FR;0;2021-01-05;7764;6;0;0;128;0;0;0;0;14458;18;0;0;453;0;0;0;0
FR;0;2021-01-06;12468;23;0;0;127;0;0;0;0;26926;41;0;0;580;0;0;0;0
FR;0;2021-01-07;29475;23;0;0;159;0;0;0;0;56401;64;0;0;739;0;0;0;0
FR;0;2021-01-08;37165;34;0;0;203;0;0;0;0;93566;98;0;0;942;0;0;0;0
FR;0;2021-01-09;11219;9;0;0;77;0;0;0;0;104785;107;0;0;1019;0;0;0;0
FR;0;2021-01-10;6012;8;0;0;28;0;0;0;0;110797;115;0;0;1047;0;0;0;0
FR;0;2021-01-11;39952;36;0;0;229;0;0;0;0;150749;151;0;0;1276;0;0;0;0
FR;0;2021-01-12;62156;27;0;0;297;0;0;0;0;212905;178;0;0;1573;0;0;0;0
FR;0;2021-01-13;65145;60;0;0;432;0;0;0;0;278050;238;0;0;2005;0;0;0;0
FR;0;2021-01-14;83109;237;0;0;1172;0;0;0;0;361159;475;0;0;3177;0;0;0;0
FR;0;2021-01-15;69028;95;0;0;554;0;0;0;0;430187;570;0;0;3731;0;0;0;0
FR;0;2021-01-16;20219;73;0;0;184;0;0;0;0;450406;643;0;0;3915;0;0;0;0
FR;0;2021-01-17;10990;54;0;0;138;0;0;0;0;461396;697;0;0;4053;0;0;0;0
FR;0;2021-01-18;85918;179;0;0;617;0;0;0;0;547314;876;0;0;4670;0;0;0;0
FR;0;2021-01-19;130614;209;0;0;868;0;0;0;0;677928;1085;0;0;5538;0;0;0;0
FR;0;2021-01-20;137563;194;0;0;837;0;0;0;0;815491;1279;0;0;6375;0;0;0;0
FR;0;2021-01-21;158424;198;0;0;945;0;0;0;0;973915;1477;0;0;7320;0;0;0;0
FR;0;2021-01-22;121081;255;0;0;845;0;0;0;0;1094996;1732;0;0;8165;0;0;0;0
FR;0;2021-01-23;38491;80;0;0;217;0;0;0;0;1133487;1812;0;0;8382;0;0;0;0
FR;0;2021-01-24;9749;129;0;0;194;0;0;0;0;1143236;1941;0;0;8576;0;0;0;0
FR;0;2021-01-25;78250;1445;0;0;1797;0;0;0;0;1221486;3386;0;0;10373;0;0;0;0
FR;0;2021-01-26;100390;3691;1;0;4170;0;0;0;0;1321876;7077;1;0;14543;0;0;0;0
FR;0;2021-01-27;107261;6403;0;0;7119;0;0;0;0;1429137;13480;1;0;21662;0;0;0;0
FR;0;2021-01-28;124376;16361;0;0;17185;0;0;0;0;1553513;29841;1;0;38847;0;0;0;0
FR;0;2021-01-29;92200;18709;0;0;19283;0;0;0;0;1645713;48550;1;0;58130;0;0;0;0
FR;0;2021-01-30;29128;4512;0;0;4648;0;0;0;0;1674841;53062;1;0;62778;0;0;0;0
FR;0;2021-01-31;5240;1901;0;0;1946;0;0;0;0;1680081;54963;1;0;64724;0;0;0;0
FR;0;2021-02-01;53150;22925;0;0;23189;0;0;0;0;1733231;77888;1;0;87913;0;0;0;0
FR;0;2021-02-02;72332;38008;0;0;38497;0;0;0;0;1805563;115896;1;0;126410;0;0;0;0
FR;0;2021-02-03;72324;40054;0;0;40554;0;0;0;0;1877887;155950;1;0;166964;0;0;0;0
FR;0;2021-02-04;82090;54812;0;0;55404;0;0;0;0;1959977;210762;1;0;222368;0;0;0;0
FR;0;2021-02-05;68248;48015;0;0;48447;0;0;0;0;2028225;258777;1;0;270815;0;0;0;0
FR;0;2021-02-06;22959;11407;0;0;11646;0;0;0;0;2051184;270184;1;0;282461;0;0;0;0
FR;0;2021-02-07;5195;6029;0;0;6155;0;0;0;0;2056379;276213;1;0;288616;0;0;0;0
FR;0;2021-02-08;46855;48667;0;0;49141;0;0;0;0;2103234;324880;1;0;337757;0;0;0;0
FR;0;2021-02-09;66041;78119;0;0;79211;0;0;0;0;2169275;402999;1;0;416968;0;0;0;0
FR;0;2021-02-10;71036;83140;0;0;84430;0;0;0;0;2240311;486139;1;0;501398;0;0;0;0
FR;0;2021-02-11;87305;105193;0;0;107115;0;0;0;0;2327616;591332;1;0;608513;0;0;0;0
FR;0;2021-02-12;79351;75955;0;0;77691;0;0;0;0;2406967;667287;1;0;686204;0;0;0;0
FR;0;2021-02-13;22387;19533;0;0;19899;0;0;0;0;2429354;686820;1;0;706103;0;0;0;0
FR;0;2021-02-14;5080;7370;0;0;7497;0;0;0;0;2434434;694190;1;0;713600;0;0;0;0
FR;0;2021-02-15;38126;76730;0;0;77733;0;0;0;0;2472560;770920;1;0;791333;0;0;0;0
FR;0;2021-02-16;50414;99778;0;0;101105;0;0;0;0;2522974;870698;1;0;892438;0;0;0;0
FR;0;2021-02-17;50549;106770;20;0;108205;0;0;0;0;2573523;977468;21;0;1000643;0;0;0;0
FR;0;2021-02-18;69812;123470;0;0;125499;0;0;0;0;2643335;1100938;21;0;1126142;0;0;0;0
FR;0;2021-02-19;65087;92119;1;0;93997;0;0;0;0;2708422;1193057;22;0;1220139;0;0;0;0
FR;0;2021-02-20;18600;28565;0;0;28933;0;0;0;0;2727022;1221622;22;0;1249072;0;0;0;0
FR;0;2021-02-21;3332;6079;0;0;6184;0;0;0;0;2730354;1227701;22;0;1255256;0;0;0;0
FR;0;2021-02-22;37508;73188;2;0;74194;0;0;0;0;2767862;1300889;24;0;1329450;0;0;0;0
FR;0;2021-02-23;53798;85237;1;0;86744;0;0;0;0;2821660;1386126;25;0;1416194;0;0;0;0
FR;0;2021-02-24;60033;82817;1;0;84392;0;0;0;0;2881693;1468943;26;0;1500586;0;0;0;0
FR;0;2021-02-25;100607;91356;1;0;94338;0;0;0;0;2982300;1560299;27;0;1594924;0;0;0;0
FR;0;2021-02-26;113488;70764;1;0;73895;0;0;0;0;3095788;1631063;28;0;1668819;0;0;0;0
FR;0;2021-02-27;52128;22421;1;0;23663;0;0;0;0;3147916;1653484;29;0;1692482;0;0;0;0
FR;0;2021-02-28;6208;4127;2;0;4324;0;0;0;0;3154124;1657611;31;0;1696806;0;0;0;0
FR;0;2021-03-01;65934;54059;1;0;55918;0;0;0;0;3220058;1711670;32;0;1752724;0;0;0;0
FR;0;2021-03-02;101411;67161;3;0;70200;0;0;0;0;3321469;1778831;35;0;1822924;0;0;0;0
FR;0;2021-03-03;116553;65457;0;0;69137;0;0;0;0;3438022;1844288;35;0;1892061;0;0;0;0
FR;0;2021-03-04;163655;72511;3;0;78073;0;0;0;0;3601677;1916799;38;0;1970134;0;0;0;0
FR;0;2021-03-05;200955;62725;3;0;69449;0;0;0;0;3802632;1979524;41;0;2039583;0;0;0;0
FR;0;2021-03-06;207983;17504;3;0;22803;0;0;0;0;4010615;1997028;44;0;2062386;0;0;0;0
FR;0;2021-03-07;121291;4038;1;0;7332;0;0;0;0;4131906;2001066;45;0;2069718;0;0;0;0
FR;0;2021-03-08;107173;49606;2;0;53088;0;0;0;0;4239079;2050672;47;0;2122806;0;0;0;0
FR;0;2021-03-09;172480;56088;2;0;61574;0;0;0;0;4411559;2106760;49;0;2184380;0;0;0;0
FR;0;2021-03-10;179036;57095;5;0;62759;0;0;0;0;4590595;2163855;54;0;2247139;0;0;0;0
FR;0;2021-03-11;242927;63995;2;0;72077;0;0;0;0;4833522;2227850;56;0;2319216;0;0;0;0
FR;0;2021-03-12;294865;53369;1;0;62823;0;0;0;0;5128387;2281219;57;0;2382039;0;0;0;0
FR;0;2021-03-13;231441;15272;1;0;21250;0;0;0;0;5359828;2296491;58;0;2403289;0;0;0;0
FR;0;2021-03-14;63359;3075;1;0;5110;0;0;0;0;5423187;2299566;59;0;2408399;0;0;0;0
FR;0;2021-03-15;158690;31553;3;0;36200;0;0;0;0;5581877;2331119;62;0;2444599;0;0;0;0
FR;0;2021-03-16;141592;38818;6;0;42961;0;0;0;0;5723469;2369937;68;0;2487560;0;0;0;0
FR;0;2021-03-17;150515;37615;4;0;42380;0;0;0;0;5873984;2407552;72;0;2529940;0;0;0;0
FR;0;2021-03-18;167863;44384;5;0;49941;0;0;0;0;6041847;2451936;77;0;2579881;0;0;0;0
FR;0;2021-03-19;230048;36734;2;0;44090;0;0;0;0;6271895;2488670;79;0;2623971;0;0;0;0
FR;0;2021-03-20;166715;11395;1;0;16020;0;0;0;0;6438610;2500065;80;0;2639991;0;0;0;0
FR;0;2021-03-21;49953;2151;1;0;3909;0;0;0;0;6488563;2502216;81;0;2643900;0;0;0;0
FR;0;2021-03-22;170076;33552;2;0;39048;0;0;0;0;6658639;2535768;83;0;2682948;0;0;0;0
FR;0;2021-03-23;250427;42401;1;0;50238;0;0;0;0;6909066;2578169;84;0;2733186;0;0;0;0
FR;0;2021-03-24;256940;43532;0;0;51619;0;0;0;0;7166006;2621701;84;0;2784805;0;0;0;0
FR;0;2021-03-25;341863;45247;5;0;56239;0;0;0;0;7507869;2666948;89;0;2841044;0;0;0;0
FR;0;2021-03-26;358839;41801;5;1;53547;0;0;0;0;7866708;2708749;94;1;2894591;0;0;0;0
FR;0;2021-03-27;195293;16937;1;0;23379;0;0;0;0;8062001;2725686;95;1;2917970;0;0;0;0
FR;0;2021-03-28;59352;4549;3;0;6613;0;0;0;0;8121353;2730235;98;1;2924583;0;0;0;0
FR;0;2021-03-29;203013;53449;4;0;60202;0;0;0;0;8324366;2783684;102;1;2984785;0;0;0;0
FR;0;2021-03-30;285524;69990;5;0;80397;0;0;0;0;8609890;2853674;107;1;3065182;0;0;0;0
FR;0;2021-03-31;263074;73967;4;0;84642;0;0;0;0;8872964;2927641;111;1;3149824;0;0;0;0
FR;0;2021-04-01;315562;92623;11;0;106191;0;0;0;0;9188526;3020264;122;1;3256015;0;0;0;0
FR;0;2021-04-02;281374;94696;7;0;106517;0;0;0;0;9469900;3114960;129;1;3362532;0;0;0;0
FR;0;2021-04-03;141090;62552;6;0;67807;0;0;0;0;9610990;3177512;135;1;3430339;0;0;0;0
FR;0;2021-04-04;46546;19009;2;0;21059;0;0;0;0;9657536;3196521;137;1;3451398;0;0;0;0
FR;0;2021-04-05;63362;10427;11;0;13086;0;0;0;0;9720898;3206948;148;1;3464484;0;0;0;0
FR;0;2021-04-06;217258;112927;17;0;121773;0;0;0;0;9938156;3319875;165;1;3586257;0;0;0;0
FR;0;2021-04-07;260309;115275;17;0;126613;0;0;0;0;10198465;3435150;182;1;3712870;0;0;0;0
FR;0;2021-04-08;337905;123092;15;0;138705;0;0;0;0;10536370;3558242;197;1;3851575;0;0;0;0
FR;0;2021-04-09;410215;116854;49;0;134250;0;0;0;0;10946585;3675096;246;1;3985825;0;0;0;0
FR;0;2021-04-10;212656;82846;15;0;91232;0;0;0;0;11159241;3757942;261;1;4077057;0;0;0;0
FR;0;2021-04-11;56158;34184;7;0;36709;0;0;0;0;11215399;3792126;268;1;4113766;0;0;0;0
FR;0;2021-04-12;237115;115801;46;0;125393;0;0;0;0;11452514;3907927;314;1;4239159;0;0;0;0
FR;0;2021-04-13;309534;144178;98;1;157123;0;0;0;0;11762048;4052105;412;2;4396282;0;0;0;0
FR;0;2021-04-14;294578;139754;215;0;153122;0;0;0;0;12056626;4191859;627;2;4549404;0;0;0;0
FR;0;2021-04-15;337174;150375;340;0;165894;0;0;0;0;12393800;4342234;967;2;4715298;0;0;0;0
FR;0;2021-04-16;339355;146990;354;0;161641;0;0;0;0;12733155;4489224;1321;2;4876939;0;0;0;0
FR;0;2021-04-17;188687;89975;109;0;97671;0;0;0;0;12921842;4579199;1430;2;4974610;0;0;0;0
FR;0;2021-04-18;51637;35454;47;0;37874;0;0;0;0;12973479;4614653;1477;2;5012484;0;0;0;0
FR;0;2021-04-19;205740;138256;456;0;147403;0;0;0;0;13179219;4752909;1933;2;5159887;0;0;0;0
FR;0;2021-04-20;254478;171898;569;0;183547;0;0;0;0;13433697;4924807;2502;2;5343434;0;0;0;0
FR;0;2021-04-21;253318;170076;836;0;182091;0;0;0;0;13687015;5094883;3338;2;5525525;0;0;0;0
FR;0;2021-04-22;287619;190297;819;0;204884;0;0;0;0;13974634;5285180;4157;2;5730409;0;0;0;0
FR;0;2021-04-23;297703;184583;747;0;203356;0;0;0;0;14272337;5469763;4904;2;5933765;0;0;0;0
FR;0;2021-04-24;190477;112005;252;0;122455;0;0;0;0;14462814;5581768;5156;2;6056220;0;0;0;0
FR;0;2021-04-25;69574;38847;51;0;42579;0;0;0;0;14532388;5620615;5207;2;6098799;0;0;0;0
FR;0;2021-04-26;220996;158527;563;0;171721;0;0;0;0;14753384;5779142;5770;2;6270520;0;0;0;0
FR;0;2021-04-27;284646;188004;941;0;211316;0;0;0;0;15038030;5967146;6711;2;6481836;0;0;0;0
FR;0;2021-04-28;299560;184589;1426;1;209664;1;0;0;0;15337590;6151735;8137;3;6691500;1;0;0;0
FR;0;2021-04-29;357196;198126;1281;0;233209;0;0;0;0;15694786;6349861;9418;3;6924709;1;0;0;0
FR;0;2021-04-30;372254;185999;1123;1;225338;0;0;0;0;16067040;6535860;10541;4;7150047;1;0;0;0
FR;0;2021-05-01;167673;52518;179;0;63765;0;0;0;0;16234713;6588378;10720;4;7213812;1;0;0;0
FR;0;2021-05-02;91766;37851;83;0;43577;0;0;0;0;16326479;6626229;10803;4;7257389;1;0;0;0
FR;0;2021-05-03;288963;165471;843;0;185991;0;0;0;0;16615442;6791700;11646;4;7443380;1;0;0;0
FR;0;2021-05-04;315739;225489;1235;0;251659;0;0;0;0;16931181;7017189;12881;4;7695039;1;0;0;0
FR;0;2021-05-05;327272;226447;1316;0;251514;0;0;0;0;17258453;7243636;14197;4;7946553;1;0;0;0
FR;0;2021-05-06;379584;241006;1634;0;275257;0;0;0;0;17638037;7484642;15831;4;8221810;1;0;0;0
FR;0;2021-05-07;372813;258760;1224;0;299816;0;0;0;0;18010850;7743402;17055;4;8521626;1;0;0;0
FR;0;2021-05-08;222180;71159;300;0;86372;0;0;0;0;18233030;7814561;17355;4;8607998;1;0;0;0
FR;0;2021-05-09;129724;44691;243;0;53326;0;0;0;0;18362754;7859252;17598;4;8661324;1;0;0;0
FR;0;2021-05-10;313421;229622;1238;0;255399;0;0;0;0;18676175;8088874;18836;4;8916723;1;0;0;0
FR;0;2021-05-11;403963;258341;1566;0;296765;0;0;0;0;19080138;8347215;20402;4;9213488;1;0;0;0
FR;0;2021-05-12;434182;233798;1544;0;270081;0;0;0;0;19514320;8581013;21946;4;9483569;1;0;0;0
FR;0;2021-05-13;338631;56481;432;0;77976;0;0;0;0;19852951;8637494;22378;4;9561545;1;0;0;0
FR;0;2021-05-14;454178;167479;1127;0;203083;0;0;0;0;20307129;8804973;23505;4;9764628;1;0;0;0
FR;0;2021-05-15;375005;94355;444;0;120752;0;0;0;0;20682134;8899328;23949;4;9885380;1;0;0;0
FR;0;2021-05-16;202770;20694;168;0;34094;0;0;0;0;20884904;8920022;24117;4;9919474;1;0;0;0
FR;0;2021-05-17;376145;148851;1555;0;178645;0;0;0;0;21261049;9068873;25672;4;10098119;1;0;0;0
FR;0;2021-05-18;460194;154025;1991;0;193173;0;0;0;0;21721243;9222898;27663;4;10291292;1;0;0;0
FR;0;2021-05-19;467450;142672;2465;0;179938;0;0;0;0;22188693;9365570;30128;4;10471230;1;0;0;0
FR;0;2021-05-20;507580;160288;2340;0;204268;0;0;0;0;22696273;9525858;32468;4;10675498;1;0;0;0
FR;0;2021-05-21;489718;175184;1996;0;221737;0;0;0;0;23185991;9701042;34464;4;10897235;1;0;0;0
FR;0;2021-05-22;347221;80198;670;0;108625;0;0;0;0;23533212;9781240;35134;4;11005860;1;0;0;0
FR;0;2021-05-23;161710;14224;246;0;26694;0;0;0;0;23694922;9795464;35380;4;11032554;1;0;0;0
FR;0;2021-05-24;263212;33100;604;0;52938;0;0;0;0;23958134;9828564;35984;4;11085492;1;0;0;0
FR;0;2021-05-25;400304;190428;2357;1;226989;0;0;0;0;24358438;10018992;38341;5;11312481;1;0;0;0
FR;0;2021-05-26;413486;190992;2227;0;229054;0;0;0;0;24771924;10209984;40568;5;11541535;1;0;0;0
FR;0;2021-05-27;449850;219905;2163;0;267050;0;0;0;0;25221774;10429889;42731;5;11808585;1;0;0;0
FR;0;2021-05-28;429585;261050;1894;0;319153;0;0;0;0;25651359;10690939;44625;5;12127738;1;0;0;0
FR;0;2021-05-29;299002;150427;586;0;183282;0;0;0;0;25950361;10841366;45211;5;12311020;1;0;0;0
FR;0;2021-05-30;107153;32515;164;0;42101;0;0;0;0;26057514;10873881;45375;5;12353121;1;0;0;0
FR;0;2021-05-31;358070;203465;1473;1;241749;1;0;0;0;26415584;11077346;46848;6;12594870;2;0;0;0
FR;0;2021-06-01;431109;251218;1969;1;302863;1;0;0;0;26846693;11328564;48817;7;12897733;3;0;0;0
FR;0;2021-06-02;420149;232530;1985;0;279913;0;0;0;0;27266842;11561094;50802;7;13177646;3;0;0;0
FR;0;2021-06-03;465665;257737;1826;0;312506;0;0;0;0;27732507;11818831;52628;7;13490152;3;0;0;0
FR;0;2021-06-04;456281;305773;1734;1;363177;1;0;0;0;28188788;12124604;54362;8;13853329;4;0;0;0
FR;0;2021-06-05;304825;189508;653;0;222722;0;0;0;0;28493613;12314112;55015;8;14076051;4;0;0;0
FR;0;2021-06-06;133332;49046;226;0;61188;0;0;0;0;28626945;12363158;55241;8;14137239;4;0;0;0
FR;0;2021-06-07;340010;261524;1529;0;298620;0;0;0;0;28966955;12624682;56770;8;14435859;4;0;0;0
FR;0;2021-06-08;393928;291358;1806;0;338229;0;0;0;0;29360883;12916040;58576;8;14774088;4;0;0;0
FR;0;2021-06-09;384911;273885;1733;0;318298;0;0;0;0;29745794;13189925;60309;8;15092386;4;0;0;0
FR;0;2021-06-10;404224;286589;1727;1;336030;0;0;0;0;30150018;13476514;62036;9;15428416;4;0;0;0
FR;0;2021-06-11;386696;356529;1467;1;406964;0;0;0;0;30536714;13833043;63503;10;15835380;4;0;0;0
FR;0;2021-06-12;283289;210988;497;0;243134;0;0;0;0;30820003;14044031;64000;10;16078514;4;0;0;0
FR;0;2021-06-13;104898;73849;204;0;84840;0;0;0;0;30924901;14117880;64204;10;16163354;4;0;0;0
FR;0;2021-06-14;240865;354142;1429;1;383325;0;0;0;0;31165766;14472022;65633;11;16546679;4;0;0;0
FR;0;2021-06-15;308206;384423;1574;1;423192;0;0;0;0;31473972;14856445;67207;12;16969871;4;0;0;0
FR;0;2021-06-16;314005;357533;1418;1;395298;0;0;0;0;31787977;15213978;68625;13;17365169;4;0;0;0
FR;0;2021-06-17;317718;373057;1432;1;414244;0;0;0;0;32105695;15587035;70057;14;17779413;4;0;0;0
FR;0;2021-06-18;321778;442605;1341;1;485998;0;0;0;0;32427473;16029640;71398;15;18265411;4;0;0;0
FR;0;2021-06-19;224358;273990;449;0;301174;0;0;0;0;32651831;16303630;71847;15;18566585;4;0;0;0
FR;0;2021-06-20;74453;102301;130;0;111495;0;0;0;0;32726284;16405931;71977;15;18678080;4;0;0;0
FR;0;2021-06-21;195804;401707;1038;1;427665;1;0;0;0;32922088;16807638;73015;16;19105745;5;0;0;0
FR;0;2021-06-22;223228;467679;1266;10;500333;1;0;0;0;33145316;17275317;74281;26;19606078;6;0;0;0
FR;0;2021-06-23;234065;440017;1197;1;474125;1;0;0;0;33379381;17715334;75478;27;20080203;7;0;0;0
FR;0;2021-06-24;241889;409651;1359;0;447149;0;0;0;0;33621270;18124985;76837;27;20527352;7;0;0;0
FR;0;2021-06-25;227663;522963;1403;0;561961;0;0;0;0;33848933;18647948;78240;27;21089313;7;0;0;0
FR;0;2021-06-26;153282;371015;587;1;395813;0;0;0;0;34002215;19018963;78827;28;21485126;7;0;0;0
FR;0;2021-06-27;55916;155962;169;1;164874;0;0;0;0;34058131;19174925;78996;29;21650000;7;0;0;0
FR;0;2021-06-28;154802;452535;1176;0;478131;0;0;0;0;34212933;19627460;80172;29;22128131;7;0;0;0
FR;0;2021-06-29;182731;507678;2123;0;539064;0;0;0;0;34395664;20135138;82295;29;22667195;7;0;0;0
FR;0;2021-06-30;204034;485136;2015;21;519418;2;0;0;0;34599698;20620274;84310;50;23186613;9;0;0;0
FR;0;2021-07-01;231437;458428;2225;5;498393;1;0;0;0;34831135;21078702;86535;55;23685006;10;0;0;0
FR;0;2021-07-02;228701;519996;2120;5;562321;2;0;0;0;35059836;21598698;88655;60;24247327;12;0;0;0
FR;0;2021-07-03;142053;368759;908;3;395257;1;0;0;0;35201889;21967457;89563;63;24642584;13;0;0;0
FR;0;2021-07-04;56760;141011;265;0;150708;0;0;0;0;35258649;22108468;89828;63;24793292;13;0;0;0
FR;0;2021-07-05;168535;418673;1668;8;448624;0;0;0;0;35427184;22527141;91496;71;25241916;13;0;0;0
FR;0;2021-07-06;196793;474507;1830;45;511112;8;0;0;0;35623977;23001648;93326;116;25753028;21;0;0;0
FR;0;2021-07-07;213227;438969;1880;25;477436;2;0;0;0;35837204;23440617;95206;141;26230464;23;0;0;0
FR;0;2021-07-08;231663;424099;2089;20;468047;3;0;0;0;36068867;23864716;97295;161;26698511;26;0;0;0
FR;0;2021-07-09;228635;511067;2185;4;557383;2;0;0;0;36297502;24375783;99480;165;27255894;28;0;0;0
FR;0;2021-07-10;148627;339909;986;1;368858;1;0;0;0;36446129;24715692;100466;166;27624752;29;0;0;0
FR;0;2021-07-11;60209;110055;283;0;120974;0;0;0;0;36506338;24825747;100749;166;27745726;29;0;0;0
FR;0;2021-07-12;169434;477758;1765;4;512517;0;0;0;0;36675772;25303505;102514;170;28258243;29;0;0;0
FR;0;2021-07-13;287286;526677;2050;8;585726;1;0;0;0;36963058;25830182;104564;178;28843969;30;0;0;0
FR;0;2021-07-14;181117;157368;435;0;186687;0;0;0;0;37144175;25987550;104999;178;29030656;30;0;0;0
FR;0;2021-07-15;347118;501641;2100;1;571634;0;0;0;0;37491293;26489191;107099;179;29602290;30;0;0;0
FR;0;2021-07-16;380121;495068;2023;3;574279;1;0;0;0;37871414;26984259;109122;182;30176569;31;0;0;0
FR;0;2021-07-17;259745;319623;877;1;368591;0;0;0;0;38131159;27303882;109999;183;30545160;31;0;0;0
FR;0;2021-07-18;109736;114569;310;0;133016;0;0;0;0;38240895;27418451;110309;183;30678176;31;0;0;0
FR;0;2021-07-19;285513;423970;1631;3;479011;0;0;0;0;38526408;27842421;111940;186;31157187;31;0;0;0
FR;0;2021-07-20;376933;451292;1724;0;523646;0;0;0;0;38903341;28293713;113664;186;31680833;31;0;0;0
FR;0;2021-07-21;395829;406947;1549;4;481976;1;0;0;0;39299170;28700660;115213;190;32162809;32;0;0;0
FR;0;2021-07-22;441072;387346;1715;4;471862;2;0;0;0;39740242;29088006;116928;194;32634671;34;0;0;0
FR;0;2021-07-23;440341;422078;1883;4;510070;1;0;0;0;40180583;29510084;118811;198;33144741;35;0;0;0
FR;0;2021-07-24;285260;269311;804;1;322011;0;0;0;0;40465843;29779395;119615;199;33466752;35;0;0;0
FR;0;2021-07-25;121123;79924;234;0;100286;0;0;0;0;40586966;29859319;119849;199;33567038;35;0;0;0
FR;0;2021-07-26;347438;322209;1614;3;384785;1;0;0;0;40934404;30181528;121463;202;33951823;36;0;0;0
FR;0;2021-07-27;464096;319338;1698;4;400503;1;0;0;0;41398500;30500866;123161;206;34352326;37;0;0;0
FR;0;2021-07-28;459458;289361;1637;4;366997;1;0;0;0;41857958;30790227;124798;210;34719323;38;0;0;0
FR;0;2021-07-29;489850;276145;1797;2;357059;0;0;0;0;42347808;31066372;126595;212;35076382;38;0;0;0
FR;0;2021-07-30;461847;302400;1941;5;380922;1;0;0;0;42809655;31368772;128536;217;35457304;39;0;0;0
FR;0;2021-07-31;285414;185013;916;1;231526;0;0;0;0;43095069;31553785;129452;218;35688830;39;0;0;0
FR;0;2021-08-01;112037;49920;255;0;65701;0;0;0;0;43207106;31603705;129707;218;35754531;39;0;0;0
FR;0;2021-08-02;341657;234047;1602;2;284775;0;0;0;0;43548763;31837752;131309;220;36039306;39;0;0;0
FR;0;2021-08-03;398633;244486;1728;2;304590;1;0;0;0;43947396;32082238;133037;222;36343896;40;0;0;0
FR;0;2021-08-04;384874;209541;1593;6;265691;3;0;0;0;44332270;32291779;134630;228;36609587;43;0;0;0
FR;0;2021-08-05;366189;228359;1711;0;281758;0;0;0;0;44698459;32520138;136341;228;36891345;43;0;0;0
FR;0;2021-08-06;359743;271232;1835;4;326652;0;0;0;0;45058202;32791370;138176;232;37217997;43;0;0;0
FR;0;2021-08-07;213139;178320;756;5;210069;1;0;0;0;45271341;32969690;138932;237;37428066;44;0;0;0
FR;0;2021-08-08;74202;63182;276;0;73616;0;0;0;0;45345543;33032872;139208;237;37501682;44;0;0;0
FR;0;2021-08-09;258769;258627;1548;4;297570;2;0;0;0;45604312;33291499;140756;241;37799252;46;0;0;0
FR;0;2021-08-10;306887;277096;1663;2;323515;0;0;0;0;45911199;33568595;142419;243;38122767;46;0;0;0
FR;0;2021-08-11;279756;259585;1441;5;301678;0;0;0;0;46190955;33828180;143860;248;38424445;46;0;0;0
FR;0;2021-08-12;271558;278057;1668;3;320355;0;0;0;0;46462513;34106237;145528;251;38744800;46;0;0;0
FR;0;2021-08-13;252166;278083;1594;3;316946;2;0;0;0;46714679;34384320;147122;254;39061746;48;0;0;0
FR;0;2021-08-14;145354;197083;740;0;219026;0;0;0;0;46860033;34581403;147862;254;39280772;48;0;0;0
FR;0;2021-08-15;39396;50095;218;1;55680;0;0;0;0;46899429;34631498;148080;255;39336452;48;0;0;0
FR;0;2021-08-16;186195;317520;1542;0;345473;0;0;0;0;47085624;34949018;149622;255;39681925;48;0;0;0
FR;0;2021-08-17;215703;335826;1638;7;368891;0;0;0;0;47301327;35284844;151260;262;40050816;48;0;0;0
FR;0;2021-08-18;199066;324378;1599;7;354571;4;0;0;0;47500393;35609222;152859;269;40405387;52;0;0;0
FR;0;2021-08-19;192044;325411;1642;1;356003;0;0;0;0;47692437;35934633;154501;270;40761390;52;0;0;0
FR;0;2021-08-20;186481;366200;1820;3;396668;2;0;0;0;47878918;36300833;156321;273;41158058;54;0;0;0
FR;0;2021-08-21;104806;238128;709;0;254573;0;0;0;0;47983724;36538961;157030;273;41412631;54;0;0;0
FR;0;2021-08-22;31946;87212;256;1;92166;1;0;0;0;48015670;36626173;157286;274;41504797;55;0;0;0
FR;0;2021-08-23;140990;357000;1561;3;379620;0;0;0;0;48156660;36983173;158847;277;41884417;55;0;0;0
FR;0;2021-08-24;162512;376616;1850;5;402898;0;0;0;0;48319172;37359789;160697;282;42287315;55;0;0;0
FR;0;2021-08-25;151159;350735;2036;8;375460;2;0;0;0;48470331;37710524;162733;290;42662775;57;0;0;0
FR;0;2021-08-26;142886;342745;2561;10;367587;0;0;0;0;48613217;38053269;165294;300;43030362;57;0;0;0
FR;0;2021-08-27;148457;388253;2791;11;414958;1;0;0;0;48761674;38441522;168085;311;43445320;58;0;0;0
FR;0;2021-08-28;90676;249627;1407;0;264976;0;0;0;0;48852350;38691149;169492;311;43710296;58;0;0;0
FR;0;2021-08-29;27323;83341;518;1;88262;0;0;0;0;48879673;38774490;170010;312;43798558;58;0;0;0
FR;0;2021-08-30;117427;324590;4713;6;342401;5859;0;0;0;48997100;39099080;174723;318;44140959;5917;0;0;0
FR;0;2021-08-31;128825;334463;10189;19;353950;11779;2;0;0;49125925;39433543;184912;337;44494909;17696;2;0;0
FR;0;2021-09-01;136159;285667;22435;8;302436;24407;1;0;0;49262084;39719210;207347;345;44797345;42103;3;0;0
FR;0;2021-09-02;114659;247197;26522;20;262117;29002;0;0;0;49376743;39966407;233869;365;45059462;71105;3;0;0
FR;0;2021-09-03;118321;292657;29967;24;309330;33078;1;0;0;49495064;40259064;263836;389;45368792;104183;4;0;0
FR;0;2021-09-04;89891;217787;12588;12;230507;14149;7;0;0;49584955;40476851;276424;401;45599299;118332;11;0;0
FR;0;2021-09-05;21362;44802;4395;2;48291;4714;0;0;0;49606317;40521653;280819;403;45647590;123046;11;0;0
FR;0;2021-09-06;75697;180522;31956;16;190719;34301;2;0;0;49682014;40702175;312775;419;45838309;157347;13;0;0
FR;0;2021-09-07;80312;181185;33248;43;191081;36304;2;0;0;49762326;40883360;346023;462;46029390;193651;15;0;0
FR;0;2021-09-08;91005;206076;29667;28;216588;32563;4;0;0;49853331;41089436;375690;490;46245978;226214;19;0;0
FR;0;2021-09-09;76958;165304;33081;27;174123;36694;5;0;0;49930289;41254740;408771;517;46420101;262908;24;0;0
FR;0;2021-09-10;96042;203801;35743;28;214920;40774;7;0;0;50026331;41458541;444514;545;46635021;303682;31;0;0
FR;0;2021-09-11;67167;169314;12140;19;178188;14397;0;0;0;50093498;41627855;456654;564;46813209;318079;31;0;0
FR;0;2021-09-12;12827;32096;2782;1;34146;3187;2;0;0;50106325;41659951;459436;565;46847355;321266;33;0;0
FR;0;2021-09-13;64576;126183;41245;35;134225;44248;17;0;0;50170901;41786134;500681;600;46981580;365514;50;0;0
FR;0;2021-09-14;73497;129009;56383;80;135791;62415;42;0;0;50244398;41915143;557064;680;47117371;427929;92;0;0
FR;0;2021-09-15;76652;167755;55669;58;174714;54844;77;0;0;50321050;42082898;612733;738;47292085;482773;169;0;0
FR;0;2021-09-16;63887;114496;60100;82;117886;60163;69;0;0;50384937;42197394;672833;820;47409971;542936;238;0;0
FR;0;2021-09-17;75089;156845;53857;71;159739;57339;68;0;0;50460026;42354239;726690;891;47569710;600275;306;0;0
FR;0;2021-09-18;48240;139629;15602;25;144315;17319;20;0;0;50508266;42493868;742292;916;47714025;617594;326;0;0
FR;0;2021-09-19;7908;23657;2440;1;24886;2618;1;0;0;50516174;42517525;744732;917;47738911;620212;327;0;0
FR;0;2021-09-20;44577;93747;50088;72;96242;50344;36;0;0;50560751;42611272;794820;989;47835153;670556;363;0;0
FR;0;2021-09-21;45909;98383;62769;77;98392;63506;80;0;0;50606660;42709655;857589;1066;47933545;734062;443;0;0
FR;0;2021-09-22;48697;142397;55379;82;144848;55470;47;0;0;50655357;42852052;912968;1148;48078393;789532;490;0;0
FR;0;2021-09-23;43291;92071;62404;95;91277;63589;89;0;0;50698648;42944123;975372;1243;48169670;853121;579;0;0
FR;0;2021-09-24;52316;133300;54563;107;132406;59222;78;0;0;50750964;43077423;1029935;1350;48302076;912343;657;0;0
FR;0;2021-09-25;35221;115653;16276;36;118647;18312;22;0;0;50786185;43193076;1046211;1386;48420723;930655;679;0;0
FR;0;2021-09-26;5556;17803;2273;5;18688;2331;5;0;0;50791741;43210879;1048484;1391;48439411;932986;684;0;0
FR;0;2021-09-27;33982;76912;47204;97;78801;48186;83;0;1;50825723;43287791;1095688;1488;48518212;981172;767;0;1
FR;0;2021-09-28;36522;75246;54976;90;74337;56586;48;0;0;50862245;43363037;1150664;1578;48592549;1037758;815;0;1
FR;0;2021-09-29;44423;100709;53370;112;102867;54906;44;0;0;50906668;43463746;1204034;1690;48695416;1092664;859;0;1
FR;0;2021-09-30;36345;72976;57044;96;71481;59606;58;0;0;50943013;43536722;1261078;1786;48766897;1152270;917;0;1
FR;0;2021-10-01;61716;102863;57829;108;101435;63998;25;0;0;51004729;43639585;1318907;1894;48868332;1216268;942;0;1
FR;0;2021-10-02;39470;78443;20964;39;81730;23383;12;0;0;51044199;43718028;1339871;1933;48950062;1239651;954;0;1
FR;0;2021-10-03;5289;10495;2533;4;11260;2541;4;0;0;51049488;43728523;1342404;1937;48961322;1242192;958;0;1
FR;0;2021-10-04;35199;58498;52632;84;59506;54851;37;0;0;51084687;43787021;1395036;2021;49020828;1297043;995;0;1
FR;0;2021-10-05;33927;64361;61028;135;62102;65107;50;0;0;51118614;43851382;1456064;2156;49082930;1362150;1045;0;1
FR;0;2021-10-06;42725;79283;65759;112;80168;68373;29;0;0;51161339;43930665;1521823;2268;49163098;1430523;1074;0;1
FR;0;2021-10-07;30571;62273;65444;89;59502;68885;39;0;0;51191910;43992938;1587267;2357;49222600;1499408;1113;0;1
FR;0;2021-10-08;49483;91935;77769;111;89885;84803;41;0;0;51241393;44084873;1665036;2468;49312485;1584211;1154;0;1
FR;0;2021-10-09;33677;60938;31548;35;64140;33925;17;0;0;51275070;44145811;1696584;2503;49376625;1618136;1171;0;1
FR;0;2021-10-10;4720;7429;3198;9;7945;3477;2;0;0;51279790;44153240;1699782;2512;49384570;1621613;1173;0;1
FR;0;2021-10-11;30732;49895;61046;105;50614;64107;51;0;0;51310522;44203135;1760828;2617;49435184;1685720;1224;0;1
FR;0;2021-10-12;31643;54484;70631;141;51337;76028;28;0;0;51342165;44257619;1831459;2758;49486521;1761748;1252;0;1
FR;0;2021-10-13;40165;62830;74441;137;62799;79378;30;0;1;51382330;44320449;1905900;2895;49549320;1841126;1282;0;2
FR;0;2021-10-14;30360;52869;68774;116;49701;73854;35;0;0;51412690;44373318;1974674;3011;49599021;1914980;1317;0;2
FR;0;2021-10-15;44952;75237;93244;191;70337;103040;27;0;0;51457642;44448555;2067918;3202;49669358;2018020;1344;0;2
FR;0;2021-10-16;31332;44098;36698;44;46706;39659;16;0;0;51488974;44492653;2104616;3246;49716064;2057679;1360;0;2
FR;0;2021-10-17;3892;5226;3602;2;5673;3673;4;0;0;51492866;44497879;2108218;3248;49721737;2061352;1364;0;2
FR;0;2021-10-18;29208;42356;67515;134;42577;71373;28;0;0;51522074;44540235;2175733;3382;49764314;2132725;1392;0;2
FR;0;2021-10-19;27195;45548;76424;140;43216;81667;46;0;0;51549269;44585783;2252157;3522;49807530;2214392;1438;0;2
FR;0;2021-10-20;35342;52410;96953;181;51819;101571;45;0;0;51584611;44638193;2349110;3703;49859349;2315963;1483;0;2
FR;0;2021-10-21;26164;45163;83989;112;41963;89181;32;0;0;51610775;44683356;2433099;3815;49901312;2405144;1515;0;2
FR;0;2021-10-22;38449;62486;104923;200;59363;112642;61;0;0;51649224;44745842;2538022;4015;49960675;2517786;1576;0;2
FR;0;2021-10-23;27034;41205;45465;57;42437;48636;14;0;0;51676258;44787047;2583487;4072;50003112;2566422;1590;0;2
FR;0;2021-10-24;2946;4765;3685;6;5014;3924;1;0;0;51679204;44791812;2587172;4078;50008126;2570346;1591;0;2
FR;0;2021-10-25;26102;36232;82345;144;35510;86675;39;0;0;51705306;44828044;2669517;4222;50043636;2657021;1630;0;2
FR;0;2021-10-26;23767;34996;87277;166;32174;92399;36;0;0;51729073;44863040;2756794;4388;50075810;2749420;1666;0;2
FR;0;2021-10-27;30113;46314;109028;257;44053;114750;50;0;0;51759186;44909354;2865822;4645;50119863;2864170;1716;0;2
FR;0;2021-10-28;23608;34928;88740;153;31206;94530;38;0;0;51782794;44944282;2954562;4798;50151069;2958700;1754;0;2
FR;0;2021-10-29;31581;51459;117343;206;46512;125424;56;0;0;51814375;44995741;3071905;5004;50197581;3084124;1810;0;2
FR;0;2021-10-30;20575;33230;50360;76;32925;53421;20;0;0;51834950;45028971;3122265;5080;50230506;3137545;1830;0;2
FR;0;2021-10-31;2517;3734;3594;3;3846;3880;3;0;0;51837467;45032705;3125859;5083;50234352;3141425;1833;0;2
FR;0;2021-11-01;8530;4867;3222;3;5020;3584;10;0;0;51845997;45037572;3129081;5086;50239372;3145009;1843;0;2
FR;0;2021-11-02;26374;40105;93605;156;36255;99654;44;0;1;51872371;45077677;3222686;5242;50275627;3244663;1887;0;3
FR;0;2021-11-03;30127;47921;118918;222;43585;125889;65;0;0;51902498;45125598;3341604;5464;50319212;3370552;1952;0;3
FR;0;2021-11-04;23820;37479;107596;217;31583;114484;47;0;0;51926318;45163077;3449200;5681;50350795;3485036;1999;0;3
FR;0;2021-11-05;32407;52938;141669;236;44658;151452;54;0;0;51958725;45216015;3590869;5917;50395453;3636488;2053;0;3
FR;0;2021-11-06;21551;34556;64897;123;32396;68334;27;0;0;51980276;45250571;3655766;6040;50427849;3704822;2080;0;3
FR;0;2021-11-07;2427;4169;5208;6;4011;5599;7;0;0;51982703;45254740;3660974;6046;50431860;3710421;2087;0;3
FR;0;2021-11-08;20627;37735;127224;227;30950;134347;51;0;0;52003330;45292475;3788198;6273;50462810;3844768;2138;0;3
FR;0;2021-11-09;22441;44648;161735;339;32870;172333;69;0;0;52025771;45337123;3949933;6612;50495680;4017101;2207;0;3
FR;0;2021-11-10;31614;54904;187058;447;44052;198875;95;0;0;52057385;45392027;4136991;7059;50539732;4215976;2302;0;3
FR;0;2021-11-11;4748;6751;12993;28;5907;13981;17;0;0;52062133;45398778;4149984;7087;50545639;4229957;2319;0;3
FR;0;2021-11-12;29097;55059;183836;252;41746;197478;91;0;0;52091230;45453837;4333820;7339;50587385;4427435;2410;0;3
FR;0;2021-11-13;20354;32608;80728;118;28237;86356;45;0;0;52111584;45486445;4414548;7457;50615622;4513791;2455;0;3
FR;0;2021-11-14;2365;3860;7183;6;3365;7848;9;0;0;52113949;45490305;4421731;7463;50618987;4521639;2464;0;3
FR;0;2021-11-15;20513;38556;160902;314;27795;171634;77;0;0;52134462;45528861;4582633;7777;50646782;4693273;2541;0;3
FR;0;2021-11-16;23666;43862;200474;394;27737;215166;119;0;1;52158128;45572723;4783107;8171;50674519;4908439;2660;0;4
FR;0;2021-11-17;30541;50247;199897;406;36459;212956;101;0;0;52188669;45622970;4983004;8577;50710978;5121395;2761;0;4
FR;0;2021-11-18;23454;45690;191741;468;29410;205716;96;0;0;52212123;45668660;5174745;9045;50740388;5327111;2857;0;4
FR;0;2021-11-19;33692;61286;243285;551;39933;262294;150;0;0;52245815;45729946;5418030;9596;50780321;5589405;3007;0;4
FR;0;2021-11-20;25418;36663;102186;207;29268;109754;47;0;0;52271233;45766609;5520216;9803;50809589;5699159;3054;0;4
FR;0;2021-11-21;2661;4445;9675;19;3443;10603;19;0;0;52273894;45771054;5529891;9822;50813032;5709762;3073;0;4
FR;0;2021-11-22;22820;33133;180431;472;18931;194918;89;0;0;52296714;45804187;5710322;10294;50831963;5904680;3162;0;4
FR;0;2021-11-23;25733;45467;229475;549;24130;247955;85;0;0;52322447;45849654;5939797;10843;50856093;6152635;3247;0;4
FR;0;2021-11-24;31820;53619;224891;716;34507;243340;81;0;0;52354267;45903273;6164688;11559;50890600;6395975;3328;0;4
FR;0;2021-11-25;25650;49136;256004;739;25073;277890;112;0;0;52379917;45952409;6420692;12298;50915673;6673865;3440;0;4
FR;0;2021-11-26;33257;74696;379552;867;37436;414773;172;0;0;52413174;46027105;6800244;13165;50953109;7088638;3612;0;4
FR;0;2021-11-27;23507;49576;214966;390;28483;236760;134;0;0;52436681;46076681;7015210;13555;50981592;7325398;3746;0;4
FR;0;2021-11-28;3525;10466;56782;66;4066;63337;42;0;0;52440206;46087147;7071992;13621;50985658;7388735;3788;0;4
FR;0;2021-11-29;19444;54081;341552;864;23116;371880;178;0;0;52459650;46141228;7413544;14485;51008774;7760615;3966;0;4
FR;0;2021-11-30;24787;71843;457472;988;26865;500900;286;0;0;52484437;46213071;7871016;15473;51035639;8261515;4252;0;4
FR;0;2021-12-01;27386;75514;469198;1162;31397;511428;304;0;0;52511823;46288585;8340214;16635;51067036;8772943;4556;0;4
FR;0;2021-12-02;22123;71570;527226;1281;21087;575037;307;0;0;52533946;46360155;8867440;17916;51088123;9347980;4863;0;4
FR;0;2021-12-03;25579;92838;596503;1421;34416;651276;341;0;0;52559525;46452993;9463943;19337;51122539;9999256;5204;0;4
FR;0;2021-12-04;18342;60355;336294;692;25714;369881;198;0;0;52577867;46513348;9800237;20029;51148253;10369137;5402;0;4
FR;0;2021-12-05;4157;16104;95815;157;4868;107049;92;0;0;52582024;46529452;9896052;20186;51153121;10476186;5494;0;4
FR;0;2021-12-06;28454;72735;493246;1175;25294;540065;384;0;0;52610478;46602187;10389298;21361;51178415;11016251;5878;0;4
FR;0;2021-12-07;23563;91234;645524;1774;28582;706509;415;0;0;52634041;46693421;11034822;23135;51206997;11722760;6293;0;4
FR;0;2021-12-08;25521;91960;591755;1875;34995;647648;440;0;0;52659562;46785381;11626577;25010;51241992;12370408;6733;0;4
FR;0;2021-12-09;24083;94119;663264;2181;29067;726714;462;0;0;52683645;46879500;12289841;27191;51271059;13097122;7195;0;4
FR;0;2021-12-10;28074;110920;736171;2075;38035;806334;469;0;1;52711719;46990420;13026012;29266;51309094;13903456;7664;0;5
FR;0;2021-12-11;20251;76085;435240;990;29985;480461;345;0;0;52731970;47066505;13461252;30256;51339079;14383917;8009;0;5
FR;0;2021-12-12;5678;23131;142346;262;6406;159225;108;0;0;52737648;47089636;13603598;30518;51345485;14543142;8117;0;5
FR;0;2021-12-13;21363;90782;587799;1699;29731;649417;396;0;0;52759011;47180418;14191397;32217;51375216;15192559;8513;0;5
FR;0;2021-12-14;27986;118282;765747;2656;35504;847702;698;0;1;52786997;47298700;14957144;34873;51410720;16040261;9211;0;6
FR;0;2021-12-15;28452;114218;694473;2266;39570;769254;502;0;1;52815449;47412918;15651617;37139;51450290;16809515;9713;0;7
FR;0;2021-12-16;28054;115671;764184;2558;35184;844600;516;0;0;52843503;47528589;16415801;39697;51485474;17654115;10229;0;7
FR;0;2021-12-17;31664;128342;807987;2713;43440;892144;610;0;0;52875167;47656931;17223788;42410;51528914;18546259;10839;0;7
FR;0;2021-12-18;24944;81541;470038;1179;30097;522260;353;0;0;52900111;47738472;17693826;43589;51559011;19068519;11192;0;7
FR;0;2021-12-19;8769;28561;169436;376;7862;191071;141;0;0;52908880;47767033;17863262;43965;51566873;19259590;11333;0;7
FR;0;2021-12-20;31777;97172;591593;1787;33949;658823;500;0;0;52940657;47864205;18454855;45752;51600822;19918413;11833;0;7
FR;0;2021-12-21;39476;111946;682515;2392;38847;759657;603;0;0;52980133;47976151;19137370;48144;51639669;20678070;12436;0;7
FR;0;2021-12-22;39562;99210;575867;2169;37173;642188;687;0;2;53019695;48075361;19713237;50313;51676842;21320258;13123;0;9
FR;0;2021-12-23;33784;79416;441074;1659;30180;494420;591;0;0;53053479;48154777;20154311;51972;51707022;21814678;13714;0;9
FR;0;2021-12-24;10698;26048;111047;398;11660;126673;236;0;1;53064177;48180825;20265358;52370;51718682;21941351;13950;0;10
FR;0;2021-12-25;776;3582;7598;25;2053;9026;72;0;0;53064953;48184407;20272956;52395;51720735;21950377;14022;0;10
FR;0;2021-12-26;4698;11892;52114;142;4742;60163;170;0;0;53069651;48196299;20325070;52537;51725477;22010540;14192;0;10
FR;0;2021-12-27;30510;83948;453612;1364;33075;509241;665;0;0;53100161;48280247;20778682;53901;51758552;22519781;14857;0;10
FR;0;2021-12-28;38370;98866;564211;1769;35153;632306;1559;0;2;53138531;48379113;21342893;55670;51793705;23152087;16416;0;12
FR;0;2021-12-29;39882;88224;501256;1687;33155;561035;1739;0;1;53178413;48467337;21844149;57357;51826860;23713122;18155;0;13
FR;0;2021-12-30;35925;75102;421060;1521;29552;471157;1881;0;0;53214338;48542439;22265209;58878;51856412;24184279;20036;0;13
FR;0;2021-12-31;12050;25088;116888;405;11288;131665;740;0;0;53226388;48567527;22382097;59283;51867700;24315944;20776;0;13
FR;0;2022-01-01;1581;3218;8530;37;1799;9949;102;0;0;53227969;48570745;22390627;59320;51869499;24325893;20878;0;13
FR;0;2022-01-02;6121;13011;58432;126;5109;66962;409;0;0;53234090;48583756;22449059;59446;51874608;24392855;21287;0;13
FR;0;2022-01-03;38463;90212;494881;1596;36931;551773;2644;0;1;53272553;48673968;22943940;61042;51911539;24944628;23931;0;14
FR;0;2022-01-04;42137;111082;641441;2308;40725;714463;3835;0;3;53314690;48785050;23585381;63350;51952264;25659091;27766;0;17
FR;0;2022-01-05;61201;103632;569246;1984;43836;634284;3427;0;2;53375891;48888682;24154627;65334;51996100;26293375;31193;0;19
FR;0;2022-01-06;44297;110346;639016;2699;40264;711524;4557;0;2;53420188;48999028;24793643;68033;52036364;27004899;35750;0;21
FR;0;2022-01-07;50836;123369;711039;2811;46905;790542;4996;0;2;53471024;49122397;25504682;70844;52083269;27795441;40746;0;23
FR;0;2022-01-08;45013;80287;423828;1213;35060;472901;2444;0;3;53516037;49202684;25928510;72057;52118329;28268342;43190;0;26
FR;0;2022-01-09;15614;26626;128572;300;11511;145654;829;0;0;53531651;49229310;26057082;72357;52129840;28413996;44019;0;26
FR;0;2022-01-10;35401;93316;469369;1814;43077;522757;3719;0;1;53567052;49322626;26526451;74171;52172917;28936753;47738;0;27
FR;0;2022-01-11;41936;100494;548293;2309;42450;608551;5217;0;2;53608988;49423120;27074744;76480;52215367;29545304;52955;0;29
FR;0;2022-01-12;60415;95744;452721;1968;49538;504385;4496;0;8;53669403;49518864;27527465;78448;52264905;30049689;57451;0;37
FR;0;2022-01-13;38266;92558;487378;2084;40598;541057;5467;0;8;53707669;49611422;28014843;80532;52305503;30590746;62918;0;45
FR;0;2022-01-14;42579;103359;568645;2286;43562;629031;6467;0;2;53750248;49714781;28583488;82818;52349065;31219777;69385;0;47
FR;0;2022-01-15;39427;65911;340153;984;31465;377572;3294;0;1;53789675;49780692;28923641;83802;52380530;31597349;72679;0;48
FR;0;2022-01-16;11413;19219;87438;216;9028;99408;763;0;0;53801088;49799911;29011079;84018;52389558;31696757;73442;0;48
FR;0;2022-01-17;24740;60039;320307;1384;28083;354161;3961;0;4;53825828;49859950;29331386;85402;52417641;32050918;77403;0;52
FR;0;2022-01-18;28326;68711;361122;1801;32033;397577;5772;0;1;53854154;49928661;29692508;87203;52449674;32448495;83175;0;53
FR;0;2022-01-19;43221;67062;281322;1451;40416;311084;4388;0;5;53897375;49995723;29973830;88654;52490090;32759579;87563;0;58
FR;0;2022-01-20;23669;59612;299048;1750;29566;328525;5635;0;4;53921044;50055335;30272878;90404;52519656;33088104;93198;0;62
FR;0;2022-01-21;28207;68812;366395;2086;33113;401205;6580;0;3;53949251;50124147;30639273;92490;52552769;33489309;99778;0;65
FR;0;2022-01-22;27630;47986;218797;839;27319;241777;2838;0;2;53976881;50172133;30858070;93329;52580088;33731086;102616;0;67
FR;0;2022-01-23;6738;12971;48684;173;7504;55163;591;0;1;53983619;50185104;30906754;93502;52587592;33786249;103207;0;68
FR;0;2022-01-24;16279;47471;217337;1148;25422;239348;4101;0;3;53999898;50232575;31124091;94650;52613014;34025597;107308;0;71
FR;0;2022-01-25;19030;54351;243082;1548;28817;267102;6068;0;5;54018928;50286926;31367173;96198;52641831;34292699;113376;0;76
FR;0;2022-01-26;28147;60548;209300;1298;41367;229518;4479;0;3;54047075;50347474;31576473;97496;52683198;34522217;117855;0;79
FR;0;2022-01-27;16335;46467;207660;1285;26152;226029;5690;0;4;54063410;50393941;31784133;98781;52709350;34748246;123545;0;83
FR;0;2022-01-28;21592;78684;290074;1573;44984;321355;7411;0;4;54085002;50472625;32074207;100354;52754334;35069601;130956;0;87
FR;0;2022-01-29;18420;52864;184134;689;32755;204577;3256;0;2;54103422;50525489;32258341;101043;52787089;35274178;134212;0;89
FR;0;2022-01-30;4476;14476;39145;124;9137;45058;638;0;1;54107898;50539965;32297486;101167;52796226;35319236;134850;0;90
FR;0;2022-01-31;11259;43940;148213;742;26149;164745;4233;0;5;54119157;50583905;32445699;101909;52822375;35483981;139083;0;95
FR;0;2022-02-01;13637;48318;174139;1144;27347;191354;7044;0;1;54132794;50632223;32619838;103053;52849722;35675335;146127;0;96
FR;0;2022-02-02;20644;66319;171548;1034;46166;190093;5973;0;10;54153438;50698542;32791386;104087;52895888;35865428;152100;0;106
FR;0;2022-02-03;11577;44794;157569;990;25342;173291;6939;0;6;54165015;50743336;32948955;105077;52921230;36038719;159039;0;112
FR;0;2022-02-04;14637;67032;239258;1266;36651;264097;9162;0;6;54179652;50810368;33188213;106343;52957881;36302816;168201;0;118
FR;0;2022-02-05;12900;51454;153560;523;31985;172309;3791;0;3;54192552;50861822;33341773;106866;52989866;36475125;171992;0;121
FR;0;2022-02-06;2725;12173;28895;101;7286;33833;661;0;0;54195277;50873995;33370668;106967;52997152;36508958;172653;0;121
FR;0;2022-02-07;9594;46658;156896;593;24533;176314;5294;0;6;54204871;50920653;33527564;107560;53021685;36685272;177947;0;127
FR;0;2022-02-08;9807;43096;166649;869;20960;184443;7054;0;6;54214678;50963749;33694213;108429;53042645;36869715;185001;0;133
FR;0;2022-02-09;14372;58254;172351;875;35350;193061;5787;0;9;54229050;51022003;33866564;109304;53077995;37062776;190788;0;142
FR;0;2022-02-10;8719;39208;150238;879;18684;166716;6501;0;2;54237769;51061211;34016802;110183;53096679;37229492;197289;0;144
FR;0;2022-02-11;10858;55683;218516;1101;25821;243111;8322;0;3;54248627;51116894;34235318;111284;53122500;37472603;205611;0;147
FR;0;2022-02-12;8406;40964;134736;465;22631;151765;3508;0;4;54257033;51157858;34370054;111749;53145131;37624368;209119;0;151
FR;0;2022-02-13;1936;8603;26565;86;4409;30927;544;0;3;54258969;51166461;34396619;111835;53149540;37655295;209663;0;154
FR;0;2022-02-14;6991;35254;148385;485;14666;166381;4787;0;5;54265960;51201715;34545004;112320;53164206;37821676;214450;0;159
FR;0;2022-02-15;7065;36228;146992;751;15994;162577;6850;0;3;54273025;51237943;34691996;113071;53180200;37984253;221300;0;162
FR;0;2022-02-16;9412;42986;132541;721;25974;146760;5726;0;6;54282437;51280929;34824537;113792;53206174;38131013;227026;0;168
FR;0;2022-02-17;5578;24338;87309;587;13143;94882;5407;0;5;54288015;51305267;34911846;114379;53219317;38225895;232433;0;173
FR;0;2022-02-18;6998;33581;119666;807;18753;129330;7416;0;2;54295013;51338848;35031512;115186;53238070;38355225;239849;0;175
FR;0;2022-02-19;5370;24557;70030;370;15908;77340;3019;0;2;54300383;51363405;35101542;115556;53253978;38432565;242868;0;177
FR;0;2022-02-20;1148;4657;12175;39;2914;13954;460;0;1;54301531;51368062;35113717;115595;53256892;38446519;243328;0;178
FR;0;2022-02-21;4098;17889;61958;351;10169;67185;4059;0;2;54305629;51385951;35175675;115946;53267061;38513704;247387;0;180
FR;0;2022-02-22;4462;18657;60838;577;11259;64479;5255;0;1;54310091;51404608;35236513;116523;53278320;38578183;252642;0;181
FR;0;2022-02-23;6591;27358;66505;592;19626;71902;4596;0;3;54316682;51431966;35303018;117115;53297946;38650085;257238;0;184
FR;0;2022-02-24;3850;15550;50430;519;9510;53254;4530;0;2;54320532;51447516;35353448;117634;53307456;38703339;261768;0;186
FR;0;2022-02-25;5284;24131;76363;803;15107;80096;7334;0;7;54325816;51471647;35429811;118437;53322563;38783435;269102;0;193
FR;0;2022-02-26;3991;17768;47419;359;12170;51486;3083;0;3;54329807;51489415;35477230;118796;53334733;38834921;272185;0;196
FR;0;2022-02-27;880;3009;8037;47;1978;8948;529;0;0;54330687;51492424;35485267;118843;53336711;38843869;272714;0;196
FR;0;2022-02-28;3123;12553;40492;359;7589;42925;3858;0;0;54333810;51504977;35525759;119202;53344300;38886794;276572;0;196
FR;0;2022-03-01;4004;12606;44200;437;7633;44870;5519;0;6;54337814;51517583;35569959;119639;53351933;38931664;282091;0;202
FR;0;2022-03-02;5331;17797;47145;446;12857;49077;4929;0;2;54343145;51535380;35617104;120085;53364790;38980741;287020;0;204
FR;0;2022-03-03;2826;9353;29898;370;6250;30021;4049;0;2;54345971;51544733;35647002;120455;53371040;39010762;291069;0;206
FR;0;2022-03-04;3222;12476;40320;667;8475;39470;6231;0;4;54349193;51557209;35687322;121122;53379515;39050232;297300;0;210
FR;0;2022-03-05;3073;9284;24958;314;7127;25122;3134;0;1;54352266;51566493;35712280;121436;53386642;39075354;300434;0;211
FR;0;2022-03-06;521;1400;3198;43;1023;3441;379;0;0;54352787;51567893;35715478;121479;53387665;39078795;300813;0;211
FR;0;2022-03-07;2377;5631;18433;315;3849;17703;3307;0;4;54355164;51573524;35733911;121794;53391514;39096498;304120;0;215
FR;0;2022-03-08;2148;6077;19447;363;4331;17919;4094;0;3;54357312;51579601;35753358;122157;53395845;39114417;308214;0;218
FR;0;2022-03-09;3582;10498;22190;407;8728;21285;4039;0;4;54360894;51590099;35775548;122564;53404573;39135702;312253;0;222
FR;0;2022-03-10;1828;5835;17005;344;4381;15831;3407;0;3;54362722;51595934;35792553;122908;53408954;39151533;315660;0;225
FR;0;2022-03-11;2419;7559;24503;545;5439;22271;5479;0;2;54365141;51603493;35817056;123453;53414393;39173804;321139;0;227
FR;0;2022-03-12;2695;6777;17167;309;5497;16521;3136;0;2;54367836;51610270;35834223;123762;53419890;39190325;324275;0;229
FR;0;2022-03-13;405;791;2324;149;599;2273;537;0;0;54368241;51611061;35836547;123911;53420489;39192598;324812;0;229
FR;0;2022-03-14;1554;4274;14987;4412;2809;13841;7295;0;8;54369795;51615335;35851534;128323;53423298;39206439;332107;0;237
FR;0;2022-03-15;1749;6295;16383;7556;4812;14612;11035;0;9;54371544;51621630;35867917;135879;53428110;39221051;343142;0;246
FR;0;2022-03-16;3035;7408;19427;13140;6210;18106;16296;0;8;54374579;51629038;35887344;149019;53434320;39239157;359438;0;254
FR;0;2022-03-17;1457;3985;13151;10846;2805;11990;13314;0;8;54376036;51633023;35900495;159865;53437125;39251147;372752;0;262
FR;0;2022-03-18;2269;5757;20012;18306;4098;18108;22038;0;15;54378305;51638780;35920507;178171;53441223;39269255;394790;0;277
FR;0;2022-03-19;2294;4803;13115;9405;4139;12418;11408;0;6;54380599;51643583;35933622;187576;53445362;39281673;406198;0;283
FR;0;2022-03-20;300;734;1919;1073;526;1930;1340;0;2;54380899;51644317;35935541;188649;53445888;39283603;407538;0;285
FR;0;2022-03-21;1392;3220;12731;14950;2154;11955;16910;0;11;54382291;51647537;35948272;203599;53448042;39295558;424448;0;296
FR;0;2022-03-22;1554;3738;13801;20551;2578;12556;22842;0;5;54383845;51651275;35962073;224150;53450620;39308114;447290;0;301
FR;0;2022-03-23;2685;6291;17729;23151;5223;17241;25267;0;40;54386530;51657566;35979802;247301;53455843;39325355;472557;0;341
FR;0;2022-03-24;1407;3159;11596;17617;2248;10682;19391;0;23;54387937;51660725;35991398;264918;53458091;39336037;491948;0;364
FR;0;2022-03-25;2084;5156;18572;27775;3685;16910;30809;0;31;54390021;51665881;36009970;292693;53461776;39352947;522757;0;395
FR;0;2022-03-26;2232;4414;12079;12678;3864;11519;14400;0;26;54392253;51670295;36022049;305371;53465640;39364466;537157;0;421
FR;0;2022-03-27;361;693;1909;1482;515;1943;1739;0;1;54392614;51670988;36023958;306853;53466155;39366409;538896;0;422
FR;0;2022-03-28;1464;3079;11128;17490;2116;10619;19067;0;16;54394078;51674067;36035086;324343;53468271;39377028;557963;0;438
FR;0;2022-03-29;1454;3274;12908;27583;2090;12051;29281;0;34;54395532;51677341;36047994;351926;53470361;39389079;587244;0;472
FR;0;2022-03-30;2853;5517;15685;27428;4701;15085;29334;0;21;54398385;51682858;36063679;379354;53475062;39404164;616578;0;493
FR;0;2022-03-31;1611;3567;12987;25022;2550;12327;26631;0;43;54399996;51686425;36076666;404376;53477612;39416491;643209;0;536
FR;0;2022-04-01;2680;4584;20077;30894;2968;18719;33487;0;61;54402676;51691009;36096743;435270;53480580;39435210;676696;0;597
FR;0;2022-04-02;1531;2644;9052;10133;2008;8722;11295;0;29;54404207;51693653;36105795;445403;53482588;39443932;687991;0;626
FR;0;2022-04-03;290;515;1562;1170;360;1579;1381;0;2;54404497;51694168;36107357;446573;53482948;39445511;689372;0;628
FR;0;2022-04-04;2858;2902;12374;19130;1918;11583;20601;0;35;54407355;51697070;36119731;465703;53484866;39457094;709973;0;663
FR;0;2022-04-05;2455;3157;14341;34142;2036;13194;35758;0;85;54409810;51700227;36134072;499845;53486902;39470288;745731;0;748
FR;0;2022-04-06;2540;3949;13539;26505;3014;12813;27974;0;72;54412350;51704176;36147611;526350;53489916;39483101;773705;0;820
FR;0;2022-04-07;1858;3135;13679;33782;1986;12889;35140;0;76;54414208;51707311;36161290;560132;53491902;39495990;808845;0;896
FR;0;2022-04-08;2218;4283;19222;43986;2618;17828;46354;0;89;54416426;51711594;36180512;604118;53494520;39513818;855199;0;985
FR;0;2022-04-09;1368;2679;9313;13566;1900;8866;14800;0;30;54417794;51714273;36189825;617684;53496420;39522684;869999;0;1015
FR;0;2022-04-10;294;752;1984;2017;549;2006;2279;0;7;54418088;51715025;36191809;619701;53496969;39524690;872278;0;1022
FR;0;2022-04-11;1329;2620;11872;23910;1636;11483;25180;0;74;54419417;51717645;36203681;643611;53498605;39536173;897458;0;1096
FR;0;2022-04-12;1715;3072;14017;40912;1955;13390;41801;0;127;54421132;51720717;36217698;684523;53500560;39549563;939259;0;1223
FR;0;2022-04-13;1973;3719;13409;33108;2716;13032;34076;0;96;54423105;51724436;36231107;717631;53503276;39562595;973335;0;1319
FR;0;2022-04-14;1497;2973;13215;36322;1901;13073;36991;0;106;54424602;51727409;36244322;753953;53505177;39575668;1010326;0;1425
FR;0;2022-04-15;1869;3765;15639;35568;2511;14916;37220;0;115;54426471;51731174;36259961;789521;53507688;39590584;1047546;0;1540
FR;0;2022-04-16;1043;1830;6400;8553;1260;6262;9435;0;40;54427514;51733004;36266361;798074;53508948;39596846;1056981;0;1580
FR;0;2022-04-17;194;337;993;1174;221;1036;1242;0;7;54427708;51733341;36267354;799248;53509169;39597882;1058223;0;1587
FR;0;2022-04-18;197;541;2768;1072;342;2786;1287;0;5;54427905;51733882;36270122;800320;53509511;39600668;1059510;0;1592
FR;0;2022-04-19;1543;3029;12916;29667;1874;12476;30714;0;78;54429448;51736911;36283038;829987;53511385;39613144;1090224;0;1670
FR;0;2022-04-20;1999;3490;13304;29064;2603;12991;30081;0;96;54431447;51740401;36296342;859051;53513988;39626135;1120305;0;1766
FR;0;2022-04-21;1513;2850;12548;35178;1821;12623;35769;0;117;54432960;51743251;36308890;894229;53515809;39638758;1156074;0;1883
FR;0;2022-04-22;1876;3616;16478;37610;2392;15837;39148;0;131;54434836;51746867;36325368;931839;53518201;39654595;1195222;0;2014
FR;0;2022-04-23;1148;2062;7388;10658;1471;7239;11443;0;38;54435984;51748929;36332756;942497;53519672;39661834;1206665;0;2052
FR;0;2022-04-24;250;462;1475;1589;321;1413;1845;0;7;54436234;51749391;36334231;944086;53519993;39663247;1208510;0;2059
FR;0;2022-04-25;1306;2531;10683;21056;1611;10490;22077;0;79;54437540;51751922;36344914;965142;53521604;39673737;1230587;0;2138
FR;0;2022-04-26;1623;3004;13667;38613;1963;13110;39410;0;181;54439163;51754926;36358581;1003755;53523567;39686847;1269997;0;2319
FR;0;2022-04-27;1964;3063;11538;31034;2276;11595;31453;0;130;54441127;51757989;36370119;1034789;53525843;39698442;1301450;0;2449
FR;0;2022-04-28;1570;2770;12527;36226;1852;12269;36542;0;139;54442697;51760759;36382646;1071015;53527695;39710711;1337992;0;2588
FR;0;2022-04-29;2008;4808;15553;37277;3615;14929;38746;0;164;54444705;51765567;36398199;1108292;53531310;39725640;1376738;0;2752
FR;0;2022-04-30;1216;2890;6927;9717;2386;6755;10608;0;44;54445921;51768457;36405126;1118009;53533696;39732395;1387346;0;2796
FR;0;2022-05-01;218;325;916;998;229;911;1139;0;6;54446139;51768782;36406042;1119007;53533925;39733306;1388485;0;2802
FR;0;2022-05-02;2149;2947;11152;18174;2044;10984;19019;0;69;54448288;51771729;36417194;1137181;53535969;39744290;1407504;0;2871
FR;0;2022-05-03;2011;3262;13722;34679;2126;13563;35600;0;163;54450299;51774991;36430916;1171860;53538095;39757853;1443104;0;3034
FR;0;2022-05-04;1913;3296;12184;25639;2296;12301;26190;0;110;54452212;51778287;36443100;1197499;53540391;39770154;1469294;0;3144
FR;0;2022-05-05;1768;2996;13067;33594;1972;12913;34262;0;180;54453980;51781283;36456167;1231093;53542363;39783067;1503556;0;3324
FR;0;2022-05-06;2214;3655;15349;36799;2314;14858;38262;0;182;54456194;51784938;36471516;1267892;53544677;39797925;1541818;0;3506
FR;0;2022-05-07;1208;1781;6464;9613;1255;6455;10338;0;48;54457402;51786719;36477980;1277505;53545932;39804380;1552156;0;3554
FR;0;2022-05-08;267;400;1173;1547;289;1234;1653;0;8;54457669;51787119;36479153;1279052;53546221;39805614;1553809;0;3562
FR;0;2022-05-09;1386;2300;9926;20259;1407;9796;21176;0;102;54459055;51789419;36489079;1299311;53547628;39815410;1574985;0;3664
FR;0;2022-05-10;1783;3410;13577;38996;2273;13133;40023;0;200;54460838;51792829;36502656;1338307;53549901;39828543;1615008;0;3864
FR;0;2022-05-11;1998;3012;10751;27929;2316;10696;28437;0;146;54462836;51795841;36513407;1366236;53552217;39839239;1643445;0;4010
FR;0;2022-05-12;1589;2719;11380;35734;1788;11050;36496;0;211;54464425;51798560;36524787;1401970;53554005;39850289;1679941;0;4221
FR;0;2022-05-13;1975;3220;13758;37973;2060;13346;39239;0;162;54466400;51801780;36538545;1439943;53556065;39863635;1719180;0;4383
FR;0;2022-05-14;1148;1638;5937;10776;1196;5800;11364;0;57;54467548;51803418;36544482;1450719;53557261;39869435;1730544;0;4440
FR;0;2022-05-15;283;475;1278;1438;299;1361;1591;0;6;54467831;51803893;36545760;1452157;53557560;39870796;1732135;0;4446
FR;0;2022-05-16;1195;2043;8691;21069;1245;8697;21597;0;128;54469026;51805936;36554451;1473226;53558805;39879493;1753732;0;4574
FR;0;2022-05-17;1588;2599;11823;37876;1664;11401;38716;0;180;54470614;51808535;36566274;1511102;53560469;39890894;1792448;0;4754
FR;0;2022-05-18;1814;2650;9689;27160;1953;9663;27777;0;109;54472428;51811185;36575963;1538262;53562422;39900557;1820225;0;4863
FR;0;2022-05-19;1447;2655;10575;35835;1629;10714;36025;0;162;54473875;51813840;36586538;1574097;53564051;39911271;1856250;0;5025
FR;0;2022-05-20;1873;3112;13420;39367;2071;12911;40385;0;168;54475748;51816952;36599958;1613464;53566122;39924182;1896635;0;5193
FR;0;2022-05-21;1158;1706;5662;9897;1300;5534;10533;0;45;54476906;51818658;36605620;1623361;53567422;39929716;1907168;0;5238
FR;0;2022-05-22;238;341;1028;1438;262;1016;1581;0;10;54477144;51818999;36606648;1624799;53567684;39930732;1908749;0;5248
FR;0;2022-05-23;1175;2120;8879;20346;1402;8828;21001;0;86;54478319;51821119;36615527;1645145;53569086;39939560;1929750;0;5334
FR;0;2022-05-24;1541;2758;11363;38875;1734;11234;39505;0;190;54479860;51823877;36626890;1684020;53570820;39950794;1969255;0;5524
FR;0;2022-05-25;1814;2833;9342;24845;2071;9480;25321;0;116;54481674;51826710;36636232;1708865;53572891;39960274;1994576;0;5640
FR;0;2022-05-26;213;423;1666;1201;287;1675;1345;0;26;54481887;51827133;36637898;1710066;53573178;39961949;1995921;0;5666
FR;0;2022-05-27;1386;2470;9263;21290;1665;9003;22324;0;94;54483273;51829603;36647161;1731356;53574843;39970952;2018245;0;5760
FR;0;2022-05-28;669;1266;3916;6792;846;3966;7202;0;38;54483942;51830869;36651077;1738148;53575689;39974918;2025447;0;5798
FR;0;2022-05-29;157;315;752;920;200;773;1032;0;4;54484099;51831184;36651829;1739068;53575889;39975691;2026479;0;5802
FR;0;2022-05-30;1025;1961;6993;19295;1243;7010;19807;0;91;54485124;51833145;36658822;1758363;53577132;39982701;2046286;0;5893
FR;0;2022-05-31;1489;2508;9821;35654;1639;9643;36286;0;171;54486613;51835653;36668643;1794017;53578771;39992344;2082572;0;6064
FR;0;2022-06-01;1736;3097;11020;24532;2244;10885;25486;0;121;54488349;51838750;36679663;1818549;53581015;40003229;2108058;0;6185
FR;0;2022-06-02;1476;2611;11305;35568;1712;10863;36512;0;174;54489825;51841361;36690968;1854117;53582727;40014092;2144570;0;6359
FR;0;2022-06-03;1727;3069;13398;38723;2038;12763;39993;0;176;54491552;51844430;36704366;1892840;53584765;40026855;2184563;0;6535
FR;0;2022-06-04;971;1515;5045;9112;1075;5116;9648;0;73;54492523;51845945;36709411;1901952;53585840;40031971;2194211;0;6608
FR;0;2022-06-05;178;335;875;1106;205;886;1228;0;4;54492701;51846280;36710286;1903058;53586045;40032857;2195439;0;6612
FR;0;2022-06-06;620;1209;2120;1328;1035;2134;1508;0;13;54493321;51847489;36712406;1904386;53587080;40034991;2196947;0;6625
FR;0;2022-06-07;1414;2707;9849;35583;1785;9428;36809;0;153;54494735;51850196;36722255;1939969;53588865;40044419;2233756;0;6778
FR;0;2022-06-08;1563;2693;9167;28751;1939;9010;29716;0;112;54496298;51852889;36731422;1968720;53590804;40053429;2263472;0;6890
FR;0;2022-06-09;1289;2438;10622;39493;1553;10266;40269;0;167;54497587;51855327;36742044;2008213;53592357;40063695;2303741;0;7057
FR;0;2022-06-10;1627;3115;13081;44814;2082;12636;46146;0;224;54499214;51858442;36755125;2053027;53594439;40076331;2349887;0;7281
FR;0;2022-06-11;960;1737;5436;11626;1123;5469;12211;0;55;54500174;51860179;36760561;2064653;53595562;40081800;2362098;0;7336
FR;0;2022-06-12;198;443;1074;1765;253;1137;1866;0;11;54500372;51860622;36761635;2066418;53595815;40082937;2363964;0;7347
FR;0;2022-06-13;1096;2062;7439;23182;1336;7268;24098;0;90;54501468;51862684;36769074;2089600;53597151;40090205;2388062;0;7437
FR;0;2022-06-14;1321;2538;10448;44944;1587;9804;46140;0;200;54502789;51865222;36779522;2134544;53598738;40100009;2434202;0;7637
FR;0;2022-06-15;1511;2453;9322;30889;1922;8953;31586;0;178;54504300;51867675;36788844;2165433;53600660;40108962;2465788;0;7815
FR;0;2022-06-16;1181;2035;9913;39926;1269;9324;40947;0;201;54505481;51869710;36798757;2205359;53601929;40118286;2506735;0;8016
FR;0;2022-06-17;1489;2848;12494;46687;1772;11896;47929;0;240;54506970;51872558;36811251;2252046;53603701;40130182;2554664;0;8256
FR;0;2022-06-18;855;1525;4566;11123;1035;4501;11717;0;67;54507825;51874083;36815817;2263169;53604736;40134683;2566381;0;8323
FR;0;2022-06-19;183;363;1058;1615;208;1130;1701;0;14;54508008;51874446;36816875;2264784;53604944;40135813;2568082;0;8337
FR;0;2022-06-20;1025;1918;8906;26076;1192;8567;27018;0;153;54509033;51876364;36825781;2290860;53606136;40144380;2595100;0;8490
FR;0;2022-06-21;1326;2400;10310;49892;1535;9338;51278;0;264;54510359;51878764;36836091;2340752;53607671;40153718;2646378;0;8754
FR;0;2022-06-22;1389;2507;8912;39057;1798;8419;40001;0;256;54511748;51881271;36845003;2379809;53609469;40162137;2686379;0;9010
FR;0;2022-06-23;1228;2363;10679;55099;1359;9884;56232;0;320;54512976;51883634;36855682;2434908;53610828;40172021;2742611;0;9330
FR;0;2022-06-24;1488;2990;13642;69180;1746;12303;70998;0;405;54514464;51886624;36869324;2504088;53612574;40184324;2813609;0;9735
FR;0;2022-06-25;937;1779;6233;19919;1110;5985;20773;0;177;54515401;51888403;36875557;2524007;53613684;40190309;2834382;0;9912
FR;0;2022-06-26;229;458;1952;3688;258;1817;3966;0;39;54515630;51888861;36877509;2527695;53613942;40192126;2838348;0;9951
FR;0;2022-06-27;1128;2019;10494;48485;1175;9636;49753;0;339;54516758;51890880;36888003;2576180;53615117;40201762;2888101;0;10290
FR;0;2022-06-28;1458;2811;14665;91379;1578;13085;93147;0;624;54518216;51893691;36902668;2667559;53616695;40214847;2981248;0;10914
FR;0;2022-06-29;1712;2825;12291;71888;1838;11239;73030;0;548;54519928;51896516;36914959;2739447;53618533;40226086;3054278;0;11462
FR;0;2022-06-30;1534;2717;14390;95163;1637;12470;97178;0;724;54521462;51899233;36929349;2834610;53620170;40238556;3151456;0;12186
FR;0;2022-07-01;2006;3797;21501;115921;2304;18855;118567;0;954;54523468;51903030;36950850;2950531;53622474;40257411;3270023;0;13140
FR;0;2022-07-02;1085;1856;8524;35748;1102;7701;36869;0;342;54524553;51904886;36959374;2986279;53623576;40265112;3306892;0;13482
FR;0;2022-07-03;292;539;2092;6455;317;1895;6804;0;79;54524845;51905425;36961466;2992734;53623893;40267007;3313696;0;13561
FR;0;2022-07-04;1702;3334;14707;79220;2195;12985;81293;0;639;54526547;51908759;36976173;3071954;53626088;40279992;3394989;0;14200
FR;0;2022-07-05;1717;3145;18831;133249;1775;16012;135541;0;1145;54528264;51911904;36995004;3205203;53627863;40296004;3530530;0;15345
FR;0;2022-07-06;1817;2772;15849;99571;1837;13637;101139;0;899;54530081;51914676;37010853;3304774;53629700;40309641;3631669;0;16244
FR;0;2022-07-07;1706;2866;17998;126036;1704;14776;128363;0;1179;54531787;51917542;37028851;3430810;53631404;40324417;3760032;0;17423
FR;0;2022-07-08;1889;3148;20747;137078;1847;16761;140072;0;1346;54533676;51920690;37049598;3567888;53633251;40341178;3900104;0;18769
FR;0;2022-07-09;866;1456;7742;37922;873;6686;38767;0;426;54534542;51922146;37057340;3605810;53634124;40347864;3938871;0;19195
FR;0;2022-07-10;264;577;2346;7004;330;2125;7395;0;94;54534806;51922723;37059686;3612814;53634454;40349989;3946266;0;19289
FR;0;2022-07-11;1430;2464;15016;88272;1385;12506;90463;0;801;54536236;51925187;37074702;3701086;53635839;40362495;4036729;0;20090
FR;0;2022-07-12;1798;3104;20531;143952;1701;16726;146655;0;1604;54538034;51928291;37095233;3845038;53637540;40379221;4183384;0;21694
FR;0;2022-07-13;1739;2742;15692;94536;1653;13271;96396;0;1080;54539773;51931033;37110925;3939574;53639193;40392492;4279780;0;22774
FR;0;2022-07-14;185;368;1952;5535;218;1831;5702;0;82;54539958;51931401;37112877;3945109;53639411;40394323;4285482;0;22856
FR;0;2022-07-15;1476;2557;15113;84454;1417;12596;86613;0;1034;54541434;51933958;37127990;4029563;53640828;40406919;4372095;0;23890
FR;0;2022-07-16;619;1180;5948;24976;685;5155;25667;0;327;54542053;51935138;37133938;4054539;53641513;40412074;4397762;0;24217
FR;0;2022-07-17;178;389;1737;4663;213;1568;4935;0;66;54542231;51935527;37135675;4059202;53641726;40413642;4402697;0;24283
FR;0;2022-07-18;1130;2246;11824;61798;1334;9973;63661;0;780;54543361;51937773;37147499;4121000;53643060;40423615;4466358;0;25063
FR;0;2022-07-19;1414;2349;15470;103695;1387;12292;105882;0;1459;54544775;51940122;37162969;4224695;53644447;40435907;4572240;0;26522
FR;0;2022-07-20;1418;2289;12958;77573;1458;10730;79163;0;1050;54546193;51942411;37175927;4302268;53645905;40446637;4651403;0;27572
FR;0;2022-07-21;1284;2166;13089;88237;1366;10492;89720;0;1316;54547477;51944577;37189016;4390505;53647271;40457129;4741123;0;28888
FR;0;2022-07-22;1401;2458;14812;89519;1444;11962;91391;0;1347;54548878;51947035;37203828;4480024;53648715;40469091;4832514;0;30235
FR;0;2022-07-23;672;1306;5530;22478;819;4853;23074;0;412;54549550;51948341;37209358;4502502;53649534;40473944;4855588;0;30647
FR;0;2022-07-24;184;352;1398;3904;200;1241;4130;0;72;54549734;51948693;37210756;4506406;53649734;40475185;4859718;0;30719
FR;0;2022-07-25;1058;1790;9489;48067;1142;7838;49507;0;737;54550792;51950483;37220245;4554473;53650876;40483023;4909225;0;31456
FR;0;2022-07-26;1290;2209;13303;85431;1315;10827;87127;0;1311;54552082;51952692;37233548;4639904;53652191;40493850;4996352;0;32767
FR;0;2022-07-27;1221;2003;10235;61312;1333;8529;62517;0;971;54553303;51954695;37243783;4701216;53653524;40502379;5058869;0;33738
FR;0;2022-07-28;1088;1861;10307;64392;1251;8214;65627;0;1046;54554391;51956556;37254090;4765608;53654775;40510593;5124496;0;34784
FR;0;2022-07-29;1281;2068;11003;65865;1375;8759;67294;0;1140;54555672;51958624;37265093;4831473;53656150;40519352;5191790;0;35924
FR;0;2022-07-30;499;856;3521;15282;592;2973;15663;0;303;54556171;51959480;37268614;4846755;53656742;40522325;5207453;0;36227
FR;0;2022-07-31;152;288;929;2439;184;788;2588;0;49;54556323;51959768;37269543;4849194;53656926;40523113;5210041;0;36276
FR;0;2022-08-01;846;1565;7591;30234;1159;6387;31307;0;548;54557169;51961333;37277134;4879428;53658085;40529500;5241348;0;36824
FR;0;2022-08-02;1021;1637;8575;56104;1142;6888;56792;0;1169;54558190;51962970;37285709;4935532;53659227;40536388;5298140;0;37993
FR;0;2022-08-03;837;1260;6420;38670;896;5142;39407;0;701;54559027;51964230;37292129;4974202;53660123;40541530;5337547;0;38694
FR;0;2022-08-04;732;1179;6566;43153;775;5297;43718;0;917;54559759;51965409;37298695;5017355;53660898;40546827;5381265;0;39611
FR;0;2022-08-05;853;1355;7093;44955;961;5673;45617;0;993;54560612;51966764;37305788;5062310;53661859;40552500;5426882;0;40604
FR;0;2022-08-06;338;555;2099;9366;396;1757;9566;0;228;54560950;51967319;37307887;5071676;53662255;40554257;5436448;0;40832
FR;0;2022-08-07;104;156;536;1621;113;453;1701;0;38;54561054;51967475;37308423;5073297;53662368;40554710;5438149;0;40870
FR;0;2022-08-08;563;1030;4019;22096;785;3280;22540;0;490;54561617;51968505;37312442;5095393;53663153;40557990;5460689;0;41360
FR;0;2022-08-09;686;1141;5969;39948;825;4800;40439;0;844;54562303;51969646;37318411;5135341;53663978;40562790;5501128;0;42204
FR;0;2022-08-10;637;1124;4653;28055;838;3793;28390;0;652;54562940;51970770;37323064;5163396;53664816;40566583;5529518;0;42856
FR;0;2022-08-11;613;1022;4482;29246;733;3702;29582;0;676;54563553;51971792;37327546;5192642;53665549;40570285;5559100;0;43532
FR;0;2022-08-12;713;1146;4741;28209;829;3913;28645;0;702;54564266;51972938;37332287;5220851;53666378;40574198;5587745;0;44234
FR;0;2022-08-13;213;413;1294;5256;311;1118;5415;0;121;54564479;51973351;37333581;5226107;53666689;40575316;5593160;0;44355
FR;0;2022-08-14;71;121;288;923;104;246;995;0;25;54564550;51973472;37333869;5227030;53666793;40575562;5594155;0;44380
FR;0;2022-08-15;83;185;606;564;151;554;618;0;19;54564633;51973657;37334475;5227594;53666944;40576116;5594773;0;44399
FR;0;2022-08-16;617;1058;3956;22174;819;3351;22366;0;615;54565250;51974715;37338431;5249768;53667763;40579467;5617139;0;45014
FR;0;2022-08-17;630;1014;3887;22895;790;3292;23139;0;620;54565880;51975729;37342318;5272663;53668553;40582759;5640278;0;45634
FR;0;2022-08-18;615;980;4108;26291;780;3249;26521;0;673;54566495;51976709;37346426;5298954;53669333;40586008;5666799;0;46307
FR;0;2022-08-19;601;1154;4490;27243;861;3692;27548;0;766;54567096;51977863;37350916;5326197;53670194;40589700;5694347;0;47073
FR;0;2022-08-20;290;494;1355;5569;391;1170;5728;0;146;54567386;51978357;37352271;5331766;53670585;40590870;5700075;0;47219
FR;0;2022-08-21;95;133;301;1008;94;263;1043;0;27;54567481;51978490;37352572;5332774;53670679;40591133;5701118;0;47246
FR;0;2022-08-22;547;988;3272;15347;766;2795;15677;0;425;54568028;51979478;37355844;5348121;53671445;40593928;5716795;0;47671
FR;0;2022-08-23;711;1172;4297;28989;846;3610;29075;0;870;54568739;51980650;37360141;5377110;53672291;40597538;5745870;0;48541
FR;0;2022-08-24;657;930;3494;19529;774;2856;19719;0;608;54569396;51981580;37363635;5396639;53673065;40600394;5765589;0;49149
FR;0;2022-08-25;623;1011;3936;23402;720;3284;23666;0;673;54570019;51982591;37367571;5420041;53673785;40603678;5789255;0;49822
FR;0;2022-08-26;849;1256;4473;25882;950;3664;26256;0;777;54570868;51983847;37372044;5445923;53674735;40607342;5815511;0;50599
FR;0;2022-08-27;293;498;1377;5462;359;1243;5526;0;194;54571161;51984345;37373421;5451385;53675094;40608585;5821037;0;50793
FR;0;2022-08-28;123;160;303;919;114;288;964;0;38;54571284;51984505;37373724;5452304;53675208;40608873;5822001;0;50831
FR;0;2022-08-29;618;965;3072;14655;764;2609;14961;0;433;54571902;51985470;37376796;5466959;53675972;40611482;5836962;0;51264
FR;0;2022-08-30;848;1207;4792;28542;884;3909;28872;0;823;54572750;51986677;37381588;5495501;53676856;40615391;5865834;0;52087
FR;0;2022-08-31;688;948;3200;17634;733;2710;17899;0;508;54573438;51987625;37384788;5513135;53677589;40618101;5883733;0;52595
FR;0;2022-09-01;729;982;4472;22475;693;3818;22750;0;622;54574167;51988607;37389260;5535610;53678282;40621919;5906483;0;53217
FR;0;2022-09-02;868;1137;5037;28608;821;4247;28901;0;914;54575035;51989744;37394297;5564218;53679103;40626166;5935384;0;54131
FR;0;2022-09-03;416;562;1917;6084;417;1663;6321;0;181;54575451;51990306;37396214;5570302;53679520;40627829;5941705;0;54312
FR;0;2022-09-04;131;150;351;873;86;347;942;0;24;54575582;51990456;37396565;5571175;53679606;40628176;5942647;0;54336
FR;0;2022-09-05;619;713;3150;16054;531;2630;16367;0;523;54576201;51991169;37399715;5587229;53680137;40630806;5959014;0;54859
FR;0;2022-09-06;792;1013;4732;31841;644;3863;32072;0;1040;54576993;51992182;37404447;5619070;53680781;40634669;5991086;0;55899
FR;0;2022-09-07;642;765;2995;16820;545;2475;16969;0;572;54577635;51992947;37407442;5635890;53681326;40637144;6008055;0;56471
FR;0;2022-09-08;616;849;3805;24845;580;3138;24934;0;818;54578251;51993796;37411247;5660735;53681906;40640282;6032989;0;57289
FR;0;2022-09-09;836;1010;4437;27645;650;3674;27823;0;948;54579087;51994806;37415684;5688380;53682556;40643956;6060812;0;58237
FR;0;2022-09-10;385;536;1732;5708;362;1532;5912;0;207;54579472;51995342;37417416;5694088;53682918;40645488;6066724;0;58444
FR;0;2022-09-11;123;131;322;656;93;306;714;0;17;54579595;51995473;37417738;5694744;53683011;40645794;6067438;0;58461
FR;0;2022-09-12;486;625;2682;13288;445;2287;13581;0;478;54580081;51996098;37420420;5708032;53683456;40648081;6081019;0;58939
FR;0;2022-09-13;610;835;3995;26504;521;3484;26385;0;875;54580691;51996933;37424415;5734536;53683977;40651565;6107404;0;59814
FR;0;2022-09-14;652;769;2954;16180;561;2469;16413;0;573;54581343;51997702;37427369;5750716;53684538;40654034;6123817;0;60387
FR;0;2022-09-15;554;778;3464;23578;529;2954;23646;0;726;54581897;51998480;37430833;5774294;53685067;40656988;6147463;0;61113
FR;0;2022-09-16;785;1031;4137;25898;713;3477;26121;0;932;54582682;51999511;37434970;5800192;53685780;40660465;6173584;0;62045
FR;0;2022-09-17;386;493;1449;6144;370;1279;6236;0;242;54583068;52000004;37436419;5806336;53686150;40661744;6179820;0;62287
FR;0;2022-09-18;115;141;323;961;120;291;1016;0;36;54583183;52000145;37436742;5807297;53686270;40662035;6180836;0;62323
FR;0;2022-09-19;445;638;2252;13201;437;1927;13383;0;436;54583628;52000783;37438994;5820498;53686707;40663962;6194219;0;62759
FR;0;2022-09-20;634;865;3779;26437;617;3149;26489;0;892;54584262;52001648;37442773;5846935;53687324;40667111;6220708;0;63651
FR;0;2022-09-21;575;764;2736;16257;568;2351;16249;0;586;54584837;52002412;37445509;5863192;53687892;40669462;6236957;0;64237
FR;0;2022-09-22;582;827;3417;23573;550;2789;23799;0;772;54585419;52003239;37448926;5886765;53688442;40672251;6260756;0;65009
FR;0;2022-09-23;829;1040;4491;28701;759;3759;28877;0;1017;54586248;52004279;37453417;5915466;53689201;40676010;6289633;0;66026
FR;0;2022-09-24;423;609;1639;6894;468;1415;7076;0;306;54586671;52004888;37455056;5922360;53689669;40677425;6296709;0;66332
FR;0;2022-09-25;98;188;335;1100;142;306;1142;0;37;54586769;52005076;37455391;5923460;53689811;40677731;6297851;0;66369
FR;0;2022-09-26;437;699;2286;13526;469;2015;13631;0;435;54587206;52005775;37457677;5936986;53690280;40679746;6311482;0;66804
FR;0;2022-09-27;610;841;3626;25940;612;2909;26095;0;959;54587816;52006616;37461303;5962926;53690892;40682655;6337577;0;67763
FR;0;2022-09-28;626;816;2550;15389;623;2296;15504;0;622;54588442;52007432;37463853;5978315;53691515;40684951;6353081;0;68385
FR;0;2022-09-29;564;761;3114;21031;537;2629;21058;43;810;54589006;52008193;37466967;5999346;53692052;40687580;6374139;43;69195
FR;0;2022-09-30;771;1091;3950;25550;801;3297;25815;713;1050;54589777;52009284;37470917;6024896;53692853;40690877;6399954;756;70245
FR;0;2022-10-01;420;612;2003;5969;459;1733;6208;396;317;54590197;52009896;37472920;6030865;53693312;40692610;6406162;1152;70562
FR;0;2022-10-02;58;133;218;638;95;214;664;66;42;54590255;52010029;37473138;6031503;53693407;40692824;6406826;1218;70604
FR;0;2022-10-03;466;728;2438;12020;561;2146;12214;2073;744;54590721;52010757;37475576;6043523;53693968;40694970;6419040;3291;71348
FR;0;2022-10-04;612;787;3386;23504;531;2775;23684;4702;1581;54591333;52011544;37478962;6067027;53694499;40697745;6442724;7993;72929
FR;0;2022-10-05;544;802;2430;14588;578;2145;14734;3655;1209;54591877;52012346;37481392;6081615;53695077;40699890;6457458;11648;74138
FR;0;2022-10-06;535;701;3083;21681;503;2514;21893;6665;1907;54592412;52013047;37484475;6103296;53695580;40702404;6479351;18313;76045
FR;0;2022-10-07;719;973;4125;30291;703;3471;30381;16870;3203;54593131;52014020;37488600;6133587;53696283;40705875;6509732;35183;79248
FR;0;2022-10-08;345;512;1648;8428;371;1408;8596;6696;1169;54593476;52014532;37490248;6142015;53696654;40707283;6518328;41879;80417
FR;0;2022-10-09;108;137;336;1587;111;311;1650;1510;295;54593584;52014669;37490584;6143602;53696765;40707594;6519978;43389;80712
FR;0;2022-10-10;474;699;2913;20483;514;2497;20811;19514;3269;54594058;52015368;37493497;6164085;53697279;40710091;6540789;62903;83981
FR;0;2022-10-11;571;784;4260;40306;527;3561;40650;40146;6378;54594629;52016152;37497757;6204391;53697806;40713652;6581439;103049;90359
FR;0;2022-10-12;563;791;3247;26707;578;2752;27034;27293;4688;54595192;52016943;37501004;6231098;53698384;40716404;6608473;130342;95047
FR;0;2022-10-13;610;747;4000;38397;538;3119;38859;40566;6602;54595802;52017690;37505004;6269495;53698922;40719523;6647332;170908;101649
FR;0;2022-10-14;752;1048;4863;47646;757;3945;48122;51111;7858;54596554;52018738;37509867;6317141;53699679;40723468;6695454;222019;109507
FR;0;2022-10-15;353;493;1855;11845;333;1613;11962;13089;2275;54596907;52019231;37511722;6328986;53700012;40725081;6707416;235108;111782
FR;0;2022-10-16;92;125;371;1960;76;355;2005;2344;479;54596999;52019356;37512093;6330946;53700088;40725436;6709421;237452;112261
FR;0;2022-10-17;435;689;3031;26426;476;2470;26798;30747;5408;54597434;52020045;37515124;6357372;53700564;40727906;6736219;268199;117669
FR;0;2022-10-18;599;722;4698;46066;519;3755;46598;55415;11688;54598033;52020767;37519822;6403438;53701083;40731661;6782817;323614;129357
FR;0;2022-10-19;547;770;3629;34360;574;3066;34691;42412;9204;54598580;52021537;37523451;6437798;53701657;40734727;6817508;366026;138561
FR;0;2022-10-20;599;758;4826;49416;543;3709;50070;60447;12901;54599179;52022295;37528277;6487214;53702200;40738436;6867578;426473;151462
FR;0;2022-10-21;683;971;5695;56971;688;4501;57655;70884;14283;54599862;52023266;37533972;6544185;53702888;40742937;6925233;497357;165745
FR;0;2022-10-22;331;397;1654;12932;315;1319;13093;15923;3375;54600193;52023663;37535626;6557117;53703203;40744256;6938326;513280;169120
FR;0;2022-10-23;93;102;349;2061;97;265;2163;2753;629;54600286;52023765;37535975;6559178;53703300;40744521;6940489;516033;169749
FR;0;2022-10-24;548;592;3132;27113;418;2678;27539;35433;7772;54600834;52024357;37539107;6586291;53703718;40747199;6968028;551466;177521
FR;0;2022-10-25;584;715;4862;49044;523;3793;49716;65126;15402;54601418;52025072;37543969;6635335;53704241;40750992;7017744;616592;192923
FR;0;2022-10-26;528;634;3446;32493;470;2880;32826;43781;10914;54601946;52025706;37547415;6667828;53704711;40753872;7050570;660373;203837
FR;0;2022-10-27;586;681;4070;40715;481;3336;41187;54311;13056;54602532;52026387;37551485;6708543;53705192;40757208;7091757;714684;216893
FR;0;2022-10-28;696;844;4601;44130;613;3494;44958;58163;13123;54603228;52027231;37556086;6752673;53705805;40760702;7136715;772847;230016
FR;0;2022-10-29;254;354;1325;9486;250;1079;9620;12513;3009;54603482;52027585;37557411;6762159;53706055;40761781;7146335;785360;233025
FR;0;2022-10-30;86;111;284;1581;87;247;1629;2129;539;54603568;52027696;37557695;6763740;53706142;40762028;7147964;787489;233564
FR;0;2022-10-31;380;476;2068;16036;344;1620;16400;22114;5443;54603948;52028172;37559763;6779776;53706486;40763648;7164364;809603;239007
FR;0;2022-11-01;70;156;911;1112;119;940;1156;1660;481;54604018;52028328;37560674;6780888;53706605;40764588;7165520;811263;239488
FR;0;2022-11-02;499;651;3019;25357;480;2561;25833;36567;10108;54604517;52028979;37563693;6806245;53707085;40767149;7191353;847830;249596
FR;0;2022-11-03;636;681;4089;39955;516;3100;40680;56838;15290;54605153;52029660;37567782;6846200;53707601;40770249;7232033;904668;264886
FR;0;2022-11-04;651;816;4416;43626;561;3511;44239;60454;15208;54605804;52030476;37572198;6889826;53708162;40773760;7276272;965122;280094
FR;0;2022-11-05;250;353;1447;9699;277;1163;9908;13443;3289;54606054;52030829;37573645;6899525;53708439;40774923;7286180;978565;283383
FR;0;2022-11-06;89;112;262;1597;95;246;1626;2329;650;54606143;52030941;37573907;6901122;53708534;40775169;7287806;980894;284033
FR;0;2022-11-07;461;513;2714;26611;427;2193;27245;38872;10921;54606604;52031454;37576621;6927733;53708961;40777362;7315051;1019766;294954
FR;0;2022-11-08;589;771;4960;51851;558;3804;52824;74004;19954;54607193;52032225;37581581;6979584;53709519;40781166;7367875;1093770;314908
FR;0;2022-11-09;502;643;3351;31573;463;2679;32342;46286;13185;54607695;52032868;37584932;7011157;53709982;40783845;7400217;1140056;328093
FR;0;2022-11-10;605;847;4547;43563;597;3603;44459;62615;17222;54608300;52033715;37589479;7054720;53710579;40787448;7444676;1202671;345315
FR;0;2022-11-11;73;105;363;1656;71;308;1720;2784;1000;54608373;52033820;37589842;7056376;53710650;40787756;7446396;1205455;346315
FR;0;2022-11-12;197;310;1192;7098;219;973;7334;10285;2765;54608570;52034130;37591034;7063474;53710869;40788729;7453730;1215740;349080
FR;0;2022-11-13;63;82;244;1206;58;208;1260;1967;621;54608633;52034212;37591278;7064680;53710927;40788937;7454990;1217707;349701
FR;0;2022-11-14;427;510;2557;23909;357;2038;24533;36047;10835;54609060;52034722;37593835;7088589;53711284;40790975;7479523;1253754;360536
FR;0;2022-11-15;580;695;4291;44910;520;3332;45855;66679;19542;54609640;52035417;37598126;7133499;53711804;40794307;7525378;1320433;380078
FR;0;2022-11-16;537;611;3044;28475;481;2548;29004;43051;13250;54610177;52036028;37601170;7161974;53712285;40796855;7554382;1363484;393328
FR;0;2022-11-17;549;648;3786;39119;495;2946;39730;58155;17347;54610726;52036676;37604956;7201093;53712780;40799801;7594112;1421639;410675
FR;0;2022-11-18;615;758;4582;45048;572;3435;45951;65514;18260;54611341;52037434;37609538;7246141;53713352;40803236;7640063;1487153;428935
FR;0;2022-11-19;268;325;1494;9773;255;1083;9969;14254;3971;54611609;52037759;37611032;7255914;53713607;40804319;7650032;1501407;432906
FR;0;2022-11-20;63;86;300;1696;68;256;1770;2702;847;54611672;52037845;37611332;7257610;53713675;40804575;7651802;1504109;433753
FR;0;2022-11-21;430;502;2403;21332;340;1931;21894;32874;10230;54612102;52038347;37613735;7278942;53714015;40806506;7673696;1536983;443983
FR;0;2022-11-22;531;579;3998;39711;402;3139;40266;59496;18115;54612633;52038926;37617733;7318653;53714417;40809645;7713962;1596479;462098
FR;0;2022-11-23;464;532;2738;25954;372;2306;26445;40235;12805;54613097;52039458;37620471;7344607;53714789;40811951;7740407;1636714;474903
FR;0;2022-11-24;502;581;3746;37008;410;2930;37723;56466;17690;54613599;52040039;37624217;7381615;53715199;40814881;7778130;1693180;492593
FR;0;2022-11-25;561;695;4170;40040;548;3128;40880;59365;17329;54614160;52040734;37628387;7421655;53715747;40818009;7819010;1752545;509922
FR;0;2022-11-26;293;332;1332;9340;253;1059;9479;13956;3956;54614453;52041066;37629719;7430995;53716000;40819068;7828489;1766501;513878
FR;0;2022-11-27;69;75;263;1656;54;224;1683;2549;805;54614522;52041141;37629982;7432651;53716054;40819292;7830172;1769050;514683
FR;0;2022-11-28;401;460;2620;24651;342;1960;25379;38180;12089;54614923;52041601;37632602;7457302;53716396;40821252;7855551;1807230;526772
FR;0;2022-11-29;491;597;4350;46274;367;3255;46974;70691;22179;54615414;52042198;37636952;7503576;53716763;40824507;7902525;1877921;548951
FR;0;2022-11-30;499;672;3696;36779;475;2864;37561;56079;17162;54615913;52042870;37640648;7540355;53717238;40827371;7940086;1934000;566113
FR;0;2022-12-01;490;631;5196;51500;417;3776;52312;78987;24951;54616403;52043501;37645844;7591855;53717655;40831147;7992398;2012987;591064
FR;0;2022-12-02;618;725;6101;61349;506;4315;62575;92112;27334;54617021;52044226;37651945;7653204;53718161;40835462;8054973;2105099;618398
FR;0;2022-12-03;298;334;2241;17987;215;1580;18425;26637;7582;54617319;52044560;37654186;7671191;53718376;40837042;8073398;2131736;625980
FR;0;2022-12-04;92;122;522;4285;90;432;4336;6411;1844;54617411;52044682;37654708;7675476;53718466;40837474;8077734;2138147;627824
FR;0;2022-12-05;436;544;4245;44554;386;2852;45517;68725;21745;54617847;52045226;37658953;7720030;53718852;40840326;8123251;2206872;649569
FR;0;2022-12-06;604;716;6809;78009;450;4620;79518;121153;39290;54618451;52045942;37665762;7798039;53719302;40844946;8202769;2328025;688859
FR;0;2022-12-07;530;601;5316;57939;445;3549;59102;90082;29365;54618981;52046543;37671078;7855978;53719747;40848495;8261871;2418107;718224
FR;0;2022-12-08;597;694;6904;79272;437;4526;80959;123461;40585;54619578;52047237;37677982;7935250;53720184;40853021;8342830;2541568;758809
FR;0;2022-12-09;763;827;8560;95366;540;5614;97243;146673;46508;54620341;52048064;37686542;8030616;53720724;40858635;8440073;2688241;805317
FR;0;2022-12-10;394;414;3618;33845;261;2277;34735;50390;14650;54620735;52048478;37690160;8064461;53720985;40860912;8474808;2738631;819967
FR;0;2022-12-11;129;137;985;8331;98;676;8539;12210;3268;54620864;52048615;37691145;8072792;53721083;40861588;8483347;2750841;823235
FR;0;2022-12-12;494;555;6303;67195;349;4055;68794;105770;34632;54621358;52049170;37697448;8139987;53721432;40865643;8552141;2856611;857867
FR;0;2022-12-13;680;761;8943;103173;469;5556;105724;164065;54717;54622038;52049931;37706391;8243160;53721901;40871199;8657865;3020676;912584
FR;0;2022-12-14;569;676;6739;72969;439;4444;74606;116098;38356;54622607;52050607;37713130;8316129;53722340;40875643;8732471;3136774;950940
FR;0;2022-12-15;631;795;8575;95244;487;5420;97512;151989;51199;54623238;52051402;37721705;8411373;53722827;40881063;8829983;3288763;1002139
FR;0;2022-12-16;791;926;9364;104166;598;6064;106382;165358;54836;54624029;52052328;37731069;8515539;53723425;40887127;8936365;3454121;1056975
FR;0;2022-12-17;338;408;3350;31626;271;2145;32414;48153;14327;54624367;52052736;37734419;8547165;53723696;40889272;8968779;3502274;1071302
FR;0;2022-12-18;93;119;774;6265;70;529;6415;9544;2730;54624460;52052855;37735193;8553430;53723766;40889801;8975194;3511818;1074032
FR;0;2022-12-19;574;593;5643;55875;405;3572;57480;89600;29797;54625034;52053448;37740836;8609305;53724171;40893373;9032674;3601418;1103829
FR;0;2022-12-20;716;735;7690;79194;473;5004;81300;129561;44482;54625750;52054183;37748526;8688499;53724644;40898377;9113974;3730979;1148311
FR;0;2022-12-21;561;598;5182;50425;403;3444;51742;83024;28778;54626311;52054781;37753708;8738924;53725047;40901821;9165716;3814003;1177089
FR;0;2022-12-22;614;623;4748;45583;421;3274;46783;75614;26365;54626925;52055404;37758456;8784507;53725468;40905095;9212499;3889617;1203454
FR;0;2022-12-23;439;511;3042;25848;351;2210;26508;42739;14606;54627364;52055915;37761498;8810355;53725819;40907305;9239007;3932356;1218060
FR;0;2022-12-24;99;94;425;2658;68;317;2779;4199;1198;54627463;52056009;37761923;8813013;53725887;40907622;9241786;3936555;1219258
FR;0;2022-12-25;31;31;113;544;24;88;564;890;267;54627494;52056040;37762036;8813557;53725911;40907710;9242350;3937445;1219525
FR;0;2022-12-26;348;347;2276;16698;251;1609;17348;27217;8618;54627842;52056387;37764312;8830255;53726162;40909319;9259698;3964662;1228143
FR;0;2022-12-27;504;618;3937;33397;404;2696;34521;56083;19472;54628346;52057005;37768249;8863652;53726566;40912015;9294219;4020745;1247615
FR;0;2022-12-28;451;471;3046;25354;312;2133;25962;42233;14506;54628797;52057476;37771295;8889006;53726878;40914148;9320181;4062978;1262121
FR;0;2022-12-29;410;507;3287;26199;322;2253;27189;44263;15277;54629207;52057983;37774582;8915205;53727200;40916401;9347370;4107241;1277398
FR;0;2022-12-30;428;466;2546;19200;326;1771;19839;31873;10685;54629635;52058449;37777128;8934405;53727526;40918172;9367209;4139114;1288083
FR;0;2022-12-31;125;150;479;3100;111;388;3244;4824;1289;54629760;52058599;37777607;8937505;53727637;40918560;9370453;4143938;1289372
FR;0;2023-01-01;20;36;108;671;18;89;690;971;228;54629780;52058635;37777715;8938176;53727655;40918649;9371143;4144909;1289600
FR;0;2023-01-02;306;429;2281;18411;275;1611;18862;31932;11665;54630086;52059064;37779996;8956587;53727930;40920260;9390005;4176841;1301265
