fra;vaccin;jour;n_dose1;n_dose2;n_dose3;n_dose4;n_complet;n_rappel;n_2_rappel;n_rappel_biv;n_3_rappel;n_cum_dose1;n_cum_dose2;n_cum_dose3;n_cum_dose4;n_cum_complet;n_cum_rappel;n_cum_2_rappel;n_cum_rappel_biv;n_cum_3_rappel
FR;1;2020-12-27;614;0;0;0;55;0;0;0;0;614;0;0;0;55;0;0;0;0
FR;1;2020-12-28;698;1;0;0;42;0;0;0;0;1312;1;0;0;97;0;0;0;0
FR;1;2020-12-29;387;0;0;0;19;0;0;0;0;1699;1;0;0;116;0;0;0;0
FR;1;2020-12-30;449;0;0;0;18;0;0;0;0;2148;1;0;0;134;0;0;0;0
FR;1;2020-12-31;446;1;0;0;23;0;0;0;0;2594;2;0;0;157;0;0;0;0
FR;1;2021-01-01;1181;2;0;0;65;0;0;0;0;3775;4;0;0;222;0;0;0;0
FR;1;2021-01-02;366;3;0;0;28;0;0;0;0;4141;7;0;0;250;0;0;0;0
FR;1;2021-01-03;409;0;0;0;23;0;0;0;0;4550;7;0;0;273;0;0;0;0
FR;1;2021-01-04;2126;4;0;0;50;0;0;0;0;6676;11;0;0;323;0;0;0;0
FR;1;2021-01-05;7761;6;0;0;129;0;0;0;0;14437;17;0;0;452;0;0;0;0
FR;1;2021-01-06;12466;23;0;0;126;0;0;0;0;26903;40;0;0;578;0;0;0;0
FR;1;2021-01-07;29472;22;0;0;159;0;0;0;0;56375;62;0;0;737;0;0;0;0
FR;1;2021-01-08;37158;33;0;0;204;0;0;0;0;93533;95;0;0;941;0;0;0;0
FR;1;2021-01-09;11219;9;0;0;77;0;0;0;0;104752;104;0;0;1018;0;0;0;0
FR;1;2021-01-10;6011;8;0;0;28;0;0;0;0;110763;112;0;0;1046;0;0;0;0
FR;1;2021-01-11;39951;34;0;0;227;0;0;0;0;150714;146;0;0;1273;0;0;0;0
FR;1;2021-01-12;62153;25;0;0;299;0;0;0;0;212867;171;0;0;1572;0;0;0;0
FR;1;2021-01-13;65142;55;0;0;429;0;0;0;0;278009;226;0;0;2001;0;0;0;0
FR;1;2021-01-14;81463;215;0;0;957;0;0;0;0;359472;441;0;0;2958;0;0;0;0
FR;1;2021-01-15;68624;88;0;0;522;0;0;0;0;428096;529;0;0;3480;0;0;0;0
FR;1;2021-01-16;19902;73;0;0;172;0;0;0;0;447998;602;0;0;3652;0;0;0;0
FR;1;2021-01-17;10905;52;0;0;129;0;0;0;0;458903;654;0;0;3781;0;0;0;0
FR;1;2021-01-18;82841;174;0;0;587;0;0;0;0;541744;828;0;0;4368;0;0;0;0
FR;1;2021-01-19;125929;203;0;0;834;0;0;0;0;667673;1031;0;0;5202;0;0;0;0
FR;1;2021-01-20;132425;185;0;0;785;0;0;0;0;800098;1216;0;0;5987;0;0;0;0
FR;1;2021-01-21;153075;189;0;0;891;0;0;0;0;953173;1405;0;0;6878;0;0;0;0
FR;1;2021-01-22;115960;232;0;0;772;0;0;0;0;1069133;1637;0;0;7650;0;0;0;0
FR;1;2021-01-23;36615;78;0;0;201;0;0;0;0;1105748;1715;0;0;7851;0;0;0;0
FR;1;2021-01-24;9585;117;0;0;176;0;0;0;0;1115333;1832;0;0;8027;0;0;0;0
FR;1;2021-01-25;74435;1424;0;0;1744;0;0;0;0;1189768;3256;0;0;9771;0;0;0;0
FR;1;2021-01-26;96463;3662;1;0;4105;0;0;0;0;1286231;6918;1;0;13876;0;0;0;0
FR;1;2021-01-27;103655;6356;0;0;7041;0;0;0;0;1389886;13274;1;0;20917;0;0;0;0
FR;1;2021-01-28;120619;16245;0;0;17032;0;0;0;0;1510505;29519;1;0;37949;0;0;0;0
FR;1;2021-01-29;88898;18618;0;0;19156;0;0;0;0;1599403;48137;1;0;57105;0;0;0;0
FR;1;2021-01-30;27995;4497;0;0;4617;0;0;0;0;1627398;52634;1;0;61722;0;0;0;0
FR;1;2021-01-31;5193;1885;0;0;1920;0;0;0;0;1632591;54519;1;0;63642;0;0;0;0
FR;1;2021-02-01;49738;22736;0;0;22964;0;0;0;0;1682329;77255;1;0;86606;0;0;0;0
FR;1;2021-02-02;67834;37806;0;0;38266;0;0;0;0;1750163;115061;1;0;124872;0;0;0;0
FR;1;2021-02-03;67099;39889;0;0;40311;0;0;0;0;1817262;154950;1;0;165183;0;0;0;0
FR;1;2021-02-04;77147;54515;0;0;55078;0;0;0;0;1894409;209465;1;0;220261;0;0;0;0
FR;1;2021-02-05;63431;47812;0;0;48203;0;0;0;0;1957840;257277;1;0;268464;0;0;0;0
FR;1;2021-02-06;19427;11325;0;0;11428;0;0;0;0;1977267;268602;1;0;279892;0;0;0;0
FR;1;2021-02-07;3669;5969;0;0;5994;0;0;0;0;1980936;274571;1;0;285886;0;0;0;0
FR;1;2021-02-08;36506;48526;0;0;48752;0;0;0;0;2017442;323097;1;0;334638;0;0;0;0
FR;1;2021-02-09;50817;77741;0;0;78253;0;0;0;0;2068259;400838;1;0;412891;0;0;0;0
FR;1;2021-02-10;52078;82718;0;0;83190;0;0;0;0;2120337;483556;1;0;496081;0;0;0;0
FR;1;2021-02-11;63389;104752;0;0;105619;0;0;0;0;2183726;588308;1;0;601700;0;0;0;0
FR;1;2021-02-12;55879;75618;0;0;76281;0;0;0;0;2239605;663926;1;0;677981;0;0;0;0
FR;1;2021-02-13;15468;19309;0;0;19419;0;0;0;0;2255073;683235;1;0;697400;0;0;0;0
FR;1;2021-02-14;3747;7354;0;0;7417;0;0;0;0;2258820;690589;1;0;704817;0;0;0;0
FR;1;2021-02-15;24166;73563;0;0;73792;0;0;0;0;2282986;764152;1;0;778609;0;0;0;0
FR;1;2021-02-16;32779;95654;0;0;96033;0;0;0;0;2315765;859806;1;0;874642;0;0;0;0
FR;1;2021-02-17;35132;102011;20;0;102639;0;0;0;0;2350897;961817;21;0;977281;0;0;0;0
FR;1;2021-02-18;49458;118063;0;0;119025;0;0;0;0;2400355;1079880;21;0;1096306;0;0;0;0
FR;1;2021-02-19;45393;87586;1;0;88515;0;0;0;0;2445748;1167466;22;0;1184821;0;0;0;0
FR;1;2021-02-20;13394;27065;0;0;27232;0;0;0;0;2459142;1194531;22;0;1212053;0;0;0;0
FR;1;2021-02-21;2464;6013;0;0;6081;0;0;0;0;2461606;1200544;22;0;1218134;0;0;0;0
FR;1;2021-02-22;24723;69411;2;0;69693;0;0;0;0;2486329;1269955;24;0;1287827;0;0;0;0
FR;1;2021-02-23;37436;81471;1;0;82149;0;0;0;0;2523765;1351426;25;0;1369976;0;0;0;0
FR;1;2021-02-24;40707;79184;1;0;79867;0;0;0;0;2564472;1430610;26;0;1449843;0;0;0;0
FR;1;2021-02-25;50169;87863;1;0;88934;0;0;0;0;2614641;1518473;27;0;1538777;0;0;0;0
FR;1;2021-02-26;47229;67593;1;0;68454;0;0;0;0;2661870;1586066;28;0;1607231;0;0;0;0
FR;1;2021-02-27;15687;21318;1;0;21525;0;0;0;0;2677557;1607384;29;0;1628756;0;0;0;0
FR;1;2021-02-28;3564;4123;2;0;4194;0;0;0;0;2681121;1611507;31;0;1632950;0;0;0;0
FR;1;2021-03-01;40215;50246;1;0;50966;0;0;0;0;2721336;1661753;32;0;1683916;0;0;0;0
FR;1;2021-03-02;55990;62398;3;0;63566;0;0;0;0;2777326;1724151;35;0;1747482;0;0;0;0
FR;1;2021-03-03;61258;60508;0;0;61929;0;0;0;0;2838584;1784659;35;0;1809411;0;0;0;0
FR;1;2021-03-04;73014;68095;3;0;70301;0;0;0;0;2911598;1852754;38;0;1879712;0;0;0;0
FR;1;2021-03-05;74778;58640;3;0;60528;0;0;0;0;2986376;1911394;41;0;1940240;0;0;0;0
FR;1;2021-03-06;82465;15774;2;0;17481;0;0;0;0;3068841;1927168;43;0;1957721;0;0;0;0
FR;1;2021-03-07;63732;4069;1;0;5613;0;0;0;0;3132573;1931237;44;0;1963334;0;0;0;0
FR;1;2021-03-08;60189;41278;2;0;42551;0;0;0;0;3192762;1972515;46;0;2005885;0;0;0;0
FR;1;2021-03-09;86003;47522;1;0;49510;0;0;0;0;3278765;2020037;47;0;2055395;0;0;0;0
FR;1;2021-03-10;90941;47812;5;0;50073;0;0;0;0;3369706;2067849;52;0;2105468;0;0;0;0
FR;1;2021-03-11;105098;54571;1;0;57629;0;0;0;0;3474804;2122420;53;0;2163097;0;0;0;0
FR;1;2021-03-12;104154;44929;1;0;47923;0;0;0;0;3578958;2167349;54;0;2211020;0;0;0;0
FR;1;2021-03-13;89215;12590;1;0;14807;0;0;0;0;3668173;2179939;55;0;2225827;0;0;0;0
FR;1;2021-03-14;44460;2725;1;0;4058;0;0;0;0;3712633;2182664;56;0;2229885;0;0;0;0
FR;1;2021-03-15;95529;28054;3;0;30395;0;0;0;0;3808162;2210718;59;0;2260280;0;0;0;0
FR;1;2021-03-16;123601;34137;5;0;37674;0;0;0;0;3931763;2244855;64;0;2297954;0;0;0;0
FR;1;2021-03-17;129319;33599;4;0;37647;0;0;0;0;4061082;2278454;68;0;2335601;0;0;0;0
FR;1;2021-03-18;142913;39222;5;0;43885;0;0;0;0;4203995;2317676;73;0;2379486;0;0;0;0
FR;1;2021-03-19;136264;32074;2;0;36663;0;0;0;0;4340259;2349750;75;0;2416149;0;0;0;0
FR;1;2021-03-20;76021;9769;1;0;11986;0;0;0;0;4416280;2359519;76;0;2428135;0;0;0;0
FR;1;2021-03-21;26518;2016;1;0;3004;0;0;0;0;4442798;2361535;77;0;2431139;0;0;0;0
FR;1;2021-03-22;114774;30301;2;0;34122;0;0;0;0;4557572;2391836;79;0;2465261;0;0;0;0
FR;1;2021-03-23;143053;38045;1;0;42824;0;0;0;0;4700625;2429881;80;0;2508085;0;0;0;0
FR;1;2021-03-24;142020;38376;0;0;43228;0;0;0;0;4842645;2468257;80;0;2551313;0;0;0;0
FR;1;2021-03-25;165028;39848;4;0;45996;0;0;0;0;5007673;2508105;84;0;2597309;0;0;0;0
FR;1;2021-03-26;166415;37438;5;1;44044;0;0;0;0;5174088;2545543;89;1;2641353;0;0;0;0
FR;1;2021-03-27;110899;15476;1;0;19486;0;0;0;0;5284987;2561019;90;1;2660839;0;0;0;0
FR;1;2021-03-28;42306;4350;3;0;5905;0;0;0;0;5327293;2565369;93;1;2666744;0;0;0;0
FR;1;2021-03-29;129839;49064;4;0;53713;0;0;0;0;5457132;2614433;97;1;2720457;0;0;0;0
FR;1;2021-03-30;167739;63766;5;0;70766;0;0;0;0;5624871;2678199;102;1;2791223;0;0;0;0
FR;1;2021-03-31;170961;67840;4;0;75364;0;0;0;0;5795832;2746039;106;1;2866587;0;0;0;0
FR;1;2021-04-01;194857;83724;10;0;93210;0;0;0;0;5990689;2829763;116;1;2959797;0;0;0;0
FR;1;2021-04-02;164468;86656;7;0;94459;0;0;0;0;6155157;2916419;123;1;3054256;0;0;0;0
FR;1;2021-04-03;88256;58179;6;0;61719;0;0;0;0;6243413;2974598;129;1;3115975;0;0;0;0
FR;1;2021-04-04;33659;17714;0;0;19209;0;0;0;0;6277072;2992312;129;1;3135184;0;0;0;0
FR;1;2021-04-05;46420;9622;11;0;11495;0;0;0;0;6323492;3001934;140;1;3146679;0;0;0;0
FR;1;2021-04-06;160336;105227;17;0;111674;0;0;0;0;6483828;3107161;157;1;3258353;0;0;0;0
FR;1;2021-04-07;197017;108109;16;0;116921;0;0;0;0;6680845;3215270;173;1;3375274;0;0;0;0
FR;1;2021-04-08;222171;114082;14;0;125412;0;0;0;0;6903016;3329352;187;1;3500686;0;0;0;0
FR;1;2021-04-09;214593;107941;21;0;118815;0;0;0;0;7117609;3437293;208;1;3619501;0;0;0;0
FR;1;2021-04-10;117198;73246;14;0;78384;0;0;0;0;7234807;3510539;222;1;3697885;0;0;0;0
FR;1;2021-04-11;40897;29897;6;0;31802;0;0;0;0;7275704;3540436;228;1;3729687;0;0;0;0
FR;1;2021-04-12;168489;104549;46;0;111771;0;0;0;0;7444193;3644985;274;1;3841458;0;0;0;0
FR;1;2021-04-13;203831;127803;97;1;137133;0;0;0;0;7648024;3772788;371;2;3978591;0;0;0;0
FR;1;2021-04-14;208657;122903;208;0;133118;0;0;0;0;7856681;3895691;579;2;4111709;0;0;0;0
FR;1;2021-04-15;221711;128035;313;0;139054;0;0;0;0;8078392;4023726;892;2;4250763;0;0;0;0
FR;1;2021-04-16;206095;125687;309;0;135347;0;0;0;0;8284487;4149413;1201;2;4386110;0;0;0;0
FR;1;2021-04-17;122103;67120;103;0;72175;0;0;0;0;8406590;4216533;1304;2;4458285;0;0;0;0
FR;1;2021-04-18;35971;21004;41;0;22710;0;0;0;0;8442561;4237537;1345;2;4480995;0;0;0;0
FR;1;2021-04-19;163766;121590;432;0;129118;0;0;0;0;8606327;4359127;1777;2;4610113;0;0;0;0
FR;1;2021-04-20;189457;149586;531;0;158692;0;0;0;0;8795784;4508713;2308;2;4768805;0;0;0;0
FR;1;2021-04-21;194029;147526;760;0;157038;0;0;0;0;8989813;4656239;3068;2;4925843;0;0;0;0
FR;1;2021-04-22;209061;164402;778;0;175625;0;0;0;0;9198874;4820641;3846;2;5101468;0;0;0;0
FR;1;2021-04-23;198980;157945;671;0;168951;0;0;0;0;9397854;4978586;4517;2;5270419;0;0;0;0
FR;1;2021-04-24;126347;95825;148;0;101888;0;0;0;0;9524201;5074411;4665;2;5372307;0;0;0;0
FR;1;2021-04-25;53635;30057;46;0;32814;0;0;0;0;9577836;5104468;4711;2;5405121;0;0;0;0
FR;1;2021-04-26;181164;140010;542;0;148719;0;0;0;0;9759000;5244478;5253;2;5553840;0;0;0;0
FR;1;2021-04-27;221389;162466;901;0;173832;0;0;0;0;9980389;5406944;6154;2;5727672;0;0;0;0
FR;1;2021-04-28;238332;156012;1314;1;168689;1;0;0;0;10218721;5562956;7468;3;5896361;1;0;0;0
FR;1;2021-04-29;270322;161429;1211;0;177027;0;0;0;0;10489043;5724385;8679;3;6073388;1;0;0;0
FR;1;2021-04-30;272013;148819;1073;0;164923;0;0;0;0;10761056;5873204;9752;3;6238311;1;0;0;0
FR;1;2021-05-01;141168;40597;173;0;48627;0;0;0;0;10902224;5913801;9925;3;6286938;1;0;0;0
FR;1;2021-05-02;81560;28200;81;0;32953;0;0;0;0;10983784;5942001;10006;3;6319891;1;0;0;0
FR;1;2021-05-03;250803;142729;803;0;156419;0;0;0;0;11234587;6084730;10809;3;6476310;1;0;0;0
FR;1;2021-05-04;265910;187801;1202;0;203370;0;0;0;0;11500497;6272531;12011;3;6679680;1;0;0;0
FR;1;2021-05-05;283920;185956;1267;0;202608;0;0;0;0;11784417;6458487;13278;3;6882288;1;0;0;0
FR;1;2021-05-06;309997;184273;1502;0;204031;0;0;0;0;12094414;6642760;14780;3;7086319;1;0;0;0
FR;1;2021-05-07;284125;196496;1127;0;214320;0;0;0;0;12378539;6839256;15907;3;7300639;1;0;0;0
FR;1;2021-05-08;191668;51095;285;0;62477;0;0;0;0;12570207;6890351;16192;3;7363116;1;0;0;0
FR;1;2021-05-09;114064;34520;236;0;41692;0;0;0;0;12684271;6924871;16428;3;7404808;1;0;0;0
FR;1;2021-05-10;258224;194847;1187;0;210842;0;0;0;0;12942495;7119718;17615;3;7615650;1;0;0;0
FR;1;2021-05-11;318910;211096;1465;0;231324;0;0;0;0;13261405;7330814;19080;3;7846974;1;0;0;0
FR;1;2021-05-12;356659;185972;1401;0;208279;0;0;0;0;13618064;7516786;20481;3;8055253;1;0;0;0
FR;1;2021-05-13;283461;47394;401;0;64320;0;0;0;0;13901525;7564180;20882;3;8119573;1;0;0;0
FR;1;2021-05-14;370517;128536;994;0;151947;0;0;0;0;14272042;7692716;21876;3;8271520;1;0;0;0
FR;1;2021-05-15;298110;66172;404;0;84880;0;0;0;0;14570152;7758888;22280;3;8356400;1;0;0;0
FR;1;2021-05-16;157784;15478;158;0;26045;0;0;0;0;14727936;7774366;22438;3;8382445;1;0;0;0
FR;1;2021-05-17;318938;116188;1441;0;138161;0;0;0;0;15046874;7890554;23879;3;8520606;1;0;0;0
FR;1;2021-05-18;383352;111558;1800;0;137510;0;0;0;0;15430226;8002112;25679;3;8658116;1;0;0;0
FR;1;2021-05-19;395287;101721;2184;0;128667;0;0;0;0;15825513;8103833;27863;3;8786783;1;0;0;0
FR;1;2021-05-20;421830;95693;2048;0;125183;0;0;0;0;16247343;8199526;29911;3;8911966;1;0;0;0
FR;1;2021-05-21;399817;97351;1764;0;125765;0;0;0;0;16647160;8296877;31675;3;9037731;1;0;0;0
FR;1;2021-05-22;275700;41917;604;0;60942;0;0;0;0;16922860;8338794;32279;3;9098673;1;0;0;0
FR;1;2021-05-23;123021;10981;224;0;20582;0;0;0;0;17045881;8349775;32503;3;9119255;1;0;0;0
FR;1;2021-05-24;244021;26255;569;0;43786;0;0;0;0;17289902;8376030;33072;3;9163041;1;0;0;0
FR;1;2021-05-25;366232;131533;2114;1;158471;0;0;0;0;17656134;8507563;35186;4;9321512;1;0;0;0
FR;1;2021-05-26;380828;127060;1995;0;155402;0;0;0;0;18036962;8634623;37181;4;9476914;1;0;0;0
FR;1;2021-05-27;406169;128233;1978;0;158720;0;0;0;0;18443131;8762856;39159;4;9635634;1;0;0;0
FR;1;2021-05-28;366045;145582;1701;0;174150;0;0;0;0;18809176;8908438;40860;4;9809784;1;0;0;0
FR;1;2021-05-29;253842;81063;527;0;100258;0;0;0;0;19063018;8989501;41387;4;9910042;1;0;0;0
FR;1;2021-05-30;100977;22593;158;0;30826;0;0;0;0;19163995;9012094;41545;4;9940868;1;0;0;0
FR;1;2021-05-31;314330;149115;1284;1;172377;1;0;0;0;19478325;9161209;42829;5;10113245;2;0;0;0
FR;1;2021-06-01;361657;166386;1733;1;194099;1;0;0;0;19839982;9327595;44562;6;10307344;3;0;0;0
FR;1;2021-06-02;365406;154175;1797;0;183706;0;0;0;0;20205388;9481770;46359;6;10491050;3;0;0;0
FR;1;2021-06-03;391440;147349;1653;0;178321;0;0;0;0;20596828;9629119;48012;6;10669371;3;0;0;0
FR;1;2021-06-04;364122;175759;1495;1;205034;1;0;0;0;20960950;9804878;49507;7;10874405;4;0;0;0
FR;1;2021-06-05;258517;112761;597;0;133119;0;0;0;0;21219467;9917639;50104;7;11007524;4;0;0;0
FR;1;2021-06-06;126821;37556;215;0;48196;0;0;0;0;21346288;9955195;50319;7;11055720;4;0;0;0
FR;1;2021-06-07;301114;207743;1367;0;233022;0;0;0;0;21647402;10162938;51686;7;11288742;4;0;0;0
FR;1;2021-06-08;330864;220930;1645;0;248892;0;0;0;0;21978266;10383868;53331;7;11537634;4;0;0;0
FR;1;2021-06-09;336598;211167;1614;0;239951;0;0;0;0;22314864;10595035;54945;7;11777585;4;0;0;0
FR;1;2021-06-10;343905;200206;1614;0;229942;0;0;0;0;22658769;10795241;56559;7;12007527;4;0;0;0
FR;1;2021-06-11;311908;234715;1299;1;262608;0;0;0;0;22970677;11029956;57858;8;12270135;4;0;0;0
FR;1;2021-06-12;244091;150590;438;0;172199;0;0;0;0;23214768;11180546;58296;8;12442334;4;0;0;0
FR;1;2021-06-13;100371;61021;188;0;70680;0;0;0;0;23315139;11241567;58484;8;12513014;4;0;0;0
FR;1;2021-06-14;207858;287788;1318;1;307578;0;0;0;0;23522997;11529355;59802;9;12820592;4;0;0;0
FR;1;2021-06-15;256874;281289;1400;1;305125;0;0;0;0;23779871;11810644;61202;10;13125717;4;0;0;0
FR;1;2021-06-16;273663;270605;1263;1;296029;0;0;0;0;24053534;12081249;62465;11;13421746;4;0;0;0
FR;1;2021-06-17;268232;244929;1240;1;270987;0;0;0;0;24321766;12326178;63705;12;13692733;4;0;0;0
FR;1;2021-06-18;260611;295266;1155;1;321086;0;0;0;0;24582377;12621444;64860;13;14013819;4;0;0;0
FR;1;2021-06-19;193458;209548;388;0;228203;0;0;0;0;24775835;12830992;65248;13;14242022;4;0;0;0
FR;1;2021-06-20;69716;89050;120;0;96892;0;0;0;0;24845551;12920042;65368;13;14338914;4;0;0;0
FR;1;2021-06-21;172384;319692;934;1;338395;1;0;0;0;25017935;13239734;66302;14;14677309;5;0;0;0
FR;1;2021-06-22;185877;347930;1102;10;368978;1;0;0;0;25203812;13587664;67404;24;15046287;6;0;0;0
FR;1;2021-06-23;204220;339525;1049;0;363424;0;0;0;0;25408032;13927189;68453;24;15409711;6;0;0;0
FR;1;2021-06-24;203539;282008;1176;0;306757;0;0;0;0;25611571;14209197;69629;24;15716468;6;0;0;0
FR;1;2021-06-25;182667;371710;1198;0;395709;0;0;0;0;25794238;14580907;70827;24;16112177;6;0;0;0
FR;1;2021-06-26;131401;278484;504;0;295846;0;0;0;0;25925639;14859391;71331;24;16408023;6;0;0;0
FR;1;2021-06-27;52410;122864;146;0;130407;0;0;0;0;25978049;14982255;71477;24;16538430;6;0;0;0
FR;1;2021-06-28;136669;368186;1065;0;386791;0;0;0;0;26114718;15350441;72542;24;16925221;6;0;0;0
FR;1;2021-06-29;154905;390987;1848;0;412107;0;0;0;0;26269623;15741428;74390;24;17337328;6;0;0;0
FR;1;2021-06-30;180063;381852;1667;4;406463;2;0;0;0;26449686;16123280;76057;28;17743791;8;0;0;0
FR;1;2021-07-01;201552;332398;1888;5;360502;1;0;0;0;26651238;16455678;77945;33;18104293;9;0;0;0
FR;1;2021-07-02;193881;367334;1765;5;395559;2;0;0;0;26845119;16823012;79710;38;18499852;11;0;0;0
FR;1;2021-07-03;124482;280405;704;3;299519;1;0;0;0;26969601;17103417;80414;41;18799371;12;0;0;0
FR;1;2021-07-04;53966;113709;244;0;122124;0;0;0;0;27023567;17217126;80658;41;18921495;12;0;0;0
FR;1;2021-07-05;153967;355788;1500;8;379146;0;0;0;0;27177534;17572914;82158;49;19300641;12;0;0;0
FR;1;2021-07-06;173511;382291;1603;45;408203;8;0;0;0;27351045;17955205;83761;94;19708844;20;0;0;0
FR;1;2021-07-07;190851;362362;1658;25;390718;4;0;0;0;27541896;18317567;85419;119;20099562;24;0;0;0
FR;1;2021-07-08;201578;322984;1826;20;353662;4;0;0;0;27743474;18640551;87245;139;20453224;28;0;0;0
FR;1;2021-07-09;189985;387774;1854;3;418210;2;0;0;0;27933459;19028325;89099;142;20871434;30;0;0;0
FR;1;2021-07-10;129957;281154;818;1;302588;1;0;0;0;28063416;19309479;89917;143;21174022;31;0;0;0
FR;1;2021-07-11;57682;102519;262;0;112406;0;0;0;0;28121098;19411998;90179;143;21286428;31;0;0;0
FR;1;2021-07-12;149924;416854;1586;4;442886;0;0;0;0;28271022;19828852;91765;147;21729314;31;0;0;0
FR;1;2021-07-13;234281;439066;1808;8;476278;1;0;0;0;28505303;20267918;93573;155;22205592;32;0;0;0
FR;1;2021-07-14;171928;151384;418;0;177028;0;0;0;0;28677231;20419302;93991;155;22382620;32;0;0;0
FR;1;2021-07-15;279693;424207;1858;1;467218;0;0;0;0;28956924;20843509;95849;156;22849838;32;0;0;0
FR;1;2021-07-16;290445;400639;1711;3;445331;1;0;0;0;29247369;21244148;97560;159;23295169;33;0;0;0
FR;1;2021-07-17;217352;281991;755;1;315473;0;0;0;0;29464721;21526139;98315;160;23610642;33;0;0;0
FR;1;2021-07-18;102018;107205;288;0;123104;0;0;0;0;29566739;21633344;98603;160;23733746;33;0;0;0
FR;1;2021-07-19;238231;378506;1497;3;414581;0;0;0;0;29804970;22011850;100100;163;24148327;33;0;0;0
FR;1;2021-07-20;305767;379896;1470;0;425749;0;0;0;0;30110737;22391746;101570;163;24574076;33;0;0;0
FR;1;2021-07-21;333295;352825;1412;4;404233;1;0;0;0;30444032;22744571;102982;167;24978309;34;0;0;0
FR;1;2021-07-22;364686;318639;1502;3;375082;2;0;0;0;30808718;23063210;104484;170;25353391;36;0;0;0
FR;1;2021-07-23;349405;342903;1589;4;398476;1;0;0;0;31158123;23406113;106073;174;25751867;37;0;0;0
FR;1;2021-07-24;238963;240734;697;1;278081;0;0;0;0;31397086;23646847;106770;175;26029948;37;0;0;0
FR;1;2021-07-25;112803;76012;223;0;93714;0;0;0;0;31509889;23722859;106993;175;26123662;37;0;0;0
FR;1;2021-07-26;299143;289386;1495;2;335134;1;0;0;0;31809032;24012245;108488;177;26458796;38;0;0;0
FR;1;2021-07-27;385841;267987;1459;4;324983;1;0;0;0;32194873;24280232;109947;181;26783779;39;0;0;0
FR;1;2021-07-28;390209;250951;1462;4;307274;1;0;0;0;32585082;24531183;111409;185;27091053;40;0;0;0
FR;1;2021-07-29;406145;227666;1541;2;284412;0;0;0;0;32991227;24758849;112950;187;27375465;40;0;0;0
FR;1;2021-07-30;370749;246578;1638;4;298455;1;0;0;0;33361976;25005427;114588;191;27673920;41;0;0;0
FR;1;2021-07-31;243386;165080;793;1;199435;0;0;0;0;33605362;25170507;115381;192;27873355;41;0;0;0
FR;1;2021-08-01;105599;47209;235;0;61212;0;0;0;0;33710961;25217716;115616;192;27934567;41;0;0;0
FR;1;2021-08-02;297416;212860;1479;2;250694;0;0;0;0;34008377;25430576;117095;194;28185261;41;0;0;0
FR;1;2021-08-03;331340;208752;1557;2;250760;1;0;0;0;34339717;25639328;118652;196;28436021;42;0;0;0
FR;1;2021-08-04;328045;183868;1439;5;224058;3;0;0;0;34667762;25823196;120091;201;28660079;45;0;0;0
FR;1;2021-08-05;301286;193123;1483;0;229449;0;0;0;0;34969048;26016319;121574;201;28889528;45;0;0;0
FR;1;2021-08-06;290986;224136;1560;3;261470;0;0;0;0;35260034;26240455;123134;204;29150998;45;0;0;0
FR;1;2021-08-07;182672;158768;655;5;181695;1;0;0;0;35442706;26399223;123789;209;29332693;46;0;0;0
FR;1;2021-08-08;68887;59101;253;0;67633;0;0;0;0;35511593;26458324;124042;209;29400326;46;0;0;0
FR;1;2021-08-09;222792;235224;1445;4;263984;2;0;0;0;35734385;26693548;125487;213;29664310;48;0;0;0
FR;1;2021-08-10;252750;239928;1493;2;271801;0;0;0;0;35987135;26933476;126980;215;29936111;48;0;0;0
FR;1;2021-08-11;236243;231792;1271;5;261330;0;0;0;0;36223378;27165268;128251;220;30197441;48;0;0;0
FR;1;2021-08-12;220788;239803;1489;3;267950;0;0;0;0;36444166;27405071;129740;223;30465391;48;0;0;0
FR;1;2021-08-13;201721;238498;1360;2;264086;2;0;0;0;36645887;27643569;131100;225;30729477;50;0;0;0
FR;1;2021-08-14;122865;174043;645;0;189573;0;0;0;0;36768752;27817612;131745;225;30919050;50;0;0;0
FR;1;2021-08-15;34708;46119;201;1;50341;0;0;0;0;36803460;27863731;131946;226;30969391;50;0;0;0
FR;1;2021-08-16;156963;289397;1423;0;310016;0;0;0;0;36960423;28153128;133369;226;31279407;50;0;0;0
FR;1;2021-08-17;171615;291022;1422;5;313468;0;0;0;0;37132038;28444150;134791;231;31592875;50;0;0;0
FR;1;2021-08-18;161435;286714;1394;6;307380;3;0;0;0;37293473;28730864;136185;237;31900255;53;0;0;0
FR;1;2021-08-19;148955;277457;1404;1;297340;0;0;0;0;37442428;29008321;137589;238;32197595;53;0;0;0
FR;1;2021-08-20;140516;308976;1532;2;328257;2;0;0;0;37582944;29317297;139121;240;32525852;55;0;0;0
FR;1;2021-08-21;84280;213207;589;0;224553;0;0;0;0;37667224;29530504;139710;240;32750405;55;0;0;0
FR;1;2021-08-22;28581;82696;233;0;86705;0;0;0;0;37695805;29613200;139943;240;32837110;55;0;0;0
FR;1;2021-08-23;118663;320961;1422;2;337733;1;0;0;0;37814468;29934161;141365;242;33174843;56;0;0;0
FR;1;2021-08-24;126673;319661;1604;5;337517;0;0;0;0;37941141;30253822;142969;247;33512360;56;0;0;0
FR;1;2021-08-25;121538;306458;1779;8;323691;2;0;0;0;38062679;30560280;144748;255;33836051;58;0;0;0
FR;1;2021-08-26;106633;286074;2162;10;302412;0;0;0;0;38169312;30846354;146910;265;34138463;58;0;0;0
FR;1;2021-08-27;107655;321616;2302;9;338972;1;0;0;0;38276967;31167970;149212;274;34477435;59;0;0;0
FR;1;2021-08-28;71024;220689;1102;0;231250;0;0;0;0;38347991;31388659;150314;274;34708685;59;0;0;0
FR;1;2021-08-29;24152;78199;469;1;82099;0;0;0;0;38372143;31466858;150783;275;34790784;59;0;0;0
FR;1;2021-08-30;96899;286286;4313;6;299784;4977;0;0;0;38469042;31753144;155096;281;35090568;5036;0;0;0
FR;1;2021-08-31;98126;276269;9295;15;289930;10088;2;0;0;38567168;32029413;164391;296;35380498;15124;2;0;0
FR;1;2021-09-01;112351;245302;21120;8;257710;22149;1;0;0;38679519;32274715;185511;304;35638208;37273;3;0;0
FR;1;2021-09-02;86767;197915;24532;18;208329;25511;0;0;0;38766286;32472630;210043;322;35846537;62784;3;0;0
FR;1;2021-09-03;82423;227499;26957;21;238957;28038;0;0;0;38848709;32700129;237000;343;36085494;90822;3;0;0
FR;1;2021-09-04;71630;189712;11141;11;199318;11707;7;0;0;38920339;32889841;248141;354;36284812;102529;10;0;0
FR;1;2021-09-05;18613;41149;4124;2;43861;4275;0;0;0;38938952;32930990;252265;356;36328673;106804;10;0;0
FR;1;2021-09-06;59819;151420;30181;15;158963;31214;2;0;0;38998771;33082410;282446;371;36487636;138018;12;0;0
FR;1;2021-09-07;57400;139645;30213;30;146796;31245;2;0;0;39056171;33222055;312659;401;36634432;169263;14;0;0
FR;1;2021-09-08;72346;173786;26927;22;182290;27955;4;0;0;39128517;33395841;339586;423;36816722;197218;18;0;0
FR;1;2021-09-09;54487;124432;28633;24;131210;29740;5;0;0;39183004;33520273;368219;447;36947932;226958;23;0;0
FR;1;2021-09-10;66217;152074;30449;24;161186;31683;5;0;0;39249221;33672347;398668;471;37109118;258641;28;0;0
FR;1;2021-09-11;52689;146629;9731;14;154137;10351;0;0;0;39301910;33818976;408399;485;37263255;268992;28;0;0
FR;1;2021-09-12;10796;29273;2489;1;30976;2657;2;0;0;39312706;33848249;410888;486;37294231;271649;30;0;0
FR;1;2021-09-13;51511;104429;38760;31;110989;40081;16;0;0;39364217;33952678;449648;517;37405220;311730;46;0;0
FR;1;2021-09-14;53342;96003;51278;67;102440;53226;36;0;0;39417559;34048681;500926;584;37507660;364956;82;0;0
FR;1;2021-09-15;60577;139242;50497;55;146432;47058;68;0;0;39478136;34187923;551423;639;37654092;412014;150;0;0
FR;1;2021-09-16;46637;81374;53353;70;86274;49600;70;0;0;39524773;34269297;604776;709;37740366;461614;220;0;0
FR;1;2021-09-17;53224;109331;45073;61;115672;42700;63;0;0;39577997;34378628;649849;770;37856038;504314;283;0;0
FR;1;2021-09-18;37881;118492;11795;19;124086;11274;19;0;0;39615878;34497120;661644;789;37980124;515588;302;0;0
FR;1;2021-09-19;6531;21034;2041;1;22137;1982;1;0;0;39622409;34518154;663685;790;38002261;517570;303;0;0
FR;1;2021-09-20;36542;74849;46228;65;78578;44185;33;0;0;39658951;34593003;709913;855;38080839;561755;336;0;0
FR;1;2021-09-21;34199;68114;56263;72;71147;52735;80;0;0;39693150;34661117;766176;927;38151986;614490;416;0;0
FR;1;2021-09-22;38839;118599;49877;76;123024;46918;41;0;0;39731989;34779716;816053;1003;38275010;661408;457;0;0
FR;1;2021-09-23;32037;62900;54507;85;65803;50914;85;0;0;39764026;34842616;870560;1088;38340813;712322;542;0;0
FR;1;2021-09-24;36797;90035;43673;89;94401;41950;58;0;0;39800823;34932651;914233;1177;38435214;754272;600;0;0
FR;1;2021-09-25;27651;96704;12307;27;101066;12184;19;0;0;39828474;35029355;926540;1204;38536280;766456;619;0;0
FR;1;2021-09-26;4386;15193;1776;5;16057;1698;4;0;0;39832860;35044548;928316;1209;38552337;768154;623;0;0
FR;1;2021-09-27;27353;60211;42912;89;63449;41636;82;0;1;39860213;35104759;971228;1298;38615786;809790;705;0;1
FR;1;2021-09-28;26912;49419;47199;76;52043;44481;44;0;0;39887125;35154178;1018427;1374;38667829;854271;749;0;1
FR;1;2021-09-29;35925;80276;47288;87;84665;45611;37;0;0;39923050;35234454;1065715;1461;38752494;899882;786;0;1
FR;1;2021-09-30;26075;46884;47526;80;49259;45459;56;0;0;39949125;35281338;1113241;1541;38801753;945341;842;0;1
FR;1;2021-10-01;47300;66932;44903;83;70828;44617;16;0;0;39996425;35348270;1158144;1624;38872581;989958;858;0;1
FR;1;2021-10-02;32383;62406;16112;32;67223;16320;6;0;0;40028808;35410676;1174256;1656;38939804;1006278;864;0;1
FR;1;2021-10-03;4342;8561;2040;3;9313;2034;4;0;0;40033150;35419237;1176296;1659;38949117;1008312;868;0;1
FR;1;2021-10-04;28976;44411;47109;79;46835;46972;33;0;0;40062126;35463648;1223405;1738;38995952;1055284;901;0;1
FR;1;2021-10-05;24567;41645;49890;116;43152;49331;51;0;0;40086693;35505293;1273295;1854;39039104;1104615;952;0;1
FR;1;2021-10-06;34656;61382;57509;102;64502;57255;27;0;0;40121349;35566675;1330804;1956;39103606;1161870;979;0;1
FR;1;2021-10-07;21077;39913;53047;75;41097;51982;36;0;0;40142426;35606588;1383851;2031;39144703;1213852;1015;0;1
FR;1;2021-10-08;35667;59646;60408;83;62884;61159;30;0;0;40178093;35666234;1444259;2114;39207587;1275011;1045;0;1
FR;1;2021-10-09;27466;48010;25496;29;52488;26022;10;0;0;40205559;35714244;1469755;2143;39260075;1301033;1055;0;1
FR;1;2021-10-10;3725;5811;2756;7;6289;2863;1;0;0;40209284;35720055;1472511;2150;39266364;1303896;1056;0;1
FR;1;2021-10-11;24857;38233;54587;88;40319;55263;49;0;0;40234141;35758288;1527098;2238;39306683;1359159;1105;0;1
FR;1;2021-10-12;23379;36587;58073;128;37107;59224;18;0;0;40257520;35794875;1585171;2366;39343790;1418383;1123;0;1
FR;1;2021-10-13;32971;47833;64172;125;50646;65691;25;0;1;40290491;35842708;1649343;2491;39394436;1484074;1148;0;2
FR;1;2021-10-14;21712;34766;53769;103;35678;54357;25;0;0;40312203;35877474;1703112;2594;39430114;1538431;1173;0;2
FR;1;2021-10-15;32750;48770;72329;165;50469;75020;24;0;0;40344953;35926244;1775441;2759;39480583;1613451;1197;0;2
FR;1;2021-10-16;26012;35286;34870;44;38304;36422;15;0;0;40370965;35961530;1810311;2803;39518887;1649873;1212;0;2
FR;1;2021-10-17;3158;4049;3417;2;4493;3317;3;0;0;40374123;35965579;1813728;2805;39523380;1653190;1215;0;2
FR;1;2021-10-18;24335;34887;66842;132;34936;69715;29;0;0;40398458;36000466;1880570;2937;39558316;1722905;1244;0;2
FR;1;2021-10-19;20721;35577;75667;135;33238;79595;41;0;0;40419179;36036043;1956237;3072;39591554;1802500;1285;0;2
FR;1;2021-10-20;29914;44207;96182;178;43290;99866;47;0;0;40449093;36080250;2052419;3250;39634844;1902366;1332;0;2
FR;1;2021-10-21;19800;35060;83187;107;31775;87041;33;0;0;40468893;36115310;2135606;3357;39666619;1989407;1365;0;2
FR;1;2021-10-22;29755;47759;103752;196;44580;109697;64;0;0;40498648;36163069;2239358;3553;39711199;2099104;1429;0;2
FR;1;2021-10-23;23052;35140;44874;57;36137;47381;12;0;0;40521700;36198209;2284232;3610;39747336;2146485;1441;0;2
FR;1;2021-10-24;2406;3847;3583;6;4042;3719;1;0;0;40524106;36202056;2287815;3616;39751378;2150204;1442;0;2
FR;1;2021-10-25;22496;30743;82027;143;29635;85830;37;0;0;40546602;36232799;2369842;3759;39781013;2236034;1479;0;2
FR;1;2021-10-26;19366;27659;86119;162;24762;90342;32;0;0;40565968;36260458;2455961;3921;39805775;2326376;1511;0;2
FR;1;2021-10-27;26218;39624;107812;252;37322;112720;51;0;0;40592186;36300082;2563773;4173;39843097;2439096;1562;0;2
FR;1;2021-10-28;18801;27116;86960;150;23507;91711;40;0;0;40610987;36327198;2650733;4323;39866604;2530807;1602;0;2
FR;1;2021-10-29;25930;40261;114836;202;35508;121659;54;0;0;40636917;36367459;2765569;4525;39902112;2652466;1656;0;2
FR;1;2021-10-30;17709;28710;49371;74;28308;51959;19;0;0;40654626;36396169;2814940;4599;39930420;2704425;1675;0;2
FR;1;2021-10-31;2086;3173;3451;2;3218;3686;2;0;0;40656712;36399342;2818391;4601;39933638;2708111;1677;0;2
FR;1;2021-11-01;8014;4271;3033;3;4356;3292;6;0;0;40664726;36403613;2821424;4604;39937994;2711403;1683;0;2
FR;1;2021-11-02;22908;33230;92406;156;29196;97850;39;0;1;40687634;36436843;2913830;4760;39967190;2809253;1722;0;3
FR;1;2021-11-03;26635;41566;117507;219;37027;123882;59;0;0;40714269;36478409;3031337;4979;40004217;2933135;1781;0;3
FR;1;2021-11-04;19625;30311;105815;213;24201;111965;44;0;0;40733894;36508720;3137152;5192;40028418;3045100;1825;0;3
FR;1;2021-11-05;27023;42311;138788;230;34211;147457;50;0;0;40760917;36551031;3275940;5422;40062629;3192557;1875;0;3
FR;1;2021-11-06;18861;29819;63487;123;27625;66500;25;0;0;40779778;36580850;3339427;5545;40090254;3259057;1900;0;3
FR;1;2021-11-07;1834;3283;4982;6;3034;5304;5;0;0;40781612;36584133;3344409;5551;40093288;3264361;1905;0;3
FR;1;2021-11-08;17877;32251;126007;224;25394;132646;48;0;0;40799489;36616384;3470416;5775;40118682;3397007;1953;0;3
FR;1;2021-11-09;19518;37622;159318;334;26163;169119;69;0;0;40819007;36654006;3629734;6109;40144845;3566126;2022;0;3
FR;1;2021-11-10;28887;49080;181915;440;39043;192528;88;0;0;40847894;36703086;3811649;6549;40183888;3758654;2110;0;3
FR;1;2021-11-11;4189;5940;12236;26;5110;13029;14;0;0;40852083;36709026;3823885;6575;40188998;3771683;2124;0;3
FR;1;2021-11-12;26021;46843;174830;244;35324;186508;85;0;0;40878104;36755869;3998715;6819;40224322;3958191;2209;0;3
FR;1;2021-11-13;18733;29148;76840;111;25382;81781;43;0;0;40896837;36785017;4075555;6930;40249704;4039972;2252;0;3
FR;1;2021-11-14;2049;3247;6825;5;2802;7355;6;0;0;40898886;36788264;4082380;6935;40252506;4047327;2258;0;3
FR;1;2021-11-15;18786;34739;156435;306;24651;166257;63;0;0;40917672;36823003;4238815;7241;40277157;4213584;2321;0;3
FR;1;2021-11-16;21363;37874;192139;380;23385;205045;103;0;1;40939035;36860877;4430954;7621;40300542;4418629;2424;0;4
FR;1;2021-11-17;28669;45568;193242;398;33048;205052;96;0;0;40967704;36906445;4624196;8019;40333590;4623681;2520;0;4
FR;1;2021-11-18;21141;39587;182519;458;25152;194616;90;0;0;40988845;36946032;4806715;8477;40358742;4818297;2610;0;4
FR;1;2021-11-19;30891;53323;230269;532;34847;246738;139;0;0;41019736;36999355;5036984;9009;40393589;5065035;2749;0;4
FR;1;2021-11-20;23765;33231;96995;202;26744;103647;45;0;0;41043501;37032586;5133979;9211;40420333;5168682;2794;0;4
FR;1;2021-11-21;2339;3911;9124;19;2956;9935;16;0;0;41045840;37036497;5143103;9230;40423289;5178617;2810;0;4
FR;1;2021-11-22;21421;30368;175921;467;16980;189472;78;0;0;41067261;37066865;5319024;9697;40440269;5368089;2888;0;4
FR;1;2021-11-23;24025;40999;221239;540;21361;237979;77;0;0;41091286;37107864;5540263;10237;40461630;5606068;2965;0;4
FR;1;2021-11-24;30298;49681;217378;702;32017;234550;67;0;0;41121584;37157545;5757641;10939;40493647;5840618;3032;0;4
FR;1;2021-11-25;23731;44043;244491;718;22112;264150;101;0;0;41145315;37201588;6002132;11657;40515759;6104768;3133;0;4
FR;1;2021-11-26;30623;66686;356823;836;33320;388590;153;0;0;41175938;37268274;6358955;12493;40549079;6493358;3286;0;4
FR;1;2021-11-27;21961;45310;202648;372;26209;222671;116;0;0;41197899;37313584;6561603;12865;40575288;6716029;3402;0;4
FR;1;2021-11-28;3179;9576;54795;63;3485;61017;37;0;0;41201078;37323160;6616398;12928;40578773;6777046;3439;0;4
FR;1;2021-11-29;17902;49489;326402;841;20832;354511;150;0;0;41218980;37372649;6942800;13769;40599605;7131557;3589;0;4
FR;1;2021-11-30;22789;64873;431168;952;23894;470796;261;0;0;41241769;37437522;7373968;14721;40623499;7602353;3850;0;4
FR;1;2021-12-01;25349;69173;442922;1131;28563;481785;271;0;0;41267118;37506695;7816890;15852;40652062;8084138;4121;0;4
FR;1;2021-12-02;20088;64449;489426;1228;18568;532943;272;0;0;41287206;37571144;8306316;17080;40670630;8617081;4393;0;4
FR;1;2021-12-03;22912;82405;542799;1309;30406;591788;307;0;0;41310118;37653549;8849115;18389;40701036;9208869;4700;0;4
FR;1;2021-12-04;16415;53886;299111;654;23296;328977;184;0;0;41326533;37707435;9148226;19043;40724332;9537846;4884;0;4
FR;1;2021-12-05;3635;13811;81538;143;4226;91043;85;0;0;41330168;37721246;9229764;19186;40728558;9628889;4969;0;4
FR;1;2021-12-06;25851;62513;415470;1066;22162;455193;354;0;0;41356019;37783759;9645234;20252;40750720;10084082;5323;0;4
FR;1;2021-12-07;20013;75553;523016;1536;24394;572655;371;0;0;41376032;37859312;10168250;21788;40775114;10656737;5694;0;4
FR;1;2021-12-08;21712;75616;458452;1545;30739;502131;378;0;0;41397744;37934928;10626702;23333;40805853;11158868;6072;0;4
FR;1;2021-12-09;19468;74028;492963;1626;24449;540946;397;0;0;41417212;38008956;11119665;24959;40830302;11699814;6469;0;4
FR;1;2021-12-10;23323;87632;547405;1585;32541;600034;390;0;1;41440535;38096588;11667070;26544;40862843;12299848;6859;0;5
FR;1;2021-12-11;16533;59143;302753;751;26018;335477;277;0;0;41457068;38155731;11969823;27295;40888861;12635325;7136;0;5
FR;1;2021-12-12;4392;15927;83225;179;5275;94050;96;0;0;41461460;38171658;12053048;27474;40894136;12729375;7232;0;5
FR;1;2021-12-13;15754;63525;367012;1094;24043;406285;234;0;0;41477214;38235183;12420060;28568;40918179;13135660;7466;0;5
FR;1;2021-12-14;20861;80222;464809;1747;28760;515258;505;0;1;41498075;38315405;12884869;30315;40946939;13650918;7971;0;6
FR;1;2021-12-15;21617;77413;409106;1309;33130;453178;310;0;1;41519692;38392818;13293975;31624;40980069;14104096;8281;0;7
FR;1;2021-12-16;20047;77211;451892;1577;28068;500635;324;0;0;41539739;38470029;13745867;33201;41008137;14604731;8605;0;7
FR;1;2021-12-17;22616;86531;479955;1737;34780;530996;372;0;0;41562355;38556560;14225822;34938;41042917;15135727;8977;0;7
FR;1;2021-12-18;17604;54656;257635;731;24758;288538;230;0;0;41579959;38611216;14483457;35669;41067675;15424265;9207;0;7
FR;1;2021-12-19;5552;16993;79186;194;5945;90706;116;0;0;41585511;38628209;14562643;35863;41073620;15514971;9323;0;7
FR;1;2021-12-20;20935;63049;316260;1081;26635;355312;282;0;0;41606446;38691258;14878903;36944;41100255;15870283;9605;0;7
FR;1;2021-12-21;26328;73002;372774;1423;30706;418093;337;0;0;41632774;38764260;15251677;38367;41130961;16288376;9942;0;7
FR;1;2021-12-22;24980;65814;310647;1217;29712;349601;360;0;1;41657754;38830074;15562324;39584;41160673;16637977;10302;0;8
FR;1;2021-12-23;21272;52217;241495;956;23450;273037;361;0;0;41679026;38882291;15803819;40540;41184123;16911014;10663;0;8
FR;1;2021-12-24;7127;18324;67158;258;9287;77062;154;0;1;41686153;38900615;15870977;40798;41193410;16988076;10817;0;9
FR;1;2021-12-25;508;2877;5588;15;1806;6535;55;0;0;41686661;38903492;15876565;40813;41195216;16994611;10872;0;9
FR;1;2021-12-26;2749;7579;26946;71;3497;31458;100;0;0;41689410;38911071;15903511;40884;41198713;17026069;10972;0;9
FR;1;2021-12-27;18312;53542;235119;705;25538;265771;365;0;0;41707722;38964613;16138630;41589;41224251;17291840;11337;0;9
FR;1;2021-12-28;23300;61991;292042;1026;27097;330215;595;0;1;41731022;39026604;16430672;42615;41251348;17622055;11932;0;10
FR;1;2021-12-29;22217;55478;255013;920;25346;288224;645;0;1;41753239;39082082;16685685;43535;41276694;17910279;12577;0;11
FR;1;2021-12-30;21241;46504;212167;858;22521;239624;719;0;0;41774480;39128586;16897852;44393;41299215;18149903;13296;0;11
FR;1;2021-12-31;7467;16571;61875;229;8751;70412;346;0;0;41781947;39145157;16959727;44622;41307966;18220315;13642;0;11
FR;1;2022-01-01;1158;2498;5663;30;1542;6582;72;0;0;41783105;39147655;16965390;44652;41309508;18226897;13714;0;11
FR;1;2022-01-02;3085;8077;28892;50;3674;33531;190;0;0;41786190;39155732;16994282;44702;41313182;18260428;13904;0;11
FR;1;2022-01-03;25499;54245;228249;789;27592;257725;957;0;1;41811689;39209977;17222531;45491;41340774;18518153;14861;0;12
FR;1;2022-01-04;26186;65070;299269;1239;29882;337295;1370;0;2;41837875;39275047;17521800;46730;41370656;18855448;16231;0;14
FR;1;2022-01-05;30542;64312;274890;1099;32572;310269;1261;0;0;41868417;39339359;17796690;47829;41403228;19165717;17492;0;14
FR;1;2022-01-06;26837;66252;306895;1399;29330;346560;1565;0;1;41895254;39405611;18103585;49228;41432558;19512277;19057;0;15
FR;1;2022-01-07;31569;75055;349843;1538;34463;393984;1823;0;1;41926823;39480666;18453428;50766;41467021;19906261;20880;0;16
FR;1;2022-01-08;23388;51389;222497;698;25609;251118;913;0;1;41950211;39532055;18675925;51464;41492630;20157379;21793;0;17
FR;1;2022-01-09;7092;17162;66025;163;8190;76140;335;0;0;41957303;39549217;18741950;51627;41500820;20233519;22128;0;17
FR;1;2022-01-10;21790;60665;236807;955;32974;267614;1258;0;1;41979093;39609882;18978757;52582;41533794;20501133;23386;0;18
FR;1;2022-01-11;26763;63482;282298;1277;31241;317826;1833;0;1;42005856;39673364;19261055;53859;41565035;20818959;25219;0;19
FR;1;2022-01-12;28955;62538;246264;1105;35106;278045;1685;0;3;42034811;39735902;19507319;54964;41600141;21097004;26904;0;22
FR;1;2022-01-13;24781;60213;262800;1253;30080;296124;1995;0;4;42059592;39796115;19770119;56217;41630221;21393128;28899;0;26
FR;1;2022-01-14;27967;66753;314014;1366;32172;351269;2474;0;1;42087559;39862868;20084133;57583;41662393;21744397;31373;0;27
FR;1;2022-01-15;19365;44443;199315;618;22484;223864;1362;0;1;42106924;39907311;20283448;58201;41684877;21968261;32735;0;28
FR;1;2022-01-16;5160;12980;51527;135;6033;59560;337;0;0;42112084;39920291;20334975;58336;41690910;22027821;33072;0;28
FR;1;2022-01-17;16867;39737;184834;781;20164;206830;1691;0;2;42128951;39960028;20519809;59117;41711074;22234651;34763;0;30
FR;1;2022-01-18;19453;45992;212430;1154;23001;237044;2456;0;1;42148404;40006020;20732239;60271;41734075;22471695;37219;0;31
FR;1;2022-01-19;20307;43990;176119;897;25495;197199;1974;0;4;42168711;40050010;20908358;61168;41759570;22668894;39193;0;35
FR;1;2022-01-20;16841;40617;183689;1138;20833;204749;2513;0;2;42185552;40090627;21092047;62306;41780403;22873643;41706;0;37
FR;1;2022-01-21;19915;47064;228961;1405;23927;253353;3108;0;1;42205467;40137691;21321008;63711;41804330;23126996;44814;0;38
FR;1;2022-01-22;13843;33358;144495;578;18450;161389;1404;0;2;42219310;40171049;21465503;64289;41822780;23288385;46218;0;40
FR;1;2022-01-23;3377;8770;33429;132;4578;38319;352;0;1;42222687;40179819;21498932;64421;41827358;23326704;46570;0;41
FR;1;2022-01-24;11807;32998;142218;711;17810;158258;2102;0;1;42234494;40212817;21641150;65132;41845168;23484962;48672;0;42
FR;1;2022-01-25;14213;38199;163411;1049;20295;181573;3179;0;1;42248707;40251016;21804561;66181;41865463;23666535;51851;0;43
FR;1;2022-01-26;14863;37710;150254;933;22638;166364;2517;0;1;42263570;40288726;21954815;67114;41888101;23832899;54368;0;44
FR;1;2022-01-27;12340;33319;143454;888;18500;158009;3226;0;3;42275910;40322045;22098269;68002;41906601;23990908;57594;0;47
FR;1;2022-01-28;16325;56942;198318;1143;32682;222399;4004;0;3;42292235;40378987;22296587;69145;41939283;24213307;61598;0;50
FR;1;2022-01-29;10268;35493;135205;525;19623;151542;1879;0;1;42302503;40414480;22431792;69670;41958906;24364849;63477;0;51
FR;1;2022-01-30;2485;9274;29682;86;4832;34458;435;0;1;42304988;40423754;22461474;69756;41963738;24399307;63912;0;52
FR;1;2022-01-31;8758;32501;104345;533;19492;117367;2342;0;3;42313746;40456255;22565819;70289;41983230;24516674;66254;0;55
FR;1;2022-02-01;10995;36480;127082;865;20649;141243;4328;0;1;42324741;40492735;22692901;71154;42003879;24657917;70582;0;56
FR;1;2022-02-02;12046;41601;130355;782;25273;145831;3780;0;9;42336787;40534336;22823256;71936;42029152;24803748;74362;0;65
FR;1;2022-02-03;9293;34059;117015;785;19113;130343;4296;0;4;42346080;40568395;22940271;72721;42048265;24934091;78658;0;69
FR;1;2022-02-04;11530;48565;172582;967;25847;192748;5493;0;5;42357610;40616960;23112853;73688;42074112;25126839;84151;0;74
FR;1;2022-02-05;7996;33938;117587;391;18179;133036;2421;0;3;42365606;40650898;23230440;74079;42092291;25259875;86572;0;77
FR;1;2022-02-06;1706;8002;22752;85;3875;26907;444;0;0;42367312;40658900;23253192;74164;42096166;25286782;87016;0;77
FR;1;2022-02-07;7336;35423;119101;459;18193;134975;3397;0;4;42374648;40694323;23372293;74623;42114359;25421757;90413;0;81
FR;1;2022-02-08;7762;31955;125657;694;14887;140646;4300;0;5;42382410;40726278;23497950;75317;42129246;25562403;94713;0;86
FR;1;2022-02-09;8651;36519;135256;701;17921;152500;3883;0;7;42391061;40762797;23633206;76018;42147167;25714903;98596;0;93
FR;1;2022-02-10;7021;30122;116375;674;13885;130163;4443;0;1;42398082;40792919;23749581;76692;42161052;25845066;103039;0;94
FR;1;2022-02-11;8657;41546;165143;878;18357;185368;5430;0;3;42406739;40834465;23914724;77570;42179409;26030434;108469;0;97
FR;1;2022-02-12;5340;27608;106713;379;12530;120898;2396;0;2;42412079;40862073;24021437;77949;42191939;26151332;110865;0;99
FR;1;2022-02-13;1261;5718;21717;66;2187;25333;402;0;3;42413340;40867791;24043154;78015;42194126;26176665;111267;0;102
FR;1;2022-02-14;5457;27222;118091;394;10638;133118;3384;0;4;42418797;40895013;24161245;78409;42204764;26309783;114651;0;106
FR;1;2022-02-15;5790;28859;118925;611;12207;132557;4882;0;1;42424587;40923872;24280170;79020;42216971;26442340;119533;0;107
FR;1;2022-02-16;5757;28486;110419;596;13750;123050;4152;0;3;42430344;40952358;24390589;79616;42230721;26565390;123685;0;110
FR;1;2022-02-17;4613;19737;73145;487;10124;80250;3996;0;3;42434957;40972095;24463734;80103;42240845;26645640;127681;0;113
FR;1;2022-02-18;5606;26790;99202;673;14162;108162;5519;0;2;42440563;40998885;24562936;80776;42255007;26753802;133200;0;115
FR;1;2022-02-19;3550;17177;59479;304;9569;66060;2266;0;0;42444113;41016062;24622415;81080;42264576;26819862;135466;0;115
FR;1;2022-02-20;791;3256;10706;36;1649;12333;360;0;1;42444904;41019318;24633121;81116;42266225;26832195;135826;0;116
FR;1;2022-02-21;3428;14591;52829;286;7914;57675;3126;0;2;42448332;41033909;24685950;81402;42274139;26889870;138952;0;118
FR;1;2022-02-22;3799;15539;51914;500;9036;55653;4069;0;1;42452131;41049448;24737864;81902;42283175;26945523;143021;0;119
FR;1;2022-02-23;4232;17821;57473;508;10742;62573;3568;0;3;42456363;41067269;24795337;82410;42293917;27008096;146589;0;122
FR;1;2022-02-24;3343;13128;43615;436;7824;46401;3660;0;2;42459706;41080397;24838952;82846;42301741;27054497;150249;0;124
FR;1;2022-02-25;4474;19922;64923;696;12040;68794;5767;0;4;42464180;41100319;24903875;83542;42313781;27123291;156016;0;128
FR;1;2022-02-26;2693;12801;41369;310;7648;45122;2494;0;2;42466873;41113120;24945244;83852;42321429;27168413;158510;0;130
FR;1;2022-02-27;644;2190;7128;42;1206;7993;431;0;0;42467517;41115310;24952372;83894;42322635;27176406;158941;0;130
FR;1;2022-02-28;2611;10490;34961;306;6072;37387;3124;0;0;42470128;41125800;24987333;84200;42328707;27213793;162065;0;130
FR;1;2022-03-01;3580;10750;38703;391;6355;39658;4548;0;4;42473708;41136550;25026036;84591;42335062;27253451;166613;0;134
FR;1;2022-03-02;3676;12184;41859;397;7450;43930;4108;0;1;42477384;41148734;25067895;84988;42342512;27297381;170721;0;135
FR;1;2022-03-03;2459;7983;26178;327;5239;26516;3378;0;1;42479843;41156717;25094073;85315;42347751;27323897;174099;0;136
FR;1;2022-03-04;2683;10481;35435;592;6911;34929;5277;0;3;42482526;41167198;25129508;85907;42354662;27358826;179376;0;139
FR;1;2022-03-05;1821;6361;21967;280;4201;22364;2571;0;1;42484347;41173559;25151475;86187;42358863;27381190;181947;0;140
FR;1;2022-03-06;358;955;2917;38;601;3120;327;0;0;42484705;41174514;25154392;86225;42359464;27384310;182274;0;140
FR;1;2022-03-07;1774;4718;16437;245;3042;15903;2831;0;4;42486479;41179232;25170829;86470;42362506;27400213;185105;0;144
FR;1;2022-03-08;1709;5256;17168;309;3667;15996;3472;0;3;42488188;41184488;25187997;86779;42366173;27416209;188577;0;147
FR;1;2022-03-09;1988;6676;19811;370;4752;19170;3421;0;4;42490176;41191164;25207808;87149;42370925;27435379;191998;0;151
FR;1;2022-03-10;1406;5005;15290;308;3656;14329;2943;0;2;42491582;41196169;25223098;87457;42374581;27449708;194941;0;153
FR;1;2022-03-11;1754;6406;21708;484;4439;19863;4734;0;1;42493336;41202575;25244806;87941;42379020;27469571;199675;0;154
FR;1;2022-03-12;1248;4653;15362;281;3096;14912;2685;0;2;42494584;41207228;25260168;88222;42382116;27484483;202360;0;156
FR;1;2022-03-13;255;612;2120;119;412;2066;468;0;0;42494839;41207840;25262288;88341;42382528;27486549;202828;0;156
FR;1;2022-03-14;1149;3677;13405;3880;2292;12527;6340;0;8;42495988;41211517;25275693;92221;42384820;27499076;209168;0;164
FR;1;2022-03-15;1407;5738;14657;6862;4321;13255;9842;0;8;42497395;41217255;25290350;99083;42389141;27512331;219010;0;172
FR;1;2022-03-16;1693;5081;17392;11519;3591;16457;14124;0;6;42499088;41222336;25307742;110602;42392732;27528788;233134;0;178
FR;1;2022-03-17;1171;3440;11731;9648;2364;10828;11730;0;8;42500259;41225776;25319473;120250;42395096;27539616;244864;0;186
FR;1;2022-03-18;1727;4928;17970;16506;3323;16409;19720;0;14;42501986;41230704;25337443;136756;42398419;27556025;264584;0;200
FR;1;2022-03-19;1126;3299;11889;8458;2275;11358;10140;0;6;42503112;41234003;25349332;145214;42400694;27567383;274724;0;206
FR;1;2022-03-20;224;559;1724;1014;361;1758;1224;0;2;42503336;41234562;25351056;146228;42401055;27569141;275948;0;208
FR;1;2022-03-21;1086;2764;11498;13461;1784;10847;15142;0;10;42504422;41237326;25362554;159689;42402839;27579988;291090;0;218
FR;1;2022-03-22;1241;3210;12258;18713;2151;11246;20616;0;5;42505663;41240536;25374812;178402;42404990;27591234;311706;0;223
FR;1;2022-03-23;1506;4357;16027;20112;2952;15711;21881;0;34;42507169;41244893;25390839;198514;42407942;27606945;333587;0;257
FR;1;2022-03-24;1116;2753;10398;16054;1910;9660;17558;0;15;42508285;41247646;25401237;214568;42409852;27616605;351145;0;272
FR;1;2022-03-25;1535;4360;16747;25303;2877;15399;27947;0;23;42509820;41252006;25417984;239871;42412729;27632004;379092;0;295
FR;1;2022-03-26;1108;3013;10856;11450;2062;10517;12862;0;20;42510928;41255019;25428840;251321;42414791;27642521;391954;0;315
FR;1;2022-03-27;233;546;1751;1382;333;1804;1593;0;1;42511161;41255565;25430591;252703;42415124;27644325;393547;0;316
FR;1;2022-03-28;1082;2485;9978;15884;1552;9601;17227;0;10;42512243;41258050;25440569;268587;42416676;27653926;410774;0;326
FR;1;2022-03-29;1142;2740;11556;25108;1590;10922;26504;0;30;42513385;41260790;25452125;293695;42418266;27664848;437278;0;356
FR;1;2022-03-30;1630;3596;14169;24215;2368;13701;25890;0;19;42515015;41264386;25466294;317910;42420634;27678549;463168;0;375
FR;1;2022-03-31;1278;3013;11697;22685;2038;11211;24005;0;40;42516293;41267399;25477991;340595;42422672;27689760;487173;0;415
FR;1;2022-04-01;2233;4021;18484;28531;2475;17354;30803;0;53;42518526;41271420;25496475;369126;42425147;27707114;517976;0;468
FR;1;2022-04-02;909;1889;8195;9238;1106;7954;10231;0;28;42519435;41273309;25504670;378364;42426253;27715068;528207;0;496
FR;1;2022-04-03;203;380;1433;1057;218;1434;1248;0;1;42519638;41273689;25506103;379421;42426471;27716502;529455;0;497
FR;1;2022-04-04;2296;2469;11371;17678;1548;10761;18899;0;30;42521934;41276158;25517474;397099;42428019;27727263;548354;0;527
FR;1;2022-04-05;2067;2707;13001;31217;1693;12025;32598;0;68;42524001;41278865;25530475;428316;42429712;27739288;580952;0;595
FR;1;2022-04-06;1807;3000;12204;23926;1907;11635;25228;0;62;42525808;41281865;25542679;452242;42431619;27750923;606180;0;657
FR;1;2022-04-07;1516;2737;12350;31073;1637;11814;32150;0;68;42527324;41284602;25555029;483315;42433256;27762737;638330;0;725
FR;1;2022-04-08;1745;3649;17558;40615;2039;16468;42683;0;76;42529069;41288251;25572587;523930;42435295;27779205;681013;0;801
FR;1;2022-04-09;820;1997;8404;12500;1074;8103;13500;0;26;42529889;41290248;25580991;536430;42436369;27787308;694513;0;827
FR;1;2022-04-10;200;643;1834;1853;407;1879;2074;0;6;42530089;41290891;25582825;538283;42436776;27789187;696587;0;833
FR;1;2022-04-11;1079;2257;10967;22345;1305;10684;23452;0;68;42531168;41293148;25593792;560628;42438081;27799871;720039;0;901
FR;1;2022-04-12;1327;2669;12820;38126;1582;12310;38877;0;119;42532495;41295817;25606612;598754;42439663;27812181;758916;0;1020
FR;1;2022-04-13;1274;2891;12270;30617;1786;12003;31387;0;85;42533769;41298708;25618882;629371;42441449;27824184;790303;0;1105
FR;1;2022-04-14;1228;2582;12115;33619;1586;12127;34057;0;88;42534997;41301290;25630997;662990;42443035;27836311;824360;0;1193
FR;1;2022-04-15;1496;3224;14400;33262;2045;13803;34662;0;107;42536493;41304514;25645397;696252;42445080;27850114;859022;0;1300
FR;1;2022-04-16;660;1405;5844;8002;763;5775;8757;0;31;42537153;41305919;25651241;704254;42445843;27855889;867779;0;1331
FR;1;2022-04-17;155;288;930;1121;175;975;1171;0;7;42537308;41306207;25652171;705375;42446018;27856864;868950;0;1338
FR;1;2022-04-18;165;479;2634;1002;296;2658;1186;0;5;42537473;41306686;25654805;706377;42446314;27859522;870136;0;1343
FR;1;2022-04-19;1252;2608;11784;27931;1494;11515;28786;0;69;42538725;41309294;25666589;734308;42447808;27871037;898922;0;1412
FR;1;2022-04-20;1348;2658;12176;26857;1660;12017;27693;0;82;42540073;41311952;25678765;761165;42449468;27883054;926615;0;1494
FR;1;2022-04-21;1241;2459;11547;33241;1509;11756;33600;0;107;42541314;41314411;25690312;794406;42450977;27894810;960215;0;1601
FR;1;2022-04-22;1514;3079;15213;35497;1911;14790;36696;0;120;42542828;41317490;25705525;829903;42452888;27909600;996911;0;1721
FR;1;2022-04-23;760;1581;6733;9892;916;6639;10576;0;30;42543588;41319071;25712258;839795;42453804;27916239;1007487;0;1751
FR;1;2022-04-24;196;373;1373;1521;237;1328;1744;0;7;42543784;41319444;25713631;841316;42454041;27917567;1009231;0;1758
FR;1;2022-04-25;1040;2130;9853;19731;1251;9755;20553;0;64;42544824;41321574;25723484;861047;42455292;27927322;1029784;0;1822
FR;1;2022-04-26;1348;2622;12601;36570;1603;12202;37156;0;163;42546172;41324196;25736085;897617;42456895;27939524;1066940;0;1985
FR;1;2022-04-27;1330;2405;10652;29223;1461;10787;29610;0;122;42547502;41326601;25746737;926840;42458356;27950311;1096550;0;2107
FR;1;2022-04-28;1283;2409;11561;34275;1516;11403;34424;0;127;42548785;41329010;25758298;961115;42459872;27961714;1130974;0;2234
FR;1;2022-04-29;1612;4271;14402;35551;3145;13855;36840;0;153;42550397;41333281;25772700;996666;42463017;27975569;1167814;0;2387
FR;1;2022-04-30;831;2236;6445;9174;1665;6288;9975;0;35;42551228;41335517;25779145;1005840;42464682;27981857;1177789;0;2422
FR;1;2022-05-01;177;288;830;948;190;824;1077;0;5;42551405;41335805;25779975;1006788;42464872;27982681;1178866;0;2427
FR;1;2022-05-02;1775;2600;10375;16946;1756;10299;17628;0;64;42553180;41338405;25790350;1023734;42466628;27992980;1196494;0;2491
FR;1;2022-05-03;1611;2870;12705;32893;1756;12597;33693;0;149;42554791;41341275;25803055;1056627;42468384;28005577;1230187;0;2640
FR;1;2022-05-04;1369;2740;11230;23807;1686;11391;24345;0;96;42556160;41344015;25814285;1080434;42470070;28016968;1254532;0;2736
FR;1;2022-05-05;1475;2679;12189;31843;1665;12113;32390;0;169;42557635;41346694;25826474;1112277;42471735;28029081;1286922;0;2905
FR;1;2022-05-06;1818;3232;14232;34917;1909;13815;36180;0;166;42559453;41349926;25840706;1147194;42473644;28042896;1323102;0;3071
FR;1;2022-05-07;856;1470;5976;9094;876;6010;9728;0;44;42560309;41351396;25846682;1156288;42474520;28048906;1332830;0;3115
FR;1;2022-05-08;190;329;1059;1471;222;1121;1547;0;8;42560499;41351725;25847741;1157759;42474742;28050027;1334377;0;3123
FR;1;2022-05-09;1141;2012;9247;19262;1152;9161;20035;0;93;42561640;41353737;25856988;1177021;42475894;28059188;1354412;0;3216
FR;1;2022-05-10;1487;2968;12619;37129;1877;12217;38028;0;177;42563127;41356705;25869607;1214150;42477771;28071405;1392440;0;3393
FR;1;2022-05-11;1435;2468;9909;26025;1687;9854;26547;0;140;42564562;41359173;25879516;1240175;42479458;28081259;1418987;0;3533
FR;1;2022-05-12;1318;2427;10517;33593;1519;10220;34234;0;188;42565880;41361600;25890033;1273768;42480977;28091479;1453221;0;3721
FR;1;2022-05-13;1610;2801;12765;35845;1679;12412;36940;0;149;42567490;41364401;25902798;1309613;42482656;28103891;1490161;0;3870
FR;1;2022-05-14;781;1320;5480;10214;806;5364;10729;0;51;42568271;41365721;25908278;1319827;42483462;28109255;1500890;0;3921
FR;1;2022-05-15;221;417;1182;1350;242;1252;1495;0;5;42568492;41366138;25909460;1321177;42483704;28110507;1502385;0;3926
FR;1;2022-05-16;970;1779;8071;20112;999;8126;20534;0;117;42569462;41367917;25917531;1341289;42484703;28118633;1522919;0;4043
FR;1;2022-05-17;1292;2293;11120;36182;1377;10726;36965;0;172;42570754;41370210;25928651;1377471;42486080;28129359;1559884;0;4215
FR;1;2022-05-18;1308;2132;9035;25718;1364;8986;26276;0;99;42572062;41372342;25937686;1403189;42487444;28138345;1586160;0;4314
FR;1;2022-05-19;1200;2395;9850;33990;1404;9945;34191;0;150;42573262;41374737;25947536;1437179;42488848;28148290;1620351;0;4464
FR;1;2022-05-20;1560;2751;12525;37650;1713;12109;38509;0;151;42574822;41377488;25960061;1474829;42490561;28160399;1658860;0;4615
FR;1;2022-05-21;774;1375;5246;9374;866;5164;9943;0;37;42575596;41378863;25965307;1484203;42491427;28165563;1668803;0;4652
FR;1;2022-05-22;191;292;951;1395;203;952;1517;0;10;42575787;41379155;25966258;1485598;42491630;28166515;1670320;0;4662
FR;1;2022-05-23;968;1883;8369;19409;1169;8345;20025;0;79;42576755;41381038;25974627;1505007;42492799;28174860;1690345;0;4741
FR;1;2022-05-24;1285;2447;10719;37243;1436;10587;37818;0;173;42578040;41383485;25985346;1542250;42494235;28185447;1728163;0;4914
FR;1;2022-05-25;1273;2296;8792;23688;1422;8955;24051;0;111;42579313;41385781;25994138;1565938;42495657;28194402;1752214;0;5025
FR;1;2022-05-26;169;377;1580;1154;254;1575;1283;0;27;42579482;41386158;25995718;1567092;42495911;28195977;1753497;0;5052
FR;1;2022-05-27;1114;2184;8783;20455;1368;8532;21407;0;84;42580596;41388342;26004501;1587547;42497279;28204509;1774904;0;5136
FR;1;2022-05-28;486;1051;3688;6539;619;3726;6927;0;37;42581082;41389393;26008189;1594086;42497898;28208235;1781831;0;5173
FR;1;2022-05-29;121;257;707;893;149;718;1002;0;4;42581203;41389650;26008896;1594979;42498047;28208953;1782833;0;5177
FR;1;2022-05-30;831;1732;6558;18535;1035;6590;18989;0;85;42582034;41391382;26015454;1613514;42499082;28215543;1801822;0;5262
FR;1;2022-05-31;1267;2220;9242;34368;1354;9112;34968;0;159;42583301;41393602;26024696;1647882;42500436;28224655;1836790;0;5421
FR;1;2022-06-01;1317;2597;10431;23451;1743;10292;24299;0;115;42584618;41396199;26035127;1671333;42502179;28234947;1861089;0;5536
FR;1;2022-06-02;1223;2304;10666;34140;1443;10244;34975;0;161;42585841;41398503;26045793;1705473;42503622;28245191;1896064;0;5697
FR;1;2022-06-03;1443;2733;12703;37101;1722;12124;38277;0;157;42587284;41401236;26058496;1742574;42505344;28257315;1934341;0;5854
FR;1;2022-06-04;681;1261;4746;8677;758;4822;9167;0;62;42587965;41402497;26063242;1751251;42506102;28262137;1943508;0;5916
FR;1;2022-06-05;131;292;810;1048;150;834;1153;0;3;42588096;41402789;26064052;1752299;42506252;28262971;1944661;0;5919
FR;1;2022-06-06;499;1143;2023;1250;968;2039;1424;0;9;42588595;41403932;26066075;1753549;42507220;28265010;1946085;0;5928
FR;1;2022-06-07;1168;2329;9179;34042;1423;8840;35140;0;143;42589763;41406261;26075254;1787591;42508643;28273850;1981225;0;6071
FR;1;2022-06-08;1116;2235;8669;27549;1400;8549;28422;0;107;42590879;41408496;26083923;1815140;42510043;28282399;2009647;0;6178
FR;1;2022-06-09;1066;2146;9986;37562;1279;9670;38329;0;148;42591945;41410642;26093909;1852702;42511322;28292069;2047976;0;6326
FR;1;2022-06-10;1335;2725;12402;43109;1687;11978;44352;0;201;42593280;41413367;26106311;1895811;42513009;28304047;2092328;0;6527
FR;1;2022-06-11;657;1450;5140;11083;796;5188;11613;0;50;42593937;41414817;26111451;1906894;42513805;28309235;2103941;0;6577
FR;1;2022-06-12;152;374;1015;1684;186;1072;1786;0;11;42594089;41415191;26112466;1908578;42513991;28310307;2105727;0;6588
FR;1;2022-06-13;914;1830;7014;22225;1124;6871;23066;0;84;42595003;41417021;26119480;1930803;42515115;28317178;2128793;0;6672
FR;1;2022-06-14;1090;2209;9839;42843;1289;9242;43935;0;186;42596093;41419230;26129319;1973646;42516404;28326420;2172728;0;6858
FR;1;2022-06-15;1076;1997;8782;29367;1350;8462;29922;0;168;42597169;41421227;26138101;2003013;42517754;28334882;2202650;0;7026
FR;1;2022-06-16;951;1831;9396;38496;1050;8876;39402;0;188;42598120;41423058;26147497;2041509;42518804;28343758;2242052;0;7214
FR;1;2022-06-17;1221;2554;11874;44793;1464;11356;45922;0;223;42599341;41425612;26159371;2086302;42520268;28355114;2287974;0;7437
FR;1;2022-06-18;561;1273;4316;10543;713;4255;11085;0;62;42599902;41426885;26163687;2096845;42520981;28359369;2299059;0;7499
FR;1;2022-06-19;137;325;1002;1543;173;1081;1609;0;12;42600039;41427210;26164689;2098388;42521154;28360450;2300668;0;7511
FR;1;2022-06-20;860;1699;8490;25040;997;8152;25904;0;143;42600899;41428909;26173179;2123428;42522151;28368602;2326572;0;7654
FR;1;2022-06-21;1102;2134;9763;47753;1249;8854;49100;0;241;42602001;41431043;26182942;2171181;42523400;28377456;2375672;0;7895
FR;1;2022-06-22;1037;2055;8434;37146;1284;7951;38009;0;231;42603038;41433098;26191376;2208327;42524684;28385407;2413681;0;8126
FR;1;2022-06-23;1051;2171;10122;52798;1201;9405;53807;0;290;42604089;41435269;26201498;2261125;42525885;28394812;2467488;0;8416
FR;1;2022-06-24;1249;2709;12913;65953;1475;11697;67624;0;367;42605338;41437978;26214411;2327078;42527360;28406509;2535112;0;8783
FR;1;2022-06-25;686;1503;5927;18917;791;5708;19716;0;162;42606024;41439481;26220338;2345995;42528151;28412217;2554828;0;8945
FR;1;2022-06-26;167;406;1818;3494;191;1713;3731;0;34;42606191;41439887;26222156;2349489;42528342;28413930;2558559;0;8979
FR;1;2022-06-27;940;1767;9905;45973;936;9129;47108;0;300;42607131;41441654;26232061;2395462;42529278;28423059;2605667;0;9279
FR;1;2022-06-28;1209;2570;13834;86550;1374;12398;88235;0;569;42608340;41444224;26245895;2482012;42530652;28435457;2693902;0;9848
FR;1;2022-06-29;1238;2288;11480;67386;1251;10546;68433;0;487;42609578;41446512;26257375;2549398;42531903;28446003;2762335;0;10335
FR;1;2022-06-30;1285;2462;13512;89960;1408;11820;91759;0;645;42610863;41448974;26270887;2639358;42533311;28457823;2854094;0;10980
FR;1;2022-07-01;1635;3470;20303;109187;1982;17963;111577;0;859;42612498;41452444;26291190;2748545;42535293;28475786;2965671;0;11839
FR;1;2022-07-02;767;1524;8020;33771;746;7250;34797;0;315;42613265;41453968;26299210;2782316;42536039;28483036;3000468;0;12154
FR;1;2022-07-03;227;480;1940;6117;254;1756;6444;0;70;42613492;41454448;26301150;2788433;42536293;28484792;3006912;0;12224
FR;1;2022-07-04;1391;2977;13920;75400;1858;12340;77292;0;589;42614883;41457425;26315070;2863833;42538151;28497132;3084204;0;12813
FR;1;2022-07-05;1424;2820;17683;126346;1474;15136;128461;0;1059;42616307;41460245;26332753;2990179;42539625;28512268;3212665;0;13872
FR;1;2022-07-06;1350;2387;14881;93713;1368;12901;95149;0;815;42617657;41462632;26347634;3083892;42540993;28525169;3307814;0;14687
FR;1;2022-07-07;1436;2533;16928;119480;1399;13998;121575;0;1075;42619093;41465165;26364562;3203372;42542392;28539167;3429389;0;15762
FR;1;2022-07-08;1528;2817;19604;129993;1531;15967;132800;0;1219;42620621;41467982;26384166;3333365;42543923;28555134;3562189;0;16981
FR;1;2022-07-09;661;1272;7302;36015;689;6345;36803;0;392;42621282;41469254;26391468;3369380;42544612;28561479;3598992;0;17373
FR;1;2022-07-10;237;516;2240;6688;270;2032;7067;0;89;42621519;41469770;26393708;3376068;42544882;28563511;3606059;0;17462
FR;1;2022-07-11;1213;2218;14313;84432;1155;11927;86548;0;734;42622732;41471988;26408021;3460500;42546037;28575438;3692607;0;18196
FR;1;2022-07-12;1557;2782;19451;137393;1417;15888;139879;0;1485;42624289;41474770;26427472;3597893;42547454;28591326;3832486;0;19681
FR;1;2022-07-13;1416;2421;14781;89823;1299;12632;91508;0;1002;42625705;41477191;26442253;3687716;42548753;28603958;3923994;0;20683
FR;1;2022-07-14;161;347;1862;5285;192;1771;5432;0;74;42625866;41477538;26444115;3693001;42548945;28605729;3929426;0;20757
FR;1;2022-07-15;1257;2297;14360;80583;1179;12002;82587;0;959;42627123;41479835;26458475;3773584;42550124;28617731;4012013;0;21716
FR;1;2022-07-16;505;1049;5638;23944;541;4892;24584;0;302;42627628;41480884;26464113;3797528;42550665;28622623;4036597;0;22018
FR;1;2022-07-17;158;363;1655;4461;188;1498;4724;0;60;42627786;41481247;26465768;3801989;42550853;28624121;4041321;0;22078
FR;1;2022-07-18;973;2028;11297;59269;1137;9567;60993;0;715;42628759;41483275;26477065;3861258;42551990;28633688;4102314;0;22793
FR;1;2022-07-19;1227;2121;14688;99397;1184;11721;101396;0;1386;42629986;41485396;26491753;3960655;42553174;28645409;4203710;0;24179
FR;1;2022-07-20;1176;1994;12360;74347;1162;10271;75833;0;964;42631162;41487390;26504113;4035002;42554336;28655680;4279543;0;25143
FR;1;2022-07-21;1133;1947;12407;84530;1179;9986;85892;0;1210;42632295;41489337;26516520;4119532;42555515;28665666;4365435;0;26353
FR;1;2022-07-22;1241;2206;14085;85927;1226;11416;87658;0;1264;42633536;41491543;26530605;4205459;42556741;28677082;4453093;0;27617
FR;1;2022-07-23;533;1084;5231;21294;624;4605;21837;0;374;42634069;41492627;26535836;4226753;42557365;28681687;4474930;0;27991
FR;1;2022-07-24;147;304;1325;3695;149;1165;3921;0;65;42634216;41492931;26537161;4230448;42557514;28682852;4478851;0;28056
FR;1;2022-07-25;887;1627;9070;46107;977;7517;47483;0;680;42635103;41494558;26546231;4276555;42558491;28690369;4526334;0;28736
FR;1;2022-07-26;1123;1957;12678;81944;1111;10334;83559;0;1197;42636226;41496515;26558909;4358499;42559602;28700703;4609893;0;29933
FR;1;2022-07-27;1015;1723;9757;58474;1036;8137;59655;0;874;42637241;41498238;26568666;4416973;42560638;28708840;4669548;0;30807
FR;1;2022-07-28;979;1701;9851;61891;1105;7843;63122;0;967;42638220;41499939;26578517;4478864;42561743;28716683;4732670;0;31774
FR;1;2022-07-29;1111;1817;10443;62931;1141;8371;64242;0;1066;42639331;41501756;26588960;4541795;42562884;28725054;4796912;0;32840
FR;1;2022-07-30;391;714;3345;14490;429;2847;14848;0;279;42639722;41502470;26592305;4556285;42563313;28727901;4811760;0;33119
FR;1;2022-07-31;138;263;900;2334;158;766;2476;0;47;42639860;41502733;26593205;4558619;42563471;28728667;4814236;0;33166
FR;1;2022-08-01;721;1346;7246;28961;964;6105;29953;0;518;42640581;41504079;26600451;4587580;42564435;28734772;4844189;0;33684
FR;1;2022-08-02;896;1468;8225;54020;980;6621;54669;0;1090;42641477;41505547;26608676;4641600;42565415;28741393;4898858;0;34774
FR;1;2022-08-03;720;1097;6143;37031;740;4926;37759;0;645;42642197;41506644;26614819;4678631;42566155;28746319;4936617;0;35419
FR;1;2022-08-04;642;1073;6255;41443;690;5047;41999;0;849;42642839;41507717;26621074;4720074;42566845;28751366;4978616;0;36268
FR;1;2022-08-05;738;1189;6757;43042;798;5419;43679;0;933;42643577;41508906;26627831;4763116;42567643;28756785;5022295;0;37201
FR;1;2022-08-06;274;461;1990;8998;301;1671;9190;0;216;42643851;41509367;26629821;4772114;42567944;28758456;5031485;0;37417
FR;1;2022-08-07;88;143;520;1552;99;436;1629;0;35;42643939;41509510;26630341;4773666;42568043;28758892;5033114;0;37452
FR;1;2022-08-08;491;907;3794;21215;663;3125;21621;0;457;42644430;41510417;26634135;4794881;42568706;28762017;5054735;0;37909
FR;1;2022-08-09;606;1025;5675;38451;717;4548;38945;0;793;42645036;41511442;26639810;4833332;42569423;28766565;5093680;0;38702
FR;1;2022-08-10;532;1010;4432;26912;710;3632;27226;0;601;42645568;41512452;26644242;4860244;42570133;28770197;5120906;0;39303
FR;1;2022-08-11;538;911;4303;28202;624;3577;28530;0;635;42646106;41513363;26648545;4888446;42570757;28773774;5149436;0;39938
FR;1;2022-08-12;589;1020;4548;27159;694;3756;27570;0;666;42646695;41514383;26653093;4915605;42571451;28777530;5177006;0;40604
FR;1;2022-08-13;176;352;1247;5106;245;1063;5277;0;116;42646871;41514735;26654340;4920711;42571696;28778593;5182283;0;40720
FR;1;2022-08-14;65;114;276;871;96;235;941;0;24;42646936;41514849;26654616;4921582;42571792;28778828;5183224;0;40744
FR;1;2022-08-15;77;165;570;540;134;531;591;0;16;42647013;41515014;26655186;4922122;42571926;28779359;5183815;0;40760
FR;1;2022-08-16;522;928;3783;21484;687;3212;21684;0;583;42647535;41515942;26658969;4943606;42572613;28782571;5205499;0;41343
FR;1;2022-08-17;525;888;3765;22145;657;3192;22386;0;579;42648060;41516830;26662734;4965751;42573270;28785763;5227885;0;41922
FR;1;2022-08-18;542;878;3925;25432;678;3127;25651;0;630;42648602;41517708;26666659;4991183;42573948;28788890;5253536;0;42552
FR;1;2022-08-19;533;1036;4361;26513;735;3594;26820;0;732;42649135;41518744;26671020;5017696;42574683;28792484;5280356;0;43284
FR;1;2022-08-20;231;409;1287;5369;309;1104;5523;0;137;42649366;41519153;26672307;5023065;42574992;28793588;5285879;0;43421
FR;1;2022-08-21;81;110;281;989;75;249;1010;0;27;42649447;41519263;26672588;5024054;42575067;28793837;5286889;0;43448
FR;1;2022-08-22;472;878;3140;14944;648;2710;15221;0;411;42649919;41520141;26675728;5038998;42575715;28796547;5302110;0;43859
FR;1;2022-08-23;636;1056;4148;28310;741;3482;28388;0;830;42650555;41521197;26679876;5067308;42576456;28800029;5330498;0;44689
FR;1;2022-08-24;556;828;3399;19059;648;2769;19243;0;587;42651111;41522025;26683275;5086367;42577104;28802798;5349741;0;45276
FR;1;2022-08-25;562;922;3820;22914;643;3203;23144;0;654;42651673;41522947;26687095;5109281;42577747;28806001;5372885;0;45930
FR;1;2022-08-26;745;1123;4345;25151;797;3561;25527;0;745;42652418;41524070;26691440;5134432;42578544;28809562;5398412;0;46675
FR;1;2022-08-27;216;428;1322;5303;272;1190;5357;0;192;42652634;41524498;26692762;5139735;42578816;28810752;5403769;0;46867
FR;1;2022-08-28;111;145;298;898;104;280;947;0;33;42652745;41524643;26693060;5140633;42578920;28811032;5404716;0;46900
FR;1;2022-08-29;502;854;2975;14225;631;2514;14545;0;408;42653247;41525497;26696035;5154858;42579551;28813546;5419261;0;47308
FR;1;2022-08-30;739;1093;4621;27709;771;3771;28030;0;793;42653986;41526590;26700656;5182567;42580322;28817317;5447291;0;48101
FR;1;2022-08-31;579;824;3103;17228;602;2613;17490;0;483;42654565;41527414;26703759;5199795;42580924;28819930;5464781;0;48584
FR;1;2022-09-01;673;910;4324;21858;638;3682;22120;0;586;42655238;41528324;26708083;5221653;42581562;28823612;5486901;0;49170
FR;1;2022-09-02;770;1042;4878;27862;736;4074;28149;0;882;42656008;41529366;26712961;5249515;42582298;28827686;5515050;0;50052
FR;1;2022-09-03;316;497;1831;5873;336;1592;6102;0;174;42656324;41529863;26714792;5255388;42582634;28829278;5521152;0;50226
FR;1;2022-09-04;106;136;341;842;73;334;912;0;21;42656430;41529999;26715133;5256230;42582707;28829612;5522064;0;50247
FR;1;2022-09-05;571;652;3010;15684;476;2515;15967;0;499;42657001;41530651;26718143;5271914;42583183;28832127;5538031;0;50746
FR;1;2022-09-06;718;926;4561;31052;574;3699;31275;0;1002;42657719;41531577;26722704;5302966;42583757;28835826;5569306;0;51748
FR;1;2022-09-07;537;682;2917;16441;442;2420;16578;0;550;42658256;41532259;26725621;5319407;42584199;28838246;5585884;0;52298
FR;1;2022-09-08;567;783;3691;24200;527;3033;24278;0;796;42658823;41533042;26729312;5343607;42584726;28841279;5610162;0;53094
FR;1;2022-09-09;768;964;4296;26880;603;3582;27063;0;902;42659591;41534006;26733608;5370487;42585329;28844861;5637225;0;53996
FR;1;2022-09-10;327;460;1671;5588;290;1472;5778;0;203;42659918;41534466;26735279;5376075;42585619;28846333;5643003;0;54199
FR;1;2022-09-11;105;118;310;645;80;291;701;0;17;42660023;41534584;26735589;5376720;42585699;28846624;5643704;0;54216
FR;1;2022-09-12;447;574;2607;12940;397;2226;13218;0;462;42660470;41535158;26738196;5389660;42586096;28848850;5656922;0;54678
FR;1;2022-09-13;577;788;3863;25828;493;3374;25705;0;835;42661047;41535946;26742059;5415488;42586589;28852224;5682627;0;55513
FR;1;2022-09-14;568;691;2862;15687;476;2392;15923;0;537;42661615;41536637;26744921;5431175;42587065;28854616;5698550;0;56050
FR;1;2022-09-15;508;705;3330;23042;476;2811;23131;0;676;42662123;41537342;26748251;5454217;42587541;28857427;5721681;0;56726
FR;1;2022-09-16;714;925;4010;25330;607;3378;25532;0;891;42662837;41538267;26752261;5479547;42588148;28860805;5747213;0;57617
FR;1;2022-09-17;292;403;1392;5977;273;1217;6085;0;227;42663129;41538670;26753653;5485524;42588421;28862022;5753298;0;57844
FR;1;2022-09-18;97;120;310;922;96;278;978;0;33;42663226;41538790;26753963;5486446;42588517;28862300;5754276;0;57877
FR;1;2022-09-19;365;559;2131;12843;360;1827;12996;0;414;42663591;41539349;26756094;5499289;42588877;28864127;5767272;0;58291
FR;1;2022-09-20;553;798;3656;25783;544;3055;25824;0;852;42664144;41540147;26759750;5525072;42589421;28867182;5793096;0;59143
FR;1;2022-09-21;469;678;2624;15861;478;2252;15826;0;561;42664613;41540825;26762374;5540933;42589899;28869434;5808922;0;59704
FR;1;2022-09-22;532;744;3281;22945;486;2676;23135;0;742;42665145;41541569;26765655;5563878;42590385;28872110;5832057;0;60446
FR;1;2022-09-23;756;926;4348;28132;657;3628;28300;0;978;42665901;41542495;26770003;5592010;42591042;28875738;5860357;0;61424
FR;1;2022-09-24;352;533;1583;6692;375;1365;6865;0;300;42666253;41543028;26771586;5598702;42591417;28877103;5867222;0;61724
FR;1;2022-09-25;80;149;321;1071;102;293;1109;0;32;42666333;41543177;26771907;5599773;42591519;28877396;5868331;0;61756
FR;1;2022-09-26;382;633;2176;13039;413;1928;13136;0;409;42666715;41543810;26774083;5612812;42591932;28879324;5881467;0;62165
FR;1;2022-09-27;540;754;3457;25017;530;2792;25214;0;906;42667255;41544564;26777540;5637829;42592462;28882116;5906681;0;63071
FR;1;2022-09-28;516;709;2439;14954;496;2206;15045;0;597;42667771;41545273;26779979;5652783;42592958;28884322;5921726;0;63668
FR;1;2022-09-29;502;686;2977;20344;477;2501;20357;0;767;42668273;41545959;26782956;5673127;42593435;28886823;5942083;0;64435
FR;1;2022-09-30;676;964;3772;24413;663;3155;24662;0;966;42668949;41546923;26786728;5697540;42594098;28889978;5966745;0;65401
FR;1;2022-10-01;340;540;1886;5501;375;1642;5729;0;272;42669289;41547463;26788614;5703041;42594473;28891620;5972474;0;65673
FR;1;2022-10-02;52;115;203;567;78;202;588;0;29;42669341;41547578;26788817;5703608;42594551;28891822;5973062;0;65702
FR;1;2022-10-03;410;662;2187;10010;504;1931;10194;0;488;42669751;41548240;26791004;5713618;42595055;28893753;5983256;0;66190
FR;1;2022-10-04;542;683;2917;18916;451;2465;19006;0;1082;42670293;41548923;26793921;5732534;42595506;28896218;6002262;0;67272
FR;1;2022-10-05;428;678;2078;11091;449;1852;11224;0;721;42670721;41549601;26795999;5743625;42595955;28898070;6013486;0;67993
FR;1;2022-10-06;439;603;2489;15769;426;2054;15952;0;1062;42671160;41550204;26798488;5759394;42596381;28900124;6029438;0;69055
FR;1;2022-10-07;545;735;2689;16055;534;2305;16080;0;1160;42671705;41550939;26801177;5775449;42596915;28902429;6045518;0;70215
FR;1;2022-10-08;234;304;886;3166;234;775;3270;0;291;42671939;41551243;26802063;5778615;42597149;28903204;6048788;0;70506
FR;1;2022-10-09;74;87;149;461;77;133;487;0;50;42672013;41551330;26802212;5779076;42597226;28903337;6049275;0;70556
FR;1;2022-10-10;295;436;1310;4984;343;1228;5079;0;462;42672308;41551766;26803522;5784060;42597569;28904565;6054354;0;71018
FR;1;2022-10-11;317;428;1307;8065;318;1179;8173;0;757;42672625;41552194;26804829;5792125;42597887;28905744;6062527;0;71775
FR;1;2022-10-12;321;416;1054;5172;309;1049;5185;0;520;42672946;41552610;26805883;5797297;42598196;28906793;6067712;0;72295
FR;1;2022-10-13;320;380;1063;6065;289;918;6115;0;625;42673266;41552990;26806946;5803362;42598485;28907711;6073827;0;72920
FR;1;2022-10-14;408;524;1167;6705;436;1040;6773;0;674;42673674;41553514;26808113;5810067;42598921;28908751;6080600;0;73594
FR;1;2022-10-15;200;257;514;1855;210;495;1865;0;225;42673874;41553771;26808627;5811922;42599131;28909246;6082465;0;73819
FR;1;2022-10-16;47;58;110;292;40;117;311;0;48;42673921;41553829;26808737;5812214;42599171;28909363;6082776;0;73867
FR;1;2022-10-17;235;317;732;2652;251;687;2695;0;366;42674156;41554146;26809469;5814866;42599422;28910050;6085471;0;74233
FR;1;2022-10-18;262;311;950;4584;245;828;4682;0;865;42674418;41554457;26810419;5819450;42599667;28910878;6090153;0;75098
FR;1;2022-10-19;275;358;687;3175;291;656;3156;0;502;42674693;41554815;26811106;5822625;42599958;28911534;6093309;0;75600
FR;1;2022-10-20;273;310;881;4357;257;768;4395;0;769;42674966;41555125;26811987;5826982;42600215;28912302;6097704;0;76369
FR;1;2022-10-21;298;398;843;3796;354;736;3869;0;674;42675264;41555523;26812830;5830778;42600569;28913038;6101573;0;77043
FR;1;2022-10-22;135;165;305;1242;143;298;1208;0;209;42675399;41555688;26813135;5832020;42600712;28913336;6102781;0;77252
FR;1;2022-10-23;30;37;64;197;35;58;213;0;25;42675429;41555725;26813199;5832217;42600747;28913394;6102994;0;77277
FR;1;2022-10-24;272;229;475;1593;201;471;1649;0;305;42675701;41555954;26813674;5833810;42600948;28913865;6104643;0;77582
FR;1;2022-10-25;213;251;520;2648;219;442;2702;0;488;42675914;41556205;26814194;5836458;42601167;28914307;6107345;0;78070
FR;1;2022-10-26;232;242;389;1950;226;366;1956;0;435;42676146;41556447;26814583;5838408;42601393;28914673;6109301;0;78505
FR;1;2022-10-27;258;217;483;2161;189;492;2144;0;509;42676404;41556664;26815066;5840569;42601582;28915165;6111445;0;79014
FR;1;2022-10-28;305;308;524;2320;289;462;2386;0;473;42676709;41556972;26815590;5842889;42601871;28915627;6113831;0;79487
FR;1;2022-10-29;95;148;174;711;116;208;702;0;201;42676804;41557120;26815764;5843600;42601987;28915835;6114533;0;79688
FR;1;2022-10-30;37;40;58;181;33;52;187;0;38;42676841;41557160;26815822;5843781;42602020;28915887;6114720;0;79726
FR;1;2022-10-31;133;180;293;796;158;270;863;0;144;42676974;41557340;26816115;5844577;42602178;28916157;6115583;0;79870
FR;1;2022-11-01;30;69;737;95;60;728;116;0;12;42677004;41557409;26816852;5844672;42602238;28916885;6115699;0;79882
FR;1;2022-11-02;249;219;516;962;217;483;1024;0;354;42677253;41557628;26817368;5845634;42602455;28917368;6116723;0;80236
FR;1;2022-11-03;264;221;423;1378;208;383;1416;0;383;42677517;41557849;26817791;5847012;42602663;28917751;6118139;0;80619
FR;1;2022-11-04;224;250;414;1594;229;393;1632;0;437;42677741;41558099;26818205;5848606;42602892;28918144;6119771;0;81056
FR;1;2022-11-05;93;118;268;500;106;250;522;0;111;42677834;41558217;26818473;5849106;42602998;28918394;6120293;0;81167
FR;1;2022-11-06;34;41;32;131;40;35;129;0;33;42677868;41558258;26818505;5849237;42603038;28918429;6120422;0;81200
FR;1;2022-11-07;179;199;283;893;188;274;958;0;221;42678047;41558457;26818788;5850130;42603226;28918703;6121380;0;81421
FR;1;2022-11-08;193;226;450;1677;214;396;1702;0;504;42678240;41558683;26819238;5851807;42603440;28919099;6123082;0;81925
FR;1;2022-11-09;180;203;327;1082;191;291;1122;0;454;42678420;41558886;26819565;5852889;42603631;28919390;6124204;0;82379
FR;1;2022-11-10;196;260;421;1673;248;430;1662;0;575;42678616;41559146;26819986;5854562;42603879;28919820;6125866;0;82954
FR;1;2022-11-11;21;32;98;98;31;84;114;0;42;42678637;41559178;26820084;5854660;42603910;28919904;6125980;0;82996
FR;1;2022-11-12;77;110;240;372;97;238;389;0;99;42678714;41559288;26820324;5855032;42604007;28920142;6126369;0;83095
FR;1;2022-11-13;19;23;20;62;20;24;63;0;26;42678733;41559311;26820344;5855094;42604027;28920166;6126432;0;83121
FR;1;2022-11-14;163;168;250;763;157;253;833;0;234;42678896;41559479;26820594;5855857;42604184;28920419;6127265;0;83355
FR;1;2022-11-15;196;214;364;1274;213;341;1316;0;404;42679092;41559693;26820958;5857131;42604397;28920760;6128581;0;83759
FR;1;2022-11-16;178;210;318;977;205;331;1012;0;356;42679270;41559903;26821276;5858108;42604602;28921091;6129593;0;84115
FR;1;2022-11-17;159;171;273;1187;168;245;1194;0;402;42679429;41560074;26821549;5859295;42604770;28921336;6130787;0;84517
FR;1;2022-11-18;222;244;377;1311;237;365;1344;0;411;42679651;41560318;26821926;5860606;42605007;28921701;6132131;0;84928
FR;1;2022-11-19;117;99;211;424;97;175;457;0;99;42679768;41560417;26822137;5861030;42605104;28921876;6132588;0;85027
FR;1;2022-11-20;19;30;24;64;25;26;72;0;28;42679787;41560447;26822161;5861094;42605129;28921902;6132660;0;85055
FR;1;2022-11-21;172;161;257;630;137;274;663;0;208;42679959;41560608;26822418;5861724;42605266;28922176;6133323;0;85263
FR;1;2022-11-22;148;141;364;1095;124;348;1121;0;353;42680107;41560749;26822782;5862819;42605390;28922524;6134444;0;85616
FR;1;2022-11-23;170;162;232;756;143;234;778;0;241;42680277;41560911;26823014;5863575;42605533;28922758;6135222;0;85857
FR;1;2022-11-24;129;158;275;1173;140;274;1183;0;428;42680406;41561069;26823289;5864748;42605673;28923032;6136405;0;86285
FR;1;2022-11-25;192;219;397;1142;206;385;1174;0;379;42680598;41561288;26823686;5865890;42605879;28923417;6137579;0;86664
FR;1;2022-11-26;86;102;95;307;92;108;292;0;114;42680684;41561390;26823781;5866197;42605971;28923525;6137871;0;86778
FR;1;2022-11-27;14;27;14;71;14;27;76;0;49;42680698;41561417;26823795;5866268;42605985;28923552;6137947;0;86827
FR;1;2022-11-28;195;129;192;598;137;183;635;0;269;42680893;41561546;26823987;5866866;42606122;28923735;6138582;0;87096
FR;1;2022-11-29;165;130;252;1066;114;237;1078;0;445;42681058;41561676;26824239;5867932;42606236;28923972;6139660;0;87541
FR;1;2022-11-30;151;175;214;925;163;215;946;0;316;42681209;41561851;26824453;5868857;42606399;28924187;6140606;0;87857
FR;1;2022-12-01;124;102;303;1031;93;268;1069;0;356;42681333;41561953;26824756;5869888;42606492;28924455;6141675;0;88213
FR;1;2022-12-02;185;164;262;1142;162;261;1175;0;447;42681518;41562117;26825018;5871030;42606654;28924716;6142850;0;88660
FR;1;2022-12-03;99;97;138;507;88;120;501;0;174;42681617;41562214;26825156;5871537;42606742;28924836;6143351;0;88834
FR;1;2022-12-04;23;21;18;136;18;19;127;0;58;42681640;41562235;26825174;5871673;42606760;28924855;6143478;0;88892
FR;1;2022-12-05;127;106;215;834;102;213;860;0;294;42681767;41562341;26825389;5872507;42606862;28925068;6144338;0;89186
FR;1;2022-12-06;138;132;225;1416;118;229;1425;0;703;42681905;41562473;26825614;5873923;42606980;28925297;6145763;0;89889
FR;1;2022-12-07;141;135;192;1152;142;173;1175;0;546;42682046;41562608;26825806;5875075;42607122;28925470;6146938;0;90435
FR;1;2022-12-08;119;120;235;1652;111;197;1693;0;742;42682165;41562728;26826041;5876727;42607233;28925667;6148631;0;91177
FR;1;2022-12-09;185;168;248;1751;148;252;1766;0;686;42682350;41562896;26826289;5878478;42607381;28925919;6150397;0;91863
FR;1;2022-12-10;102;80;114;822;74;96;837;0;283;42682452;41562976;26826403;5879300;42607455;28926015;6151234;0;92146
FR;1;2022-12-11;33;23;28;206;20;25;192;0;49;42682485;41562999;26826431;5879506;42607475;28926040;6151426;0;92195
FR;1;2022-12-12;106;74;149;1036;70;147;1031;0;428;42682591;41563073;26826580;5880542;42607545;28926187;6152457;0;92623
FR;1;2022-12-13;107;102;183;1177;78;165;1189;0;504;42682698;41563175;26826763;5881719;42607623;28926352;6153646;0;93127
FR;2;2020-12-27;0;0;0;0;0;0;0;0;0;0;0;0;0;0;0;0;0;0
FR;2;2020-12-28;0;0;0;0;0;0;0;0;0;0;0;0;0;0;0;0;0;0
FR;2;2020-12-29;0;0;0;0;0;0;0;0;0;0;0;0;0;0;0;0;0;0
FR;2;2020-12-30;0;0;0;0;0;0;0;0;0;0;0;0;0;0;0;0;0;0
FR;2;2020-12-31;0;0;0;0;0;0;0;0;0;0;0;0;0;0;0;0;0;0
FR;2;2021-01-01;0;0;0;0;0;0;0;0;0;0;0;0;0;0;0;0;0;0
FR;2;2021-01-02;0;0;0;0;0;0;0;0;0;0;0;0;0;0;0;0;0;0
FR;2;2021-01-03;0;0;0;0;0;0;0;0;0;0;0;0;0;0;0;0;0;0
FR;2;2021-01-04;0;0;0;0;0;0;0;0;0;0;0;0;0;0;0;0;0;0
FR;2;2021-01-05;0;0;0;0;0;0;0;0;0;0;0;0;0;0;0;0;0;0
FR;2;2021-01-06;0;0;0;0;0;0;0;0;0;0;0;0;0;0;0;0;0;0
FR;2;2021-01-07;0;0;0;0;0;0;0;0;0;0;0;0;0;0;0;0;0;0
FR;2;2021-01-08;0;0;0;0;0;0;0;0;0;0;0;0;0;0;0;0;0;0
FR;2;2021-01-09;0;0;0;0;0;0;0;0;0;0;0;0;0;0;0;0;0;0
FR;2;2021-01-10;0;0;0;0;0;0;0;0;0;0;0;0;0;0;0;0;0;0
FR;2;2021-01-11;0;0;0;0;0;0;0;0;0;0;0;0;0;0;0;0;0;0
FR;2;2021-01-12;0;0;0;0;0;0;0;0;0;0;0;0;0;0;0;0;0;0
FR;2;2021-01-13;0;0;0;0;0;0;0;0;0;0;0;0;0;0;0;0;0;0
FR;2;2021-01-14;1648;0;0;0;213;0;0;0;0;1648;0;0;0;213;0;0;0;0
FR;2;2021-01-15;398;0;0;0;28;0;0;0;0;2046;0;0;0;241;0;0;0;0
FR;2;2021-01-16;316;0;0;0;12;0;0;0;0;2362;0;0;0;253;0;0;0;0
FR;2;2021-01-17;84;0;0;0;7;0;0;0;0;2446;0;0;0;260;0;0;0;0
FR;2;2021-01-18;3075;2;0;0;27;0;0;0;0;5521;2;0;0;287;0;0;0;0
FR;2;2021-01-19;4681;2;0;0;31;0;0;0;0;10202;4;0;0;318;0;0;0;0
FR;2;2021-01-20;5137;6;0;0;58;0;0;0;0;15339;10;0;0;376;0;0;0;0
FR;2;2021-01-21;5345;9;0;0;56;0;0;0;0;20684;19;0;0;432;0;0;0;0
FR;2;2021-01-22;5118;17;0;0;69;0;0;0;0;25802;36;0;0;501;0;0;0;0
FR;2;2021-01-23;1874;2;0;0;16;0;0;0;0;27676;38;0;0;517;0;0;0;0
FR;2;2021-01-24;163;2;0;0;8;0;0;0;0;27839;40;0;0;525;0;0;0;0
FR;2;2021-01-25;3814;3;0;0;36;0;0;0;0;31653;43;0;0;561;0;0;0;0
FR;2;2021-01-26;3926;6;0;0;42;0;0;0;0;35579;49;0;0;603;0;0;0;0
FR;2;2021-01-27;3605;4;0;0;37;0;0;0;0;39184;53;0;0;640;0;0;0;0
FR;2;2021-01-28;3755;9;0;0;44;0;0;0;0;42939;62;0;0;684;0;0;0;0
FR;2;2021-01-29;3298;5;0;0;41;0;0;0;0;46237;67;0;0;725;0;0;0;0
FR;2;2021-01-30;1133;3;0;0;16;0;0;0;0;47370;70;0;0;741;0;0;0;0
FR;2;2021-01-31;46;2;0;0;9;0;0;0;0;47416;72;0;0;750;0;0;0;0
FR;2;2021-02-01;3406;11;0;0;44;0;0;0;0;50822;83;0;0;794;0;0;0;0
FR;2;2021-02-02;4495;19;0;0;53;0;0;0;0;55317;102;0;0;847;0;0;0;0
FR;2;2021-02-03;5222;11;0;0;82;0;0;0;0;60539;113;0;0;929;0;0;0;0
FR;2;2021-02-04;4940;11;0;0;36;0;0;0;0;65479;124;0;0;965;0;0;0;0
FR;2;2021-02-05;4816;16;0;0;49;0;0;0;0;70295;140;0;0;1014;0;0;0;0
FR;2;2021-02-06;2044;15;0;0;41;0;0;0;0;72339;155;0;0;1055;0;0;0;0
FR;2;2021-02-07;103;4;0;0;18;0;0;0;0;72442;159;0;0;1073;0;0;0;0
FR;2;2021-02-08;7558;26;0;0;85;0;0;0;0;80000;185;0;0;1158;0;0;0;0
FR;2;2021-02-09;8431;29;0;0;97;0;0;0;0;88431;214;0;0;1255;0;0;0;0
FR;2;2021-02-10;9346;62;0;0;182;0;0;0;0;97777;276;0;0;1437;0;0;0;0
FR;2;2021-02-11;10291;127;0;0;252;0;0;0;0;108068;403;0;0;1689;0;0;0;0
FR;2;2021-02-12;10060;273;0;0;428;0;0;0;0;118128;676;0;0;2117;0;0;0;0
FR;2;2021-02-13;3120;226;0;0;264;0;0;0;0;121248;902;0;0;2381;0;0;0;0
FR;2;2021-02-14;357;11;0;0;21;0;0;0;0;121605;913;0;0;2402;0;0;0;0
FR;2;2021-02-15;3460;3120;0;0;3166;0;0;0;0;125065;4033;0;0;5568;0;0;0;0
FR;2;2021-02-16;5075;4145;0;0;4218;0;0;0;0;130140;8178;0;0;9786;0;0;0;0
FR;2;2021-02-17;4259;4547;0;0;4623;0;0;0;0;134399;12725;0;0;14409;0;0;0;0
FR;2;2021-02-18;5404;5175;0;0;5243;0;0;0;0;139803;17900;0;0;19652;0;0;0;0
FR;2;2021-02-19;5328;4478;0;0;4580;0;0;0;0;145131;22378;0;0;24232;0;0;0;0
FR;2;2021-02-20;1872;1520;0;0;1534;0;0;0;0;147003;23898;0;0;25766;0;0;0;0
FR;2;2021-02-21;244;96;0;0;98;0;0;0;0;147247;23994;0;0;25864;0;0;0;0
FR;2;2021-02-22;3613;3776;0;0;3836;0;0;0;0;150860;27770;0;0;29700;0;0;0;0
FR;2;2021-02-23;4956;3729;0;0;3790;0;0;0;0;155816;31499;0;0;33490;0;0;0;0
FR;2;2021-02-24;5017;3549;0;0;3601;0;0;0;0;160833;35048;0;0;37091;0;0;0;0
FR;2;2021-02-25;5499;3487;0;0;3574;0;0;0;0;166332;38535;0;0;40665;0;0;0;0
FR;2;2021-02-26;4367;3177;0;0;3246;0;0;0;0;170699;41712;0;0;43911;0;0;0;0
FR;2;2021-02-27;1629;1066;0;0;1085;0;0;0;0;172328;42778;0;0;44996;0;0;0;0
FR;2;2021-02-28;179;17;0;0;28;0;0;0;0;172507;42795;0;0;45024;0;0;0;0
FR;2;2021-03-01;5192;3758;0;0;3846;0;0;0;0;177699;46553;0;0;48870;0;0;0;0
FR;2;2021-03-02;6540;4724;0;0;4824;0;0;0;0;184239;51277;0;0;53694;0;0;0;0
FR;2;2021-03-03;6543;4954;0;0;5093;0;0;0;0;190782;56231;0;0;58787;0;0;0;0
FR;2;2021-03-04;8409;4196;0;0;4380;0;0;0;0;199191;60427;0;0;63167;0;0;0;0
FR;2;2021-03-05;8037;4051;0;0;4231;0;0;0;0;207228;64478;0;0;67398;0;0;0;0
FR;2;2021-03-06;4790;1684;0;0;1784;0;0;0;0;212018;66162;0;0;69182;0;0;0;0
FR;2;2021-03-07;2373;32;0;0;76;0;0;0;0;214391;66194;0;0;69258;0;0;0;0
FR;2;2021-03-08;4166;8390;0;0;8545;0;0;0;0;218557;74584;0;0;77803;0;0;0;0
FR;2;2021-03-09;7492;8591;1;0;8845;0;0;0;0;226049;83175;1;0;86648;0;0;0;0
FR;2;2021-03-10;7107;9223;0;0;9448;0;0;0;0;233156;92398;1;0;96096;0;0;0;0
FR;2;2021-03-11;9377;9345;1;0;9662;0;0;0;0;242533;101743;2;0;105758;0;0;0;0
FR;2;2021-03-12;7984;8352;0;0;8652;0;0;0;0;250517;110095;2;0;114410;0;0;0;0
FR;2;2021-03-13;10056;2590;0;0;2911;0;0;0;0;260573;112685;2;0;117321;0;0;0;0
FR;2;2021-03-14;4841;383;0;0;542;0;0;0;0;265414;113068;2;0;117863;0;0;0;0
FR;2;2021-03-15;10915;3477;0;0;3766;0;0;0;0;276329;116545;2;0;121629;0;0;0;0
FR;2;2021-03-16;16769;4694;1;0;5241;0;0;0;0;293098;121239;3;0;126870;0;0;0;0
FR;2;2021-03-17;20241;4005;0;0;4679;0;0;0;0;313339;125244;3;0;131549;0;0;0;0
FR;2;2021-03-18;23370;5115;0;0;5941;0;0;0;0;336709;130359;3;0;137490;0;0;0;0
FR;2;2021-03-19;23312;4668;0;0;5427;0;0;0;0;360021;135027;3;0;142917;0;0;0;0
FR;2;2021-03-20;25451;1579;0;0;2335;0;0;0;0;385472;136606;3;0;145252;0;0;0;0
FR;2;2021-03-21;17672;152;0;0;730;0;0;0;0;403144;136758;3;0;145982;0;0;0;0
FR;2;2021-03-22;17789;3255;0;0;3923;0;0;0;0;420933;140013;3;0;149905;0;0;0;0
FR;2;2021-03-23;22702;4270;0;0;5120;0;0;0;0;443635;144283;3;0;155025;0;0;0;0
FR;2;2021-03-24;23961;5060;0;0;5896;0;0;0;0;467596;149343;3;0;160921;0;0;0;0
FR;2;2021-03-25;26758;5257;1;0;6453;0;0;0;0;494354;154600;4;0;167374;0;0;0;0
FR;2;2021-03-26;26989;4229;0;0;5375;0;0;0;0;521343;158829;4;0;172749;0;0;0;0
FR;2;2021-03-27;15921;1357;0;0;1886;0;0;0;0;537264;160186;4;0;174635;0;0;0;0
FR;2;2021-03-28;10562;125;0;0;417;0;0;0;0;547826;160311;4;0;175052;0;0;0;0
FR;2;2021-03-29;18997;4350;0;0;5051;0;0;0;0;566823;164661;4;0;180103;0;0;0;0
FR;2;2021-03-30;24593;6095;0;0;7033;0;0;0;0;591416;170756;4;0;187136;0;0;0;0
FR;2;2021-03-31;28560;5930;0;0;7221;0;0;0;0;619976;176686;4;0;194357;0;0;0;0
FR;2;2021-04-01;34556;8574;1;0;10266;0;0;0;0;654532;185260;5;0;204623;0;0;0;0
FR;2;2021-04-02;29989;7717;0;0;9144;0;0;0;0;684521;192977;5;0;213767;0;0;0;0
FR;2;2021-04-03;16955;4206;0;0;4888;0;0;0;0;701476;197183;5;0;218655;0;0;0;0
FR;2;2021-04-04;9308;1254;2;0;1662;0;0;0;0;710784;198437;7;0;220317;0;0;0;0
FR;2;2021-04-05;12445;798;0;0;1382;0;0;0;0;723229;199235;7;0;221699;0;0;0;0
FR;2;2021-04-06;27159;7309;0;0;8698;0;0;0;0;750388;206544;7;0;230397;0;0;0;0
FR;2;2021-04-07;30930;7072;1;0;8648;0;0;0;0;781318;213616;8;0;239045;0;0;0;0
FR;2;2021-04-08;36894;8579;1;0;10502;0;0;0;0;818212;222195;9;0;249547;0;0;0;0
FR;2;2021-04-09;33849;8399;28;0;10182;0;0;0;0;852061;230594;37;0;259729;0;0;0;0
FR;2;2021-04-10;19689;9251;1;0;10164;0;0;0;0;871750;239845;38;0;269893;0;0;0;0
FR;2;2021-04-11;7942;4240;1;0;4603;0;0;0;0;879692;244085;39;0;274496;0;0;0;0
FR;2;2021-04-12;17128;11014;0;0;11853;0;0;0;0;896820;255099;39;0;286349;0;0;0;0
FR;2;2021-04-13;19460;16037;1;0;17101;0;0;0;0;916280;271136;40;0;303450;0;0;0;0
FR;2;2021-04-14;18070;16432;7;0;17526;0;0;0;0;934350;287568;47;0;320976;0;0;0;0
FR;2;2021-04-15;22203;21750;27;0;23200;0;0;0;0;956553;309318;74;0;344176;0;0;0;0
FR;2;2021-04-16;20717;20564;45;0;21834;0;0;0;0;977270;329882;119;0;366010;0;0;0;0
FR;2;2021-04-17;13258;22488;5;0;23218;0;0;0;0;990528;352370;124;0;389228;0;0;0;0
FR;2;2021-04-18;5911;14394;6;0;14733;0;0;0;0;996439;366764;130;0;403961;0;0;0;0
FR;2;2021-04-19;16847;16380;24;0;17184;0;0;0;0;1013286;383144;154;0;421145;0;0;0;0
FR;2;2021-04-20;19324;21752;38;0;22812;0;0;0;0;1032610;404896;192;0;443957;0;0;0;0
FR;2;2021-04-21;20291;21834;76;0;22986;0;0;0;0;1052901;426730;268;0;466943;0;0;0;0
FR;2;2021-04-22;23821;24940;41;0;26348;0;0;0;0;1076722;451670;309;0;493291;0;0;0;0
FR;2;2021-04-23;24530;25478;76;0;26987;0;0;0;0;1101252;477148;385;0;520278;0;0;0;0
FR;2;2021-04-24;25304;15056;104;0;16494;0;0;0;0;1126556;492204;489;0;536772;0;0;0;0
FR;2;2021-04-25;9596;8615;5;0;9176;0;0;0;0;1136152;500819;494;0;545948;0;0;0;0
FR;2;2021-04-26;17165;17582;21;0;18467;0;0;0;0;1153317;518401;515;0;564415;0;0;0;0
FR;2;2021-04-27;19245;24115;40;0;25297;0;0;0;0;1172562;542516;555;0;589712;0;0;0;0
FR;2;2021-04-28;22341;26427;112;0;27827;0;0;0;0;1194903;568943;667;0;617539;0;0;0;0
FR;2;2021-04-29;25472;30414;70;0;32103;0;0;0;0;1220375;599357;737;0;649642;0;0;0;0
FR;2;2021-04-30;25537;27931;49;1;29576;0;0;0;0;1245912;627288;786;1;679218;0;0;0;0
FR;2;2021-05-01;14988;9849;6;0;10651;0;0;0;0;1260900;637137;792;1;689869;0;0;0;0
FR;2;2021-05-02;6640;9168;2;0;9512;0;0;0;0;1267540;646305;794;1;699381;0;0;0;0
FR;2;2021-05-03;20023;19149;40;0;20352;0;0;0;0;1287563;665454;834;1;719733;0;0;0;0
FR;2;2021-05-04;18286;29183;33;0;30326;0;0;0;0;1305849;694637;867;1;750059;0;0;0;0
FR;2;2021-05-05;18384;29477;48;0;30773;0;0;0;0;1324233;724114;915;1;780832;0;0;0;0
FR;2;2021-05-06;23548;35398;132;0;36971;0;0;0;0;1347781;759512;1047;1;817803;0;0;0;0
FR;2;2021-05-07;25337;33247;97;0;35102;0;0;0;0;1373118;792759;1144;1;852905;0;0;0;0
FR;2;2021-05-08;21342;10513;15;0;11602;0;0;0;0;1394460;803272;1159;1;864507;0;0;0;0
FR;2;2021-05-09;13168;7669;7;0;8343;0;0;0;0;1407628;810941;1166;1;872850;0;0;0;0
FR;2;2021-05-10;32944;21779;50;0;23637;0;0;0;0;1440572;832720;1216;1;896487;0;0;0;0
FR;2;2021-05-11;43611;20929;101;0;23555;0;0;0;0;1484183;853649;1317;1;920042;0;0;0;0
FR;2;2021-05-12;50060;19654;143;0;22530;0;0;0;0;1534243;873303;1460;1;942572;0;0;0;0
FR;2;2021-05-13;51297;5623;31;0;8492;0;0;0;0;1585540;878926;1491;1;951064;0;0;0;0
FR;2;2021-05-14;61356;12891;132;0;16543;0;0;0;0;1646896;891817;1623;1;967607;0;0;0;0
FR;2;2021-05-15;65936;7104;39;0;10654;0;0;0;0;1712832;898921;1662;1;978261;0;0;0;0
FR;2;2021-05-16;43588;2572;10;0;4942;0;0;0;0;1756420;901493;1672;1;983203;0;0;0;0
FR;2;2021-05-17;44753;12457;114;0;15362;0;0;0;0;1801173;913950;1786;1;998565;0;0;0;0
FR;2;2021-05-18;54646;12266;190;0;15945;0;0;0;0;1855819;926216;1976;1;1014510;0;0;0;0
FR;2;2021-05-19;57177;10490;281;0;14531;0;0;0;0;1912996;936706;2257;1;1029041;0;0;0;0
FR;2;2021-05-20;63444;10799;288;0;14898;0;0;0;0;1976440;947505;2545;1;1043939;0;0;0;0
FR;2;2021-05-21;64300;11605;230;0;16028;0;0;0;0;2040740;959110;2775;1;1059967;0;0;0;0
FR;2;2021-05-22;61488;4527;65;0;8498;0;0;0;0;2102228;963637;2840;1;1068465;0;0;0;0
FR;2;2021-05-23;37534;576;22;0;2913;0;0;0;0;2139762;964213;2862;1;1071378;0;0;0;0
FR;2;2021-05-24;17245;2048;35;0;3255;0;0;0;0;2157007;966261;2897;1;1074633;0;0;0;0
FR;2;2021-05-25;21117;12245;240;0;13848;0;0;0;0;2178124;978506;3137;1;1088481;0;0;0;0
FR;2;2021-05-26;19942;11523;230;0;13047;0;0;0;0;2198066;990029;3367;1;1101528;0;0;0;0
FR;2;2021-05-27;23000;12647;182;0;14385;0;0;0;0;2221066;1002676;3549;1;1115913;0;0;0;0
FR;2;2021-05-28;29394;15029;190;0;17211;0;0;0;0;2250460;1017705;3739;1;1133124;0;0;0;0
FR;2;2021-05-29;30422;8193;58;0;10102;0;0;0;0;2280882;1025898;3797;1;1143226;0;0;0;0
FR;2;2021-05-30;4647;1820;6;0;2155;0;0;0;0;2285529;1027718;3803;1;1145381;0;0;0;0
FR;2;2021-05-31;28590;18745;184;0;20824;0;0;0;0;2314119;1046463;3987;1;1166205;0;0;0;0
FR;2;2021-06-01;45734;19915;224;0;23156;0;0;0;0;2359853;1066378;4211;1;1189361;0;0;0;0
FR;2;2021-06-02;37476;19304;182;0;22309;0;0;0;0;2397329;1085682;4393;1;1211670;0;0;0;0
FR;2;2021-06-03;51279;23130;161;0;26983;0;0;0;0;2448608;1108812;4554;1;1238653;0;0;0;0
FR;2;2021-06-04;65515;24086;217;0;29055;0;0;0;0;2514123;1132898;4771;1;1267708;0;0;0;0
FR;2;2021-06-05;34602;24091;52;0;26944;0;0;0;0;2548725;1156989;4823;1;1294652;0;0;0;0
FR;2;2021-06-06;4956;6194;10;0;6612;0;0;0;0;2553681;1163183;4833;1;1301264;0;0;0;0
FR;2;2021-06-07;28176;23014;150;0;25427;0;0;0;0;2581857;1186197;4983;1;1326691;0;0;0;0
FR;2;2021-06-08;46377;22927;143;0;26888;0;0;0;0;2628234;1209124;5126;1;1353579;0;0;0;0
FR;2;2021-06-09;34295;20965;107;0;24097;0;0;0;0;2662529;1230089;5233;1;1377676;0;0;0;0
FR;2;2021-06-10;42643;19106;95;1;23028;0;0;0;0;2705172;1249195;5328;2;1400704;0;0;0;0
FR;2;2021-06-11;55301;25146;134;0;30245;0;0;0;0;2760473;1274341;5462;2;1430949;0;0;0;0
FR;2;2021-06-12;30561;19790;53;0;22644;0;0;0;0;2791034;1294131;5515;2;1453593;0;0;0;0
FR;2;2021-06-13;3331;9194;13;0;9582;0;0;0;0;2794365;1303325;5528;2;1463175;0;0;0;0
FR;2;2021-06-14;25303;24109;92;0;26692;0;0;0;0;2819668;1327434;5620;2;1489867;0;0;0;0
FR;2;2021-06-15;39047;22829;154;0;26580;0;0;0;0;2858715;1350263;5774;2;1516447;0;0;0;0
FR;2;2021-06-16;30164;21372;135;0;24527;0;0;0;0;2888879;1371635;5909;2;1540974;0;0;0;0
FR;2;2021-06-17;36912;25781;150;0;29643;0;0;0;0;2925791;1397416;6059;2;1570617;0;0;0;0
FR;2;2021-06-18;46859;28875;123;0;33576;0;0;0;0;2972650;1426291;6182;2;1604193;0;0;0;0
FR;2;2021-06-19;24526;24918;39;0;27690;0;0;0;0;2997176;1451209;6221;2;1631883;0;0;0;0
FR;2;2021-06-20;3745;10060;9;0;10558;0;0;0;0;3000921;1461269;6230;2;1642441;0;0;0;0
FR;2;2021-06-21;17532;42850;88;0;44858;0;0;0;0;3018453;1504119;6318;2;1687299;0;0;0;0
FR;2;2021-06-22;28361;49598;110;0;53025;0;0;0;0;3046814;1553717;6428;2;1740324;0;0;0;0
FR;2;2021-06-23;21790;49593;107;1;52440;1;0;0;0;3068604;1603310;6535;3;1792764;1;0;0;0
FR;2;2021-06-24;28378;50299;134;0;54036;0;0;0;0;3096982;1653609;6669;3;1846800;1;0;0;0
FR;2;2021-06-25;33401;60442;128;0;64831;0;0;0;0;3130383;1714051;6797;3;1911631;1;0;0;0
FR;2;2021-06-26;16391;59324;54;1;61714;0;0;0;0;3146774;1773375;6851;4;1973345;1;0;0;0
FR;2;2021-06-27;2566;29315;22;1;29895;0;0;0;0;3149340;1802690;6873;5;2003240;1;0;0;0
FR;2;2021-06-28;12640;54331;84;0;56305;0;0;0;0;3161980;1857021;6957;5;2059545;1;0;0;0
FR;2;2021-06-29;19857;59965;178;0;62913;0;0;0;0;3181837;1916986;7135;5;2122458;1;0;0;0
FR;2;2021-06-30;16331;57999;253;17;60689;0;0;0;0;3198168;1974985;7388;22;2183147;1;0;0;0
FR;2;2021-07-01;20493;59869;228;0;63198;0;0;0;0;3218661;2034854;7616;22;2246345;1;0;0;0
FR;2;2021-07-02;24080;62154;184;0;66370;0;0;0;0;3242741;2097008;7800;22;2312715;1;0;0;0
FR;2;2021-07-03;12120;57127;153;0;59463;0;0;0;0;3254861;2154135;7953;22;2372178;1;0;0;0
FR;2;2021-07-04;1960;23303;18;0;23870;0;0;0;0;3256821;2177438;7971;22;2396048;1;0;0;0
FR;2;2021-07-05;9177;29297;106;0;30934;0;0;0;0;3265998;2206735;8077;22;2426982;1;0;0;0
FR;2;2021-07-06;14583;36253;135;0;38934;0;0;0;0;3280581;2242988;8212;22;2465916;1;0;0;0
FR;2;2021-07-07;14416;33657;139;0;36415;0;0;0;0;3294997;2276645;8351;22;2502331;1;0;0;0
FR;2;2021-07-08;19722;40313;162;0;43975;0;0;0;0;3314719;2316958;8513;22;2546306;1;0;0;0
FR;2;2021-07-09;27103;54312;202;1;59465;0;0;0;0;3341822;2371270;8715;23;2605771;1;0;0;0
FR;2;2021-07-10;13387;33699;107;0;36389;0;0;0;0;3355209;2404969;8822;23;2642160;1;0;0;0
FR;2;2021-07-11;1810;4348;16;0;4777;0;0;0;0;3357019;2409317;8838;23;2646937;1;0;0;0
FR;2;2021-07-12;12971;37289;119;0;39947;0;0;0;0;3369990;2446606;8957;23;2686884;1;0;0;0
FR;2;2021-07-13;37115;53170;152;0;60310;0;0;0;0;3407105;2499776;9109;23;2747194;1;0;0;0
FR;2;2021-07-14;6627;3543;15;0;4891;0;0;0;0;3413732;2503319;9124;23;2752085;1;0;0;0
FR;2;2021-07-15;47243;47012;156;0;55213;0;0;0;0;3460975;2550331;9280;23;2807298;1;0;0;0
FR;2;2021-07-16;64317;55774;188;0;66756;0;0;0;0;3525292;2606105;9468;23;2874054;1;0;0;0
FR;2;2021-07-17;31600;23919;96;0;29375;0;0;0;0;3556892;2630024;9564;23;2903429;1;0;0;0
FR;2;2021-07-18;6090;4817;19;0;5965;0;0;0;0;3562982;2634841;9583;23;2909394;1;0;0;0
FR;2;2021-07-19;33004;28621;94;0;34235;0;0;0;0;3595986;2663462;9677;23;2943629;1;0;0;0
FR;2;2021-07-20;51998;44518;155;0;53161;0;0;0;0;3647984;2707980;9832;23;2996790;1;0;0;0
FR;2;2021-07-21;45256;34664;93;0;42173;0;0;0;0;3693240;2742644;9925;23;3038963;1;0;0;0
FR;2;2021-07-22;56279;41082;128;1;50371;0;0;0;0;3749519;2783726;10053;24;3089334;1;0;0;0
FR;2;2021-07-23;68301;48982;170;0;60273;0;0;0;0;3817820;2832708;10223;24;3149607;1;0;0;0
FR;2;2021-07-24;36179;21608;82;0;27469;0;0;0;0;3853999;2854316;10305;24;3177076;1;0;0;0
FR;2;2021-07-25;6751;2612;10;0;3872;0;0;0;0;3860750;2856928;10315;24;3180948;1;0;0;0
FR;2;2021-07-26;36319;22359;91;1;27868;0;0;0;0;3897069;2879287;10406;25;3208816;1;0;0;0
FR;2;2021-07-27;62390;34577;180;0;43726;0;0;0;0;3959459;2913864;10586;25;3252542;1;0;0;0
FR;2;2021-07-28;55321;26431;132;0;34530;0;0;0;0;4014780;2940295;10718;25;3287072;1;0;0;0
FR;2;2021-07-29;68479;32795;189;0;42483;0;0;0;0;4083259;2973090;10907;25;3329555;1;0;0;0
FR;2;2021-07-30;74464;37803;222;1;48601;0;0;0;0;4157723;3010893;11129;26;3378156;1;0;0;0
FR;2;2021-07-31;34772;16204;105;0;21405;0;0;0;0;4192495;3027097;11234;26;3399561;1;0;0;0
FR;2;2021-08-01;5414;2258;19;0;3122;0;0;0;0;4197909;3029355;11253;26;3402683;1;0;0;0
FR;2;2021-08-02;35887;16165;101;0;21065;0;0;0;0;4233796;3045520;11354;26;3423748;1;0;0;0
FR;2;2021-08-03;55986;28267;142;0;35476;0;0;0;0;4289782;3073787;11496;26;3459224;1;0;0;0
FR;2;2021-08-04;46637;20836;128;1;26954;0;0;0;0;4336419;3094623;11624;27;3486178;1;0;0;0
FR;2;2021-08-05;54637;31560;215;0;38752;0;0;0;0;4391056;3126183;11839;27;3524930;1;0;0;0
FR;2;2021-08-06;58096;42394;242;1;50236;0;0;0;0;4449152;3168577;12081;28;3575166;1;0;0;0
FR;2;2021-08-07;25149;17627;89;0;21323;0;0;0;0;4474301;3186204;12170;28;3596489;1;0;0;0
FR;2;2021-08-08;3838;3650;21;0;4308;0;0;0;0;4478139;3189854;12191;28;3600797;1;0;0;0
FR;2;2021-08-09;29308;21049;92;0;24878;0;0;0;0;4507447;3210903;12283;28;3625675;1;0;0;0
FR;2;2021-08-10;45010;33475;155;0;39244;0;0;0;0;4552457;3244378;12438;28;3664919;1;0;0;0
FR;2;2021-08-11;35275;25143;151;0;29749;0;0;0;0;4587732;3269521;12589;28;3694668;1;0;0;0
FR;2;2021-08-12;41904;35696;163;0;41240;0;0;0;0;4629636;3305217;12752;28;3735908;1;0;0;0
FR;2;2021-08-13;42606;37282;218;0;42977;0;0;0;0;4672242;3342499;12970;28;3778885;1;0;0;0
FR;2;2021-08-14;18524;22159;94;0;24797;0;0;0;0;4690766;3364658;13064;28;3803682;1;0;0;0
FR;2;2021-08-15;3860;3800;17;0;4388;0;0;0;0;4694626;3368458;13081;28;3808070;1;0;0;0
FR;2;2021-08-16;25093;27128;111;0;30455;0;0;0;0;4719719;3395586;13192;28;3838525;1;0;0;0
FR;2;2021-08-17;38261;43415;205;2;48407;0;0;0;0;4757980;3439001;13397;30;3886932;1;0;0;0
FR;2;2021-08-18;32254;36354;195;1;40707;1;0;0;0;4790234;3475355;13592;31;3927639;2;0;0;0
FR;2;2021-08-19;37434;46577;224;0;51787;0;0;0;0;4827668;3521932;13816;31;3979426;2;0;0;0
FR;2;2021-08-20;40568;55639;271;1;61579;0;0;0;0;4868236;3577571;14087;32;4041005;2;0;0;0
FR;2;2021-08-21;18121;24308;116;0;27100;0;0;0;0;4886357;3601879;14203;32;4068105;2;0;0;0
FR;2;2021-08-22;2907;4327;22;1;4860;1;0;0;0;4889264;3606206;14225;33;4072965;3;0;0;0
FR;2;2021-08-23;19248;35150;131;1;38048;0;0;0;0;4908512;3641356;14356;34;4111013;3;0;0;0
FR;2;2021-08-24;31951;56043;236;0;60704;0;0;0;0;4940463;3697399;14592;34;4171717;3;0;0;0
FR;2;2021-08-25;25934;43453;251;0;47411;0;0;0;0;4966397;3740852;14843;34;4219128;3;0;0;0
FR;2;2021-08-26;32362;55830;388;0;60599;0;0;0;0;4998759;3796682;15231;34;4279727;3;0;0;0
FR;2;2021-08-27;37003;65678;477;2;71425;0;0;0;0;5035762;3862360;15708;36;4351152;3;0;0;0
FR;2;2021-08-28;17819;28539;300;0;31609;0;0;0;0;5053581;3890899;16008;36;4382761;3;0;0;0
FR;2;2021-08-29;2656;5014;47;0;5628;0;0;0;0;5056237;3895913;16055;36;4388389;3;0;0;0
FR;2;2021-08-30;18416;37729;400;0;40152;757;0;0;0;5074653;3933642;16455;36;4428541;760;0;0;0
FR;2;2021-08-31;28076;57508;887;4;60948;1557;0;0;0;5102729;3991150;17342;40;4489489;2317;0;0;0
FR;2;2021-09-01;21594;39868;1309;0;42268;2120;0;0;0;5124323;4031018;18651;40;4531757;4437;0;0;0
FR;2;2021-09-02;25485;48661;1962;2;50956;3358;0;0;0;5149808;4079679;20613;42;4582713;7795;0;0;0
FR;2;2021-09-03;33412;64559;2988;3;67541;4879;1;0;0;5183220;4144238;23601;45;4650254;12674;1;0;0
FR;2;2021-09-04;16832;27758;1443;1;29561;2380;0;0;0;5200052;4171996;25044;46;4679815;15054;1;0;0
FR;2;2021-09-05;2264;3598;266;0;3956;412;0;0;0;5202316;4175594;25310;46;4683771;15466;1;0;0
FR;2;2021-09-06;14043;28705;1771;1;29772;2945;0;0;0;5216359;4204299;27081;47;4713543;18411;1;0;0
FR;2;2021-09-07;21108;41099;3021;13;42273;4928;0;0;0;5237467;4245398;30102;60;4755816;23339;1;0;0
FR;2;2021-09-08;17248;31918;2736;6;32746;4495;0;0;0;5254715;4277316;32838;66;4788562;27834;1;0;0
FR;2;2021-09-09;20981;40487;4437;3;41247;6836;0;0;0;5275696;4317803;37275;69;4829809;34670;1;0;0
FR;2;2021-09-10;28201;51290;5285;4;51894;8957;1;0;0;5303897;4369093;42560;73;4881703;43627;2;0;0
FR;2;2021-09-11;13654;22446;2405;5;23140;3977;0;0;0;5317551;4391539;44965;78;4904843;47604;2;0;0
FR;2;2021-09-12;1824;2773;292;0;2967;511;0;0;0;5319375;4394312;45257;78;4907810;48115;2;0;0
FR;2;2021-09-13;11659;21444;2473;4;21713;4043;0;0;0;5331034;4415756;47730;82;4929523;52158;2;0;0
FR;2;2021-09-14;18576;32740;5092;13;31708;9058;2;0;0;5349610;4448496;52822;95;4961231;61216;4;0;0
FR;2;2021-09-15;14914;28248;5169;3;26939;7759;9;0;0;5364524;4476744;57991;98;4988170;68975;13;0;0
FR;2;2021-09-16;16078;32786;6737;12;30179;10535;4;0;0;5380602;4509530;64728;110;5018349;79510;17;0;0
FR;2;2021-09-17;20915;47151;8781;10;42817;14613;6;0;0;5401517;4556681;73509;120;5061166;94123;23;0;0
FR;2;2021-09-18;9857;20963;3803;6;19596;6036;1;0;0;5411374;4577644;77312;126;5080762;100159;24;0;0
FR;2;2021-09-19;1166;2595;396;0;2537;632;0;0;0;5412540;4580239;77708;126;5083299;100791;24;0;0
FR;2;2021-09-20;7499;18713;3856;7;17030;6142;4;0;0;5420039;4598952;81564;133;5100329;106933;28;0;0
FR;2;2021-09-21;11215;29990;6495;5;26543;10745;3;0;0;5431254;4628942;88059;138;5126872;117678;31;0;0
FR;2;2021-09-22;9412;23538;5490;6;21195;8517;8;0;0;5440666;4652480;93549;144;5148067;126195;39;0;0
FR;2;2021-09-23;10730;28900;7881;10;24727;12650;11;0;0;5451396;4681380;101430;154;5172794;138845;50;0;0
FR;2;2021-09-24;15075;42933;10876;18;37277;17239;21;0;0;5466471;4724313;112306;172;5210071;156084;71;0;0
FR;2;2021-09-25;7258;18794;3965;9;17151;6117;3;0;0;5473729;4743107;116271;181;5227222;162201;74;0;0
FR;2;2021-09-26;1080;2551;495;0;2495;631;1;0;0;5474809;4745658;116766;181;5229717;162832;75;0;0
FR;2;2021-09-27;6313;16405;4287;8;14797;6535;2;0;0;5481122;4762063;121053;189;5244514;169367;77;0;0
FR;2;2021-09-28;9241;25562;7769;14;21714;12080;7;0;0;5490363;4787625;128822;203;5266228;181447;84;0;0
FR;2;2021-09-29;8081;20202;6067;25;17611;9259;8;0;0;5498444;4807827;134889;228;5283839;190706;92;0;0
FR;2;2021-09-30;9864;25834;9509;16;21633;14100;6;0;0;5508308;4833661;144398;244;5305472;204806;98;0;0
FR;2;2021-10-01;13978;35727;12919;25;30047;19316;10;0;0;5522286;4869388;157317;269;5335519;224122;108;0;0
FR;2;2021-10-02;6874;15935;4850;7;14232;7046;6;0;0;5529160;4885323;162167;276;5349751;231168;114;0;0
FR;2;2021-10-03;841;1914;492;1;1842;503;0;0;0;5530001;4887237;162659;277;5351593;231671;114;0;0
FR;2;2021-10-04;5825;13897;5515;5;12137;7849;6;0;0;5535826;4901134;168174;282;5363730;239520;120;0;0
FR;2;2021-10-05;9058;22560;11125;19;18527;15739;1;0;0;5544884;4923694;179299;301;5382257;255259;121;0;0
FR;2;2021-10-06;7783;17745;8243;11;15275;11089;4;0;0;5552667;4941439;187542;312;5397532;266348;125;0;0
FR;2;2021-10-07;9203;22203;12385;14;18008;16866;7;0;0;5561870;4963642;199927;326;5415540;283214;132;0;0
FR;2;2021-10-08;13431;32123;17349;28;26506;23604;12;0;0;5575301;4995765;217276;354;5442046;306818;144;0;0
FR;2;2021-10-09;6000;12841;6044;6;11377;7895;7;0;0;5581301;5008606;223320;360;5453423;314713;151;0;0
FR;2;2021-10-10;885;1599;436;2;1541;607;1;0;0;5582186;5010205;223756;362;5454964;315320;152;0;0
FR;2;2021-10-11;5607;11554;6455;17;9943;8829;3;0;0;5587793;5021759;230211;379;5464907;324149;155;0;0
FR;2;2021-10-12;8029;17792;12550;13;13930;16784;9;0;0;5595822;5039551;242761;392;5478837;340933;164;0;0
FR;2;2021-10-13;6944;14852;10256;12;11811;13644;7;0;0;5602766;5054403;253017;404;5490648;354577;171;0;0
FR;2;2021-10-14;8314;17938;14996;13;13562;19470;11;0;0;5611080;5072341;268013;417;5504210;374047;182;0;0
FR;2;2021-10-15;11855;26307;20903;26;19416;27977;4;0;0;5622935;5098648;288916;443;5523626;402024;186;0;0
FR;2;2021-10-16;5140;8740;1819;0;8173;3218;2;0;0;5628075;5107388;290735;443;5531799;405242;188;0;0
FR;2;2021-10-17;651;1152;184;0;1081;357;1;0;0;5628726;5108540;290919;443;5532880;405599;189;0;0
FR;2;2021-10-18;4562;7348;665;2;7248;1637;0;0;0;5633288;5115888;291584;445;5540128;407236;189;0;0
FR;2;2021-10-19;6238;9853;732;5;9658;2034;5;0;0;5639526;5125741;292316;450;5549786;409270;194;0;0
FR;2;2021-10-20;5170;8058;758;3;8176;1678;0;0;0;5644696;5133799;293074;453;5557962;410948;194;0;0
FR;2;2021-10-21;6090;9977;780;5;9838;2102;1;0;0;5650786;5143776;293854;458;5567800;413050;195;0;0
FR;2;2021-10-22;8452;14600;1148;4;14472;2892;2;0;0;5659238;5158376;295002;462;5582272;415942;197;0;0
FR;2;2021-10-23;3845;5993;587;0;6126;1236;3;0;0;5663083;5164369;295589;462;5588398;417178;200;0;0
FR;2;2021-10-24;494;886;101;0;903;205;0;0;0;5663577;5165255;295690;462;5589301;417383;200;0;0
FR;2;2021-10-25;3359;5349;307;1;5524;825;2;0;0;5666936;5170604;295997;463;5594825;418208;202;0;0
FR;2;2021-10-26;4176;7241;1132;4;7131;2021;5;0;0;5671112;5177845;297129;467;5601956;420229;207;0;0
FR;2;2021-10-27;3676;6596;1193;5;6453;1992;1;0;0;5674788;5184441;298322;472;5608409;422221;208;0;0
FR;2;2021-10-28;4598;7690;1735;3;7418;2748;1;0;0;5679386;5192131;300057;475;5615827;424969;209;0;0
FR;2;2021-10-29;5413;11084;2437;4;10698;3682;3;0;0;5684799;5203215;302494;479;5626525;428651;212;0;0
FR;2;2021-10-30;2749;4450;976;1;4454;1440;2;0;0;5687548;5207665;303470;480;5630979;430091;214;0;0
FR;2;2021-10-31;364;535;139;1;544;190;1;0;0;5687912;5208200;303609;481;5631523;430281;215;0;0
FR;2;2021-11-01;429;547;181;0;563;267;1;0;0;5688341;5208747;303790;481;5632086;430548;216;0;0
FR;2;2021-11-02;3293;6758;1183;0;6804;1763;5;0;0;5691634;5215505;304973;481;5638890;432311;221;0;0
FR;2;2021-11-03;3340;6230;1388;2;6317;1968;2;0;0;5694974;5221735;306361;483;5645207;434279;223;0;0
FR;2;2021-11-04;3986;7074;1768;4;7112;2495;3;0;0;5698960;5228809;308129;487;5652319;436774;226;0;0
FR;2;2021-11-05;5234;10503;2867;5;10212;3958;6;0;0;5704194;5239312;310996;492;5662531;440732;232;0;0
FR;2;2021-11-06;2596;4678;1403;0;4639;1817;2;0;0;5706790;5243990;312399;492;5667170;442549;234;0;0
FR;2;2021-11-07;506;867;221;0;873;292;2;0;0;5707296;5244857;312620;492;5668043;442841;236;0;0
FR;2;2021-11-08;2578;5345;1205;3;5264;1677;3;0;0;5709874;5250202;313825;495;5673307;444518;239;0;0
FR;2;2021-11-09;2749;6912;2402;5;6449;3180;2;0;0;5712623;5257114;316227;500;5679756;447698;241;0;0
FR;2;2021-11-10;2590;5672;5114;6;4770;6287;8;0;0;5715213;5262786;321341;506;5684526;453985;249;0;0
FR;2;2021-11-11;445;754;752;2;646;936;3;0;0;5715658;5263540;322093;508;5685172;454921;252;0;0
FR;2;2021-11-12;2953;8083;8980;8;6201;10922;9;0;0;5718611;5271623;331073;516;5691373;465843;261;0;0
FR;2;2021-11-13;1539;3375;3870;7;2723;4537;4;0;0;5720150;5274998;334943;523;5694096;470380;265;0;0
FR;2;2021-11-14;257;588;351;1;487;481;3;0;0;5720407;5275586;335294;524;5694583;470861;268;0;0
FR;2;2021-11-15;1622;3662;4447;8;2916;5329;16;0;0;5722029;5279248;339741;532;5697499;476190;284;0;0
FR;2;2021-11-16;2183;5887;8309;14;4164;10079;16;0;0;5724212;5285135;348050;546;5701663;486269;300;0;0
FR;2;2021-11-17;1741;4522;6632;8;3171;7849;5;0;0;5725953;5289657;354682;554;5704834;494118;305;0;0
FR;2;2021-11-18;2192;5932;9185;10;4028;11018;8;0;0;5728145;5295589;363867;564;5708862;505136;313;0;0
FR;2;2021-11-19;2700;7768;12978;19;4842;15483;12;0;0;5730845;5303357;376845;583;5713704;520619;325;0;0
FR;2;2021-11-20;1566;3334;5180;5;2354;6090;3;0;0;5732411;5306691;382025;588;5716058;526709;328;0;0
FR;2;2021-11-21;249;510;541;0;394;659;3;0;0;5732660;5307201;382566;588;5716452;527368;331;0;0
FR;2;2021-11-22;1278;2582;4481;5;1676;5402;9;0;0;5733938;5309783;387047;593;5718128;532770;340;0;0
FR;2;2021-11-23;1617;4279;8202;9;2542;9915;6;0;0;5735555;5314062;395249;602;5720670;542685;346;0;0
FR;2;2021-11-24;1421;3756;7481;14;2252;8734;9;0;0;5736976;5317818;402730;616;5722922;551419;355;0;0
FR;2;2021-11-25;1813;4869;11472;21;2685;13668;6;0;0;5738789;5322687;414202;637;5725607;565087;361;0;0
FR;2;2021-11-26;2541;7738;22672;31;3820;26083;14;0;0;5741330;5330425;436874;668;5729427;591170;375;0;0
FR;2;2021-11-27;1497;4147;12273;18;2133;14032;12;0;0;5742827;5334572;449147;686;5731560;605202;387;0;0
FR;2;2021-11-28;292;839;1973;3;481;2300;5;0;0;5743119;5335411;451120;689;5732041;607502;392;0;0
FR;2;2021-11-29;1447;4352;15095;23;2020;17257;25;0;0;5744566;5339763;466215;712;5734061;624759;417;0;0
FR;2;2021-11-30;1912;6662;26246;36;2648;30005;22;0;0;5746478;5346425;492461;748;5736709;654764;439;0;0
FR;2;2021-12-01;1916;6030;26205;31;2497;29517;20;0;0;5748394;5352455;518666;779;5739206;684281;459;0;0
FR;2;2021-12-02;1914;6790;37726;52;2128;41976;32;0;0;5750308;5359245;556392;831;5741334;726257;491;0;0
FR;2;2021-12-03;2556;10086;53630;111;3610;59379;30;0;0;5752864;5369331;610022;942;5744944;785636;521;0;0
FR;2;2021-12-04;1850;6289;37124;38;2195;40815;15;0;0;5754714;5375620;647146;980;5747139;826451;536;0;0
FR;2;2021-12-05;458;2248;14263;14;537;15990;7;0;0;5755172;5377868;661409;994;5747676;842441;543;0;0
FR;2;2021-12-06;2487;9862;77722;109;2712;84775;25;0;0;5757659;5387730;739131;1103;5750388;927216;568;0;0
FR;2;2021-12-07;3454;15304;122458;238;3760;133779;40;0;0;5761113;5403034;861589;1341;5754148;1060995;608;0;0
FR;2;2021-12-08;3725;15993;133211;330;3866;145401;54;0;0;5764838;5419027;994800;1671;5758014;1206396;662;0;0
FR;2;2021-12-09;4546;19639;170229;555;4188;185622;61;0;0;5769384;5438666;1165029;2226;5762202;1392018;723;0;0
FR;2;2021-12-10;4675;22824;188692;490;5030;206182;68;0;0;5774059;5461490;1353721;2716;5767232;1598200;791;0;0
FR;2;2021-12-11;3687;16622;132460;239;3679;144912;63;0;0;5777746;5478112;1486181;2955;5770911;1743112;854;0;0
FR;2;2021-12-12;1256;7125;59106;83;1026;65158;12;0;0;5779002;5485237;1545287;3038;5771937;1808270;866;0;0
FR;2;2021-12-13;5530;26819;220714;605;5239;243005;159;0;0;5784532;5512056;1766001;3643;5777176;2051275;1025;0;0
FR;2;2021-12-14;7018;37467;300792;908;6162;332246;187;0;0;5791550;5549523;2066793;4551;5783338;2383521;1212;0;0
FR;2;2021-12-15;6556;36235;285244;957;5881;315881;186;0;0;5798106;5585758;2352037;5508;5789219;2699402;1398;0;0
FR;2;2021-12-16;7763;37916;312162;980;6574;343787;182;0;0;5805869;5623674;2664199;6488;5795793;3043189;1580;0;0
FR;2;2021-12-17;8681;41204;327895;976;8040;360973;230;0;0;5814550;5664878;2992094;7464;5803833;3404162;1810;0;0
FR;2;2021-12-18;6514;26557;212357;448;4917;233672;119;0;0;5821064;5691435;3204451;7912;5808750;3637834;1929;0;0
FR;2;2021-12-19;2603;11417;90217;182;1665;100350;25;0;0;5823667;5702852;3294668;8094;5810415;3738184;1954;0;0
FR;2;2021-12-20;9546;33541;275239;706;6612;303386;208;0;0;5833213;5736393;3569907;8800;5817027;4041570;2162;0;0
FR;2;2021-12-21;11565;38316;309644;968;7396;341441;257;0;0;5844778;5774709;3879551;9768;5824423;4383011;2419;0;0
FR;2;2021-12-22;10459;32790;265123;952;6451;292482;316;0;1;5855237;5807499;4144674;10720;5830874;4675493;2735;0;1
FR;2;2021-12-23;9425;26657;199521;701;5898;221292;227;0;0;5864662;5834156;4344195;11421;5836772;4896785;2962;0;1
FR;2;2021-12-24;2783;7475;43860;140;2039;49559;78;0;0;5867445;5841631;4388055;11561;5838811;4946344;3040;0;1
FR;2;2021-12-25;201;680;2003;10;211;2484;15;0;0;5867646;5842311;4390058;11571;5839022;4948828;3055;0;1
FR;2;2021-12-26;1320;4213;25157;71;1052;28687;70;0;0;5868966;5846524;4415215;11642;5840074;4977515;3125;0;1
FR;2;2021-12-27;8077;29916;218424;659;6635;243351;295;0;0;5877043;5876440;4633639;12301;5846709;5220866;3420;0;1
FR;2;2021-12-28;9836;36306;272104;742;6998;302004;956;0;1;5886879;5912746;4905743;13043;5853707;5522870;4376;0;2
FR;2;2021-12-29;9497;32247;246140;765;6420;272694;1090;0;0;5896376;5944993;5151883;13808;5860127;5795564;5466;0;2
FR;2;2021-12-30;9462;28090;208835;663;5984;231457;1157;0;0;5905838;5973083;5360718;14471;5866111;6027021;6623;0;2
FR;2;2021-12-31;3011;8349;54990;176;2171;61237;393;0;0;5908849;5981432;5415708;14647;5868282;6088258;7016;0;2
FR;2;2022-01-01;231;687;2857;7;204;3350;29;0;0;5909080;5982119;5418565;14654;5868486;6091608;7045;0;2
FR;2;2022-01-02;1503;4852;29521;75;1167;33407;217;0;0;5910583;5986971;5448086;14729;5869653;6125015;7262;0;2
FR;2;2022-01-03;9602;35407;266537;806;8502;293914;1676;0;0;5920185;6022378;5714623;15535;5878155;6418929;8938;0;2
FR;2;2022-01-04;12854;45411;342100;1068;9978;377041;2458;0;1;5933039;6067789;6056723;16603;5888133;6795970;11396;0;3
FR;2;2022-01-05;11273;38640;294205;884;8637;323849;2155;0;2;5944312;6106429;6350928;17487;5896770;7119819;13551;0;5
FR;2;2022-01-06;13655;43488;331952;1298;9942;364750;2979;0;1;5957967;6149917;6682880;18785;5906712;7484569;16530;0;6
FR;2;2022-01-07;14226;47631;361109;1271;11248;396457;3159;0;0;5972193;6197548;7043989;20056;5917960;7881026;19689;0;6
FR;2;2022-01-08;7946;28145;201265;515;7209;221702;1529;0;2;5980139;6225693;7245254;20571;5925169;8102728;21218;0;8
FR;2;2022-01-09;2749;8963;62525;137;2076;69499;493;0;0;5982888;6234656;7307779;20708;5927245;8172227;21711;0;8
FR;2;2022-01-10;10099;31907;232491;858;8912;255060;2458;0;0;5992987;6266563;7540270;21566;5936157;8427287;24169;0;8
FR;2;2022-01-11;11468;36256;265931;1029;10071;290641;3380;0;1;6004455;6302819;7806201;22595;5946228;8717928;27549;0;9
FR;2;2022-01-12;8765;29804;206332;863;8724;226180;2799;0;5;6013220;6332623;8012533;23458;5954952;8944108;30348;0;14
FR;2;2022-01-13;9387;31334;224500;831;9043;244841;3462;0;4;6022607;6363957;8237033;24289;5963995;9188949;33810;0;18
FR;2;2022-01-14;9740;35599;254547;920;9854;277660;3982;0;1;6032347;6399556;8491580;25209;5973849;9466609;37792;0;19
FR;2;2022-01-15;5359;19454;140783;363;5328;153645;1928;0;0;6037706;6419010;8632363;25572;5979177;9620254;39720;0;19
FR;2;2022-01-16;1512;5468;35889;81;1621;39823;424;0;0;6039218;6424478;8668252;25653;5980798;9660077;40144;0;19
FR;2;2022-01-17;5546;19270;135416;601;6607;147257;2264;0;2;6044764;6443748;8803668;26254;5987405;9807334;42408;0;21
FR;2;2022-01-18;6423;21486;148636;647;7523;160460;3313;0;0;6051187;6465234;8952304;26901;5994928;9967794;45721;0;21
FR;2;2022-01-19;4397;16320;105108;551;6216;113704;2409;0;1;6055584;6481554;9057412;27452;6001144;10081498;48130;0;22
FR;2;2022-01-20;4872;17577;115299;603;7070;123691;3111;0;2;6060456;6499131;9172711;28055;6008214;10205189;51241;0;24
FR;2;2022-01-21;5198;20044;137353;679;7175;147771;3452;0;1;6065654;6519175;9310064;28734;6015389;10352960;54693;0;25
FR;2;2022-01-22;3034;10948;74261;260;3957;80326;1428;0;0;6068688;6530123;9384325;28994;6019346;10433286;56121;0;25
FR;2;2022-01-23;724;2713;15242;41;1057;16829;238;0;0;6069412;6532836;9399567;29035;6020403;10450115;56359;0;25
FR;2;2022-01-24;3290;12807;75081;431;5847;81026;1994;0;2;6072702;6545643;9474648;29466;6026250;10531141;58353;0;27
FR;2;2022-01-25;3574;14411;79629;496;6654;85455;2879;0;4;6076276;6560054;9554277;29962;6032904;10616596;61232;0;31
FR;2;2022-01-26;2515;10706;58979;363;5331;63034;1957;0;1;6078791;6570760;9613256;30325;6038235;10679630;63189;0;32
FR;2;2022-01-27;2683;11379;64179;388;5735;67961;2463;0;1;6081474;6582139;9677435;30713;6043970;10747591;65652;0;33
FR;2;2022-01-28;3551;18275;91724;429;8613;98915;3402;0;1;6085025;6600414;9769159;31142;6052583;10846506;69054;0;34
FR;2;2022-01-29;1893;9240;48853;164;4171;52928;1375;0;1;6086918;6609654;9818012;31306;6056754;10899434;70429;0;35
FR;2;2022-01-30;464;2209;9455;38;1051;10585;203;0;0;6087382;6611863;9827467;31344;6057805;10910019;70632;0;35
FR;2;2022-01-31;1890;9562;43833;209;4717;47330;1887;0;2;6089272;6621425;9871300;31553;6062522;10957349;72519;0;37
FR;2;2022-02-01;1915;10028;47031;279;4803;50087;2711;0;0;6091187;6631453;9918331;31832;6067325;11007436;75230;0;37
FR;2;2022-02-02;1614;8985;41120;250;4196;44153;2190;0;1;6092801;6640438;9959451;32082;6071521;11051589;77420;0;38
FR;2;2022-02-03;1727;8938;40526;205;4374;42916;2644;0;2;6094528;6649376;9999977;32287;6075895;11094505;80064;0;40
FR;2;2022-02-04;2151;15181;66647;299;7385;71330;3672;0;1;6096679;6664557;10066624;32586;6083280;11165835;83736;0;41
FR;2;2022-02-05;1360;8523;35946;132;4215;39226;1372;0;0;6098039;6673080;10102570;32718;6087495;11205061;85108;0;41
FR;2;2022-02-06;275;1762;6127;16;840;6898;217;0;0;6098314;6674842;10108697;32734;6088335;11211959;85325;0;41
FR;2;2022-02-07;1351;9555;37758;134;4538;41293;1889;0;2;6099665;6684397;10146455;32868;6092873;11253252;87214;0;43
FR;2;2022-02-08;1299;9832;40954;173;4644;43748;2741;0;1;6100964;6694229;10187409;33041;6097517;11297000;89955;0;44
FR;2;2022-02-09;1160;8840;37040;174;3804;40464;1901;0;2;6102124;6703069;10224449;33215;6101321;11337464;91856;0;46
FR;2;2022-02-10;1029;7999;33837;204;3604;36510;2051;0;1;6103153;6711068;10258286;33419;6104925;11373974;93907;0;47
FR;2;2022-02-11;1391;12085;53347;223;5281;57700;2888;0;0;6104544;6723153;10311633;33642;6110206;11431674;96795;0;47
FR;2;2022-02-12;754;6533;27987;86;2792;30806;1112;0;2;6105298;6729686;10339620;33728;6112998;11462480;97907;0;49
FR;2;2022-02-13;200;1340;4836;20;562;5577;141;0;0;6105498;6731026;10344456;33748;6113560;11468057;98048;0;49
FR;2;2022-02-14;835;6731;30273;91;2598;33232;1398;0;1;6106333;6737757;10374729;33839;6116158;11501289;99446;0;50
FR;2;2022-02-15;774;6472;28050;140;2800;29991;1967;0;2;6107107;6744229;10402779;33979;6118958;11531280;101413;0;52
FR;2;2022-02-16;657;5361;22067;123;2526;23632;1568;0;3;6107764;6749590;10424846;34102;6121484;11554912;102981;0;55
FR;2;2022-02-17;518;3783;14152;98;2128;14617;1406;0;2;6108282;6753373;10438998;34200;6123612;11569529;104387;0;57
FR;2;2022-02-18;723;5368;20442;134;3039;21129;1895;0;0;6109005;6758741;10459440;34334;6126651;11590658;106282;0;57
FR;2;2022-02-19;430;3061;10532;66;1699;11246;753;0;2;6109435;6761802;10469972;34400;6128350;11601904;107035;0;59
FR;2;2022-02-20;102;518;1463;3;314;1611;100;0;0;6109537;6762320;10471435;34403;6128664;11603515;107135;0;59
FR;2;2022-02-21;422;2685;9122;65;1568;9499;930;0;0;6109959;6765005;10480557;34468;6130232;11613014;108065;0;59
FR;2;2022-02-22;392;2567;8894;77;1621;8797;1180;0;0;6110351;6767572;10489451;34545;6131853;11621811;109245;0;59
FR;2;2022-02-23;432;2604;8992;82;1522;9268;1022;0;0;6110783;6770176;10498443;34627;6133375;11631079;110267;0;59
FR;2;2022-02-24;314;2036;6802;82;1250;6830;870;0;0;6111097;6772212;10505245;34709;6134625;11637909;111137;0;59
FR;2;2022-02-25;457;3207;11419;107;1977;11283;1559;0;3;6111554;6775419;10516664;34816;6136602;11649192;112696;0;62
FR;2;2022-02-26;297;1892;6036;49;1161;6343;587;0;1;6111851;6777311;10522700;34865;6137763;11655535;113283;0;63
FR;2;2022-02-27;76;313;907;5;214;950;98;0;0;6111927;6777624;10523607;34870;6137977;11656485;113381;0;63
FR;2;2022-02-28;330;1688;5524;53;1087;5531;732;0;0;6112257;6779312;10529131;34923;6139064;11662016;114113;0;63
FR;2;2022-03-01;279;1569;5483;46;952;5200;964;0;2;6112536;6780881;10534614;34969;6140016;11667216;115077;0;65
FR;2;2022-03-02;298;1445;5247;45;876;5091;815;0;1;6112834;6782326;10539861;35014;6140892;11672307;115892;0;66
FR;2;2022-03-03;226;1111;3708;42;720;3485;668;0;1;6113060;6783437;10543569;35056;6141612;11675792;116560;0;67
FR;2;2022-03-04;243;1468;4859;74;983;4506;949;0;1;6113303;6784905;10548428;35130;6142595;11680298;117509;0;68
FR;2;2022-03-05;174;906;2979;34;612;2723;561;0;0;6113477;6785811;10551407;35164;6143207;11683021;118070;0;68
FR;2;2022-03-06;42;183;280;5;105;320;52;0;0;6113519;6785994;10551687;35169;6143312;11683341;118122;0;68
FR;2;2022-03-07;156;659;1987;70;491;1777;472;0;0;6113675;6786653;10553674;35239;6143803;11685118;118594;0;68
FR;2;2022-03-08;144;670;2273;53;461;1907;620;0;0;6113819;6787323;10555947;35292;6144264;11687025;119214;0;68
FR;2;2022-03-09;154;708;2348;37;473;2050;615;0;0;6113973;6788031;10558295;35329;6144737;11689075;119829;0;68
FR;2;2022-03-10;123;603;1695;35;445;1470;456;0;1;6114096;6788634;10559990;35364;6145182;11690545;120285;0;69
FR;2;2022-03-11;172;756;2769;57;504;2368;737;0;1;6114268;6789390;10562759;35421;6145686;11692913;121022;0;70
FR;2;2022-03-12;149;484;1787;27;331;1556;450;0;0;6114417;6789874;10564546;35448;6146017;11694469;121472;0;70
FR;2;2022-03-13;25;75;203;30;45;204;69;0;0;6114442;6789949;10564749;35478;6146062;11694673;121541;0;70
FR;2;2022-03-14;128;470;1569;529;333;1299;950;0;0;6114570;6790419;10566318;36007;6146395;11695972;122491;0;70
FR;2;2022-03-15;138;441;1713;691;333;1333;1186;0;1;6114708;6790860;10568031;36698;6146728;11697305;123677;0;71
FR;2;2022-03-16;142;476;2013;1615;331;1593;2159;0;2;6114850;6791336;10570044;38313;6147059;11698898;125836;0;73
FR;2;2022-03-17;94;413;1408;1193;273;1144;1577;0;0;6114944;6791749;10571452;39506;6147332;11700042;127413;0;73
FR;2;2022-03-18;147;496;2024;1795;335;1667;2313;0;1;6115091;6792245;10573476;41301;6147667;11701709;129726;0;74
FR;2;2022-03-19;108;321;1210;941;219;1015;1259;0;0;6115199;6792566;10574686;42242;6147886;11702724;130985;0;74
FR;2;2022-03-20;13;77;191;59;39;168;115;0;0;6115212;6792643;10574877;42301;6147925;11702892;131100;0;74
FR;2;2022-03-21;97;307;1215;1484;180;1078;1761;0;1;6115309;6792950;10576092;43785;6148105;11703970;132861;0;75
FR;2;2022-03-22;118;390;1530;1830;244;1291;2218;0;0;6115427;6793340;10577622;45615;6148349;11705261;135079;0;75
FR;2;2022-03-23;139;361;1675;3032;232;1470;3374;0;6;6115566;6793701;10579297;48647;6148581;11706731;138453;0;81
FR;2;2022-03-24;117;293;1183;1547;186;1001;1813;0;8;6115683;6793994;10580480;50194;6148767;11707732;140266;0;89
FR;2;2022-03-25;119;361;1805;2451;238;1475;2837;0;8;6115802;6794355;10582285;52645;6149005;11709207;143103;0;97
FR;2;2022-03-26;79;247;1204;1222;138;952;1531;0;5;6115881;6794602;10583489;53867;6149143;11710159;144634;0;102
FR;2;2022-03-27;19;36;154;100;19;133;144;0;0;6115900;6794638;10583643;53967;6149162;11710292;144778;0;102
FR;2;2022-03-28;94;288;1138;1602;187;995;1834;0;6;6115994;6794926;10584781;55569;6149349;11711287;146612;0;108
FR;2;2022-03-29;108;258;1325;2467;167;1105;2760;0;4;6116102;6795184;10586106;58036;6149516;11712392;149372;0;112
FR;2;2022-03-30;91;312;1489;3185;163;1320;3422;0;2;6116193;6795496;10587595;61221;6149679;11713712;152794;0;114
FR;2;2022-03-31;104;284;1276;2332;172;1091;2616;0;3;6116297;6795780;10588871;63553;6149851;11714803;155410;0;117
FR;2;2022-04-01;123;324;1567;2349;164;1322;2667;0;7;6116420;6796104;10590438;65902;6150015;11716125;158077;0;124
FR;2;2022-04-02;81;161;845;891;83;737;1052;0;1;6116501;6796265;10591283;66793;6150098;11716862;159129;0;125
FR;2;2022-04-03;16;53;128;113;27;142;133;0;1;6116517;6796318;10591411;66906;6150125;11717004;159262;0;126
FR;2;2022-04-04;113;239;989;1447;141;798;1693;0;5;6116630;6796557;10592400;68353;6150266;11717802;160955;0;131
FR;2;2022-04-05;143;298;1316;2914;158;1145;3142;0;17;6116773;6796855;10593716;71267;6150424;11718947;164097;0;148
FR;2;2022-04-06;89;260;1306;2522;128;1130;2686;0;10;6116862;6797115;10595022;73789;6150552;11720077;166783;0;158
FR;2;2022-04-07;120;229;1301;2682;140;1041;2957;0;8;6116982;6797344;10596323;76471;6150692;11721118;169740;0;166
FR;2;2022-04-08;126;342;1634;3351;178;1327;3641;0;12;6117108;6797686;10597957;79822;6150870;11722445;173381;0;178
FR;2;2022-04-09;90;219;900;1046;144;732;1288;0;4;6117198;6797905;10598857;80868;6151014;11723177;174669;0;182
FR;2;2022-04-10;37;48;143;162;45;119;200;0;1;6117235;6797953;10599000;81030;6151059;11723296;174869;0;183
FR;2;2022-04-11;88;195;891;1560;121;781;1718;0;6;6117323;6798148;10599891;82590;6151180;11724077;176587;0;189
FR;2;2022-04-12;176;273;1183;2770;175;1062;2903;0;8;6117499;6798421;10601074;85360;6151355;11725139;179490;0;197
FR;2;2022-04-13;147;230;1125;2477;110;988;2671;0;11;6117646;6798651;10602199;87837;6151465;11726127;182161;0;208
FR;2;2022-04-14;115;226;1085;2677;113;919;2911;0;18;6117761;6798877;10603284;90514;6151578;11727046;185072;0;226
FR;2;2022-04-15;114;258;1216;2293;128;1073;2533;0;7;6117875;6799135;10604500;92807;6151706;11728119;187605;0;233
FR;2;2022-04-16;67;108;548;549;68;459;675;0;9;6117942;6799243;10605048;93356;6151774;11728578;188280;0;242
FR;2;2022-04-17;15;27;57;53;16;53;71;0;0;6117957;6799270;10605105;93409;6151790;11728631;188351;0;242
FR;2;2022-04-18;12;35;121;70;18;116;95;0;0;6117969;6799305;10605226;93479;6151808;11728747;188446;0;242
FR;2;2022-04-19;112;237;1120;1731;149;951;1915;0;9;6118081;6799542;10606346;95210;6151957;11729698;190361;0;251
FR;2;2022-04-20;95;241;1110;2172;125;934;2366;0;14;6118176;6799783;10607456;97382;6152082;11730632;192727;0;265
FR;2;2022-04-21;111;233;982;1911;125;837;2140;0;10;6118287;6800016;10608438;99293;6152207;11731469;194867;0;275
FR;2;2022-04-22;100;276;1242;2092;141;1023;2430;0;11;6118387;6800292;10609680;101385;6152348;11732492;197297;0;286
FR;2;2022-04-23;67;156;644;762;107;573;862;0;8;6118454;6800448;10610324;102147;6152455;11733065;198159;0;294
FR;2;2022-04-24;12;29;101;68;11;79;100;0;0;6118466;6800477;10610425;102215;6152466;11733144;198259;0;294
FR;2;2022-04-25;103;204;821;1315;104;711;1513;0;15;6118569;6800681;10611246;103530;6152570;11733855;199772;0;309
FR;2;2022-04-26;108;184;1041;2018;118;878;2216;0;18;6118677;6800865;10612287;105548;6152688;11734733;201988;0;327
FR;2;2022-04-27;98;179;860;1783;120;764;1805;0;7;6118775;6801044;10613147;107331;6152808;11735497;203793;0;334
FR;2;2022-04-28;93;214;950;1931;128;843;2087;0;12;6118868;6801258;10614097;109262;6152936;11736340;205880;0;346
FR;2;2022-04-29;81;280;1130;1696;131;1040;1874;0;11;6118949;6801538;10615227;110958;6153067;11737380;207754;0;357
FR;2;2022-04-30;66;126;471;539;79;430;627;0;9;6119015;6801664;10615698;111497;6153146;11737810;208381;0;366
FR;2;2022-05-01;23;24;84;49;20;85;61;0;1;6119038;6801688;10615782;111546;6153166;11737895;208442;0;367
FR;2;2022-05-02;115;232;762;1216;141;660;1374;0;5;6119153;6801920;10616544;112762;6153307;11738555;209816;0;372
FR;2;2022-05-03;152;233;999;1780;156;938;1894;0;14;6119305;6802153;10617543;114542;6153463;11739493;211710;0;386
FR;2;2022-05-04;90;226;924;1810;116;867;1821;0;13;6119395;6802379;10618467;116352;6153579;11740360;213531;0;399
FR;2;2022-05-05;127;197;853;1719;146;770;1836;0;9;6119522;6802576;10619320;118071;6153725;11741130;215367;0;408
FR;2;2022-05-06;133;246;1100;1855;139;1016;2052;0;16;6119655;6802822;10620420;119926;6153864;11742146;217419;0;424
FR;2;2022-05-07;40;99;470;504;61;406;593;0;4;6119695;6802921;10620890;120430;6153925;11742552;218012;0;428
FR;2;2022-05-08;48;54;107;70;41;102;100;0;0;6119743;6802975;10620997;120500;6153966;11742654;218112;0;428
FR;2;2022-05-09;101;174;654;986;103;604;1130;0;9;6119844;6803149;10621651;121486;6154069;11743258;219242;0;437
FR;2;2022-05-10;121;252;938;1840;155;893;1964;0;23;6119965;6803401;10622589;123326;6154224;11744151;221206;0;460
FR;2;2022-05-11;101;178;813;1873;116;792;1862;0;8;6120066;6803579;10623402;125199;6154340;11744943;223068;0;468
FR;2;2022-05-12;111;173;845;2095;115;803;2212;0;21;6120177;6803752;10624247;127294;6154455;11745746;225280;0;489
FR;2;2022-05-13;100;234;969;2096;120;900;2272;0;13;6120277;6803986;10625216;129390;6154575;11746646;227552;0;502
FR;2;2022-05-14;76;124;451;553;93;411;632;0;6;6120353;6804110;10625667;129943;6154668;11747057;228184;0;508
FR;2;2022-05-15;24;39;94;88;20;108;95;0;1;6120377;6804149;10625761;130031;6154688;11747165;228279;0;509
FR;2;2022-05-16;102;170;601;925;115;537;1037;0;11;6120479;6804319;10626362;130956;6154803;11747702;229316;0;520
FR;2;2022-05-17;95;184;690;1685;119;658;1737;0;8;6120574;6804503;10627052;132641;6154922;11748360;231053;0;528
FR;2;2022-05-18;80;181;642;1431;97;647;1486;0;10;6120654;6804684;10627694;134072;6155019;11749007;232539;0;538
FR;2;2022-05-19;73;161;708;1831;81;751;1816;0;12;6120727;6804845;10628402;135903;6155100;11749758;234355;0;550
FR;2;2022-05-20;107;180;874;1701;110;779;1849;0;17;6120834;6805025;10629276;137604;6155210;11750537;236204;0;567
FR;2;2022-05-21;48;96;397;517;71;338;581;0;8;6120882;6805121;10629673;138121;6155281;11750875;236785;0;575
FR;2;2022-05-22;8;23;69;37;18;57;56;0;0;6120890;6805144;10629742;138158;6155299;11750932;236841;0;575
FR;2;2022-05-23;86;133;498;932;100;469;968;0;7;6120976;6805277;10630240;139090;6155399;11751401;237809;0;582
FR;2;2022-05-24;87;164;627;1626;103;615;1680;0;17;6121063;6805441;10630867;140716;6155502;11752016;239489;0;599
FR;2;2022-05-25;72;145;539;1148;90;493;1259;0;5;6121135;6805586;10631406;141864;6155592;11752509;240748;0;604
FR;2;2022-05-26;11;31;77;43;13;85;54;0;1;6121146;6805617;10631483;141907;6155605;11752594;240802;0;605
FR;2;2022-05-27;44;124;456;818;68;438;893;0;9;6121190;6805741;10631939;142725;6155673;11753032;241695;0;614
FR;2;2022-05-28;28;60;221;244;29;221;266;0;1;6121218;6805801;10632160;142969;6155702;11753253;241961;0;615
FR;2;2022-05-29;13;34;43;25;22;51;28;0;0;6121231;6805835;10632203;142994;6155724;11753304;241989;0;615
FR;2;2022-05-30;65;109;424;755;60;409;806;0;6;6121296;6805944;10632627;143749;6155784;11753713;242795;0;621
FR;2;2022-05-31;76;135;564;1276;92;511;1302;0;12;6121372;6806079;10633191;145025;6155876;11754224;244097;0;633
FR;2;2022-06-01;59;158;562;1075;84;541;1170;0;6;6121431;6806237;10633753;146100;6155960;11754765;245267;0;639
FR;2;2022-06-02;92;178;625;1413;109;592;1519;0;12;6121523;6806415;10634378;147513;6156069;11755357;246786;0;651
FR;2;2022-06-03;71;155;668;1604;94;594;1693;0;19;6121594;6806570;10635046;149117;6156163;11755951;248479;0;670
FR;2;2022-06-04;69;93;283;433;66;269;475;0;11;6121663;6806663;10635329;149550;6156229;11756220;248954;0;681
FR;2;2022-06-05;12;17;63;57;16;47;74;0;1;6121675;6806680;10635392;149607;6156245;11756267;249028;0;682
FR;2;2022-06-06;11;39;92;75;28;92;80;0;3;6121686;6806719;10635484;149682;6156273;11756359;249108;0;685
FR;2;2022-06-07;99;222;667;1535;155;577;1661;0;10;6121785;6806941;10636151;151217;6156428;11756936;250769;0;695
FR;2;2022-06-08;70;118;475;1166;77;411;1261;0;5;6121855;6807059;10636626;152383;6156505;11757347;252030;0;700
FR;2;2022-06-09;93;166;613;1922;107;571;1927;0;18;6121948;6807225;10637239;154305;6156612;11757918;253957;0;718
FR;2;2022-06-10;91;167;650;1683;107;621;1774;0;23;6122039;6807392;10637889;155988;6156719;11758539;255731;0;741
FR;2;2022-06-11;43;84;287;529;41;258;583;0;5;6122082;6807476;10638176;156517;6156760;11758797;256314;0;746
FR;2;2022-06-12;18;38;58;78;27;60;78;0;0;6122100;6807514;10638234;156595;6156787;11758857;256392;0;746
FR;2;2022-06-13;39;119;393;952;63;378;1018;0;6;6122139;6807633;10638627;157547;6156850;11759235;257410;0;752
FR;2;2022-06-14;68;157;599;2087;101;537;2188;0;14;6122207;6807790;10639226;159634;6156951;11759772;259598;0;766
FR;2;2022-06-15;78;104;520;1503;84;444;1638;0;10;6122285;6807894;10639746;161137;6157035;11760216;261236;0;776
FR;2;2022-06-16;127;127;495;1411;122;422;1526;0;12;6122412;6808021;10640241;162548;6157157;11760638;262762;0;788
FR;2;2022-06-17;73;137;588;1817;87;515;1921;0;16;6122485;6808158;10640829;164365;6157244;11761153;264683;0;804
FR;2;2022-06-18;76;93;224;579;81;196;630;0;4;6122561;6808251;10641053;164944;6157325;11761349;265313;0;808
FR;2;2022-06-19;11;17;53;71;7;41;90;0;2;6122572;6808268;10641106;165015;6157332;11761390;265403;0;810
FR;2;2022-06-20;62;125;401;1027;71;392;1104;0;10;6122634;6808393;10641507;166042;6157403;11761782;266507;0;820
FR;2;2022-06-21;107;115;524;2124;104;453;2161;0;22;6122741;6808508;10642031;168166;6157507;11762235;268668;0;842
FR;2;2022-06-22;39;110;462;1889;57;415;1971;0;25;6122780;6808618;10642493;170055;6157564;11762650;270639;0;867
FR;2;2022-06-23;58;108;537;2282;67;452;2400;0;30;6122838;6808726;10643030;172337;6157631;11763102;273039;0;897
FR;2;2022-06-24;66;122;709;3198;67;571;3338;0;38;6122904;6808848;10643739;175535;6157698;11763673;276377;0;935
FR;2;2022-06-25;30;90;298;987;55;254;1040;0;13;6122934;6808938;10644037;176522;6157753;11763927;277417;0;948
FR;2;2022-06-26;30;27;131;194;29;97;236;0;5;6122964;6808965;10644168;176716;6157782;11764024;277653;0;953
FR;2;2022-06-27;79;137;582;2488;94;483;2621;0;39;6123043;6809102;10644750;179204;6157876;11764507;280274;0;992
FR;2;2022-06-28;109;140;812;4816;81;650;4893;0;54;6123152;6809242;10645562;184020;6157957;11765157;285167;0;1046
FR;2;2022-06-29;73;150;776;4433;80;637;4529;0;56;6123225;6809392;10646338;188453;6158037;11765794;289696;0;1102
FR;2;2022-06-30;72;133;832;5177;71;618;5397;0;79;6123297;6809525;10647170;193630;6158108;11766412;295093;0;1181
FR;2;2022-07-01;112;160;1150;6691;95;850;6943;0;92;6123409;6809685;10648320;200321;6158203;11767262;302036;0;1273
FR;2;2022-07-02;69;132;474;1976;82;392;2067;0;27;6123478;6809817;10648794;202297;6158285;11767654;304103;0;1300
FR;2;2022-07-03;23;30;146;334;21;130;357;0;8;6123501;6809847;10648940;202631;6158306;11767784;304460;0;1308
FR;2;2022-07-04;120;181;775;3785;109;612;3972;0;49;6123621;6810028;10649715;206416;6158415;11768396;308432;0;1357
FR;2;2022-07-05;118;186;1121;6818;119;828;6999;0;85;6123739;6810214;10650836;213234;6158534;11769224;315431;0;1442
FR;2;2022-07-06;92;150;951;5807;92;697;5933;0;84;6123831;6810364;10651787;219041;6158626;11769921;321364;0;1526
FR;2;2022-07-07;81;185;1020;6500;115;750;6732;0;101;6123912;6810549;10652807;225541;6158741;11770671;328096;0;1627
FR;2;2022-07-08;65;122;1095;7044;51;758;7235;0;123;6123977;6810671;10653902;232585;6158792;11771429;335331;0;1750
FR;2;2022-07-09;34;62;418;1869;31;299;1920;0;33;6124011;6810733;10654320;234454;6158823;11771728;337251;0;1783
FR;2;2022-07-10;6;17;96;315;8;82;327;0;5;6124017;6810750;10654416;234769;6158831;11771810;337578;0;1788
FR;2;2022-07-11;68;120;683;3825;75;540;3901;0;67;6124085;6810870;10655099;238594;6158906;11772350;341479;0;1855
FR;2;2022-07-12;102;180;1054;6517;107;809;6725;0;119;6124187;6811050;10656153;245111;6159013;11773159;348204;0;1974
FR;2;2022-07-13;64;126;879;4664;74;591;4830;0;78;6124251;6811176;10657032;249775;6159087;11773750;353034;0;2052
FR;2;2022-07-14;6;13;88;248;8;59;267;0;8;6124257;6811189;10657120;250023;6159095;11773809;353301;0;2060
FR;2;2022-07-15;61;129;739;3793;53;560;3959;0;75;6124318;6811318;10657859;253816;6159148;11774369;357260;0;2135
FR;2;2022-07-16;27;54;289;1029;30;242;1075;0;25;6124345;6811372;10658148;254845;6159178;11774611;358335;0;2160
FR;2;2022-07-17;5;12;77;201;6;66;207;0;6;6124350;6811384;10658225;255046;6159184;11774677;358542;0;2166
FR;2;2022-07-18;57;103;514;2509;61;384;2648;0;59;6124407;6811487;10658739;257555;6159245;11775061;361190;0;2225
FR;2;2022-07-19;66;133;770;4254;72;555;4443;0;72;6124473;6811620;10659509;261809;6159317;11775616;365633;0;2297
FR;2;2022-07-20;59;118;581;3179;68;431;3277;0;87;6124532;6811738;10660090;264988;6159385;11776047;368910;0;2384
FR;2;2022-07-21;60;110;671;3678;73;485;3795;0;105;6124592;6811848;10660761;268666;6159458;11776532;372705;0;2489
FR;2;2022-07-22;51;99;698;3548;48;506;3697;0;80;6124643;6811947;10661459;272214;6159506;11777038;376402;0;2569
FR;2;2022-07-23;39;97;290;1173;52;229;1226;0;37;6124682;6812044;10661749;273387;6159558;11777267;377628;0;2606
FR;2;2022-07-24;14;24;68;201;19;67;203;0;7;6124696;6812068;10661817;273588;6159577;11777334;377831;0;2613
FR;2;2022-07-25;50;71;405;1938;60;300;2000;0;56;6124746;6812139;10662222;275526;6159637;11777634;379831;0;2669
FR;2;2022-07-26;57;133;606;3423;66;477;3496;0;113;6124803;6812272;10662828;278949;6159703;11778111;383327;0;2782
FR;2;2022-07-27;42;81;457;2782;50;361;2801;0;89;6124845;6812353;10663285;281731;6159753;11778472;386128;0;2871
FR;2;2022-07-28;29;75;450;2484;36;357;2488;0;78;6124874;6812428;10663735;284215;6159789;11778829;388616;0;2949
FR;2;2022-07-29;68;88;535;2857;63;347;2978;0;72;6124942;6812516;10664270;287072;6159852;11779176;391594;0;3021
FR;2;2022-07-30;22;39;162;775;32;110;794;0;24;6124964;6812555;10664432;287847;6159884;11779286;392388;0;3045
FR;2;2022-07-31;6;13;27;104;12;21;110;0;2;6124970;6812568;10664459;287951;6159896;11779307;392498;0;3047
FR;2;2022-08-01;38;105;323;1261;73;260;1343;0;29;6125008;6812673;10664782;289212;6159969;11779567;393841;0;3076
FR;2;2022-08-02;49;75;325;2060;50;247;2096;0;78;6125057;6812748;10665107;291272;6160019;11779814;395937;0;3154
FR;2;2022-08-03;29;53;259;1611;25;187;1617;0;57;6125086;6812801;10665366;292883;6160044;11780001;397554;0;3211
FR;2;2022-08-04;40;65;306;1692;39;240;1701;0;66;6125126;6812866;10665672;294575;6160083;11780241;399255;0;3277
FR;2;2022-08-05;33;94;328;1880;67;236;1911;0;60;6125159;6812960;10666000;296455;6160150;11780477;401166;0;3337
FR;2;2022-08-06;22;41;106;365;29;82;372;0;10;6125181;6813001;10666106;296820;6160179;11780559;401538;0;3347
FR;2;2022-08-07;7;8;15;69;5;16;71;0;3;6125188;6813009;10666121;296889;6160184;11780575;401609;0;3350
FR;2;2022-08-08;19;35;218;877;22;146;915;0;33;6125207;6813044;10666339;297766;6160206;11780721;402524;0;3383
FR;2;2022-08-09;29;51;279;1475;40;238;1471;0;50;6125236;6813095;10666618;299241;6160246;11780959;403995;0;3433
FR;2;2022-08-10;15;21;213;1133;18;150;1154;0;46;6125251;6813116;10666831;300374;6160264;11781109;405149;0;3479
FR;2;2022-08-11;21;41;174;1038;26;117;1047;0;40;6125272;6813157;10667005;301412;6160290;11781226;406196;0;3519
FR;2;2022-08-12;36;49;184;1046;37;140;1069;0;35;6125308;6813206;10667189;302458;6160327;11781366;407265;0;3554
FR;2;2022-08-13;9;19;47;149;15;53;137;0;5;6125317;6813225;10667236;302607;6160342;11781419;407402;0;3559
FR;2;2022-08-14;1;2;12;52;1;11;54;0;1;6125318;6813227;10667248;302659;6160343;11781430;407456;0;3560
FR;2;2022-08-15;0;5;32;22;2;21;21;0;3;6125318;6813232;10667280;302681;6160345;11781451;407477;0;3563
FR;2;2022-08-16;27;32;144;681;33;120;678;0;33;6125345;6813264;10667424;303362;6160378;11781571;408155;0;3596
FR;2;2022-08-17;17;26;109;738;18;88;744;0;34;6125362;6813290;10667533;304100;6160396;11781659;408899;0;3630
FR;2;2022-08-18;14;28;159;835;12;106;851;0;42;6125376;6813318;10667692;304935;6160408;11781765;409750;0;3672
FR;2;2022-08-19;8;38;117;705;31;86;706;0;33;6125384;6813356;10667809;305640;6160439;11781851;410456;0;3705
FR;2;2022-08-20;6;26;61;197;16;52;201;0;8;6125390;6813382;10667870;305837;6160455;11781903;410657;0;3713
FR;2;2022-08-21;4;14;15;19;6;13;31;0;0;6125394;6813396;10667885;305856;6160461;11781916;410688;0;3713
FR;2;2022-08-22;11;24;116;395;16;73;451;0;13;6125405;6813420;10668001;306251;6160477;11781989;411139;0;3726
FR;2;2022-08-23;11;41;134;671;22;112;679;0;38;6125416;6813461;10668135;306922;6160499;11782101;411818;0;3764
FR;2;2022-08-24;11;28;87;466;21;80;472;0;18;6125427;6813489;10668222;307388;6160520;11782181;412290;0;3782
FR;2;2022-08-25;8;32;109;481;16;69;516;0;17;6125435;6813521;10668331;307869;6160536;11782250;412806;0;3799
FR;2;2022-08-26;15;46;117;720;36;91;713;0;32;6125450;6813567;10668448;308589;6160572;11782341;413519;0;3831
FR;2;2022-08-27;10;19;47;156;16;42;164;0;2;6125460;6813586;10668495;308745;6160588;11782383;413683;0;3833
FR;2;2022-08-28;1;5;5;15;1;7;16;0;1;6125461;6813591;10668500;308760;6160589;11782390;413699;0;3834
FR;2;2022-08-29;24;43;93;400;29;87;396;0;24;6125485;6813634;10668593;309160;6160618;11782477;414095;0;3858
FR;2;2022-08-30;31;54;154;791;34;119;798;0;29;6125516;6813688;10668747;309951;6160652;11782596;414893;0;3887
FR;2;2022-08-31;19;35;85;392;22;79;393;0;25;6125535;6813723;10668832;310343;6160674;11782675;415286;0;3912
FR;2;2022-09-01;19;42;139;600;24;122;609;0;36;6125554;6813765;10668971;310943;6160698;11782797;415895;0;3948
FR;2;2022-09-02;34;56;146;744;34;158;748;0;32;6125588;6813821;10669117;311687;6160732;11782955;416643;0;3980
FR;2;2022-09-03;17;20;83;205;11;67;213;0;7;6125605;6813841;10669200;311892;6160743;11783022;416856;0;3987
FR;2;2022-09-04;8;5;9;31;2;10;30;0;3;6125613;6813846;10669209;311923;6160745;11783032;416886;0;3990
FR;2;2022-09-05;29;29;125;367;23;96;396;0;24;6125642;6813875;10669334;312290;6160768;11783128;417282;0;4014
FR;2;2022-09-06;43;62;158;761;42;153;767;0;36;6125685;6813937;10669492;313051;6160810;11783281;418049;0;4050
FR;2;2022-09-07;21;20;74;375;16;49;387;0;22;6125706;6813957;10669566;313426;6160826;11783330;418436;0;4072
FR;2;2022-09-08;31;57;109;636;40;100;646;0;22;6125737;6814014;10669675;314062;6160866;11783430;419082;0;4094
FR;2;2022-09-09;18;24;126;752;21;74;745;0;46;6125755;6814038;10669801;314814;6160887;11783504;419827;0;4140
FR;2;2022-09-10;14;24;57;117;16;48;131;0;4;6125769;6814062;10669858;314931;6160903;11783552;419958;0;4144
FR;2;2022-09-11;11;5;10;11;2;12;13;0;0;6125780;6814067;10669868;314942;6160905;11783564;419971;0;4144
FR;2;2022-09-12;20;30;69;340;25;55;352;0;16;6125800;6814097;10669937;315282;6160930;11783619;420323;0;4160
FR;2;2022-09-13;15;34;125;670;13;99;674;0;40;6125815;6814131;10670062;315952;6160943;11783718;420997;0;4200
FR;2;2022-09-14;19;21;81;480;19;59;478;0;36;6125834;6814152;10670143;316432;6160962;11783777;421475;0;4236
FR;2;2022-09-15;22;43;126;486;25;102;493;0;47;6125856;6814195;10670269;316918;6160987;11783879;421968;0;4283
FR;2;2022-09-16;21;31;124;563;17;89;585;0;39;6125877;6814226;10670393;317481;6161004;11783968;422553;0;4322
FR;2;2022-09-17;6;20;56;160;15;52;147;0;13;6125883;6814246;10670449;317641;6161019;11784020;422700;0;4335
FR;2;2022-09-18;4;7;13;37;6;10;37;0;3;6125887;6814253;10670462;317678;6161025;11784030;422737;0;4338
FR;2;2022-09-19;26;24;114;353;16;87;381;0;22;6125913;6814277;10670576;318031;6161041;11784117;423118;0;4360
FR;2;2022-09-20;27;27;117;624;21;84;639;0;38;6125940;6814304;10670693;318655;6161062;11784201;423757;0;4398
FR;2;2022-09-21;15;30;100;393;15;78;418;0;22;6125955;6814334;10670793;319048;6161077;11784279;424175;0;4420
FR;2;2022-09-22;16;39;124;581;18;95;619;0;28;6125971;6814373;10670917;319629;6161095;11784374;424794;0;4448
FR;2;2022-09-23;21;38;135;555;22;111;570;0;39;6125992;6814411;10671052;320184;6161117;11784485;425364;0;4487
FR;2;2022-09-24;10;8;51;190;6;36;201;0;6;6126002;6814419;10671103;320374;6161123;11784521;425565;0;4493
FR;2;2022-09-25;9;11;14;29;11;11;33;0;5;6126011;6814430;10671117;320403;6161134;11784532;425598;0;4498
FR;2;2022-09-26;22;41;106;447;27;79;458;0;20;6126033;6814471;10671223;320850;6161161;11784611;426056;0;4518
FR;2;2022-09-27;30;46;161;906;35;108;861;0;52;6126063;6814517;10671384;321756;6161196;11784719;426917;0;4570
FR;2;2022-09-28;15;31;93;421;18;74;439;0;23;6126078;6814548;10671477;322177;6161214;11784793;427356;0;4593
FR;2;2022-09-29;26;48;114;618;23;110;630;0;33;6126104;6814596;10671591;322795;6161237;11784903;427986;0;4626
FR;2;2022-09-30;24;44;111;520;43;84;533;0;31;6126128;6814640;10671702;323315;6161280;11784987;428519;0;4657
FR;2;2022-10-01;11;20;51;128;20;36;129;0;8;6126139;6814660;10671753;323443;6161300;11785023;428648;0;4665
FR;2;2022-10-02;0;5;8;21;4;5;25;0;2;6126139;6814665;10671761;323464;6161304;11785028;428673;0;4667
FR;2;2022-10-03;22;30;83;291;26;66;306;0;22;6126161;6814695;10671844;323755;6161330;11785094;428979;0;4689
FR;2;2022-10-04;17;21;105;601;19;71;620;0;45;6126178;6814716;10671949;324356;6161349;11785165;429599;0;4734
FR;2;2022-10-05;20;29;75;491;24;67;488;0;54;6126198;6814745;10672024;324847;6161373;11785232;430087;0;4788
FR;2;2022-10-06;30;23;74;442;17;71;428;0;65;6126228;6814768;10672098;325289;6161390;11785303;430515;0;4853
FR;2;2022-10-07;21;30;86;499;26;66;503;0;42;6126249;6814798;10672184;325788;6161416;11785369;431018;0;4895
FR;2;2022-10-08;12;8;23;114;3;24;108;0;12;6126261;6814806;10672207;325902;6161419;11785393;431126;0;4907
FR;2;2022-10-09;1;8;15;17;6;11;22;0;5;6126262;6814814;10672222;325919;6161425;11785404;431148;0;4912
FR;2;2022-10-10;18;24;47;223;22;49;218;0;21;6126280;6814838;10672269;326142;6161447;11785453;431366;0;4933
FR;2;2022-10-11;15;14;47;253;11;38;240;0;52;6126295;6814852;10672316;326395;6161458;11785491;431606;0;4985
FR;2;2022-10-12;8;17;52;290;13;36;305;0;56;6126303;6814869;10672368;326685;6161471;11785527;431911;0;5041
FR;2;2022-10-13;11;14;48;271;9;48;262;0;25;6126314;6814883;10672416;326956;6161480;11785575;432173;0;5066
FR;2;2022-10-14;11;28;35;229;17;39;229;0;29;6126325;6814911;10672451;327185;6161497;11785614;432402;0;5095
FR;2;2022-10-15;4;10;22;111;4;17;113;0;15;6126329;6814921;10672473;327296;6161501;11785631;432515;0;5110
FR;2;2022-10-16;0;5;4;10;5;6;8;0;0;6126329;6814926;10672477;327306;6161506;11785637;432523;0;5110
FR;2;2022-10-17;15;17;31;122;16;26;132;0;29;6126344;6814943;10672508;327428;6161522;11785663;432655;0;5139
FR;2;2022-10-18;13;11;68;181;5;34;217;0;41;6126357;6814954;10672576;327609;6161527;11785697;432872;0;5180
FR;2;2022-10-19;8;17;36;182;12;30;184;0;42;6126365;6814971;10672612;327791;6161539;11785727;433056;0;5222
FR;2;2022-10-20;11;29;41;200;15;40;196;0;52;6126376;6815000;10672653;327991;6161554;11785767;433252;0;5274
FR;2;2022-10-21;5;15;60;232;6;53;222;0;30;6126381;6815015;10672713;328223;6161560;11785820;433474;0;5304
FR;2;2022-10-22;8;7;25;101;2;23;102;0;20;6126389;6815022;10672738;328324;6161562;11785843;433576;0;5324
FR;2;2022-10-23;0;3;1;5;3;0;6;0;2;6126389;6815025;10672739;328329;6161565;11785843;433582;0;5326
FR;2;2022-10-24;12;12;16;109;12;16;112;0;20;6126401;6815037;10672755;328438;6161577;11785859;433694;0;5346
FR;2;2022-10-25;12;7;23;138;6;15;145;0;51;6126413;6815044;10672778;328576;6161583;11785874;433839;0;5397
FR;2;2022-10-26;4;3;16;88;2;10;94;0;27;6126417;6815047;10672794;328664;6161585;11785884;433933;0;5424
FR;2;2022-10-27;7;9;18;86;9;20;69;0;26;6126424;6815056;10672812;328750;6161594;11785904;434002;0;5450
FR;2;2022-10-28;5;3;15;91;3;7;92;0;27;6126429;6815059;10672827;328841;6161597;11785911;434094;0;5477
FR;2;2022-10-29;7;8;18;33;6;14;37;0;8;6126436;6815067;10672845;328874;6161603;11785925;434131;0;5485
FR;2;2022-10-30;3;7;5;8;5;2;5;0;1;6126439;6815074;10672850;328882;6161608;11785927;434136;0;5486
FR;2;2022-10-31;2;8;6;49;6;10;48;0;11;6126441;6815082;10672856;328931;6161614;11785937;434184;0;5497
FR;2;2022-11-01;0;0;7;1;0;5;3;0;0;6126441;6815082;10672863;328932;6161614;11785942;434187;0;5497
FR;2;2022-11-02;6;5;12;44;5;12;45;0;11;6126447;6815087;10672875;328976;6161619;11785954;434232;0;5508
FR;2;2022-11-03;6;7;15;77;6;10;74;0;18;6126453;6815094;10672890;329053;6161625;11785964;434306;0;5526
FR;2;2022-11-04;7;12;14;85;10;14;92;0;10;6126460;6815106;10672904;329138;6161635;11785978;434398;0;5536
FR;2;2022-11-05;0;11;12;38;6;16;35;0;6;6126460;6815117;10672916;329176;6161641;11785994;434433;0;5542
FR;2;2022-11-06;0;1;2;1;0;3;0;0;2;6126460;6815118;10672918;329177;6161641;11785997;434433;0;5544
FR;2;2022-11-07;11;7;14;66;5;13;65;0;20;6126471;6815125;10672932;329243;6161646;11786010;434498;0;5564
FR;2;2022-11-08;10;6;18;58;4;14;65;0;27;6126481;6815131;10672950;329301;6161650;11786024;434563;0;5591
FR;2;2022-11-09;4;5;17;56;2;17;50;0;28;6126485;6815136;10672967;329357;6161652;11786041;434613;0;5619
FR;2;2022-11-10;6;10;17;74;7;14;76;0;14;6126491;6815146;10672984;329431;6161659;11786055;434689;0;5633
FR;2;2022-11-11;0;3;7;3;0;8;4;0;0;6126491;6815149;10672991;329434;6161659;11786063;434693;0;5633
FR;2;2022-11-12;2;5;6;19;4;6;19;0;4;6126493;6815154;10672997;329453;6161663;11786069;434712;0;5637
FR;2;2022-11-13;2;2;3;2;1;4;1;0;0;6126495;6815156;10673000;329455;6161664;11786073;434713;0;5637
FR;2;2022-11-14;4;6;11;29;3;8;33;0;7;6126499;6815162;10673011;329484;6161667;11786081;434746;0;5644
FR;2;2022-11-15;5;12;14;35;13;17;32;0;7;6126504;6815174;10673025;329519;6161680;11786098;434778;0;5651
FR;2;2022-11-16;4;3;4;45;3;4;46;0;18;6126508;6815177;10673029;329564;6161683;11786102;434824;0;5669
FR;2;2022-11-17;2;6;10;53;5;7;52;0;22;6126510;6815183;10673039;329617;6161688;11786109;434876;0;5691
FR;2;2022-11-18;3;4;7;41;4;6;44;0;10;6126513;6815187;10673046;329658;6161692;11786115;434920;0;5701
FR;2;2022-11-19;2;2;2;25;2;3;18;0;4;6126515;6815189;10673048;329683;6161694;11786118;434938;0;5705
FR;2;2022-11-20;0;2;6;8;2;6;9;0;25;6126515;6815191;10673054;329691;6161696;11786124;434947;0;5730
FR;2;2022-11-21;6;8;9;31;5;8;34;0;22;6126521;6815199;10673063;329722;6161701;11786132;434981;0;5752
FR;2;2022-11-22;7;8;20;65;6;21;70;0;71;6126528;6815207;10673083;329787;6161707;11786153;435051;0;5823
FR;2;2022-11-23;7;6;8;67;3;5;72;0;8;6126535;6815213;10673091;329854;6161710;11786158;435123;0;5831
FR;2;2022-11-24;2;2;11;50;2;7;57;0;10;6126537;6815215;10673102;329904;6161712;11786165;435180;0;5841
FR;2;2022-11-25;11;8;11;25;11;13;26;0;8;6126548;6815223;10673113;329929;6161723;11786178;435206;0;5849
FR;2;2022-11-26;1;5;3;8;4;6;6;0;0;6126549;6815228;10673116;329937;6161727;11786184;435212;0;5849
FR;2;2022-11-27;2;2;12;2;0;11;4;0;1;6126551;6815230;10673128;329939;6161727;11786195;435216;0;5850
FR;2;2022-11-28;0;2;7;35;1;5;37;0;5;6126551;6815232;10673135;329974;6161728;11786200;435253;0;5855
FR;2;2022-11-29;1;1;9;24;0;3;30;0;8;6126552;6815233;10673144;329998;6161728;11786203;435283;0;5863
FR;2;2022-11-30;2;1;9;47;0;10;44;0;21;6126554;6815234;10673153;330045;6161728;11786213;435327;0;5884
FR;2;2022-12-01;2;7;3;57;4;11;49;0;23;6126556;6815241;10673156;330102;6161732;11786224;435376;0;5907
FR;2;2022-12-02;1;1;9;52;1;7;52;0;27;6126557;6815242;10673165;330154;6161733;11786231;435428;0;5934
FR;2;2022-12-03;1;3;1;18;1;2;16;0;10;6126558;6815245;10673166;330172;6161734;11786233;435444;0;5944
FR;2;2022-12-04;0;0;0;4;0;0;4;0;0;6126558;6815245;10673166;330176;6161734;11786233;435448;0;5944
FR;2;2022-12-05;3;1;4;49;4;1;42;0;16;6126561;6815246;10673170;330225;6161738;11786234;435490;0;5960
FR;2;2022-12-06;3;4;11;41;3;6;41;0;17;6126564;6815250;10673181;330266;6161741;11786240;435531;0;5977
FR;2;2022-12-07;1;3;7;42;2;6;43;0;11;6126565;6815253;10673188;330308;6161743;11786246;435574;0;5988
FR;2;2022-12-08;0;2;9;43;0;5;47;0;16;6126565;6815255;10673197;330351;6161743;11786251;435621;0;6004
FR;2;2022-12-09;0;1;10;53;0;7;57;0;16;6126565;6815256;10673207;330404;6161743;11786258;435678;0;6020
FR;2;2022-12-10;0;0;8;48;0;0;48;0;8;6126565;6815256;10673215;330452;6161743;11786258;435726;0;6028
FR;2;2022-12-11;0;0;2;2;0;2;1;0;3;6126565;6815256;10673217;330454;6161743;11786260;435727;0;6031
FR;2;2022-12-12;0;0;2;36;0;2;35;0;9;6126565;6815256;10673219;330490;6161743;11786262;435762;0;6040
FR;2;2022-12-13;0;2;1;36;1;1;35;0;13;6126565;6815258;10673220;330526;6161744;11786263;435797;0;6053
FR;3;2020-12-27;0;0;0;0;0;0;0;0;0;0;0;0;0;0;0;0;0;0
FR;3;2020-12-28;0;0;0;0;0;0;0;0;0;0;0;0;0;0;0;0;0;0
FR;3;2020-12-29;0;0;0;0;0;0;0;0;0;0;0;0;0;0;0;0;0;0
FR;3;2020-12-30;0;0;0;0;0;0;0;0;0;0;0;0;0;0;0;0;0;0
FR;3;2020-12-31;0;0;0;0;0;0;0;0;0;0;0;0;0;0;0;0;0;0
FR;3;2021-01-01;0;0;0;0;0;0;0;0;0;0;0;0;0;0;0;0;0;0
FR;3;2021-01-02;0;0;0;0;0;0;0;0;0;0;0;0;0;0;0;0;0;0
FR;3;2021-01-03;0;0;0;0;0;0;0;0;0;0;0;0;0;0;0;0;0;0
FR;3;2021-01-04;0;0;0;0;0;0;0;0;0;0;0;0;0;0;0;0;0;0
FR;3;2021-01-05;0;0;0;0;0;0;0;0;0;0;0;0;0;0;0;0;0;0
FR;3;2021-01-06;0;0;0;0;0;0;0;0;0;0;0;0;0;0;0;0;0;0
FR;3;2021-01-07;0;0;0;0;0;0;0;0;0;0;0;0;0;0;0;0;0;0
FR;3;2021-01-08;0;0;0;0;0;0;0;0;0;0;0;0;0;0;0;0;0;0
FR;3;2021-01-09;0;0;0;0;0;0;0;0;0;0;0;0;0;0;0;0;0;0
FR;3;2021-01-10;0;0;0;0;0;0;0;0;0;0;0;0;0;0;0;0;0;0
FR;3;2021-01-11;0;0;0;0;0;0;0;0;0;0;0;0;0;0;0;0;0;0
FR;3;2021-01-12;0;0;0;0;0;0;0;0;0;0;0;0;0;0;0;0;0;0
FR;3;2021-01-13;0;0;0;0;0;0;0;0;0;0;0;0;0;0;0;0;0;0
FR;3;2021-01-14;0;0;0;0;0;0;0;0;0;0;0;0;0;0;0;0;0;0
FR;3;2021-01-15;0;0;0;0;0;0;0;0;0;0;0;0;0;0;0;0;0;0
FR;3;2021-01-16;0;0;0;0;0;0;0;0;0;0;0;0;0;0;0;0;0;0
FR;3;2021-01-17;0;0;0;0;0;0;0;0;0;0;0;0;0;0;0;0;0;0
FR;3;2021-01-18;0;0;0;0;0;0;0;0;0;0;0;0;0;0;0;0;0;0
FR;3;2021-01-19;0;0;0;0;0;0;0;0;0;0;0;0;0;0;0;0;0;0
FR;3;2021-01-20;0;0;0;0;0;0;0;0;0;0;0;0;0;0;0;0;0;0
FR;3;2021-01-21;0;0;0;0;0;0;0;0;0;0;0;0;0;0;0;0;0;0
FR;3;2021-01-22;0;0;0;0;0;0;0;0;0;0;0;0;0;0;0;0;0;0
FR;3;2021-01-23;0;0;0;0;0;0;0;0;0;0;0;0;0;0;0;0;0;0
FR;3;2021-01-24;0;0;0;0;0;0;0;0;0;0;0;0;0;0;0;0;0;0
FR;3;2021-01-25;0;0;0;0;0;0;0;0;0;0;0;0;0;0;0;0;0;0
FR;3;2021-01-26;0;0;0;0;0;0;0;0;0;0;0;0;0;0;0;0;0;0
FR;3;2021-01-27;0;0;0;0;0;0;0;0;0;0;0;0;0;0;0;0;0;0
FR;3;2021-01-28;0;0;0;0;0;0;0;0;0;0;0;0;0;0;0;0;0;0
FR;3;2021-01-29;0;0;0;0;0;0;0;0;0;0;0;0;0;0;0;0;0;0
FR;3;2021-01-30;0;0;0;0;0;0;0;0;0;0;0;0;0;0;0;0;0;0
FR;3;2021-01-31;0;0;0;0;0;0;0;0;0;0;0;0;0;0;0;0;0;0
FR;3;2021-02-01;0;0;0;0;0;0;0;0;0;0;0;0;0;0;0;0;0;0
FR;3;2021-02-02;0;0;0;0;0;0;0;0;0;0;0;0;0;0;0;0;0;0
FR;3;2021-02-03;0;0;0;0;0;0;0;0;0;0;0;0;0;0;0;0;0;0
FR;3;2021-02-04;0;0;0;0;0;0;0;0;0;0;0;0;0;0;0;0;0;0
FR;3;2021-02-05;0;0;0;0;0;0;0;0;0;0;0;0;0;0;0;0;0;0
FR;3;2021-02-06;1502;0;0;0;108;0;0;0;0;1502;0;0;0;108;0;0;0;0
FR;3;2021-02-07;1423;2;0;0;87;0;0;0;0;2925;2;0;0;195;0;0;0;0
FR;3;2021-02-08;2789;1;0;0;177;0;0;0;0;5714;3;0;0;372;0;0;0;0
FR;3;2021-02-09;6786;0;0;0;502;0;0;0;0;12500;3;0;0;874;0;0;0;0
FR;3;2021-02-10;9611;0;0;0;695;0;0;0;0;22111;3;0;0;1569;0;0;0;0
FR;3;2021-02-11;13620;4;0;0;920;0;0;0;0;35731;7;0;0;2489;0;0;0;0
FR;3;2021-02-12;13409;0;0;0;907;0;0;0;0;49140;7;0;0;3396;0;0;0;0
FR;3;2021-02-13;3799;1;0;0;218;0;0;0;0;52939;8;0;0;3614;0;0;0;0
FR;3;2021-02-14;975;1;0;0;53;0;0;0;0;53914;9;0;0;3667;0;0;0;0
FR;3;2021-02-15;10495;2;0;0;719;0;0;0;0;64409;11;0;0;4386;0;0;0;0
FR;3;2021-02-16;12555;5;0;0;871;0;0;0;0;76964;16;0;0;5257;0;0;0;0
FR;3;2021-02-17;11158;1;0;0;716;0;0;0;0;88122;17;0;0;5973;0;0;0;0
FR;3;2021-02-18;14943;2;0;0;985;0;0;0;0;103065;19;0;0;6958;0;0;0;0
FR;3;2021-02-19;14365;1;0;0;846;0;0;0;0;117430;20;0;0;7804;0;0;0;0
FR;3;2021-02-20;3330;0;0;0;178;0;0;0;0;120760;20;0;0;7982;0;0;0;0
FR;3;2021-02-21;619;0;0;0;35;0;0;0;0;121379;20;0;0;8017;0;0;0;0
FR;3;2021-02-22;9170;1;0;0;655;0;0;0;0;130549;21;0;0;8672;0;0;0;0
FR;3;2021-02-23;11400;5;0;0;759;0;0;0;0;141949;26;0;0;9431;0;0;0;0
FR;3;2021-02-24;14306;1;0;0;829;0;0;0;0;156255;27;0;0;10260;0;0;0;0
FR;3;2021-02-25;44933;3;0;0;1814;0;0;0;0;201188;30;0;0;12074;0;0;0;0
FR;3;2021-02-26;61890;9;0;0;2201;0;0;0;0;263078;39;0;0;14275;0;0;0;0
FR;3;2021-02-27;34810;14;0;0;1028;0;0;0;0;297888;53;0;0;15303;0;0;0;0
FR;3;2021-02-28;2464;0;0;0;114;0;0;0;0;300352;53;0;0;15417;0;0;0;0
FR;3;2021-03-01;20520;20;0;0;1066;0;0;0;0;320872;73;0;0;16483;0;0;0;0
FR;3;2021-03-02;38877;24;0;0;1788;0;0;0;0;359749;97;0;0;18271;0;0;0;0
FR;3;2021-03-03;48748;20;0;0;2133;0;0;0;0;408497;117;0;0;20404;0;0;0;0
FR;3;2021-03-04;82229;25;0;0;3194;0;0;0;0;490726;142;0;0;23598;0;0;0;0
FR;3;2021-03-05;118135;42;0;0;4691;0;0;0;0;608861;184;0;0;28289;0;0;0;0
FR;3;2021-03-06;120724;64;1;0;3559;0;0;0;0;729585;248;1;0;31848;0;0;0;0
FR;3;2021-03-07;55184;23;0;0;1729;0;0;0;0;784769;271;1;0;33577;0;0;0;0
FR;3;2021-03-08;42813;30;0;0;2074;0;0;0;0;827582;301;1;0;35651;0;0;0;0
FR;3;2021-03-09;78977;49;0;0;3284;0;0;0;0;906559;350;1;0;38935;0;0;0;0
FR;3;2021-03-10;80983;61;0;0;3238;0;0;0;0;987542;411;1;0;42173;0;0;0;0
FR;3;2021-03-11;128447;64;0;0;4764;0;0;0;0;1115989;475;1;0;46937;0;0;0;0
FR;3;2021-03-12;182723;119;0;0;6278;0;0;0;0;1298712;594;1;0;53215;0;0;0;0
FR;3;2021-03-13;132164;83;0;0;3522;0;0;0;0;1430876;677;1;0;56737;0;0;0;0
FR;3;2021-03-14;14057;4;0;0;548;0;0;0;0;1444933;681;1;0;57285;0;0;0;0
FR;3;2021-03-15;52236;78;0;0;2093;0;0;0;0;1497169;759;1;0;59378;0;0;0;0
FR;3;2021-03-16;1218;47;0;0;101;0;0;0;0;1498387;806;1;0;59479;0;0;0;0
FR;3;2021-03-17;950;53;0;0;92;0;0;0;0;1499337;859;1;0;59571;0;0;0;0
FR;3;2021-03-18;1575;40;0;0;100;0;0;0;0;1500912;899;1;0;59671;0;0;0;0
FR;3;2021-03-19;70459;55;0;0;2059;0;0;0;0;1571371;954;1;0;61730;0;0;0;0
FR;3;2021-03-20;65239;49;0;0;1701;0;0;0;0;1636610;1003;1;0;63431;0;0;0;0
FR;3;2021-03-21;5761;8;0;0;199;0;0;0;0;1642371;1011;1;0;63630;0;0;0;0
FR;3;2021-03-22;37510;47;0;0;1051;0;0;0;0;1679881;1058;1;0;64681;0;0;0;0
FR;3;2021-03-23;84667;84;0;0;2283;0;0;0;0;1764548;1142;1;0;66964;0;0;0;0
FR;3;2021-03-24;90953;95;0;0;2487;0;0;0;0;1855501;1237;1;0;69451;0;0;0;0
FR;3;2021-03-25;150070;141;0;0;3785;0;0;0;0;2005571;1378;1;0;73236;0;0;0;0
FR;3;2021-03-26;165431;159;0;0;4155;0;0;0;0;2171002;1537;1;0;77391;0;0;0;0
FR;3;2021-03-27;68465;102;0;0;2005;0;0;0;0;2239467;1639;1;0;79396;0;0;0;0
FR;3;2021-03-28;6479;20;0;0;237;0;0;0;0;2245946;1659;1;0;79633;0;0;0;0
FR;3;2021-03-29;54168;79;0;0;1478;0;0;0;0;2300114;1738;1;0;81111;0;0;0;0
FR;3;2021-03-30;93183;105;0;0;2566;0;0;0;0;2393297;1843;1;0;83677;0;0;0;0
FR;3;2021-03-31;63543;110;0;0;1965;0;0;0;0;2456840;1953;1;0;85642;0;0;0;0
FR;3;2021-04-01;86135;112;0;0;2491;0;0;0;0;2542975;2065;1;0;88133;0;0;0;0
FR;3;2021-04-02;86913;183;0;0;2763;0;0;0;0;2629888;2248;1;0;90896;0;0;0;0
FR;3;2021-04-03;35874;130;0;0;1160;0;0;0;0;2665762;2378;1;0;92056;0;0;0;0
FR;3;2021-04-04;3576;19;0;0;164;0;0;0;0;2669338;2397;1;0;92220;0;0;0;0
FR;3;2021-04-05;4492;39;0;0;237;0;0;0;0;2673830;2436;1;0;92457;0;0;0;0
FR;3;2021-04-06;29758;103;0;0;1090;0;0;0;0;2703588;2539;1;0;93547;0;0;0;0
FR;3;2021-04-07;32348;106;0;0;1045;0;0;0;0;2735936;2645;1;0;94592;0;0;0;0
FR;3;2021-04-08;78825;264;0;0;2609;0;0;0;0;2814761;2909;1;0;97201;0;0;0;0
FR;3;2021-04-09;161757;448;0;0;5177;0;0;0;0;2976518;3357;1;0;102378;0;0;0;0
FR;3;2021-04-10;75763;360;0;0;2693;0;0;0;0;3052281;3717;1;0;105071;0;0;0;0
FR;3;2021-04-11;7313;46;0;0;304;0;0;0;0;3059594;3763;1;0;105375;0;0;0;0
FR;3;2021-04-12;51485;213;0;0;1734;0;0;0;0;3111079;3976;1;0;107109;0;0;0;0
FR;3;2021-04-13;86233;357;0;0;2904;0;0;0;0;3197312;4333;1;0;110013;0;0;0;0
FR;3;2021-04-14;67843;373;0;0;2424;0;0;0;0;3265155;4706;1;0;112437;0;0;0;0
FR;3;2021-04-15;93241;399;0;0;3437;0;0;0;0;3358396;5105;1;0;115874;0;0;0;0
FR;3;2021-04-16;112527;619;0;0;4335;0;0;0;0;3470923;5724;1;0;120209;0;0;0;0
FR;3;2021-04-17;53319;362;1;0;2268;0;0;0;0;3524242;6086;2;0;122477;0;0;0;0
FR;3;2021-04-18;9749;48;0;0;423;0;0;0;0;3533991;6134;2;0;122900;0;0;0;0
FR;3;2021-04-19;25113;274;0;0;1080;0;0;0;0;3559104;6408;2;0;123980;0;0;0;0
FR;3;2021-04-20;45673;431;0;0;1903;0;0;0;0;3604777;6839;2;0;125883;0;0;0;0
FR;3;2021-04-21;38985;540;0;0;1884;0;0;0;0;3643762;7379;2;0;127767;0;0;0;0
FR;3;2021-04-22;54720;864;0;0;2815;0;0;0;0;3698482;8243;2;0;130582;0;0;0;0
FR;3;2021-04-23;70491;1081;0;0;3684;0;0;0;0;3768973;9324;2;0;134266;0;0;0;0
FR;3;2021-04-24;37251;1083;0;0;2471;0;0;0;0;3806224;10407;2;0;136737;0;0;0;0
FR;3;2021-04-25;6213;156;0;0;444;0;0;0;0;3812437;10563;2;0;137181;0;0;0;0
FR;3;2021-04-26;19788;689;0;0;1423;0;0;0;0;3832225;11252;2;0;138604;0;0;0;0
FR;3;2021-04-27;34485;1319;0;0;2577;0;0;0;0;3866710;12571;2;0;141181;0;0;0;0
FR;3;2021-04-28;28970;2022;0;0;3139;0;0;0;0;3895680;14593;2;0;144320;0;0;0;0
FR;3;2021-04-29;45389;6099;0;0;7917;0;0;0;0;3941069;20692;2;0;152237;0;0;0;0
FR;3;2021-04-30;55466;9077;1;0;11473;0;0;0;0;3996535;29769;3;0;163710;0;0;0;0
FR;3;2021-05-01;9517;2048;0;0;2479;0;0;0;0;4006052;31817;3;0;166189;0;0;0;0
FR;3;2021-05-02;3079;474;0;0;618;0;0;0;0;4009131;32291;3;0;166807;0;0;0;0
FR;3;2021-05-03;13063;3930;0;0;4497;0;0;0;0;4022194;36221;3;0;171304;0;0;0;0
FR;3;2021-05-04;23118;8392;0;0;9458;0;0;0;0;4045312;44613;3;0;180762;0;0;0;0
FR;3;2021-05-05;18762;10793;0;0;11730;0;0;0;0;4064074;55406;3;0;192492;0;0;0;0
FR;3;2021-05-06;34630;21202;0;0;22748;0;0;0;0;4098704;76608;3;0;215240;0;0;0;0
FR;3;2021-05-07;44209;28825;0;0;31128;0;0;0;0;4142913;105433;3;0;246368;0;0;0;0
FR;3;2021-05-08;6785;9186;0;0;9548;0;0;0;0;4149698;114619;3;0;255916;0;0;0;0
FR;3;2021-05-09;1797;2671;0;0;2771;0;0;0;0;4151495;117290;3;0;258687;0;0;0;0
FR;3;2021-05-10;15001;12876;0;0;13565;0;0;0;0;4166496;130166;3;0;272252;0;0;0;0
FR;3;2021-05-11;27100;26208;0;0;27479;0;0;0;0;4193596;156374;3;0;299731;0;0;0;0
FR;3;2021-05-12;17271;28050;0;0;28984;0;0;0;0;4210867;184424;3;0;328715;0;0;0;0
FR;3;2021-05-13;2285;3511;0;0;3631;0;0;0;0;4213152;187935;3;0;332346;0;0;0;0
FR;3;2021-05-14;14520;26042;0;0;26820;0;0;0;0;4227672;213977;3;0;359166;0;0;0;0
FR;3;2021-05-15;7233;21045;0;0;21469;0;0;0;0;4234905;235022;3;0;380635;0;0;0;0
FR;3;2021-05-16;977;2642;0;0;2686;0;0;0;0;4235882;237664;3;0;383321;0;0;0;0
FR;3;2021-05-17;7966;20164;0;0;20607;0;0;0;0;4243848;257828;3;0;403928;0;0;0;0
FR;3;2021-05-18;13416;30090;0;0;30848;0;0;0;0;4257264;287918;3;0;434776;0;0;0;0
FR;3;2021-05-19;9274;30662;0;0;31247;0;0;0;0;4266538;318580;3;0;466023;0;0;0;0
FR;3;2021-05-20;12806;53758;3;0;54678;0;0;0;0;4279344;372338;6;0;520701;0;0;0;0
FR;3;2021-05-21;12768;66098;2;0;67018;0;0;0;0;4292112;438436;8;0;587719;0;0;0;0
FR;3;2021-05-22;4964;33723;1;0;34104;0;0;0;0;4297076;472159;9;0;621823;0;0;0;0
FR;3;2021-05-23;651;2673;0;0;2705;0;0;0;0;4297727;474832;9;0;624528;0;0;0;0
FR;3;2021-05-24;883;4798;0;0;4842;0;0;0;0;4298610;479630;9;0;629370;0;0;0;0
FR;3;2021-05-25;5311;46586;1;0;46981;0;0;0;0;4303921;526216;10;0;676351;0;0;0;0
FR;3;2021-05-26;4980;52049;1;0;52518;0;0;0;0;4308901;578265;11;0;728869;0;0;0;0
FR;3;2021-05-27;6336;78938;3;0;79541;0;0;0;0;4315237;657203;14;0;808410;0;0;0;0
FR;3;2021-05-28;7544;100175;2;0;100966;0;0;0;0;4322781;757378;16;0;909376;0;0;0;0
FR;3;2021-05-29;3349;61072;1;0;61451;0;0;0;0;4326130;818450;17;0;970827;0;0;0;0
FR;3;2021-05-30;551;8109;0;0;8158;0;0;0;0;4326681;826559;17;0;978985;0;0;0;0
FR;3;2021-05-31;2441;35529;3;0;35793;0;0;0;0;4329122;862088;20;0;1014778;0;0;0;0
FR;3;2021-06-01;3413;64854;10;0;65296;0;0;0;0;4332535;926942;30;0;1080074;0;0;0;0
FR;3;2021-06-02;2735;58848;6;0;59179;0;0;0;0;4335270;985790;36;0;1139253;0;0;0;0
FR;3;2021-06-03;3495;87221;10;0;87750;0;0;0;0;4338765;1073011;46;0;1227003;0;0;0;0
FR;3;2021-06-04;4118;105780;22;0;106433;0;0;0;0;4342883;1178791;68;0;1333436;0;0;0;0
FR;3;2021-06-05;1983;52548;4;0;52860;0;0;0;0;4344866;1231339;72;0;1386296;0;0;0;0
FR;3;2021-06-06;511;5290;1;0;5337;0;0;0;0;4345377;1236629;73;0;1391633;0;0;0;0
FR;3;2021-06-07;1485;30757;11;0;30937;0;0;0;0;4346862;1267386;84;0;1422570;0;0;0;0
FR;3;2021-06-08;2062;47393;18;0;47737;0;0;0;0;4348924;1314779;102;0;1470307;0;0;0;0
FR;3;2021-06-09;1794;41873;13;0;42177;0;0;0;0;4350718;1356652;115;0;1512484;0;0;0;0
FR;3;2021-06-10;2256;67661;17;0;68055;0;0;0;0;4352974;1424313;132;0;1580539;0;0;0;0
FR;3;2021-06-11;2486;96635;34;0;97106;0;0;0;0;4355460;1520948;166;0;1677645;0;0;0;0
FR;3;2021-06-12;1178;40574;6;0;40803;0;0;0;0;4356638;1561522;172;0;1718448;0;0;0;0
FR;3;2021-06-13;283;3642;3;0;3677;0;0;0;0;4356921;1565164;175;0;1722125;0;0;0;0
FR;3;2021-06-14;1048;42340;17;0;42503;0;0;0;0;4357969;1607504;192;0;1764628;0;0;0;0
FR;3;2021-06-15;1377;80391;20;0;80688;0;0;0;0;4359346;1687895;212;0;1845316;0;0;0;0
FR;3;2021-06-16;1262;65493;20;0;65765;0;0;0;0;4360608;1753388;232;0;1911081;0;0;0;0
FR;3;2021-06-17;1667;102230;41;0;102613;0;0;0;0;4362275;1855618;273;0;2013694;0;0;0;0
FR;3;2021-06-18;1871;118391;63;0;118850;0;0;0;0;4364146;1974009;336;0;2132544;0;0;0;0
FR;3;2021-06-19;803;39451;22;0;39642;0;0;0;0;4364949;2013460;358;0;2172186;0;0;0;0
FR;3;2021-06-20;161;3213;0;0;3241;0;0;0;0;4365110;2016673;358;0;2175427;0;0;0;0
FR;3;2021-06-21;773;39085;16;0;39244;0;0;0;0;4365883;2055758;374;0;2214671;0;0;0;0
FR;3;2021-06-22;1065;70053;52;0;70322;0;0;0;0;4366948;2125811;426;0;2284993;0;0;0;0
FR;3;2021-06-23;945;50832;39;0;51104;0;0;0;0;4367893;2176643;465;0;2336097;0;0;0;0
FR;3;2021-06-24;1310;77279;48;0;77651;0;0;0;0;4369203;2253922;513;0;2413748;0;0;0;0
FR;3;2021-06-25;1410;90743;73;0;91175;0;0;0;0;4370613;2344665;586;0;2504923;0;0;0;0
FR;3;2021-06-26;631;33116;29;0;33306;0;0;0;0;4371244;2377781;615;0;2538229;0;0;0;0
FR;3;2021-06-27;166;3788;1;0;3812;0;0;0;0;4371410;2381569;616;0;2542041;0;0;0;0
FR;3;2021-06-28;655;29990;27;0;30184;0;0;0;0;4372065;2411559;643;0;2572225;0;0;0;0
FR;3;2021-06-29;856;56579;95;0;56820;0;0;0;0;4372921;2468138;738;0;2629045;0;0;0;0
FR;3;2021-06-30;905;45180;93;0;45452;0;0;0;0;4373826;2513318;831;0;2674497;0;0;0;0
FR;3;2021-07-01;1164;66050;108;0;66401;0;0;0;0;4374990;2579368;939;0;2740898;0;0;0;0
FR;3;2021-07-02;1305;90502;170;0;90977;0;0;0;0;4376295;2669870;1109;0;2831875;0;0;0;0
FR;3;2021-07-03;602;31175;51;0;31375;0;0;0;0;4376897;2701045;1160;0;2863250;0;0;0;0
FR;3;2021-07-04;144;4008;3;0;4038;0;0;0;0;4377041;2705053;1163;0;2867288;0;0;0;0
FR;3;2021-07-05;612;33622;60;0;33821;0;0;0;0;4377653;2738675;1223;0;2901109;0;0;0;0
FR;3;2021-07-06;964;55932;88;0;56245;0;0;0;0;4378617;2794607;1311;0;2957354;0;0;0;0
FR;3;2021-07-07;873;42955;80;0;43251;0;0;0;0;4379490;2837562;1391;0;3000605;0;0;0;0
FR;3;2021-07-08;1127;60791;99;0;61201;0;0;0;0;4380617;2898353;1490;0;3061806;0;0;0;0
FR;3;2021-07-09;1261;68924;128;0;69391;0;0;0;0;4381878;2967277;1618;0;3131197;0;0;0;0
FR;3;2021-07-10;643;25030;59;0;25227;0;0;0;0;4382521;2992307;1677;0;3156424;0;0;0;0
FR;3;2021-07-11;132;3187;4;0;3213;0;0;0;0;4382653;2995494;1681;0;3159637;0;0;0;0
FR;3;2021-07-12;662;23654;59;0;23867;0;0;0;0;4383315;3019148;1740;0;3183504;0;0;0;0
FR;3;2021-07-13;1648;34501;90;0;34989;0;0;0;0;4384963;3053649;1830;0;3218493;0;0;0;0
FR;3;2021-07-14;271;2480;2;0;2537;0;0;0;0;4385234;3056129;1832;0;3221030;0;0;0;0
FR;3;2021-07-15;1940;30449;85;0;31022;0;0;0;0;4387174;3086578;1917;0;3252052;0;0;0;0
FR;3;2021-07-16;2520;38677;122;0;39413;0;0;0;0;4389694;3125255;2039;0;3291465;0;0;0;0
FR;3;2021-07-17;1051;13720;26;0;14027;0;0;0;0;4390745;3138975;2065;0;3305492;0;0;0;0
FR;3;2021-07-18;266;2558;3;0;2606;0;0;0;0;4391011;3141533;2068;0;3308098;0;0;0;0
FR;3;2021-07-19;1280;16922;38;0;17291;0;0;0;0;4392291;3158455;2106;0;3325389;0;0;0;0
FR;3;2021-07-20;1823;26949;98;0;27491;0;0;0;0;4394114;3185404;2204;0;3352880;0;0;0;0
FR;3;2021-07-21;1651;19529;44;0;20034;0;0;0;0;4395765;3204933;2248;0;3372914;0;0;0;0
FR;3;2021-07-22;1856;27646;83;0;28213;0;0;0;0;4397621;3232579;2331;0;3401127;0;0;0;0
FR;3;2021-07-23;2216;30254;117;0;30994;0;0;0;0;4399837;3262833;2448;0;3432121;0;0;0;0
FR;3;2021-07-24;826;6947;25;0;7170;0;0;0;0;4400663;3269780;2473;0;3439291;0;0;0;0
FR;3;2021-07-25;210;1298;1;0;1353;0;0;0;0;4400873;3271078;2474;0;3440644;0;0;0;0
FR;3;2021-07-26;932;10539;28;0;10846;0;0;0;0;4401805;3281617;2502;0;3451490;0;0;0;0
FR;3;2021-07-27;1169;16817;56;0;17183;0;0;0;0;4402974;3298434;2558;0;3468673;0;0;0;0
FR;3;2021-07-28;989;12011;40;0;12323;0;0;0;0;4403963;3310445;2598;0;3480996;0;0;0;0
FR;3;2021-07-29;1127;15714;63;0;16127;0;0;0;0;4405090;3326159;2661;0;3497123;0;0;0;0
FR;3;2021-07-30;1128;18007;79;0;18383;0;0;0;0;4406218;3344166;2740;0;3515506;0;0;0;0
FR;3;2021-07-31;406;3715;15;0;3838;0;0;0;0;4406624;3347881;2755;0;3519344;0;0;0;0
FR;3;2021-08-01;117;454;1;0;476;0;0;0;0;4406741;3348335;2756;0;3519820;0;0;0;0
FR;3;2021-08-02;421;5035;22;0;5156;0;0;0;0;4407162;3353370;2778;0;3524976;0;0;0;0
FR;3;2021-08-03;498;7489;27;0;7625;0;0;0;0;4407660;3360859;2805;0;3532601;0;0;0;0
FR;3;2021-08-04;439;4835;26;0;4981;0;0;0;0;4408099;3365694;2831;0;3537582;0;0;0;0
FR;3;2021-08-05;433;3660;13;0;3771;0;0;0;0;4408532;3369354;2844;0;3541353;0;0;0;0
FR;3;2021-08-06;456;4709;30;0;4811;0;0;0;0;4408988;3374063;2874;0;3546164;0;0;0;0
FR;3;2021-08-07;214;1901;11;0;1947;0;0;0;0;4409202;3375964;2885;0;3548111;0;0;0;0
FR;3;2021-08-08;250;422;2;0;455;0;0;0;0;4409452;3376386;2887;0;3548566;0;0;0;0
FR;3;2021-08-09;318;2392;11;0;2463;0;0;0;0;4409770;3378778;2898;0;3551029;0;0;0;0
FR;3;2021-08-10;368;3763;15;0;3852;0;0;0;0;4410138;3382541;2913;0;3554881;0;0;0;0
FR;3;2021-08-11;291;2653;15;0;2713;0;0;0;0;4410429;3385194;2928;0;3557594;0;0;0;0
FR;3;2021-08-12;279;2575;13;0;2663;0;0;0;0;4410708;3387769;2941;0;3560257;0;0;0;0
FR;3;2021-08-13;278;2259;16;0;2344;0;0;0;0;4410986;3390028;2957;0;3562601;0;0;0;0
FR;3;2021-08-14;172;884;1;0;915;0;0;0;0;4411158;3390912;2958;0;3563516;0;0;0;0
FR;3;2021-08-15;56;174;0;0;183;0;0;0;0;4411214;3391086;2958;0;3563699;0;0;0;0
FR;3;2021-08-16;125;1024;8;0;1063;0;0;0;0;4411339;3392110;2966;0;3564762;0;0;0;0
FR;3;2021-08-17;191;1438;8;0;1479;0;0;0;0;4411530;3393548;2974;0;3566241;0;0;0;0
FR;3;2021-08-18;204;1311;10;0;1353;0;0;0;0;4411734;3394859;2984;0;3567594;0;0;0;0
FR;3;2021-08-19;165;1380;10;0;1428;0;0;0;0;4411899;3396239;2994;0;3569022;0;0;0;0
FR;3;2021-08-20;167;1600;16;0;1663;0;0;0;0;4412066;3397839;3010;0;3570685;0;0;0;0
FR;3;2021-08-21;93;581;2;0;596;0;0;0;0;4412159;3398420;3012;0;3571281;0;0;0;0
FR;3;2021-08-22;42;191;1;0;194;0;0;0;0;4412201;3398611;3013;0;3571475;0;0;0;0
FR;3;2021-08-23;141;889;7;0;934;0;0;0;0;4412342;3399500;3020;0;3572409;0;0;0;0
FR;3;2021-08-24;125;927;10;0;959;0;0;0;0;4412467;3400427;3030;0;3573368;0;0;0;0
FR;3;2021-08-25;137;820;3;0;849;0;0;0;0;4412604;3401247;3033;0;3574217;0;0;0;0
FR;3;2021-08-26;172;830;9;0;878;0;0;0;0;4412776;3402077;3042;0;3575095;0;0;0;0
FR;3;2021-08-27;178;939;9;0;992;0;0;0;0;4412954;3403016;3051;0;3576087;0;0;0;0
FR;3;2021-08-28;101;373;4;0;390;0;0;0;0;4413055;3403389;3055;0;3576477;0;0;0;0
FR;3;2021-08-29;128;128;1;0;161;0;0;0;0;4413183;3403517;3056;0;3576638;0;0;0;0
FR;3;2021-08-30;100;568;0;0;473;112;0;0;0;4413283;3404085;3056;0;3577111;112;0;0;0
FR;3;2021-08-31;134;688;7;0;591;136;0;0;0;4413417;3404773;3063;0;3577702;248;0;0;0
FR;3;2021-09-01;121;461;5;0;381;109;0;0;0;4413538;3405234;3068;0;3578083;357;0;0;0
FR;3;2021-09-02;100;600;22;0;536;105;0;0;0;4413638;3405834;3090;0;3578619;462;0;0;0
FR;3;2021-09-03;116;559;17;0;482;118;0;0;0;4413754;3406393;3107;0;3579101;580;0;0;0
FR;3;2021-09-04;55;293;3;0;253;51;0;0;0;4413809;3406686;3110;0;3579354;631;0;0;0
FR;3;2021-09-05;51;67;5;0;56;26;0;0;0;4413860;3406753;3115;0;3579410;657;0;0;0
FR;3;2021-09-06;118;370;4;0;262;132;0;0;0;4413978;3407123;3119;0;3579672;789;0;0;0
FR;3;2021-09-07;124;437;14;0;353;116;0;0;0;4414102;3407560;3133;0;3580025;905;0;0;0
FR;3;2021-09-08;121;344;2;0;271;90;0;0;0;4414223;3407904;3135;0;3580296;995;0;0;0
FR;3;2021-09-09;94;380;8;0;300;103;0;0;0;4414317;3408284;3143;0;3580596;1098;0;0;0
FR;3;2021-09-10;101;400;3;0;329;94;0;0;0;4414418;3408684;3146;0;3580925;1192;0;0;0
FR;3;2021-09-11;78;232;4;0;177;65;0;0;0;4414496;3408916;3150;0;3581102;1257;0;0;0
FR;3;2021-09-12;37;48;1;0;37;16;0;0;0;4414533;3408964;3151;0;3581139;1273;0;0;0
FR;3;2021-09-13;77;303;7;0;220;102;1;0;0;4414610;3409267;3158;0;3581359;1375;1;0;0
FR;3;2021-09-14;75;275;6;0;193;96;0;0;0;4414685;3409542;3164;0;3581552;1471;1;0;0
FR;3;2021-09-15;63;254;3;0;259;6;0;0;0;4414748;3409796;3167;0;3581811;1477;1;0;0
FR;3;2021-09-16;65;321;6;0;332;6;0;0;0;4414813;3410117;3173;0;3582143;1483;1;0;0
FR;3;2021-09-17;52;327;3;0;339;6;0;0;0;4414865;3410444;3176;0;3582482;1489;1;0;0
FR;3;2021-09-18;37;172;1;0;176;1;0;0;0;4414902;3410616;3177;0;3582658;1490;1;0;0
FR;3;2021-09-19;29;31;2;0;34;1;0;0;0;4414931;3410647;3179;0;3582692;1491;1;0;0
FR;3;2021-09-20;81;193;0;0;201;1;0;0;0;4415012;3410840;3179;0;3582893;1492;1;0;0
FR;3;2021-09-21;60;271;7;0;275;8;0;0;0;4415072;3411111;3186;0;3583168;1500;1;0;0
FR;3;2021-09-22;66;230;6;0;243;7;0;0;0;4415138;3411341;3192;0;3583411;1507;1;0;0
FR;3;2021-09-23;37;258;11;0;262;7;0;0;0;4415175;3411599;3203;0;3583673;1514;1;0;0
FR;3;2021-09-24;28;320;12;0;318;18;0;0;0;4415203;3411919;3215;0;3583991;1532;1;0;0
FR;3;2021-09-25;31;144;3;0;150;3;0;0;0;4415234;3412063;3218;0;3584141;1535;1;0;0
FR;3;2021-09-26;16;57;1;0;59;1;0;0;0;4415250;3412120;3219;0;3584200;1536;1;0;0
FR;3;2021-09-27;48;288;3;0;291;5;0;0;0;4415298;3412408;3222;0;3584491;1541;1;0;0
FR;3;2021-09-28;49;246;6;0;254;8;0;0;0;4415347;3412654;3228;0;3584745;1549;1;0;0
FR;3;2021-09-29;39;219;10;0;223;15;0;0;0;4415386;3412873;3238;0;3584968;1564;1;0;0
FR;3;2021-09-30;40;203;8;0;207;11;0;0;0;4415426;3413076;3246;0;3585175;1575;1;0;0
FR;3;2021-10-01;23;159;6;0;161;8;0;0;0;4415449;3413235;3252;0;3585336;1583;1;0;0
FR;3;2021-10-02;17;84;0;0;85;0;0;0;0;4415466;3413319;3252;0;3585421;1583;1;0;0
FR;3;2021-10-03;19;19;1;0;19;2;0;0;0;4415485;3413338;3253;0;3585440;1585;1;0;0
FR;3;2021-10-04;33;158;4;0;163;4;0;0;0;4415518;3413496;3257;0;3585603;1589;1;0;0
FR;3;2021-10-05;17;148;10;0;153;12;0;0;0;4415535;3413644;3267;0;3585756;1601;1;0;0
FR;3;2021-10-06;33;143;9;0;151;10;0;0;0;4415568;3413787;3276;0;3585907;1611;1;0;0
FR;3;2021-10-07;20;134;6;0;132;6;0;0;0;4415588;3413921;3282;0;3586039;1617;1;0;0
FR;3;2021-10-08;25;138;10;0;143;9;0;0;0;4415613;3414059;3292;0;3586182;1626;1;0;0
FR;3;2021-10-09;17;71;1;0;72;1;0;0;0;4415630;3414130;3293;0;3586254;1627;1;0;0
FR;3;2021-10-10;13;17;2;0;16;3;0;0;0;4415643;3414147;3295;0;3586270;1630;1;0;0
FR;3;2021-10-11;17;116;4;0;121;5;0;0;0;4415660;3414263;3299;0;3586391;1635;1;0;0
FR;3;2021-10-12;22;100;5;0;100;5;0;0;0;4415682;3414363;3304;0;3586491;1640;1;0;0
FR;3;2021-10-13;25;114;9;0;121;7;0;0;0;4415707;3414477;3313;0;3586612;1647;1;0;0
FR;3;2021-10-14;19;142;3;0;143;4;0;0;0;4415726;3414619;3316;0;3586755;1651;1;0;0
FR;3;2021-10-15;23;140;8;0;140;12;0;0;0;4415749;3414759;3324;0;3586895;1663;1;0;0
FR;3;2021-10-16;13;68;6;0;67;8;0;0;0;4415762;3414827;3330;0;3586962;1671;1;0;0
FR;3;2021-10-17;12;24;0;0;26;0;0;0;0;4415774;3414851;3330;0;3586988;1671;1;0;0
FR;3;2021-10-18;18;113;2;0;118;2;0;0;0;4415792;3414964;3332;0;3587106;1673;1;0;0
FR;3;2021-10-19;18;113;19;0;114;21;0;0;0;4415810;3415077;3351;0;3587220;1694;1;0;0
FR;3;2021-10-20;26;127;6;0;129;7;0;0;0;4415836;3415204;3357;0;3587349;1701;1;0;0
FR;3;2021-10-21;28;124;17;0;124;13;0;0;0;4415864;3415328;3374;0;3587473;1714;1;0;0
FR;3;2021-10-22;24;107;18;0;106;21;0;0;0;4415888;3415435;3392;0;3587579;1735;1;0;0
FR;3;2021-10-23;17;53;3;0;53;2;0;0;0;4415905;3415488;3395;0;3587632;1737;1;0;0
FR;3;2021-10-24;7;36;0;0;34;0;0;0;0;4415912;3415524;3395;0;3587666;1737;1;0;0
FR;3;2021-10-25;26;141;7;0;145;7;0;0;0;4415938;3415665;3402;0;3587811;1744;1;0;0
FR;3;2021-10-26;25;96;22;0;93;19;0;0;0;4415963;3415761;3424;0;3587904;1763;1;0;0
FR;3;2021-10-27;18;94;9;0;95;9;0;0;0;4415981;3415855;3433;0;3587999;1772;1;0;0
FR;3;2021-10-28;23;114;33;0;111;36;0;0;0;4416004;3415969;3466;0;3588110;1808;1;0;0
FR;3;2021-10-29;12;100;64;0;94;54;0;0;0;4416016;3416069;3530;0;3588204;1862;1;0;0
FR;3;2021-10-30;11;62;11;1;62;10;0;0;0;4416027;3416131;3541;1;3588266;1872;1;0;0
FR;3;2021-10-31;8;25;1;0;25;1;0;0;0;4416035;3416156;3542;1;3588291;1873;1;0;0
FR;3;2021-11-01;11;22;2;0;23;1;0;0;0;4416046;3416178;3544;1;3588314;1874;1;0;0
FR;3;2021-11-02;11;101;10;0;101;12;0;0;0;4416057;3416279;3554;1;3588415;1886;1;0;0
FR;3;2021-11-03;20;107;10;0;115;10;0;0;0;4416077;3416386;3564;1;3588530;1896;1;0;0
FR;3;2021-11-04;20;91;5;0;96;4;0;0;0;4416097;3416477;3569;1;3588626;1900;1;0;0
FR;3;2021-11-05;19;121;9;1;127;6;1;0;0;4416116;3416598;3578;2;3588753;1906;2;0;0
FR;3;2021-11-06;11;56;3;0;58;3;0;0;0;4416127;3416654;3581;2;3588811;1909;2;0;0
FR;3;2021-11-07;6;22;1;0;23;1;0;0;0;4416133;3416676;3582;2;3588834;1910;2;0;0
FR;3;2021-11-08;11;128;7;0;133;5;0;0;0;4416144;3416804;3589;2;3588967;1915;2;0;0
FR;3;2021-11-09;15;123;6;0;125;6;0;0;0;4416159;3416927;3595;2;3589092;1921;2;0;0
FR;3;2021-11-10;14;141;14;0;139;15;0;0;0;4416173;3417068;3609;2;3589231;1936;2;0;0
FR;3;2021-11-11;11;50;3;0;52;3;0;0;0;4416184;3417118;3612;2;3589283;1939;2;0;0
FR;3;2021-11-12;15;129;6;0;132;4;0;0;0;4416199;3417247;3618;2;3589415;1943;2;0;0
FR;3;2021-11-13;7;67;9;0;62;10;0;0;0;4416206;3417314;3627;2;3589477;1953;2;0;0
FR;3;2021-11-14;3;24;1;0;24;1;0;0;0;4416209;3417338;3628;2;3589501;1954;2;0;0
FR;3;2021-11-15;5;164;10;0;161;11;0;0;0;4416214;3417502;3638;2;3589662;1965;2;0;0
FR;3;2021-11-16;9;127;11;0;122;10;0;0;0;4416223;3417629;3649;2;3589784;1975;2;0;0
FR;3;2021-11-17;8;134;11;0;135;8;0;0;0;4416231;3417763;3660;2;3589919;1983;2;0;0
FR;3;2021-11-18;16;135;10;0;136;11;0;0;0;4416247;3417898;3670;2;3590055;1994;2;0;0
FR;3;2021-11-19;12;187;23;0;180;28;0;0;0;4416259;3418085;3693;2;3590235;2022;2;0;0
FR;3;2021-11-20;6;100;6;0;101;6;0;0;0;4416265;3418185;3699;2;3590336;2028;2;0;0
FR;3;2021-11-21;3;25;4;0;24;4;0;0;0;4416268;3418210;3703;2;3590360;2032;2;0;0
FR;3;2021-11-22;11;191;11;0;190;11;0;0;0;4416279;3418401;3714;2;3590550;2043;2;0;0
FR;3;2021-11-23;9;185;15;0;183;14;0;0;0;4416288;3418586;3729;2;3590733;2057;2;0;0
FR;3;2021-11-24;10;194;9;0;186;17;0;0;0;4416298;3418780;3738;2;3590919;2074;2;0;0
FR;3;2021-11-25;12;209;11;0;205;11;0;0;0;4416310;3418989;3749;2;3591124;2085;2;0;0
FR;3;2021-11-26;10;263;35;0;262;33;1;0;0;4416320;3419252;3784;2;3591386;2118;3;0;0
FR;3;2021-11-27;8;130;20;0;129;21;0;0;0;4416328;3419382;3804;2;3591515;2139;3;0;0
FR;3;2021-11-28;3;59;7;0;60;7;0;0;0;4416331;3419441;3811;2;3591575;2146;3;0;0
FR;3;2021-11-29;5;225;22;0;220;23;1;0;0;4416336;3419666;3833;2;3591795;2169;4;0;0
FR;3;2021-11-30;7;309;29;0;308;32;0;0;0;4416343;3419975;3862;2;3592103;2201;4;0;0
FR;3;2021-12-01;30;332;38;0;329;40;2;0;0;4416373;3420307;3900;2;3592432;2241;6;0;0
FR;3;2021-12-02;9;357;33;0;353;36;0;0;0;4416382;3420664;3933;2;3592785;2277;6;0;0
FR;3;2021-12-03;6;386;37;0;380;38;0;0;0;4416388;3421050;3970;2;3593165;2315;6;0;0
FR;3;2021-12-04;3;215;26;0;211;28;0;0;0;4416391;3421265;3996;2;3593376;2343;6;0;0
FR;3;2021-12-05;1;61;5;0;61;5;0;0;0;4416392;3421326;4001;2;3593437;2348;6;0;0
FR;3;2021-12-06;7;375;14;0;374;15;0;0;0;4416399;3421701;4015;2;3593811;2363;6;0;0
FR;3;2021-12-07;6;439;20;0;433;24;1;0;0;4416405;3422140;4035;2;3594244;2387;7;0;0
FR;3;2021-12-08;8;401;29;0;393;30;1;0;0;4416413;3422541;4064;2;3594637;2417;8;0;0
FR;3;2021-12-09;3;452;17;0;438;22;1;0;0;4416416;3422993;4081;2;3595075;2439;9;0;0
FR;3;2021-12-10;11;475;29;0;471;25;0;0;0;4416427;3423468;4110;2;3595546;2464;9;0;0
FR;3;2021-12-11;4;310;10;0;307;9;2;0;0;4416431;3423778;4120;2;3595853;2473;11;0;0
FR;3;2021-12-12;1;99;3;0;99;3;0;0;0;4416432;3423877;4123;2;3595952;2476;11;0;0
FR;3;2021-12-13;2;452;19;0;446;21;0;0;0;4416434;3424329;4142;2;3596398;2497;11;0;0
FR;3;2021-12-14;8;570;18;0;558;21;1;0;0;4416442;3424899;4160;2;3596956;2518;12;0;0
FR;3;2021-12-15;9;548;17;0;535;21;0;0;0;4416451;3425447;4177;2;3597491;2539;12;0;0
FR;3;2021-12-16;10;567;19;0;561;18;3;0;0;4416461;3426014;4196;2;3598052;2557;15;0;0
FR;3;2021-12-17;5;632;18;0;628;19;0;0;0;4416466;3426646;4214;2;3598680;2576;15;0;0
FR;3;2021-12-18;5;361;4;0;355;5;1;0;0;4416471;3427007;4218;2;3599035;2581;16;0;0
FR;3;2021-12-19;3;189;2;0;186;2;0;0;0;4416474;3427196;4220;2;3599221;2583;16;0;0
FR;3;2021-12-20;9;605;23;0;599;28;0;0;0;4416483;3427801;4243;2;3599820;2611;16;0;0
FR;3;2021-12-21;5;686;10;0;678;13;2;0;0;4416488;3428487;4253;2;3600498;2624;18;0;0
FR;3;2021-12-22;10;638;9;0;632;10;1;0;0;4416498;3429125;4262;2;3601130;2634;19;0;0
FR;3;2021-12-23;3;565;8;0;563;8;0;0;0;4416501;3429690;4270;2;3601693;2642;19;0;0
FR;3;2021-12-24;2;241;3;0;236;6;0;0;0;4416503;3429931;4273;2;3601929;2648;19;0;0
FR;3;2021-12-25;0;24;0;0;24;0;0;0;0;4416503;3429955;4273;2;3601953;2648;19;0;0
FR;3;2021-12-26;0;90;1;0;90;1;0;0;0;4416503;3430045;4274;2;3602043;2649;19;0;0
FR;3;2021-12-27;7;474;17;0;471;20;1;0;0;4416510;3430519;4291;2;3602514;2669;20;0;0
FR;3;2021-12-28;3;598;6;0;597;5;0;0;0;4416513;3431117;4297;2;3603111;2674;20;0;0
FR;3;2021-12-29;5;514;14;0;508;16;0;0;0;4416518;3431631;4311;2;3603619;2690;20;0;0
FR;3;2021-12-30;3;531;7;0;524;10;2;0;0;4416521;3432162;4318;2;3604143;2700;22;0;0
FR;3;2021-12-31;0;185;5;0;181;7;0;0;0;4416521;3432347;4323;2;3604324;2707;22;0;0
FR;3;2022-01-01;0;26;0;0;24;2;0;0;0;4416521;3432373;4323;2;3604348;2709;22;0;0
FR;3;2022-01-02;0;79;0;0;79;0;0;0;0;4416521;3432452;4323;2;3604427;2709;22;0;0
FR;3;2022-01-03;4;511;17;0;500;21;3;0;0;4416525;3432963;4340;2;3604927;2730;25;0;0
FR;3;2022-01-04;6;551;9;0;550;8;0;0;0;4416531;3433514;4349;2;3605477;2738;25;0;0
FR;3;2022-01-05;5;504;10;0;496;14;1;0;0;4416536;3434018;4359;2;3605973;2752;26;0;0
FR;3;2022-01-06;6;477;9;0;472;10;1;0;0;4416542;3434495;4368;2;3606445;2762;27;0;0
FR;3;2022-01-07;2;507;11;0;501;13;1;0;1;4416544;3435002;4379;2;3606946;2775;28;0;1
FR;3;2022-01-08;5;255;4;0;252;5;0;0;0;4416549;3435257;4383;2;3607198;2780;28;0;1
FR;3;2022-01-09;0;117;0;0;117;0;0;0;0;4416549;3435374;4383;2;3607315;2780;28;0;1
FR;3;2022-01-10;2;442;12;0;440;12;0;0;0;4416551;3435816;4395;2;3607755;2792;28;0;1
FR;3;2022-01-11;3;467;1;0;466;1;0;0;0;4416554;3436283;4396;2;3608221;2793;28;0;1
FR;3;2022-01-12;4;404;9;0;401;10;2;0;0;4416558;3436687;4405;2;3608622;2803;30;0;1
FR;3;2022-01-13;3;393;11;0;391;12;1;0;0;4416561;3437080;4416;2;3609013;2815;31;0;1
FR;3;2022-01-14;4;431;10;0;425;13;1;0;0;4416565;3437511;4426;2;3609438;2828;32;0;1
FR;3;2022-01-15;0;284;2;0;280;3;0;0;0;4416565;3437795;4428;2;3609718;2831;32;0;1
FR;3;2022-01-16;1;109;1;0;107;1;1;0;0;4416566;3437904;4429;2;3609825;2832;33;0;1
FR;3;2022-01-17;2;327;8;0;324;9;1;0;0;4416568;3438231;4437;2;3610149;2841;34;0;1
FR;3;2022-01-18;2;368;1;0;364;2;1;0;0;4416570;3438599;4438;2;3610513;2843;35;0;1
FR;3;2022-01-19;2;326;5;0;320;10;0;0;0;4416572;3438925;4443;2;3610833;2853;35;0;1
FR;3;2022-01-20;1;354;5;0;353;3;2;0;0;4416573;3439279;4448;2;3611186;2856;37;0;1
FR;3;2022-01-21;4;347;5;0;341;7;2;0;0;4416577;3439626;4453;2;3611527;2863;39;0;1
FR;3;2022-01-22;2;227;1;0;223;2;3;0;0;4416579;3439853;4454;2;3611750;2865;42;0;1
FR;3;2022-01-23;0;78;0;0;76;1;1;0;0;4416579;3439931;4454;2;3611826;2866;43;0;1
FR;3;2022-01-24;2;325;1;0;316;7;2;0;0;4416581;3440256;4455;2;3612142;2873;45;0;1
FR;3;2022-01-25;0;176;0;0;173;0;1;0;0;4416581;3440432;4455;2;3612315;2873;46;0;1
FR;3;2022-01-26;0;77;0;0;77;0;0;0;0;4416581;3440509;4455;2;3612392;2873;46;0;1
FR;3;2022-01-27;0;53;0;0;53;0;0;0;0;4416581;3440562;4455;2;3612445;2873;46;0;1
FR;3;2022-01-28;0;116;0;0;115;0;0;0;0;4416581;3440678;4455;2;3612560;2873;46;0;1
FR;3;2022-01-29;0;98;0;0;98;0;0;0;0;4416581;3440776;4455;2;3612658;2873;46;0;1
FR;3;2022-01-30;0;50;0;0;50;0;0;0;0;4416581;3440826;4455;2;3612708;2873;46;0;1
FR;3;2022-01-31;0;91;0;0;91;0;0;0;0;4416581;3440917;4455;2;3612799;2873;46;0;1
FR;3;2022-02-01;0;98;0;0;96;1;0;0;0;4416581;3441015;4455;2;3612895;2874;46;0;1
FR;3;2022-02-02;0;85;0;0;83;0;0;0;0;4416581;3441100;4455;2;3612978;2874;46;0;1
FR;3;2022-02-03;0;94;0;0;92;0;0;0;0;4416581;3441194;4455;2;3613070;2874;46;0;1
FR;3;2022-02-04;0;115;0;0;112;0;1;0;0;4416581;3441309;4455;2;3613182;2874;47;0;1
FR;3;2022-02-05;0;71;0;0;71;0;0;0;0;4416581;3441380;4455;2;3613253;2874;47;0;1
FR;3;2022-02-06;0;10;0;0;10;0;0;0;0;4416581;3441390;4455;2;3613263;2874;47;0;1
FR;3;2022-02-07;0;76;0;0;76;0;0;0;0;4416581;3441466;4455;2;3613339;2874;47;0;1
FR;3;2022-02-08;0;0;0;0;0;0;0;0;0;4416581;3441466;4455;2;3613339;2874;47;0;1
FR;3;2022-02-09;0;0;0;0;0;0;0;0;0;4416581;3441466;4455;2;3613339;2874;47;0;1
FR;3;2022-02-10;0;0;0;0;0;0;0;0;0;4416581;3441466;4455;2;3613339;2874;47;0;1
FR;3;2022-02-11;0;0;0;0;0;0;0;0;0;4416581;3441466;4455;2;3613339;2874;47;0;1
FR;3;2022-02-12;0;0;0;0;0;0;0;0;0;4416581;3441466;4455;2;3613339;2874;47;0;1
FR;3;2022-02-13;0;0;0;0;0;0;0;0;0;4416581;3441466;4455;2;3613339;2874;47;0;1
FR;3;2022-02-14;0;0;0;0;0;0;0;0;0;4416581;3441466;4455;2;3613339;2874;47;0;1
FR;3;2022-02-15;0;0;0;0;0;0;0;0;0;4416581;3441466;4455;2;3613339;2874;47;0;1
FR;3;2022-02-16;0;0;0;0;0;0;0;0;0;4416581;3441466;4455;2;3613339;2874;47;0;1
FR;3;2022-02-17;0;0;0;0;0;0;0;0;0;4416581;3441466;4455;2;3613339;2874;47;0;1
FR;3;2022-02-18;0;0;0;0;0;0;0;0;0;4416581;3441466;4455;2;3613339;2874;47;0;1
FR;3;2022-02-19;0;0;0;0;0;0;0;0;0;4416581;3441466;4455;2;3613339;2874;47;0;1
FR;3;2022-02-20;0;0;0;0;0;0;0;0;0;4416581;3441466;4455;2;3613339;2874;47;0;1
FR;3;2022-02-21;2;0;0;0;0;0;0;0;0;4416583;3441466;4455;2;3613339;2874;47;0;1
FR;3;2022-02-22;0;0;0;0;0;0;0;0;0;4416583;3441466;4455;2;3613339;2874;47;0;1
FR;3;2022-02-23;0;0;0;0;0;0;0;0;0;4416583;3441466;4455;2;3613339;2874;47;0;1
FR;3;2022-02-24;0;0;0;0;0;0;0;0;0;4416583;3441466;4455;2;3613339;2874;47;0;1
FR;3;2022-02-25;0;0;0;0;0;0;0;0;0;4416583;3441466;4455;2;3613339;2874;47;0;1
FR;3;2022-02-26;0;0;0;0;0;0;0;0;0;4416583;3441466;4455;2;3613339;2874;47;0;1
FR;3;2022-02-27;0;0;0;0;0;0;0;0;0;4416583;3441466;4455;2;3613339;2874;47;0;1
FR;3;2022-02-28;1;0;0;0;0;0;0;0;0;4416584;3441466;4455;2;3613339;2874;47;0;1
FR;3;2022-03-01;1;0;0;0;0;0;0;0;0;4416585;3441466;4455;2;3613339;2874;47;0;1
FR;3;2022-03-02;0;0;0;0;0;0;0;0;0;4416585;3441466;4455;2;3613339;2874;47;0;1
FR;3;2022-03-03;0;0;0;0;0;0;0;0;0;4416585;3441466;4455;2;3613339;2874;47;0;1
FR;3;2022-03-04;0;0;0;0;0;0;0;0;0;4416585;3441466;4455;2;3613339;2874;47;0;1
FR;3;2022-03-05;0;0;0;0;0;0;0;0;0;4416585;3441466;4455;2;3613339;2874;47;0;1
FR;3;2022-03-06;1;0;0;0;0;0;0;0;0;4416586;3441466;4455;2;3613339;2874;47;0;1
FR;3;2022-03-07;0;0;0;0;0;0;0;0;0;4416586;3441466;4455;2;3613339;2874;47;0;1
FR;3;2022-03-08;1;0;0;0;0;0;0;0;0;4416587;3441466;4455;2;3613339;2874;47;0;1
FR;3;2022-03-09;0;0;0;0;0;0;0;0;0;4416587;3441466;4455;2;3613339;2874;47;0;1
FR;3;2022-03-10;0;0;0;0;0;0;0;0;0;4416587;3441466;4455;2;3613339;2874;47;0;1
FR;3;2022-03-11;0;0;0;0;0;0;0;0;0;4416587;3441466;4455;2;3613339;2874;47;0;1
FR;3;2022-03-12;0;0;0;0;0;0;0;0;0;4416587;3441466;4455;2;3613339;2874;47;0;1
FR;3;2022-03-13;0;0;0;0;0;0;0;0;0;4416587;3441466;4455;2;3613339;2874;47;0;1
FR;3;2022-03-14;0;0;0;0;0;0;0;0;0;4416587;3441466;4455;2;3613339;2874;47;0;1
FR;3;2022-03-15;0;0;0;0;0;0;0;0;0;4416587;3441466;4455;2;3613339;2874;47;0;1
FR;3;2022-03-16;0;0;0;0;0;0;0;0;0;4416587;3441466;4455;2;3613339;2874;47;0;1
FR;3;2022-03-17;0;0;0;0;0;0;0;0;0;4416587;3441466;4455;2;3613339;2874;47;0;1
FR;3;2022-03-18;0;0;0;0;0;0;0;0;0;4416587;3441466;4455;2;3613339;2874;47;0;1
FR;3;2022-03-19;0;0;0;0;0;0;0;0;0;4416587;3441466;4455;2;3613339;2874;47;0;1
FR;3;2022-03-20;1;0;0;0;0;0;0;0;0;4416588;3441466;4455;2;3613339;2874;47;0;1
FR;3;2022-03-21;0;0;0;0;0;0;0;0;0;4416588;3441466;4455;2;3613339;2874;47;0;1
FR;3;2022-03-22;0;0;0;0;0;0;0;0;0;4416588;3441466;4455;2;3613339;2874;47;0;1
FR;3;2022-03-23;1;0;0;0;0;0;0;0;0;4416589;3441466;4455;2;3613339;2874;47;0;1
FR;3;2022-03-24;0;0;0;0;0;0;0;0;0;4416589;3441466;4455;2;3613339;2874;47;0;1
FR;3;2022-03-25;1;0;0;0;0;0;0;0;0;4416590;3441466;4455;2;3613339;2874;47;0;1
FR;3;2022-03-26;0;0;0;0;0;0;0;0;0;4416590;3441466;4455;2;3613339;2874;47;0;1
FR;3;2022-03-27;0;0;0;0;0;0;0;0;0;4416590;3441466;4455;2;3613339;2874;47;0;1
FR;3;2022-03-28;0;0;0;0;0;0;0;0;0;4416590;3441466;4455;2;3613339;2874;47;0;1
FR;3;2022-03-29;0;0;0;0;0;0;0;0;0;4416590;3441466;4455;2;3613339;2874;47;0;1
FR;3;2022-03-30;0;0;0;0;0;0;0;0;0;4416590;3441466;4455;2;3613339;2874;47;0;1
FR;3;2022-03-31;0;0;0;0;0;0;0;0;0;4416590;3441466;4455;2;3613339;2874;47;0;1
FR;3;2022-04-01;0;0;0;0;0;0;0;0;0;4416590;3441466;4455;2;3613339;2874;47;0;1
FR;3;2022-04-02;0;0;0;0;0;0;0;0;0;4416590;3441466;4455;2;3613339;2874;47;0;1
FR;3;2022-04-03;0;0;0;0;0;0;0;0;0;4416590;3441466;4455;2;3613339;2874;47;0;1
FR;3;2022-04-04;0;0;0;0;0;0;0;0;0;4416590;3441466;4455;2;3613339;2874;47;0;1
FR;3;2022-04-05;0;0;0;0;0;0;0;0;0;4416590;3441466;4455;2;3613339;2874;47;0;1
FR;3;2022-04-06;0;0;0;0;0;0;0;0;0;4416590;3441466;4455;2;3613339;2874;47;0;1
FR;3;2022-04-07;0;0;0;0;0;0;0;0;0;4416590;3441466;4455;2;3613339;2874;47;0;1
FR;3;2022-04-08;0;0;0;0;0;0;0;0;0;4416590;3441466;4455;2;3613339;2874;47;0;1
FR;3;2022-04-09;0;0;0;0;0;0;0;0;0;4416590;3441466;4455;2;3613339;2874;47;0;1
FR;3;2022-04-10;0;0;0;0;0;0;0;0;0;4416590;3441466;4455;2;3613339;2874;47;0;1
FR;3;2022-04-11;0;0;0;0;0;0;0;0;0;4416590;3441466;4455;2;3613339;2874;47;0;1
FR;3;2022-04-12;0;0;0;0;0;0;0;0;0;4416590;3441466;4455;2;3613339;2874;47;0;1
FR;3;2022-04-13;0;0;0;0;0;0;0;0;0;4416590;3441466;4455;2;3613339;2874;47;0;1
FR;3;2022-04-14;0;0;0;0;0;0;0;0;0;4416590;3441466;4455;2;3613339;2874;47;0;1
FR;3;2022-04-15;1;0;0;0;0;0;0;0;0;4416591;3441466;4455;2;3613339;2874;47;0;1
FR;3;2022-04-16;0;0;0;0;0;0;0;0;0;4416591;3441466;4455;2;3613339;2874;47;0;1
FR;3;2022-04-17;0;0;0;0;0;0;0;0;0;4416591;3441466;4455;2;3613339;2874;47;0;1
FR;3;2022-04-18;0;0;0;0;0;0;0;0;0;4416591;3441466;4455;2;3613339;2874;47;0;1
FR;3;2022-04-19;0;0;0;0;0;0;0;0;0;4416591;3441466;4455;2;3613339;2874;47;0;1
FR;3;2022-04-20;0;0;0;0;0;0;0;0;0;4416591;3441466;4455;2;3613339;2874;47;0;1
FR;3;2022-04-21;0;0;0;0;0;0;0;0;0;4416591;3441466;4455;2;3613339;2874;47;0;1
FR;3;2022-04-22;0;0;0;0;0;0;0;0;0;4416591;3441466;4455;2;3613339;2874;47;0;1
FR;3;2022-04-23;0;0;0;0;0;0;0;0;0;4416591;3441466;4455;2;3613339;2874;47;0;1
FR;3;2022-04-24;0;0;0;0;0;0;0;0;0;4416591;3441466;4455;2;3613339;2874;47;0;1
FR;3;2022-04-25;0;0;0;0;0;0;0;0;0;4416591;3441466;4455;2;3613339;2874;47;0;1
FR;3;2022-04-26;0;0;0;0;0;0;0;0;0;4416591;3441466;4455;2;3613339;2874;47;0;1
FR;3;2022-04-27;0;0;0;0;0;0;0;0;0;4416591;3441466;4455;2;3613339;2874;47;0;1
FR;3;2022-04-28;0;0;0;0;0;0;0;0;0;4416591;3441466;4455;2;3613339;2874;47;0;1
FR;3;2022-04-29;0;0;0;0;0;0;0;0;0;4416591;3441466;4455;2;3613339;2874;47;0;1
FR;3;2022-04-30;0;0;0;0;0;0;0;0;0;4416591;3441466;4455;2;3613339;2874;47;0;1
FR;3;2022-05-01;0;0;0;0;0;0;0;0;0;4416591;3441466;4455;2;3613339;2874;47;0;1
FR;3;2022-05-02;0;0;0;0;0;0;0;0;0;4416591;3441466;4455;2;3613339;2874;47;0;1
FR;3;2022-05-03;0;0;0;0;0;0;0;0;0;4416591;3441466;4455;2;3613339;2874;47;0;1
FR;3;2022-05-04;0;0;0;0;0;0;0;0;0;4416591;3441466;4455;2;3613339;2874;47;0;1
FR;3;2022-05-05;0;0;0;0;0;0;0;0;0;4416591;3441466;4455;2;3613339;2874;47;0;1
FR;3;2022-05-06;0;0;0;0;0;0;0;0;0;4416591;3441466;4455;2;3613339;2874;47;0;1
FR;3;2022-05-07;0;0;0;0;0;0;0;0;0;4416591;3441466;4455;2;3613339;2874;47;0;1
FR;3;2022-05-08;0;0;0;0;0;0;0;0;0;4416591;3441466;4455;2;3613339;2874;47;0;1
FR;3;2022-05-09;0;0;0;0;0;0;0;0;0;4416591;3441466;4455;2;3613339;2874;47;0;1
FR;3;2022-05-10;0;0;0;0;0;0;0;0;0;4416591;3441466;4455;2;3613339;2874;47;0;1
FR;3;2022-05-11;0;0;0;0;0;0;0;0;0;4416591;3441466;4455;2;3613339;2874;47;0;1
FR;3;2022-05-12;0;0;0;0;0;0;0;0;0;4416591;3441466;4455;2;3613339;2874;47;0;1
FR;3;2022-05-13;0;0;0;0;0;0;0;0;0;4416591;3441466;4455;2;3613339;2874;47;0;1
FR;3;2022-05-14;1;0;0;0;0;0;0;0;0;4416592;3441466;4455;2;3613339;2874;47;0;1
FR;3;2022-05-15;0;0;0;0;0;0;0;0;0;4416592;3441466;4455;2;3613339;2874;47;0;1
FR;3;2022-05-16;0;0;0;0;0;0;0;0;0;4416592;3441466;4455;2;3613339;2874;47;0;1
FR;3;2022-05-17;0;0;0;0;0;0;0;0;0;4416592;3441466;4455;2;3613339;2874;47;0;1
FR;3;2022-05-18;0;0;0;0;0;0;0;0;0;4416592;3441466;4455;2;3613339;2874;47;0;1
FR;3;2022-05-19;0;0;0;0;0;0;0;0;0;4416592;3441466;4455;2;3613339;2874;47;0;1
FR;3;2022-05-20;0;0;0;0;0;0;0;0;0;4416592;3441466;4455;2;3613339;2874;47;0;1
FR;3;2022-05-21;0;0;0;0;0;0;0;0;0;4416592;3441466;4455;2;3613339;2874;47;0;1
FR;3;2022-05-22;0;0;0;0;0;0;0;0;0;4416592;3441466;4455;2;3613339;2874;47;0;1
FR;3;2022-05-23;0;0;0;0;0;0;0;0;0;4416592;3441466;4455;2;3613339;2874;47;0;1
FR;3;2022-05-24;0;0;0;0;0;0;0;0;0;4416592;3441466;4455;2;3613339;2874;47;0;1
FR;3;2022-05-25;0;0;0;0;0;0;0;0;0;4416592;3441466;4455;2;3613339;2874;47;0;1
FR;3;2022-05-26;0;0;0;0;0;0;0;0;0;4416592;3441466;4455;2;3613339;2874;47;0;1
FR;3;2022-05-27;0;0;0;0;0;0;0;0;0;4416592;3441466;4455;2;3613339;2874;47;0;1
FR;3;2022-05-28;0;0;0;0;0;0;0;0;0;4416592;3441466;4455;2;3613339;2874;47;0;1
FR;3;2022-05-29;0;0;0;0;0;0;0;0;0;4416592;3441466;4455;2;3613339;2874;47;0;1
FR;3;2022-05-30;0;0;0;0;0;0;0;0;0;4416592;3441466;4455;2;3613339;2874;47;0;1
FR;3;2022-05-31;0;0;0;0;0;0;0;0;0;4416592;3441466;4455;2;3613339;2874;47;0;1
FR;3;2022-06-01;0;0;0;0;0;0;0;0;0;4416592;3441466;4455;2;3613339;2874;47;0;1
FR;3;2022-06-02;0;0;0;0;0;0;0;0;0;4416592;3441466;4455;2;3613339;2874;47;0;1
FR;3;2022-06-03;0;0;0;0;0;0;0;0;0;4416592;3441466;4455;2;3613339;2874;47;0;1
FR;3;2022-06-04;0;0;0;0;0;0;0;0;0;4416592;3441466;4455;2;3613339;2874;47;0;1
FR;3;2022-06-05;0;0;0;0;0;0;0;0;0;4416592;3441466;4455;2;3613339;2874;47;0;1
FR;3;2022-06-06;0;0;0;0;0;0;0;0;0;4416592;3441466;4455;2;3613339;2874;47;0;1
FR;3;2022-06-07;0;0;0;0;0;0;0;0;0;4416592;3441466;4455;2;3613339;2874;47;0;1
FR;3;2022-06-08;0;0;0;0;0;0;0;0;0;4416592;3441466;4455;2;3613339;2874;47;0;1
FR;3;2022-06-09;0;0;0;0;0;0;0;0;0;4416592;3441466;4455;2;3613339;2874;47;0;1
FR;3;2022-06-10;0;0;0;0;0;0;0;0;0;4416592;3441466;4455;2;3613339;2874;47;0;1
FR;3;2022-06-11;0;0;0;0;0;0;0;0;0;4416592;3441466;4455;2;3613339;2874;47;0;1
FR;3;2022-06-12;0;0;0;0;0;0;0;0;0;4416592;3441466;4455;2;3613339;2874;47;0;1
FR;3;2022-06-13;1;0;0;0;0;0;0;0;0;4416593;3441466;4455;2;3613339;2874;47;0;1
FR;3;2022-06-14;0;0;0;0;0;0;0;0;0;4416593;3441466;4455;2;3613339;2874;47;0;1
FR;3;2022-06-15;0;0;0;0;0;0;0;0;0;4416593;3441466;4455;2;3613339;2874;47;0;1
FR;3;2022-06-16;0;0;0;0;0;0;0;0;0;4416593;3441466;4455;2;3613339;2874;47;0;1
FR;3;2022-06-17;0;0;0;0;0;0;0;0;0;4416593;3441466;4455;2;3613339;2874;47;0;1
FR;3;2022-06-18;0;0;0;0;0;0;0;0;0;4416593;3441466;4455;2;3613339;2874;47;0;1
FR;3;2022-06-19;0;0;0;0;0;0;0;0;0;4416593;3441466;4455;2;3613339;2874;47;0;1
FR;3;2022-06-20;0;0;0;0;0;0;0;0;0;4416593;3441466;4455;2;3613339;2874;47;0;1
FR;3;2022-06-21;0;0;0;0;0;0;0;0;0;4416593;3441466;4455;2;3613339;2874;47;0;1
FR;3;2022-06-22;0;0;0;0;0;0;0;0;0;4416593;3441466;4455;2;3613339;2874;47;0;1
FR;3;2022-06-23;0;0;0;0;0;0;0;0;0;4416593;3441466;4455;2;3613339;2874;47;0;1
FR;3;2022-06-24;0;0;0;0;0;0;0;0;0;4416593;3441466;4455;2;3613339;2874;47;0;1
FR;3;2022-06-25;0;0;0;0;0;0;0;0;0;4416593;3441466;4455;2;3613339;2874;47;0;1
FR;3;2022-06-26;0;0;0;0;0;0;0;0;0;4416593;3441466;4455;2;3613339;2874;47;0;1
FR;3;2022-06-27;0;0;0;0;0;0;0;0;0;4416593;3441466;4455;2;3613339;2874;47;0;1
FR;3;2022-06-28;0;0;0;0;0;0;0;0;0;4416593;3441466;4455;2;3613339;2874;47;0;1
FR;3;2022-06-29;1;0;0;0;0;0;0;0;0;4416594;3441466;4455;2;3613339;2874;47;0;1
FR;3;2022-06-30;0;0;0;0;0;0;0;0;0;4416594;3441466;4455;2;3613339;2874;47;0;1
FR;3;2022-07-01;0;0;0;0;0;0;0;0;0;4416594;3441466;4455;2;3613339;2874;47;0;1
FR;3;2022-07-02;0;0;0;0;0;0;0;0;0;4416594;3441466;4455;2;3613339;2874;47;0;1
FR;3;2022-07-03;0;0;0;0;0;0;0;0;0;4416594;3441466;4455;2;3613339;2874;47;0;1
FR;3;2022-07-04;0;0;0;0;0;0;0;0;0;4416594;3441466;4455;2;3613339;2874;47;0;1
FR;3;2022-07-05;0;0;0;0;0;0;0;0;0;4416594;3441466;4455;2;3613339;2874;47;0;1
FR;3;2022-07-06;0;0;0;0;0;0;0;0;0;4416594;3441466;4455;2;3613339;2874;47;0;1
FR;3;2022-07-07;0;0;0;0;0;0;0;0;0;4416594;3441466;4455;2;3613339;2874;47;0;1
FR;3;2022-07-08;0;0;0;0;0;0;0;0;0;4416594;3441466;4455;2;3613339;2874;47;0;1
FR;3;2022-07-09;0;0;0;0;0;0;0;0;0;4416594;3441466;4455;2;3613339;2874;47;0;1
FR;3;2022-07-10;0;0;0;0;0;0;0;0;0;4416594;3441466;4455;2;3613339;2874;47;0;1
FR;3;2022-07-11;0;0;0;0;0;0;0;0;0;4416594;3441466;4455;2;3613339;2874;47;0;1
FR;3;2022-07-12;0;0;0;0;0;0;0;0;0;4416594;3441466;4455;2;3613339;2874;47;0;1
FR;3;2022-07-13;0;0;0;0;0;0;0;0;0;4416594;3441466;4455;2;3613339;2874;47;0;1
FR;3;2022-07-14;0;0;0;0;0;0;0;0;0;4416594;3441466;4455;2;3613339;2874;47;0;1
FR;3;2022-07-15;0;0;0;0;0;0;0;0;0;4416594;3441466;4455;2;3613339;2874;47;0;1
FR;3;2022-07-16;0;0;0;0;0;0;0;0;0;4416594;3441466;4455;2;3613339;2874;47;0;1
FR;3;2022-07-17;0;0;0;0;0;0;0;0;0;4416594;3441466;4455;2;3613339;2874;47;0;1
FR;3;2022-07-18;0;0;0;0;0;0;0;0;0;4416594;3441466;4455;2;3613339;2874;47;0;1
FR;3;2022-07-19;0;0;0;0;0;0;0;0;0;4416594;3441466;4455;2;3613339;2874;47;0;1
FR;3;2022-07-20;0;0;0;0;0;0;0;0;0;4416594;3441466;4455;2;3613339;2874;47;0;1
FR;3;2022-07-21;0;0;0;0;0;0;0;0;0;4416594;3441466;4455;2;3613339;2874;47;0;1
FR;3;2022-07-22;0;0;0;0;0;0;0;0;0;4416594;3441466;4455;2;3613339;2874;47;0;1
FR;3;2022-07-23;0;0;0;0;0;0;0;0;0;4416594;3441466;4455;2;3613339;2874;47;0;1
FR;3;2022-07-24;0;0;0;0;0;0;0;0;0;4416594;3441466;4455;2;3613339;2874;47;0;1
FR;3;2022-07-25;0;0;0;0;0;0;0;0;0;4416594;3441466;4455;2;3613339;2874;47;0;1
FR;3;2022-07-26;0;0;0;0;0;0;0;0;0;4416594;3441466;4455;2;3613339;2874;47;0;1
FR;3;2022-07-27;0;0;0;0;0;0;0;0;0;4416594;3441466;4455;2;3613339;2874;47;0;1
FR;3;2022-07-28;0;0;0;0;0;0;0;0;0;4416594;3441466;4455;2;3613339;2874;47;0;1
FR;3;2022-07-29;0;0;0;0;0;0;0;0;0;4416594;3441466;4455;2;3613339;2874;47;0;1
FR;3;2022-07-30;0;0;0;0;0;0;0;0;0;4416594;3441466;4455;2;3613339;2874;47;0;1
FR;3;2022-07-31;0;0;0;0;0;0;0;0;0;4416594;3441466;4455;2;3613339;2874;47;0;1
FR;3;2022-08-01;0;0;0;0;0;0;0;0;0;4416594;3441466;4455;2;3613339;2874;47;0;1
FR;3;2022-08-02;0;0;0;0;0;0;0;0;0;4416594;3441466;4455;2;3613339;2874;47;0;1
FR;3;2022-08-03;0;0;0;0;0;0;0;0;0;4416594;3441466;4455;2;3613339;2874;47;0;1
FR;3;2022-08-04;0;0;0;0;0;0;0;0;0;4416594;3441466;4455;2;3613339;2874;47;0;1
FR;3;2022-08-05;0;0;0;0;0;0;0;0;0;4416594;3441466;4455;2;3613339;2874;47;0;1
FR;3;2022-08-06;0;0;0;0;0;0;0;0;0;4416594;3441466;4455;2;3613339;2874;47;0;1
FR;3;2022-08-07;0;0;0;0;0;0;0;0;0;4416594;3441466;4455;2;3613339;2874;47;0;1
FR;3;2022-08-08;0;0;0;0;0;0;0;0;0;4416594;3441466;4455;2;3613339;2874;47;0;1
FR;3;2022-08-09;0;0;0;0;0;0;0;0;0;4416594;3441466;4455;2;3613339;2874;47;0;1
FR;3;2022-08-10;0;0;0;0;0;0;0;0;0;4416594;3441466;4455;2;3613339;2874;47;0;1
FR;3;2022-08-11;0;0;0;0;0;0;0;0;0;4416594;3441466;4455;2;3613339;2874;47;0;1
FR;3;2022-08-12;0;0;0;0;0;0;0;0;0;4416594;3441466;4455;2;3613339;2874;47;0;1
FR;3;2022-08-13;0;0;0;0;0;0;0;0;0;4416594;3441466;4455;2;3613339;2874;47;0;1
FR;3;2022-08-14;0;0;0;0;0;0;0;0;0;4416594;3441466;4455;2;3613339;2874;47;0;1
FR;3;2022-08-15;0;0;0;0;0;0;0;0;0;4416594;3441466;4455;2;3613339;2874;47;0;1
FR;3;2022-08-16;0;0;0;0;0;0;0;0;0;4416594;3441466;4455;2;3613339;2874;47;0;1
FR;3;2022-08-17;0;0;0;0;0;0;0;0;0;4416594;3441466;4455;2;3613339;2874;47;0;1
FR;3;2022-08-18;0;0;0;0;0;0;0;0;0;4416594;3441466;4455;2;3613339;2874;47;0;1
FR;3;2022-08-19;0;0;0;0;0;0;0;0;0;4416594;3441466;4455;2;3613339;2874;47;0;1
FR;3;2022-08-20;0;0;0;0;0;0;0;0;0;4416594;3441466;4455;2;3613339;2874;47;0;1
FR;3;2022-08-21;0;0;0;0;0;0;0;0;0;4416594;3441466;4455;2;3613339;2874;47;0;1
FR;3;2022-08-22;0;0;0;0;0;0;0;0;0;4416594;3441466;4455;2;3613339;2874;47;0;1
FR;3;2022-08-23;0;0;0;0;0;0;0;0;0;4416594;3441466;4455;2;3613339;2874;47;0;1
FR;3;2022-08-24;0;0;0;0;0;0;0;0;0;4416594;3441466;4455;2;3613339;2874;47;0;1
FR;3;2022-08-25;0;0;0;0;0;0;0;0;0;4416594;3441466;4455;2;3613339;2874;47;0;1
FR;3;2022-08-26;0;0;0;0;0;0;0;0;0;4416594;3441466;4455;2;3613339;2874;47;0;1
FR;3;2022-08-27;0;0;0;0;0;0;0;0;0;4416594;3441466;4455;2;3613339;2874;47;0;1
FR;3;2022-08-28;0;0;0;0;0;0;0;0;0;4416594;3441466;4455;2;3613339;2874;47;0;1
FR;3;2022-08-29;0;0;0;0;0;0;0;0;0;4416594;3441466;4455;2;3613339;2874;47;0;1
FR;3;2022-08-30;0;0;0;0;0;0;0;0;0;4416594;3441466;4455;2;3613339;2874;47;0;1
FR;3;2022-08-31;0;0;0;0;0;0;0;0;0;4416594;3441466;4455;2;3613339;2874;47;0;1
FR;3;2022-09-01;0;0;0;0;0;0;0;0;0;4416594;3441466;4455;2;3613339;2874;47;0;1
FR;3;2022-09-02;0;0;0;0;0;0;0;0;0;4416594;3441466;4455;2;3613339;2874;47;0;1
FR;3;2022-09-03;0;0;0;0;0;0;0;0;0;4416594;3441466;4455;2;3613339;2874;47;0;1
FR;3;2022-09-04;0;0;0;0;0;0;0;0;0;4416594;3441466;4455;2;3613339;2874;47;0;1
FR;3;2022-09-05;0;0;0;0;0;0;0;0;0;4416594;3441466;4455;2;3613339;2874;47;0;1
FR;3;2022-09-06;0;0;0;0;0;0;0;0;0;4416594;3441466;4455;2;3613339;2874;47;0;1
FR;3;2022-09-07;0;0;0;0;0;0;0;0;0;4416594;3441466;4455;2;3613339;2874;47;0;1
FR;3;2022-09-08;0;0;0;0;0;0;0;0;0;4416594;3441466;4455;2;3613339;2874;47;0;1
FR;3;2022-09-09;0;0;0;0;0;0;0;0;0;4416594;3441466;4455;2;3613339;2874;47;0;1
FR;3;2022-09-10;0;0;0;0;0;0;0;0;0;4416594;3441466;4455;2;3613339;2874;47;0;1
FR;3;2022-09-11;0;0;0;0;0;0;0;0;0;4416594;3441466;4455;2;3613339;2874;47;0;1
FR;3;2022-09-12;0;0;0;0;0;0;0;0;0;4416594;3441466;4455;2;3613339;2874;47;0;1
FR;3;2022-09-13;0;0;0;0;0;0;0;0;0;4416594;3441466;4455;2;3613339;2874;47;0;1
FR;3;2022-09-14;0;0;0;0;0;0;0;0;0;4416594;3441466;4455;2;3613339;2874;47;0;1
FR;3;2022-09-15;0;0;0;0;0;0;0;0;0;4416594;3441466;4455;2;3613339;2874;47;0;1
FR;3;2022-09-16;0;0;0;0;0;0;0;0;0;4416594;3441466;4455;2;3613339;2874;47;0;1
FR;3;2022-09-17;0;0;0;0;0;0;0;0;0;4416594;3441466;4455;2;3613339;2874;47;0;1
FR;3;2022-09-18;0;0;0;0;0;0;0;0;0;4416594;3441466;4455;2;3613339;2874;47;0;1
FR;3;2022-09-19;0;0;0;0;0;0;0;0;0;4416594;3441466;4455;2;3613339;2874;47;0;1
FR;3;2022-09-20;0;0;0;0;0;0;0;0;0;4416594;3441466;4455;2;3613339;2874;47;0;1
FR;3;2022-09-21;0;0;0;0;0;0;0;0;0;4416594;3441466;4455;2;3613339;2874;47;0;1
FR;3;2022-09-22;0;0;0;0;0;0;0;0;0;4416594;3441466;4455;2;3613339;2874;47;0;1
FR;3;2022-09-23;0;0;0;0;0;0;0;0;0;4416594;3441466;4455;2;3613339;2874;47;0;1
FR;3;2022-09-24;0;0;0;0;0;0;0;0;0;4416594;3441466;4455;2;3613339;2874;47;0;1
FR;3;2022-09-25;0;0;0;0;0;0;0;0;0;4416594;3441466;4455;2;3613339;2874;47;0;1
FR;3;2022-09-26;0;0;0;0;0;0;0;0;0;4416594;3441466;4455;2;3613339;2874;47;0;1
FR;3;2022-09-27;0;0;0;0;0;0;0;0;0;4416594;3441466;4455;2;3613339;2874;47;0;1
FR;3;2022-09-28;0;0;0;0;0;0;0;0;0;4416594;3441466;4455;2;3613339;2874;47;0;1
FR;3;2022-09-29;0;0;0;0;0;0;0;0;0;4416594;3441466;4455;2;3613339;2874;47;0;1
FR;3;2022-09-30;0;0;0;0;0;0;0;0;0;4416594;3441466;4455;2;3613339;2874;47;0;1
FR;3;2022-10-01;0;0;0;0;0;0;0;0;0;4416594;3441466;4455;2;3613339;2874;47;0;1
FR;3;2022-10-02;0;0;0;0;0;0;0;0;0;4416594;3441466;4455;2;3613339;2874;47;0;1
FR;3;2022-10-03;0;0;0;0;0;0;0;0;0;4416594;3441466;4455;2;3613339;2874;47;0;1
FR;3;2022-10-04;0;0;0;0;0;0;0;0;0;4416594;3441466;4455;2;3613339;2874;47;0;1
FR;3;2022-10-05;0;0;0;0;0;0;0;0;0;4416594;3441466;4455;2;3613339;2874;47;0;1
FR;3;2022-10-06;0;0;0;0;0;0;0;0;0;4416594;3441466;4455;2;3613339;2874;47;0;1
FR;3;2022-10-07;0;0;0;0;0;0;0;0;0;4416594;3441466;4455;2;3613339;2874;47;0;1
FR;3;2022-10-08;0;0;0;0;0;0;0;0;0;4416594;3441466;4455;2;3613339;2874;47;0;1
FR;3;2022-10-09;0;0;0;0;0;0;0;0;0;4416594;3441466;4455;2;3613339;2874;47;0;1
FR;3;2022-10-10;0;0;0;0;0;0;0;0;0;4416594;3441466;4455;2;3613339;2874;47;0;1
FR;3;2022-10-11;0;0;0;0;0;0;0;0;0;4416594;3441466;4455;2;3613339;2874;47;0;1
FR;3;2022-10-12;0;0;0;0;0;0;0;0;0;4416594;3441466;4455;2;3613339;2874;47;0;1
FR;3;2022-10-13;0;0;0;0;0;0;0;0;0;4416594;3441466;4455;2;3613339;2874;47;0;1
FR;3;2022-10-14;0;0;0;0;0;0;0;0;0;4416594;3441466;4455;2;3613339;2874;47;0;1
FR;3;2022-10-15;0;0;0;0;0;0;0;0;0;4416594;3441466;4455;2;3613339;2874;47;0;1
FR;3;2022-10-16;0;0;0;0;0;0;0;0;0;4416594;3441466;4455;2;3613339;2874;47;0;1
FR;3;2022-10-17;0;0;0;0;0;0;0;0;0;4416594;3441466;4455;2;3613339;2874;47;0;1
FR;3;2022-10-18;0;0;0;0;0;0;0;0;0;4416594;3441466;4455;2;3613339;2874;47;0;1
FR;3;2022-10-19;0;0;0;0;0;0;0;0;0;4416594;3441466;4455;2;3613339;2874;47;0;1
FR;3;2022-10-20;0;0;0;0;0;0;0;0;0;4416594;3441466;4455;2;3613339;2874;47;0;1
FR;3;2022-10-21;0;0;0;0;0;0;0;0;0;4416594;3441466;4455;2;3613339;2874;47;0;1
FR;3;2022-10-22;0;0;0;0;0;0;0;0;0;4416594;3441466;4455;2;3613339;2874;47;0;1
FR;3;2022-10-23;0;0;0;0;0;0;0;0;0;4416594;3441466;4455;2;3613339;2874;47;0;1
FR;3;2022-10-24;0;0;0;0;0;0;0;0;0;4416594;3441466;4455;2;3613339;2874;47;0;1
FR;3;2022-10-25;0;0;0;0;0;0;0;0;0;4416594;3441466;4455;2;3613339;2874;47;0;1
FR;3;2022-10-26;0;0;0;0;0;0;0;0;0;4416594;3441466;4455;2;3613339;2874;47;0;1
FR;3;2022-10-27;0;0;0;0;0;0;0;0;0;4416594;3441466;4455;2;3613339;2874;47;0;1
FR;3;2022-10-28;0;0;0;0;0;0;0;0;0;4416594;3441466;4455;2;3613339;2874;47;0;1
FR;3;2022-10-29;0;0;0;0;0;0;0;0;0;4416594;3441466;4455;2;3613339;2874;47;0;1
FR;3;2022-10-30;0;0;0;0;0;0;0;0;0;4416594;3441466;4455;2;3613339;2874;47;0;1
FR;3;2022-10-31;0;0;0;0;0;0;0;0;0;4416594;3441466;4455;2;3613339;2874;47;0;1
FR;3;2022-11-01;0;0;0;0;0;0;0;0;0;4416594;3441466;4455;2;3613339;2874;47;0;1
FR;3;2022-11-02;0;0;0;0;0;0;0;0;0;4416594;3441466;4455;2;3613339;2874;47;0;1
FR;3;2022-11-03;0;0;0;0;0;0;0;0;0;4416594;3441466;4455;2;3613339;2874;47;0;1
FR;3;2022-11-04;0;0;0;0;0;0;0;0;0;4416594;3441466;4455;2;3613339;2874;47;0;1
FR;3;2022-11-05;0;0;0;0;0;0;0;0;0;4416594;3441466;4455;2;3613339;2874;47;0;1
FR;3;2022-11-06;0;0;0;0;0;0;0;0;0;4416594;3441466;4455;2;3613339;2874;47;0;1
FR;3;2022-11-07;0;0;0;0;0;0;0;0;0;4416594;3441466;4455;2;3613339;2874;47;0;1
FR;3;2022-11-08;1;0;0;0;0;0;0;0;0;4416595;3441466;4455;2;3613339;2874;47;0;1
FR;3;2022-11-09;0;0;0;0;0;0;0;0;0;4416595;3441466;4455;2;3613339;2874;47;0;1
FR;3;2022-11-10;0;0;0;0;0;0;0;0;0;4416595;3441466;4455;2;3613339;2874;47;0;1
FR;3;2022-11-11;0;0;0;0;0;0;0;0;0;4416595;3441466;4455;2;3613339;2874;47;0;1
FR;3;2022-11-12;0;0;0;0;0;0;0;0;0;4416595;3441466;4455;2;3613339;2874;47;0;1
FR;3;2022-11-13;0;0;0;0;0;0;0;0;0;4416595;3441466;4455;2;3613339;2874;47;0;1
FR;3;2022-11-14;0;0;0;0;0;0;0;0;0;4416595;3441466;4455;2;3613339;2874;47;0;1
FR;3;2022-11-15;0;0;0;0;0;0;0;0;0;4416595;3441466;4455;2;3613339;2874;47;0;1
FR;3;2022-11-16;0;0;0;0;0;0;0;0;0;4416595;3441466;4455;2;3613339;2874;47;0;1
FR;3;2022-11-17;0;0;0;0;0;0;0;0;0;4416595;3441466;4455;2;3613339;2874;47;0;1
FR;3;2022-11-18;0;0;0;0;0;0;0;0;0;4416595;3441466;4455;2;3613339;2874;47;0;1
FR;3;2022-11-19;0;0;0;0;0;0;0;0;0;4416595;3441466;4455;2;3613339;2874;47;0;1
FR;3;2022-11-20;0;0;0;0;0;0;0;0;0;4416595;3441466;4455;2;3613339;2874;47;0;1
FR;3;2022-11-21;0;0;0;0;0;0;0;0;0;4416595;3441466;4455;2;3613339;2874;47;0;1
FR;3;2022-11-22;0;0;0;0;0;0;0;0;0;4416595;3441466;4455;2;3613339;2874;47;0;1
FR;3;2022-11-23;0;0;0;0;0;0;0;0;0;4416595;3441466;4455;2;3613339;2874;47;0;1
FR;3;2022-11-24;0;0;0;0;0;0;0;0;0;4416595;3441466;4455;2;3613339;2874;47;0;1
FR;3;2022-11-25;0;0;0;0;0;0;0;0;0;4416595;3441466;4455;2;3613339;2874;47;0;1
FR;3;2022-11-26;0;0;0;0;0;0;0;0;0;4416595;3441466;4455;2;3613339;2874;47;0;1
FR;3;2022-11-27;0;0;0;0;0;0;0;0;0;4416595;3441466;4455;2;3613339;2874;47;0;1
FR;3;2022-11-28;0;0;0;0;0;0;0;0;0;4416595;3441466;4455;2;3613339;2874;47;0;1
FR;3;2022-11-29;0;0;0;0;0;0;0;0;0;4416595;3441466;4455;2;3613339;2874;47;0;1
FR;3;2022-11-30;0;0;0;0;0;0;0;0;0;4416595;3441466;4455;2;3613339;2874;47;0;1
FR;3;2022-12-01;0;0;0;0;0;0;0;0;0;4416595;3441466;4455;2;3613339;2874;47;0;1
FR;3;2022-12-02;0;0;0;0;0;0;0;0;0;4416595;3441466;4455;2;3613339;2874;47;0;1
FR;3;2022-12-03;0;0;0;0;0;0;0;0;0;4416595;3441466;4455;2;3613339;2874;47;0;1
FR;3;2022-12-04;0;0;0;0;0;0;0;0;0;4416595;3441466;4455;2;3613339;2874;47;0;1
FR;3;2022-12-05;0;0;0;0;0;0;0;0;0;4416595;3441466;4455;2;3613339;2874;47;0;1
FR;3;2022-12-06;0;0;0;0;0;0;0;0;0;4416595;3441466;4455;2;3613339;2874;47;0;1
FR;3;2022-12-07;0;0;0;0;0;0;0;0;0;4416595;3441466;4455;2;3613339;2874;47;0;1
FR;3;2022-12-08;0;0;0;0;0;0;0;0;0;4416595;3441466;4455;2;3613339;2874;47;0;1
FR;3;2022-12-09;0;0;0;0;0;0;0;0;0;4416595;3441466;4455;2;3613339;2874;47;0;1
FR;3;2022-12-10;0;0;0;0;0;0;0;0;0;4416595;3441466;4455;2;3613339;2874;47;0;1
FR;3;2022-12-11;0;0;0;0;0;0;0;0;0;4416595;3441466;4455;2;3613339;2874;47;0;1
FR;3;2022-12-12;0;0;0;0;0;0;0;0;0;4416595;3441466;4455;2;3613339;2874;47;0;1
FR;3;2022-12-13;0;0;0;0;0;0;0;0;0;4416595;3441466;4455;2;3613339;2874;47;0;1
FR;4;2020-12-27;0;0;0;0;0;0;0;0;0;0;0;0;0;0;0;0;0;0
FR;4;2020-12-28;0;0;0;0;0;0;0;0;0;0;0;0;0;0;0;0;0;0
FR;4;2020-12-29;0;0;0;0;0;0;0;0;0;0;0;0;0;0;0;0;0;0
FR;4;2020-12-30;0;0;0;0;0;0;0;0;0;0;0;0;0;0;0;0;0;0
FR;4;2020-12-31;0;0;0;0;0;0;0;0;0;0;0;0;0;0;0;0;0;0
FR;4;2021-01-01;0;0;0;0;0;0;0;0;0;0;0;0;0;0;0;0;0;0
FR;4;2021-01-02;0;0;0;0;0;0;0;0;0;0;0;0;0;0;0;0;0;0
FR;4;2021-01-03;0;0;0;0;0;0;0;0;0;0;0;0;0;0;0;0;0;0
FR;4;2021-01-04;0;0;0;0;0;0;0;0;0;0;0;0;0;0;0;0;0;0
FR;4;2021-01-05;0;0;0;0;0;0;0;0;0;0;0;0;0;0;0;0;0;0
FR;4;2021-01-06;0;0;0;0;0;0;0;0;0;0;0;0;0;0;0;0;0;0
FR;4;2021-01-07;0;0;0;0;0;0;0;0;0;0;0;0;0;0;0;0;0;0
FR;4;2021-01-08;0;0;0;0;0;0;0;0;0;0;0;0;0;0;0;0;0;0
FR;4;2021-01-09;0;0;0;0;0;0;0;0;0;0;0;0;0;0;0;0;0;0
FR;4;2021-01-10;0;0;0;0;0;0;0;0;0;0;0;0;0;0;0;0;0;0
FR;4;2021-01-11;0;0;0;0;0;0;0;0;0;0;0;0;0;0;0;0;0;0
FR;4;2021-01-12;0;0;0;0;0;0;0;0;0;0;0;0;0;0;0;0;0;0
FR;4;2021-01-13;0;0;0;0;0;0;0;0;0;0;0;0;0;0;0;0;0;0
FR;4;2021-01-14;0;0;0;0;0;0;0;0;0;0;0;0;0;0;0;0;0;0
FR;4;2021-01-15;0;0;0;0;0;0;0;0;0;0;0;0;0;0;0;0;0;0
FR;4;2021-01-16;0;0;0;0;0;0;0;0;0;0;0;0;0;0;0;0;0;0
FR;4;2021-01-17;0;0;0;0;0;0;0;0;0;0;0;0;0;0;0;0;0;0
FR;4;2021-01-18;0;0;0;0;0;0;0;0;0;0;0;0;0;0;0;0;0;0
FR;4;2021-01-19;0;0;0;0;0;0;0;0;0;0;0;0;0;0;0;0;0;0
FR;4;2021-01-20;0;0;0;0;0;0;0;0;0;0;0;0;0;0;0;0;0;0
FR;4;2021-01-21;0;0;0;0;0;0;0;0;0;0;0;0;0;0;0;0;0;0
FR;4;2021-01-22;0;0;0;0;0;0;0;0;0;0;0;0;0;0;0;0;0;0
FR;4;2021-01-23;0;0;0;0;0;0;0;0;0;0;0;0;0;0;0;0;0;0
FR;4;2021-01-24;0;0;0;0;0;0;0;0;0;0;0;0;0;0;0;0;0;0
FR;4;2021-01-25;0;0;0;0;0;0;0;0;0;0;0;0;0;0;0;0;0;0
FR;4;2021-01-26;0;0;0;0;0;0;0;0;0;0;0;0;0;0;0;0;0;0
FR;4;2021-01-27;0;0;0;0;0;0;0;0;0;0;0;0;0;0;0;0;0;0
FR;4;2021-01-28;0;0;0;0;0;0;0;0;0;0;0;0;0;0;0;0;0;0
FR;4;2021-01-29;0;0;0;0;0;0;0;0;0;0;0;0;0;0;0;0;0;0
FR;4;2021-01-30;0;0;0;0;0;0;0;0;0;0;0;0;0;0;0;0;0;0
FR;4;2021-01-31;0;0;0;0;0;0;0;0;0;0;0;0;0;0;0;0;0;0
FR;4;2021-02-01;0;0;0;0;0;0;0;0;0;0;0;0;0;0;0;0;0;0
FR;4;2021-02-02;0;0;0;0;0;0;0;0;0;0;0;0;0;0;0;0;0;0
FR;4;2021-02-03;0;0;0;0;0;0;0;0;0;0;0;0;0;0;0;0;0;0
FR;4;2021-02-04;0;0;0;0;0;0;0;0;0;0;0;0;0;0;0;0;0;0
FR;4;2021-02-05;0;0;0;0;0;0;0;0;0;0;0;0;0;0;0;0;0;0
FR;4;2021-02-06;0;0;0;0;0;0;0;0;0;0;0;0;0;0;0;0;0;0
FR;4;2021-02-07;0;0;0;0;0;0;0;0;0;0;0;0;0;0;0;0;0;0
FR;4;2021-02-08;0;0;0;0;0;0;0;0;0;0;0;0;0;0;0;0;0;0
FR;4;2021-02-09;0;0;0;0;0;0;0;0;0;0;0;0;0;0;0;0;0;0
FR;4;2021-02-10;0;0;0;0;0;0;0;0;0;0;0;0;0;0;0;0;0;0
FR;4;2021-02-11;0;0;0;0;0;0;0;0;0;0;0;0;0;0;0;0;0;0
FR;4;2021-02-12;0;0;0;0;0;0;0;0;0;0;0;0;0;0;0;0;0;0
FR;4;2021-02-13;0;0;0;0;0;0;0;0;0;0;0;0;0;0;0;0;0;0
FR;4;2021-02-14;0;0;0;0;0;0;0;0;0;0;0;0;0;0;0;0;0;0
FR;4;2021-02-15;0;0;0;0;0;0;0;0;0;0;0;0;0;0;0;0;0;0
FR;4;2021-02-16;0;0;0;0;0;0;0;0;0;0;0;0;0;0;0;0;0;0
FR;4;2021-02-17;0;0;0;0;0;0;0;0;0;0;0;0;0;0;0;0;0;0
FR;4;2021-02-18;0;0;0;0;0;0;0;0;0;0;0;0;0;0;0;0;0;0
FR;4;2021-02-19;0;0;0;0;0;0;0;0;0;0;0;0;0;0;0;0;0;0
FR;4;2021-02-20;0;0;0;0;0;0;0;0;0;0;0;0;0;0;0;0;0;0
FR;4;2021-02-21;0;0;0;0;0;0;0;0;0;0;0;0;0;0;0;0;0;0
FR;4;2021-02-22;0;0;0;0;0;0;0;0;0;0;0;0;0;0;0;0;0;0
FR;4;2021-02-23;0;0;0;0;0;0;0;0;0;0;0;0;0;0;0;0;0;0
FR;4;2021-02-24;0;0;0;0;0;0;0;0;0;0;0;0;0;0;0;0;0;0
FR;4;2021-02-25;0;0;0;0;0;0;0;0;0;0;0;0;0;0;0;0;0;0
FR;4;2021-02-26;0;0;0;0;0;0;0;0;0;0;0;0;0;0;0;0;0;0
FR;4;2021-02-27;0;0;0;0;0;0;0;0;0;0;0;0;0;0;0;0;0;0
FR;4;2021-02-28;0;0;0;0;0;0;0;0;0;0;0;0;0;0;0;0;0;0
FR;4;2021-03-01;0;0;0;0;0;0;0;0;0;0;0;0;0;0;0;0;0;0
FR;4;2021-03-02;0;0;0;0;0;0;0;0;0;0;0;0;0;0;0;0;0;0
FR;4;2021-03-03;0;0;0;0;0;0;0;0;0;0;0;0;0;0;0;0;0;0
FR;4;2021-03-04;0;0;0;0;0;0;0;0;0;0;0;0;0;0;0;0;0;0
FR;4;2021-03-05;0;0;0;0;0;0;0;0;0;0;0;0;0;0;0;0;0;0
FR;4;2021-03-06;0;0;0;0;0;0;0;0;0;0;0;0;0;0;0;0;0;0
FR;4;2021-03-07;0;0;0;0;0;0;0;0;0;0;0;0;0;0;0;0;0;0
FR;4;2021-03-08;0;0;0;0;0;0;0;0;0;0;0;0;0;0;0;0;0;0
FR;4;2021-03-09;0;0;0;0;0;0;0;0;0;0;0;0;0;0;0;0;0;0
FR;4;2021-03-10;0;0;0;0;0;0;0;0;0;0;0;0;0;0;0;0;0;0
FR;4;2021-03-11;0;0;0;0;0;0;0;0;0;0;0;0;0;0;0;0;0;0
FR;4;2021-03-12;0;0;0;0;0;0;0;0;0;0;0;0;0;0;0;0;0;0
FR;4;2021-03-13;0;0;0;0;0;0;0;0;0;0;0;0;0;0;0;0;0;0
FR;4;2021-03-14;0;0;0;0;0;0;0;0;0;0;0;0;0;0;0;0;0;0
FR;4;2021-03-15;0;0;0;0;0;0;0;0;0;0;0;0;0;0;0;0;0;0
FR;4;2021-03-16;0;0;0;0;0;0;0;0;0;0;0;0;0;0;0;0;0;0
FR;4;2021-03-17;0;0;0;0;0;0;0;0;0;0;0;0;0;0;0;0;0;0
FR;4;2021-03-18;0;0;0;0;0;0;0;0;0;0;0;0;0;0;0;0;0;0
FR;4;2021-03-19;0;0;0;0;0;0;0;0;0;0;0;0;0;0;0;0;0;0
FR;4;2021-03-20;0;0;0;0;0;0;0;0;0;0;0;0;0;0;0;0;0;0
FR;4;2021-03-21;0;0;0;0;0;0;0;0;0;0;0;0;0;0;0;0;0;0
FR;4;2021-03-22;0;0;0;0;0;0;0;0;0;0;0;0;0;0;0;0;0;0
FR;4;2021-03-23;0;0;0;0;0;0;0;0;0;0;0;0;0;0;0;0;0;0
FR;4;2021-03-24;0;0;0;0;0;0;0;0;0;0;0;0;0;0;0;0;0;0
FR;4;2021-03-25;0;0;0;0;0;0;0;0;0;0;0;0;0;0;0;0;0;0
FR;4;2021-03-26;0;0;0;0;0;0;0;0;0;0;0;0;0;0;0;0;0;0
FR;4;2021-03-27;0;0;0;0;0;0;0;0;0;0;0;0;0;0;0;0;0;0
FR;4;2021-03-28;0;0;0;0;0;0;0;0;0;0;0;0;0;0;0;0;0;0
FR;4;2021-03-29;0;0;0;0;0;0;0;0;0;0;0;0;0;0;0;0;0;0
FR;4;2021-03-30;0;0;0;0;0;0;0;0;0;0;0;0;0;0;0;0;0;0
FR;4;2021-03-31;0;0;0;0;0;0;0;0;0;0;0;0;0;0;0;0;0;0
FR;4;2021-04-01;0;0;0;0;0;0;0;0;0;0;0;0;0;0;0;0;0;0
FR;4;2021-04-02;0;0;0;0;0;0;0;0;0;0;0;0;0;0;0;0;0;0
FR;4;2021-04-03;0;0;0;0;0;0;0;0;0;0;0;0;0;0;0;0;0;0
FR;4;2021-04-04;0;0;0;0;0;0;0;0;0;0;0;0;0;0;0;0;0;0
FR;4;2021-04-05;0;0;0;0;0;0;0;0;0;0;0;0;0;0;0;0;0;0
FR;4;2021-04-06;0;0;0;0;0;0;0;0;0;0;0;0;0;0;0;0;0;0
FR;4;2021-04-07;0;0;0;0;0;0;0;0;0;0;0;0;0;0;0;0;0;0
FR;4;2021-04-08;0;0;0;0;0;0;0;0;0;0;0;0;0;0;0;0;0;0
FR;4;2021-04-09;0;0;0;0;0;0;0;0;0;0;0;0;0;0;0;0;0;0
FR;4;2021-04-10;0;0;0;0;0;0;0;0;0;0;0;0;0;0;0;0;0;0
FR;4;2021-04-11;0;0;0;0;0;0;0;0;0;0;0;0;0;0;0;0;0;0
FR;4;2021-04-12;0;0;0;0;0;0;0;0;0;0;0;0;0;0;0;0;0;0
FR;4;2021-04-13;0;0;0;0;0;0;0;0;0;0;0;0;0;0;0;0;0;0
FR;4;2021-04-14;0;0;0;0;0;0;0;0;0;0;0;0;0;0;0;0;0;0
FR;4;2021-04-15;0;0;0;0;0;0;0;0;0;0;0;0;0;0;0;0;0;0
FR;4;2021-04-16;0;0;0;0;0;0;0;0;0;0;0;0;0;0;0;0;0;0
FR;4;2021-04-17;0;0;0;0;0;0;0;0;0;0;0;0;0;0;0;0;0;0
FR;4;2021-04-18;0;0;0;0;0;0;0;0;0;0;0;0;0;0;0;0;0;0
FR;4;2021-04-19;0;0;0;0;0;0;0;0;0;0;0;0;0;0;0;0;0;0
FR;4;2021-04-20;0;0;0;0;0;0;0;0;0;0;0;0;0;0;0;0;0;0
FR;4;2021-04-21;0;0;0;0;0;0;0;0;0;0;0;0;0;0;0;0;0;0
FR;4;2021-04-22;0;0;0;0;0;0;0;0;0;0;0;0;0;0;0;0;0;0
FR;4;2021-04-23;3732;0;0;0;3689;0;0;0;0;3732;0;0;0;3689;0;0;0;0
FR;4;2021-04-24;1569;1;0;0;1558;0;0;0;0;5301;1;0;0;5247;0;0;0;0
FR;4;2021-04-25;125;0;0;0;125;0;0;0;0;5426;1;0;0;5372;0;0;0;0
FR;4;2021-04-26;2871;1;0;0;2860;0;0;0;0;8297;2;0;0;8232;0;0;0;0
FR;4;2021-04-27;9520;3;0;0;9501;0;0;0;0;17817;5;0;0;17733;0;0;0;0
FR;4;2021-04-28;9909;6;0;0;9884;0;0;0;0;27726;11;0;0;27617;0;0;0;0
FR;4;2021-04-29;15996;8;0;0;15980;0;0;0;0;43722;19;0;0;43597;0;0;0;0
FR;4;2021-04-30;19234;10;0;0;19204;0;0;0;0;62956;29;0;0;62801;0;0;0;0
FR;4;2021-05-01;1994;6;0;0;1992;0;0;0;0;64950;35;0;0;64793;0;0;0;0
FR;4;2021-05-02;484;0;0;0;481;0;0;0;0;65434;35;0;0;65274;0;0;0;0
FR;4;2021-05-03;5066;2;0;0;5060;0;0;0;0;70500;37;0;0;70334;0;0;0;0
FR;4;2021-05-04;8408;11;0;0;8397;0;0;0;0;78908;48;0;0;78731;0;0;0;0
FR;4;2021-05-05;6190;7;0;0;6185;0;0;0;0;85098;55;0;0;84916;0;0;0;0
FR;4;2021-05-06;11387;11;0;0;11384;0;0;0;0;96485;66;0;0;96300;0;0;0;0
FR;4;2021-05-07;19127;9;0;0;19088;0;0;0;0;115612;75;0;0;115388;0;0;0;0
FR;4;2021-05-08;2378;6;0;0;2382;0;0;0;0;117990;81;0;0;117770;0;0;0;0
FR;4;2021-05-09;690;3;0;0;691;0;0;0;0;118680;84;0;0;118461;0;0;0;0
FR;4;2021-05-10;7244;5;1;0;7241;0;0;0;0;125924;89;1;0;125702;0;0;0;0
FR;4;2021-05-11;14325;12;0;0;14305;0;0;0;0;140249;101;1;0;140007;0;0;0;0
FR;4;2021-05-12;10174;15;0;0;10177;0;0;0;0;150423;116;1;0;150184;0;0;0;0
FR;4;2021-05-13;1583;4;0;0;1584;0;0;0;0;152006;120;1;0;151768;0;0;0;0
FR;4;2021-05-14;7767;7;0;0;7761;0;0;0;0;159773;127;1;0;159529;0;0;0;0
FR;4;2021-05-15;3721;8;1;0;3720;0;0;0;0;163494;135;2;0;163249;0;0;0;0
FR;4;2021-05-16;417;1;0;0;417;0;0;0;0;163911;136;2;0;163666;0;0;0;0
FR;4;2021-05-17;4480;6;0;0;4479;0;0;0;0;168391;142;2;0;168145;0;0;0;0
FR;4;2021-05-18;8768;10;0;0;8768;0;0;0;0;177159;152;2;0;176913;0;0;0;0
FR;4;2021-05-19;5697;7;0;0;5699;0;0;0;0;182856;159;2;0;182612;0;0;0;0
FR;4;2021-05-20;9485;8;0;0;9477;0;0;0;0;192341;167;2;0;192089;0;0;0;0
FR;4;2021-05-21;12810;30;0;0;12817;0;0;0;0;205151;197;2;0;204906;0;0;0;0
FR;4;2021-05-22;5061;15;0;0;5068;0;0;0;0;210212;212;2;0;209974;0;0;0;0
FR;4;2021-05-23;497;4;0;0;500;0;0;0;0;210709;216;2;0;210474;0;0;0;0
FR;4;2021-05-24;1059;7;0;0;1063;0;0;0;0;211768;223;2;0;211537;0;0;0;0
FR;4;2021-05-25;7633;16;0;0;7639;0;0;0;0;219401;239;2;0;219176;0;0;0;0
FR;4;2021-05-26;7730;16;0;0;7739;0;0;0;0;227131;255;2;0;226915;0;0;0;0
FR;4;2021-05-27;14336;35;0;0;14344;0;0;0;0;241467;290;2;0;241259;0;0;0;0
FR;4;2021-05-28;26593;82;1;0;26634;0;0;0;0;268060;372;3;0;267893;0;0;0;0
FR;4;2021-05-29;11385;18;0;0;11386;0;0;0;0;279445;390;3;0;279279;0;0;0;0
FR;4;2021-05-30;973;7;0;0;972;0;0;0;0;280418;397;3;0;280251;0;0;0;0
FR;4;2021-05-31;12698;21;0;0;12698;0;0;0;0;293116;418;3;0;292949;0;0;0;0
FR;4;2021-06-01;20275;48;1;0;20293;0;0;0;0;313391;466;4;0;313242;0;0;0;0
FR;4;2021-06-02;14522;33;0;0;14535;0;0;0;0;327913;499;4;0;327777;0;0;0;0
FR;4;2021-06-03;19435;24;1;0;19433;0;0;0;0;347348;523;5;0;347210;0;0;0;0
FR;4;2021-06-04;22517;48;0;0;22535;0;0;0;0;369865;571;5;0;369745;0;0;0;0
FR;4;2021-06-05;9715;32;0;0;9718;0;0;0;0;379580;603;5;0;379463;0;0;0;0
FR;4;2021-06-06;1040;1;0;0;1036;0;0;0;0;380620;604;5;0;380499;0;0;0;0
FR;4;2021-06-07;9230;19;0;0;9237;0;0;0;0;389850;623;5;0;389736;0;0;0;0
FR;4;2021-06-08;14613;32;0;0;14625;0;0;0;0;404463;655;5;0;404361;0;0;0;0
FR;4;2021-06-09;12212;25;0;0;12220;0;0;0;0;416675;680;5;0;416581;0;0;0;0
FR;4;2021-06-10;15406;30;0;0;15414;0;0;0;0;432081;710;5;0;431995;0;0;0;0
FR;4;2021-06-11;16986;57;0;0;17013;0;0;0;0;449067;767;5;0;449008;0;0;0;0
FR;4;2021-06-12;7451;27;0;0;7476;0;0;0;0;456518;794;5;0;456484;0;0;0;0
FR;4;2021-06-13;908;3;0;0;910;0;0;0;0;457426;797;5;0;457394;0;0;0;0
FR;4;2021-06-14;6650;27;0;0;6660;0;0;0;0;464076;824;5;0;464054;0;0;0;0
FR;4;2021-06-15;10893;39;0;0;10910;0;0;0;0;474969;863;5;0;474964;0;0;0;0
FR;4;2021-06-16;8909;16;0;0;8917;0;0;0;0;483878;879;5;0;483881;0;0;0;0
FR;4;2021-06-17;10899;37;0;0;10911;0;0;0;0;494777;916;5;0;494792;0;0;0;0
FR;4;2021-06-18;12424;45;0;0;12451;0;0;0;0;507201;961;5;0;507243;0;0;0;0
FR;4;2021-06-19;5567;25;0;0;5587;0;0;0;0;512768;986;5;0;512830;0;0;0;0
FR;4;2021-06-20;824;5;0;0;828;0;0;0;0;513592;991;5;0;513658;0;0;0;0
FR;4;2021-06-21;5103;21;0;0;5103;0;0;0;0;518695;1012;5;0;518761;0;0;0;0
FR;4;2021-06-22;7913;29;2;0;7930;0;0;0;0;526608;1041;7;0;526691;0;0;0;0
FR;4;2021-06-23;7103;42;2;0;7130;0;0;0;0;533711;1083;9;0;533821;0;0;0;0
FR;4;2021-06-24;8654;46;1;0;8686;0;0;0;0;542365;1129;10;0;542507;0;0;0;0
FR;4;2021-06-25;10175;41;2;0;10207;0;0;0;0;552540;1170;12;0;552714;0;0;0;0
FR;4;2021-06-26;4853;21;0;0;4870;0;0;0;0;557393;1191;12;0;557584;0;0;0;0
FR;4;2021-06-27;766;4;0;0;768;0;0;0;0;558159;1195;12;0;558352;0;0;0;0
FR;4;2021-06-28;4834;16;1;0;4842;0;0;0;0;562993;1211;13;0;563194;0;0;0;0
FR;4;2021-06-29;7110;28;2;0;7119;0;0;0;0;570103;1239;15;0;570313;0;0;0;0
FR;4;2021-06-30;6725;40;2;0;6753;0;0;0;0;576828;1279;17;0;577066;0;0;0;0
FR;4;2021-07-01;8210;42;0;0;8232;0;0;0;0;585038;1321;17;0;585298;0;0;0;0
FR;4;2021-07-02;9429;53;1;0;9469;0;0;0;0;594467;1374;18;0;594767;0;0;0;0
FR;4;2021-07-03;4846;20;0;0;4861;0;0;0;0;599313;1394;18;0;599628;0;0;0;0
FR;4;2021-07-04;689;5;0;0;691;0;0;0;0;600002;1399;18;0;600319;0;0;0;0
FR;4;2021-07-05;4771;19;2;0;4782;0;0;0;0;604773;1418;20;0;605101;0;0;0;0
FR;4;2021-07-06;7728;29;4;0;7741;0;0;0;0;612501;1447;24;0;612842;0;0;0;0
FR;4;2021-07-07;7084;34;2;0;7097;0;0;0;0;619585;1481;26;0;619939;0;0;0;0
FR;4;2021-07-08;9232;40;2;0;9255;0;0;0;0;628817;1521;28;0;629194;0;0;0;0
FR;4;2021-07-09;10279;34;1;0;10302;0;0;0;0;639096;1555;29;0;639496;0;0;0;0
FR;4;2021-07-10;4639;14;2;0;4646;0;0;0;0;643735;1569;31;0;644142;0;0;0;0
FR;4;2021-07-11;582;4;1;0;580;0;0;0;0;644317;1573;32;0;644722;0;0;0;0
FR;4;2021-07-12;5875;29;0;0;5897;0;0;0;0;650192;1602;32;0;650619;0;0;0;0
FR;4;2021-07-13;14230;29;0;0;14248;0;0;0;0;664422;1631;32;0;664867;0;0;0;0
FR;4;2021-07-14;2289;15;0;0;2289;0;0;0;0;666711;1646;32;0;667156;0;0;0;0
FR;4;2021-07-15;18236;36;0;0;18253;0;0;0;0;684947;1682;32;0;685409;0;0;0;0
FR;4;2021-07-16;22836;71;2;0;22886;0;0;0;0;707783;1753;34;0;708295;0;0;0;0
FR;4;2021-07-17;9739;20;0;0;9748;0;0;0;0;717522;1773;34;0;718043;0;0;0;0
FR;4;2021-07-18;1358;5;0;0;1361;0;0;0;0;718880;1778;34;0;719404;0;0;0;0
FR;4;2021-07-19;12991;30;1;0;13016;0;0;0;0;731871;1808;35;0;732420;0;0;0;0
FR;4;2021-07-20;17343;26;1;0;17359;0;0;0;0;749214;1834;36;0;749779;0;0;0;0
FR;4;2021-07-21;15619;33;0;0;15639;0;0;0;0;764833;1867;36;0;765418;0;0;0;0
FR;4;2021-07-22;18246;44;2;0;18270;0;0;0;0;783079;1911;38;0;783688;0;0;0;0
FR;4;2021-07-23;20417;57;7;0;20450;0;0;0;0;803496;1968;45;0;804138;0;0;0;0
FR;4;2021-07-24;9288;32;0;0;9302;0;0;0;0;812784;2000;45;0;813440;0;0;0;0
FR;4;2021-07-25;1354;9;0;0;1356;0;0;0;0;814138;2009;45;0;814796;0;0;0;0
FR;4;2021-07-26;11042;23;0;0;11049;0;0;0;0;825180;2032;45;0;825845;0;0;0;0
FR;4;2021-07-27;14684;35;3;0;14704;0;0;0;0;839864;2067;48;0;840549;0;0;0;0
FR;4;2021-07-28;12933;26;2;0;12950;0;0;0;0;852797;2093;50;0;853499;0;0;0;0
FR;4;2021-07-29;14093;54;4;0;14134;0;0;0;0;866890;2147;54;0;867633;0;0;0;0
FR;4;2021-07-30;15501;46;2;0;15532;0;0;0;0;882391;2193;56;0;883165;0;0;0;0
FR;4;2021-07-31;6844;14;2;0;6854;0;0;0;0;889235;2207;58;0;890019;0;0;0;0
FR;4;2021-08-01;906;1;0;0;901;0;0;0;0;890141;2208;58;0;890920;0;0;0;0
FR;4;2021-08-02;7918;31;0;0;7919;0;0;0;0;898059;2239;58;0;898839;0;0;0;0
FR;4;2021-08-03;10801;31;2;0;10797;0;0;0;0;908860;2270;60;0;909636;0;0;0;0
FR;4;2021-08-04;9747;29;0;0;9746;0;0;0;0;918607;2299;60;0;919382;0;0;0;0
FR;4;2021-08-05;9825;42;0;0;9831;0;0;0;0;928432;2341;60;0;929213;0;0;0;0
FR;4;2021-08-06;10200;30;3;0;10197;0;0;0;0;938632;2371;63;0;939410;0;0;0;0
FR;4;2021-08-07;5100;30;1;0;5116;0;0;0;0;943732;2401;64;0;944526;0;0;0;0
FR;4;2021-08-08;1219;13;0;0;1222;0;0;0;0;944951;2414;64;0;945748;0;0;0;0
FR;4;2021-08-09;6350;31;0;0;6343;0;0;0;0;951301;2445;64;0;952091;0;0;0;0
FR;4;2021-08-10;8753;18;0;0;8724;0;0;0;0;960054;2463;64;0;960815;0;0;0;0
FR;4;2021-08-11;7944;34;4;0;7933;0;0;0;0;967998;2497;68;0;968748;0;0;0;0
FR;4;2021-08-12;8585;31;1;0;8573;0;0;0;0;976583;2528;69;0;977321;0;0;0;0
FR;4;2021-08-13;7558;25;0;1;7545;0;0;0;0;984141;2553;69;1;984866;0;0;0;0
FR;4;2021-08-14;3791;20;0;0;3775;0;0;0;0;987932;2573;69;1;988641;0;0;0;0
FR;4;2021-08-15;771;5;0;0;773;0;0;0;0;988703;2578;69;1;989414;0;0;0;0
FR;4;2021-08-16;4008;17;0;0;4002;0;0;0;0;992711;2595;69;1;993416;0;0;0;0
FR;4;2021-08-17;5630;17;1;0;5620;0;0;0;0;998341;2612;70;1;999036;0;0;0;0
FR;4;2021-08-18;5168;37;0;0;5185;0;0;0;0;1003509;2649;70;1;1004221;0;0;0;0
FR;4;2021-08-19;5487;33;3;0;5501;0;0;0;0;1008996;2682;73;1;1009722;0;0;0;0
FR;4;2021-08-20;5225;25;1;0;5235;0;0;0;0;1014221;2707;74;1;1014957;0;0;0;0
FR;4;2021-08-21;2311;22;1;0;2327;0;0;0;0;1016532;2729;75;1;1017284;0;0;0;0
FR;4;2021-08-22;414;2;0;0;415;0;0;0;0;1016946;2731;75;1;1017699;0;0;0;0
FR;4;2021-08-23;2932;20;1;0;2939;0;0;0;0;1019878;2751;76;1;1020638;0;0;0;0
FR;4;2021-08-24;3758;15;0;0;3761;0;0;0;0;1023636;2766;76;1;1024399;0;0;0;0
FR;4;2021-08-25;3543;25;1;0;3559;0;0;0;0;1027179;2791;77;1;1027958;0;0;0;0
FR;4;2021-08-26;3715;21;2;0;3727;0;0;0;0;1030894;2812;79;1;1031685;0;0;0;0
FR;4;2021-08-27;3617;31;2;0;3635;0;0;0;0;1034511;2843;81;1;1035320;0;0;0;0
FR;4;2021-08-28;1727;10;1;0;1732;0;0;0;0;1036238;2853;82;1;1037052;0;0;0;0
FR;4;2021-08-29;385;7;1;0;389;0;0;0;0;1036623;2860;83;1;1037441;0;0;0;0
FR;4;2021-08-30;2010;25;0;0;2018;16;0;0;0;1038633;2885;83;1;1039459;16;0;0;0
FR;4;2021-08-31;2486;21;0;0;2493;14;0;0;0;1041119;2906;83;1;1041952;30;0;0;0
FR;4;2021-09-01;2085;38;1;0;2096;21;0;0;0;1043204;2944;84;1;1044048;51;0;0;0
FR;4;2021-09-02;2307;31;4;0;2320;18;0;0;0;1045511;2975;88;1;1046368;69;0;0;0
FR;4;2021-09-03;2363;44;5;0;2373;36;0;0;0;1047874;3019;93;1;1048741;105;0;0;0
FR;4;2021-09-04;1374;18;0;0;1381;9;0;0;0;1049248;3037;93;1;1050122;114;0;0;0
FR;4;2021-09-05;433;2;0;0;433;2;0;0;0;1049681;3039;93;1;1050555;116;0;0;0
FR;4;2021-09-06;1713;62;0;0;1751;23;0;0;0;1051394;3101;93;1;1052306;139;0;0;0
FR;4;2021-09-07;1680;18;0;0;1689;8;0;0;0;1053074;3119;93;1;1053995;147;0;0;0
FR;4;2021-09-08;1286;26;3;0;1291;19;0;0;0;1054360;3145;96;1;1055286;166;0;0;0
FR;4;2021-09-09;1392;23;2;0;1403;9;0;0;0;1055752;3168;98;1;1056689;175;0;0;0
FR;4;2021-09-10;1521;31;2;0;1525;23;1;0;0;1057273;3199;100;1;1058214;198;1;0;0
FR;4;2021-09-11;745;11;0;0;748;3;0;0;0;1058018;3210;100;1;1058962;201;1;0;0
FR;4;2021-09-12;169;4;0;0;170;3;0;0;0;1058187;3214;100;1;1059132;204;1;0;0
FR;4;2021-09-13;1322;22;1;0;1325;16;0;0;0;1059509;3236;101;1;1060457;220;1;0;0
FR;4;2021-09-14;1503;9;2;0;1506;6;0;0;0;1061012;3245;103;1;1061963;226;1;0;0
FR;4;2021-09-15;1095;28;1;0;1098;25;0;0;0;1062107;3273;104;1;1063061;251;1;0;0
FR;4;2021-09-16;1105;22;2;0;1109;15;0;0;0;1063212;3295;106;1;1064170;266;1;0;0
FR;4;2021-09-17;897;21;1;0;904;12;0;0;0;1064109;3316;107;1;1065074;278;1;0;0
FR;4;2021-09-18;464;6;1;0;465;5;0;0;0;1064573;3322;108;1;1065539;283;1;0;0
FR;4;2021-09-19;182;3;0;0;183;2;0;0;0;1064755;3325;108;1;1065722;285;1;0;0
FR;4;2021-09-20;452;19;0;0;458;13;0;0;0;1065207;3344;108;1;1066180;298;1;0;0
FR;4;2021-09-21;432;11;0;0;434;7;0;0;0;1065639;3355;108;1;1066614;305;1;0;0
FR;4;2021-09-22;375;19;2;0;382;13;0;0;0;1066014;3374;110;1;1066996;318;1;0;0
FR;4;2021-09-23;485;15;1;0;486;14;0;0;0;1066499;3389;111;1;1067482;332;1;0;0
FR;4;2021-09-24;413;13;2;0;417;9;0;0;0;1066912;3402;113;1;1067899;341;1;0;0
FR;4;2021-09-25;280;10;1;0;281;5;0;0;0;1067192;3412;114;1;1068180;346;1;0;0
FR;4;2021-09-26;74;2;0;0;75;1;0;0;0;1067266;3414;114;1;1068255;347;1;0;0
FR;4;2021-09-27;268;10;1;0;269;8;0;0;0;1067534;3424;115;1;1068524;355;1;0;0
FR;4;2021-09-28;318;8;0;0;318;8;0;0;0;1067852;3432;115;1;1068842;363;1;0;0
FR;4;2021-09-29;375;19;1;0;377;13;0;0;0;1068227;3451;116;1;1069219;376;1;0;0
FR;4;2021-09-30;365;41;0;0;379;22;0;0;0;1068592;3492;116;1;1069598;398;1;0;0
FR;4;2021-10-01;411;56;0;0;413;50;0;0;0;1069003;3548;116;1;1070011;448;1;0;0
FR;4;2021-10-02;196;22;1;0;198;13;0;0;0;1069199;3570;117;1;1070209;461;1;0;0
FR;4;2021-10-03;86;1;0;0;87;0;0;0;0;1069285;3571;117;1;1070296;461;1;0;0
FR;4;2021-10-04;363;20;1;0;367;16;0;0;0;1069648;3591;118;1;1070663;477;1;0;0
FR;4;2021-10-05;286;19;2;0;288;15;0;0;0;1069934;3610;120;1;1070951;492;1;0;0
FR;4;2021-10-06;249;23;1;0;254;18;0;0;0;1070183;3633;121;1;1071205;510;1;0;0
FR;4;2021-10-07;267;25;2;0;272;13;0;0;0;1070450;3658;123;1;1071477;523;1;0;0
FR;4;2021-10-08;357;24;2;0;360;20;0;0;0;1070807;3682;125;1;1071837;543;1;0;0
FR;4;2021-10-09;194;6;6;0;195;7;0;0;0;1071001;3688;131;1;1072032;550;1;0;0
FR;4;2021-10-10;97;3;2;0;99;3;0;0;0;1071098;3691;133;1;1072131;553;1;0;0
FR;4;2021-10-11;251;15;1;0;252;14;0;0;0;1071349;3706;134;1;1072383;567;1;0;0
FR;4;2021-10-12;210;14;0;0;210;13;0;0;0;1071559;3720;134;1;1072593;580;1;0;0
FR;4;2021-10-13;221;28;1;0;224;25;0;0;0;1071780;3748;135;1;1072817;605;1;0;0
FR;4;2021-10-14;315;21;4;0;319;15;0;0;0;1072095;3769;139;1;1073136;620;1;0;0
FR;4;2021-10-15;322;24;5;0;323;25;0;0;0;1072417;3793;144;1;1073459;645;1;0;0
FR;4;2021-10-16;166;6;2;0;166;6;0;0;0;1072583;3799;146;1;1073625;651;1;0;0
FR;4;2021-10-17;70;2;0;0;71;1;0;0;0;1072653;3801;146;1;1073696;652;1;0;0
FR;4;2021-10-18;281;16;1;0;283;13;0;0;0;1072934;3817;147;1;1073979;665;1;0;0
FR;4;2021-10-19;215;14;2;0;215;15;0;0;0;1073149;3831;149;1;1074194;680;1;0;0
FR;4;2021-10-20;231;27;4;0;234;15;0;0;0;1073380;3858;153;1;1074428;695;1;0;0
FR;4;2021-10-21;243;18;0;0;245;14;0;0;0;1073623;3876;153;1;1074673;709;1;0;0
FR;4;2021-10-22;217;25;2;0;219;20;1;0;0;1073840;3901;155;1;1074892;729;2;0;0
FR;4;2021-10-23;116;16;1;0;117;15;0;0;0;1073956;3917;156;1;1075009;744;2;0;0
FR;4;2021-10-24;39;4;0;0;39;1;0;0;0;1073995;3921;156;1;1075048;745;2;0;0
FR;4;2021-10-25;218;7;2;0;218;9;0;0;0;1074213;3928;158;1;1075266;754;2;0;0
FR;4;2021-10-26;200;14;0;0;202;12;0;0;0;1074413;3942;158;1;1075468;766;2;0;0
FR;4;2021-10-27;196;12;4;0;196;12;2;0;0;1074609;3954;162;1;1075664;778;4;0;0
FR;4;2021-10-28;184;18;5;0;184;22;0;0;0;1074793;3972;167;1;1075848;800;4;0;0
FR;4;2021-10-29;225;17;2;0;226;15;0;0;0;1075018;3989;169;1;1076074;815;4;0;0
FR;4;2021-10-30;103;2;1;0;104;2;0;0;0;1075121;3991;170;1;1076178;817;4;0;0
FR;4;2021-10-31;59;3;2;0;60;3;0;0;0;1075180;3994;172;1;1076238;820;4;0;0
FR;4;2021-11-01;75;27;4;0;76;24;3;0;0;1075255;4021;176;1;1076314;844;7;0;0
FR;4;2021-11-02;162;21;2;0;163;21;0;0;0;1075417;4042;178;1;1076477;865;7;0;0
FR;4;2021-11-03;130;20;8;1;131;18;6;0;0;1075547;4062;186;2;1076608;883;13;0;0
FR;4;2021-11-04;186;15;1;0;187;12;1;0;0;1075733;4077;187;2;1076795;895;14;0;0
FR;4;2021-11-05;130;17;1;0;131;16;0;0;0;1075863;4094;188;2;1076926;911;14;0;0
FR;4;2021-11-06;81;6;1;0;81;6;0;0;0;1075944;4100;189;2;1077007;917;14;0;0
FR;4;2021-11-07;81;2;2;0;81;4;0;0;0;1076025;4102;191;2;1077088;921;14;0;0
FR;4;2021-11-08;161;20;1;0;162;20;0;0;0;1076186;4122;192;2;1077250;941;14;0;0
FR;4;2021-11-09;158;14;3;0;158;16;0;0;0;1076344;4136;195;2;1077408;957;14;0;0
FR;4;2021-11-10;121;30;6;0;121;32;2;0;0;1076465;4166;201;2;1077529;989;16;0;0
FR;4;2021-11-11;99;10;1;0;99;11;0;0;0;1076564;4176;202;2;1077628;1000;16;0;0
FR;4;2021-11-12;106;19;2;0;107;18;1;0;0;1076670;4195;204;2;1077735;1018;17;0;0
FR;4;2021-11-13;74;15;2;0;75;14;0;0;0;1076744;4210;206;2;1077810;1032;17;0;0
FR;4;2021-11-14;55;5;4;0;56;8;0;0;0;1076799;4215;210;2;1077866;1040;17;0;0
FR;4;2021-11-15;99;26;2;0;101;24;2;0;0;1076898;4241;212;2;1077967;1064;19;0;0
FR;4;2021-11-16;107;13;3;0;107;16;0;0;0;1077005;4254;215;2;1078074;1080;19;0;0
FR;4;2021-11-17;120;30;4;0;120;30;1;0;0;1077125;4284;219;2;1078194;1110;20;0;0
FR;4;2021-11-18;103;34;14;0;105;43;1;0;0;1077228;4318;233;2;1078299;1153;21;0;0
FR;4;2021-11-19;87;21;3;0;87;22;1;0;0;1077315;4339;236;2;1078386;1175;22;0;0
FR;4;2021-11-20;77;8;1;0;77;8;0;0;0;1077392;4347;237;2;1078463;1183;22;0;0
FR;4;2021-11-21;68;7;2;0;68;9;0;0;0;1077460;4354;239;2;1078531;1192;22;0;0
FR;4;2021-11-22;107;28;9;0;108;33;2;0;0;1077567;4382;248;2;1078639;1225;24;0;0
FR;4;2021-11-23;77;31;6;0;78;29;2;0;0;1077644;4413;254;2;1078717;1254;26;0;0
FR;4;2021-11-24;90;23;11;0;92;24;4;0;0;1077734;4436;265;2;1078809;1278;30;0;0
FR;4;2021-11-25;93;28;17;0;94;33;5;0;0;1077827;4464;282;2;1078903;1311;35;0;0
FR;4;2021-11-26;85;43;12;0;89;45;3;0;0;1077912;4507;294;2;1078992;1356;38;0;0
FR;4;2021-11-27;41;22;15;0;41;25;10;0;0;1077953;4529;309;2;1079033;1381;48;0;0
FR;4;2021-11-28;50;8;0;0;51;7;0;0;0;1078003;4537;309;2;1079084;1388;48;0;0
FR;4;2021-11-29;90;31;16;0;90;40;2;0;0;1078093;4568;325;2;1079174;1428;50;0;0
FR;4;2021-11-30;75;37;12;0;75;41;2;0;0;1078168;4605;337;2;1079249;1469;52;0;0
FR;4;2021-12-01;88;60;19;0;88;67;11;0;0;1078256;4665;356;2;1079337;1536;63;0;0
FR;4;2021-12-02;110;48;21;0;114;56;3;0;0;1078366;4713;377;2;1079451;1592;66;0;0
FR;4;2021-12-03;102;36;15;0;102;44;4;0;0;1078468;4749;392;2;1079553;1636;70;0;0
FR;4;2021-12-04;72;31;18;0;74;44;1;0;0;1078540;4780;410;2;1079627;1680;71;0;0
FR;4;2021-12-05;63;7;1;0;64;7;0;0;0;1078603;4787;411;2;1079691;1687;71;0;0
FR;4;2021-12-06;110;46;19;0;110;59;3;0;0;1078713;4833;430;2;1079801;1746;74;0;0
FR;4;2021-12-07;82;37;9;0;85;36;3;0;0;1078795;4870;439;2;1079886;1782;77;0;0
FR;4;2021-12-08;70;31;17;0;72;38;7;0;0;1078865;4901;456;2;1079958;1820;84;0;0
FR;4;2021-12-09;64;32;10;1;64;39;3;0;0;1078929;4933;466;3;1080022;1859;87;0;0
FR;4;2021-12-10;63;64;20;0;64;68;10;0;0;1078992;4997;486;3;1080086;1927;97;0;0
FR;4;2021-12-11;28;34;7;0;28;34;3;0;0;1079020;5031;493;3;1080114;1961;100;0;0
FR;4;2021-12-12;28;11;3;0;28;14;0;0;0;1079048;5042;496;3;1080142;1975;100;0;0
FR;4;2021-12-13;75;40;14;0;77;49;2;0;0;1079123;5082;510;3;1080219;2024;102;0;0
FR;4;2021-12-14;61;43;17;0;62;54;2;0;0;1079184;5125;527;3;1080281;2078;104;0;0
FR;4;2021-12-15;68;64;29;0;68;85;6;0;0;1079252;5189;556;3;1080349;2163;110;0;0
FR;4;2021-12-16;34;45;19;0;35;58;4;0;0;1079286;5234;575;3;1080384;2221;114;0;0
FR;4;2021-12-17;39;55;11;0;39;59;6;0;0;1079325;5289;586;3;1080423;2280;120;0;0
FR;4;2021-12-18;49;30;2;0;50;31;0;0;0;1079374;5319;588;3;1080473;2311;120;0;0
FR;4;2021-12-19;16;4;1;0;17;4;0;0;0;1079390;5323;589;3;1080490;2315;120;0;0
FR;4;2021-12-20;43;38;10;0;44;41;6;0;0;1079433;5361;599;3;1080534;2356;126;0;0
FR;4;2021-12-21;31;32;16;0;33;38;5;0;0;1079464;5393;615;3;1080567;2394;131;0;0
FR;4;2021-12-22;37;37;10;0;37;38;7;0;0;1079501;5430;625;3;1080604;2432;138;0;0
FR;4;2021-12-23;39;45;8;0;39;49;2;0;0;1079540;5475;633;3;1080643;2481;140;0;0
FR;4;2021-12-24;23;28;10;0;25;31;4;0;0;1079563;5503;643;3;1080668;2512;144;0;0
FR;4;2021-12-25;7;3;3;0;7;4;2;0;0;1079570;5506;646;3;1080675;2516;146;0;0
FR;4;2021-12-26;5;3;1;0;6;2;0;0;0;1079575;5509;647;3;1080681;2518;146;0;0
FR;4;2021-12-27;31;41;9;0;32;43;4;0;0;1079606;5550;656;3;1080713;2561;150;0;0
FR;4;2021-12-28;26;28;7;0;28;29;4;0;0;1079632;5578;663;3;1080741;2590;154;0;0
FR;4;2021-12-29;54;25;11;0;55;30;5;0;0;1079686;5603;674;3;1080796;2620;159;0;0
FR;4;2021-12-30;47;19;12;0;50;22;5;0;0;1079733;5622;686;3;1080846;2642;164;0;0
FR;4;2021-12-31;19;6;8;0;20;11;2;0;0;1079752;5628;694;3;1080866;2653;166;0;0
FR;4;2022-01-01;5;4;4;0;5;6;1;0;0;1079757;5632;698;3;1080871;2659;167;0;0
FR;4;2022-01-02;41;5;16;0;41;20;1;0;0;1079798;5637;714;3;1080912;2679;168;0;0
FR;4;2022-01-03;44;55;22;1;46;62;10;0;0;1079842;5692;736;4;1080958;2741;178;0;0
FR;4;2022-01-04;37;28;15;0;38;33;7;0;0;1079879;5720;751;4;1080996;2774;185;0;0
FR;4;2022-01-05;51;24;19;0;57;27;9;0;0;1079930;5744;770;4;1081053;2801;194;0;0
FR;4;2022-01-06;49;22;24;0;49;38;8;0;0;1079979;5766;794;4;1081102;2839;202;0;0
FR;4;2022-01-07;30;20;16;0;32;21;12;0;0;1080009;5786;810;4;1081134;2860;214;0;0
FR;4;2022-01-08;12;6;10;0;13;12;3;0;0;1080021;5792;820;4;1081147;2872;217;0;0
FR;4;2022-01-09;19;2;3;0;20;4;0;0;0;1080040;5794;823;4;1081167;2876;217;0;0
FR;4;2022-01-10;51;22;19;0;51;36;4;0;0;1080091;5816;842;4;1081218;2912;221;0;0
FR;4;2022-01-11;29;31;12;0;33;35;1;0;0;1080120;5847;854;4;1081251;2947;222;0;0
FR;4;2022-01-12;33;21;13;0;35;23;9;0;0;1080153;5868;867;4;1081286;2970;231;0;0
FR;4;2022-01-13;54;20;27;0;55;38;8;0;0;1080207;5888;894;4;1081341;3008;239;0;0
FR;4;2022-01-14;24;29;13;0;25;32;7;0;0;1080231;5917;907;4;1081366;3040;246;0;0
FR;4;2022-01-15;13;6;8;0;14;12;1;0;0;1080244;5923;915;4;1081380;3052;247;0;0
FR;4;2022-01-16;12;9;14;0;12;22;1;0;0;1080256;5932;929;4;1081392;3074;248;0;0
FR;4;2022-01-17;27;19;12;0;27;25;5;0;0;1080283;5951;941;4;1081419;3099;253;0;0
FR;4;2022-01-18;17;13;10;0;17;20;3;0;0;1080300;5964;951;4;1081436;3119;256;0;0
FR;4;2022-01-19;31;23;13;0;31;34;1;0;0;1080331;5987;964;4;1081467;3153;257;0;0
FR;4;2022-01-20;33;34;13;0;35;39;5;0;0;1080364;6021;977;4;1081502;3192;262;0;0
FR;4;2022-01-21;11;12;20;1;11;17;15;0;1;1080375;6033;997;5;1081513;3209;277;0;1
FR;4;2022-01-22;30;13;3;0;30;14;2;0;0;1080405;6046;1000;5;1081543;3223;279;0;1
FR;4;2022-01-23;8;2;5;0;8;7;0;0;0;1080413;6048;1005;5;1081551;3230;279;0;1
FR;4;2022-01-24;14;21;8;0;15;27;1;0;0;1080427;6069;1013;5;1081566;3257;280;0;1
FR;4;2022-01-25;22;32;10;1;23;38;3;0;0;1080449;6101;1023;6;1081589;3295;283;0;1
FR;4;2022-01-26;19;16;9;1;20;20;4;0;0;1080468;6117;1032;7;1081609;3315;287;0;1
FR;4;2022-01-27;21;18;8;0;22;24;1;0;0;1080489;6135;1040;7;1081631;3339;288;0;1
FR;4;2022-01-28;13;23;8;0;14;26;4;0;0;1080502;6158;1048;7;1081645;3365;292;0;1
FR;4;2022-01-29;17;6;5;0;17;10;0;0;0;1080519;6164;1053;7;1081662;3375;292;0;1
FR;4;2022-01-30;18;3;1;0;18;4;0;0;0;1080537;6167;1054;7;1081680;3379;292;0;1
FR;4;2022-01-31;22;28;8;0;22;32;2;0;0;1080559;6195;1062;7;1081702;3411;294;0;1
FR;4;2022-02-01;13;22;12;0;14;23;9;0;0;1080572;6217;1074;7;1081716;3434;303;0;1
FR;4;2022-02-02;18;11;14;2;18;20;7;0;0;1080590;6228;1088;9;1081734;3454;310;0;1
FR;4;2022-02-03;15;24;10;0;17;28;4;0;0;1080605;6252;1098;9;1081751;3482;314;0;1
FR;4;2022-02-04;7;5;7;0;7;9;3;0;0;1080612;6257;1105;9;1081758;3491;317;0;1
FR;4;2022-02-05;7;14;1;0;8;13;1;0;0;1080619;6271;1106;9;1081766;3504;318;0;1
FR;4;2022-02-06;7;4;4;0;7;7;1;0;0;1080626;6275;1110;9;1081773;3511;319;0;1
FR;4;2022-02-07;15;19;8;0;17;19;6;0;0;1080641;6294;1118;9;1081790;3530;325;0;1
FR;4;2022-02-08;19;21;13;1;21;22;10;0;0;1080660;6315;1131;10;1081811;3552;335;0;1
FR;4;2022-02-09;17;11;9;0;18;16;2;0;0;1080677;6326;1140;10;1081829;3568;337;0;1
FR;4;2022-02-10;22;23;10;0;23;25;7;0;0;1080699;6349;1150;10;1081852;3593;344;0;1
FR;4;2022-02-11;18;15;8;0;18;20;3;0;0;1080717;6364;1158;10;1081870;3613;347;0;1
FR;4;2022-02-12;24;6;3;0;26;7;0;0;0;1080741;6370;1161;10;1081896;3620;347;0;1
FR;4;2022-02-13;7;3;3;0;7;6;0;0;0;1080748;6373;1164;10;1081903;3626;347;0;1
FR;4;2022-02-14;20;10;10;0;20;16;4;0;0;1080768;6383;1174;10;1081923;3642;351;0;1
FR;4;2022-02-15;18;7;2;0;18;8;0;0;0;1080786;6390;1176;10;1081941;3650;351;0;1
FR;4;2022-02-16;16;10;11;0;16;17;3;0;0;1080802;6400;1187;10;1081957;3667;354;0;1
FR;4;2022-02-17;11;4;5;0;11;7;2;0;0;1080813;6404;1192;10;1081968;3674;356;0;1
FR;4;2022-02-18;16;15;8;0;16;21;2;0;0;1080829;6419;1200;10;1081984;3695;358;0;1
FR;4;2022-02-19;16;4;2;0;17;5;0;0;0;1080845;6423;1202;10;1082001;3700;358;0;1
FR;4;2022-02-20;8;3;0;0;9;2;0;0;0;1080853;6426;1202;10;1082010;3702;358;0;1
FR;4;2022-02-21;23;4;4;0;23;6;2;0;0;1080876;6430;1206;10;1082033;3708;360;0;1
FR;4;2022-02-22;8;5;10;0;9;10;4;0;0;1080884;6435;1216;10;1082042;3718;364;0;1
FR;4;2022-02-23;17;6;10;0;17;10;5;0;0;1080901;6441;1226;10;1082059;3728;369;0;1
FR;4;2022-02-24;11;5;3;0;11;6;2;0;0;1080912;6446;1229;10;1082070;3734;371;0;1
FR;4;2022-02-25;16;5;7;0;16;6;6;0;0;1080928;6451;1236;10;1082086;3740;377;0;1
FR;4;2022-02-26;27;3;0;0;27;3;0;0;0;1080955;6454;1236;10;1082113;3743;377;0;1
FR;4;2022-02-27;9;0;1;0;9;1;0;0;0;1080964;6454;1237;10;1082122;3744;377;0;1
FR;4;2022-02-28;18;3;2;0;19;3;1;0;0;1080982;6457;1239;10;1082141;3747;378;0;1
FR;4;2022-03-01;8;4;7;0;8;5;5;0;0;1080990;6461;1246;10;1082149;3752;383;0;1
FR;4;2022-03-02;16;2;4;0;16;5;1;0;0;1081006;6463;1250;10;1082165;3757;384;0;1
FR;4;2022-03-03;17;5;3;0;17;6;1;0;0;1081023;6468;1253;10;1082182;3763;385;0;1
FR;4;2022-03-04;7;7;2;1;7;5;3;0;0;1081030;6475;1255;11;1082189;3768;388;0;1
FR;4;2022-03-05;9;2;0;0;9;2;0;0;0;1081039;6477;1255;11;1082198;3770;388;0;1
FR;4;2022-03-06;4;0;1;0;4;1;0;0;0;1081043;6477;1256;11;1082202;3771;388;0;1
FR;4;2022-03-07;10;4;2;0;10;3;2;0;0;1081053;6481;1258;11;1082212;3774;390;0;1
FR;4;2022-03-08;15;3;0;0;15;3;0;0;0;1081068;6484;1258;11;1082227;3777;390;0;1
FR;4;2022-03-09;8;7;2;0;10;7;0;0;0;1081076;6491;1260;11;1082237;3784;390;0;1
FR;4;2022-03-10;5;1;6;0;5;3;4;0;0;1081081;6492;1266;11;1082242;3787;394;0;1
FR;4;2022-03-11;10;4;5;0;12;2;5;0;0;1081091;6496;1271;11;1082254;3789;399;0;1
FR;4;2022-03-12;10;2;0;0;11;0;0;0;0;1081101;6498;1271;11;1082265;3789;399;0;1
FR;4;2022-03-13;6;2;1;0;7;2;0;0;0;1081107;6500;1272;11;1082272;3791;399;0;1
FR;4;2022-03-14;4;3;1;0;5;3;0;0;0;1081111;6503;1273;11;1082277;3794;399;0;1
FR;4;2022-03-15;8;6;3;0;10;5;2;0;0;1081119;6509;1276;11;1082287;3799;401;0;1
FR;4;2022-03-16;7;3;3;0;7;3;3;0;0;1081126;6512;1279;11;1082294;3802;404;0;1
FR;4;2022-03-17;3;4;1;0;3;5;0;0;0;1081129;6516;1280;11;1082297;3807;404;0;1
FR;4;2022-03-18;9;3;0;0;9;3;0;0;0;1081138;6519;1280;11;1082306;3810;404;0;1
FR;4;2022-03-19;1;1;1;0;1;2;0;0;0;1081139;6520;1281;11;1082307;3812;404;0;1
FR;4;2022-03-20;2;0;2;0;2;1;1;0;0;1081141;6520;1283;11;1082309;3813;405;0;1
FR;4;2022-03-21;6;4;1;0;6;5;0;0;0;1081147;6524;1284;11;1082315;3818;405;0;1
FR;4;2022-03-22;4;2;2;0;4;3;1;0;0;1081151;6526;1286;11;1082319;3821;406;0;1
FR;4;2022-03-23;6;4;5;0;6;8;1;0;0;1081157;6530;1291;11;1082325;3829;407;0;1
FR;4;2022-03-24;2;5;3;1;2;7;2;0;0;1081159;6535;1294;12;1082327;3836;409;0;1
FR;4;2022-03-25;3;1;2;0;3;1;2;0;0;1081162;6536;1296;12;1082330;3837;411;0;1
FR;4;2022-03-26;5;5;0;0;5;5;0;0;0;1081167;6541;1296;12;1082335;3842;411;0;1
FR;4;2022-03-27;1;0;3;0;1;2;1;0;0;1081168;6541;1299;12;1082336;3844;412;0;1
FR;4;2022-03-28;6;1;3;0;7;3;0;0;0;1081174;6542;1302;12;1082343;3847;412;0;1
FR;4;2022-03-29;9;0;4;1;9;0;2;0;0;1081183;6542;1306;13;1082352;3847;414;0;1
FR;4;2022-03-30;3;4;0;0;3;4;0;0;0;1081186;6546;1306;13;1082355;3851;414;0;1
FR;4;2022-03-31;3;3;2;1;3;4;1;0;0;1081189;6549;1308;14;1082358;3855;415;0;1
FR;4;2022-04-01;15;3;5;0;15;6;2;0;0;1081204;6552;1313;14;1082373;3861;417;0;1
FR;4;2022-04-02;4;4;0;0;5;3;0;0;0;1081208;6556;1313;14;1082378;3864;417;0;1
FR;4;2022-04-03;0;1;0;0;0;1;0;0;0;1081208;6557;1313;14;1082378;3865;417;0;1
FR;4;2022-04-04;4;4;4;0;5;5;2;0;0;1081212;6561;1317;14;1082383;3870;419;0;1
FR;4;2022-04-05;4;3;2;1;5;3;2;0;0;1081216;6564;1319;15;1082388;3873;421;0;1
FR;4;2022-04-06;6;0;0;0;6;0;0;0;0;1081222;6564;1319;15;1082394;3873;421;0;1
FR;4;2022-04-07;3;2;3;2;3;5;0;0;0;1081225;6566;1322;17;1082397;3878;421;0;1
FR;4;2022-04-08;4;2;1;0;4;2;1;0;0;1081229;6568;1323;17;1082401;3880;422;0;1
FR;4;2022-04-09;0;0;1;1;0;1;1;0;0;1081229;6568;1324;18;1082401;3881;423;0;1
FR;4;2022-04-10;2;2;0;0;2;2;0;0;0;1081231;6570;1324;18;1082403;3883;423;0;1
FR;4;2022-04-11;4;3;4;0;4;5;2;0;0;1081235;6573;1328;18;1082407;3888;425;0;1
FR;4;2022-04-12;5;1;4;0;5;2;3;0;0;1081240;6574;1332;18;1082412;3890;428;0;1
FR;4;2022-04-13;5;8;2;0;5;10;0;0;0;1081245;6582;1334;18;1082417;3900;428;0;1
FR;4;2022-04-14;6;4;2;1;7;5;1;0;0;1081251;6586;1336;19;1082424;3905;429;0;1
FR;4;2022-04-15;6;9;1;0;6;10;0;0;0;1081257;6595;1337;19;1082430;3915;429;0;1
FR;4;2022-04-16;1;0;0;0;1;0;0;0;0;1081258;6595;1337;19;1082431;3915;429;0;1
FR;4;2022-04-17;3;2;1;0;3;3;0;0;0;1081261;6597;1338;19;1082434;3918;429;0;1
FR;4;2022-04-18;2;2;6;0;2;4;4;0;0;1081263;6599;1344;19;1082436;3922;433;0;1
FR;4;2022-04-19;2;0;1;0;2;0;1;0;0;1081265;6599;1345;19;1082438;3922;434;0;1
FR;4;2022-04-20;14;4;1;1;15;3;1;0;0;1081279;6603;1346;20;1082453;3925;435;0;1
FR;4;2022-04-21;7;1;0;0;7;1;0;0;0;1081286;6604;1346;20;1082460;3926;435;0;1
FR;4;2022-04-22;1;1;2;0;1;2;1;0;0;1081287;6605;1348;20;1082461;3928;436;0;1
FR;4;2022-04-23;2;3;3;0;2;6;0;0;0;1081289;6608;1351;20;1082463;3934;436;0;1
FR;4;2022-04-24;0;3;0;0;0;3;0;0;0;1081289;6611;1351;20;1082463;3937;436;0;1
FR;4;2022-04-25;3;5;3;0;3;8;0;0;0;1081292;6616;1354;20;1082466;3945;436;0;1
FR;4;2022-04-26;5;6;1;0;5;6;1;0;0;1081297;6622;1355;20;1082471;3951;437;0;1
FR;4;2022-04-27;4;1;1;1;5;1;1;0;0;1081301;6623;1356;21;1082476;3952;438;0;1
FR;4;2022-04-28;3;5;5;1;3;7;4;0;0;1081304;6628;1361;22;1082479;3959;442;0;1
FR;4;2022-04-29;6;3;0;0;6;2;0;0;0;1081310;6631;1361;22;1082485;3961;442;0;1
FR;4;2022-04-30;2;1;1;0;2;2;0;0;0;1081312;6632;1362;22;1082487;3963;442;0;1
FR;4;2022-05-01;0;0;0;0;0;0;0;0;0;1081312;6632;1362;22;1082487;3963;442;0;1
FR;4;2022-05-02;5;16;6;0;5;19;3;0;0;1081317;6648;1368;22;1082492;3982;445;0;1
FR;4;2022-05-03;2;6;2;0;2;7;1;0;0;1081319;6654;1370;22;1082494;3989;446;0;1
FR;4;2022-05-04;7;4;1;0;7;4;1;0;0;1081326;6658;1371;22;1082501;3993;447;0;1
FR;4;2022-05-05;2;2;1;1;3;1;2;0;0;1081328;6660;1372;23;1082504;3994;449;0;1
FR;4;2022-05-06;5;3;1;0;6;2;1;0;0;1081333;6663;1373;23;1082510;3996;450;0;1
FR;4;2022-05-07;0;0;0;0;0;0;0;0;0;1081333;6663;1373;23;1082510;3996;450;0;1
FR;4;2022-05-08;1;1;0;0;1;1;0;0;0;1081334;6664;1373;23;1082511;3997;450;0;1
FR;4;2022-05-09;5;1;0;0;5;1;0;0;0;1081339;6665;1373;23;1082516;3998;450;0;1
FR;4;2022-05-10;3;1;0;2;3;3;0;0;0;1081342;6666;1373;25;1082519;4001;450;0;1
FR;4;2022-05-11;3;2;4;0;3;5;1;0;0;1081345;6668;1377;25;1082522;4006;451;0;1
FR;4;2022-05-12;7;4;2;1;7;5;1;0;1;1081352;6672;1379;26;1082529;4011;452;0;2
FR;4;2022-05-13;1;0;2;0;1;2;0;0;0;1081353;6672;1381;26;1082530;4013;452;0;2
FR;4;2022-05-14;0;2;0;0;0;2;0;0;0;1081353;6674;1381;26;1082530;4015;452;0;2
FR;4;2022-05-15;2;2;0;0;4;0;0;0;0;1081355;6676;1381;26;1082534;4015;452;0;2
FR;4;2022-05-16;5;2;2;0;5;2;2;0;0;1081360;6678;1383;26;1082539;4017;454;0;2
FR;4;2022-05-17;5;1;2;0;5;3;0;0;0;1081365;6679;1385;26;1082544;4020;454;0;2
FR;4;2022-05-18;3;6;0;0;3;6;0;0;0;1081368;6685;1385;26;1082547;4026;454;0;2
FR;4;2022-05-19;2;3;3;0;2;5;1;0;0;1081370;6688;1388;26;1082549;4031;455;0;2
FR;4;2022-05-20;4;2;3;0;4;2;3;0;0;1081374;6690;1391;26;1082553;4033;458;0;2
FR;4;2022-05-21;2;0;1;0;2;1;0;0;0;1081376;6690;1392;26;1082555;4034;458;0;2
FR;4;2022-05-22;0;0;1;0;0;1;0;0;0;1081376;6690;1393;26;1082555;4035;458;0;2
FR;4;2022-05-23;0;0;2;0;0;0;2;0;0;1081376;6690;1395;26;1082555;4035;460;0;2
FR;4;2022-05-24;2;4;1;0;2;5;0;0;0;1081378;6694;1396;26;1082557;4040;460;0;2
FR;4;2022-05-25;1;4;1;0;3;3;0;0;0;1081379;6698;1397;26;1082560;4043;460;0;2
FR;4;2022-05-26;5;0;1;0;5;1;0;0;0;1081384;6698;1398;26;1082565;4044;460;0;2
FR;4;2022-05-27;0;2;1;1;0;3;1;0;0;1081384;6700;1399;27;1082565;4047;461;0;2
FR;4;2022-05-28;1;0;0;0;1;0;0;0;0;1081385;6700;1399;27;1082566;4047;461;0;2
FR;4;2022-05-29;1;0;1;0;1;1;0;0;0;1081386;6700;1400;27;1082567;4048;461;0;2
FR;4;2022-05-30;3;4;2;0;3;5;1;0;0;1081389;6704;1402;27;1082570;4053;462;0;2
FR;4;2022-05-31;2;1;0;0;2;1;0;0;0;1081391;6705;1402;27;1082572;4054;462;0;2
FR;4;2022-06-01;3;11;7;0;3;15;3;0;0;1081394;6716;1409;27;1082575;4069;465;0;2
FR;4;2022-06-02;6;7;3;0;6;7;2;0;0;1081400;6723;1412;27;1082581;4076;467;0;2
FR;4;2022-06-03;2;6;4;1;2;7;4;0;0;1081402;6729;1416;28;1082583;4083;471;0;2
FR;4;2022-06-04;0;1;1;1;0;1;2;0;0;1081402;6730;1417;29;1082583;4084;473;0;2
FR;4;2022-06-05;0;0;0;0;0;0;0;0;0;1081402;6730;1417;29;1082583;4084;473;0;2
FR;4;2022-06-06;7;0;3;0;7;2;1;0;0;1081409;6730;1420;29;1082590;4086;474;0;2
FR;4;2022-06-07;6;2;0;1;6;2;1;0;0;1081415;6732;1420;30;1082596;4088;475;0;2
FR;4;2022-06-08;0;4;3;0;0;7;0;0;0;1081415;6736;1423;30;1082596;4095;475;0;2
FR;4;2022-06-09;1;2;0;0;2;1;0;0;0;1081416;6738;1423;30;1082598;4096;475;0;2
FR;4;2022-06-10;3;0;3;0;3;1;2;0;0;1081419;6738;1426;30;1082601;4097;477;0;2
FR;4;2022-06-11;1;0;0;0;1;0;0;0;0;1081420;6738;1426;30;1082602;4097;477;0;2
FR;4;2022-06-12;4;0;0;0;4;0;0;0;0;1081424;6738;1426;30;1082606;4097;477;0;2
FR;4;2022-06-13;5;2;3;0;6;2;1;0;0;1081429;6740;1429;30;1082612;4099;478;0;2
FR;4;2022-06-14;4;3;0;0;5;2;0;0;0;1081433;6743;1429;30;1082617;4101;478;0;2
FR;4;2022-06-15;8;3;4;0;8;3;4;0;0;1081441;6746;1433;30;1082625;4104;482;0;2
FR;4;2022-06-16;2;3;1;1;3;2;1;0;1;1081443;6749;1434;31;1082628;4106;483;0;3
FR;4;2022-06-17;6;1;0;0;6;1;0;0;0;1081449;6750;1434;31;1082634;4107;483;0;3
FR;4;2022-06-18;0;0;0;0;0;0;0;0;0;1081449;6750;1434;31;1082634;4107;483;0;3
FR;4;2022-06-19;3;0;0;0;3;0;0;0;0;1081452;6750;1434;31;1082637;4107;483;0;3
FR;4;2022-06-20;4;2;2;1;4;3;2;0;0;1081456;6752;1436;32;1082641;4110;485;0;3
FR;4;2022-06-21;5;2;3;1;6;3;2;0;0;1081461;6754;1439;33;1082647;4113;487;0;3
FR;4;2022-06-22;3;2;0;3;4;1;1;0;0;1081464;6756;1439;36;1082651;4114;488;0;3
FR;4;2022-06-23;3;3;3;0;3;5;1;0;0;1081467;6759;1442;36;1082654;4119;489;0;3
FR;4;2022-06-24;3;0;2;0;3;0;2;0;0;1081470;6759;1444;36;1082657;4119;491;0;3
FR;4;2022-06-25;1;0;1;1;1;1;1;0;0;1081471;6759;1445;37;1082658;4120;492;0;3
FR;4;2022-06-26;0;0;1;0;0;1;0;0;0;1081471;6759;1446;37;1082658;4121;492;0;3
FR;4;2022-06-27;2;2;0;3;2;2;3;0;0;1081473;6761;1446;40;1082660;4123;495;0;3
FR;4;2022-06-28;0;4;2;1;0;5;2;0;0;1081473;6765;1448;41;1082660;4128;497;0;3
FR;4;2022-06-29;1;2;0;0;1;2;0;0;0;1081474;6767;1448;41;1082661;4130;497;0;3
FR;4;2022-06-30;2;0;0;0;2;0;0;0;0;1081476;6767;1448;41;1082663;4130;497;0;3
FR;4;2022-07-01;2;4;8;0;2;4;8;0;0;1081478;6771;1456;41;1082665;4134;505;0;3
FR;4;2022-07-02;0;1;0;0;1;0;0;0;0;1081478;6772;1456;41;1082666;4134;505;0;3
FR;4;2022-07-03;0;0;0;0;0;0;0;0;0;1081478;6772;1456;41;1082666;4134;505;0;3
FR;4;2022-07-04;3;1;0;0;3;1;0;0;0;1081481;6773;1456;41;1082669;4135;505;0;3
FR;4;2022-07-05;2;0;2;0;2;2;0;0;0;1081483;6773;1458;41;1082671;4137;505;0;3
FR;4;2022-07-06;5;0;1;1;5;0;1;0;1;1081488;6773;1459;42;1082676;4137;506;0;4
FR;4;2022-07-07;1;0;2;1;1;0;3;0;0;1081489;6773;1461;43;1082677;4137;509;0;4
FR;4;2022-07-08;3;1;0;0;3;1;0;0;0;1081492;6774;1461;43;1082680;4138;509;0;4
FR;4;2022-07-09;2;2;1;0;2;3;0;0;0;1081494;6776;1462;43;1082682;4141;509;0;4
FR;4;2022-07-10;2;0;1;0;2;0;0;0;0;1081496;6776;1463;43;1082684;4141;509;0;4
FR;4;2022-07-11;2;0;2;0;2;0;1;0;0;1081498;6776;1465;43;1082686;4141;510;0;4
FR;4;2022-07-12;0;0;2;0;0;2;0;0;0;1081498;6776;1467;43;1082686;4143;510;0;4
FR;4;2022-07-13;2;2;3;0;2;2;3;0;0;1081500;6778;1470;43;1082688;4145;513;0;4
FR;4;2022-07-14;4;0;1;0;4;0;1;0;0;1081504;6778;1471;43;1082692;4145;514;0;4
FR;4;2022-07-15;11;2;0;0;11;2;0;0;0;1081515;6780;1471;43;1082703;4147;514;0;4
FR;4;2022-07-16;4;0;0;2;4;0;2;0;0;1081519;6780;1471;45;1082707;4147;516;0;4
FR;4;2022-07-17;1;0;1;1;1;0;2;0;0;1081520;6780;1472;46;1082708;4147;518;0;4
FR;4;2022-07-18;3;3;2;0;3;3;2;0;0;1081523;6783;1474;46;1082711;4150;520;0;4
FR;4;2022-07-19;4;0;1;0;4;1;0;0;0;1081527;6783;1475;46;1082715;4151;520;0;4
FR;4;2022-07-20;10;0;1;0;10;1;0;0;0;1081537;6783;1476;46;1082725;4152;520;0;4
FR;4;2022-07-21;2;1;1;0;2;1;1;0;0;1081539;6784;1477;46;1082727;4153;521;0;4
FR;4;2022-07-22;4;0;3;0;4;1;2;0;0;1081543;6784;1480;46;1082731;4154;523;0;4
FR;4;2022-07-23;1;2;0;0;1;1;0;0;0;1081544;6786;1480;46;1082732;4155;523;0;4
FR;4;2022-07-24;0;0;0;0;0;0;0;0;0;1081544;6786;1480;46;1082732;4155;523;0;4
FR;4;2022-07-25;5;0;2;0;5;2;0;0;0;1081549;6786;1482;46;1082737;4157;523;0;4
FR;4;2022-07-26;2;0;0;0;2;0;0;0;0;1081551;6786;1482;46;1082739;4157;523;0;4
FR;4;2022-07-27;2;1;0;0;2;0;0;0;0;1081553;6787;1482;46;1082741;4157;523;0;4
FR;4;2022-07-28;11;0;0;0;11;0;0;0;0;1081564;6787;1482;46;1082752;4157;523;0;4
FR;4;2022-07-29;3;0;2;0;3;1;1;0;0;1081567;6787;1484;46;1082755;4158;524;0;4
FR;4;2022-07-30;4;0;2;0;4;0;2;0;0;1081571;6787;1486;46;1082759;4158;526;0;4
FR;4;2022-07-31;0;0;0;0;0;0;0;0;0;1081571;6787;1486;46;1082759;4158;526;0;4
FR;4;2022-08-01;2;0;2;0;2;1;1;0;0;1081573;6787;1488;46;1082761;4159;527;0;4
FR;4;2022-08-02;6;0;0;0;6;0;0;0;0;1081579;6787;1488;46;1082767;4159;527;0;4
FR;4;2022-08-03;1;2;1;0;1;2;1;0;0;1081580;6789;1489;46;1082768;4161;528;0;4
FR;4;2022-08-04;3;2;0;1;3;2;1;0;0;1081583;6791;1489;47;1082771;4163;529;0;4
FR;4;2022-08-05;2;0;1;0;2;0;1;0;0;1081585;6791;1490;47;1082773;4163;530;0;4
FR;4;2022-08-06;2;0;0;0;2;0;0;0;0;1081587;6791;1490;47;1082775;4163;530;0;4
FR;4;2022-08-07;5;0;0;0;5;0;0;0;0;1081592;6791;1490;47;1082780;4163;530;0;4
FR;4;2022-08-08;1;0;1;1;1;1;1;0;0;1081593;6791;1491;48;1082781;4164;531;0;4
FR;4;2022-08-09;1;1;1;2;1;2;2;0;0;1081594;6792;1492;50;1082782;4166;533;0;4
FR;4;2022-08-10;5;1;1;0;6;1;0;0;0;1081599;6793;1493;50;1082788;4167;533;0;4
FR;4;2022-08-11;2;0;1;0;2;1;0;0;0;1081601;6793;1494;50;1082790;4168;533;0;4
FR;4;2022-08-12;4;0;1;0;4;0;1;0;0;1081605;6793;1495;50;1082794;4168;534;0;4
FR;4;2022-08-13;1;0;0;0;1;0;0;0;0;1081606;6793;1495;50;1082795;4168;534;0;4
FR;4;2022-08-14;0;0;0;0;0;0;0;0;0;1081606;6793;1495;50;1082795;4168;534;0;4
FR;4;2022-08-15;1;2;3;0;1;2;3;0;0;1081607;6795;1498;50;1082796;4170;537;0;4
FR;4;2022-08-16;0;0;1;0;0;1;0;0;0;1081607;6795;1499;50;1082796;4171;537;0;4
FR;4;2022-08-17;2;0;0;0;2;0;0;0;0;1081609;6795;1499;50;1082798;4171;537;0;4
FR;4;2022-08-18;3;0;0;0;3;0;0;0;0;1081612;6795;1499;50;1082801;4171;537;0;4
FR;4;2022-08-19;5;0;0;0;5;0;0;0;0;1081617;6795;1499;50;1082806;4171;537;0;4
FR;4;2022-08-20;1;1;0;0;2;0;0;0;0;1081618;6796;1499;50;1082808;4171;537;0;4
FR;4;2022-08-21;1;0;0;0;1;0;0;0;0;1081619;6796;1499;50;1082809;4171;537;0;4
FR;4;2022-08-22;4;9;0;0;4;9;0;0;0;1081623;6805;1499;50;1082813;4180;537;0;4
FR;4;2022-08-23;3;3;3;0;3;4;2;0;0;1081626;6808;1502;50;1082816;4184;539;0;4
FR;4;2022-08-24;5;0;0;1;5;0;1;0;0;1081631;6808;1502;51;1082821;4184;540;0;4
FR;4;2022-08-25;1;3;1;0;1;3;1;0;0;1081632;6811;1503;51;1082822;4187;541;0;4
FR;4;2022-08-26;2;0;0;1;2;0;1;0;0;1081634;6811;1503;52;1082824;4187;542;0;4
FR;4;2022-08-27;1;0;0;0;1;0;0;0;0;1081635;6811;1503;52;1082825;4187;542;0;4
FR;4;2022-08-28;0;1;0;0;0;0;0;0;0;1081635;6812;1503;52;1082825;4187;542;0;4
FR;4;2022-08-29;7;0;0;0;7;0;0;0;0;1081642;6812;1503;52;1082832;4187;542;0;4
FR;4;2022-08-30;4;0;0;0;4;0;0;0;0;1081646;6812;1503;52;1082836;4187;542;0;4
FR;4;2022-08-31;2;1;0;0;2;1;0;0;0;1081648;6813;1503;52;1082838;4188;542;0;4
FR;4;2022-09-01;3;8;2;0;4;7;2;0;0;1081651;6821;1505;52;1082842;4195;544;0;4
FR;4;2022-09-02;2;1;1;0;2;2;0;0;0;1081653;6822;1506;52;1082844;4197;544;0;4
FR;4;2022-09-03;3;0;0;0;3;0;0;0;0;1081656;6822;1506;52;1082847;4197;544;0;4
FR;4;2022-09-04;1;0;0;0;1;0;0;0;0;1081657;6822;1506;52;1082848;4197;544;0;4
FR;4;2022-09-05;2;2;0;0;2;2;0;0;0;1081659;6824;1506;52;1082850;4199;544;0;4
FR;4;2022-09-06;1;0;0;0;1;0;0;0;0;1081660;6824;1506;52;1082851;4199;544;0;4
FR;4;2022-09-07;1;0;1;1;1;1;1;0;0;1081661;6824;1507;53;1082852;4200;545;0;4
FR;4;2022-09-08;3;0;0;0;3;0;0;0;0;1081664;6824;1507;53;1082855;4200;545;0;4
FR;4;2022-09-09;2;0;0;0;2;0;0;0;0;1081666;6824;1507;53;1082857;4200;545;0;4
FR;4;2022-09-10;0;0;0;3;0;1;2;0;0;1081666;6824;1507;56;1082857;4201;547;0;4
FR;4;2022-09-11;2;0;0;0;2;0;0;0;0;1081668;6824;1507;56;1082859;4201;547;0;4
FR;4;2022-09-12;1;1;1;0;1;1;1;0;0;1081669;6825;1508;56;1082860;4202;548;0;4
FR;4;2022-09-13;2;0;0;0;2;0;0;0;0;1081671;6825;1508;56;1082862;4202;548;0;4
FR;4;2022-09-14;2;0;0;0;2;0;0;0;0;1081673;6825;1508;56;1082864;4202;548;0;4
FR;4;2022-09-15;3;0;0;0;3;0;0;0;0;1081676;6825;1508;56;1082867;4202;548;0;4
FR;4;2022-09-16;0;0;0;0;0;0;0;0;0;1081676;6825;1508;56;1082867;4202;548;0;4
FR;4;2022-09-17;2;0;0;0;2;0;0;0;0;1081678;6825;1508;56;1082869;4202;548;0;4
FR;4;2022-09-18;0;1;0;0;0;1;0;0;0;1081678;6826;1508;56;1082869;4203;548;0;4
FR;4;2022-09-19;2;0;2;0;2;2;0;0;0;1081680;6826;1510;56;1082871;4205;548;0;4
FR;4;2022-09-20;4;0;0;0;4;0;0;0;0;1081684;6826;1510;56;1082875;4205;548;0;4
FR;4;2022-09-21;2;1;0;0;2;1;0;0;0;1081686;6827;1510;56;1082877;4206;548;0;4
FR;4;2022-09-22;1;1;0;0;1;1;0;0;0;1081687;6828;1510;56;1082878;4207;548;0;4
FR;4;2022-09-23;2;3;0;0;3;2;0;0;0;1081689;6831;1510;56;1082881;4209;548;0;4
FR;4;2022-09-24;1;0;0;0;1;0;0;0;0;1081690;6831;1510;56;1082882;4209;548;0;4
FR;4;2022-09-25;0;0;0;0;0;0;0;0;0;1081690;6831;1510;56;1082882;4209;548;0;4
FR;4;2022-09-26;2;0;1;0;2;0;1;0;0;1081692;6831;1511;56;1082884;4209;549;0;4
FR;4;2022-09-27;0;0;1;1;0;0;2;0;0;1081692;6831;1512;57;1082884;4209;551;0;4
FR;4;2022-09-28;3;0;2;0;3;2;0;0;0;1081695;6831;1514;57;1082887;4211;551;0;4
FR;4;2022-09-29;3;0;1;1;3;1;1;0;0;1081698;6831;1515;58;1082890;4212;552;0;4
FR;4;2022-09-30;1;0;0;0;1;0;0;0;0;1081699;6831;1515;58;1082891;4212;552;0;4
FR;4;2022-10-01;1;1;0;0;2;0;0;0;0;1081700;6832;1515;58;1082893;4212;552;0;4
FR;4;2022-10-02;0;1;0;0;0;1;0;0;0;1081700;6833;1515;58;1082893;4213;552;0;4
FR;4;2022-10-03;3;2;1;0;4;2;0;0;0;1081703;6835;1516;58;1082897;4215;552;0;4
FR;4;2022-10-04;2;0;0;0;2;0;0;0;0;1081705;6835;1516;58;1082899;4215;552;0;4
FR;4;2022-10-05;0;1;0;0;0;1;0;0;0;1081705;6836;1516;58;1082899;4216;552;0;4
FR;4;2022-10-06;1;0;0;0;1;0;0;0;0;1081706;6836;1516;58;1082900;4216;552;0;4
FR;4;2022-10-07;3;0;1;0;3;0;1;0;0;1081709;6836;1517;58;1082903;4216;553;0;4
FR;4;2022-10-08;3;1;0;0;3;0;0;0;0;1081712;6837;1517;58;1082906;4216;553;0;4
FR;4;2022-10-09;0;0;0;0;0;0;0;0;0;1081712;6837;1517;58;1082906;4216;553;0;4
FR;4;2022-10-10;4;0;2;3;4;2;1;0;2;1081716;6837;1519;61;1082910;4218;554;0;6
FR;4;2022-10-11;1;2;0;0;1;1;0;0;0;1081717;6839;1519;61;1082911;4219;554;0;6
FR;4;2022-10-12;0;0;0;0;0;0;0;0;0;1081717;6839;1519;61;1082911;4219;554;0;6
FR;4;2022-10-13;5;0;0;0;5;0;0;0;0;1081722;6839;1519;61;1082916;4219;554;0;6
FR;4;2022-10-14;1;0;0;0;1;0;0;0;0;1081723;6839;1519;61;1082917;4219;554;0;6
FR;4;2022-10-15;0;1;0;0;0;1;0;0;0;1081723;6840;1519;61;1082917;4220;554;0;6
FR;4;2022-10-16;0;0;0;0;0;0;0;0;0;1081723;6840;1519;61;1082917;4220;554;0;6
FR;4;2022-10-17;2;0;1;0;2;1;0;0;0;1081725;6840;1520;61;1082919;4221;554;0;6
FR;4;2022-10-18;1;0;0;1;1;0;1;0;0;1081726;6840;1520;62;1082920;4221;555;0;6
FR;4;2022-10-19;1;0;0;2;1;0;2;0;3;1081727;6840;1520;64;1082921;4221;557;0;9
FR;4;2022-10-20;4;1;0;0;4;1;0;0;0;1081731;6841;1520;64;1082925;4222;557;0;9
FR;4;2022-10-21;1;0;0;0;1;0;0;0;0;1081732;6841;1520;64;1082926;4222;557;0;9
FR;4;2022-10-22;1;0;0;0;1;0;0;0;0;1081733;6841;1520;64;1082927;4222;557;0;9
FR;4;2022-10-23;0;0;0;0;0;0;0;0;0;1081733;6841;1520;64;1082927;4222;557;0;9
FR;4;2022-10-24;0;0;0;0;0;0;0;0;0;1081733;6841;1520;64;1082927;4222;557;0;9
FR;4;2022-10-25;1;0;0;0;1;0;0;0;0;1081734;6841;1520;64;1082928;4222;557;0;9
FR;4;2022-10-26;2;1;0;0;2;1;0;0;0;1081736;6842;1520;64;1082930;4223;557;0;9
FR;4;2022-10-27;3;1;1;0;3;0;1;0;0;1081739;6843;1521;64;1082933;4223;558;0;9
FR;4;2022-10-28;0;0;0;0;0;0;0;0;0;1081739;6843;1521;64;1082933;4223;558;0;9
FR;4;2022-10-29;1;0;0;3;1;0;3;0;3;1081740;6843;1521;67;1082934;4223;561;0;12
FR;4;2022-10-30;1;0;0;0;1;0;0;0;0;1081741;6843;1521;67;1082935;4223;561;0;12
FR;4;2022-10-31;0;0;0;0;0;0;0;0;0;1081741;6843;1521;67;1082935;4223;561;0;12
FR;4;2022-11-01;1;5;0;0;1;5;0;0;0;1081742;6848;1521;67;1082936;4228;561;0;12
FR;4;2022-11-02;0;0;2;2;0;1;3;0;0;1081742;6848;1523;69;1082936;4229;564;0;12
FR;4;2022-11-03;1;0;0;0;1;0;0;0;0;1081743;6848;1523;69;1082937;4229;564;0;12
FR;4;2022-11-04;4;1;0;0;4;0;0;0;0;1081747;6849;1523;69;1082941;4229;564;0;12
FR;4;2022-11-05;0;0;0;0;0;0;0;0;0;1081747;6849;1523;69;1082941;4229;564;0;12
FR;4;2022-11-06;1;0;0;0;1;0;0;0;0;1081748;6849;1523;69;1082942;4229;564;0;12
FR;4;2022-11-07;2;0;0;0;2;0;0;0;0;1081750;6849;1523;69;1082944;4229;564;0;12
FR;4;2022-11-08;7;0;0;0;7;0;0;0;0;1081757;6849;1523;69;1082951;4229;564;0;12
FR;4;2022-11-09;0;0;0;0;0;0;0;0;0;1081757;6849;1523;69;1082951;4229;564;0;12
FR;4;2022-11-10;0;0;0;0;0;0;0;0;0;1081757;6849;1523;69;1082951;4229;564;0;12
FR;4;2022-11-11;1;0;0;0;1;0;0;0;0;1081758;6849;1523;69;1082952;4229;564;0;12
FR;4;2022-11-12;3;0;0;0;3;0;0;0;0;1081761;6849;1523;69;1082955;4229;564;0;12
FR;4;2022-11-13;0;0;0;0;0;0;0;0;0;1081761;6849;1523;69;1082955;4229;564;0;12
FR;4;2022-11-14;0;0;0;0;0;0;0;0;0;1081761;6849;1523;69;1082955;4229;564;0;12
FR;4;2022-11-15;3;0;0;0;3;0;0;0;0;1081764;6849;1523;69;1082958;4229;564;0;12
FR;4;2022-11-16;1;1;0;0;1;1;0;0;0;1081765;6850;1523;69;1082959;4230;564;0;12
FR;4;2022-11-17;0;0;0;0;0;0;0;0;0;1081765;6850;1523;69;1082959;4230;564;0;12
FR;4;2022-11-18;2;0;1;0;2;0;1;0;0;1081767;6850;1524;69;1082961;4230;565;0;12
FR;4;2022-11-19;0;0;0;0;0;0;0;0;0;1081767;6850;1524;69;1082961;4230;565;0;12
FR;4;2022-11-20;0;0;0;0;0;0;0;0;0;1081767;6850;1524;69;1082961;4230;565;0;12
FR;4;2022-11-21;0;0;0;0;0;0;0;0;0;1081767;6850;1524;69;1082961;4230;565;0;12
FR;4;2022-11-22;0;0;0;0;0;0;0;0;0;1081767;6850;1524;69;1082961;4230;565;0;12
FR;4;2022-11-23;1;0;0;0;1;0;0;0;1;1081768;6850;1524;69;1082962;4230;565;0;13
FR;4;2022-11-24;0;0;0;0;0;0;0;0;0;1081768;6850;1524;69;1082962;4230;565;0;13
FR;4;2022-11-25;3;1;0;0;3;1;0;0;0;1081771;6851;1524;69;1082965;4231;565;0;13
FR;4;2022-11-26;0;0;0;0;0;0;0;0;0;1081771;6851;1524;69;1082965;4231;565;0;13
FR;4;2022-11-27;0;0;0;0;0;0;0;0;0;1081771;6851;1524;69;1082965;4231;565;0;13
FR;4;2022-11-28;3;0;0;0;3;0;0;0;0;1081774;6851;1524;69;1082968;4231;565;0;13
FR;4;2022-11-29;2;0;0;0;2;0;0;0;0;1081776;6851;1524;69;1082970;4231;565;0;13
FR;4;2022-11-30;0;0;0;0;0;0;0;0;0;1081776;6851;1524;69;1082970;4231;565;0;13
FR;4;2022-12-01;0;0;2;0;0;1;1;0;0;1081776;6851;1526;69;1082970;4232;566;0;13
FR;4;2022-12-02;2;0;0;1;2;0;0;0;1;1081778;6851;1526;70;1082972;4232;566;0;14
FR;4;2022-12-03;0;0;0;0;0;0;0;0;0;1081778;6851;1526;70;1082972;4232;566;0;14
FR;4;2022-12-04;0;0;0;0;0;0;0;0;0;1081778;6851;1526;70;1082972;4232;566;0;14
FR;4;2022-12-05;1;0;0;0;1;0;0;0;0;1081779;6851;1526;70;1082973;4232;566;0;14
FR;4;2022-12-06;1;0;0;0;1;0;0;0;0;1081780;6851;1526;70;1082974;4232;566;0;14
FR;4;2022-12-07;2;0;0;0;2;0;0;0;0;1081782;6851;1526;70;1082976;4232;566;0;14
FR;4;2022-12-08;1;0;0;0;1;0;0;0;0;1081783;6851;1526;70;1082977;4232;566;0;14
FR;4;2022-12-09;1;0;0;0;1;0;0;0;0;1081784;6851;1526;70;1082978;4232;566;0;14
FR;4;2022-12-10;1;0;0;0;1;0;0;0;0;1081785;6851;1526;70;1082979;4232;566;0;14
FR;4;2022-12-11;0;0;0;0;0;0;0;0;0;1081785;6851;1526;70;1082979;4232;566;0;14
FR;4;2022-12-12;0;1;0;5;0;1;5;0;0;1081785;6852;1526;75;1082979;4233;571;0;14
FR;4;2022-12-13;0;0;0;0;0;0;0;0;0;1081785;6852;1526;75;1082979;4233;571;0;14
FR;5;2020-12-27;0;0;0;0;0;0;0;0;0;0;0;0;0;0;0;0;0;0
FR;5;2020-12-28;0;0;0;0;0;0;0;0;0;0;0;0;0;0;0;0;0;0
FR;5;2020-12-29;0;0;0;0;0;0;0;0;0;0;0;0;0;0;0;0;0;0
FR;5;2020-12-30;0;0;0;0;0;0;0;0;0;0;0;0;0;0;0;0;0;0
FR;5;2020-12-31;0;0;0;0;0;0;0;0;0;0;0;0;0;0;0;0;0;0
FR;5;2021-01-01;0;0;0;0;0;0;0;0;0;0;0;0;0;0;0;0;0;0
FR;5;2021-01-02;0;0;0;0;0;0;0;0;0;0;0;0;0;0;0;0;0;0
FR;5;2021-01-03;0;0;0;0;0;0;0;0;0;0;0;0;0;0;0;0;0;0
FR;5;2021-01-04;0;0;0;0;0;0;0;0;0;0;0;0;0;0;0;0;0;0
FR;5;2021-01-05;0;0;0;0;0;0;0;0;0;0;0;0;0;0;0;0;0;0
FR;5;2021-01-06;0;0;0;0;0;0;0;0;0;0;0;0;0;0;0;0;0;0
FR;5;2021-01-07;0;0;0;0;0;0;0;0;0;0;0;0;0;0;0;0;0;0
FR;5;2021-01-08;0;0;0;0;0;0;0;0;0;0;0;0;0;0;0;0;0;0
FR;5;2021-01-09;0;0;0;0;0;0;0;0;0;0;0;0;0;0;0;0;0;0
FR;5;2021-01-10;0;0;0;0;0;0;0;0;0;0;0;0;0;0;0;0;0;0
FR;5;2021-01-11;0;0;0;0;0;0;0;0;0;0;0;0;0;0;0;0;0;0
FR;5;2021-01-12;0;0;0;0;0;0;0;0;0;0;0;0;0;0;0;0;0;0
FR;5;2021-01-13;0;0;0;0;0;0;0;0;0;0;0;0;0;0;0;0;0;0
FR;5;2021-01-14;0;0;0;0;0;0;0;0;0;0;0;0;0;0;0;0;0;0
FR;5;2021-01-15;0;0;0;0;0;0;0;0;0;0;0;0;0;0;0;0;0;0
FR;5;2021-01-16;0;0;0;0;0;0;0;0;0;0;0;0;0;0;0;0;0;0
FR;5;2021-01-17;0;0;0;0;0;0;0;0;0;0;0;0;0;0;0;0;0;0
FR;5;2021-01-18;0;0;0;0;0;0;0;0;0;0;0;0;0;0;0;0;0;0
FR;5;2021-01-19;0;0;0;0;0;0;0;0;0;0;0;0;0;0;0;0;0;0
FR;5;2021-01-20;0;0;0;0;0;0;0;0;0;0;0;0;0;0;0;0;0;0
FR;5;2021-01-21;0;0;0;0;0;0;0;0;0;0;0;0;0;0;0;0;0;0
FR;5;2021-01-22;0;0;0;0;0;0;0;0;0;0;0;0;0;0;0;0;0;0
FR;5;2021-01-23;0;0;0;0;0;0;0;0;0;0;0;0;0;0;0;0;0;0
FR;5;2021-01-24;0;0;0;0;0;0;0;0;0;0;0;0;0;0;0;0;0;0
FR;5;2021-01-25;0;0;0;0;0;0;0;0;0;0;0;0;0;0;0;0;0;0
FR;5;2021-01-26;0;0;0;0;0;0;0;0;0;0;0;0;0;0;0;0;0;0
FR;5;2021-01-27;0;0;0;0;0;0;0;0;0;0;0;0;0;0;0;0;0;0
FR;5;2021-01-28;0;0;0;0;0;0;0;0;0;0;0;0;0;0;0;0;0;0
FR;5;2021-01-29;0;0;0;0;0;0;0;0;0;0;0;0;0;0;0;0;0;0
FR;5;2021-01-30;0;0;0;0;0;0;0;0;0;0;0;0;0;0;0;0;0;0
FR;5;2021-01-31;0;0;0;0;0;0;0;0;0;0;0;0;0;0;0;0;0;0
FR;5;2021-02-01;0;0;0;0;0;0;0;0;0;0;0;0;0;0;0;0;0;0
FR;5;2021-02-02;0;0;0;0;0;0;0;0;0;0;0;0;0;0;0;0;0;0
FR;5;2021-02-03;0;0;0;0;0;0;0;0;0;0;0;0;0;0;0;0;0;0
FR;5;2021-02-04;0;0;0;0;0;0;0;0;0;0;0;0;0;0;0;0;0;0
FR;5;2021-02-05;0;0;0;0;0;0;0;0;0;0;0;0;0;0;0;0;0;0
FR;5;2021-02-06;0;0;0;0;0;0;0;0;0;0;0;0;0;0;0;0;0;0
FR;5;2021-02-07;0;0;0;0;0;0;0;0;0;0;0;0;0;0;0;0;0;0
FR;5;2021-02-08;0;0;0;0;0;0;0;0;0;0;0;0;0;0;0;0;0;0
FR;5;2021-02-09;0;0;0;0;0;0;0;0;0;0;0;0;0;0;0;0;0;0
FR;5;2021-02-10;0;0;0;0;0;0;0;0;0;0;0;0;0;0;0;0;0;0
FR;5;2021-02-11;0;0;0;0;0;0;0;0;0;0;0;0;0;0;0;0;0;0
FR;5;2021-02-12;0;0;0;0;0;0;0;0;0;0;0;0;0;0;0;0;0;0
FR;5;2021-02-13;0;0;0;0;0;0;0;0;0;0;0;0;0;0;0;0;0;0
FR;5;2021-02-14;0;0;0;0;0;0;0;0;0;0;0;0;0;0;0;0;0;0
FR;5;2021-02-15;0;0;0;0;0;0;0;0;0;0;0;0;0;0;0;0;0;0
FR;5;2021-02-16;0;0;0;0;0;0;0;0;0;0;0;0;0;0;0;0;0;0
FR;5;2021-02-17;0;0;0;0;0;0;0;0;0;0;0;0;0;0;0;0;0;0
FR;5;2021-02-18;0;0;0;0;0;0;0;0;0;0;0;0;0;0;0;0;0;0
FR;5;2021-02-19;0;0;0;0;0;0;0;0;0;0;0;0;0;0;0;0;0;0
FR;5;2021-02-20;0;0;0;0;0;0;0;0;0;0;0;0;0;0;0;0;0;0
FR;5;2021-02-21;0;0;0;0;0;0;0;0;0;0;0;0;0;0;0;0;0;0
FR;5;2021-02-22;0;0;0;0;0;0;0;0;0;0;0;0;0;0;0;0;0;0
FR;5;2021-02-23;0;0;0;0;0;0;0;0;0;0;0;0;0;0;0;0;0;0
FR;5;2021-02-24;0;0;0;0;0;0;0;0;0;0;0;0;0;0;0;0;0;0
FR;5;2021-02-25;0;0;0;0;0;0;0;0;0;0;0;0;0;0;0;0;0;0
FR;5;2021-02-26;0;0;0;0;0;0;0;0;0;0;0;0;0;0;0;0;0;0
FR;5;2021-02-27;0;0;0;0;0;0;0;0;0;0;0;0;0;0;0;0;0;0
FR;5;2021-02-28;0;0;0;0;0;0;0;0;0;0;0;0;0;0;0;0;0;0
FR;5;2021-03-01;0;0;0;0;0;0;0;0;0;0;0;0;0;0;0;0;0;0
FR;5;2021-03-02;0;0;0;0;0;0;0;0;0;0;0;0;0;0;0;0;0;0
FR;5;2021-03-03;0;0;0;0;0;0;0;0;0;0;0;0;0;0;0;0;0;0
FR;5;2021-03-04;0;0;0;0;0;0;0;0;0;0;0;0;0;0;0;0;0;0
FR;5;2021-03-05;0;0;0;0;0;0;0;0;0;0;0;0;0;0;0;0;0;0
FR;5;2021-03-06;0;0;0;0;0;0;0;0;0;0;0;0;0;0;0;0;0;0
FR;5;2021-03-07;0;0;0;0;0;0;0;0;0;0;0;0;0;0;0;0;0;0
FR;5;2021-03-08;0;0;0;0;0;0;0;0;0;0;0;0;0;0;0;0;0;0
FR;5;2021-03-09;0;0;0;0;0;0;0;0;0;0;0;0;0;0;0;0;0;0
FR;5;2021-03-10;0;0;0;0;0;0;0;0;0;0;0;0;0;0;0;0;0;0
FR;5;2021-03-11;0;0;0;0;0;0;0;0;0;0;0;0;0;0;0;0;0;0
FR;5;2021-03-12;0;0;0;0;0;0;0;0;0;0;0;0;0;0;0;0;0;0
FR;5;2021-03-13;0;0;0;0;0;0;0;0;0;0;0;0;0;0;0;0;0;0
FR;5;2021-03-14;0;0;0;0;0;0;0;0;0;0;0;0;0;0;0;0;0;0
FR;5;2021-03-15;0;0;0;0;0;0;0;0;0;0;0;0;0;0;0;0;0;0
FR;5;2021-03-16;0;0;0;0;0;0;0;0;0;0;0;0;0;0;0;0;0;0
FR;5;2021-03-17;0;0;0;0;0;0;0;0;0;0;0;0;0;0;0;0;0;0
FR;5;2021-03-18;0;0;0;0;0;0;0;0;0;0;0;0;0;0;0;0;0;0
FR;5;2021-03-19;0;0;0;0;0;0;0;0;0;0;0;0;0;0;0;0;0;0
FR;5;2021-03-20;0;0;0;0;0;0;0;0;0;0;0;0;0;0;0;0;0;0
FR;5;2021-03-21;0;0;0;0;0;0;0;0;0;0;0;0;0;0;0;0;0;0
FR;5;2021-03-22;0;0;0;0;0;0;0;0;0;0;0;0;0;0;0;0;0;0
FR;5;2021-03-23;0;0;0;0;0;0;0;0;0;0;0;0;0;0;0;0;0;0
FR;5;2021-03-24;0;0;0;0;0;0;0;0;0;0;0;0;0;0;0;0;0;0
FR;5;2021-03-25;0;0;0;0;0;0;0;0;0;0;0;0;0;0;0;0;0;0
FR;5;2021-03-26;0;0;0;0;0;0;0;0;0;0;0;0;0;0;0;0;0;0
FR;5;2021-03-27;0;0;0;0;0;0;0;0;0;0;0;0;0;0;0;0;0;0
FR;5;2021-03-28;0;0;0;0;0;0;0;0;0;0;0;0;0;0;0;0;0;0
FR;5;2021-03-29;0;0;0;0;0;0;0;0;0;0;0;0;0;0;0;0;0;0
FR;5;2021-03-30;0;0;0;0;0;0;0;0;0;0;0;0;0;0;0;0;0;0
FR;5;2021-03-31;0;0;0;0;0;0;0;0;0;0;0;0;0;0;0;0;0;0
FR;5;2021-04-01;0;0;0;0;0;0;0;0;0;0;0;0;0;0;0;0;0;0
FR;5;2021-04-02;0;0;0;0;0;0;0;0;0;0;0;0;0;0;0;0;0;0
FR;5;2021-04-03;0;0;0;0;0;0;0;0;0;0;0;0;0;0;0;0;0;0
FR;5;2021-04-04;0;0;0;0;0;0;0;0;0;0;0;0;0;0;0;0;0;0
FR;5;2021-04-05;0;0;0;0;0;0;0;0;0;0;0;0;0;0;0;0;0;0
FR;5;2021-04-06;0;0;0;0;0;0;0;0;0;0;0;0;0;0;0;0;0;0
FR;5;2021-04-07;0;0;0;0;0;0;0;0;0;0;0;0;0;0;0;0;0;0
FR;5;2021-04-08;0;0;0;0;0;0;0;0;0;0;0;0;0;0;0;0;0;0
FR;5;2021-04-09;0;0;0;0;0;0;0;0;0;0;0;0;0;0;0;0;0;0
FR;5;2021-04-10;0;0;0;0;0;0;0;0;0;0;0;0;0;0;0;0;0;0
FR;5;2021-04-11;0;0;0;0;0;0;0;0;0;0;0;0;0;0;0;0;0;0
FR;5;2021-04-12;0;0;0;0;0;0;0;0;0;0;0;0;0;0;0;0;0;0
FR;5;2021-04-13;0;0;0;0;0;0;0;0;0;0;0;0;0;0;0;0;0;0
FR;5;2021-04-14;0;0;0;0;0;0;0;0;0;0;0;0;0;0;0;0;0;0
FR;5;2021-04-15;0;0;0;0;0;0;0;0;0;0;0;0;0;0;0;0;0;0
FR;5;2021-04-16;0;0;0;0;0;0;0;0;0;0;0;0;0;0;0;0;0;0
FR;5;2021-04-17;0;0;0;0;0;0;0;0;0;0;0;0;0;0;0;0;0;0
FR;5;2021-04-18;0;0;0;0;0;0;0;0;0;0;0;0;0;0;0;0;0;0
FR;5;2021-04-19;0;0;0;0;0;0;0;0;0;0;0;0;0;0;0;0;0;0
FR;5;2021-04-20;0;0;0;0;0;0;0;0;0;0;0;0;0;0;0;0;0;0
FR;5;2021-04-21;0;0;0;0;0;0;0;0;0;0;0;0;0;0;0;0;0;0
FR;5;2021-04-22;0;0;0;0;0;0;0;0;0;0;0;0;0;0;0;0;0;0
FR;5;2021-04-23;0;0;0;0;0;0;0;0;0;0;0;0;0;0;0;0;0;0
FR;5;2021-04-24;0;0;0;0;0;0;0;0;0;0;0;0;0;0;0;0;0;0
FR;5;2021-04-25;0;0;0;0;0;0;0;0;0;0;0;0;0;0;0;0;0;0
FR;5;2021-04-26;0;0;0;0;0;0;0;0;0;0;0;0;0;0;0;0;0;0
FR;5;2021-04-27;0;0;0;0;0;0;0;0;0;0;0;0;0;0;0;0;0;0
FR;5;2021-04-28;0;0;0;0;0;0;0;0;0;0;0;0;0;0;0;0;0;0
FR;5;2021-04-29;0;0;0;0;0;0;0;0;0;0;0;0;0;0;0;0;0;0
FR;5;2021-04-30;0;0;0;0;0;0;0;0;0;0;0;0;0;0;0;0;0;0
FR;5;2021-05-01;0;0;0;0;0;0;0;0;0;0;0;0;0;0;0;0;0;0
FR;5;2021-05-02;0;0;0;0;0;0;0;0;0;0;0;0;0;0;0;0;0;0
FR;5;2021-05-03;0;0;0;0;0;0;0;0;0;0;0;0;0;0;0;0;0;0
FR;5;2021-05-04;0;0;0;0;0;0;0;0;0;0;0;0;0;0;0;0;0;0
FR;5;2021-05-05;0;0;0;0;0;0;0;0;0;0;0;0;0;0;0;0;0;0
FR;5;2021-05-06;0;0;0;0;0;0;0;0;0;0;0;0;0;0;0;0;0;0
FR;5;2021-05-07;0;0;0;0;0;0;0;0;0;0;0;0;0;0;0;0;0;0
FR;5;2021-05-08;0;0;0;0;0;0;0;0;0;0;0;0;0;0;0;0;0;0
FR;5;2021-05-09;0;0;0;0;0;0;0;0;0;0;0;0;0;0;0;0;0;0
FR;5;2021-05-10;0;0;0;0;0;0;0;0;0;0;0;0;0;0;0;0;0;0
FR;5;2021-05-11;0;0;0;0;0;0;0;0;0;0;0;0;0;0;0;0;0;0
FR;5;2021-05-12;0;0;0;0;0;0;0;0;0;0;0;0;0;0;0;0;0;0
FR;5;2021-05-13;0;0;0;0;0;0;0;0;0;0;0;0;0;0;0;0;0;0
FR;5;2021-05-14;0;0;0;0;0;0;0;0;0;0;0;0;0;0;0;0;0;0
FR;5;2021-05-15;0;0;0;0;0;0;0;0;0;0;0;0;0;0;0;0;0;0
FR;5;2021-05-16;0;0;0;0;0;0;0;0;0;0;0;0;0;0;0;0;0;0
FR;5;2021-05-17;0;0;0;0;0;0;0;0;0;0;0;0;0;0;0;0;0;0
FR;5;2021-05-18;0;0;0;0;0;0;0;0;0;0;0;0;0;0;0;0;0;0
FR;5;2021-05-19;0;0;0;0;0;0;0;0;0;0;0;0;0;0;0;0;0;0
FR;5;2021-05-20;0;0;0;0;0;0;0;0;0;0;0;0;0;0;0;0;0;0
FR;5;2021-05-21;0;0;0;0;0;0;0;0;0;0;0;0;0;0;0;0;0;0
FR;5;2021-05-22;0;0;0;0;0;0;0;0;0;0;0;0;0;0;0;0;0;0
FR;5;2021-05-23;0;0;0;0;0;0;0;0;0;0;0;0;0;0;0;0;0;0
FR;5;2021-05-24;0;0;0;0;0;0;0;0;0;0;0;0;0;0;0;0;0;0
FR;5;2021-05-25;0;0;0;0;0;0;0;0;0;0;0;0;0;0;0;0;0;0
FR;5;2021-05-26;0;0;0;0;0;0;0;0;0;0;0;0;0;0;0;0;0;0
FR;5;2021-05-27;0;0;0;0;0;0;0;0;0;0;0;0;0;0;0;0;0;0
FR;5;2021-05-28;0;0;0;0;0;0;0;0;0;0;0;0;0;0;0;0;0;0
FR;5;2021-05-29;0;0;0;0;0;0;0;0;0;0;0;0;0;0;0;0;0;0
FR;5;2021-05-30;0;0;0;0;0;0;0;0;0;0;0;0;0;0;0;0;0;0
FR;5;2021-05-31;0;0;0;0;0;0;0;0;0;0;0;0;0;0;0;0;0;0
FR;5;2021-06-01;0;0;0;0;0;0;0;0;0;0;0;0;0;0;0;0;0;0
FR;5;2021-06-02;0;0;0;0;0;0;0;0;0;0;0;0;0;0;0;0;0;0
FR;5;2021-06-03;0;0;0;0;0;0;0;0;0;0;0;0;0;0;0;0;0;0
FR;5;2021-06-04;0;0;0;0;0;0;0;0;0;0;0;0;0;0;0;0;0;0
FR;5;2021-06-05;0;0;0;0;0;0;0;0;0;0;0;0;0;0;0;0;0;0
FR;5;2021-06-06;0;0;0;0;0;0;0;0;0;0;0;0;0;0;0;0;0;0
FR;5;2021-06-07;0;0;0;0;0;0;0;0;0;0;0;0;0;0;0;0;0;0
FR;5;2021-06-08;0;0;0;0;0;0;0;0;0;0;0;0;0;0;0;0;0;0
FR;5;2021-06-09;0;0;0;0;0;0;0;0;0;0;0;0;0;0;0;0;0;0
FR;5;2021-06-10;0;0;0;0;0;0;0;0;0;0;0;0;0;0;0;0;0;0
FR;5;2021-06-11;0;0;0;0;0;0;0;0;0;0;0;0;0;0;0;0;0;0
FR;5;2021-06-12;0;0;0;0;0;0;0;0;0;0;0;0;0;0;0;0;0;0
FR;5;2021-06-13;0;0;0;0;0;0;0;0;0;0;0;0;0;0;0;0;0;0
FR;5;2021-06-14;0;0;0;0;0;0;0;0;0;0;0;0;0;0;0;0;0;0
FR;5;2021-06-15;0;0;0;0;0;0;0;0;0;0;0;0;0;0;0;0;0;0
FR;5;2021-06-16;0;0;0;0;0;0;0;0;0;0;0;0;0;0;0;0;0;0
FR;5;2021-06-17;0;0;0;0;0;0;0;0;0;0;0;0;0;0;0;0;0;0
FR;5;2021-06-18;0;0;0;0;0;0;0;0;0;0;0;0;0;0;0;0;0;0
FR;5;2021-06-19;0;0;0;0;0;0;0;0;0;0;0;0;0;0;0;0;0;0
FR;5;2021-06-20;0;0;0;0;0;0;0;0;0;0;0;0;0;0;0;0;0;0
FR;5;2021-06-21;0;0;0;0;0;0;0;0;0;0;0;0;0;0;0;0;0;0
FR;5;2021-06-22;0;0;0;0;0;0;0;0;0;0;0;0;0;0;0;0;0;0
FR;5;2021-06-23;0;0;0;0;0;0;0;0;0;0;0;0;0;0;0;0;0;0
FR;5;2021-06-24;0;0;0;0;0;0;0;0;0;0;0;0;0;0;0;0;0;0
FR;5;2021-06-25;0;0;0;0;0;0;0;0;0;0;0;0;0;0;0;0;0;0
FR;5;2021-06-26;0;0;0;0;0;0;0;0;0;0;0;0;0;0;0;0;0;0
FR;5;2021-06-27;0;0;0;0;0;0;0;0;0;0;0;0;0;0;0;0;0;0
FR;5;2021-06-28;0;0;0;0;0;0;0;0;0;0;0;0;0;0;0;0;0;0
FR;5;2021-06-29;0;0;0;0;0;0;0;0;0;0;0;0;0;0;0;0;0;0
FR;5;2021-06-30;0;0;0;0;0;0;0;0;0;0;0;0;0;0;0;0;0;0
FR;5;2021-07-01;0;0;0;0;0;0;0;0;0;0;0;0;0;0;0;0;0;0
FR;5;2021-07-02;0;0;0;0;0;0;0;0;0;0;0;0;0;0;0;0;0;0
FR;5;2021-07-03;0;0;0;0;0;0;0;0;0;0;0;0;0;0;0;0;0;0
FR;5;2021-07-04;0;0;0;0;0;0;0;0;0;0;0;0;0;0;0;0;0;0
FR;5;2021-07-05;0;0;0;0;0;0;0;0;0;0;0;0;0;0;0;0;0;0
FR;5;2021-07-06;0;0;0;0;0;0;0;0;0;0;0;0;0;0;0;0;0;0
FR;5;2021-07-07;0;0;0;0;0;0;0;0;0;0;0;0;0;0;0;0;0;0
FR;5;2021-07-08;0;0;0;0;0;0;0;0;0;0;0;0;0;0;0;0;0;0
FR;5;2021-07-09;0;0;0;0;0;0;0;0;0;0;0;0;0;0;0;0;0;0
FR;5;2021-07-10;0;0;0;0;0;0;0;0;0;0;0;0;0;0;0;0;0;0
FR;5;2021-07-11;0;0;0;0;0;0;0;0;0;0;0;0;0;0;0;0;0;0
FR;5;2021-07-12;0;0;0;0;0;0;0;0;0;0;0;0;0;0;0;0;0;0
FR;5;2021-07-13;0;0;0;0;0;0;0;0;0;0;0;0;0;0;0;0;0;0
FR;5;2021-07-14;0;0;0;0;0;0;0;0;0;0;0;0;0;0;0;0;0;0
FR;5;2021-07-15;0;0;0;0;0;0;0;0;0;0;0;0;0;0;0;0;0;0
FR;5;2021-07-16;0;0;0;0;0;0;0;0;0;0;0;0;0;0;0;0;0;0
FR;5;2021-07-17;0;0;0;0;0;0;0;0;0;0;0;0;0;0;0;0;0;0
FR;5;2021-07-18;0;0;0;0;0;0;0;0;0;0;0;0;0;0;0;0;0;0
FR;5;2021-07-19;0;0;0;0;0;0;0;0;0;0;0;0;0;0;0;0;0;0
FR;5;2021-07-20;0;0;0;0;0;0;0;0;0;0;0;0;0;0;0;0;0;0
FR;5;2021-07-21;0;0;0;0;0;0;0;0;0;0;0;0;0;0;0;0;0;0
FR;5;2021-07-22;0;0;0;0;0;0;0;0;0;0;0;0;0;0;0;0;0;0
FR;5;2021-07-23;0;0;0;0;0;0;0;0;0;0;0;0;0;0;0;0;0;0
FR;5;2021-07-24;0;0;0;0;0;0;0;0;0;0;0;0;0;0;0;0;0;0
FR;5;2021-07-25;0;0;0;0;0;0;0;0;0;0;0;0;0;0;0;0;0;0
FR;5;2021-07-26;0;0;0;0;0;0;0;0;0;0;0;0;0;0;0;0;0;0
FR;5;2021-07-27;0;0;0;0;0;0;0;0;0;0;0;0;0;0;0;0;0;0
FR;5;2021-07-28;0;0;0;0;0;0;0;0;0;0;0;0;0;0;0;0;0;0
FR;5;2021-07-29;0;0;0;0;0;0;0;0;0;0;0;0;0;0;0;0;0;0
FR;5;2021-07-30;0;0;0;0;0;0;0;0;0;0;0;0;0;0;0;0;0;0
FR;5;2021-07-31;0;0;0;0;0;0;0;0;0;0;0;0;0;0;0;0;0;0
FR;5;2021-08-01;0;0;0;0;0;0;0;0;0;0;0;0;0;0;0;0;0;0
FR;5;2021-08-02;0;0;0;0;0;0;0;0;0;0;0;0;0;0;0;0;0;0
FR;5;2021-08-03;0;0;0;0;0;0;0;0;0;0;0;0;0;0;0;0;0;0
FR;5;2021-08-04;0;0;0;0;0;0;0;0;0;0;0;0;0;0;0;0;0;0
FR;5;2021-08-05;0;0;0;0;0;0;0;0;0;0;0;0;0;0;0;0;0;0
FR;5;2021-08-06;0;0;0;0;0;0;0;0;0;0;0;0;0;0;0;0;0;0
FR;5;2021-08-07;0;0;0;0;0;0;0;0;0;0;0;0;0;0;0;0;0;0
FR;5;2021-08-08;0;0;0;0;0;0;0;0;0;0;0;0;0;0;0;0;0;0
FR;5;2021-08-09;0;0;0;0;0;0;0;0;0;0;0;0;0;0;0;0;0;0
FR;5;2021-08-10;0;0;0;0;0;0;0;0;0;0;0;0;0;0;0;0;0;0
FR;5;2021-08-11;0;0;0;0;0;0;0;0;0;0;0;0;0;0;0;0;0;0
FR;5;2021-08-12;0;0;0;0;0;0;0;0;0;0;0;0;0;0;0;0;0;0
FR;5;2021-08-13;0;0;0;0;0;0;0;0;0;0;0;0;0;0;0;0;0;0
FR;5;2021-08-14;0;0;0;0;0;0;0;0;0;0;0;0;0;0;0;0;0;0
FR;5;2021-08-15;0;0;0;0;0;0;0;0;0;0;0;0;0;0;0;0;0;0
FR;5;2021-08-16;0;0;0;0;0;0;0;0;0;0;0;0;0;0;0;0;0;0
FR;5;2021-08-17;0;0;0;0;0;0;0;0;0;0;0;0;0;0;0;0;0;0
FR;5;2021-08-18;0;0;0;0;0;0;0;0;0;0;0;0;0;0;0;0;0;0
FR;5;2021-08-19;0;0;0;0;0;0;0;0;0;0;0;0;0;0;0;0;0;0
FR;5;2021-08-20;0;0;0;0;0;0;0;0;0;0;0;0;0;0;0;0;0;0
FR;5;2021-08-21;0;0;0;0;0;0;0;0;0;0;0;0;0;0;0;0;0;0
FR;5;2021-08-22;0;0;0;0;0;0;0;0;0;0;0;0;0;0;0;0;0;0
FR;5;2021-08-23;0;0;0;0;0;0;0;0;0;0;0;0;0;0;0;0;0;0
FR;5;2021-08-24;0;0;0;0;0;0;0;0;0;0;0;0;0;0;0;0;0;0
FR;5;2021-08-25;0;0;0;0;0;0;0;0;0;0;0;0;0;0;0;0;0;0
FR;5;2021-08-26;0;0;0;0;0;0;0;0;0;0;0;0;0;0;0;0;0;0
FR;5;2021-08-27;0;0;0;0;0;0;0;0;0;0;0;0;0;0;0;0;0;0
FR;5;2021-08-28;0;0;0;0;0;0;0;0;0;0;0;0;0;0;0;0;0;0
FR;5;2021-08-29;0;0;0;0;0;0;0;0;0;0;0;0;0;0;0;0;0;0
FR;5;2021-08-30;0;0;0;0;0;0;0;0;0;0;0;0;0;0;0;0;0;0
FR;5;2021-08-31;0;0;0;0;0;0;0;0;0;0;0;0;0;0;0;0;0;0
FR;5;2021-09-01;0;0;0;0;0;0;0;0;0;0;0;0;0;0;0;0;0;0
FR;5;2021-09-02;0;0;0;0;0;0;0;0;0;0;0;0;0;0;0;0;0;0
FR;5;2021-09-03;0;0;0;0;0;0;0;0;0;0;0;0;0;0;0;0;0;0
FR;5;2021-09-04;0;0;0;0;0;0;0;0;0;0;0;0;0;0;0;0;0;0
FR;5;2021-09-05;0;0;0;0;0;0;0;0;0;0;0;0;0;0;0;0;0;0
FR;5;2021-09-06;0;0;0;0;0;0;0;0;0;0;0;0;0;0;0;0;0;0
FR;5;2021-09-07;0;0;0;0;0;0;0;0;0;0;0;0;0;0;0;0;0;0
FR;5;2021-09-08;0;0;0;0;0;0;0;0;0;0;0;0;0;0;0;0;0;0
FR;5;2021-09-09;0;0;0;0;0;0;0;0;0;0;0;0;0;0;0;0;0;0
FR;5;2021-09-10;0;0;0;0;0;0;0;0;0;0;0;0;0;0;0;0;0;0
FR;5;2021-09-11;0;0;0;0;0;0;0;0;0;0;0;0;0;0;0;0;0;0
FR;5;2021-09-12;0;0;0;0;0;0;0;0;0;0;0;0;0;0;0;0;0;0
FR;5;2021-09-13;0;0;0;0;0;0;0;0;0;0;0;0;0;0;0;0;0;0
FR;5;2021-09-14;0;0;0;0;0;0;0;0;0;0;0;0;0;0;0;0;0;0
FR;5;2021-09-15;0;0;0;0;0;0;0;0;0;0;0;0;0;0;0;0;0;0
FR;5;2021-09-16;0;0;0;0;0;0;0;0;0;0;0;0;0;0;0;0;0;0
FR;5;2021-09-17;0;0;0;0;0;0;0;0;0;0;0;0;0;0;0;0;0;0
FR;5;2021-09-18;0;0;0;0;0;0;0;0;0;0;0;0;0;0;0;0;0;0
FR;5;2021-09-19;0;0;0;0;0;0;0;0;0;0;0;0;0;0;0;0;0;0
FR;5;2021-09-20;0;0;0;0;0;0;0;0;0;0;0;0;0;0;0;0;0;0
FR;5;2021-09-21;0;0;0;0;0;0;0;0;0;0;0;0;0;0;0;0;0;0
FR;5;2021-09-22;0;0;0;0;0;0;0;0;0;0;0;0;0;0;0;0;0;0
FR;5;2021-09-23;0;0;0;0;0;0;0;0;0;0;0;0;0;0;0;0;0;0
FR;5;2021-09-24;0;0;0;0;0;0;0;0;0;0;0;0;0;0;0;0;0;0
FR;5;2021-09-25;0;0;0;0;0;0;0;0;0;0;0;0;0;0;0;0;0;0
FR;5;2021-09-26;0;0;0;0;0;0;0;0;0;0;0;0;0;0;0;0;0;0
FR;5;2021-09-27;0;0;0;0;0;0;0;0;0;0;0;0;0;0;0;0;0;0
FR;5;2021-09-28;0;0;0;0;0;0;0;0;0;0;0;0;0;0;0;0;0;0
FR;5;2021-09-29;0;0;0;0;0;0;0;0;0;0;0;0;0;0;0;0;0;0
FR;5;2021-09-30;0;0;0;0;0;0;0;0;0;0;0;0;0;0;0;0;0;0
FR;5;2021-10-01;0;0;0;0;0;0;0;0;0;0;0;0;0;0;0;0;0;0
FR;5;2021-10-02;0;0;0;0;0;0;0;0;0;0;0;0;0;0;0;0;0;0
FR;5;2021-10-03;0;0;0;0;0;0;0;0;0;0;0;0;0;0;0;0;0;0
FR;5;2021-10-04;0;0;0;0;0;0;0;0;0;0;0;0;0;0;0;0;0;0
FR;5;2021-10-05;0;0;0;0;0;0;0;0;0;0;0;0;0;0;0;0;0;0
FR;5;2021-10-06;0;0;0;0;0;0;0;0;0;0;0;0;0;0;0;0;0;0
FR;5;2021-10-07;0;0;0;0;0;0;0;0;0;0;0;0;0;0;0;0;0;0
FR;5;2021-10-08;0;0;0;0;0;0;0;0;0;0;0;0;0;0;0;0;0;0
FR;5;2021-10-09;0;0;0;0;0;0;0;0;0;0;0;0;0;0;0;0;0;0
FR;5;2021-10-10;0;0;0;0;0;0;0;0;0;0;0;0;0;0;0;0;0;0
FR;5;2021-10-11;0;0;0;0;0;0;0;0;0;0;0;0;0;0;0;0;0;0
FR;5;2021-10-12;0;0;0;0;0;0;0;0;0;0;0;0;0;0;0;0;0;0
FR;5;2021-10-13;0;0;0;0;0;0;0;0;0;0;0;0;0;0;0;0;0;0
FR;5;2021-10-14;0;0;0;0;0;0;0;0;0;0;0;0;0;0;0;0;0;0
FR;5;2021-10-15;0;0;0;0;0;0;0;0;0;0;0;0;0;0;0;0;0;0
FR;5;2021-10-16;0;0;0;0;0;0;0;0;0;0;0;0;0;0;0;0;0;0
FR;5;2021-10-17;0;0;0;0;0;0;0;0;0;0;0;0;0;0;0;0;0;0
FR;5;2021-10-18;0;0;0;0;0;0;0;0;0;0;0;0;0;0;0;0;0;0
FR;5;2021-10-19;0;0;0;0;0;0;0;0;0;0;0;0;0;0;0;0;0;0
FR;5;2021-10-20;0;0;0;0;0;0;0;0;0;0;0;0;0;0;0;0;0;0
FR;5;2021-10-21;0;0;0;0;0;0;0;0;0;0;0;0;0;0;0;0;0;0
FR;5;2021-10-22;0;0;0;0;0;0;0;0;0;0;0;0;0;0;0;0;0;0
FR;5;2021-10-23;0;0;0;0;0;0;0;0;0;0;0;0;0;0;0;0;0;0
FR;5;2021-10-24;0;0;0;0;0;0;0;0;0;0;0;0;0;0;0;0;0;0
FR;5;2021-10-25;0;0;0;0;0;0;0;0;0;0;0;0;0;0;0;0;0;0
FR;5;2021-10-26;0;0;0;0;0;0;0;0;0;0;0;0;0;0;0;0;0;0
FR;5;2021-10-27;0;0;0;0;0;0;0;0;0;0;0;0;0;0;0;0;0;0
FR;5;2021-10-28;0;0;0;0;0;0;0;0;0;0;0;0;0;0;0;0;0;0
FR;5;2021-10-29;0;0;0;0;0;0;0;0;0;0;0;0;0;0;0;0;0;0
FR;5;2021-10-30;0;0;0;0;0;0;0;0;0;0;0;0;0;0;0;0;0;0
FR;5;2021-10-31;0;0;0;0;0;0;0;0;0;0;0;0;0;0;0;0;0;0
FR;5;2021-11-01;0;0;0;0;0;0;0;0;0;0;0;0;0;0;0;0;0;0
FR;5;2021-11-02;0;0;0;0;0;0;0;0;0;0;0;0;0;0;0;0;0;0
FR;5;2021-11-03;0;0;0;0;0;0;0;0;0;0;0;0;0;0;0;0;0;0
FR;5;2021-11-04;0;0;0;0;0;0;0;0;0;0;0;0;0;0;0;0;0;0
FR;5;2021-11-05;0;0;0;0;0;0;0;0;0;0;0;0;0;0;0;0;0;0
FR;5;2021-11-06;0;0;0;0;0;0;0;0;0;0;0;0;0;0;0;0;0;0
FR;5;2021-11-07;0;0;0;0;0;0;0;0;0;0;0;0;0;0;0;0;0;0
FR;5;2021-11-08;0;0;0;0;0;0;0;0;0;0;0;0;0;0;0;0;0;0
FR;5;2021-11-09;0;0;0;0;0;0;0;0;0;0;0;0;0;0;0;0;0;0
FR;5;2021-11-10;0;0;0;0;0;0;0;0;0;0;0;0;0;0;0;0;0;0
FR;5;2021-11-11;0;0;0;0;0;0;0;0;0;0;0;0;0;0;0;0;0;0
FR;5;2021-11-12;0;0;0;0;0;0;0;0;0;0;0;0;0;0;0;0;0;0
FR;5;2021-11-13;0;0;0;0;0;0;0;0;0;0;0;0;0;0;0;0;0;0
FR;5;2021-11-14;0;0;0;0;0;0;0;0;0;0;0;0;0;0;0;0;0;0
FR;5;2021-11-15;0;0;0;0;0;0;0;0;0;0;0;0;0;0;0;0;0;0
FR;5;2021-11-16;0;0;0;0;0;0;0;0;0;0;0;0;0;0;0;0;0;0
FR;5;2021-11-17;0;0;0;0;0;0;0;0;0;0;0;0;0;0;0;0;0;0
FR;5;2021-11-18;0;0;0;0;0;0;0;0;0;0;0;0;0;0;0;0;0;0
FR;5;2021-11-19;0;0;0;0;0;0;0;0;0;0;0;0;0;0;0;0;0;0
FR;5;2021-11-20;0;0;0;0;0;0;0;0;0;0;0;0;0;0;0;0;0;0
FR;5;2021-11-21;0;0;0;0;0;0;0;0;0;0;0;0;0;0;0;0;0;0
FR;5;2021-11-22;0;0;0;0;0;0;0;0;0;0;0;0;0;0;0;0;0;0
FR;5;2021-11-23;0;0;0;0;0;0;0;0;0;0;0;0;0;0;0;0;0;0
FR;5;2021-11-24;0;0;0;0;0;0;0;0;0;0;0;0;0;0;0;0;0;0
FR;5;2021-11-25;0;0;0;0;0;0;0;0;0;0;0;0;0;0;0;0;0;0
FR;5;2021-11-26;0;0;0;0;0;0;0;0;0;0;0;0;0;0;0;0;0;0
FR;5;2021-11-27;0;0;0;0;0;0;0;0;0;0;0;0;0;0;0;0;0;0
FR;5;2021-11-28;0;0;0;0;0;0;0;0;0;0;0;0;0;0;0;0;0;0
FR;5;2021-11-29;0;0;0;0;0;0;0;0;0;0;0;0;0;0;0;0;0;0
FR;5;2021-11-30;0;0;0;0;0;0;0;0;0;0;0;0;0;0;0;0;0;0
FR;5;2021-12-01;0;0;0;0;0;0;0;0;0;0;0;0;0;0;0;0;0;0
FR;5;2021-12-02;0;0;0;0;0;0;0;0;0;0;0;0;0;0;0;0;0;0
FR;5;2021-12-03;0;0;0;0;0;0;0;0;0;0;0;0;0;0;0;0;0;0
FR;5;2021-12-04;0;0;0;0;0;0;0;0;0;0;0;0;0;0;0;0;0;0
FR;5;2021-12-05;0;0;0;0;0;0;0;0;0;0;0;0;0;0;0;0;0;0
FR;5;2021-12-06;0;0;0;0;0;0;0;0;0;0;0;0;0;0;0;0;0;0
FR;5;2021-12-07;0;0;0;0;0;0;0;0;0;0;0;0;0;0;0;0;0;0
FR;5;2021-12-08;0;0;0;0;0;0;0;0;0;0;0;0;0;0;0;0;0;0
FR;5;2021-12-09;0;0;0;0;0;0;0;0;0;0;0;0;0;0;0;0;0;0
FR;5;2021-12-10;0;0;0;0;0;0;0;0;0;0;0;0;0;0;0;0;0;0
FR;5;2021-12-11;0;0;0;0;0;0;0;0;0;0;0;0;0;0;0;0;0;0
FR;5;2021-12-12;0;0;0;0;0;0;0;0;0;0;0;0;0;0;0;0;0;0
FR;5;2021-12-13;0;0;0;0;0;0;0;0;0;0;0;0;0;0;0;0;0;0
FR;5;2021-12-14;33;45;77;0;27;88;1;0;0;33;45;77;0;27;88;1;0;0
FR;5;2021-12-15;196;44;37;0;42;49;0;0;0;229;89;114;0;69;137;1;0;0
FR;5;2021-12-16;181;21;44;0;38;48;0;0;0;410;110;158;0;107;185;1;0;0
FR;5;2021-12-17;313;16;72;0;34;74;2;0;0;723;126;230;0;141;259;3;0;0
FR;5;2021-12-18;766;24;22;0;67;29;0;0;0;1489;150;252;0;208;288;3;0;0
FR;5;2021-12-19;586;15;15;0;67;17;0;0;0;2075;165;267;0;275;305;3;0;0
FR;5;2021-12-20;1224;31;34;0;133;37;2;0;0;3299;196;301;0;408;342;5;0;0
FR;5;2021-12-21;1535;22;54;1;140;60;0;0;0;4834;218;355;1;548;402;5;0;0
FR;5;2021-12-22;4069;40;37;0;420;46;2;0;0;8903;258;392;1;968;448;7;0;0
FR;5;2021-12-23;3042;16;21;0;304;25;0;0;0;11945;274;413;1;1272;473;7;0;0
FR;5;2021-12-24;761;18;9;0;103;14;0;0;0;12706;292;422;1;1375;487;7;0;0
FR;5;2021-12-25;61;5;2;0;9;3;0;0;0;12767;297;424;1;1384;490;7;0;0
FR;5;2021-12-26;623;6;3;0;101;4;0;0;0;13390;303;427;1;1485;494;7;0;0
FR;5;2021-12-27;4085;25;21;0;457;23;1;0;0;17475;328;448;1;1942;517;8;0;0
FR;5;2021-12-28;5204;23;41;1;511;43;2;0;0;22679;351;489;2;2453;560;10;0;0
FR;5;2021-12-29;8105;34;66;2;886;69;1;0;0;30784;385;555;4;3339;629;11;0;0
FR;5;2021-12-30;5173;18;33;0;525;39;0;0;0;35957;403;588;4;3864;668;11;0;0
FR;5;2021-12-31;1553;8;10;0;181;11;0;0;0;37510;411;598;4;4045;679;11;0;0
FR;5;2022-01-01;185;2;2;0;24;3;0;0;0;37695;413;600;4;4069;682;11;0;0
FR;5;2022-01-02;1489;1;1;0;149;1;0;0;0;39184;414;601;4;4218;683;11;0;0
FR;5;2022-01-03;3067;36;34;0;321;33;1;0;0;42251;450;635;4;4539;716;12;0;0
FR;5;2022-01-04;3034;39;33;0;320;42;3;0;0;45285;489;668;4;4859;758;15;0;0
FR;5;2022-01-05;19324;203;97;1;2112;108;0;0;0;64609;692;765;5;6971;866;15;0;0
FR;5;2022-01-06;3748;134;122;0;507;142;2;0;0;68357;826;887;5;7478;1008;17;0;0
FR;5;2022-01-07;5005;202;48;2;702;56;1;0;0;73362;1028;935;7;8180;1064;18;0;0
FR;5;2022-01-08;13659;514;45;0;1998;52;0;0;0;87021;1542;980;7;10178;1116;18;0;0
FR;5;2022-01-09;5754;399;15;0;1113;20;1;0;0;92775;1941;995;7;11291;1136;19;0;0
FR;5;2022-01-10;3454;326;25;0;731;29;0;0;0;96229;2267;1020;7;12022;1165;19;0;0
FR;5;2022-01-11;3671;284;38;0;662;41;1;0;0;99900;2551;1058;7;12684;1206;20;0;0
FR;5;2022-01-12;22650;3005;89;0;5291;112;2;0;0;122550;5556;1147;7;17975;1318;22;0;0
FR;5;2022-01-13;4039;622;29;0;1051;31;2;0;0;126589;6178;1176;7;19026;1349;24;0;0
FR;5;2022-01-14;4843;583;45;0;1115;52;1;0;0;131432;6761;1221;7;20141;1401;25;0;0
FR;5;2022-01-15;14686;1746;38;3;3370;49;3;0;0;146118;8507;1259;10;23511;1450;28;0;0
FR;5;2022-01-16;4727;666;3;0;1260;5;0;0;0;150845;9173;1262;10;24771;1455;28;0;0
FR;5;2022-01-17;2297;718;26;0;986;29;0;0;0;153142;9891;1288;10;25757;1484;28;0;0
FR;5;2022-01-18;2431;870;30;0;1141;40;0;0;0;155573;10761;1318;10;26898;1524;28;0;0
FR;5;2022-01-19;18482;6423;74;2;8361;142;3;0;0;174055;17184;1392;12;35259;1666;31;0;0
FR;5;2022-01-20;1920;1067;25;0;1295;34;2;0;0;175975;18251;1417;12;36554;1700;33;0;0
FR;5;2022-01-21;3077;1372;47;1;1675;59;2;0;0;179052;19623;1464;13;38229;1759;35;0;0
FR;5;2022-01-22;10720;3454;33;1;4670;43;1;0;0;189772;23077;1497;14;42899;1802;36;0;0
FR;5;2022-01-23;2629;1415;6;0;1788;10;0;0;0;192401;24492;1503;14;44687;1812;36;0;0
FR;5;2022-01-24;1161;1340;19;0;1446;23;1;0;0;193562;25832;1522;14;46133;1835;37;0;0
FR;5;2022-01-25;1220;1549;20;2;1681;31;3;0;0;194782;27381;1542;16;47814;1866;40;0;0
FR;5;2022-01-26;10750;12031;50;1;13297;89;1;0;1;205532;39412;1592;17;61111;1955;41;0;1
FR;5;2022-01-27;1291;1692;10;0;1837;17;0;0;0;206823;41104;1602;17;62948;1972;41;0;1
FR;5;2022-01-28;1699;3345;16;0;3565;19;1;0;0;208522;44449;1618;17;66513;1991;42;0;1
FR;5;2022-01-29;6241;8041;68;0;8855;96;2;0;0;214763;52490;1686;17;75368;2087;44;0;1
FR;5;2022-01-30;1509;2950;5;0;3185;18;0;0;0;216272;55440;1691;17;78553;2105;44;0;1
FR;5;2022-01-31;589;1773;23;0;1837;24;3;0;0;216861;57213;1714;17;80390;2129;47;0;1
FR;5;2022-02-01;712;1706;10;0;1791;15;0;0;0;217573;58919;1724;17;82181;2144;47;0;1
FR;5;2022-02-02;6958;15655;52;0;16603;94;0;0;0;224531;74574;1776;17;98784;2238;47;0;1
FR;5;2022-02-03;491;1691;14;0;1748;13;5;0;0;225022;76265;1790;17;100532;2251;52;0;1
FR;5;2022-02-04;945;3002;19;0;3123;31;0;0;0;225967;79267;1809;17;103655;2282;52;0;1
FR;5;2022-02-05;3535;8919;23;0;9517;37;0;0;0;229502;88186;1832;17;113172;2319;52;0;1
FR;5;2022-02-06;737;2397;10;0;2556;19;0;0;0;230239;90583;1842;17;115728;2338;52;0;1
FR;5;2022-02-07;884;1596;23;0;1715;25;2;0;0;231123;92179;1865;17;117443;2363;54;0;1
FR;5;2022-02-08;723;1287;18;0;1407;20;2;0;0;231846;93466;1883;17;118850;2383;56;0;1
FR;5;2022-02-09;4544;12880;44;0;13608;76;1;0;0;236390;106346;1927;17;132458;2459;57;0;1
FR;5;2022-02-10;646;1059;14;0;1166;15;0;0;0;237036;107405;1941;17;133624;2474;57;0;1
FR;5;2022-02-11;793;2032;16;0;2163;21;1;0;0;237829;109437;1957;17;135787;2495;58;0;1
FR;5;2022-02-12;2286;6812;33;0;7279;53;0;0;0;240115;116249;1990;17;143066;2548;58;0;1
FR;5;2022-02-13;464;1540;8;0;1653;8;1;0;0;240579;117789;1998;17;144719;2556;59;0;1
FR;5;2022-02-14;678;1288;10;0;1407;13;1;0;0;241257;119077;2008;17;146126;2569;60;0;1
FR;5;2022-02-15;482;886;9;0;968;14;1;0;0;241739;119963;2017;17;147094;2583;61;0;1
FR;5;2022-02-16;2980;9123;41;1;9675;58;2;0;0;244719;129086;2058;18;156769;2641;63;0;1
FR;5;2022-02-17;436;809;6;0;876;7;1;0;0;245155;129895;2064;18;157645;2648;64;0;1
FR;5;2022-02-18;649;1408;13;0;1535;17;0;0;0;245804;131303;2077;18;159180;2665;64;0;1
FR;5;2022-02-19;1373;4315;16;0;4623;28;0;0;0;247177;135618;2093;18;163803;2693;64;0;1
FR;5;2022-02-20;247;879;6;0;941;8;0;0;0;247424;136497;2099;18;164744;2701;64;0;1
FR;5;2022-02-21;221;607;2;0;661;4;1;0;0;247645;137104;2101;18;165405;2705;65;0;1
FR;5;2022-02-22;262;545;17;0;592;17;1;0;0;247907;137649;2118;18;165997;2722;66;0;1
FR;5;2022-02-23;1909;6926;23;1;7346;43;0;0;0;249816;144575;2141;19;173343;2765;66;0;1
FR;5;2022-02-24;182;374;6;1;421;7;1;0;0;249998;144949;2147;20;173764;2772;67;0;1
FR;5;2022-02-25;336;950;13;0;1027;12;2;0;0;250334;145899;2160;20;174791;2784;69;0;1
FR;5;2022-02-26;972;3071;11;0;3333;15;2;0;0;251306;148970;2171;20;178124;2799;71;0;1
FR;5;2022-02-27;151;506;0;0;549;3;0;0;0;251457;149476;2171;20;178673;2802;71;0;1
FR;5;2022-02-28;162;369;1;0;408;1;0;0;0;251619;149845;2172;20;179081;2803;71;0;1
FR;5;2022-03-01;130;280;6;0;315;7;1;0;0;251749;150125;2178;20;179396;2810;72;0;1
FR;5;2022-03-02;1241;4156;28;3;4497;40;3;0;0;252990;154281;2206;23;183893;2850;75;0;1
FR;5;2022-03-03;121;251;5;0;271;10;1;0;0;253111;154532;2211;23;184164;2860;76;0;1
FR;5;2022-03-04;197;488;13;0;538;14;2;0;0;253308;155020;2224;23;184702;2874;78;0;1
FR;5;2022-03-05;677;1990;8;0;2244;16;2;0;0;253985;157010;2232;23;186946;2890;80;0;1
FR;5;2022-03-06;108;260;0;0;310;0;0;0;0;254093;157270;2232;23;187256;2890;80;0;1
FR;5;2022-03-07;71;228;5;0;254;3;2;0;0;254164;157498;2237;23;187510;2893;82;0;1
FR;5;2022-03-08;46;134;7;1;141;8;3;0;0;254210;157632;2244;24;187651;2901;85;0;1
FR;5;2022-03-09;910;3078;24;0;3407;36;0;0;0;255120;160710;2268;24;191058;2937;85;0;1
FR;5;2022-03-10;82;202;9;0;215;13;3;0;0;255202;160912;2277;24;191273;2950;88;0;1
FR;5;2022-03-11;148;369;13;1;427;15;0;0;0;255350;161281;2290;25;191700;2965;88;0;1
FR;5;2022-03-12;758;1613;13;1;1976;30;0;0;0;256108;162894;2303;26;193676;2995;88;0;1
FR;5;2022-03-13;78;100;0;0;133;0;0;0;0;256186;162994;2303;26;193809;2995;88;0;1
FR;5;2022-03-14;67;119;7;1;139;7;1;0;0;256253;163113;2310;27;193948;3002;89;0;1
FR;5;2022-03-15;83;99;4;0;119;7;1;0;0;256336;163212;2314;27;194067;3009;90;0;1
FR;5;2022-03-16;882;1827;15;3;2228;36;7;0;0;257218;165039;2329;30;196295;3045;97;0;1
FR;5;2022-03-17;68;123;8;4;151;10;4;0;0;257286;165162;2337;34;196446;3055;101;0;1
FR;5;2022-03-18;172;318;13;4;390;18;4;0;0;257458;165480;2350;38;196836;3073;105;0;1
FR;5;2022-03-19;752;1163;12;5;1555;33;8;0;0;258210;166643;2362;43;198391;3106;113;0;1
FR;5;2022-03-20;45;93;1;0;119;1;0;0;0;258255;166736;2363;43;198510;3107;113;0;1
FR;5;2022-03-21;71;120;10;6;136;15;8;0;0;258326;166856;2373;49;198646;3122;121;0;1
FR;5;2022-03-22;56;119;8;7;143;9;6;0;0;258382;166975;2381;56;198789;3131;127;0;1
FR;5;2022-03-23;805;1461;14;8;1878;36;9;0;0;259187;168436;2395;64;200667;3167;136;0;1
FR;5;2022-03-24;70;93;8;7;118;7;10;0;0;259257;168529;2403;71;200785;3174;146;0;1
FR;5;2022-03-25;222;293;14;8;388;18;9;0;0;259479;168822;2417;79;201173;3192;155;0;1
FR;5;2022-03-26;707;853;12;5;1273;26;6;0;1;260186;169675;2429;84;202446;3218;161;0;2
FR;5;2022-03-27;75;81;0;0;124;3;0;0;0;260261;169756;2429;84;202570;3221;161;0;2
FR;5;2022-03-28;81;93;1;2;132;3;2;0;0;260342;169849;2430;86;202702;3224;163;0;2
FR;5;2022-03-29;71;82;10;4;113;12;5;0;0;260413;169931;2440;90;202815;3236;168;0;2
FR;5;2022-03-30;823;1116;16;13;1606;29;14;0;0;261236;171047;2456;103;204421;3265;182;0;2
FR;5;2022-03-31;102;125;1;4;173;6;4;0;0;261338;171172;2457;107;204594;3271;186;0;2
FR;5;2022-04-01;114;86;7;12;135;11;12;0;1;261452;171258;2464;119;204729;3282;198;0;3
FR;5;2022-04-02;330;349;3;3;535;15;4;0;0;261782;171607;2467;122;205264;3297;202;0;3
FR;5;2022-04-03;54;59;1;0;88;1;0;0;0;261836;171666;2468;122;205352;3298;202;0;3
FR;5;2022-04-04;40;57;4;1;70;8;2;0;0;261876;171723;2472;123;205422;3306;204;0;3
FR;5;2022-04-05;53;60;6;6;75;9;5;0;0;261929;171783;2478;129;205497;3315;209;0;3
FR;5;2022-04-06;421;439;7;14;678;16;14;0;0;262350;172222;2485;143;206175;3331;223;0;3
FR;5;2022-04-07;45;69;5;7;89;7;10;0;0;262395;172291;2490;150;206264;3338;233;0;3
FR;5;2022-04-08;134;112;12;13;174;14;15;0;0;262529;172403;2502;163;206438;3352;248;0;3
FR;5;2022-04-09;311;324;2;5;511;17;5;0;0;262840;172727;2504;168;206949;3369;253;0;3
FR;5;2022-04-10;44;31;2;0;61;2;1;0;0;262884;172758;2506;168;207010;3371;254;0;3
FR;5;2022-04-11;50;60;3;2;78;4;3;0;0;262934;172818;2509;170;207088;3375;257;0;3
FR;5;2022-04-12;59;54;3;3;78;5;3;0;0;262993;172872;2512;173;207166;3380;260;0;3
FR;5;2022-04-13;382;413;3;8;606;16;8;0;0;263375;173285;2515;181;207772;3396;268;0;3
FR;5;2022-04-14;48;52;5;5;69;9;3;0;0;263423;173337;2520;186;207841;3405;271;0;3
FR;5;2022-04-15;91;109;4;4;150;5;6;0;0;263514;173446;2524;190;207991;3410;277;0;3
FR;5;2022-04-16;188;184;2;1;265;13;1;0;0;263702;173630;2526;191;208256;3423;278;0;3
FR;5;2022-04-17;12;11;1;0;17;1;0;0;0;263714;173641;2527;191;208273;3424;278;0;3
FR;5;2022-04-18;9;10;2;0;11;3;1;0;0;263723;173651;2529;191;208284;3427;279;0;3
FR;5;2022-04-19;75;71;6;1;96;6;4;0;0;263798;173722;2535;192;208380;3433;283;0;3
FR;5;2022-04-20;361;349;9;6;522;12;7;0;0;264159;174071;2544;198;208902;3445;290;0;3
FR;5;2022-04-21;42;64;9;10;71;12;14;0;0;264201;174135;2553;208;208973;3457;304;0;3
FR;5;2022-04-22;113;96;5;4;144;5;5;0;0;264314;174231;2558;212;209117;3462;309;0;3
FR;5;2022-04-23;209;193;4;2;284;11;3;0;0;264523;174424;2562;214;209401;3473;312;0;3
FR;5;2022-04-24;37;35;0;0;50;3;0;0;0;264560;174459;2562;214;209451;3476;312;0;3
FR;5;2022-04-25;69;65;1;1;102;4;1;0;0;264629;174524;2563;215;209553;3480;313;0;3
FR;5;2022-04-26;60;63;2;1;85;5;1;0;0;264689;174587;2565;216;209638;3485;314;0;3
FR;5;2022-04-27;335;316;3;7;463;14;8;0;0;265024;174903;2568;223;210101;3499;322;0;3
FR;5;2022-04-28;81;54;4;5;81;8;7;0;0;265105;174957;2572;228;210182;3507;329;0;3
FR;5;2022-04-29;117;84;5;19;117;12;17;0;0;265222;175041;2577;247;210299;3519;346;0;3
FR;5;2022-04-30;183;114;2;3;184;10;4;0;0;265405;175155;2579;250;210483;3529;350;0;3
FR;5;2022-05-01;11;7;0;0;11;0;0;0;0;265416;175162;2579;250;210494;3529;350;0;3
FR;5;2022-05-02;52;28;4;5;48;2;7;0;0;265468;175190;2583;255;210542;3531;357;0;3
FR;5;2022-05-03;87;57;2;4;84;11;4;0;0;265555;175247;2585;259;210626;3542;361;0;3
FR;5;2022-05-04;278;205;1;2;324;7;2;0;0;265833;175452;2586;261;210950;3549;363;0;3
FR;5;2022-05-05;62;32;3;4;46;5;4;0;0;265895;175484;2589;265;210996;3554;367;0;3
FR;5;2022-05-06;105;65;2;3;106;5;3;0;0;266000;175549;2591;268;211102;3559;370;0;3
FR;5;2022-05-07;171;117;2;10;180;13;7;0;0;266171;175666;2593;278;211282;3572;377;0;3
FR;5;2022-05-08;8;8;0;0;9;2;0;0;0;266179;175674;2593;278;211291;3574;377;0;3
FR;5;2022-05-09;44;34;15;3;51;16;4;0;0;266223;175708;2608;281;211342;3590;381;0;3
FR;5;2022-05-10;54;49;3;4;67;5;5;0;0;266277;175757;2611;285;211409;3595;386;0;3
FR;5;2022-05-11;327;237;12;7;344;21;11;0;0;266604;175994;2623;292;211753;3616;397;0;3
FR;5;2022-05-12;46;34;2;2;46;2;3;0;0;266650;176028;2625;294;211799;3618;400;0;3
FR;5;2022-05-13;109;83;3;8;119;8;7;0;0;266759;176111;2628;302;211918;3626;407;0;3
FR;5;2022-05-14;209;131;0;1;212;8;0;0;0;266968;176242;2628;303;212130;3634;407;0;3
FR;5;2022-05-15;22;9;2;0;18;1;1;0;0;266990;176251;2630;303;212148;3635;408;0;3
FR;5;2022-05-16;52;34;4;5;53;4;5;0;0;267042;176285;2634;308;212201;3639;413;0;3
FR;5;2022-05-17;72;40;5;0;68;2;3;0;0;267114;176325;2639;308;212269;3641;416;0;3
FR;5;2022-05-18;289;215;4;4;330;8;6;0;0;267403;176540;2643;312;212599;3649;422;0;3
FR;5;2022-05-19;45;35;5;3;42;3;4;0;0;267448;176575;2648;315;212641;3652;426;0;3
FR;5;2022-05-20;76;63;3;10;92;1;11;0;0;267524;176638;2651;325;212733;3653;437;0;3
FR;5;2022-05-21;242;166;2;3;268;17;1;0;0;267766;176804;2653;328;213001;3670;438;0;3
FR;5;2022-05-22;20;14;2;5;20;2;6;0;0;267786;176818;2655;333;213021;3672;444;0;3
FR;5;2022-05-23;42;31;4;3;42;6;3;0;0;267828;176849;2659;336;213063;3678;447;0;3
FR;5;2022-05-24;47;45;3;2;60;5;2;0;0;267875;176894;2662;338;213123;3683;449;0;3
FR;5;2022-05-25;329;257;4;1;385;16;1;0;0;268204;177151;2666;339;213508;3699;450;0;3
FR;5;2022-05-26;17;5;0;1;9;2;0;0;1;268221;177156;2666;340;213517;3701;450;0;4
FR;5;2022-05-27;99;54;4;4;89;9;3;0;0;268320;177210;2670;344;213606;3710;453;0;4
FR;5;2022-05-28;100;78;5;3;106;10;3;0;0;268420;177288;2675;347;213712;3720;456;0;4
FR;5;2022-05-29;14;14;1;0;18;2;0;0;0;268434;177302;2676;347;213730;3722;456;0;4
FR;5;2022-05-30;56;41;2;1;54;2;2;0;0;268490;177343;2678;348;213784;3724;458;0;4
FR;5;2022-05-31;57;43;1;8;62;1;8;0;0;268547;177386;2679;356;213846;3725;466;0;4
FR;5;2022-06-01;257;241;9;2;301;25;5;0;0;268804;177627;2688;358;214147;3750;471;0;4
FR;5;2022-06-02;63;61;5;0;73;9;1;0;0;268867;177688;2693;358;214220;3759;472;0;4
FR;5;2022-06-03;82;71;4;5;88;10;6;0;0;268949;177759;2697;363;214308;3769;478;0;4
FR;5;2022-06-04;157;109;2;1;187;9;1;0;0;269106;177868;2699;364;214495;3778;479;0;4
FR;5;2022-06-05;18;11;0;0;21;1;0;0;0;269124;177879;2699;364;214516;3779;479;0;4
FR;5;2022-06-06;16;12;0;1;15;0;1;0;0;269140;177891;2699;365;214531;3779;480;0;4
FR;5;2022-06-07;50;56;1;1;76;2;1;0;0;269190;177947;2700;366;214607;3781;481;0;4
FR;5;2022-06-08;283;225;3;4;332;17;2;0;0;269473;178172;2703;370;214939;3798;483;0;4
FR;5;2022-06-09;52;41;6;3;57;7;2;0;1;269525;178213;2709;373;214996;3805;485;0;5
FR;5;2022-06-10;81;72;1;1;105;6;1;0;0;269606;178285;2710;374;215101;3811;486;0;5
FR;5;2022-06-11;173;141;3;3;202;10;4;0;0;269779;178426;2713;377;215303;3821;490;0;5
FR;5;2022-06-12;17;16;0;0;19;2;0;0;0;269796;178442;2713;377;215322;3823;490;0;5
FR;5;2022-06-13;56;47;9;3;70;10;6;0;0;269852;178489;2722;380;215392;3833;496;0;5
FR;5;2022-06-14;59;56;1;4;64;6;4;0;0;269911;178545;2723;384;215456;3839;500;0;5
FR;5;2022-06-15;266;260;5;2;363;27;1;0;0;270177;178805;2728;386;215819;3866;501;0;5
FR;5;2022-06-16;47;30;5;2;44;5;2;0;0;270224;178835;2733;388;215863;3871;503;0;5
FR;5;2022-06-17;100;67;5;5;102;10;5;0;0;270324;178902;2738;393;215965;3881;508;0;5
FR;5;2022-06-18;146;95;10;2;152;26;2;0;1;270470;178997;2748;395;216117;3907;510;0;6
FR;5;2022-06-19;26;15;0;1;18;4;1;0;0;270496;179012;2748;396;216135;3911;511;0;6
FR;5;2022-06-20;56;50;8;0;62;11;2;0;0;270552;179062;2756;396;216197;3922;513;0;6
FR;5;2022-06-21;52;73;5;3;90;7;5;0;1;270604;179135;2761;399;216287;3929;518;0;7
FR;5;2022-06-22;224;247;7;9;347;33;10;0;0;270828;179382;2768;408;216634;3962;528;0;7
FR;5;2022-06-23;50;38;2;5;43;6;6;0;0;270878;179420;2770;413;216677;3968;534;0;7
FR;5;2022-06-24;91;70;12;5;101;16;8;0;0;270969;179490;2782;418;216778;3984;542;0;7
FR;5;2022-06-25;154;124;3;7;185;14;8;0;1;271123;179614;2785;425;216963;3998;550;0;8
FR;5;2022-06-26;26;19;2;0;29;5;0;0;0;271149;179633;2787;425;216992;4003;550;0;8
FR;5;2022-06-27;57;60;5;7;78;11;9;0;0;271206;179693;2792;432;217070;4014;559;0;8
FR;5;2022-06-28;70;49;8;2;69;14;5;0;0;271276;179742;2800;434;217139;4028;564;0;8
FR;5;2022-06-29;297;268;9;21;391;34;23;0;0;271573;180010;2809;455;217530;4062;587;0;8
FR;5;2022-06-30;89;57;10;12;89;17;11;0;0;271662;180067;2819;467;217619;4079;598;0;8
FR;5;2022-07-01;127;65;7;11;118;12;11;0;2;271789;180132;2826;478;217737;4091;609;0;10
FR;5;2022-07-02;191;132;4;0;209;22;0;0;0;271980;180264;2830;478;217946;4113;609;0;10
FR;5;2022-07-03;30;25;1;0;36;4;0;0;0;272010;180289;2831;478;217982;4117;609;0;10
FR;5;2022-07-04;103;64;2;5;102;6;5;0;1;272113;180353;2833;483;218084;4123;614;0;11
FR;5;2022-07-05;104;72;3;8;107;13;8;0;1;272217;180425;2836;491;218191;4136;622;0;12
FR;5;2022-07-06;277;168;9;36;289;27;36;0;0;272494;180593;2845;527;218480;4163;658;0;12
FR;5;2022-07-07;88;68;6;9;88;13;11;0;0;272582;180661;2851;536;218568;4176;669;0;12
FR;5;2022-07-08;152;120;7;14;146;25;13;0;1;272734;180781;2858;550;218714;4201;682;0;13
FR;5;2022-07-09;116;68;1;8;100;10;8;0;0;272850;180849;2859;558;218814;4211;690;0;13
FR;5;2022-07-10;15;6;0;0;10;1;0;0;0;272865;180855;2859;558;218824;4212;690;0;13
FR;5;2022-07-11;92;72;10;2;98;19;3;0;0;272957;180927;2869;560;218922;4231;693;0;13
FR;5;2022-07-12;67;63;5;10;81;7;12;0;0;273024;180990;2874;570;219003;4238;705;0;13
FR;5;2022-07-13;169;118;10;19;196;16;23;0;0;273193;181108;2884;589;219199;4254;728;0;13
FR;5;2022-07-14;8;4;0;0;7;0;0;0;0;273201;181112;2884;589;219206;4254;728;0;13
FR;5;2022-07-15;74;66;5;14;86;15;15;0;0;273275;181178;2889;603;219292;4269;743;0;13
FR;5;2022-07-16;54;44;3;0;71;3;2;0;0;273329;181222;2892;603;219363;4272;745;0;13
FR;5;2022-07-17;10;7;3;0;10;2;2;0;0;273339;181229;2895;603;219373;4274;747;0;13
FR;5;2022-07-18;60;47;0;4;70;4;3;0;0;273399;181276;2895;607;219443;4278;750;0;13
FR;5;2022-07-19;63;42;5;3;63;7;4;0;0;273462;181318;2900;610;219506;4285;754;0;13
FR;5;2022-07-20;119;106;4;11;141;14;9;0;0;273581;181424;2904;621;219647;4299;763;0;13
FR;5;2022-07-21;38;43;2;10;52;5;10;0;0;273619;181467;2906;631;219699;4304;773;0;13
FR;5;2022-07-22;48;69;11;13;75;23;11;0;1;273667;181536;2917;644;219774;4327;784;0;14
FR;5;2022-07-23;59;78;2;1;95;11;2;0;0;273726;181614;2919;645;219869;4338;786;0;14
FR;5;2022-07-24;11;9;3;1;12;3;1;0;0;273737;181623;2922;646;219881;4341;787;0;14
FR;5;2022-07-25;53;48;2;7;57;8;8;0;0;273790;181671;2924;653;219938;4349;795;0;14
FR;5;2022-07-26;58;52;5;41;70;6;44;0;0;273848;181723;2929;694;220008;4355;839;0;14
FR;5;2022-07-27;106;118;4;4;161;13;4;0;0;273954;181841;2933;698;220169;4368;843;0;14
FR;5;2022-07-28;39;35;2;2;47;6;1;0;0;273993;181876;2935;700;220216;4374;844;0;14
FR;5;2022-07-29;56;74;3;14;90;8;10;0;0;274049;181950;2938;714;220306;4382;854;0;14
FR;5;2022-07-30;55;53;5;1;75;7;2;0;0;274104;182003;2943;715;220381;4389;856;0;14
FR;5;2022-07-31;7;11;1;0;13;1;0;0;0;274111;182014;2944;715;220394;4390;856;0;14
FR;5;2022-08-01;39;53;1;2;62;6;2;0;0;274150;182067;2945;717;220456;4396;858;0;14
FR;5;2022-08-02;32;43;8;7;47;8;7;0;1;274182;182110;2953;724;220503;4404;865;0;15
FR;5;2022-08-03;54;51;4;10;70;9;8;0;0;274236;182161;2957;734;220573;4413;873;0;15
FR;5;2022-08-04;20;18;1;6;22;1;6;0;0;274256;182179;2958;740;220595;4414;879;0;15
FR;5;2022-08-05;35;26;3;3;39;3;3;0;0;274291;182205;2961;743;220634;4417;882;0;15
FR;5;2022-08-06;23;26;1;0;31;1;0;0;0;274314;182231;2962;743;220665;4418;882;0;15
FR;5;2022-08-07;2;2;1;0;1;1;1;0;0;274316;182233;2963;743;220666;4419;883;0;15
FR;5;2022-08-08;26;19;1;2;24;2;1;0;0;274342;182252;2964;745;220690;4421;884;0;15
FR;5;2022-08-09;26;28;3;3;35;3;3;0;0;274368;182280;2967;748;220725;4424;887;0;15
FR;5;2022-08-10;47;47;2;0;56;5;0;0;0;274415;182327;2969;748;220781;4429;887;0;15
FR;5;2022-08-11;19;36;2;2;42;5;2;0;0;274434;182363;2971;750;220823;4434;889;0;15
FR;5;2022-08-12;27;28;2;0;39;2;0;0;0;274461;182391;2973;750;220862;4436;889;0;15
FR;5;2022-08-13;16;18;0;0;24;0;0;0;0;274477;182409;2973;750;220886;4436;889;0;15
FR;5;2022-08-14;2;3;0;0;4;0;0;0;0;274479;182412;2973;750;220890;4436;889;0;15
FR;5;2022-08-15;2;5;0;0;5;0;0;0;0;274481;182417;2973;750;220895;4436;889;0;15
FR;5;2022-08-16;33;26;3;0;28;6;0;0;0;274514;182443;2976;750;220923;4442;889;0;15
FR;5;2022-08-17;52;55;2;1;72;1;1;0;0;274566;182498;2978;751;220995;4443;890;0;15
FR;5;2022-08-18;26;18;8;17;25;10;16;0;0;274592;182516;2986;768;221020;4453;906;0;15
FR;5;2022-08-19;25;33;1;2;41;2;2;0;0;274617;182549;2987;770;221061;4455;908;0;15
FR;5;2022-08-20;25;27;2;1;33;4;2;0;0;274642;182576;2989;771;221094;4459;910;0;15
FR;5;2022-08-21;7;4;1;0;7;1;0;0;0;274649;182580;2990;771;221101;4460;910;0;15
FR;5;2022-08-22;39;26;1;6;42;2;5;0;1;274688;182606;2991;777;221143;4462;915;0;16
FR;5;2022-08-23;27;26;1;1;32;2;1;0;0;274715;182632;2992;778;221175;4464;916;0;16
FR;5;2022-08-24;50;43;0;0;62;0;0;0;0;274765;182675;2992;778;221237;4464;916;0;16
FR;5;2022-08-25;27;26;3;1;31;2;0;0;1;274792;182701;2995;779;221268;4466;916;0;17
FR;5;2022-08-26;48;39;7;2;58;5;4;0;0;274840;182740;3002;781;221326;4471;920;0;17
FR;5;2022-08-27;46;28;1;0;46;3;1;0;0;274886;182768;3003;781;221372;4474;921;0;17
FR;5;2022-08-28;5;6;0;0;6;0;0;0;0;274891;182774;3003;781;221378;4474;921;0;17
FR;5;2022-08-29;58;44;1;1;66;4;1;0;0;274949;182818;3004;782;221444;4478;922;0;17
FR;5;2022-08-30;45;23;12;29;40;10;30;0;1;274994;182841;3016;811;221484;4488;952;0;18
FR;5;2022-08-31;53;47;6;1;58;11;1;0;0;275047;182888;3022;812;221542;4499;953;0;18
FR;5;2022-09-01;14;8;1;4;13;1;4;0;0;275061;182896;3023;816;221555;4500;957;0;18
FR;5;2022-09-02;42;22;8;2;34;9;3;0;0;275103;182918;3031;818;221589;4509;960;0;18
FR;5;2022-09-03;69;37;2;0;58;2;0;0;0;275172;182955;3033;818;221647;4511;960;0;18
FR;5;2022-09-04;12;7;1;0;8;3;0;0;0;275184;182962;3034;818;221655;4514;960;0;18
FR;5;2022-09-05;7;4;1;0;4;1;0;0;0;275191;182966;3035;818;221659;4515;960;0;18
FR;5;2022-09-06;21;14;3;15;17;2;14;0;2;275212;182980;3038;833;221676;4517;974;0;20
FR;5;2022-09-07;79;53;1;1;76;3;1;0;0;275291;183033;3039;834;221752;4520;975;0;20
FR;5;2022-09-08;9;4;0;4;7;0;4;0;0;275300;183037;3039;838;221759;4520;979;0;20
FR;5;2022-09-09;40;11;9;2;14;10;3;0;0;275340;183048;3048;840;221773;4530;982;0;20
FR;5;2022-09-10;40;45;1;1;50;8;1;0;0;275380;183093;3049;841;221823;4538;983;0;20
FR;5;2022-09-11;3;3;0;0;3;1;0;0;0;275383;183096;3049;841;221826;4539;983;0;20
FR;5;2022-09-12;7;5;2;2;7;2;2;0;0;275390;183101;3051;843;221833;4541;985;0;20
FR;5;2022-09-13;9;6;0;1;4;3;1;0;0;275399;183107;3051;844;221837;4544;986;0;20
FR;5;2022-09-14;52;47;4;7;55;9;6;0;0;275451;183154;3055;851;221892;4553;992;0;20
FR;5;2022-09-15;11;13;2;3;11;5;3;0;0;275462;183167;3057;854;221903;4558;995;0;20
FR;5;2022-09-16;25;33;1;4;38;3;3;0;0;275487;183200;3058;858;221941;4561;998;0;20
FR;5;2022-09-17;60;43;1;1;51;5;1;0;0;275547;183243;3059;859;221992;4566;999;0;20
FR;5;2022-09-18;9;6;0;1;10;1;0;0;0;275556;183249;3059;860;222002;4567;999;0;20
FR;5;2022-09-19;22;17;2;1;20;5;2;0;0;275578;183266;3061;861;222022;4572;1001;0;20
FR;5;2022-09-20;15;11;3;3;15;1;4;0;0;275593;183277;3064;864;222037;4573;1005;0;20
FR;5;2022-09-21;68;45;9;0;65;13;0;0;0;275661;183322;3073;864;222102;4586;1005;0;20
FR;5;2022-09-22;12;6;4;24;6;4;23;0;1;275673;183328;3077;888;222108;4590;1028;0;21
FR;5;2022-09-23;20;25;2;3;23;8;3;0;0;275693;183353;3079;891;222131;4598;1031;0;21
FR;5;2022-09-24;44;51;1;8;65;5;8;0;0;275737;183404;3080;899;222196;4603;1039;0;21
FR;5;2022-09-25;6;12;0;0;13;1;0;0;0;275743;183416;3080;899;222209;4604;1039;0;21
FR;5;2022-09-26;15;7;0;2;12;0;1;0;1;275758;183423;3080;901;222221;4604;1040;0;22
FR;5;2022-09-27;7;12;4;9;14;4;9;0;1;275765;183435;3084;910;222235;4608;1049;0;23
FR;5;2022-09-28;65;64;5;0;88;7;0;0;0;275830;183499;3089;910;222323;4615;1049;0;23
FR;5;2022-09-29;17;9;1;0;15;1;1;0;1;275847;183508;3090;910;222338;4616;1050;0;24
FR;5;2022-09-30;28;44;2;2;51;4;3;0;0;275875;183552;3092;912;222389;4620;1053;0;24
FR;5;2022-10-01;40;35;5;5;48;8;7;0;0;275915;183587;3097;917;222437;4628;1060;0;24
FR;5;2022-10-02;1;9;1;0;10;1;0;0;0;275916;183596;3098;917;222447;4629;1060;0;24
FR;5;2022-10-03;7;6;3;0;5;4;0;0;0;275923;183602;3101;917;222452;4633;1060;0;24
FR;5;2022-10-04;11;8;0;3;11;1;3;0;0;275934;183610;3101;920;222463;4634;1063;0;24
FR;5;2022-10-05;57;62;2;2;79;13;2;0;0;275991;183672;3103;922;222542;4647;1065;0;24
FR;5;2022-10-06;12;10;1;4;15;2;4;0;0;276003;183682;3104;926;222557;4649;1069;0;24
FR;5;2022-10-07;21;31;1;0;34;5;0;0;0;276024;183713;3105;926;222591;4654;1069;0;24
FR;5;2022-10-08;33;51;1;0;54;7;0;0;0;276057;183764;3106;926;222645;4661;1069;0;24
FR;5;2022-10-09;7;10;0;0;11;1;0;0;0;276064;183774;3106;926;222656;4662;1069;0;24
FR;5;2022-10-10;14;6;0;1;8;1;1;0;0;276078;183780;3106;927;222664;4663;1070;0;24
FR;5;2022-10-11;6;13;2;1;14;2;2;0;0;276084;183793;3108;928;222678;4665;1072;0;24
FR;5;2022-10-12;39;57;3;2;69;8;2;0;0;276123;183850;3111;930;222747;4673;1074;0;24
FR;5;2022-10-13;11;16;2;0;18;4;0;0;0;276134;183866;3113;930;222765;4677;1074;0;24
FR;5;2022-10-14;21;21;1;0;20;5;0;0;0;276155;183887;3114;930;222785;4682;1074;0;24
FR;5;2022-10-15;19;26;10;0;24;11;2;0;0;276174;183913;3124;930;222809;4693;1076;0;24
FR;5;2022-10-16;3;1;0;0;1;1;0;0;0;276177;183914;3124;930;222810;4694;1076;0;24
FR;5;2022-10-17;8;8;2;1;8;3;1;0;2;276185;183922;3126;931;222818;4697;1077;0;26
FR;5;2022-10-18;6;7;0;2;8;0;2;0;0;276191;183929;3126;933;222826;4697;1079;0;26
FR;5;2022-10-19;38;43;8;0;52;11;0;0;1;276229;183972;3134;933;222878;4708;1079;0;27
FR;5;2022-10-20;18;15;2;1;16;3;1;0;0;276247;183987;3136;934;222894;4711;1080;0;27
FR;5;2022-10-21;22;15;6;0;19;8;1;0;2;276269;184002;3142;934;222913;4719;1081;0;29
FR;5;2022-10-22;34;28;2;12;31;5;12;0;0;276303;184030;3144;946;222944;4724;1093;0;29
FR;5;2022-10-23;9;3;0;0;4;0;0;0;0;276312;184033;3144;946;222948;4724;1093;0;29
FR;5;2022-10-24;14;7;6;7;9;9;8;0;0;276326;184040;3150;953;222957;4733;1101;0;29
FR;5;2022-10-25;12;9;6;3;9;8;3;0;2;276338;184049;3156;956;222966;4741;1104;0;31
FR;5;2022-10-26;34;22;6;0;29;10;0;0;0;276372;184071;3162;956;222995;4751;1104;0;31
FR;5;2022-10-27;16;4;4;0;11;4;0;0;0;276388;184075;3166;956;223006;4755;1104;0;31
FR;5;2022-10-28;19;13;5;3;14;6;4;0;0;276407;184088;3171;959;223020;4761;1108;0;31
FR;5;2022-10-29;21;13;0;0;17;3;0;0;0;276428;184101;3171;959;223037;4764;1108;0;31
FR;5;2022-10-30;1;4;2;0;4;3;0;0;0;276429;184105;3173;959;223041;4767;1108;0;31
FR;5;2022-10-31;14;11;2;1;12;3;1;0;0;276443;184116;3175;960;223053;4770;1109;0;31
FR;5;2022-11-01;3;3;0;1;3;0;1;0;0;276446;184119;3175;961;223056;4770;1110;0;31
FR;5;2022-11-02;23;17;5;4;23;5;5;0;0;276469;184136;3180;965;223079;4775;1115;0;31
FR;5;2022-11-03;22;4;1;1;11;1;1;0;0;276491;184140;3181;966;223090;4776;1116;0;31
FR;5;2022-11-04;19;18;1;0;18;2;0;0;0;276510;184158;3182;966;223108;4778;1116;0;31
FR;5;2022-11-05;25;16;1;0;21;1;0;0;0;276535;184174;3183;966;223129;4779;1116;0;31
FR;5;2022-11-06;1;7;0;0;7;0;0;0;0;276536;184181;3183;966;223136;4779;1116;0;31
FR;5;2022-11-07;4;3;3;0;3;3;0;0;0;276540;184184;3186;966;223139;4782;1116;0;31
FR;5;2022-11-08;11;7;1;2;8;1;1;0;0;276551;184191;3187;968;223147;4783;1117;0;31
FR;5;2022-11-09;28;29;6;1;32;6;1;0;0;276579;184220;3193;969;223179;4789;1118;0;31
FR;5;2022-11-10;11;16;1;0;17;1;0;0;0;276590;184236;3194;969;223196;4790;1118;0;31
FR;5;2022-11-11;2;4;0;1;6;0;1;0;0;276592;184240;3194;970;223202;4790;1119;0;31
FR;5;2022-11-12;19;10;5;9;18;6;9;0;2;276611;184250;3199;979;223220;4796;1128;0;33
FR;5;2022-11-13;2;2;0;1;2;0;1;0;0;276613;184252;3199;980;223222;4796;1129;0;33
FR;5;2022-11-14;8;10;0;1;9;3;0;0;0;276621;184262;3199;981;223231;4799;1129;0;33
FR;5;2022-11-15;8;6;4;3;6;4;3;0;0;276629;184268;3203;984;223237;4803;1132;0;33
FR;5;2022-11-16;29;28;2;1;32;5;0;0;0;276658;184296;3205;985;223269;4808;1132;0;33
FR;5;2022-11-17;6;15;2;0;15;3;0;0;0;276664;184311;3207;985;223284;4811;1132;0;33
FR;5;2022-11-18;16;17;6;0;19;8;0;0;0;276680;184328;3213;985;223303;4819;1132;0;33
FR;5;2022-11-19;18;27;2;0;27;6;0;0;0;276698;184355;3215;985;223330;4825;1132;0;33
FR;5;2022-11-20;6;3;0;0;5;0;0;0;0;276704;184358;3215;985;223335;4825;1132;0;33
FR;5;2022-11-21;8;5;0;2;4;2;1;0;0;276712;184363;3215;987;223339;4827;1133;0;33
FR;5;2022-11-22;9;3;0;1;4;0;1;0;0;276721;184366;3215;988;223343;4827;1134;0;33
FR;5;2022-11-23;34;25;6;1;27;13;0;0;0;276755;184391;3221;989;223370;4840;1134;0;33
FR;5;2022-11-24;3;7;2;1;8;1;2;0;0;276758;184398;3223;990;223378;4841;1136;0;33
FR;5;2022-11-25;15;20;2;0;25;3;0;0;1;276773;184418;3225;990;223403;4844;1136;0;34
FR;5;2022-11-26;22;19;4;0;20;8;0;0;0;276795;184437;3229;990;223423;4852;1136;0;34
FR;5;2022-11-27;7;0;1;0;2;1;0;0;0;276802;184437;3230;990;223425;4853;1136;0;34
FR;5;2022-11-28;7;11;3;0;11;5;0;0;0;276809;184448;3233;990;223436;4858;1136;0;34
FR;5;2022-11-29;10;9;1;0;11;3;0;0;1;276819;184457;3234;990;223447;4861;1136;0;35
FR;5;2022-11-30;34;48;12;0;55;17;1;0;0;276853;184505;3246;990;223502;4878;1137;0;35
FR;5;2022-12-01;3;8;2;0;8;3;0;0;0;276856;184513;3248;990;223510;4881;1137;0;35
FR;5;2022-12-02;1;5;2;1;4;3;1;0;0;276857;184518;3250;991;223514;4884;1138;0;35
FR;5;2022-12-03;3;3;8;1;5;8;1;0;0;276860;184521;3258;992;223519;4892;1139;0;35
FR;5;2022-12-04;3;2;1;0;2;2;0;0;0;276863;184523;3259;992;223521;4894;1139;0;35
FR;5;2022-12-05;0;1;0;0;0;1;0;0;0;276863;184524;3259;992;223521;4895;1139;0;35
FR;5;2022-12-06;3;1;0;0;1;0;0;0;1;276866;184525;3259;992;223522;4895;1139;0;36
FR;5;2022-12-07;5;8;2;0;9;2;0;0;0;276871;184533;3261;992;223531;4897;1139;0;36
FR;5;2022-12-08;2;2;0;0;2;0;0;0;0;276873;184535;3261;992;223533;4897;1139;0;36
FR;5;2022-12-09;3;8;0;0;6;2;0;0;0;276876;184543;3261;992;223539;4899;1139;0;36
FR;5;2022-12-10;4;7;2;1;8;2;1;0;0;276880;184550;3263;993;223547;4901;1140;0;36
FR;5;2022-12-11;2;0;0;0;0;0;0;0;0;276882;184550;3263;993;223547;4901;1140;0;36
FR;5;2022-12-12;0;0;0;0;0;0;0;0;0;276882;184550;3263;993;223547;4901;1140;0;36
FR;5;2022-12-13;2;3;0;0;2;1;0;0;0;276884;184553;3263;993;223549;4902;1140;0;36
FR;6;2020-12-27;0;0;0;0;0;0;0;0;0;0;0;0;0;0;0;0;0;0
FR;6;2020-12-28;0;0;0;0;0;0;0;0;0;0;0;0;0;0;0;0;0;0
FR;6;2020-12-29;0;0;0;0;0;0;0;0;0;0;0;0;0;0;0;0;0;0
FR;6;2020-12-30;0;0;0;0;0;0;0;0;0;0;0;0;0;0;0;0;0;0
FR;6;2020-12-31;0;0;0;0;0;0;0;0;0;0;0;0;0;0;0;0;0;0
FR;6;2021-01-01;0;0;0;0;0;0;0;0;0;0;0;0;0;0;0;0;0;0
FR;6;2021-01-02;0;0;0;0;0;0;0;0;0;0;0;0;0;0;0;0;0;0
FR;6;2021-01-03;0;0;0;0;0;0;0;0;0;0;0;0;0;0;0;0;0;0
FR;6;2021-01-04;0;0;0;0;0;0;0;0;0;0;0;0;0;0;0;0;0;0
FR;6;2021-01-05;0;0;0;0;0;0;0;0;0;0;0;0;0;0;0;0;0;0
FR;6;2021-01-06;0;0;0;0;0;0;0;0;0;0;0;0;0;0;0;0;0;0
FR;6;2021-01-07;0;0;0;0;0;0;0;0;0;0;0;0;0;0;0;0;0;0
FR;6;2021-01-08;0;0;0;0;0;0;0;0;0;0;0;0;0;0;0;0;0;0
FR;6;2021-01-09;0;0;0;0;0;0;0;0;0;0;0;0;0;0;0;0;0;0
FR;6;2021-01-10;0;0;0;0;0;0;0;0;0;0;0;0;0;0;0;0;0;0
FR;6;2021-01-11;0;0;0;0;0;0;0;0;0;0;0;0;0;0;0;0;0;0
FR;6;2021-01-12;0;0;0;0;0;0;0;0;0;0;0;0;0;0;0;0;0;0
FR;6;2021-01-13;0;0;0;0;0;0;0;0;0;0;0;0;0;0;0;0;0;0
FR;6;2021-01-14;0;0;0;0;0;0;0;0;0;0;0;0;0;0;0;0;0;0
FR;6;2021-01-15;0;0;0;0;0;0;0;0;0;0;0;0;0;0;0;0;0;0
FR;6;2021-01-16;0;0;0;0;0;0;0;0;0;0;0;0;0;0;0;0;0;0
FR;6;2021-01-17;0;0;0;0;0;0;0;0;0;0;0;0;0;0;0;0;0;0
FR;6;2021-01-18;0;0;0;0;0;0;0;0;0;0;0;0;0;0;0;0;0;0
FR;6;2021-01-19;0;0;0;0;0;0;0;0;0;0;0;0;0;0;0;0;0;0
FR;6;2021-01-20;0;0;0;0;0;0;0;0;0;0;0;0;0;0;0;0;0;0
FR;6;2021-01-21;0;0;0;0;0;0;0;0;0;0;0;0;0;0;0;0;0;0
FR;6;2021-01-22;0;0;0;0;0;0;0;0;0;0;0;0;0;0;0;0;0;0
FR;6;2021-01-23;0;0;0;0;0;0;0;0;0;0;0;0;0;0;0;0;0;0
FR;6;2021-01-24;0;0;0;0;0;0;0;0;0;0;0;0;0;0;0;0;0;0
FR;6;2021-01-25;0;0;0;0;0;0;0;0;0;0;0;0;0;0;0;0;0;0
FR;6;2021-01-26;0;0;0;0;0;0;0;0;0;0;0;0;0;0;0;0;0;0
FR;6;2021-01-27;0;0;0;0;0;0;0;0;0;0;0;0;0;0;0;0;0;0
FR;6;2021-01-28;0;0;0;0;0;0;0;0;0;0;0;0;0;0;0;0;0;0
FR;6;2021-01-29;0;0;0;0;0;0;0;0;0;0;0;0;0;0;0;0;0;0
FR;6;2021-01-30;0;0;0;0;0;0;0;0;0;0;0;0;0;0;0;0;0;0
FR;6;2021-01-31;0;0;0;0;0;0;0;0;0;0;0;0;0;0;0;0;0;0
FR;6;2021-02-01;0;0;0;0;0;0;0;0;0;0;0;0;0;0;0;0;0;0
FR;6;2021-02-02;0;0;0;0;0;0;0;0;0;0;0;0;0;0;0;0;0;0
FR;6;2021-02-03;0;0;0;0;0;0;0;0;0;0;0;0;0;0;0;0;0;0
FR;6;2021-02-04;0;0;0;0;0;0;0;0;0;0;0;0;0;0;0;0;0;0
FR;6;2021-02-05;0;0;0;0;0;0;0;0;0;0;0;0;0;0;0;0;0;0
FR;6;2021-02-06;0;0;0;0;0;0;0;0;0;0;0;0;0;0;0;0;0;0
FR;6;2021-02-07;0;0;0;0;0;0;0;0;0;0;0;0;0;0;0;0;0;0
FR;6;2021-02-08;0;0;0;0;0;0;0;0;0;0;0;0;0;0;0;0;0;0
FR;6;2021-02-09;0;0;0;0;0;0;0;0;0;0;0;0;0;0;0;0;0;0
FR;6;2021-02-10;0;0;0;0;0;0;0;0;0;0;0;0;0;0;0;0;0;0
FR;6;2021-02-11;0;0;0;0;0;0;0;0;0;0;0;0;0;0;0;0;0;0
FR;6;2021-02-12;0;0;0;0;0;0;0;0;0;0;0;0;0;0;0;0;0;0
FR;6;2021-02-13;0;0;0;0;0;0;0;0;0;0;0;0;0;0;0;0;0;0
FR;6;2021-02-14;0;0;0;0;0;0;0;0;0;0;0;0;0;0;0;0;0;0
FR;6;2021-02-15;0;0;0;0;0;0;0;0;0;0;0;0;0;0;0;0;0;0
FR;6;2021-02-16;0;0;0;0;0;0;0;0;0;0;0;0;0;0;0;0;0;0
FR;6;2021-02-17;0;0;0;0;0;0;0;0;0;0;0;0;0;0;0;0;0;0
FR;6;2021-02-18;0;0;0;0;0;0;0;0;0;0;0;0;0;0;0;0;0;0
FR;6;2021-02-19;0;0;0;0;0;0;0;0;0;0;0;0;0;0;0;0;0;0
FR;6;2021-02-20;0;0;0;0;0;0;0;0;0;0;0;0;0;0;0;0;0;0
FR;6;2021-02-21;0;0;0;0;0;0;0;0;0;0;0;0;0;0;0;0;0;0
FR;6;2021-02-22;0;0;0;0;0;0;0;0;0;0;0;0;0;0;0;0;0;0
FR;6;2021-02-23;0;0;0;0;0;0;0;0;0;0;0;0;0;0;0;0;0;0
FR;6;2021-02-24;0;0;0;0;0;0;0;0;0;0;0;0;0;0;0;0;0;0
FR;6;2021-02-25;0;0;0;0;0;0;0;0;0;0;0;0;0;0;0;0;0;0
FR;6;2021-02-26;0;0;0;0;0;0;0;0;0;0;0;0;0;0;0;0;0;0
FR;6;2021-02-27;0;0;0;0;0;0;0;0;0;0;0;0;0;0;0;0;0;0
FR;6;2021-02-28;0;0;0;0;0;0;0;0;0;0;0;0;0;0;0;0;0;0
FR;6;2021-03-01;0;0;0;0;0;0;0;0;0;0;0;0;0;0;0;0;0;0
FR;6;2021-03-02;0;0;0;0;0;0;0;0;0;0;0;0;0;0;0;0;0;0
FR;6;2021-03-03;0;0;0;0;0;0;0;0;0;0;0;0;0;0;0;0;0;0
FR;6;2021-03-04;0;0;0;0;0;0;0;0;0;0;0;0;0;0;0;0;0;0
FR;6;2021-03-05;0;0;0;0;0;0;0;0;0;0;0;0;0;0;0;0;0;0
FR;6;2021-03-06;0;0;0;0;0;0;0;0;0;0;0;0;0;0;0;0;0;0
FR;6;2021-03-07;0;0;0;0;0;0;0;0;0;0;0;0;0;0;0;0;0;0
FR;6;2021-03-08;0;0;0;0;0;0;0;0;0;0;0;0;0;0;0;0;0;0
FR;6;2021-03-09;0;0;0;0;0;0;0;0;0;0;0;0;0;0;0;0;0;0
FR;6;2021-03-10;0;0;0;0;0;0;0;0;0;0;0;0;0;0;0;0;0;0
FR;6;2021-03-11;0;0;0;0;0;0;0;0;0;0;0;0;0;0;0;0;0;0
FR;6;2021-03-12;0;0;0;0;0;0;0;0;0;0;0;0;0;0;0;0;0;0
FR;6;2021-03-13;0;0;0;0;0;0;0;0;0;0;0;0;0;0;0;0;0;0
FR;6;2021-03-14;0;0;0;0;0;0;0;0;0;0;0;0;0;0;0;0;0;0
FR;6;2021-03-15;0;0;0;0;0;0;0;0;0;0;0;0;0;0;0;0;0;0
FR;6;2021-03-16;0;0;0;0;0;0;0;0;0;0;0;0;0;0;0;0;0;0
FR;6;2021-03-17;0;0;0;0;0;0;0;0;0;0;0;0;0;0;0;0;0;0
FR;6;2021-03-18;0;0;0;0;0;0;0;0;0;0;0;0;0;0;0;0;0;0
FR;6;2021-03-19;0;0;0;0;0;0;0;0;0;0;0;0;0;0;0;0;0;0
FR;6;2021-03-20;0;0;0;0;0;0;0;0;0;0;0;0;0;0;0;0;0;0
FR;6;2021-03-21;0;0;0;0;0;0;0;0;0;0;0;0;0;0;0;0;0;0
FR;6;2021-03-22;0;0;0;0;0;0;0;0;0;0;0;0;0;0;0;0;0;0
FR;6;2021-03-23;0;0;0;0;0;0;0;0;0;0;0;0;0;0;0;0;0;0
FR;6;2021-03-24;0;0;0;0;0;0;0;0;0;0;0;0;0;0;0;0;0;0
FR;6;2021-03-25;0;0;0;0;0;0;0;0;0;0;0;0;0;0;0;0;0;0
FR;6;2021-03-26;0;0;0;0;0;0;0;0;0;0;0;0;0;0;0;0;0;0
FR;6;2021-03-27;0;0;0;0;0;0;0;0;0;0;0;0;0;0;0;0;0;0
FR;6;2021-03-28;0;0;0;0;0;0;0;0;0;0;0;0;0;0;0;0;0;0
FR;6;2021-03-29;0;0;0;0;0;0;0;0;0;0;0;0;0;0;0;0;0;0
FR;6;2021-03-30;0;0;0;0;0;0;0;0;0;0;0;0;0;0;0;0;0;0
FR;6;2021-03-31;0;0;0;0;0;0;0;0;0;0;0;0;0;0;0;0;0;0
FR;6;2021-04-01;0;0;0;0;0;0;0;0;0;0;0;0;0;0;0;0;0;0
FR;6;2021-04-02;0;0;0;0;0;0;0;0;0;0;0;0;0;0;0;0;0;0
FR;6;2021-04-03;0;0;0;0;0;0;0;0;0;0;0;0;0;0;0;0;0;0
FR;6;2021-04-04;0;0;0;0;0;0;0;0;0;0;0;0;0;0;0;0;0;0
FR;6;2021-04-05;0;0;0;0;0;0;0;0;0;0;0;0;0;0;0;0;0;0
FR;6;2021-04-06;0;0;0;0;0;0;0;0;0;0;0;0;0;0;0;0;0;0
FR;6;2021-04-07;0;0;0;0;0;0;0;0;0;0;0;0;0;0;0;0;0;0
FR;6;2021-04-08;0;0;0;0;0;0;0;0;0;0;0;0;0;0;0;0;0;0
FR;6;2021-04-09;0;0;0;0;0;0;0;0;0;0;0;0;0;0;0;0;0;0
FR;6;2021-04-10;0;0;0;0;0;0;0;0;0;0;0;0;0;0;0;0;0;0
FR;6;2021-04-11;0;0;0;0;0;0;0;0;0;0;0;0;0;0;0;0;0;0
FR;6;2021-04-12;0;0;0;0;0;0;0;0;0;0;0;0;0;0;0;0;0;0
FR;6;2021-04-13;0;0;0;0;0;0;0;0;0;0;0;0;0;0;0;0;0;0
FR;6;2021-04-14;0;0;0;0;0;0;0;0;0;0;0;0;0;0;0;0;0;0
FR;6;2021-04-15;0;0;0;0;0;0;0;0;0;0;0;0;0;0;0;0;0;0
FR;6;2021-04-16;0;0;0;0;0;0;0;0;0;0;0;0;0;0;0;0;0;0
FR;6;2021-04-17;0;0;0;0;0;0;0;0;0;0;0;0;0;0;0;0;0;0
FR;6;2021-04-18;0;0;0;0;0;0;0;0;0;0;0;0;0;0;0;0;0;0
FR;6;2021-04-19;0;0;0;0;0;0;0;0;0;0;0;0;0;0;0;0;0;0
FR;6;2021-04-20;0;0;0;0;0;0;0;0;0;0;0;0;0;0;0;0;0;0
FR;6;2021-04-21;0;0;0;0;0;0;0;0;0;0;0;0;0;0;0;0;0;0
FR;6;2021-04-22;0;0;0;0;0;0;0;0;0;0;0;0;0;0;0;0;0;0
FR;6;2021-04-23;0;0;0;0;0;0;0;0;0;0;0;0;0;0;0;0;0;0
FR;6;2021-04-24;0;0;0;0;0;0;0;0;0;0;0;0;0;0;0;0;0;0
FR;6;2021-04-25;0;0;0;0;0;0;0;0;0;0;0;0;0;0;0;0;0;0
FR;6;2021-04-26;0;0;0;0;0;0;0;0;0;0;0;0;0;0;0;0;0;0
FR;6;2021-04-27;0;0;0;0;0;0;0;0;0;0;0;0;0;0;0;0;0;0
FR;6;2021-04-28;0;0;0;0;0;0;0;0;0;0;0;0;0;0;0;0;0;0
FR;6;2021-04-29;0;0;0;0;0;0;0;0;0;0;0;0;0;0;0;0;0;0
FR;6;2021-04-30;0;0;0;0;0;0;0;0;0;0;0;0;0;0;0;0;0;0
FR;6;2021-05-01;0;0;0;0;0;0;0;0;0;0;0;0;0;0;0;0;0;0
FR;6;2021-05-02;0;0;0;0;0;0;0;0;0;0;0;0;0;0;0;0;0;0
FR;6;2021-05-03;0;0;0;0;0;0;0;0;0;0;0;0;0;0;0;0;0;0
FR;6;2021-05-04;0;0;0;0;0;0;0;0;0;0;0;0;0;0;0;0;0;0
FR;6;2021-05-05;0;0;0;0;0;0;0;0;0;0;0;0;0;0;0;0;0;0
FR;6;2021-05-06;0;0;0;0;0;0;0;0;0;0;0;0;0;0;0;0;0;0
FR;6;2021-05-07;0;0;0;0;0;0;0;0;0;0;0;0;0;0;0;0;0;0
FR;6;2021-05-08;0;0;0;0;0;0;0;0;0;0;0;0;0;0;0;0;0;0
FR;6;2021-05-09;0;0;0;0;0;0;0;0;0;0;0;0;0;0;0;0;0;0
FR;6;2021-05-10;0;0;0;0;0;0;0;0;0;0;0;0;0;0;0;0;0;0
FR;6;2021-05-11;0;0;0;0;0;0;0;0;0;0;0;0;0;0;0;0;0;0
FR;6;2021-05-12;0;0;0;0;0;0;0;0;0;0;0;0;0;0;0;0;0;0
FR;6;2021-05-13;0;0;0;0;0;0;0;0;0;0;0;0;0;0;0;0;0;0
FR;6;2021-05-14;0;0;0;0;0;0;0;0;0;0;0;0;0;0;0;0;0;0
FR;6;2021-05-15;0;0;0;0;0;0;0;0;0;0;0;0;0;0;0;0;0;0
FR;6;2021-05-16;0;0;0;0;0;0;0;0;0;0;0;0;0;0;0;0;0;0
FR;6;2021-05-17;0;0;0;0;0;0;0;0;0;0;0;0;0;0;0;0;0;0
FR;6;2021-05-18;0;0;0;0;0;0;0;0;0;0;0;0;0;0;0;0;0;0
FR;6;2021-05-19;0;0;0;0;0;0;0;0;0;0;0;0;0;0;0;0;0;0
FR;6;2021-05-20;0;0;0;0;0;0;0;0;0;0;0;0;0;0;0;0;0;0
FR;6;2021-05-21;0;0;0;0;0;0;0;0;0;0;0;0;0;0;0;0;0;0
FR;6;2021-05-22;0;0;0;0;0;0;0;0;0;0;0;0;0;0;0;0;0;0
FR;6;2021-05-23;0;0;0;0;0;0;0;0;0;0;0;0;0;0;0;0;0;0
FR;6;2021-05-24;0;0;0;0;0;0;0;0;0;0;0;0;0;0;0;0;0;0
FR;6;2021-05-25;0;0;0;0;0;0;0;0;0;0;0;0;0;0;0;0;0;0
FR;6;2021-05-26;0;0;0;0;0;0;0;0;0;0;0;0;0;0;0;0;0;0
FR;6;2021-05-27;0;0;0;0;0;0;0;0;0;0;0;0;0;0;0;0;0;0
FR;6;2021-05-28;0;0;0;0;0;0;0;0;0;0;0;0;0;0;0;0;0;0
FR;6;2021-05-29;0;0;0;0;0;0;0;0;0;0;0;0;0;0;0;0;0;0
FR;6;2021-05-30;0;0;0;0;0;0;0;0;0;0;0;0;0;0;0;0;0;0
FR;6;2021-05-31;0;0;0;0;0;0;0;0;0;0;0;0;0;0;0;0;0;0
FR;6;2021-06-01;0;0;0;0;0;0;0;0;0;0;0;0;0;0;0;0;0;0
FR;6;2021-06-02;0;0;0;0;0;0;0;0;0;0;0;0;0;0;0;0;0;0
FR;6;2021-06-03;0;0;0;0;0;0;0;0;0;0;0;0;0;0;0;0;0;0
FR;6;2021-06-04;0;0;0;0;0;0;0;0;0;0;0;0;0;0;0;0;0;0
FR;6;2021-06-05;0;0;0;0;0;0;0;0;0;0;0;0;0;0;0;0;0;0
FR;6;2021-06-06;0;0;0;0;0;0;0;0;0;0;0;0;0;0;0;0;0;0
FR;6;2021-06-07;0;0;0;0;0;0;0;0;0;0;0;0;0;0;0;0;0;0
FR;6;2021-06-08;0;0;0;0;0;0;0;0;0;0;0;0;0;0;0;0;0;0
FR;6;2021-06-09;0;0;0;0;0;0;0;0;0;0;0;0;0;0;0;0;0;0
FR;6;2021-06-10;0;0;0;0;0;0;0;0;0;0;0;0;0;0;0;0;0;0
FR;6;2021-06-11;0;0;0;0;0;0;0;0;0;0;0;0;0;0;0;0;0;0
FR;6;2021-06-12;0;0;0;0;0;0;0;0;0;0;0;0;0;0;0;0;0;0
FR;6;2021-06-13;0;0;0;0;0;0;0;0;0;0;0;0;0;0;0;0;0;0
FR;6;2021-06-14;0;0;0;0;0;0;0;0;0;0;0;0;0;0;0;0;0;0
FR;6;2021-06-15;0;0;0;0;0;0;0;0;0;0;0;0;0;0;0;0;0;0
FR;6;2021-06-16;0;0;0;0;0;0;0;0;0;0;0;0;0;0;0;0;0;0
FR;6;2021-06-17;0;0;0;0;0;0;0;0;0;0;0;0;0;0;0;0;0;0
FR;6;2021-06-18;0;0;0;0;0;0;0;0;0;0;0;0;0;0;0;0;0;0
FR;6;2021-06-19;0;0;0;0;0;0;0;0;0;0;0;0;0;0;0;0;0;0
FR;6;2021-06-20;0;0;0;0;0;0;0;0;0;0;0;0;0;0;0;0;0;0
FR;6;2021-06-21;0;0;0;0;0;0;0;0;0;0;0;0;0;0;0;0;0;0
FR;6;2021-06-22;0;0;0;0;0;0;0;0;0;0;0;0;0;0;0;0;0;0
FR;6;2021-06-23;0;0;0;0;0;0;0;0;0;0;0;0;0;0;0;0;0;0
FR;6;2021-06-24;0;0;0;0;0;0;0;0;0;0;0;0;0;0;0;0;0;0
FR;6;2021-06-25;0;0;0;0;0;0;0;0;0;0;0;0;0;0;0;0;0;0
FR;6;2021-06-26;0;0;0;0;0;0;0;0;0;0;0;0;0;0;0;0;0;0
FR;6;2021-06-27;0;0;0;0;0;0;0;0;0;0;0;0;0;0;0;0;0;0
FR;6;2021-06-28;0;0;0;0;0;0;0;0;0;0;0;0;0;0;0;0;0;0
FR;6;2021-06-29;0;0;0;0;0;0;0;0;0;0;0;0;0;0;0;0;0;0
FR;6;2021-06-30;0;0;0;0;0;0;0;0;0;0;0;0;0;0;0;0;0;0
FR;6;2021-07-01;0;0;0;0;0;0;0;0;0;0;0;0;0;0;0;0;0;0
FR;6;2021-07-02;0;0;0;0;0;0;0;0;0;0;0;0;0;0;0;0;0;0
FR;6;2021-07-03;0;0;0;0;0;0;0;0;0;0;0;0;0;0;0;0;0;0
FR;6;2021-07-04;0;0;0;0;0;0;0;0;0;0;0;0;0;0;0;0;0;0
FR;6;2021-07-05;0;0;0;0;0;0;0;0;0;0;0;0;0;0;0;0;0;0
FR;6;2021-07-06;0;0;0;0;0;0;0;0;0;0;0;0;0;0;0;0;0;0
FR;6;2021-07-07;0;0;0;0;0;0;0;0;0;0;0;0;0;0;0;0;0;0
FR;6;2021-07-08;0;0;0;0;0;0;0;0;0;0;0;0;0;0;0;0;0;0
FR;6;2021-07-09;0;0;0;0;0;0;0;0;0;0;0;0;0;0;0;0;0;0
FR;6;2021-07-10;0;0;0;0;0;0;0;0;0;0;0;0;0;0;0;0;0;0
FR;6;2021-07-11;0;0;0;0;0;0;0;0;0;0;0;0;0;0;0;0;0;0
FR;6;2021-07-12;0;0;0;0;0;0;0;0;0;0;0;0;0;0;0;0;0;0
FR;6;2021-07-13;0;0;0;0;0;0;0;0;0;0;0;0;0;0;0;0;0;0
FR;6;2021-07-14;0;0;0;0;0;0;0;0;0;0;0;0;0;0;0;0;0;0
FR;6;2021-07-15;0;0;0;0;0;0;0;0;0;0;0;0;0;0;0;0;0;0
FR;6;2021-07-16;0;0;0;0;0;0;0;0;0;0;0;0;0;0;0;0;0;0
FR;6;2021-07-17;0;0;0;0;0;0;0;0;0;0;0;0;0;0;0;0;0;0
FR;6;2021-07-18;0;0;0;0;0;0;0;0;0;0;0;0;0;0;0;0;0;0
FR;6;2021-07-19;0;0;0;0;0;0;0;0;0;0;0;0;0;0;0;0;0;0
FR;6;2021-07-20;0;0;0;0;0;0;0;0;0;0;0;0;0;0;0;0;0;0
FR;6;2021-07-21;0;0;0;0;0;0;0;0;0;0;0;0;0;0;0;0;0;0
FR;6;2021-07-22;0;0;0;0;0;0;0;0;0;0;0;0;0;0;0;0;0;0
FR;6;2021-07-23;0;0;0;0;0;0;0;0;0;0;0;0;0;0;0;0;0;0
FR;6;2021-07-24;0;0;0;0;0;0;0;0;0;0;0;0;0;0;0;0;0;0
FR;6;2021-07-25;0;0;0;0;0;0;0;0;0;0;0;0;0;0;0;0;0;0
FR;6;2021-07-26;0;0;0;0;0;0;0;0;0;0;0;0;0;0;0;0;0;0
FR;6;2021-07-27;0;0;0;0;0;0;0;0;0;0;0;0;0;0;0;0;0;0
FR;6;2021-07-28;0;0;0;0;0;0;0;0;0;0;0;0;0;0;0;0;0;0
FR;6;2021-07-29;0;0;0;0;0;0;0;0;0;0;0;0;0;0;0;0;0;0
FR;6;2021-07-30;0;0;0;0;0;0;0;0;0;0;0;0;0;0;0;0;0;0
FR;6;2021-07-31;0;0;0;0;0;0;0;0;0;0;0;0;0;0;0;0;0;0
FR;6;2021-08-01;0;0;0;0;0;0;0;0;0;0;0;0;0;0;0;0;0;0
FR;6;2021-08-02;0;0;0;0;0;0;0;0;0;0;0;0;0;0;0;0;0;0
FR;6;2021-08-03;0;0;0;0;0;0;0;0;0;0;0;0;0;0;0;0;0;0
FR;6;2021-08-04;0;0;0;0;0;0;0;0;0;0;0;0;0;0;0;0;0;0
FR;6;2021-08-05;0;0;0;0;0;0;0;0;0;0;0;0;0;0;0;0;0;0
FR;6;2021-08-06;0;0;0;0;0;0;0;0;0;0;0;0;0;0;0;0;0;0
FR;6;2021-08-07;0;0;0;0;0;0;0;0;0;0;0;0;0;0;0;0;0;0
FR;6;2021-08-08;0;0;0;0;0;0;0;0;0;0;0;0;0;0;0;0;0;0
FR;6;2021-08-09;0;0;0;0;0;0;0;0;0;0;0;0;0;0;0;0;0;0
FR;6;2021-08-10;0;0;0;0;0;0;0;0;0;0;0;0;0;0;0;0;0;0
FR;6;2021-08-11;0;0;0;0;0;0;0;0;0;0;0;0;0;0;0;0;0;0
FR;6;2021-08-12;0;0;0;0;0;0;0;0;0;0;0;0;0;0;0;0;0;0
FR;6;2021-08-13;0;0;0;0;0;0;0;0;0;0;0;0;0;0;0;0;0;0
FR;6;2021-08-14;0;0;0;0;0;0;0;0;0;0;0;0;0;0;0;0;0;0
FR;6;2021-08-15;0;0;0;0;0;0;0;0;0;0;0;0;0;0;0;0;0;0
FR;6;2021-08-16;0;0;0;0;0;0;0;0;0;0;0;0;0;0;0;0;0;0
FR;6;2021-08-17;0;0;0;0;0;0;0;0;0;0;0;0;0;0;0;0;0;0
FR;6;2021-08-18;0;0;0;0;0;0;0;0;0;0;0;0;0;0;0;0;0;0
FR;6;2021-08-19;0;0;0;0;0;0;0;0;0;0;0;0;0;0;0;0;0;0
FR;6;2021-08-20;0;0;0;0;0;0;0;0;0;0;0;0;0;0;0;0;0;0
FR;6;2021-08-21;0;0;0;0;0;0;0;0;0;0;0;0;0;0;0;0;0;0
FR;6;2021-08-22;0;0;0;0;0;0;0;0;0;0;0;0;0;0;0;0;0;0
FR;6;2021-08-23;0;0;0;0;0;0;0;0;0;0;0;0;0;0;0;0;0;0
FR;6;2021-08-24;0;0;0;0;0;0;0;0;0;0;0;0;0;0;0;0;0;0
FR;6;2021-08-25;0;0;0;0;0;0;0;0;0;0;0;0;0;0;0;0;0;0
FR;6;2021-08-26;0;0;0;0;0;0;0;0;0;0;0;0;0;0;0;0;0;0
FR;6;2021-08-27;0;0;0;0;0;0;0;0;0;0;0;0;0;0;0;0;0;0
FR;6;2021-08-28;0;0;0;0;0;0;0;0;0;0;0;0;0;0;0;0;0;0
FR;6;2021-08-29;0;0;0;0;0;0;0;0;0;0;0;0;0;0;0;0;0;0
FR;6;2021-08-30;0;0;0;0;0;0;0;0;0;0;0;0;0;0;0;0;0;0
FR;6;2021-08-31;0;0;0;0;0;0;0;0;0;0;0;0;0;0;0;0;0;0
FR;6;2021-09-01;0;0;0;0;0;0;0;0;0;0;0;0;0;0;0;0;0;0
FR;6;2021-09-02;0;0;0;0;0;0;0;0;0;0;0;0;0;0;0;0;0;0
FR;6;2021-09-03;0;0;0;0;0;0;0;0;0;0;0;0;0;0;0;0;0;0
FR;6;2021-09-04;0;0;0;0;0;0;0;0;0;0;0;0;0;0;0;0;0;0
FR;6;2021-09-05;0;0;0;0;0;0;0;0;0;0;0;0;0;0;0;0;0;0
FR;6;2021-09-06;0;0;0;0;0;0;0;0;0;0;0;0;0;0;0;0;0;0
FR;6;2021-09-07;0;0;0;0;0;0;0;0;0;0;0;0;0;0;0;0;0;0
FR;6;2021-09-08;0;0;0;0;0;0;0;0;0;0;0;0;0;0;0;0;0;0
FR;6;2021-09-09;0;0;0;0;0;0;0;0;0;0;0;0;0;0;0;0;0;0
FR;6;2021-09-10;0;0;0;0;0;0;0;0;0;0;0;0;0;0;0;0;0;0
FR;6;2021-09-11;0;0;0;0;0;0;0;0;0;0;0;0;0;0;0;0;0;0
FR;6;2021-09-12;0;0;0;0;0;0;0;0;0;0;0;0;0;0;0;0;0;0
FR;6;2021-09-13;0;0;0;0;0;0;0;0;0;0;0;0;0;0;0;0;0;0
FR;6;2021-09-14;0;0;0;0;0;0;0;0;0;0;0;0;0;0;0;0;0;0
FR;6;2021-09-15;0;0;0;0;0;0;0;0;0;0;0;0;0;0;0;0;0;0
FR;6;2021-09-16;0;0;0;0;0;0;0;0;0;0;0;0;0;0;0;0;0;0
FR;6;2021-09-17;0;0;0;0;0;0;0;0;0;0;0;0;0;0;0;0;0;0
FR;6;2021-09-18;0;0;0;0;0;0;0;0;0;0;0;0;0;0;0;0;0;0
FR;6;2021-09-19;0;0;0;0;0;0;0;0;0;0;0;0;0;0;0;0;0;0
FR;6;2021-09-20;0;0;0;0;0;0;0;0;0;0;0;0;0;0;0;0;0;0
FR;6;2021-09-21;0;0;0;0;0;0;0;0;0;0;0;0;0;0;0;0;0;0
FR;6;2021-09-22;0;0;0;0;0;0;0;0;0;0;0;0;0;0;0;0;0;0
FR;6;2021-09-23;0;0;0;0;0;0;0;0;0;0;0;0;0;0;0;0;0;0
FR;6;2021-09-24;0;0;0;0;0;0;0;0;0;0;0;0;0;0;0;0;0;0
FR;6;2021-09-25;0;0;0;0;0;0;0;0;0;0;0;0;0;0;0;0;0;0
FR;6;2021-09-26;0;0;0;0;0;0;0;0;0;0;0;0;0;0;0;0;0;0
FR;6;2021-09-27;0;0;0;0;0;0;0;0;0;0;0;0;0;0;0;0;0;0
FR;6;2021-09-28;0;0;0;0;0;0;0;0;0;0;0;0;0;0;0;0;0;0
FR;6;2021-09-29;0;0;0;0;0;0;0;0;0;0;0;0;0;0;0;0;0;0
FR;6;2021-09-30;0;0;0;0;0;0;0;0;0;0;0;0;0;0;0;0;0;0
FR;6;2021-10-01;0;0;0;0;0;0;0;0;0;0;0;0;0;0;0;0;0;0
FR;6;2021-10-02;0;0;0;0;0;0;0;0;0;0;0;0;0;0;0;0;0;0
FR;6;2021-10-03;0;0;0;0;0;0;0;0;0;0;0;0;0;0;0;0;0;0
FR;6;2021-10-04;0;0;0;0;0;0;0;0;0;0;0;0;0;0;0;0;0;0
FR;6;2021-10-05;0;0;0;0;0;0;0;0;0;0;0;0;0;0;0;0;0;0
FR;6;2021-10-06;0;0;0;0;0;0;0;0;0;0;0;0;0;0;0;0;0;0
FR;6;2021-10-07;0;0;0;0;0;0;0;0;0;0;0;0;0;0;0;0;0;0
FR;6;2021-10-08;0;0;0;0;0;0;0;0;0;0;0;0;0;0;0;0;0;0
FR;6;2021-10-09;0;0;0;0;0;0;0;0;0;0;0;0;0;0;0;0;0;0
FR;6;2021-10-10;0;0;0;0;0;0;0;0;0;0;0;0;0;0;0;0;0;0
FR;6;2021-10-11;0;0;0;0;0;0;0;0;0;0;0;0;0;0;0;0;0;0
FR;6;2021-10-12;0;0;0;0;0;0;0;0;0;0;0;0;0;0;0;0;0;0
FR;6;2021-10-13;0;0;0;0;0;0;0;0;0;0;0;0;0;0;0;0;0;0
FR;6;2021-10-14;0;0;0;0;0;0;0;0;0;0;0;0;0;0;0;0;0;0
FR;6;2021-10-15;0;0;0;0;0;0;0;0;0;0;0;0;0;0;0;0;0;0
FR;6;2021-10-16;0;0;0;0;0;0;0;0;0;0;0;0;0;0;0;0;0;0
FR;6;2021-10-17;0;0;0;0;0;0;0;0;0;0;0;0;0;0;0;0;0;0
FR;6;2021-10-18;0;0;0;0;0;0;0;0;0;0;0;0;0;0;0;0;0;0
FR;6;2021-10-19;0;0;0;0;0;0;0;0;0;0;0;0;0;0;0;0;0;0
FR;6;2021-10-20;0;0;0;0;0;0;0;0;0;0;0;0;0;0;0;0;0;0
FR;6;2021-10-21;0;0;0;0;0;0;0;0;0;0;0;0;0;0;0;0;0;0
FR;6;2021-10-22;0;0;0;0;0;0;0;0;0;0;0;0;0;0;0;0;0;0
FR;6;2021-10-23;0;0;0;0;0;0;0;0;0;0;0;0;0;0;0;0;0;0
FR;6;2021-10-24;0;0;0;0;0;0;0;0;0;0;0;0;0;0;0;0;0;0
FR;6;2021-10-25;0;0;0;0;0;0;0;0;0;0;0;0;0;0;0;0;0;0
FR;6;2021-10-26;0;0;0;0;0;0;0;0;0;0;0;0;0;0;0;0;0;0
FR;6;2021-10-27;0;0;0;0;0;0;0;0;0;0;0;0;0;0;0;0;0;0
FR;6;2021-10-28;0;0;0;0;0;0;0;0;0;0;0;0;0;0;0;0;0;0
FR;6;2021-10-29;0;0;0;0;0;0;0;0;0;0;0;0;0;0;0;0;0;0
FR;6;2021-10-30;0;0;0;0;0;0;0;0;0;0;0;0;0;0;0;0;0;0
FR;6;2021-10-31;0;0;0;0;0;0;0;0;0;0;0;0;0;0;0;0;0;0
FR;6;2021-11-01;0;0;0;0;0;0;0;0;0;0;0;0;0;0;0;0;0;0
FR;6;2021-11-02;0;0;0;0;0;0;0;0;0;0;0;0;0;0;0;0;0;0
FR;6;2021-11-03;0;0;0;0;0;0;0;0;0;0;0;0;0;0;0;0;0;0
FR;6;2021-11-04;0;0;0;0;0;0;0;0;0;0;0;0;0;0;0;0;0;0
FR;6;2021-11-05;0;0;0;0;0;0;0;0;0;0;0;0;0;0;0;0;0;0
FR;6;2021-11-06;0;0;0;0;0;0;0;0;0;0;0;0;0;0;0;0;0;0
FR;6;2021-11-07;0;0;0;0;0;0;0;0;0;0;0;0;0;0;0;0;0;0
FR;6;2021-11-08;0;0;0;0;0;0;0;0;0;0;0;0;0;0;0;0;0;0
FR;6;2021-11-09;0;0;0;0;0;0;0;0;0;0;0;0;0;0;0;0;0;0
FR;6;2021-11-10;0;0;0;0;0;0;0;0;0;0;0;0;0;0;0;0;0;0
FR;6;2021-11-11;0;0;0;0;0;0;0;0;0;0;0;0;0;0;0;0;0;0
FR;6;2021-11-12;0;0;0;0;0;0;0;0;0;0;0;0;0;0;0;0;0;0
FR;6;2021-11-13;0;0;0;0;0;0;0;0;0;0;0;0;0;0;0;0;0;0
FR;6;2021-11-14;0;0;0;0;0;0;0;0;0;0;0;0;0;0;0;0;0;0
FR;6;2021-11-15;0;0;0;0;0;0;0;0;0;0;0;0;0;0;0;0;0;0
FR;6;2021-11-16;0;0;0;0;0;0;0;0;0;0;0;0;0;0;0;0;0;0
FR;6;2021-11-17;0;0;0;0;0;0;0;0;0;0;0;0;0;0;0;0;0;0
FR;6;2021-11-18;0;0;0;0;0;0;0;0;0;0;0;0;0;0;0;0;0;0
FR;6;2021-11-19;0;0;0;0;0;0;0;0;0;0;0;0;0;0;0;0;0;0
FR;6;2021-11-20;0;0;0;0;0;0;0;0;0;0;0;0;0;0;0;0;0;0
FR;6;2021-11-21;0;0;0;0;0;0;0;0;0;0;0;0;0;0;0;0;0;0
FR;6;2021-11-22;0;0;0;0;0;0;0;0;0;0;0;0;0;0;0;0;0;0
FR;6;2021-11-23;0;0;0;0;0;0;0;0;0;0;0;0;0;0;0;0;0;0
FR;6;2021-11-24;0;0;0;0;0;0;0;0;0;0;0;0;0;0;0;0;0;0
FR;6;2021-11-25;0;0;0;0;0;0;0;0;0;0;0;0;0;0;0;0;0;0
FR;6;2021-11-26;0;0;0;0;0;0;0;0;0;0;0;0;0;0;0;0;0;0
FR;6;2021-11-27;0;0;0;0;0;0;0;0;0;0;0;0;0;0;0;0;0;0
FR;6;2021-11-28;0;0;0;0;0;0;0;0;0;0;0;0;0;0;0;0;0;0
FR;6;2021-11-29;0;0;0;0;0;0;0;0;0;0;0;0;0;0;0;0;0;0
FR;6;2021-11-30;0;0;0;0;0;0;0;0;0;0;0;0;0;0;0;0;0;0
FR;6;2021-12-01;0;0;0;0;0;0;0;0;0;0;0;0;0;0;0;0;0;0
FR;6;2021-12-02;0;0;0;0;0;0;0;0;0;0;0;0;0;0;0;0;0;0
FR;6;2021-12-03;0;0;0;0;0;0;0;0;0;0;0;0;0;0;0;0;0;0
FR;6;2021-12-04;0;0;0;0;0;0;0;0;0;0;0;0;0;0;0;0;0;0
FR;6;2021-12-05;0;0;0;0;0;0;0;0;0;0;0;0;0;0;0;0;0;0
FR;6;2021-12-06;0;0;0;0;0;0;0;0;0;0;0;0;0;0;0;0;0;0
FR;6;2021-12-07;0;0;0;0;0;0;0;0;0;0;0;0;0;0;0;0;0;0
FR;6;2021-12-08;0;0;0;0;0;0;0;0;0;0;0;0;0;0;0;0;0;0
FR;6;2021-12-09;0;0;0;0;0;0;0;0;0;0;0;0;0;0;0;0;0;0
FR;6;2021-12-10;0;0;0;0;0;0;0;0;0;0;0;0;0;0;0;0;0;0
FR;6;2021-12-11;0;0;0;0;0;0;0;0;0;0;0;0;0;0;0;0;0;0
FR;6;2021-12-12;0;0;0;0;0;0;0;0;0;0;0;0;0;0;0;0;0;0
FR;6;2021-12-13;0;0;0;0;0;0;0;0;0;0;0;0;0;0;0;0;0;0
FR;6;2021-12-14;0;0;0;0;0;0;0;0;0;0;0;0;0;0;0;0;0;0
FR;6;2021-12-15;0;0;0;0;0;0;0;0;0;0;0;0;0;0;0;0;0;0
FR;6;2021-12-16;0;0;0;0;0;0;0;0;0;0;0;0;0;0;0;0;0;0
FR;6;2021-12-17;0;0;0;0;0;0;0;0;0;0;0;0;0;0;0;0;0;0
FR;6;2021-12-18;0;0;0;0;0;0;0;0;0;0;0;0;0;0;0;0;0;0
FR;6;2021-12-19;0;0;0;0;0;0;0;0;0;0;0;0;0;0;0;0;0;0
FR;6;2021-12-20;0;0;0;0;0;0;0;0;0;0;0;0;0;0;0;0;0;0
FR;6;2021-12-21;0;0;0;0;0;0;0;0;0;0;0;0;0;0;0;0;0;0
FR;6;2021-12-22;0;0;0;0;0;0;0;0;0;0;0;0;0;0;0;0;0;0
FR;6;2021-12-23;0;0;0;0;0;0;0;0;0;0;0;0;0;0;0;0;0;0
FR;6;2021-12-24;0;0;0;0;0;0;0;0;0;0;0;0;0;0;0;0;0;0
FR;6;2021-12-25;0;0;0;0;0;0;0;0;0;0;0;0;0;0;0;0;0;0
FR;6;2021-12-26;0;0;0;0;0;0;0;0;0;0;0;0;0;0;0;0;0;0
FR;6;2021-12-27;0;0;0;0;0;0;0;0;0;0;0;0;0;0;0;0;0;0
FR;6;2021-12-28;0;0;0;0;0;0;0;0;0;0;0;0;0;0;0;0;0;0
FR;6;2021-12-29;0;0;0;0;0;0;0;0;0;0;0;0;0;0;0;0;0;0
FR;6;2021-12-30;0;0;0;0;0;0;0;0;0;0;0;0;0;0;0;0;0;0
FR;6;2021-12-31;0;0;0;0;0;0;0;0;0;0;0;0;0;0;0;0;0;0
FR;6;2022-01-01;0;0;0;0;0;0;0;0;0;0;0;0;0;0;0;0;0;0
FR;6;2022-01-02;0;0;0;0;0;0;0;0;0;0;0;0;0;0;0;0;0;0
FR;6;2022-01-03;0;0;0;0;0;0;0;0;0;0;0;0;0;0;0;0;0;0
FR;6;2022-01-04;0;0;0;0;0;0;0;0;0;0;0;0;0;0;0;0;0;0
FR;6;2022-01-05;0;0;0;0;0;0;0;0;0;0;0;0;0;0;0;0;0;0
FR;6;2022-01-06;0;0;0;0;0;0;0;0;0;0;0;0;0;0;0;0;0;0
FR;6;2022-01-07;0;0;0;0;0;0;0;0;0;0;0;0;0;0;0;0;0;0
FR;6;2022-01-08;0;0;0;0;0;0;0;0;0;0;0;0;0;0;0;0;0;0
FR;6;2022-01-09;0;0;0;0;0;0;0;0;0;0;0;0;0;0;0;0;0;0
FR;6;2022-01-10;0;0;0;0;0;0;0;0;0;0;0;0;0;0;0;0;0;0
FR;6;2022-01-11;0;0;0;0;0;0;0;0;0;0;0;0;0;0;0;0;0;0
FR;6;2022-01-12;0;0;0;0;0;0;0;0;0;0;0;0;0;0;0;0;0;0
FR;6;2022-01-13;0;0;0;0;0;0;0;0;0;0;0;0;0;0;0;0;0;0
FR;6;2022-01-14;0;0;0;0;0;0;0;0;0;0;0;0;0;0;0;0;0;0
FR;6;2022-01-15;0;0;0;0;0;0;0;0;0;0;0;0;0;0;0;0;0;0
FR;6;2022-01-16;0;0;0;0;0;0;0;0;0;0;0;0;0;0;0;0;0;0
FR;6;2022-01-17;0;0;0;0;0;0;0;0;0;0;0;0;0;0;0;0;0;0
FR;6;2022-01-18;0;0;0;0;0;0;0;0;0;0;0;0;0;0;0;0;0;0
FR;6;2022-01-19;0;0;0;0;0;0;0;0;0;0;0;0;0;0;0;0;0;0
FR;6;2022-01-20;0;0;0;0;0;0;0;0;0;0;0;0;0;0;0;0;0;0
FR;6;2022-01-21;0;0;0;0;0;0;0;0;0;0;0;0;0;0;0;0;0;0
FR;6;2022-01-22;0;0;0;0;0;0;0;0;0;0;0;0;0;0;0;0;0;0
FR;6;2022-01-23;0;0;0;0;0;0;0;0;0;0;0;0;0;0;0;0;0;0
FR;6;2022-01-24;0;0;0;0;0;0;0;0;0;0;0;0;0;0;0;0;0;0
FR;6;2022-01-25;0;0;0;0;0;0;0;0;0;0;0;0;0;0;0;0;0;0
FR;6;2022-01-26;0;0;0;0;0;0;0;0;0;0;0;0;0;0;0;0;0;0
FR;6;2022-01-27;0;0;0;0;0;0;0;0;0;0;0;0;0;0;0;0;0;0
FR;6;2022-01-28;0;0;0;0;0;0;0;0;0;0;0;0;0;0;0;0;0;0
FR;6;2022-01-29;0;0;0;0;0;0;0;0;0;0;0;0;0;0;0;0;0;0
FR;6;2022-01-30;0;0;0;0;0;0;0;0;0;0;0;0;0;0;0;0;0;0
FR;6;2022-01-31;0;0;0;0;0;0;0;0;0;0;0;0;0;0;0;0;0;0
FR;6;2022-02-01;0;0;0;0;0;0;0;0;0;0;0;0;0;0;0;0;0;0
FR;6;2022-02-02;0;0;0;0;0;0;0;0;0;0;0;0;0;0;0;0;0;0
FR;6;2022-02-03;0;0;0;0;0;0;0;0;0;0;0;0;0;0;0;0;0;0
FR;6;2022-02-04;0;0;0;0;0;0;0;0;0;0;0;0;0;0;0;0;0;0
FR;6;2022-02-05;0;0;0;0;0;0;0;0;0;0;0;0;0;0;0;0;0;0
FR;6;2022-02-06;0;0;0;0;0;0;0;0;0;0;0;0;0;0;0;0;0;0
FR;6;2022-02-07;0;0;0;0;0;0;0;0;0;0;0;0;0;0;0;0;0;0
FR;6;2022-02-08;0;0;0;0;0;0;0;0;0;0;0;0;0;0;0;0;0;0
FR;6;2022-02-09;0;0;0;0;0;0;0;0;0;0;0;0;0;0;0;0;0;0
FR;6;2022-02-10;0;0;0;0;0;0;0;0;0;0;0;0;0;0;0;0;0;0
FR;6;2022-02-11;0;0;0;0;0;0;0;0;0;0;0;0;0;0;0;0;0;0
FR;6;2022-02-12;0;0;0;0;0;0;0;0;0;0;0;0;0;0;0;0;0;0
FR;6;2022-02-13;0;0;0;0;0;0;0;0;0;0;0;0;0;0;0;0;0;0
FR;6;2022-02-14;0;0;0;0;0;0;0;0;0;0;0;0;0;0;0;0;0;0
FR;6;2022-02-15;0;0;0;0;0;0;0;0;0;0;0;0;0;0;0;0;0;0
FR;6;2022-02-16;0;0;0;0;0;0;0;0;0;0;0;0;0;0;0;0;0;0
FR;6;2022-02-17;0;0;0;0;0;0;0;0;0;0;0;0;0;0;0;0;0;0
FR;6;2022-02-18;0;0;0;0;0;0;0;0;0;0;0;0;0;0;0;0;0;0
FR;6;2022-02-19;0;0;0;0;0;0;0;0;0;0;0;0;0;0;0;0;0;0
FR;6;2022-02-20;0;0;0;0;0;0;0;0;0;0;0;0;0;0;0;0;0;0
FR;6;2022-02-21;0;0;0;0;0;0;0;0;0;0;0;0;0;0;0;0;0;0
FR;6;2022-02-22;0;0;0;0;0;0;0;0;0;0;0;0;0;0;0;0;0;0
FR;6;2022-02-23;0;0;0;0;0;0;0;0;0;0;0;0;0;0;0;0;0;0
FR;6;2022-02-24;0;0;0;0;0;0;0;0;0;0;0;0;0;0;0;0;0;0
FR;6;2022-02-25;0;0;0;0;0;0;0;0;0;0;0;0;0;0;0;0;0;0
FR;6;2022-02-26;1;0;0;0;0;0;0;0;0;1;0;0;0;0;0;0;0;0
FR;6;2022-02-27;0;0;0;0;0;0;0;0;0;1;0;0;0;0;0;0;0;0
FR;6;2022-02-28;0;0;0;0;0;0;0;0;0;1;0;0;0;0;0;0;0;0
FR;6;2022-03-01;3;0;0;0;0;0;0;0;0;4;0;0;0;0;0;0;0;0
FR;6;2022-03-02;97;9;2;0;15;7;0;0;0;101;9;2;0;15;7;0;0;0
FR;6;2022-03-03;0;0;0;0;0;0;0;0;0;101;9;2;0;15;7;0;0;0
FR;6;2022-03-04;92;4;0;0;8;4;0;0;0;193;13;2;0;23;11;0;0;0
FR;6;2022-03-05;391;23;2;0;60;14;0;0;0;584;36;4;0;83;25;0;0;0
FR;6;2022-03-06;7;1;0;0;2;0;0;0;0;591;37;4;0;85;25;0;0;0
FR;6;2022-03-07;337;19;0;0;51;13;0;0;0;928;56;4;0;136;38;0;0;0
FR;6;2022-03-08;230;14;0;0;47;5;0;0;0;1158;70;4;0;183;43;0;0;0
FR;6;2022-03-09;519;29;2;0;84;21;1;0;0;1677;99;6;0;267;64;1;0;0
FR;6;2022-03-10;206;19;0;1;54;12;1;0;0;1883;118;6;1;321;76;2;0;0
FR;6;2022-03-11;331;22;6;0;53;21;0;0;0;2214;140;12;1;374;97;2;0;0
FR;6;2022-03-12;518;25;1;0;83;20;0;0;0;2732;165;13;1;457;117;2;0;0
FR;6;2022-03-13;40;2;0;0;2;1;0;0;0;2772;167;13;1;459;118;2;0;0
FR;6;2022-03-14;201;4;2;0;39;3;1;0;0;2973;171;15;1;498;121;3;0;0
FR;6;2022-03-15;112;11;2;0;29;9;0;0;0;3085;182;17;1;527;130;3;0;0
FR;6;2022-03-16;310;17;2;1;49;15;1;0;0;3395;199;19;2;576;145;4;0;0
FR;6;2022-03-17;117;6;1;2;14;4;2;0;0;3512;205;20;4;590;149;6;0;0
FR;6;2022-03-18;215;10;0;0;40;6;0;0;0;3727;215;20;4;630;155;6;0;0
FR;6;2022-03-19;307;19;2;0;89;9;0;0;0;4034;234;22;4;719;164;6;0;0
FR;6;2022-03-20;15;5;0;0;5;1;0;0;0;4049;239;22;4;724;165;6;0;0
FR;6;2022-03-21;132;23;1;0;47;4;0;0;0;4181;262;23;4;771;169;6;0;0
FR;6;2022-03-22;97;15;0;0;34;4;0;0;0;4278;277;23;4;805;173;6;0;0
FR;6;2022-03-23;226;108;3;0;154;14;1;0;0;4504;385;26;4;959;187;7;0;0
FR;6;2022-03-24;100;15;1;3;32;4;3;0;0;4604;400;27;7;991;191;10;0;0
FR;6;2022-03-25;203;141;2;1;177;15;2;0;0;4807;541;29;8;1168;206;12;0;0
FR;6;2022-03-26;331;295;7;1;382;19;1;0;0;5138;836;36;9;1550;225;13;0;0
FR;6;2022-03-27;32;30;1;0;37;1;1;0;0;5170;866;37;9;1587;226;14;0;0
FR;6;2022-03-28;201;208;8;1;234;17;3;0;0;5371;1074;45;10;1821;243;17;0;0
FR;6;2022-03-29;124;189;12;2;206;12;9;0;0;5495;1263;57;12;2027;255;26;0;0
FR;6;2022-03-30;305;476;10;2;548;22;6;0;0;5800;1739;67;14;2575;277;32;0;0
FR;6;2022-03-31;123;140;10;0;160;14;5;0;0;5923;1879;77;14;2735;291;37;0;0
FR;6;2022-04-01;195;150;11;2;178;23;3;0;0;6118;2029;88;16;2913;314;40;0;0
FR;6;2022-04-02;206;241;9;1;280;13;8;0;0;6324;2270;97;17;3193;327;48;0;0
FR;6;2022-04-03;17;21;0;0;26;1;0;0;0;6341;2291;97;17;3219;328;48;0;0
FR;6;2022-04-04;137;114;6;1;131;9;5;0;0;6478;2405;103;18;3350;337;53;0;0
FR;6;2022-04-05;146;88;15;1;105;11;8;0;0;6624;2493;118;19;3455;348;61;0;0
FR;6;2022-04-06;204;245;22;26;291;27;33;0;0;6828;2738;140;45;3746;375;94;0;0
FR;6;2022-04-07;127;96;15;9;115;17;14;0;0;6955;2834;155;54;3861;392;108;0;0
FR;6;2022-04-08;199;171;16;3;214;17;9;0;1;7154;3005;171;57;4075;409;117;0;1
FR;6;2022-04-09;145;139;6;12;171;13;4;0;0;7299;3144;177;69;4246;422;121;0;1
FR;6;2022-04-10;10;20;3;0;25;1;3;0;0;7309;3164;180;69;4271;423;124;0;1
FR;6;2022-04-11;101;106;4;0;128;5;3;0;0;7410;3270;184;69;4399;428;127;0;1
FR;6;2022-04-12;136;75;5;8;114;10;10;0;0;7546;3345;189;77;4513;438;137;0;1
FR;6;2022-04-13;162;175;7;5;208;13;8;0;0;7708;3520;196;82;4721;451;145;0;1
FR;6;2022-04-14;100;103;5;10;121;8;10;0;0;7808;3623;201;92;4842;459;155;0;1
FR;6;2022-04-15;158;149;11;7;167;19;14;0;1;7966;3772;212;99;5009;478;169;0;2
FR;6;2022-04-16;127;132;5;0;162;14;2;0;0;8093;3904;217;99;5171;492;171;0;2
FR;6;2022-04-17;8;9;4;0;10;4;0;0;0;8101;3913;221;99;5181;496;171;0;2
FR;6;2022-04-18;8;15;3;0;15;4;0;0;0;8109;3928;224;99;5196;500;171;0;2
FR;6;2022-04-19;97;112;4;3;130;3;7;0;0;8206;4040;228;102;5326;503;178;0;2
FR;6;2022-04-20;178;227;8;7;269;15;3;0;0;8384;4267;236;109;5595;518;181;0;2
FR;6;2022-04-21;111;93;8;4;110;11;7;0;0;8495;4360;244;113;5705;529;188;0;2
FR;6;2022-04-22;138;160;13;12;190;13;13;0;0;8633;4520;257;125;5895;542;201;0;2
FR;6;2022-04-23;106;129;1;1;161;7;1;0;0;8739;4649;258;126;6056;549;202;0;2
FR;6;2022-04-24;5;21;1;0;22;0;1;0;0;8744;4670;259;126;6078;549;203;0;2
FR;6;2022-04-25;91;128;3;8;151;11;9;0;0;8835;4798;262;134;6229;560;212;0;2
FR;6;2022-04-26;101;128;19;2;151;17;13;0;0;8936;4926;281;136;6380;577;225;0;2
FR;6;2022-04-27;197;159;21;1;222;27;11;0;1;9133;5085;302;137;6602;604;236;0;3
FR;6;2022-04-28;109;87;7;1;123;8;7;0;0;9242;5172;309;138;6725;612;243;0;3
FR;6;2022-04-29;191;169;16;2;215;20;6;0;0;9433;5341;325;140;6940;632;249;0;3
FR;6;2022-04-30;133;125;7;1;168;24;2;0;0;9566;5466;332;141;7108;656;251;0;3
FR;6;2022-05-01;7;6;0;0;8;0;0;0;0;9573;5472;332;141;7116;656;251;0;3
FR;6;2022-05-02;94;65;3;4;88;3;4;0;0;9667;5537;335;145;7204;659;255;0;3
FR;6;2022-05-03;136;93;11;2;125;7;9;0;0;9803;5630;346;147;7329;666;264;0;3
FR;6;2022-05-04;167;118;25;12;161;29;12;0;1;9970;5748;371;159;7490;695;276;0;4
FR;6;2022-05-05;101;70;8;3;96;12;6;0;0;10071;5818;379;162;7586;707;282;0;4
FR;6;2022-05-06;152;110;10;9;155;16;11;0;0;10223;5928;389;171;7741;723;293;0;4
FR;6;2022-05-07;139;93;13;3;136;23;8;0;0;10362;6021;402;174;7877;746;301;0;4
FR;6;2022-05-08;20;8;6;5;16;7;5;0;0;10382;6029;408;179;7893;753;306;0;4
FR;6;2022-05-09;86;78;9;7;95;13;6;0;0;10468;6107;417;186;7988;766;312;0;4
FR;6;2022-05-10;112;80;15;7;110;12;13;0;0;10580;6187;432;193;8098;778;325;0;4
FR;6;2022-05-11;130;124;11;14;163;20;6;0;0;10710;6311;443;207;8261;798;331;0;4
FR;6;2022-05-12;105;76;7;5;96;15;6;0;1;10815;6387;450;212;8357;813;337;0;5
FR;6;2022-05-13;155;97;17;21;137;22;16;0;0;10970;6484;467;233;8494;835;353;0;5
FR;6;2022-05-14;81;60;6;7;84;15;2;0;0;11051;6544;473;240;8578;850;355;0;5
FR;6;2022-05-15;12;7;0;0;14;0;0;0;0;11063;6551;473;240;8592;850;355;0;5
FR;6;2022-05-16;65;54;6;2;69;12;3;0;0;11128;6605;479;242;8661;862;358;0;5
FR;6;2022-05-17;123;77;5;7;92;11;8;0;0;11251;6682;484;249;8753;873;366;0;5
FR;6;2022-05-18;131;116;5;1;159;13;3;0;0;11382;6798;489;250;8912;886;369;0;5
FR;6;2022-05-19;124;57;6;8;96;9;8;0;0;11506;6855;495;258;9008;895;377;0;5
FR;6;2022-05-20;125;115;13;3;151;18;10;0;0;11631;6970;508;261;9159;913;387;0;5
FR;6;2022-05-21;92;69;14;3;93;12;8;0;0;11723;7039;522;264;9252;925;395;0;5
FR;6;2022-05-22;19;12;5;0;21;4;1;0;0;11742;7051;527;264;9273;929;396;0;5
FR;6;2022-05-23;77;72;4;2;90;7;2;0;0;11819;7123;531;266;9363;936;398;0;5
FR;6;2022-05-24;117;98;8;2;132;16;4;0;0;11936;7221;539;268;9495;952;402;0;5
FR;6;2022-05-25;139;129;6;3;170;11;6;0;0;12075;7350;545;271;9665;963;408;0;5
FR;6;2022-05-26;7;9;3;0;5;9;0;0;0;12082;7359;548;271;9670;972;408;0;5
FR;6;2022-05-27;127;105;15;11;136;18;18;0;1;12209;7464;563;282;9806;990;426;0;6
FR;6;2022-05-28;53;75;1;5;89;8;5;0;0;12262;7539;564;287;9895;998;431;0;6
FR;6;2022-05-29;8;10;0;0;10;1;0;0;0;12270;7549;564;287;9905;999;431;0;6
FR;6;2022-05-30;70;70;7;4;86;4;9;0;0;12340;7619;571;291;9991;1003;440;0;6
FR;6;2022-05-31;87;102;10;2;121;14;7;0;0;12427;7721;581;293;10112;1017;447;0;6
FR;6;2022-06-01;97;89;10;1;111;11;6;0;0;12524;7810;591;294;10223;1028;453;0;6
FR;6;2022-06-02;91;60;6;3;80;9;6;0;0;12615;7870;597;297;10303;1037;459;0;6
FR;6;2022-06-03;126;102;13;7;129;21;8;0;0;12741;7972;610;304;10432;1058;467;0;6
FR;6;2022-06-04;63;51;10;0;64;12;3;0;0;12804;8023;620;304;10496;1070;470;0;6
FR;6;2022-06-05;16;15;2;1;18;4;1;0;0;12820;8038;622;305;10514;1074;471;0;6
FR;6;2022-06-06;9;6;0;0;8;0;0;0;0;12829;8044;622;305;10522;1074;471;0;6
FR;6;2022-06-07;79;90;3;4;117;8;6;0;0;12908;8134;625;309;10639;1082;477;0;6
FR;6;2022-06-08;92;110;13;5;130;20;6;0;0;13000;8244;638;314;10769;1102;483;0;6
FR;6;2022-06-09;75;81;15;3;106;15;8;0;0;13075;8325;653;317;10875;1117;491;0;6
FR;6;2022-06-10;116;93;26;10;121;22;13;0;0;13191;8418;679;327;10996;1139;504;0;6
FR;6;2022-06-11;83;62;6;10;82;12;11;0;0;13274;8480;685;337;11078;1151;515;0;6
FR;6;2022-06-12;6;14;1;0;16;2;0;0;0;13280;8494;686;337;11094;1153;515;0;6
FR;6;2022-06-13;74;59;18;1;68;7;4;0;0;13354;8553;704;338;11162;1160;519;0;6
FR;6;2022-06-14;98;100;8;5;116;16;8;0;0;13452;8653;712;343;11278;1176;527;0;6
FR;6;2022-06-15;80;86;7;8;114;15;10;0;0;13532;8739;719;351;11392;1191;537;0;6
FR;6;2022-06-16;53;40;11;7;45;14;6;0;0;13585;8779;730;358;11437;1205;543;0;6
FR;6;2022-06-17;86;85;3;13;109;11;5;0;0;13671;8864;733;371;11546;1216;548;0;6
FR;6;2022-06-18;71;61;13;0;86;21;1;0;0;13742;8925;746;371;11632;1237;549;0;6
FR;6;2022-06-19;6;6;3;0;7;4;1;0;0;13748;8931;749;371;11639;1241;550;0;6
FR;6;2022-06-20;42;41;4;1;55;6;1;0;0;13790;8972;753;372;11694;1247;551;0;6
FR;6;2022-06-21;59;73;10;7;82;17;7;0;0;13849;9045;763;379;11776;1264;558;0;6
FR;6;2022-06-22;86;85;8;2;98;17;3;0;0;13935;9130;771;381;11874;1281;561;0;6
FR;6;2022-06-23;64;39;13;7;41;15;10;0;0;13999;9169;784;388;11915;1296;571;0;6
FR;6;2022-06-24;77;85;7;14;95;20;16;0;0;14076;9254;791;402;12010;1316;587;0;6
FR;6;2022-06-25;67;61;4;3;77;8;5;0;0;14143;9315;795;405;12087;1324;592;0;6
FR;6;2022-06-26;6;7;1;0;10;1;0;0;0;14149;9322;796;405;12097;1325;592;0;6
FR;6;2022-06-27;51;50;4;9;62;12;7;0;0;14200;9372;800;414;12159;1337;599;0;6
FR;6;2022-06-28;68;47;6;3;53;15;5;0;0;14268;9419;806;417;12212;1352;604;0;6
FR;6;2022-06-29;98;117;26;37;115;19;35;0;5;14366;9536;832;454;12327;1371;639;0;11
FR;6;2022-06-30;84;60;33;10;61;12;7;0;0;14450;9596;865;464;12388;1383;646;0;11
FR;6;2022-07-01;115;94;25;33;102;18;27;0;1;14565;9690;890;497;12490;1401;673;0;12
FR;6;2022-07-02;58;67;26;2;64;37;6;0;0;14623;9757;916;499;12554;1438;679;0;12
FR;6;2022-07-03;11;4;4;3;5;4;3;0;0;14634;9761;920;502;12559;1442;682;0;12
FR;6;2022-07-04;61;43;3;23;55;13;20;0;0;14695;9804;923;525;12614;1455;702;0;12
FR;6;2022-07-05;65;53;19;67;60;27;63;0;0;14760;9857;942;592;12674;1482;765;0;12
FR;6;2022-07-06;94;64;7;11;77;12;17;0;0;14854;9921;949;603;12751;1494;782;0;12
FR;6;2022-07-07;99;79;42;37;99;14;34;0;4;14953;10000;991;640;12850;1508;816;0;16
FR;6;2022-07-08;139;87;42;27;116;10;25;0;3;15092;10087;1033;667;12966;1518;841;0;19
FR;6;2022-07-09;53;51;16;29;51;27;33;0;1;15145;10138;1049;696;13017;1545;874;0;20
FR;6;2022-07-10;3;7;8;0;9;9;0;0;0;15148;10145;1057;696;13026;1554;874;0;20
FR;6;2022-07-11;54;44;5;4;47;12;4;0;0;15202;10189;1062;700;13073;1566;878;0;20
FR;6;2022-07-12;70;72;12;23;87;12;27;0;0;15272;10261;1074;723;13160;1578;905;0;20
FR;6;2022-07-13;84;65;14;21;71;25;22;0;0;15356;10326;1088;744;13231;1603;927;0;20
FR;6;2022-07-14;4;3;1;0;4;1;0;0;0;15360;10329;1089;744;13235;1604;927;0;20
FR;6;2022-07-15;74;59;9;57;85;16;45;0;0;15434;10388;1098;801;13320;1620;972;0;20
FR;6;2022-07-16;27;31;17;0;37;17;3;0;0;15461;10419;1115;801;13357;1637;975;0;20
FR;6;2022-07-17;3;7;0;0;8;0;0;0;0;15464;10426;1115;801;13365;1637;975;0;20
FR;6;2022-07-18;37;62;11;14;60;15;14;0;6;15501;10488;1126;815;13425;1652;989;0;26
FR;6;2022-07-19;54;48;4;19;60;6;21;0;1;15555;10536;1130;834;13485;1658;1010;0;27
FR;6;2022-07-20;53;70;7;22;75;11;27;0;0;15608;10606;1137;856;13560;1669;1037;0;27
FR;6;2022-07-21;51;60;4;7;55;11;9;0;0;15659;10666;1141;863;13615;1680;1046;0;27
FR;6;2022-07-22;55;74;7;26;82;8;16;0;2;15714;10740;1148;889;13697;1688;1062;0;29
FR;6;2022-07-23;38;40;6;10;40;6;9;0;1;15752;10780;1154;899;13737;1694;1071;0;30
FR;6;2022-07-24;11;14;1;3;19;3;3;0;0;15763;10794;1155;902;13756;1697;1074;0;30
FR;6;2022-07-25;60;44;8;12;41;9;13;0;1;15823;10838;1163;914;13797;1706;1087;0;31
FR;6;2022-07-26;47;64;14;6;62;10;13;0;0;15870;10902;1177;920;13859;1716;1100;0;31
FR;6;2022-07-27;54;78;15;11;81;17;15;0;8;15924;10980;1192;931;13940;1733;1115;0;39
FR;6;2022-07-28;30;48;4;6;50;8;7;0;1;15954;11028;1196;937;13990;1741;1122;0;40
FR;6;2022-07-29;43;71;10;38;60;24;36;0;1;15997;11099;1206;975;14050;1765;1158;0;41
FR;6;2022-07-30;26;48;4;15;49;7;15;0;0;16023;11147;1210;990;14099;1772;1173;0;41
FR;6;2022-07-31;0;1;1;0;1;0;1;0;0;16023;11148;1211;990;14100;1772;1174;0;41
FR;6;2022-08-01;39;36;14;8;32;10;6;0;1;16062;11184;1225;998;14132;1782;1180;0;42
FR;6;2022-08-02;37;46;10;14;52;6;16;0;0;16099;11230;1235;1012;14184;1788;1196;0;42
FR;6;2022-08-03;29;52;7;16;53;11;19;0;0;16128;11282;1242;1028;14237;1799;1215;0;42
FR;6;2022-08-04;25;21;4;9;20;6;10;0;1;16153;11303;1246;1037;14257;1805;1225;0;43
FR;6;2022-08-05;43;45;1;7;53;5;7;0;0;16196;11348;1247;1044;14310;1810;1232;0;43
FR;6;2022-08-06;17;27;1;3;33;2;4;0;0;16213;11375;1248;1047;14343;1812;1236;0;43
FR;6;2022-08-07;1;2;0;0;2;0;0;0;0;16214;11377;1248;1047;14345;1812;1236;0;43
FR;6;2022-08-08;24;33;1;0;40;1;0;0;0;16238;11410;1249;1047;14385;1813;1236;0;43
FR;6;2022-08-09;22;30;6;3;29;3;3;0;0;16260;11440;1255;1050;14414;1816;1239;0;43
FR;6;2022-08-10;32;36;5;9;38;5;9;0;5;16292;11476;1260;1059;14452;1821;1248;0;48
FR;6;2022-08-11;33;33;1;1;40;1;0;0;1;16325;11509;1261;1060;14492;1822;1248;0;49
FR;6;2022-08-12;50;44;6;2;50;15;3;0;1;16375;11553;1267;1062;14542;1837;1251;0;50
FR;6;2022-08-13;9;20;0;0;22;1;0;0;0;16384;11573;1267;1062;14564;1838;1251;0;50
FR;6;2022-08-14;3;1;0;0;2;0;0;0;0;16387;11574;1267;1062;14566;1838;1251;0;50
FR;6;2022-08-15;2;3;1;0;4;0;1;0;0;16389;11577;1268;1062;14570;1838;1252;0;50
FR;6;2022-08-16;35;66;21;7;66;7;2;0;0;16424;11643;1289;1069;14636;1845;1254;0;50
FR;6;2022-08-17;32;44;10;9;41;10;6;0;7;16456;11687;1299;1078;14677;1855;1260;0;57
FR;6;2022-08-18;29;55;14;4;61;4;0;0;1;16485;11742;1313;1082;14738;1859;1260;0;58
FR;6;2022-08-19;30;45;5;4;47;3;2;0;1;16515;11787;1318;1086;14785;1862;1262;0;59
FR;6;2022-08-20;26;29;3;0;29;8;1;0;0;16541;11816;1321;1086;14814;1870;1263;0;59
FR;6;2022-08-21;1;5;2;0;5;0;0;0;0;16542;11821;1323;1086;14819;1870;1263;0;59
FR;6;2022-08-22;20;42;15;1;45;0;0;0;0;16562;11863;1338;1087;14864;1870;1263;0;59
FR;6;2022-08-23;34;45;6;7;48;6;4;0;2;16596;11908;1344;1094;14912;1876;1267;0;61
FR;6;2022-08-24;34;30;6;3;36;6;2;0;3;16630;11938;1350;1097;14948;1882;1269;0;64
FR;6;2022-08-25;25;27;1;1;29;5;1;0;0;16655;11965;1351;1098;14977;1887;1270;0;64
FR;6;2022-08-26;38;44;4;4;51;7;7;0;0;16693;12009;1355;1102;15028;1894;1277;0;64
FR;6;2022-08-27;19;21;7;3;22;8;4;0;0;16712;12030;1362;1105;15050;1902;1281;0;64
FR;6;2022-08-28;6;3;0;6;3;1;1;0;4;16718;12033;1362;1111;15053;1903;1282;0;68
FR;6;2022-08-29;26;22;2;6;29;3;6;0;0;16744;12055;1364;1117;15082;1906;1288;0;68
FR;6;2022-08-30;28;35;4;12;33;8;13;0;0;16772;12090;1368;1129;15115;1914;1301;0;68
FR;6;2022-08-31;35;38;2;11;46;3;12;0;0;16807;12128;1370;1140;15161;1917;1313;0;68
FR;6;2022-09-01;16;11;5;1;12;4;3;0;0;16823;12139;1375;1141;15173;1921;1316;0;68
FR;6;2022-09-02;19;14;2;1;13;3;2;0;0;16842;12153;1377;1142;15186;1924;1318;0;68
FR;6;2022-09-03;10;3;1;5;4;2;5;0;0;16852;12156;1378;1147;15190;1926;1323;0;68
FR;6;2022-09-04;4;1;0;0;1;0;0;0;0;16856;12157;1378;1147;15191;1926;1323;0;68
FR;6;2022-09-05;8;7;0;0;10;0;0;0;0;16864;12164;1378;1147;15201;1926;1323;0;68
FR;6;2022-09-06;7;9;7;12;8;6;15;0;0;16871;12173;1385;1159;15209;1932;1338;0;68
FR;6;2022-09-07;3;8;1;0;8;1;0;0;0;16874;12181;1386;1159;15217;1933;1338;0;68
FR;6;2022-09-08;6;4;0;2;3;1;2;0;0;16880;12185;1386;1161;15220;1934;1340;0;68
FR;6;2022-09-09;7;9;2;7;9;3;8;0;0;16887;12194;1388;1168;15229;1937;1348;0;68
FR;6;2022-09-10;3;4;1;0;3;1;1;0;0;16890;12198;1389;1168;15232;1938;1349;0;68
FR;6;2022-09-11;1;3;0;0;3;0;0;0;0;16891;12201;1389;1168;15235;1938;1349;0;68
FR;6;2022-09-12;10;4;1;0;3;3;0;0;0;16901;12205;1390;1168;15238;1941;1349;0;68
FR;6;2022-09-13;7;2;3;0;2;2;2;0;0;16908;12207;1393;1168;15240;1943;1351;0;68
FR;6;2022-09-14;9;8;2;0;7;4;0;0;0;16917;12215;1395;1168;15247;1947;1351;0;68
FR;6;2022-09-15;8;13;5;5;9;9;3;0;2;16925;12228;1400;1173;15256;1956;1354;0;70
FR;6;2022-09-16;25;39;1;1;46;4;1;0;2;16950;12267;1401;1174;15302;1960;1355;0;72
FR;6;2022-09-17;24;22;0;6;24;5;3;0;2;16974;12289;1401;1180;15326;1965;1358;0;74
FR;6;2022-09-18;5;4;0;0;4;1;0;0;0;16979;12293;1401;1180;15330;1966;1358;0;74
FR;6;2022-09-19;30;30;2;1;31;5;1;0;0;17009;12323;1403;1181;15361;1971;1359;0;74
FR;6;2022-09-20;34;25;1;4;29;6;2;0;1;17043;12348;1404;1185;15390;1977;1361;0;75
FR;6;2022-09-21;21;9;3;3;7;7;5;0;3;17064;12357;1407;1188;15397;1984;1366;0;78
FR;6;2022-09-22;19;28;1;22;32;3;21;0;1;17083;12385;1408;1210;15429;1987;1387;0;79
FR;6;2022-09-23;28;41;5;9;47;9;2;0;0;17111;12426;1413;1219;15476;1996;1389;0;79
FR;6;2022-09-24;16;16;4;2;21;6;2;0;0;17127;12442;1417;1221;15497;2002;1391;0;79
FR;6;2022-09-25;3;14;0;0;14;1;0;0;0;17130;12456;1417;1221;15511;2003;1391;0;79
FR;6;2022-09-26;16;13;0;18;12;5;18;0;2;17146;12469;1417;1239;15523;2008;1409;0;81
FR;6;2022-09-27;32;19;2;3;23;4;4;0;0;17178;12488;1419;1242;15546;2012;1413;0;81
FR;6;2022-09-28;27;10;9;11;16;5;17;0;2;17205;12498;1428;1253;15562;2017;1430;0;83
FR;6;2022-09-29;13;13;10;34;16;6;33;0;7;17218;12511;1438;1287;15578;2023;1463;0;90
FR;6;2022-09-30;34;24;5;6;33;5;3;0;0;17252;12535;1443;1293;15611;2028;1466;0;90
FR;6;2022-10-01;17;12;5;8;9;8;8;0;2;17269;12547;1448;1301;15620;2036;1474;0;92
FR;6;2022-10-02;3;0;0;0;1;0;0;0;0;17272;12547;1448;1301;15621;2036;1474;0;92
FR;6;2022-10-03;11;10;3;5;11;4;6;0;0;17283;12557;1451;1306;15632;2040;1480;0;92
FR;6;2022-10-04;19;17;4;28;21;3;30;0;3;17302;12574;1455;1334;15653;2043;1510;0;95
FR;6;2022-10-05;11;12;3;2;9;7;4;0;0;17313;12586;1458;1336;15662;2050;1514;0;95
FR;6;2022-10-06;19;13;4;6;17;2;10;0;0;17332;12599;1462;1342;15679;2052;1524;0;95
FR;6;2022-10-07;27;26;5;24;25;10;16;0;5;17359;12625;1467;1366;15704;2062;1540;0;100
FR;6;2022-10-08;18;13;0;0;16;0;0;0;0;17377;12638;1467;1366;15720;2062;1540;0;100
FR;6;2022-10-09;7;3;4;27;3;4;30;0;6;17384;12641;1471;1393;15723;2066;1570;0;106
FR;6;2022-10-10;15;14;1;16;16;6;13;0;0;17399;12655;1472;1409;15739;2072;1583;0;106
FR;6;2022-10-11;21;23;3;11;21;8;13;0;3;17420;12678;1475;1420;15760;2080;1596;0;109
FR;6;2022-10-12;20;16;7;19;18;3;24;0;7;17440;12694;1482;1439;15778;2083;1620;0;116
FR;6;2022-10-13;28;15;2;36;23;0;38;0;6;17468;12709;1484;1475;15801;2083;1658;0;122
FR;6;2022-10-14;29;23;5;49;23;11;45;0;13;17497;12732;1489;1524;15824;2094;1703;0;135
FR;6;2022-10-15;13;9;0;22;8;4;21;0;6;17510;12741;1489;1546;15832;2098;1724;0;141
FR;6;2022-10-16;4;4;0;6;2;2;6;0;0;17514;12745;1489;1552;15834;2100;1730;0;141
FR;6;2022-10-17;14;14;2;10;14;1;12;0;2;17528;12759;1491;1562;15848;2101;1742;0;143
FR;6;2022-10-18;12;19;9;26;19;4;18;0;11;17540;12778;1500;1588;15867;2105;1760;0;154
FR;6;2022-10-19;10;20;6;16;20;5;19;0;5;17550;12798;1506;1604;15887;2110;1779;0;159
FR;6;2022-10-20;16;15;12;57;18;5;67;0;13;17566;12813;1518;1661;15905;2115;1846;0;172
FR;6;2022-10-21;16;21;9;34;22;11;37;0;10;17582;12834;1527;1695;15927;2126;1883;0;182
FR;6;2022-10-22;19;14;1;4;17;3;4;0;0;17601;12848;1528;1699;15944;2129;1887;0;182
FR;6;2022-10-23;3;2;1;0;3;0;1;0;0;17604;12850;1529;1699;15947;2129;1888;0;182
FR;6;2022-10-24;12;14;2;7;14;6;5;0;2;17616;12864;1531;1706;15961;2135;1893;0;184
FR;6;2022-10-25;20;13;6;17;16;7;19;0;4;17636;12877;1537;1723;15977;2142;1912;0;188
FR;6;2022-10-26;17;9;4;13;12;4;15;0;5;17653;12886;1541;1736;15989;2146;1927;0;193
FR;6;2022-10-27;20;7;8;37;10;6;36;0;14;17673;12893;1549;1773;15999;2152;1963;0;207
FR;6;2022-10-28;21;27;3;4;28;6;5;0;1;17694;12920;1552;1777;16027;2158;1968;0;208
FR;6;2022-10-29;7;11;5;11;10;6;14;0;12;17701;12931;1557;1788;16037;2164;1982;0;220
FR;6;2022-10-30;2;5;0;0;5;0;0;0;0;17703;12936;1557;1788;16042;2164;1982;0;220
FR;6;2022-10-31;20;14;2;13;17;4;12;0;3;17723;12950;1559;1801;16059;2168;1994;0;223
FR;6;2022-11-01;2;1;1;0;1;1;0;0;0;17725;12951;1560;1801;16060;2169;1994;0;223
FR;6;2022-11-02;15;25;9;21;26;11;19;0;12;17740;12976;1569;1822;16086;2180;2013;0;235
FR;6;2022-11-03;17;17;11;39;20;8;43;0;9;17757;12993;1580;1861;16106;2188;2056;0;244
FR;6;2022-11-04;19;22;9;16;26;5;16;0;10;17776;13015;1589;1877;16132;2193;2072;0;254
FR;6;2022-11-05;9;16;2;4;17;4;6;0;0;17785;13031;1591;1881;16149;2197;2078;0;254
FR;6;2022-11-06;5;1;0;0;1;0;0;0;0;17790;13032;1591;1881;16150;2197;2078;0;254
FR;6;2022-11-07;18;10;6;17;12;4;18;0;11;17808;13042;1597;1898;16162;2201;2096;0;265
FR;6;2022-11-08;18;10;2;3;8;5;5;0;4;17826;13052;1599;1901;16170;2206;2101;0;269
FR;6;2022-11-09;16;22;1;6;21;4;5;0;4;17842;13074;1600;1907;16191;2210;2106;0;273
FR;6;2022-11-10;10;10;4;12;8;5;11;0;10;17852;13084;1604;1919;16199;2215;2117;0;283
FR;6;2022-11-11;3;1;0;0;1;1;0;0;0;17855;13085;1604;1919;16200;2216;2117;0;283
FR;6;2022-11-12;4;11;1;7;11;2;5;0;9;17859;13096;1605;1926;16211;2218;2122;0;292
FR;6;2022-11-13;1;1;0;1;1;0;1;0;0;17860;13097;1605;1927;16212;2218;2123;0;292
FR;6;2022-11-14;13;10;7;32;14;8;33;0;14;17873;13107;1612;1959;16226;2226;2156;0;306
FR;6;2022-11-15;7;18;1;11;16;4;7;0;1;17880;13125;1613;1970;16242;2230;2163;0;307
FR;6;2022-11-16;16;15;9;32;17;3;42;0;9;17896;13140;1622;2002;16259;2233;2205;0;316
FR;6;2022-11-17;10;8;1;29;8;2;28;0;5;17906;13148;1623;2031;16267;2235;2233;0;321
FR;6;2022-11-18;20;12;5;23;16;4;25;0;7;17926;13160;1628;2054;16283;2239;2258;0;328
FR;6;2022-11-19;5;13;0;2;11;3;2;0;1;17931;13173;1628;2056;16294;2242;2260;0;329
FR;6;2022-11-20;2;1;2;0;1;2;0;0;0;17933;13174;1630;2056;16295;2244;2260;0;329
FR;6;2022-11-21;22;13;1;14;14;6;11;0;3;17955;13187;1631;2070;16309;2250;2271;0;332
FR;6;2022-11-22;14;9;0;4;11;1;3;0;1;17969;13196;1631;2074;16320;2251;2274;0;333
FR;6;2022-11-23;14;15;15;23;17;9;31;0;8;17983;13211;1646;2097;16337;2260;2305;0;341
FR;6;2022-11-24;14;17;1;11;19;5;10;0;7;17997;13228;1647;2108;16356;2265;2315;0;348
FR;6;2022-11-25;23;15;5;50;15;5;47;0;5;18020;13243;1652;2158;16371;2270;2362;0;353
FR;6;2022-11-26;9;5;2;4;3;2;5;0;1;18029;13248;1654;2162;16374;2272;2367;0;354
FR;6;2022-11-27;1;4;0;0;4;0;0;0;0;18030;13252;1654;2162;16378;2272;2367;0;354
FR;6;2022-11-28;9;11;6;22;11;3;24;0;11;18039;13263;1660;2184;16389;2275;2391;0;365
FR;6;2022-11-29;15;10;1;12;14;1;8;0;7;18054;13273;1661;2196;16403;2276;2399;0;372
FR;6;2022-11-30;18;20;8;23;19;12;22;0;8;18072;13293;1669;2219;16422;2288;2421;0;380
FR;6;2022-12-01;12;8;7;20;10;4;24;0;9;18084;13301;1676;2239;16432;2292;2445;0;389
FR;6;2022-12-02;16;9;11;36;12;7;42;0;1;18100;13310;1687;2275;16444;2299;2487;0;390
FR;6;2022-12-03;12;3;13;20;6;5;28;0;13;18112;13313;1700;2295;16450;2304;2515;0;403
FR;6;2022-12-04;3;1;0;1;1;0;1;0;0;18115;13314;1700;2296;16451;2304;2516;0;403
FR;6;2022-12-05;11;10;7;16;11;4;19;0;8;18126;13324;1707;2312;16462;2308;2535;0;411
FR;6;2022-12-06;10;19;3;30;12;11;28;0;3;18136;13343;1710;2342;16474;2319;2563;0;414
FR;6;2022-12-07;17;8;10;56;9;8;57;0;30;18153;13351;1720;2398;16483;2327;2620;0;444
FR;6;2022-12-08;9;13;8;18;11;7;21;0;12;18162;13364;1728;2416;16494;2334;2641;0;456
FR;6;2022-12-09;15;9;5;29;12;4;30;0;6;18177;13373;1733;2445;16506;2338;2671;0;462
FR;6;2022-12-10;12;9;6;9;7;4;14;0;7;18189;13382;1739;2454;16513;2342;2685;0;469
FR;6;2022-12-11;4;2;1;0;2;1;0;0;0;18193;13384;1740;2454;16515;2343;2685;0;469
FR;6;2022-12-12;16;10;6;24;14;5;23;0;9;18209;13394;1746;2478;16529;2348;2708;0;478
FR;6;2022-12-13;16;21;11;57;16;17;56;0;12;18225;13415;1757;2535;16545;2365;2764;0;490
FR;8;2020-12-27;0;0;0;0;0;0;0;0;0;0;0;0;0;0;0;0;0;0
FR;8;2020-12-28;0;0;0;0;0;0;0;0;0;0;0;0;0;0;0;0;0;0
FR;8;2020-12-29;0;0;0;0;0;0;0;0;0;0;0;0;0;0;0;0;0;0
FR;8;2020-12-30;0;0;0;0;0;0;0;0;0;0;0;0;0;0;0;0;0;0
FR;8;2020-12-31;0;0;0;0;0;0;0;0;0;0;0;0;0;0;0;0;0;0
FR;8;2021-01-01;0;0;0;0;0;0;0;0;0;0;0;0;0;0;0;0;0;0
FR;8;2021-01-02;0;0;0;0;0;0;0;0;0;0;0;0;0;0;0;0;0;0
FR;8;2021-01-03;0;0;0;0;0;0;0;0;0;0;0;0;0;0;0;0;0;0
FR;8;2021-01-04;0;0;0;0;0;0;0;0;0;0;0;0;0;0;0;0;0;0
FR;8;2021-01-05;0;0;0;0;0;0;0;0;0;0;0;0;0;0;0;0;0;0
FR;8;2021-01-06;0;0;0;0;0;0;0;0;0;0;0;0;0;0;0;0;0;0
FR;8;2021-01-07;0;0;0;0;0;0;0;0;0;0;0;0;0;0;0;0;0;0
FR;8;2021-01-08;0;0;0;0;0;0;0;0;0;0;0;0;0;0;0;0;0;0
FR;8;2021-01-09;0;0;0;0;0;0;0;0;0;0;0;0;0;0;0;0;0;0
FR;8;2021-01-10;0;0;0;0;0;0;0;0;0;0;0;0;0;0;0;0;0;0
FR;8;2021-01-11;0;0;0;0;0;0;0;0;0;0;0;0;0;0;0;0;0;0
FR;8;2021-01-12;0;0;0;0;0;0;0;0;0;0;0;0;0;0;0;0;0;0
FR;8;2021-01-13;0;0;0;0;0;0;0;0;0;0;0;0;0;0;0;0;0;0
FR;8;2021-01-14;0;0;0;0;0;0;0;0;0;0;0;0;0;0;0;0;0;0
FR;8;2021-01-15;0;0;0;0;0;0;0;0;0;0;0;0;0;0;0;0;0;0
FR;8;2021-01-16;0;0;0;0;0;0;0;0;0;0;0;0;0;0;0;0;0;0
FR;8;2021-01-17;0;0;0;0;0;0;0;0;0;0;0;0;0;0;0;0;0;0
FR;8;2021-01-18;0;0;0;0;0;0;0;0;0;0;0;0;0;0;0;0;0;0
FR;8;2021-01-19;0;0;0;0;0;0;0;0;0;0;0;0;0;0;0;0;0;0
FR;8;2021-01-20;0;0;0;0;0;0;0;0;0;0;0;0;0;0;0;0;0;0
FR;8;2021-01-21;0;0;0;0;0;0;0;0;0;0;0;0;0;0;0;0;0;0
FR;8;2021-01-22;0;0;0;0;0;0;0;0;0;0;0;0;0;0;0;0;0;0
FR;8;2021-01-23;0;0;0;0;0;0;0;0;0;0;0;0;0;0;0;0;0;0
FR;8;2021-01-24;0;0;0;0;0;0;0;0;0;0;0;0;0;0;0;0;0;0
FR;8;2021-01-25;0;0;0;0;0;0;0;0;0;0;0;0;0;0;0;0;0;0
FR;8;2021-01-26;0;0;0;0;0;0;0;0;0;0;0;0;0;0;0;0;0;0
FR;8;2021-01-27;0;0;0;0;0;0;0;0;0;0;0;0;0;0;0;0;0;0
FR;8;2021-01-28;0;0;0;0;0;0;0;0;0;0;0;0;0;0;0;0;0;0
FR;8;2021-01-29;0;0;0;0;0;0;0;0;0;0;0;0;0;0;0;0;0;0
FR;8;2021-01-30;0;0;0;0;0;0;0;0;0;0;0;0;0;0;0;0;0;0
FR;8;2021-01-31;0;0;0;0;0;0;0;0;0;0;0;0;0;0;0;0;0;0
FR;8;2021-02-01;0;0;0;0;0;0;0;0;0;0;0;0;0;0;0;0;0;0
FR;8;2021-02-02;0;0;0;0;0;0;0;0;0;0;0;0;0;0;0;0;0;0
FR;8;2021-02-03;0;0;0;0;0;0;0;0;0;0;0;0;0;0;0;0;0;0
FR;8;2021-02-04;0;0;0;0;0;0;0;0;0;0;0;0;0;0;0;0;0;0
FR;8;2021-02-05;0;0;0;0;0;0;0;0;0;0;0;0;0;0;0;0;0;0
FR;8;2021-02-06;0;0;0;0;0;0;0;0;0;0;0;0;0;0;0;0;0;0
FR;8;2021-02-07;0;0;0;0;0;0;0;0;0;0;0;0;0;0;0;0;0;0
FR;8;2021-02-08;0;0;0;0;0;0;0;0;0;0;0;0;0;0;0;0;0;0
FR;8;2021-02-09;0;0;0;0;0;0;0;0;0;0;0;0;0;0;0;0;0;0
FR;8;2021-02-10;0;0;0;0;0;0;0;0;0;0;0;0;0;0;0;0;0;0
FR;8;2021-02-11;0;0;0;0;0;0;0;0;0;0;0;0;0;0;0;0;0;0
FR;8;2021-02-12;0;0;0;0;0;0;0;0;0;0;0;0;0;0;0;0;0;0
FR;8;2021-02-13;0;0;0;0;0;0;0;0;0;0;0;0;0;0;0;0;0;0
FR;8;2021-02-14;0;0;0;0;0;0;0;0;0;0;0;0;0;0;0;0;0;0
FR;8;2021-02-15;0;0;0;0;0;0;0;0;0;0;0;0;0;0;0;0;0;0
FR;8;2021-02-16;0;0;0;0;0;0;0;0;0;0;0;0;0;0;0;0;0;0
FR;8;2021-02-17;0;0;0;0;0;0;0;0;0;0;0;0;0;0;0;0;0;0
FR;8;2021-02-18;0;0;0;0;0;0;0;0;0;0;0;0;0;0;0;0;0;0
FR;8;2021-02-19;0;0;0;0;0;0;0;0;0;0;0;0;0;0;0;0;0;0
FR;8;2021-02-20;0;0;0;0;0;0;0;0;0;0;0;0;0;0;0;0;0;0
FR;8;2021-02-21;0;0;0;0;0;0;0;0;0;0;0;0;0;0;0;0;0;0
FR;8;2021-02-22;0;0;0;0;0;0;0;0;0;0;0;0;0;0;0;0;0;0
FR;8;2021-02-23;0;0;0;0;0;0;0;0;0;0;0;0;0;0;0;0;0;0
FR;8;2021-02-24;0;0;0;0;0;0;0;0;0;0;0;0;0;0;0;0;0;0
FR;8;2021-02-25;0;0;0;0;0;0;0;0;0;0;0;0;0;0;0;0;0;0
FR;8;2021-02-26;0;0;0;0;0;0;0;0;0;0;0;0;0;0;0;0;0;0
FR;8;2021-02-27;0;0;0;0;0;0;0;0;0;0;0;0;0;0;0;0;0;0
FR;8;2021-02-28;0;0;0;0;0;0;0;0;0;0;0;0;0;0;0;0;0;0
FR;8;2021-03-01;0;0;0;0;0;0;0;0;0;0;0;0;0;0;0;0;0;0
FR;8;2021-03-02;0;0;0;0;0;0;0;0;0;0;0;0;0;0;0;0;0;0
FR;8;2021-03-03;0;0;0;0;0;0;0;0;0;0;0;0;0;0;0;0;0;0
FR;8;2021-03-04;0;0;0;0;0;0;0;0;0;0;0;0;0;0;0;0;0;0
FR;8;2021-03-05;0;0;0;0;0;0;0;0;0;0;0;0;0;0;0;0;0;0
FR;8;2021-03-06;0;0;0;0;0;0;0;0;0;0;0;0;0;0;0;0;0;0
FR;8;2021-03-07;0;0;0;0;0;0;0;0;0;0;0;0;0;0;0;0;0;0
FR;8;2021-03-08;0;0;0;0;0;0;0;0;0;0;0;0;0;0;0;0;0;0
FR;8;2021-03-09;0;0;0;0;0;0;0;0;0;0;0;0;0;0;0;0;0;0
FR;8;2021-03-10;0;0;0;0;0;0;0;0;0;0;0;0;0;0;0;0;0;0
FR;8;2021-03-11;0;0;0;0;0;0;0;0;0;0;0;0;0;0;0;0;0;0
FR;8;2021-03-12;0;0;0;0;0;0;0;0;0;0;0;0;0;0;0;0;0;0
FR;8;2021-03-13;0;0;0;0;0;0;0;0;0;0;0;0;0;0;0;0;0;0
FR;8;2021-03-14;0;0;0;0;0;0;0;0;0;0;0;0;0;0;0;0;0;0
FR;8;2021-03-15;0;0;0;0;0;0;0;0;0;0;0;0;0;0;0;0;0;0
FR;8;2021-03-16;0;0;0;0;0;0;0;0;0;0;0;0;0;0;0;0;0;0
FR;8;2021-03-17;0;0;0;0;0;0;0;0;0;0;0;0;0;0;0;0;0;0
FR;8;2021-03-18;0;0;0;0;0;0;0;0;0;0;0;0;0;0;0;0;0;0
FR;8;2021-03-19;0;0;0;0;0;0;0;0;0;0;0;0;0;0;0;0;0;0
FR;8;2021-03-20;0;0;0;0;0;0;0;0;0;0;0;0;0;0;0;0;0;0
FR;8;2021-03-21;0;0;0;0;0;0;0;0;0;0;0;0;0;0;0;0;0;0
FR;8;2021-03-22;0;0;0;0;0;0;0;0;0;0;0;0;0;0;0;0;0;0
FR;8;2021-03-23;0;0;0;0;0;0;0;0;0;0;0;0;0;0;0;0;0;0
FR;8;2021-03-24;0;0;0;0;0;0;0;0;0;0;0;0;0;0;0;0;0;0
FR;8;2021-03-25;0;0;0;0;0;0;0;0;0;0;0;0;0;0;0;0;0;0
FR;8;2021-03-26;0;0;0;0;0;0;0;0;0;0;0;0;0;0;0;0;0;0
FR;8;2021-03-27;0;0;0;0;0;0;0;0;0;0;0;0;0;0;0;0;0;0
FR;8;2021-03-28;0;0;0;0;0;0;0;0;0;0;0;0;0;0;0;0;0;0
FR;8;2021-03-29;0;0;0;0;0;0;0;0;0;0;0;0;0;0;0;0;0;0
FR;8;2021-03-30;0;0;0;0;0;0;0;0;0;0;0;0;0;0;0;0;0;0
FR;8;2021-03-31;0;0;0;0;0;0;0;0;0;0;0;0;0;0;0;0;0;0
FR;8;2021-04-01;0;0;0;0;0;0;0;0;0;0;0;0;0;0;0;0;0;0
FR;8;2021-04-02;0;0;0;0;0;0;0;0;0;0;0;0;0;0;0;0;0;0
FR;8;2021-04-03;0;0;0;0;0;0;0;0;0;0;0;0;0;0;0;0;0;0
FR;8;2021-04-04;0;0;0;0;0;0;0;0;0;0;0;0;0;0;0;0;0;0
FR;8;2021-04-05;0;0;0;0;0;0;0;0;0;0;0;0;0;0;0;0;0;0
FR;8;2021-04-06;0;0;0;0;0;0;0;0;0;0;0;0;0;0;0;0;0;0
FR;8;2021-04-07;0;0;0;0;0;0;0;0;0;0;0;0;0;0;0;0;0;0
FR;8;2021-04-08;0;0;0;0;0;0;0;0;0;0;0;0;0;0;0;0;0;0
FR;8;2021-04-09;0;0;0;0;0;0;0;0;0;0;0;0;0;0;0;0;0;0
FR;8;2021-04-10;0;0;0;0;0;0;0;0;0;0;0;0;0;0;0;0;0;0
FR;8;2021-04-11;0;0;0;0;0;0;0;0;0;0;0;0;0;0;0;0;0;0
FR;8;2021-04-12;0;0;0;0;0;0;0;0;0;0;0;0;0;0;0;0;0;0
FR;8;2021-04-13;0;0;0;0;0;0;0;0;0;0;0;0;0;0;0;0;0;0
FR;8;2021-04-14;0;0;0;0;0;0;0;0;0;0;0;0;0;0;0;0;0;0
FR;8;2021-04-15;0;0;0;0;0;0;0;0;0;0;0;0;0;0;0;0;0;0
FR;8;2021-04-16;0;0;0;0;0;0;0;0;0;0;0;0;0;0;0;0;0;0
FR;8;2021-04-17;0;0;0;0;0;0;0;0;0;0;0;0;0;0;0;0;0;0
FR;8;2021-04-18;0;0;0;0;0;0;0;0;0;0;0;0;0;0;0;0;0;0
FR;8;2021-04-19;0;0;0;0;0;0;0;0;0;0;0;0;0;0;0;0;0;0
FR;8;2021-04-20;0;0;0;0;0;0;0;0;0;0;0;0;0;0;0;0;0;0
FR;8;2021-04-21;0;0;0;0;0;0;0;0;0;0;0;0;0;0;0;0;0;0
FR;8;2021-04-22;0;0;0;0;0;0;0;0;0;0;0;0;0;0;0;0;0;0
FR;8;2021-04-23;0;0;0;0;0;0;0;0;0;0;0;0;0;0;0;0;0;0
FR;8;2021-04-24;0;0;0;0;0;0;0;0;0;0;0;0;0;0;0;0;0;0
FR;8;2021-04-25;0;0;0;0;0;0;0;0;0;0;0;0;0;0;0;0;0;0
FR;8;2021-04-26;0;0;0;0;0;0;0;0;0;0;0;0;0;0;0;0;0;0
FR;8;2021-04-27;0;0;0;0;0;0;0;0;0;0;0;0;0;0;0;0;0;0
FR;8;2021-04-28;0;0;0;0;0;0;0;0;0;0;0;0;0;0;0;0;0;0
FR;8;2021-04-29;0;0;0;0;0;0;0;0;0;0;0;0;0;0;0;0;0;0
FR;8;2021-04-30;0;0;0;0;0;0;0;0;0;0;0;0;0;0;0;0;0;0
FR;8;2021-05-01;0;0;0;0;0;0;0;0;0;0;0;0;0;0;0;0;0;0
FR;8;2021-05-02;0;0;0;0;0;0;0;0;0;0;0;0;0;0;0;0;0;0
FR;8;2021-05-03;0;0;0;0;0;0;0;0;0;0;0;0;0;0;0;0;0;0
FR;8;2021-05-04;0;0;0;0;0;0;0;0;0;0;0;0;0;0;0;0;0;0
FR;8;2021-05-05;0;0;0;0;0;0;0;0;0;0;0;0;0;0;0;0;0;0
FR;8;2021-05-06;0;0;0;0;0;0;0;0;0;0;0;0;0;0;0;0;0;0
FR;8;2021-05-07;0;0;0;0;0;0;0;0;0;0;0;0;0;0;0;0;0;0
FR;8;2021-05-08;0;0;0;0;0;0;0;0;0;0;0;0;0;0;0;0;0;0
FR;8;2021-05-09;0;0;0;0;0;0;0;0;0;0;0;0;0;0;0;0;0;0
FR;8;2021-05-10;0;0;0;0;0;0;0;0;0;0;0;0;0;0;0;0;0;0
FR;8;2021-05-11;0;0;0;0;0;0;0;0;0;0;0;0;0;0;0;0;0;0
FR;8;2021-05-12;0;0;0;0;0;0;0;0;0;0;0;0;0;0;0;0;0;0
FR;8;2021-05-13;0;0;0;0;0;0;0;0;0;0;0;0;0;0;0;0;0;0
FR;8;2021-05-14;0;0;0;0;0;0;0;0;0;0;0;0;0;0;0;0;0;0
FR;8;2021-05-15;0;0;0;0;0;0;0;0;0;0;0;0;0;0;0;0;0;0
FR;8;2021-05-16;0;0;0;0;0;0;0;0;0;0;0;0;0;0;0;0;0;0
FR;8;2021-05-17;0;0;0;0;0;0;0;0;0;0;0;0;0;0;0;0;0;0
FR;8;2021-05-18;0;0;0;0;0;0;0;0;0;0;0;0;0;0;0;0;0;0
FR;8;2021-05-19;0;0;0;0;0;0;0;0;0;0;0;0;0;0;0;0;0;0
FR;8;2021-05-20;0;0;0;0;0;0;0;0;0;0;0;0;0;0;0;0;0;0
FR;8;2021-05-21;0;0;0;0;0;0;0;0;0;0;0;0;0;0;0;0;0;0
FR;8;2021-05-22;0;0;0;0;0;0;0;0;0;0;0;0;0;0;0;0;0;0
FR;8;2021-05-23;0;0;0;0;0;0;0;0;0;0;0;0;0;0;0;0;0;0
FR;8;2021-05-24;0;0;0;0;0;0;0;0;0;0;0;0;0;0;0;0;0;0
FR;8;2021-05-25;0;0;0;0;0;0;0;0;0;0;0;0;0;0;0;0;0;0
FR;8;2021-05-26;0;0;0;0;0;0;0;0;0;0;0;0;0;0;0;0;0;0
FR;8;2021-05-27;0;0;0;0;0;0;0;0;0;0;0;0;0;0;0;0;0;0
FR;8;2021-05-28;0;0;0;0;0;0;0;0;0;0;0;0;0;0;0;0;0;0
FR;8;2021-05-29;0;0;0;0;0;0;0;0;0;0;0;0;0;0;0;0;0;0
FR;8;2021-05-30;0;0;0;0;0;0;0;0;0;0;0;0;0;0;0;0;0;0
FR;8;2021-05-31;0;0;0;0;0;0;0;0;0;0;0;0;0;0;0;0;0;0
FR;8;2021-06-01;0;0;0;0;0;0;0;0;0;0;0;0;0;0;0;0;0;0
FR;8;2021-06-02;0;0;0;0;0;0;0;0;0;0;0;0;0;0;0;0;0;0
FR;8;2021-06-03;0;0;0;0;0;0;0;0;0;0;0;0;0;0;0;0;0;0
FR;8;2021-06-04;0;0;0;0;0;0;0;0;0;0;0;0;0;0;0;0;0;0
FR;8;2021-06-05;0;0;0;0;0;0;0;0;0;0;0;0;0;0;0;0;0;0
FR;8;2021-06-06;0;0;0;0;0;0;0;0;0;0;0;0;0;0;0;0;0;0
FR;8;2021-06-07;0;0;0;0;0;0;0;0;0;0;0;0;0;0;0;0;0;0
FR;8;2021-06-08;0;0;0;0;0;0;0;0;0;0;0;0;0;0;0;0;0;0
FR;8;2021-06-09;0;0;0;0;0;0;0;0;0;0;0;0;0;0;0;0;0;0
FR;8;2021-06-10;0;0;0;0;0;0;0;0;0;0;0;0;0;0;0;0;0;0
FR;8;2021-06-11;0;0;0;0;0;0;0;0;0;0;0;0;0;0;0;0;0;0
FR;8;2021-06-12;0;0;0;0;0;0;0;0;0;0;0;0;0;0;0;0;0;0
FR;8;2021-06-13;0;0;0;0;0;0;0;0;0;0;0;0;0;0;0;0;0;0
FR;8;2021-06-14;0;0;0;0;0;0;0;0;0;0;0;0;0;0;0;0;0;0
FR;8;2021-06-15;0;0;0;0;0;0;0;0;0;0;0;0;0;0;0;0;0;0
FR;8;2021-06-16;0;0;0;0;0;0;0;0;0;0;0;0;0;0;0;0;0;0
FR;8;2021-06-17;0;0;0;0;0;0;0;0;0;0;0;0;0;0;0;0;0;0
FR;8;2021-06-18;0;0;0;0;0;0;0;0;0;0;0;0;0;0;0;0;0;0
FR;8;2021-06-19;0;0;0;0;0;0;0;0;0;0;0;0;0;0;0;0;0;0
FR;8;2021-06-20;0;0;0;0;0;0;0;0;0;0;0;0;0;0;0;0;0;0
FR;8;2021-06-21;0;0;0;0;0;0;0;0;0;0;0;0;0;0;0;0;0;0
FR;8;2021-06-22;0;0;0;0;0;0;0;0;0;0;0;0;0;0;0;0;0;0
FR;8;2021-06-23;0;0;0;0;0;0;0;0;0;0;0;0;0;0;0;0;0;0
FR;8;2021-06-24;0;0;0;0;0;0;0;0;0;0;0;0;0;0;0;0;0;0
FR;8;2021-06-25;0;0;0;0;0;0;0;0;0;0;0;0;0;0;0;0;0;0
FR;8;2021-06-26;0;0;0;0;0;0;0;0;0;0;0;0;0;0;0;0;0;0
FR;8;2021-06-27;0;0;0;0;0;0;0;0;0;0;0;0;0;0;0;0;0;0
FR;8;2021-06-28;0;0;0;0;0;0;0;0;0;0;0;0;0;0;0;0;0;0
FR;8;2021-06-29;0;0;0;0;0;0;0;0;0;0;0;0;0;0;0;0;0;0
FR;8;2021-06-30;0;0;0;0;0;0;0;0;0;0;0;0;0;0;0;0;0;0
FR;8;2021-07-01;0;0;0;0;0;0;0;0;0;0;0;0;0;0;0;0;0;0
FR;8;2021-07-02;0;0;0;0;0;0;0;0;0;0;0;0;0;0;0;0;0;0
FR;8;2021-07-03;0;0;0;0;0;0;0;0;0;0;0;0;0;0;0;0;0;0
FR;8;2021-07-04;0;0;0;0;0;0;0;0;0;0;0;0;0;0;0;0;0;0
FR;8;2021-07-05;0;0;0;0;0;0;0;0;0;0;0;0;0;0;0;0;0;0
FR;8;2021-07-06;0;0;0;0;0;0;0;0;0;0;0;0;0;0;0;0;0;0
FR;8;2021-07-07;0;0;0;0;0;0;0;0;0;0;0;0;0;0;0;0;0;0
FR;8;2021-07-08;0;0;0;0;0;0;0;0;0;0;0;0;0;0;0;0;0;0
FR;8;2021-07-09;0;0;0;0;0;0;0;0;0;0;0;0;0;0;0;0;0;0
FR;8;2021-07-10;0;0;0;0;0;0;0;0;0;0;0;0;0;0;0;0;0;0
FR;8;2021-07-11;0;0;0;0;0;0;0;0;0;0;0;0;0;0;0;0;0;0
FR;8;2021-07-12;0;0;0;0;0;0;0;0;0;0;0;0;0;0;0;0;0;0
FR;8;2021-07-13;0;0;0;0;0;0;0;0;0;0;0;0;0;0;0;0;0;0
FR;8;2021-07-14;0;0;0;0;0;0;0;0;0;0;0;0;0;0;0;0;0;0
FR;8;2021-07-15;0;0;0;0;0;0;0;0;0;0;0;0;0;0;0;0;0;0
FR;8;2021-07-16;0;0;0;0;0;0;0;0;0;0;0;0;0;0;0;0;0;0
FR;8;2021-07-17;0;0;0;0;0;0;0;0;0;0;0;0;0;0;0;0;0;0
FR;8;2021-07-18;0;0;0;0;0;0;0;0;0;0;0;0;0;0;0;0;0;0
FR;8;2021-07-19;0;0;0;0;0;0;0;0;0;0;0;0;0;0;0;0;0;0
FR;8;2021-07-20;0;0;0;0;0;0;0;0;0;0;0;0;0;0;0;0;0;0
FR;8;2021-07-21;0;0;0;0;0;0;0;0;0;0;0;0;0;0;0;0;0;0
FR;8;2021-07-22;0;0;0;0;0;0;0;0;0;0;0;0;0;0;0;0;0;0
FR;8;2021-07-23;0;0;0;0;0;0;0;0;0;0;0;0;0;0;0;0;0;0
FR;8;2021-07-24;0;0;0;0;0;0;0;0;0;0;0;0;0;0;0;0;0;0
FR;8;2021-07-25;0;0;0;0;0;0;0;0;0;0;0;0;0;0;0;0;0;0
FR;8;2021-07-26;0;0;0;0;0;0;0;0;0;0;0;0;0;0;0;0;0;0
FR;8;2021-07-27;0;0;0;0;0;0;0;0;0;0;0;0;0;0;0;0;0;0
FR;8;2021-07-28;0;0;0;0;0;0;0;0;0;0;0;0;0;0;0;0;0;0
FR;8;2021-07-29;0;0;0;0;0;0;0;0;0;0;0;0;0;0;0;0;0;0
FR;8;2021-07-30;0;0;0;0;0;0;0;0;0;0;0;0;0;0;0;0;0;0
FR;8;2021-07-31;0;0;0;0;0;0;0;0;0;0;0;0;0;0;0;0;0;0
FR;8;2021-08-01;0;0;0;0;0;0;0;0;0;0;0;0;0;0;0;0;0;0
FR;8;2021-08-02;0;0;0;0;0;0;0;0;0;0;0;0;0;0;0;0;0;0
FR;8;2021-08-03;0;0;0;0;0;0;0;0;0;0;0;0;0;0;0;0;0;0
FR;8;2021-08-04;0;0;0;0;0;0;0;0;0;0;0;0;0;0;0;0;0;0
FR;8;2021-08-05;0;0;0;0;0;0;0;0;0;0;0;0;0;0;0;0;0;0
FR;8;2021-08-06;0;0;0;0;0;0;0;0;0;0;0;0;0;0;0;0;0;0
FR;8;2021-08-07;0;0;0;0;0;0;0;0;0;0;0;0;0;0;0;0;0;0
FR;8;2021-08-08;0;0;0;0;0;0;0;0;0;0;0;0;0;0;0;0;0;0
FR;8;2021-08-09;0;0;0;0;0;0;0;0;0;0;0;0;0;0;0;0;0;0
FR;8;2021-08-10;0;0;0;0;0;0;0;0;0;0;0;0;0;0;0;0;0;0
FR;8;2021-08-11;0;0;0;0;0;0;0;0;0;0;0;0;0;0;0;0;0;0
FR;8;2021-08-12;0;0;0;0;0;0;0;0;0;0;0;0;0;0;0;0;0;0
FR;8;2021-08-13;0;0;0;0;0;0;0;0;0;0;0;0;0;0;0;0;0;0
FR;8;2021-08-14;0;0;0;0;0;0;0;0;0;0;0;0;0;0;0;0;0;0
FR;8;2021-08-15;0;0;0;0;0;0;0;0;0;0;0;0;0;0;0;0;0;0
FR;8;2021-08-16;0;0;0;0;0;0;0;0;0;0;0;0;0;0;0;0;0;0
FR;8;2021-08-17;0;0;0;0;0;0;0;0;0;0;0;0;0;0;0;0;0;0
FR;8;2021-08-18;0;0;0;0;0;0;0;0;0;0;0;0;0;0;0;0;0;0
FR;8;2021-08-19;0;0;0;0;0;0;0;0;0;0;0;0;0;0;0;0;0;0
FR;8;2021-08-20;0;0;0;0;0;0;0;0;0;0;0;0;0;0;0;0;0;0
FR;8;2021-08-21;0;0;0;0;0;0;0;0;0;0;0;0;0;0;0;0;0;0
FR;8;2021-08-22;0;0;0;0;0;0;0;0;0;0;0;0;0;0;0;0;0;0
FR;8;2021-08-23;0;0;0;0;0;0;0;0;0;0;0;0;0;0;0;0;0;0
FR;8;2021-08-24;0;0;0;0;0;0;0;0;0;0;0;0;0;0;0;0;0;0
FR;8;2021-08-25;0;0;0;0;0;0;0;0;0;0;0;0;0;0;0;0;0;0
FR;8;2021-08-26;0;0;0;0;0;0;0;0;0;0;0;0;0;0;0;0;0;0
FR;8;2021-08-27;0;0;0;0;0;0;0;0;0;0;0;0;0;0;0;0;0;0
FR;8;2021-08-28;0;0;0;0;0;0;0;0;0;0;0;0;0;0;0;0;0;0
FR;8;2021-08-29;0;0;0;0;0;0;0;0;0;0;0;0;0;0;0;0;0;0
FR;8;2021-08-30;0;0;0;0;0;0;0;0;0;0;0;0;0;0;0;0;0;0
FR;8;2021-08-31;0;0;0;0;0;0;0;0;0;0;0;0;0;0;0;0;0;0
FR;8;2021-09-01;0;0;0;0;0;0;0;0;0;0;0;0;0;0;0;0;0;0
FR;8;2021-09-02;0;0;0;0;0;0;0;0;0;0;0;0;0;0;0;0;0;0
FR;8;2021-09-03;0;0;0;0;0;0;0;0;0;0;0;0;0;0;0;0;0;0
FR;8;2021-09-04;0;0;0;0;0;0;0;0;0;0;0;0;0;0;0;0;0;0
FR;8;2021-09-05;0;0;0;0;0;0;0;0;0;0;0;0;0;0;0;0;0;0
FR;8;2021-09-06;0;0;0;0;0;0;0;0;0;0;0;0;0;0;0;0;0;0
FR;8;2021-09-07;0;0;0;0;0;0;0;0;0;0;0;0;0;0;0;0;0;0
FR;8;2021-09-08;0;0;0;0;0;0;0;0;0;0;0;0;0;0;0;0;0;0
FR;8;2021-09-09;0;0;0;0;0;0;0;0;0;0;0;0;0;0;0;0;0;0
FR;8;2021-09-10;0;0;0;0;0;0;0;0;0;0;0;0;0;0;0;0;0;0
FR;8;2021-09-11;0;0;0;0;0;0;0;0;0;0;0;0;0;0;0;0;0;0
FR;8;2021-09-12;0;0;0;0;0;0;0;0;0;0;0;0;0;0;0;0;0;0
FR;8;2021-09-13;0;0;0;0;0;0;0;0;0;0;0;0;0;0;0;0;0;0
FR;8;2021-09-14;0;0;0;0;0;0;0;0;0;0;0;0;0;0;0;0;0;0
FR;8;2021-09-15;0;0;0;0;0;0;0;0;0;0;0;0;0;0;0;0;0;0
FR;8;2021-09-16;0;0;0;0;0;0;0;0;0;0;0;0;0;0;0;0;0;0
FR;8;2021-09-17;0;0;0;0;0;0;0;0;0;0;0;0;0;0;0;0;0;0
FR;8;2021-09-18;0;0;0;0;0;0;0;0;0;0;0;0;0;0;0;0;0;0
FR;8;2021-09-19;0;0;0;0;0;0;0;0;0;0;0;0;0;0;0;0;0;0
FR;8;2021-09-20;0;0;0;0;0;0;0;0;0;0;0;0;0;0;0;0;0;0
FR;8;2021-09-21;0;0;0;0;0;0;0;0;0;0;0;0;0;0;0;0;0;0
FR;8;2021-09-22;0;0;0;0;0;0;0;0;0;0;0;0;0;0;0;0;0;0
FR;8;2021-09-23;0;0;0;0;0;0;0;0;0;0;0;0;0;0;0;0;0;0
FR;8;2021-09-24;0;0;0;0;0;0;0;0;0;0;0;0;0;0;0;0;0;0
FR;8;2021-09-25;0;0;0;0;0;0;0;0;0;0;0;0;0;0;0;0;0;0
FR;8;2021-09-26;0;0;0;0;0;0;0;0;0;0;0;0;0;0;0;0;0;0
FR;8;2021-09-27;0;0;0;0;0;0;0;0;0;0;0;0;0;0;0;0;0;0
FR;8;2021-09-28;0;0;0;0;0;0;0;0;0;0;0;0;0;0;0;0;0;0
FR;8;2021-09-29;0;0;0;0;0;0;0;0;0;0;0;0;0;0;0;0;0;0
FR;8;2021-09-30;0;0;0;0;0;0;0;0;0;0;0;0;0;0;0;0;0;0
FR;8;2021-10-01;0;0;0;0;0;0;0;0;0;0;0;0;0;0;0;0;0;0
FR;8;2021-10-02;0;0;0;0;0;0;0;0;0;0;0;0;0;0;0;0;0;0
FR;8;2021-10-03;0;0;0;0;0;0;0;0;0;0;0;0;0;0;0;0;0;0
FR;8;2021-10-04;0;0;0;0;0;0;0;0;0;0;0;0;0;0;0;0;0;0
FR;8;2021-10-05;0;0;0;0;0;0;0;0;0;0;0;0;0;0;0;0;0;0
FR;8;2021-10-06;0;0;0;0;0;0;0;0;0;0;0;0;0;0;0;0;0;0
FR;8;2021-10-07;0;0;0;0;0;0;0;0;0;0;0;0;0;0;0;0;0;0
FR;8;2021-10-08;0;0;0;0;0;0;0;0;0;0;0;0;0;0;0;0;0;0
FR;8;2021-10-09;0;0;0;0;0;0;0;0;0;0;0;0;0;0;0;0;0;0
FR;8;2021-10-10;0;0;0;0;0;0;0;0;0;0;0;0;0;0;0;0;0;0
FR;8;2021-10-11;0;0;0;0;0;0;0;0;0;0;0;0;0;0;0;0;0;0
FR;8;2021-10-12;0;0;0;0;0;0;0;0;0;0;0;0;0;0;0;0;0;0
FR;8;2021-10-13;0;0;0;0;0;0;0;0;0;0;0;0;0;0;0;0;0;0
FR;8;2021-10-14;0;0;0;0;0;0;0;0;0;0;0;0;0;0;0;0;0;0
FR;8;2021-10-15;0;0;0;0;0;0;0;0;0;0;0;0;0;0;0;0;0;0
FR;8;2021-10-16;0;0;0;0;0;0;0;0;0;0;0;0;0;0;0;0;0;0
FR;8;2021-10-17;0;0;0;0;0;0;0;0;0;0;0;0;0;0;0;0;0;0
FR;8;2021-10-18;0;0;0;0;0;0;0;0;0;0;0;0;0;0;0;0;0;0
FR;8;2021-10-19;0;0;0;0;0;0;0;0;0;0;0;0;0;0;0;0;0;0
FR;8;2021-10-20;0;0;0;0;0;0;0;0;0;0;0;0;0;0;0;0;0;0
FR;8;2021-10-21;0;0;0;0;0;0;0;0;0;0;0;0;0;0;0;0;0;0
FR;8;2021-10-22;0;0;0;0;0;0;0;0;0;0;0;0;0;0;0;0;0;0
FR;8;2021-10-23;0;0;0;0;0;0;0;0;0;0;0;0;0;0;0;0;0;0
FR;8;2021-10-24;0;0;0;0;0;0;0;0;0;0;0;0;0;0;0;0;0;0
FR;8;2021-10-25;0;0;0;0;0;0;0;0;0;0;0;0;0;0;0;0;0;0
FR;8;2021-10-26;0;0;0;0;0;0;0;0;0;0;0;0;0;0;0;0;0;0
FR;8;2021-10-27;0;0;0;0;0;0;0;0;0;0;0;0;0;0;0;0;0;0
FR;8;2021-10-28;0;0;0;0;0;0;0;0;0;0;0;0;0;0;0;0;0;0
FR;8;2021-10-29;0;0;0;0;0;0;0;0;0;0;0;0;0;0;0;0;0;0
FR;8;2021-10-30;0;0;0;0;0;0;0;0;0;0;0;0;0;0;0;0;0;0
FR;8;2021-10-31;0;0;0;0;0;0;0;0;0;0;0;0;0;0;0;0;0;0
FR;8;2021-11-01;0;0;0;0;0;0;0;0;0;0;0;0;0;0;0;0;0;0
FR;8;2021-11-02;0;0;0;0;0;0;0;0;0;0;0;0;0;0;0;0;0;0
FR;8;2021-11-03;0;0;0;0;0;0;0;0;0;0;0;0;0;0;0;0;0;0
FR;8;2021-11-04;0;0;0;0;0;0;0;0;0;0;0;0;0;0;0;0;0;0
FR;8;2021-11-05;0;0;0;0;0;0;0;0;0;0;0;0;0;0;0;0;0;0
FR;8;2021-11-06;0;0;0;0;0;0;0;0;0;0;0;0;0;0;0;0;0;0
FR;8;2021-11-07;0;0;0;0;0;0;0;0;0;0;0;0;0;0;0;0;0;0
FR;8;2021-11-08;0;0;0;0;0;0;0;0;0;0;0;0;0;0;0;0;0;0
FR;8;2021-11-09;0;0;0;0;0;0;0;0;0;0;0;0;0;0;0;0;0;0
FR;8;2021-11-10;0;0;0;0;0;0;0;0;0;0;0;0;0;0;0;0;0;0
FR;8;2021-11-11;0;0;0;0;0;0;0;0;0;0;0;0;0;0;0;0;0;0
FR;8;2021-11-12;0;0;0;0;0;0;0;0;0;0;0;0;0;0;0;0;0;0
FR;8;2021-11-13;0;0;0;0;0;0;0;0;0;0;0;0;0;0;0;0;0;0
FR;8;2021-11-14;0;0;0;0;0;0;0;0;0;0;0;0;0;0;0;0;0;0
FR;8;2021-11-15;0;0;0;0;0;0;0;0;0;0;0;0;0;0;0;0;0;0
FR;8;2021-11-16;0;0;0;0;0;0;0;0;0;0;0;0;0;0;0;0;0;0
FR;8;2021-11-17;0;0;0;0;0;0;0;0;0;0;0;0;0;0;0;0;0;0
FR;8;2021-11-18;0;0;0;0;0;0;0;0;0;0;0;0;0;0;0;0;0;0
FR;8;2021-11-19;0;0;0;0;0;0;0;0;0;0;0;0;0;0;0;0;0;0
FR;8;2021-11-20;0;0;0;0;0;0;0;0;0;0;0;0;0;0;0;0;0;0
FR;8;2021-11-21;0;0;0;0;0;0;0;0;0;0;0;0;0;0;0;0;0;0
FR;8;2021-11-22;0;0;0;0;0;0;0;0;0;0;0;0;0;0;0;0;0;0
FR;8;2021-11-23;0;0;0;0;0;0;0;0;0;0;0;0;0;0;0;0;0;0
FR;8;2021-11-24;0;0;0;0;0;0;0;0;0;0;0;0;0;0;0;0;0;0
FR;8;2021-11-25;0;0;0;0;0;0;0;0;0;0;0;0;0;0;0;0;0;0
FR;8;2021-11-26;0;0;0;0;0;0;0;0;0;0;0;0;0;0;0;0;0;0
FR;8;2021-11-27;0;0;0;0;0;0;0;0;0;0;0;0;0;0;0;0;0;0
FR;8;2021-11-28;0;0;0;0;0;0;0;0;0;0;0;0;0;0;0;0;0;0
FR;8;2021-11-29;0;0;0;0;0;0;0;0;0;0;0;0;0;0;0;0;0;0
FR;8;2021-11-30;0;0;0;0;0;0;0;0;0;0;0;0;0;0;0;0;0;0
FR;8;2021-12-01;0;0;0;0;0;0;0;0;0;0;0;0;0;0;0;0;0;0
FR;8;2021-12-02;0;0;0;0;0;0;0;0;0;0;0;0;0;0;0;0;0;0
FR;8;2021-12-03;0;0;0;0;0;0;0;0;0;0;0;0;0;0;0;0;0;0
FR;8;2021-12-04;0;0;0;0;0;0;0;0;0;0;0;0;0;0;0;0;0;0
FR;8;2021-12-05;0;0;0;0;0;0;0;0;0;0;0;0;0;0;0;0;0;0
FR;8;2021-12-06;0;0;0;0;0;0;0;0;0;0;0;0;0;0;0;0;0;0
FR;8;2021-12-07;0;0;0;0;0;0;0;0;0;0;0;0;0;0;0;0;0;0
FR;8;2021-12-08;0;0;0;0;0;0;0;0;0;0;0;0;0;0;0;0;0;0
FR;8;2021-12-09;0;0;0;0;0;0;0;0;0;0;0;0;0;0;0;0;0;0
FR;8;2021-12-10;0;0;0;0;0;0;0;0;0;0;0;0;0;0;0;0;0;0
FR;8;2021-12-11;0;0;0;0;0;0;0;0;0;0;0;0;0;0;0;0;0;0
FR;8;2021-12-12;0;0;0;0;0;0;0;0;0;0;0;0;0;0;0;0;0;0
FR;8;2021-12-13;0;0;0;0;0;0;0;0;0;0;0;0;0;0;0;0;0;0
FR;8;2021-12-14;0;0;0;0;0;0;0;0;0;0;0;0;0;0;0;0;0;0
FR;8;2021-12-15;0;0;0;0;0;0;0;0;0;0;0;0;0;0;0;0;0;0
FR;8;2021-12-16;0;0;0;0;0;0;0;0;0;0;0;0;0;0;0;0;0;0
FR;8;2021-12-17;0;0;0;0;0;0;0;0;0;0;0;0;0;0;0;0;0;0
FR;8;2021-12-18;0;0;0;0;0;0;0;0;0;0;0;0;0;0;0;0;0;0
FR;8;2021-12-19;0;0;0;0;0;0;0;0;0;0;0;0;0;0;0;0;0;0
FR;8;2021-12-20;0;0;0;0;0;0;0;0;0;0;0;0;0;0;0;0;0;0
FR;8;2021-12-21;0;0;0;0;0;0;0;0;0;0;0;0;0;0;0;0;0;0
FR;8;2021-12-22;0;0;0;0;0;0;0;0;0;0;0;0;0;0;0;0;0;0
FR;8;2021-12-23;0;0;0;0;0;0;0;0;0;0;0;0;0;0;0;0;0;0
FR;8;2021-12-24;0;0;0;0;0;0;0;0;0;0;0;0;0;0;0;0;0;0
FR;8;2021-12-25;0;0;0;0;0;0;0;0;0;0;0;0;0;0;0;0;0;0
FR;8;2021-12-26;0;0;0;0;0;0;0;0;0;0;0;0;0;0;0;0;0;0
FR;8;2021-12-27;0;0;0;0;0;0;0;0;0;0;0;0;0;0;0;0;0;0
FR;8;2021-12-28;0;0;0;0;0;0;0;0;0;0;0;0;0;0;0;0;0;0
FR;8;2021-12-29;0;0;0;0;0;0;0;0;0;0;0;0;0;0;0;0;0;0
FR;8;2021-12-30;0;0;0;0;0;0;0;0;0;0;0;0;0;0;0;0;0;0
FR;8;2021-12-31;0;0;0;0;0;0;0;0;0;0;0;0;0;0;0;0;0;0
FR;8;2022-01-01;0;0;0;0;0;0;0;0;0;0;0;0;0;0;0;0;0;0
FR;8;2022-01-02;0;0;0;0;0;0;0;0;0;0;0;0;0;0;0;0;0;0
FR;8;2022-01-03;0;0;0;0;0;0;0;0;0;0;0;0;0;0;0;0;0;0
FR;8;2022-01-04;0;0;0;0;0;0;0;0;0;0;0;0;0;0;0;0;0;0
FR;8;2022-01-05;0;0;0;0;0;0;0;0;0;0;0;0;0;0;0;0;0;0
FR;8;2022-01-06;0;0;0;0;0;0;0;0;0;0;0;0;0;0;0;0;0;0
FR;8;2022-01-07;0;0;0;0;0;0;0;0;0;0;0;0;0;0;0;0;0;0
FR;8;2022-01-08;0;0;0;0;0;0;0;0;0;0;0;0;0;0;0;0;0;0
FR;8;2022-01-09;0;0;0;0;0;0;0;0;0;0;0;0;0;0;0;0;0;0
FR;8;2022-01-10;0;0;0;0;0;0;0;0;0;0;0;0;0;0;0;0;0;0
FR;8;2022-01-11;0;0;0;0;0;0;0;0;0;0;0;0;0;0;0;0;0;0
FR;8;2022-01-12;0;0;0;0;0;0;0;0;0;0;0;0;0;0;0;0;0;0
FR;8;2022-01-13;0;0;0;0;0;0;0;0;0;0;0;0;0;0;0;0;0;0
FR;8;2022-01-14;0;0;0;0;0;0;0;0;0;0;0;0;0;0;0;0;0;0
FR;8;2022-01-15;0;0;0;0;0;0;0;0;0;0;0;0;0;0;0;0;0;0
FR;8;2022-01-16;0;0;0;0;0;0;0;0;0;0;0;0;0;0;0;0;0;0
FR;8;2022-01-17;0;0;0;0;0;0;0;0;0;0;0;0;0;0;0;0;0;0
FR;8;2022-01-18;0;0;0;0;0;0;0;0;0;0;0;0;0;0;0;0;0;0
FR;8;2022-01-19;0;0;0;0;0;0;0;0;0;0;0;0;0;0;0;0;0;0
FR;8;2022-01-20;0;0;0;0;0;0;0;0;0;0;0;0;0;0;0;0;0;0
FR;8;2022-01-21;0;0;0;0;0;0;0;0;0;0;0;0;0;0;0;0;0;0
FR;8;2022-01-22;0;0;0;0;0;0;0;0;0;0;0;0;0;0;0;0;0;0
FR;8;2022-01-23;0;0;0;0;0;0;0;0;0;0;0;0;0;0;0;0;0;0
FR;8;2022-01-24;0;0;0;0;0;0;0;0;0;0;0;0;0;0;0;0;0;0
FR;8;2022-01-25;0;0;0;0;0;0;0;0;0;0;0;0;0;0;0;0;0;0
FR;8;2022-01-26;0;0;0;0;0;0;0;0;0;0;0;0;0;0;0;0;0;0
FR;8;2022-01-27;0;0;0;0;0;0;0;0;0;0;0;0;0;0;0;0;0;0
FR;8;2022-01-28;0;0;0;0;0;0;0;0;0;0;0;0;0;0;0;0;0;0
FR;8;2022-01-29;0;0;0;0;0;0;0;0;0;0;0;0;0;0;0;0;0;0
FR;8;2022-01-30;0;0;0;0;0;0;0;0;0;0;0;0;0;0;0;0;0;0
FR;8;2022-01-31;0;0;0;0;0;0;0;0;0;0;0;0;0;0;0;0;0;0
FR;8;2022-02-01;0;0;0;0;0;0;0;0;0;0;0;0;0;0;0;0;0;0
FR;8;2022-02-02;0;0;0;0;0;0;0;0;0;0;0;0;0;0;0;0;0;0
FR;8;2022-02-03;0;0;0;0;0;0;0;0;0;0;0;0;0;0;0;0;0;0
FR;8;2022-02-04;0;0;0;0;0;0;0;0;0;0;0;0;0;0;0;0;0;0
FR;8;2022-02-05;0;0;0;0;0;0;0;0;0;0;0;0;0;0;0;0;0;0
FR;8;2022-02-06;0;0;0;0;0;0;0;0;0;0;0;0;0;0;0;0;0;0
FR;8;2022-02-07;0;0;0;0;0;0;0;0;0;0;0;0;0;0;0;0;0;0
FR;8;2022-02-08;0;0;0;0;0;0;0;0;0;0;0;0;0;0;0;0;0;0
FR;8;2022-02-09;0;0;0;0;0;0;0;0;0;0;0;0;0;0;0;0;0;0
FR;8;2022-02-10;0;0;0;0;0;0;0;0;0;0;0;0;0;0;0;0;0;0
FR;8;2022-02-11;0;0;0;0;0;0;0;0;0;0;0;0;0;0;0;0;0;0
FR;8;2022-02-12;0;0;0;0;0;0;0;0;0;0;0;0;0;0;0;0;0;0
FR;8;2022-02-13;0;0;0;0;0;0;0;0;0;0;0;0;0;0;0;0;0;0
FR;8;2022-02-14;0;0;0;0;0;0;0;0;0;0;0;0;0;0;0;0;0;0
FR;8;2022-02-15;0;0;0;0;0;0;0;0;0;0;0;0;0;0;0;0;0;0
FR;8;2022-02-16;0;0;0;0;0;0;0;0;0;0;0;0;0;0;0;0;0;0
FR;8;2022-02-17;0;0;0;0;0;0;0;0;0;0;0;0;0;0;0;0;0;0
FR;8;2022-02-18;0;0;0;0;0;0;0;0;0;0;0;0;0;0;0;0;0;0
FR;8;2022-02-19;0;0;0;0;0;0;0;0;0;0;0;0;0;0;0;0;0;0
FR;8;2022-02-20;0;0;0;0;0;0;0;0;0;0;0;0;0;0;0;0;0;0
FR;8;2022-02-21;0;0;0;0;0;0;0;0;0;0;0;0;0;0;0;0;0;0
FR;8;2022-02-22;0;0;0;0;0;0;0;0;0;0;0;0;0;0;0;0;0;0
FR;8;2022-02-23;0;0;0;0;0;0;0;0;0;0;0;0;0;0;0;0;0;0
FR;8;2022-02-24;0;0;0;0;0;0;0;0;0;0;0;0;0;0;0;0;0;0
FR;8;2022-02-25;0;0;0;0;0;0;0;0;0;0;0;0;0;0;0;0;0;0
FR;8;2022-02-26;0;0;0;0;0;0;0;0;0;0;0;0;0;0;0;0;0;0
FR;8;2022-02-27;0;0;0;0;0;0;0;0;0;0;0;0;0;0;0;0;0;0
FR;8;2022-02-28;0;0;0;0;0;0;0;0;0;0;0;0;0;0;0;0;0;0
FR;8;2022-03-01;0;0;0;0;0;0;0;0;0;0;0;0;0;0;0;0;0;0
FR;8;2022-03-02;0;0;0;0;0;0;0;0;0;0;0;0;0;0;0;0;0;0
FR;8;2022-03-03;0;0;0;0;0;0;0;0;0;0;0;0;0;0;0;0;0;0
FR;8;2022-03-04;0;0;0;0;0;0;0;0;0;0;0;0;0;0;0;0;0;0
FR;8;2022-03-05;0;0;0;0;0;0;0;0;0;0;0;0;0;0;0;0;0;0
FR;8;2022-03-06;0;0;0;0;0;0;0;0;0;0;0;0;0;0;0;0;0;0
FR;8;2022-03-07;0;0;0;0;0;0;0;0;0;0;0;0;0;0;0;0;0;0
FR;8;2022-03-08;0;0;0;0;0;0;0;0;0;0;0;0;0;0;0;0;0;0
FR;8;2022-03-09;0;0;0;0;0;0;0;0;0;0;0;0;0;0;0;0;0;0
FR;8;2022-03-10;0;0;0;0;0;0;0;0;0;0;0;0;0;0;0;0;0;0
FR;8;2022-03-11;0;0;0;0;0;0;0;0;0;0;0;0;0;0;0;0;0;0
FR;8;2022-03-12;0;0;0;0;0;0;0;0;0;0;0;0;0;0;0;0;0;0
FR;8;2022-03-13;0;0;0;0;0;0;0;0;0;0;0;0;0;0;0;0;0;0
FR;8;2022-03-14;0;0;0;0;0;0;0;0;0;0;0;0;0;0;0;0;0;0
FR;8;2022-03-15;0;0;0;0;0;0;0;0;0;0;0;0;0;0;0;0;0;0
FR;8;2022-03-16;0;0;0;0;0;0;0;0;0;0;0;0;0;0;0;0;0;0
FR;8;2022-03-17;0;0;0;0;0;0;0;0;0;0;0;0;0;0;0;0;0;0
FR;8;2022-03-18;0;0;0;0;0;0;0;0;0;0;0;0;0;0;0;0;0;0
FR;8;2022-03-19;0;0;0;0;0;0;0;0;0;0;0;0;0;0;0;0;0;0
FR;8;2022-03-20;0;0;0;0;0;0;0;0;0;0;0;0;0;0;0;0;0;0
FR;8;2022-03-21;0;0;0;0;0;0;0;0;0;0;0;0;0;0;0;0;0;0
FR;8;2022-03-22;0;0;0;0;0;0;0;0;0;0;0;0;0;0;0;0;0;0
FR;8;2022-03-23;0;0;0;0;0;0;0;0;0;0;0;0;0;0;0;0;0;0
FR;8;2022-03-24;0;0;0;0;0;0;0;0;0;0;0;0;0;0;0;0;0;0
FR;8;2022-03-25;0;0;0;0;0;0;0;0;0;0;0;0;0;0;0;0;0;0
FR;8;2022-03-26;0;0;0;0;0;0;0;0;0;0;0;0;0;0;0;0;0;0
FR;8;2022-03-27;0;0;0;0;0;0;0;0;0;0;0;0;0;0;0;0;0;0
FR;8;2022-03-28;0;0;0;0;0;0;0;0;0;0;0;0;0;0;0;0;0;0
FR;8;2022-03-29;0;0;0;0;0;0;0;0;0;0;0;0;0;0;0;0;0;0
FR;8;2022-03-30;0;0;0;0;0;0;0;0;0;0;0;0;0;0;0;0;0;0
FR;8;2022-03-31;0;0;0;0;0;0;0;0;0;0;0;0;0;0;0;0;0;0
FR;8;2022-04-01;0;0;0;0;0;0;0;0;0;0;0;0;0;0;0;0;0;0
FR;8;2022-04-02;0;0;0;0;0;0;0;0;0;0;0;0;0;0;0;0;0;0
FR;8;2022-04-03;0;0;0;0;0;0;0;0;0;0;0;0;0;0;0;0;0;0
FR;8;2022-04-04;0;0;0;0;0;0;0;0;0;0;0;0;0;0;0;0;0;0
FR;8;2022-04-05;0;0;0;0;0;0;0;0;0;0;0;0;0;0;0;0;0;0
FR;8;2022-04-06;0;0;0;0;0;0;0;0;0;0;0;0;0;0;0;0;0;0
FR;8;2022-04-07;0;0;0;0;0;0;0;0;0;0;0;0;0;0;0;0;0;0
FR;8;2022-04-08;0;0;0;0;0;0;0;0;0;0;0;0;0;0;0;0;0;0
FR;8;2022-04-09;0;0;0;0;0;0;0;0;0;0;0;0;0;0;0;0;0;0
FR;8;2022-04-10;0;0;0;0;0;0;0;0;0;0;0;0;0;0;0;0;0;0
FR;8;2022-04-11;0;0;0;0;0;0;0;0;0;0;0;0;0;0;0;0;0;0
FR;8;2022-04-12;0;0;0;0;0;0;0;0;0;0;0;0;0;0;0;0;0;0
FR;8;2022-04-13;0;0;0;0;0;0;0;0;0;0;0;0;0;0;0;0;0;0
FR;8;2022-04-14;0;0;0;0;0;0;0;0;0;0;0;0;0;0;0;0;0;0
FR;8;2022-04-15;0;0;0;0;0;0;0;0;0;0;0;0;0;0;0;0;0;0
FR;8;2022-04-16;0;0;0;0;0;0;0;0;0;0;0;0;0;0;0;0;0;0
FR;8;2022-04-17;0;0;0;0;0;0;0;0;0;0;0;0;0;0;0;0;0;0
FR;8;2022-04-18;0;0;0;0;0;0;0;0;0;0;0;0;0;0;0;0;0;0
FR;8;2022-04-19;0;0;0;0;0;0;0;0;0;0;0;0;0;0;0;0;0;0
FR;8;2022-04-20;0;0;0;0;0;0;0;0;0;0;0;0;0;0;0;0;0;0
FR;8;2022-04-21;0;0;0;0;0;0;0;0;0;0;0;0;0;0;0;0;0;0
FR;8;2022-04-22;0;0;0;0;0;0;0;0;0;0;0;0;0;0;0;0;0;0
FR;8;2022-04-23;0;0;0;0;0;0;0;0;0;0;0;0;0;0;0;0;0;0
FR;8;2022-04-24;0;0;0;0;0;0;0;0;0;0;0;0;0;0;0;0;0;0
FR;8;2022-04-25;0;0;0;0;0;0;0;0;0;0;0;0;0;0;0;0;0;0
FR;8;2022-04-26;0;0;0;0;0;0;0;0;0;0;0;0;0;0;0;0;0;0
FR;8;2022-04-27;0;0;0;0;0;0;0;0;0;0;0;0;0;0;0;0;0;0
FR;8;2022-04-28;0;0;0;0;0;0;0;0;0;0;0;0;0;0;0;0;0;0
FR;8;2022-04-29;0;0;0;0;0;0;0;0;0;0;0;0;0;0;0;0;0;0
FR;8;2022-04-30;0;0;0;0;0;0;0;0;0;0;0;0;0;0;0;0;0;0
FR;8;2022-05-01;0;0;0;0;0;0;0;0;0;0;0;0;0;0;0;0;0;0
FR;8;2022-05-02;0;0;0;0;0;0;0;0;0;0;0;0;0;0;0;0;0;0
FR;8;2022-05-03;0;0;0;0;0;0;0;0;0;0;0;0;0;0;0;0;0;0
FR;8;2022-05-04;0;0;0;0;0;0;0;0;0;0;0;0;0;0;0;0;0;0
FR;8;2022-05-05;0;0;0;0;0;0;0;0;0;0;0;0;0;0;0;0;0;0
FR;8;2022-05-06;0;0;0;0;0;0;0;0;0;0;0;0;0;0;0;0;0;0
FR;8;2022-05-07;0;0;0;0;0;0;0;0;0;0;0;0;0;0;0;0;0;0
FR;8;2022-05-08;0;0;0;0;0;0;0;0;0;0;0;0;0;0;0;0;0;0
FR;8;2022-05-09;0;0;0;0;0;0;0;0;0;0;0;0;0;0;0;0;0;0
FR;8;2022-05-10;0;0;0;0;0;0;0;0;0;0;0;0;0;0;0;0;0;0
FR;8;2022-05-11;0;0;0;0;0;0;0;0;0;0;0;0;0;0;0;0;0;0
FR;8;2022-05-12;0;0;0;0;0;0;0;0;0;0;0;0;0;0;0;0;0;0
FR;8;2022-05-13;0;0;0;0;0;0;0;0;0;0;0;0;0;0;0;0;0;0
FR;8;2022-05-14;0;0;0;0;0;0;0;0;0;0;0;0;0;0;0;0;0;0
FR;8;2022-05-15;0;0;0;0;0;0;0;0;0;0;0;0;0;0;0;0;0;0
FR;8;2022-05-16;0;0;0;0;0;0;0;0;0;0;0;0;0;0;0;0;0;0
FR;8;2022-05-17;0;0;0;0;0;0;0;0;0;0;0;0;0;0;0;0;0;0
FR;8;2022-05-18;0;0;0;0;0;0;0;0;0;0;0;0;0;0;0;0;0;0
FR;8;2022-05-19;0;0;0;0;0;0;0;0;0;0;0;0;0;0;0;0;0;0
FR;8;2022-05-20;0;0;0;0;0;0;0;0;0;0;0;0;0;0;0;0;0;0
FR;8;2022-05-21;0;0;0;0;0;0;0;0;0;0;0;0;0;0;0;0;0;0
FR;8;2022-05-22;0;0;0;0;0;0;0;0;0;0;0;0;0;0;0;0;0;0
FR;8;2022-05-23;0;0;0;0;0;0;0;0;0;0;0;0;0;0;0;0;0;0
FR;8;2022-05-24;0;0;0;0;0;0;0;0;0;0;0;0;0;0;0;0;0;0
FR;8;2022-05-25;0;0;0;0;0;0;0;0;0;0;0;0;0;0;0;0;0;0
FR;8;2022-05-26;0;0;0;0;0;0;0;0;0;0;0;0;0;0;0;0;0;0
FR;8;2022-05-27;0;0;0;0;0;0;0;0;0;0;0;0;0;0;0;0;0;0
FR;8;2022-05-28;0;0;0;0;0;0;0;0;0;0;0;0;0;0;0;0;0;0
FR;8;2022-05-29;0;0;0;0;0;0;0;0;0;0;0;0;0;0;0;0;0;0
FR;8;2022-05-30;0;0;0;0;0;0;0;0;0;0;0;0;0;0;0;0;0;0
FR;8;2022-05-31;0;0;0;0;0;0;0;0;0;0;0;0;0;0;0;0;0;0
FR;8;2022-06-01;0;0;0;0;0;0;0;0;0;0;0;0;0;0;0;0;0;0
FR;8;2022-06-02;0;0;0;0;0;0;0;0;0;0;0;0;0;0;0;0;0;0
FR;8;2022-06-03;0;0;0;0;0;0;0;0;0;0;0;0;0;0;0;0;0;0
FR;8;2022-06-04;0;0;0;0;0;0;0;0;0;0;0;0;0;0;0;0;0;0
FR;8;2022-06-05;0;0;0;0;0;0;0;0;0;0;0;0;0;0;0;0;0;0
FR;8;2022-06-06;0;0;0;0;0;0;0;0;0;0;0;0;0;0;0;0;0;0
FR;8;2022-06-07;0;0;0;0;0;0;0;0;0;0;0;0;0;0;0;0;0;0
FR;8;2022-06-08;0;0;0;0;0;0;0;0;0;0;0;0;0;0;0;0;0;0
FR;8;2022-06-09;0;0;0;0;0;0;0;0;0;0;0;0;0;0;0;0;0;0
FR;8;2022-06-10;0;0;0;0;0;0;0;0;0;0;0;0;0;0;0;0;0;0
FR;8;2022-06-11;0;0;0;0;0;0;0;0;0;0;0;0;0;0;0;0;0;0
FR;8;2022-06-12;0;0;0;0;0;0;0;0;0;0;0;0;0;0;0;0;0;0
FR;8;2022-06-13;0;0;0;0;0;0;0;0;0;0;0;0;0;0;0;0;0;0
FR;8;2022-06-14;0;0;0;0;0;0;0;0;0;0;0;0;0;0;0;0;0;0
FR;8;2022-06-15;0;0;0;0;0;0;0;0;0;0;0;0;0;0;0;0;0;0
FR;8;2022-06-16;0;0;0;0;0;0;0;0;0;0;0;0;0;0;0;0;0;0
FR;8;2022-06-17;0;0;0;0;0;0;0;0;0;0;0;0;0;0;0;0;0;0
FR;8;2022-06-18;0;0;0;0;0;0;0;0;0;0;0;0;0;0;0;0;0;0
FR;8;2022-06-19;0;0;0;0;0;0;0;0;0;0;0;0;0;0;0;0;0;0
FR;8;2022-06-20;0;0;0;0;0;0;0;0;0;0;0;0;0;0;0;0;0;0
FR;8;2022-06-21;0;0;0;0;0;0;0;0;0;0;0;0;0;0;0;0;0;0
FR;8;2022-06-22;0;0;0;0;0;0;0;0;0;0;0;0;0;0;0;0;0;0
FR;8;2022-06-23;0;0;0;0;0;0;0;0;0;0;0;0;0;0;0;0;0;0
FR;8;2022-06-24;0;0;0;0;0;0;0;0;0;0;0;0;0;0;0;0;0;0
FR;8;2022-06-25;0;0;0;0;0;0;0;0;0;0;0;0;0;0;0;0;0;0
FR;8;2022-06-26;0;0;0;0;0;0;0;0;0;0;0;0;0;0;0;0;0;0
FR;8;2022-06-27;0;0;0;0;0;0;0;0;0;0;0;0;0;0;0;0;0;0
FR;8;2022-06-28;0;0;0;0;0;0;0;0;0;0;0;0;0;0;0;0;0;0
FR;8;2022-06-29;0;0;0;0;0;0;0;0;0;0;0;0;0;0;0;0;0;0
FR;8;2022-06-30;0;0;0;0;0;0;0;0;0;0;0;0;0;0;0;0;0;0
FR;8;2022-07-01;0;0;0;0;0;0;0;0;0;0;0;0;0;0;0;0;0;0
FR;8;2022-07-02;0;0;0;0;0;0;0;0;0;0;0;0;0;0;0;0;0;0
FR;8;2022-07-03;0;0;0;0;0;0;0;0;0;0;0;0;0;0;0;0;0;0
FR;8;2022-07-04;0;0;0;0;0;0;0;0;0;0;0;0;0;0;0;0;0;0
FR;8;2022-07-05;0;0;0;0;0;0;0;0;0;0;0;0;0;0;0;0;0;0
FR;8;2022-07-06;0;0;0;0;0;0;0;0;0;0;0;0;0;0;0;0;0;0
FR;8;2022-07-07;0;0;0;0;0;0;0;0;0;0;0;0;0;0;0;0;0;0
FR;8;2022-07-08;0;0;0;0;0;0;0;0;0;0;0;0;0;0;0;0;0;0
FR;8;2022-07-09;0;0;0;0;0;0;0;0;0;0;0;0;0;0;0;0;0;0
FR;8;2022-07-10;0;0;0;0;0;0;0;0;0;0;0;0;0;0;0;0;0;0
FR;8;2022-07-11;0;0;0;0;0;0;0;0;0;0;0;0;0;0;0;0;0;0
FR;8;2022-07-12;0;0;0;0;0;0;0;0;0;0;0;0;0;0;0;0;0;0
FR;8;2022-07-13;0;0;0;0;0;0;0;0;0;0;0;0;0;0;0;0;0;0
FR;8;2022-07-14;0;0;0;0;0;0;0;0;0;0;0;0;0;0;0;0;0;0
FR;8;2022-07-15;0;0;0;0;0;0;0;0;0;0;0;0;0;0;0;0;0;0
FR;8;2022-07-16;0;0;0;0;0;0;0;0;0;0;0;0;0;0;0;0;0;0
FR;8;2022-07-17;0;0;0;0;0;0;0;0;0;0;0;0;0;0;0;0;0;0
FR;8;2022-07-18;0;0;0;0;0;0;0;0;0;0;0;0;0;0;0;0;0;0
FR;8;2022-07-19;0;0;0;0;0;0;0;0;0;0;0;0;0;0;0;0;0;0
FR;8;2022-07-20;0;0;0;0;0;0;0;0;0;0;0;0;0;0;0;0;0;0
FR;8;2022-07-21;0;0;0;0;0;0;0;0;0;0;0;0;0;0;0;0;0;0
FR;8;2022-07-22;0;0;0;0;0;0;0;0;0;0;0;0;0;0;0;0;0;0
FR;8;2022-07-23;0;0;0;0;0;0;0;0;0;0;0;0;0;0;0;0;0;0
FR;8;2022-07-24;0;0;0;0;0;0;0;0;0;0;0;0;0;0;0;0;0;0
FR;8;2022-07-25;0;0;0;0;0;0;0;0;0;0;0;0;0;0;0;0;0;0
FR;8;2022-07-26;0;0;0;0;0;0;0;0;0;0;0;0;0;0;0;0;0;0
FR;8;2022-07-27;0;0;0;0;0;0;0;0;0;0;0;0;0;0;0;0;0;0
FR;8;2022-07-28;0;0;0;0;0;0;0;0;0;0;0;0;0;0;0;0;0;0
FR;8;2022-07-29;0;0;0;0;0;0;0;0;0;0;0;0;0;0;0;0;0;0
FR;8;2022-07-30;0;0;0;0;0;0;0;0;0;0;0;0;0;0;0;0;0;0
FR;8;2022-07-31;0;0;0;0;0;0;0;0;0;0;0;0;0;0;0;0;0;0
FR;8;2022-08-01;0;0;0;0;0;0;0;0;0;0;0;0;0;0;0;0;0;0
FR;8;2022-08-02;0;0;0;0;0;0;0;0;0;0;0;0;0;0;0;0;0;0
FR;8;2022-08-03;0;0;0;0;0;0;0;0;0;0;0;0;0;0;0;0;0;0
FR;8;2022-08-04;0;0;0;0;0;0;0;0;0;0;0;0;0;0;0;0;0;0
FR;8;2022-08-05;0;0;0;0;0;0;0;0;0;0;0;0;0;0;0;0;0;0
FR;8;2022-08-06;0;0;0;0;0;0;0;0;0;0;0;0;0;0;0;0;0;0
FR;8;2022-08-07;0;0;0;0;0;0;0;0;0;0;0;0;0;0;0;0;0;0
FR;8;2022-08-08;0;0;0;0;0;0;0;0;0;0;0;0;0;0;0;0;0;0
FR;8;2022-08-09;0;0;0;0;0;0;0;0;0;0;0;0;0;0;0;0;0;0
FR;8;2022-08-10;0;0;0;0;0;0;0;0;0;0;0;0;0;0;0;0;0;0
FR;8;2022-08-11;0;0;0;0;0;0;0;0;0;0;0;0;0;0;0;0;0;0
FR;8;2022-08-12;0;0;0;0;0;0;0;0;0;0;0;0;0;0;0;0;0;0
FR;8;2022-08-13;0;0;0;0;0;0;0;0;0;0;0;0;0;0;0;0;0;0
FR;8;2022-08-14;0;0;0;0;0;0;0;0;0;0;0;0;0;0;0;0;0;0
FR;8;2022-08-15;0;0;0;0;0;0;0;0;0;0;0;0;0;0;0;0;0;0
FR;8;2022-08-16;0;0;0;0;0;0;0;0;0;0;0;0;0;0;0;0;0;0
FR;8;2022-08-17;0;0;0;0;0;0;0;0;0;0;0;0;0;0;0;0;0;0
FR;8;2022-08-18;0;0;0;0;0;0;0;0;0;0;0;0;0;0;0;0;0;0
FR;8;2022-08-19;0;0;0;0;0;0;0;0;0;0;0;0;0;0;0;0;0;0
FR;8;2022-08-20;0;0;0;0;0;0;0;0;0;0;0;0;0;0;0;0;0;0
FR;8;2022-08-21;0;0;0;0;0;0;0;0;0;0;0;0;0;0;0;0;0;0
FR;8;2022-08-22;0;0;0;0;0;0;0;0;0;0;0;0;0;0;0;0;0;0
FR;8;2022-08-23;0;0;0;0;0;0;0;0;0;0;0;0;0;0;0;0;0;0
FR;8;2022-08-24;0;0;0;0;0;0;0;0;0;0;0;0;0;0;0;0;0;0
FR;8;2022-08-25;0;0;0;0;0;0;0;0;0;0;0;0;0;0;0;0;0;0
FR;8;2022-08-26;0;0;0;0;0;0;0;0;0;0;0;0;0;0;0;0;0;0
FR;8;2022-08-27;0;0;0;0;0;0;0;0;0;0;0;0;0;0;0;0;0;0
FR;8;2022-08-28;0;0;0;0;0;0;0;0;0;0;0;0;0;0;0;0;0;0
FR;8;2022-08-29;0;0;0;0;0;0;0;0;0;0;0;0;0;0;0;0;0;0
FR;8;2022-08-30;0;0;0;0;0;0;0;0;0;0;0;0;0;0;0;0;0;0
FR;8;2022-08-31;0;0;0;0;0;0;0;0;0;0;0;0;0;0;0;0;0;0
FR;8;2022-09-01;0;0;0;0;0;0;0;0;0;0;0;0;0;0;0;0;0;0
FR;8;2022-09-02;0;0;0;0;0;0;0;0;0;0;0;0;0;0;0;0;0;0
FR;8;2022-09-03;0;0;0;0;0;0;0;0;0;0;0;0;0;0;0;0;0;0
FR;8;2022-09-04;0;0;0;0;0;0;0;0;0;0;0;0;0;0;0;0;0;0
FR;8;2022-09-05;0;0;0;0;0;0;0;0;0;0;0;0;0;0;0;0;0;0
FR;8;2022-09-06;0;0;0;0;0;0;0;0;0;0;0;0;0;0;0;0;0;0
FR;8;2022-09-07;0;0;0;0;0;0;0;0;0;0;0;0;0;0;0;0;0;0
FR;8;2022-09-08;0;0;0;0;0;0;0;0;0;0;0;0;0;0;0;0;0;0
FR;8;2022-09-09;0;0;0;0;0;0;0;0;0;0;0;0;0;0;0;0;0;0
FR;8;2022-09-10;0;0;0;0;0;0;0;0;0;0;0;0;0;0;0;0;0;0
FR;8;2022-09-11;0;0;0;0;0;0;0;0;0;0;0;0;0;0;0;0;0;0
FR;8;2022-09-12;0;0;0;0;0;0;0;0;0;0;0;0;0;0;0;0;0;0
FR;8;2022-09-13;0;0;0;0;0;0;0;0;0;0;0;0;0;0;0;0;0;0
FR;8;2022-09-14;0;0;0;0;0;0;0;0;0;0;0;0;0;0;0;0;0;0
FR;8;2022-09-15;0;0;0;0;0;0;0;0;0;0;0;0;0;0;0;0;0;0
FR;8;2022-09-16;0;0;0;0;0;0;0;0;0;0;0;0;0;0;0;0;0;0
FR;8;2022-09-17;0;0;0;0;0;0;0;0;0;0;0;0;0;0;0;0;0;0
FR;8;2022-09-18;0;0;0;0;0;0;0;0;0;0;0;0;0;0;0;0;0;0
FR;8;2022-09-19;0;0;0;0;0;0;0;0;0;0;0;0;0;0;0;0;0;0
FR;8;2022-09-20;0;0;0;0;0;0;0;0;0;0;0;0;0;0;0;0;0;0
FR;8;2022-09-21;0;0;0;0;0;0;0;0;0;0;0;0;0;0;0;0;0;0
FR;8;2022-09-22;0;0;0;0;0;0;0;0;0;0;0;0;0;0;0;0;0;0
FR;8;2022-09-23;0;0;0;0;0;0;0;0;0;0;0;0;0;0;0;0;0;0
FR;8;2022-09-24;0;0;0;0;0;0;0;0;0;0;0;0;0;0;0;0;0;0
FR;8;2022-09-25;0;0;0;0;0;0;0;0;0;0;0;0;0;0;0;0;0;0
FR;8;2022-09-26;0;0;0;0;0;0;0;0;0;0;0;0;0;0;0;0;0;0
FR;8;2022-09-27;0;0;0;0;0;0;0;0;0;0;0;0;0;0;0;0;0;0
FR;8;2022-09-28;0;0;0;0;0;0;0;0;0;0;0;0;0;0;0;0;0;0
FR;8;2022-09-29;0;0;0;0;0;0;0;0;0;0;0;0;0;0;0;0;0;0
FR;8;2022-09-30;0;0;0;0;0;0;0;0;0;0;0;0;0;0;0;0;0;0
FR;8;2022-10-01;0;0;0;0;0;0;0;0;0;0;0;0;0;0;0;0;0;0
FR;8;2022-10-02;0;0;0;0;0;0;0;0;0;0;0;0;0;0;0;0;0;0
FR;8;2022-10-03;0;0;0;0;0;0;0;0;0;0;0;0;0;0;0;0;0;0
FR;8;2022-10-04;0;0;0;0;0;0;0;0;0;0;0;0;0;0;0;0;0;0
FR;8;2022-10-05;0;0;0;0;0;0;0;0;0;0;0;0;0;0;0;0;0;0
FR;8;2022-10-06;7;17;111;858;8;80;864;1054;110;7;17;111;858;8;80;864;1054;110
FR;8;2022-10-07;68;101;842;8007;62;699;8059;9836;1071;75;118;953;8865;70;779;8923;10890;1181
FR;8;2022-10-08;35;115;610;4053;50;516;4105;5305;675;110;233;1563;12918;120;1295;13028;16195;1856
FR;8;2022-10-09;17;22;145;885;13;132;913;1233;184;127;255;1708;13803;133;1427;13941;17428;2040
FR;8;2022-10-10;115;192;1341;12674;106;1025;12908;16166;2213;242;447;3049;26477;239;2452;26849;33594;4253
FR;8;2022-10-11;175;261;2474;26903;135;2009;27175;33927;4706;417;708;5523;53380;374;4461;54024;67521;8959
FR;8;2022-10-12;150;255;1829;18211;147;1441;18445;23441;3531;567;963;7352;71591;521;5902;72469;90962;12490
FR;8;2022-10-13;205;276;2505;28030;173;1899;28391;35524;5206;772;1239;9857;99621;694;7801;100860;126486;17696
FR;8;2022-10-14;254;419;3271;36220;242;2555;36647;45536;6292;1026;1658;13128;135841;936;10356;137507;172022;23988
FR;8;2022-10-15;102;181;1201;8800;78;1000;8929;11778;1829;1128;1839;14329;144641;1014;11356;146436;183800;25817
FR;8;2022-10-16;34;54;248;1520;26;215;1555;2175;400;1162;1893;14577;146161;1040;11571;147991;185975;26217
FR;8;2022-10-17;156;306;2097;21744;171;1622;22053;28225;4528;1318;2199;16674;167905;1211;13193;170044;214200;30745
FR;8;2022-10-18;267;347;3350;37801;224;2651;38182;50705;9800;1585;2546;20024;205706;1435;15844;208226;264905;40545
FR;8;2022-10-19;191;313;2625;28232;182;2178;28559;38580;7782;1776;2859;22649;233938;1617;18022;236785;303485;48327
FR;8;2022-10-20;251;363;3573;41109;222;2628;41741;55560;11106;2027;3222;26222;275047;1839;20650;278526;359045;59433
FR;8;2022-10-21;324;489;4446;49356;276;3459;49958;66210;12696;2351;3711;30668;324403;2115;24109;328484;425255;72129
FR;8;2022-10-22;122;168;1229;10658;110;925;10847;14731;2941;2473;3879;31897;335061;2225;25034;339331;439986;75070
FR;8;2022-10-23;48;53;266;1753;48;197;1832;2598;568;2521;3932;32163;336814;2273;25231;341163;442584;75638
FR;8;2022-10-24;229;311;2469;23988;172;2060;24297;33443;7036;2750;4243;34632;360802;2445;27291;365460;476027;82674
FR;8;2022-10-25;307;410;4074;43368;254;3130;43969;61160;13958;3057;4653;38706;404170;2699;30421;409429;537187;96632
FR;8;2022-10-26;223;338;2855;28578;181;2351;28895;41109;9776;3280;4991;41561;432748;2880;32772;438324;578296;106408
FR;8;2022-10-27;272;414;3316;36079;241;2624;36571;51038;11778;3552;5405;44877;468827;3121;35396;474895;629334;118186
FR;8;2022-10-28;327;460;3819;39306;255;2854;40050;54795;11823;3879;5865;48696;508133;3376;38250;514945;684129;130009
FR;8;2022-10-29;108;165;1071;8219;94;800;8363;11832;2652;3987;6030;49767;516352;3470;39050;523308;695961;132661
FR;8;2022-10-30;40;53;209;1332;38;180;1376;2044;484;4027;6083;49976;517684;3508;39230;524684;698005;133145
FR;8;2022-10-31;195;254;1658;14498;138;1271;14758;21067;5020;4222;6337;51634;532182;3646;40501;539442;719072;138165
FR;8;2022-11-01;24;39;132;939;21;165;956;1560;437;4246;6376;51766;533121;3667;40666;540398;720632;138602
FR;8;2022-11-02;192;368;2366;23224;202;1966;23604;34812;9175;4438;6744;54132;556345;3869;42632;564002;755444;147777
FR;8;2022-11-03;307;412;3461;36751;251;2586;37394;54238;14161;4745;7156;57593;593096;4120;45218;601396;809682;161938
FR;8;2022-11-04;350;493;3776;40154;257;2968;40677;57887;14131;5095;7649;61369;633250;4377;48186;642073;867569;176069
FR;8;2022-11-05;112;182;1097;8738;117;847;8892;12825;3051;5207;7831;62466;641988;4494;49033;650965;880394;179120
FR;8;2022-11-06;41;55;221;1388;35;205;1417;2203;571;5248;7886;62687;643376;4529;49238;652382;882597;179691
FR;8;2022-11-07;221;274;2302;24571;199;1776;25125;37103;10136;5469;8160;64989;667947;4728;51014;677507;919700;189827
FR;8;2022-11-08;335;497;4313;48227;296;3234;49181;71183;18606;5804;8657;69302;716174;5024;54248;726688;990883;208433
FR;8;2022-11-09;253;362;2842;29072;206;2228;29746;44163;12110;6057;9019;72144;745246;5230;56476;756434;1035046;220543
FR;8;2022-11-10;359;527;3930;40073;298;2999;40983;60106;15988;6416;9546;76074;785319;5528;59475;797417;1095152;236531
FR;8;2022-11-11;39;63;240;1462;30;203;1507;2638;915;6455;9609;76314;786781;5558;59678;798924;1097790;237446
FR;8;2022-11-12;84;165;881;6421;79;686;6625;9877;2547;6539;9774;77195;793202;5637;60364;805549;1107667;239993
FR;8;2022-11-13;35;54;210;1103;34;171;1151;1903;575;6574;9828;77405;794305;5671;60535;806700;1109570;240568
FR;8;2022-11-14;224;301;2216;22304;161;1704;22833;34745;10136;6798;10129;79621;816609;5832;62239;829533;1144315;250704
FR;8;2022-11-15;328;416;3729;42100;251;2822;43011;64214;18251;7126;10545;83350;858709;6083;65061;872544;1208529;268955
FR;8;2022-11-16;291;343;2582;26206;209;2128;26664;41202;12326;7417;10888;85932;884915;6292;67189;899208;1249731;281281
FR;8;2022-11-17;357;419;3348;36624;277;2585;37197;56000;16121;7774;11307;89280;921539;6569;69774;936405;1305731;297402
FR;8;2022-11-18;337;459;4037;42084;277;2952;42909;63149;17184;8111;11766;93317;963623;6846;72726;979314;1368880;314586
FR;8;2022-11-19;117;177;1195;8913;115;831;9098;13687;3722;8228;11943;94512;972536;6961;73557;988412;1382567;318308
FR;8;2022-11-20;33;48;256;1552;33;208;1622;2593;759;8261;11991;94768;974088;6994;73765;990034;1385160;319067
FR;8;2022-11-21;204;298;2043;19878;171;1557;20394;31592;9578;8465;12289;96811;993966;7165;75322;1010428;1416752;328645
FR;8;2022-11-22;328;399;3415;37197;240;2615;37707;57290;16857;8793;12688;100226;1031163;7405;77937;1048135;1474042;345502
FR;8;2022-11-23;219;309;2371;24161;171;1971;24593;38629;11988;9012;12997;102597;1055324;7576;79908;1072728;1512671;357490
FR;8;2022-11-24;338;368;3323;34571;224;2521;35204;54446;16625;9350;13365;105920;1089895;7800;82429;1107932;1567117;374115
FR;8;2022-11-25;305;411;3603;37465;271;2593;38272;57288;16300;9655;13776;109523;1127360;8071;85022;1146204;1624405;390415
FR;8;2022-11-26;164;194;1173;8771;126;896;8928;13610;3755;9819;13970;110696;1136131;8197;85918;1155132;1638015;394170
FR;8;2022-11-27;44;38;224;1537;34;177;1551;2453;715;9863;14008;110920;1137668;8231;86095;1156683;1640468;394885
FR;8;2022-11-28;173;291;2272;23107;163;1671;23729;36685;11207;10036;14299;113192;1160775;8394;87766;1180412;1677153;406092
FR;8;2022-11-29;284;415;3910;43623;209;2880;44286;68260;20973;10320;14714;117102;1204398;8603;90646;1224698;1745413;427065
FR;8;2022-11-30;275;394;3311;34563;211;2489;35296;54020;16119;10595;15108;120413;1238961;8814;93135;1259994;1799433;443184
FR;8;2022-12-01;312;445;4360;48699;254;2988;49498;76431;23785;10907;15553;124773;1287660;9068;96123;1309492;1875864;466969
FR;8;2022-12-02;383;501;5348;57827;286;3664;59002;88704;25852;11290;16054;130121;1345487;9354;99787;1368494;1964568;492821
FR;8;2022-12-03;171;211;1893;16713;105;1303;17124;25585;7126;11461;16265;132014;1362200;9459;101090;1385618;1990153;499947
FR;8;2022-12-04;54;87;479;4011;57;389;4076;6203;1726;11515;16352;132493;1366211;9516;101479;1389694;1996356;501673
FR;8;2022-12-05;265;384;3762;41912;237;2437;42824;65954;20549;11780;16736;136255;1408123;9753;103916;1432518;2062310;522222
FR;8;2022-12-06;404;523;6200;73381;280;4116;74805;116153;37000;12184;17259;142455;1481504;10033;108032;1507323;2178463;559222
FR;8;2022-12-07;331;408;4812;54289;241;3148;55333;86186;27515;12515;17667;147267;1535793;10274;111180;1562656;2264649;586737
FR;8;2022-12-08;421;502;6288;74157;269;4039;75694;117926;37949;12936;18169;153555;1609950;10543;115219;1638350;2382575;624686
FR;8;2022-12-09;526;580;7819;89377;332;5039;91110;139994;43588;13462;18749;161374;1699327;10875;120258;1729460;2522569;668274
FR;8;2022-12-10;248;283;3290;31155;152;2046;31989;47778;13656;13710;19032;164664;1730482;11027;122304;1761449;2570347;681930
FR;8;2022-12-11;85;91;911;7604;61;617;7848;11512;3027;13795;19123;165575;1738086;11088;122921;1769297;2581859;684957
FR;8;2022-12-12;328;421;5563;62365;223;3501;63816;99358;31859;14123;19544;171138;1800451;11311;126422;1833113;2681217;716816
FR;8;2022-12-13;462;538;7944;95076;302;4826;97353;152704;50226;14585;20082;179082;1895527;11613;131248;1930466;2833921;767042
FR;9;2020-12-27;0;0;0;0;0;0;0;0;0;0;0;0;0;0;0;0;0;0
FR;9;2020-12-28;0;0;0;0;0;0;0;0;0;0;0;0;0;0;0;0;0;0
FR;9;2020-12-29;0;0;0;0;0;0;0;0;0;0;0;0;0;0;0;0;0;0
FR;9;2020-12-30;0;0;0;0;0;0;0;0;0;0;0;0;0;0;0;0;0;0
FR;9;2020-12-31;0;0;0;0;0;0;0;0;0;0;0;0;0;0;0;0;0;0
FR;9;2021-01-01;0;0;0;0;0;0;0;0;0;0;0;0;0;0;0;0;0;0
FR;9;2021-01-02;0;0;0;0;0;0;0;0;0;0;0;0;0;0;0;0;0;0
FR;9;2021-01-03;0;0;0;0;0;0;0;0;0;0;0;0;0;0;0;0;0;0
FR;9;2021-01-04;0;0;0;0;0;0;0;0;0;0;0;0;0;0;0;0;0;0
FR;9;2021-01-05;0;0;0;0;0;0;0;0;0;0;0;0;0;0;0;0;0;0
FR;9;2021-01-06;0;0;0;0;0;0;0;0;0;0;0;0;0;0;0;0;0;0
FR;9;2021-01-07;0;0;0;0;0;0;0;0;0;0;0;0;0;0;0;0;0;0
FR;9;2021-01-08;0;0;0;0;0;0;0;0;0;0;0;0;0;0;0;0;0;0
FR;9;2021-01-09;0;0;0;0;0;0;0;0;0;0;0;0;0;0;0;0;0;0
FR;9;2021-01-10;0;0;0;0;0;0;0;0;0;0;0;0;0;0;0;0;0;0
FR;9;2021-01-11;0;0;0;0;0;0;0;0;0;0;0;0;0;0;0;0;0;0
FR;9;2021-01-12;0;0;0;0;0;0;0;0;0;0;0;0;0;0;0;0;0;0
FR;9;2021-01-13;0;0;0;0;0;0;0;0;0;0;0;0;0;0;0;0;0;0
FR;9;2021-01-14;0;0;0;0;0;0;0;0;0;0;0;0;0;0;0;0;0;0
FR;9;2021-01-15;0;0;0;0;0;0;0;0;0;0;0;0;0;0;0;0;0;0
FR;9;2021-01-16;0;0;0;0;0;0;0;0;0;0;0;0;0;0;0;0;0;0
FR;9;2021-01-17;0;0;0;0;0;0;0;0;0;0;0;0;0;0;0;0;0;0
FR;9;2021-01-18;0;0;0;0;0;0;0;0;0;0;0;0;0;0;0;0;0;0
FR;9;2021-01-19;0;0;0;0;0;0;0;0;0;0;0;0;0;0;0;0;0;0
FR;9;2021-01-20;0;0;0;0;0;0;0;0;0;0;0;0;0;0;0;0;0;0
FR;9;2021-01-21;0;0;0;0;0;0;0;0;0;0;0;0;0;0;0;0;0;0
FR;9;2021-01-22;0;0;0;0;0;0;0;0;0;0;0;0;0;0;0;0;0;0
FR;9;2021-01-23;0;0;0;0;0;0;0;0;0;0;0;0;0;0;0;0;0;0
FR;9;2021-01-24;0;0;0;0;0;0;0;0;0;0;0;0;0;0;0;0;0;0
FR;9;2021-01-25;0;0;0;0;0;0;0;0;0;0;0;0;0;0;0;0;0;0
FR;9;2021-01-26;0;0;0;0;0;0;0;0;0;0;0;0;0;0;0;0;0;0
FR;9;2021-01-27;0;0;0;0;0;0;0;0;0;0;0;0;0;0;0;0;0;0
FR;9;2021-01-28;0;0;0;0;0;0;0;0;0;0;0;0;0;0;0;0;0;0
FR;9;2021-01-29;0;0;0;0;0;0;0;0;0;0;0;0;0;0;0;0;0;0
FR;9;2021-01-30;0;0;0;0;0;0;0;0;0;0;0;0;0;0;0;0;0;0
FR;9;2021-01-31;0;0;0;0;0;0;0;0;0;0;0;0;0;0;0;0;0;0
FR;9;2021-02-01;0;0;0;0;0;0;0;0;0;0;0;0;0;0;0;0;0;0
FR;9;2021-02-02;0;0;0;0;0;0;0;0;0;0;0;0;0;0;0;0;0;0
FR;9;2021-02-03;0;0;0;0;0;0;0;0;0;0;0;0;0;0;0;0;0;0
FR;9;2021-02-04;0;0;0;0;0;0;0;0;0;0;0;0;0;0;0;0;0;0
FR;9;2021-02-05;0;0;0;0;0;0;0;0;0;0;0;0;0;0;0;0;0;0
FR;9;2021-02-06;0;0;0;0;0;0;0;0;0;0;0;0;0;0;0;0;0;0
FR;9;2021-02-07;0;0;0;0;0;0;0;0;0;0;0;0;0;0;0;0;0;0
FR;9;2021-02-08;0;0;0;0;0;0;0;0;0;0;0;0;0;0;0;0;0;0
FR;9;2021-02-09;0;0;0;0;0;0;0;0;0;0;0;0;0;0;0;0;0;0
FR;9;2021-02-10;0;0;0;0;0;0;0;0;0;0;0;0;0;0;0;0;0;0
FR;9;2021-02-11;0;0;0;0;0;0;0;0;0;0;0;0;0;0;0;0;0;0
FR;9;2021-02-12;0;0;0;0;0;0;0;0;0;0;0;0;0;0;0;0;0;0
FR;9;2021-02-13;0;0;0;0;0;0;0;0;0;0;0;0;0;0;0;0;0;0
FR;9;2021-02-14;0;0;0;0;0;0;0;0;0;0;0;0;0;0;0;0;0;0
FR;9;2021-02-15;0;0;0;0;0;0;0;0;0;0;0;0;0;0;0;0;0;0
FR;9;2021-02-16;0;0;0;0;0;0;0;0;0;0;0;0;0;0;0;0;0;0
FR;9;2021-02-17;0;0;0;0;0;0;0;0;0;0;0;0;0;0;0;0;0;0
FR;9;2021-02-18;0;0;0;0;0;0;0;0;0;0;0;0;0;0;0;0;0;0
FR;9;2021-02-19;0;0;0;0;0;0;0;0;0;0;0;0;0;0;0;0;0;0
FR;9;2021-02-20;0;0;0;0;0;0;0;0;0;0;0;0;0;0;0;0;0;0
FR;9;2021-02-21;0;0;0;0;0;0;0;0;0;0;0;0;0;0;0;0;0;0
FR;9;2021-02-22;0;0;0;0;0;0;0;0;0;0;0;0;0;0;0;0;0;0
FR;9;2021-02-23;0;0;0;0;0;0;0;0;0;0;0;0;0;0;0;0;0;0
FR;9;2021-02-24;0;0;0;0;0;0;0;0;0;0;0;0;0;0;0;0;0;0
FR;9;2021-02-25;0;0;0;0;0;0;0;0;0;0;0;0;0;0;0;0;0;0
FR;9;2021-02-26;0;0;0;0;0;0;0;0;0;0;0;0;0;0;0;0;0;0
FR;9;2021-02-27;0;0;0;0;0;0;0;0;0;0;0;0;0;0;0;0;0;0
FR;9;2021-02-28;0;0;0;0;0;0;0;0;0;0;0;0;0;0;0;0;0;0
FR;9;2021-03-01;0;0;0;0;0;0;0;0;0;0;0;0;0;0;0;0;0;0
FR;9;2021-03-02;0;0;0;0;0;0;0;0;0;0;0;0;0;0;0;0;0;0
FR;9;2021-03-03;0;0;0;0;0;0;0;0;0;0;0;0;0;0;0;0;0;0
FR;9;2021-03-04;0;0;0;0;0;0;0;0;0;0;0;0;0;0;0;0;0;0
FR;9;2021-03-05;0;0;0;0;0;0;0;0;0;0;0;0;0;0;0;0;0;0
FR;9;2021-03-06;0;0;0;0;0;0;0;0;0;0;0;0;0;0;0;0;0;0
FR;9;2021-03-07;0;0;0;0;0;0;0;0;0;0;0;0;0;0;0;0;0;0
FR;9;2021-03-08;0;0;0;0;0;0;0;0;0;0;0;0;0;0;0;0;0;0
FR;9;2021-03-09;0;0;0;0;0;0;0;0;0;0;0;0;0;0;0;0;0;0
FR;9;2021-03-10;0;0;0;0;0;0;0;0;0;0;0;0;0;0;0;0;0;0
FR;9;2021-03-11;0;0;0;0;0;0;0;0;0;0;0;0;0;0;0;0;0;0
FR;9;2021-03-12;0;0;0;0;0;0;0;0;0;0;0;0;0;0;0;0;0;0
FR;9;2021-03-13;0;0;0;0;0;0;0;0;0;0;0;0;0;0;0;0;0;0
FR;9;2021-03-14;0;0;0;0;0;0;0;0;0;0;0;0;0;0;0;0;0;0
FR;9;2021-03-15;0;0;0;0;0;0;0;0;0;0;0;0;0;0;0;0;0;0
FR;9;2021-03-16;0;0;0;0;0;0;0;0;0;0;0;0;0;0;0;0;0;0
FR;9;2021-03-17;0;0;0;0;0;0;0;0;0;0;0;0;0;0;0;0;0;0
FR;9;2021-03-18;0;0;0;0;0;0;0;0;0;0;0;0;0;0;0;0;0;0
FR;9;2021-03-19;0;0;0;0;0;0;0;0;0;0;0;0;0;0;0;0;0;0
FR;9;2021-03-20;0;0;0;0;0;0;0;0;0;0;0;0;0;0;0;0;0;0
FR;9;2021-03-21;0;0;0;0;0;0;0;0;0;0;0;0;0;0;0;0;0;0
FR;9;2021-03-22;0;0;0;0;0;0;0;0;0;0;0;0;0;0;0;0;0;0
FR;9;2021-03-23;0;0;0;0;0;0;0;0;0;0;0;0;0;0;0;0;0;0
FR;9;2021-03-24;0;0;0;0;0;0;0;0;0;0;0;0;0;0;0;0;0;0
FR;9;2021-03-25;0;0;0;0;0;0;0;0;0;0;0;0;0;0;0;0;0;0
FR;9;2021-03-26;0;0;0;0;0;0;0;0;0;0;0;0;0;0;0;0;0;0
FR;9;2021-03-27;0;0;0;0;0;0;0;0;0;0;0;0;0;0;0;0;0;0
FR;9;2021-03-28;0;0;0;0;0;0;0;0;0;0;0;0;0;0;0;0;0;0
FR;9;2021-03-29;0;0;0;0;0;0;0;0;0;0;0;0;0;0;0;0;0;0
FR;9;2021-03-30;0;0;0;0;0;0;0;0;0;0;0;0;0;0;0;0;0;0
FR;9;2021-03-31;0;0;0;0;0;0;0;0;0;0;0;0;0;0;0;0;0;0
FR;9;2021-04-01;0;0;0;0;0;0;0;0;0;0;0;0;0;0;0;0;0;0
FR;9;2021-04-02;0;0;0;0;0;0;0;0;0;0;0;0;0;0;0;0;0;0
FR;9;2021-04-03;0;0;0;0;0;0;0;0;0;0;0;0;0;0;0;0;0;0
FR;9;2021-04-04;0;0;0;0;0;0;0;0;0;0;0;0;0;0;0;0;0;0
FR;9;2021-04-05;0;0;0;0;0;0;0;0;0;0;0;0;0;0;0;0;0;0
FR;9;2021-04-06;0;0;0;0;0;0;0;0;0;0;0;0;0;0;0;0;0;0
FR;9;2021-04-07;0;0;0;0;0;0;0;0;0;0;0;0;0;0;0;0;0;0
FR;9;2021-04-08;0;0;0;0;0;0;0;0;0;0;0;0;0;0;0;0;0;0
FR;9;2021-04-09;0;0;0;0;0;0;0;0;0;0;0;0;0;0;0;0;0;0
FR;9;2021-04-10;0;0;0;0;0;0;0;0;0;0;0;0;0;0;0;0;0;0
FR;9;2021-04-11;0;0;0;0;0;0;0;0;0;0;0;0;0;0;0;0;0;0
FR;9;2021-04-12;0;0;0;0;0;0;0;0;0;0;0;0;0;0;0;0;0;0
FR;9;2021-04-13;0;0;0;0;0;0;0;0;0;0;0;0;0;0;0;0;0;0
FR;9;2021-04-14;0;0;0;0;0;0;0;0;0;0;0;0;0;0;0;0;0;0
FR;9;2021-04-15;0;0;0;0;0;0;0;0;0;0;0;0;0;0;0;0;0;0
FR;9;2021-04-16;0;0;0;0;0;0;0;0;0;0;0;0;0;0;0;0;0;0
FR;9;2021-04-17;0;0;0;0;0;0;0;0;0;0;0;0;0;0;0;0;0;0
FR;9;2021-04-18;0;0;0;0;0;0;0;0;0;0;0;0;0;0;0;0;0;0
FR;9;2021-04-19;0;0;0;0;0;0;0;0;0;0;0;0;0;0;0;0;0;0
FR;9;2021-04-20;0;0;0;0;0;0;0;0;0;0;0;0;0;0;0;0;0;0
FR;9;2021-04-21;0;0;0;0;0;0;0;0;0;0;0;0;0;0;0;0;0;0
FR;9;2021-04-22;0;0;0;0;0;0;0;0;0;0;0;0;0;0;0;0;0;0
FR;9;2021-04-23;0;0;0;0;0;0;0;0;0;0;0;0;0;0;0;0;0;0
FR;9;2021-04-24;0;0;0;0;0;0;0;0;0;0;0;0;0;0;0;0;0;0
FR;9;2021-04-25;0;0;0;0;0;0;0;0;0;0;0;0;0;0;0;0;0;0
FR;9;2021-04-26;0;0;0;0;0;0;0;0;0;0;0;0;0;0;0;0;0;0
FR;9;2021-04-27;0;0;0;0;0;0;0;0;0;0;0;0;0;0;0;0;0;0
FR;9;2021-04-28;0;0;0;0;0;0;0;0;0;0;0;0;0;0;0;0;0;0
FR;9;2021-04-29;0;0;0;0;0;0;0;0;0;0;0;0;0;0;0;0;0;0
FR;9;2021-04-30;0;0;0;0;0;0;0;0;0;0;0;0;0;0;0;0;0;0
FR;9;2021-05-01;0;0;0;0;0;0;0;0;0;0;0;0;0;0;0;0;0;0
FR;9;2021-05-02;0;0;0;0;0;0;0;0;0;0;0;0;0;0;0;0;0;0
FR;9;2021-05-03;0;0;0;0;0;0;0;0;0;0;0;0;0;0;0;0;0;0
FR;9;2021-05-04;0;0;0;0;0;0;0;0;0;0;0;0;0;0;0;0;0;0
FR;9;2021-05-05;0;0;0;0;0;0;0;0;0;0;0;0;0;0;0;0;0;0
FR;9;2021-05-06;0;0;0;0;0;0;0;0;0;0;0;0;0;0;0;0;0;0
FR;9;2021-05-07;0;0;0;0;0;0;0;0;0;0;0;0;0;0;0;0;0;0
FR;9;2021-05-08;0;0;0;0;0;0;0;0;0;0;0;0;0;0;0;0;0;0
FR;9;2021-05-09;0;0;0;0;0;0;0;0;0;0;0;0;0;0;0;0;0;0
FR;9;2021-05-10;0;0;0;0;0;0;0;0;0;0;0;0;0;0;0;0;0;0
FR;9;2021-05-11;0;0;0;0;0;0;0;0;0;0;0;0;0;0;0;0;0;0
FR;9;2021-05-12;0;0;0;0;0;0;0;0;0;0;0;0;0;0;0;0;0;0
FR;9;2021-05-13;0;0;0;0;0;0;0;0;0;0;0;0;0;0;0;0;0;0
FR;9;2021-05-14;0;0;0;0;0;0;0;0;0;0;0;0;0;0;0;0;0;0
FR;9;2021-05-15;0;0;0;0;0;0;0;0;0;0;0;0;0;0;0;0;0;0
FR;9;2021-05-16;0;0;0;0;0;0;0;0;0;0;0;0;0;0;0;0;0;0
FR;9;2021-05-17;0;0;0;0;0;0;0;0;0;0;0;0;0;0;0;0;0;0
FR;9;2021-05-18;0;0;0;0;0;0;0;0;0;0;0;0;0;0;0;0;0;0
FR;9;2021-05-19;0;0;0;0;0;0;0;0;0;0;0;0;0;0;0;0;0;0
FR;9;2021-05-20;0;0;0;0;0;0;0;0;0;0;0;0;0;0;0;0;0;0
FR;9;2021-05-21;0;0;0;0;0;0;0;0;0;0;0;0;0;0;0;0;0;0
FR;9;2021-05-22;0;0;0;0;0;0;0;0;0;0;0;0;0;0;0;0;0;0
FR;9;2021-05-23;0;0;0;0;0;0;0;0;0;0;0;0;0;0;0;0;0;0
FR;9;2021-05-24;0;0;0;0;0;0;0;0;0;0;0;0;0;0;0;0;0;0
FR;9;2021-05-25;0;0;0;0;0;0;0;0;0;0;0;0;0;0;0;0;0;0
FR;9;2021-05-26;0;0;0;0;0;0;0;0;0;0;0;0;0;0;0;0;0;0
FR;9;2021-05-27;0;0;0;0;0;0;0;0;0;0;0;0;0;0;0;0;0;0
FR;9;2021-05-28;0;0;0;0;0;0;0;0;0;0;0;0;0;0;0;0;0;0
FR;9;2021-05-29;0;0;0;0;0;0;0;0;0;0;0;0;0;0;0;0;0;0
FR;9;2021-05-30;0;0;0;0;0;0;0;0;0;0;0;0;0;0;0;0;0;0
FR;9;2021-05-31;0;0;0;0;0;0;0;0;0;0;0;0;0;0;0;0;0;0
FR;9;2021-06-01;0;0;0;0;0;0;0;0;0;0;0;0;0;0;0;0;0;0
FR;9;2021-06-02;0;0;0;0;0;0;0;0;0;0;0;0;0;0;0;0;0;0
FR;9;2021-06-03;0;0;0;0;0;0;0;0;0;0;0;0;0;0;0;0;0;0
FR;9;2021-06-04;0;0;0;0;0;0;0;0;0;0;0;0;0;0;0;0;0;0
FR;9;2021-06-05;0;0;0;0;0;0;0;0;0;0;0;0;0;0;0;0;0;0
FR;9;2021-06-06;0;0;0;0;0;0;0;0;0;0;0;0;0;0;0;0;0;0
FR;9;2021-06-07;0;0;0;0;0;0;0;0;0;0;0;0;0;0;0;0;0;0
FR;9;2021-06-08;0;0;0;0;0;0;0;0;0;0;0;0;0;0;0;0;0;0
FR;9;2021-06-09;0;0;0;0;0;0;0;0;0;0;0;0;0;0;0;0;0;0
FR;9;2021-06-10;0;0;0;0;0;0;0;0;0;0;0;0;0;0;0;0;0;0
FR;9;2021-06-11;0;0;0;0;0;0;0;0;0;0;0;0;0;0;0;0;0;0
FR;9;2021-06-12;0;0;0;0;0;0;0;0;0;0;0;0;0;0;0;0;0;0
FR;9;2021-06-13;0;0;0;0;0;0;0;0;0;0;0;0;0;0;0;0;0;0
FR;9;2021-06-14;0;0;0;0;0;0;0;0;0;0;0;0;0;0;0;0;0;0
FR;9;2021-06-15;0;0;0;0;0;0;0;0;0;0;0;0;0;0;0;0;0;0
FR;9;2021-06-16;0;0;0;0;0;0;0;0;0;0;0;0;0;0;0;0;0;0
FR;9;2021-06-17;0;0;0;0;0;0;0;0;0;0;0;0;0;0;0;0;0;0
FR;9;2021-06-18;0;0;0;0;0;0;0;0;0;0;0;0;0;0;0;0;0;0
FR;9;2021-06-19;0;0;0;0;0;0;0;0;0;0;0;0;0;0;0;0;0;0
FR;9;2021-06-20;0;0;0;0;0;0;0;0;0;0;0;0;0;0;0;0;0;0
FR;9;2021-06-21;0;0;0;0;0;0;0;0;0;0;0;0;0;0;0;0;0;0
FR;9;2021-06-22;0;0;0;0;0;0;0;0;0;0;0;0;0;0;0;0;0;0
FR;9;2021-06-23;0;0;0;0;0;0;0;0;0;0;0;0;0;0;0;0;0;0
FR;9;2021-06-24;0;0;0;0;0;0;0;0;0;0;0;0;0;0;0;0;0;0
FR;9;2021-06-25;0;0;0;0;0;0;0;0;0;0;0;0;0;0;0;0;0;0
FR;9;2021-06-26;0;0;0;0;0;0;0;0;0;0;0;0;0;0;0;0;0;0
FR;9;2021-06-27;0;0;0;0;0;0;0;0;0;0;0;0;0;0;0;0;0;0
FR;9;2021-06-28;0;0;0;0;0;0;0;0;0;0;0;0;0;0;0;0;0;0
FR;9;2021-06-29;0;0;0;0;0;0;0;0;0;0;0;0;0;0;0;0;0;0
FR;9;2021-06-30;0;0;0;0;0;0;0;0;0;0;0;0;0;0;0;0;0;0
FR;9;2021-07-01;0;0;0;0;0;0;0;0;0;0;0;0;0;0;0;0;0;0
FR;9;2021-07-02;0;0;0;0;0;0;0;0;0;0;0;0;0;0;0;0;0;0
FR;9;2021-07-03;0;0;0;0;0;0;0;0;0;0;0;0;0;0;0;0;0;0
FR;9;2021-07-04;0;0;0;0;0;0;0;0;0;0;0;0;0;0;0;0;0;0
FR;9;2021-07-05;0;0;0;0;0;0;0;0;0;0;0;0;0;0;0;0;0;0
FR;9;2021-07-06;0;0;0;0;0;0;0;0;0;0;0;0;0;0;0;0;0;0
FR;9;2021-07-07;0;0;0;0;0;0;0;0;0;0;0;0;0;0;0;0;0;0
FR;9;2021-07-08;0;0;0;0;0;0;0;0;0;0;0;0;0;0;0;0;0;0
FR;9;2021-07-09;0;0;0;0;0;0;0;0;0;0;0;0;0;0;0;0;0;0
FR;9;2021-07-10;0;0;0;0;0;0;0;0;0;0;0;0;0;0;0;0;0;0
FR;9;2021-07-11;0;0;0;0;0;0;0;0;0;0;0;0;0;0;0;0;0;0
FR;9;2021-07-12;0;0;0;0;0;0;0;0;0;0;0;0;0;0;0;0;0;0
FR;9;2021-07-13;0;0;0;0;0;0;0;0;0;0;0;0;0;0;0;0;0;0
FR;9;2021-07-14;0;0;0;0;0;0;0;0;0;0;0;0;0;0;0;0;0;0
FR;9;2021-07-15;0;0;0;0;0;0;0;0;0;0;0;0;0;0;0;0;0;0
FR;9;2021-07-16;0;0;0;0;0;0;0;0;0;0;0;0;0;0;0;0;0;0
FR;9;2021-07-17;0;0;0;0;0;0;0;0;0;0;0;0;0;0;0;0;0;0
FR;9;2021-07-18;0;0;0;0;0;0;0;0;0;0;0;0;0;0;0;0;0;0
FR;9;2021-07-19;0;0;0;0;0;0;0;0;0;0;0;0;0;0;0;0;0;0
FR;9;2021-07-20;0;0;0;0;0;0;0;0;0;0;0;0;0;0;0;0;0;0
FR;9;2021-07-21;0;0;0;0;0;0;0;0;0;0;0;0;0;0;0;0;0;0
FR;9;2021-07-22;0;0;0;0;0;0;0;0;0;0;0;0;0;0;0;0;0;0
FR;9;2021-07-23;0;0;0;0;0;0;0;0;0;0;0;0;0;0;0;0;0;0
FR;9;2021-07-24;0;0;0;0;0;0;0;0;0;0;0;0;0;0;0;0;0;0
FR;9;2021-07-25;0;0;0;0;0;0;0;0;0;0;0;0;0;0;0;0;0;0
FR;9;2021-07-26;0;0;0;0;0;0;0;0;0;0;0;0;0;0;0;0;0;0
FR;9;2021-07-27;0;0;0;0;0;0;0;0;0;0;0;0;0;0;0;0;0;0
FR;9;2021-07-28;0;0;0;0;0;0;0;0;0;0;0;0;0;0;0;0;0;0
FR;9;2021-07-29;0;0;0;0;0;0;0;0;0;0;0;0;0;0;0;0;0;0
FR;9;2021-07-30;0;0;0;0;0;0;0;0;0;0;0;0;0;0;0;0;0;0
FR;9;2021-07-31;0;0;0;0;0;0;0;0;0;0;0;0;0;0;0;0;0;0
FR;9;2021-08-01;0;0;0;0;0;0;0;0;0;0;0;0;0;0;0;0;0;0
FR;9;2021-08-02;0;0;0;0;0;0;0;0;0;0;0;0;0;0;0;0;0;0
FR;9;2021-08-03;0;0;0;0;0;0;0;0;0;0;0;0;0;0;0;0;0;0
FR;9;2021-08-04;0;0;0;0;0;0;0;0;0;0;0;0;0;0;0;0;0;0
FR;9;2021-08-05;0;0;0;0;0;0;0;0;0;0;0;0;0;0;0;0;0;0
FR;9;2021-08-06;0;0;0;0;0;0;0;0;0;0;0;0;0;0;0;0;0;0
FR;9;2021-08-07;0;0;0;0;0;0;0;0;0;0;0;0;0;0;0;0;0;0
FR;9;2021-08-08;0;0;0;0;0;0;0;0;0;0;0;0;0;0;0;0;0;0
FR;9;2021-08-09;0;0;0;0;0;0;0;0;0;0;0;0;0;0;0;0;0;0
FR;9;2021-08-10;0;0;0;0;0;0;0;0;0;0;0;0;0;0;0;0;0;0
FR;9;2021-08-11;0;0;0;0;0;0;0;0;0;0;0;0;0;0;0;0;0;0
FR;9;2021-08-12;0;0;0;0;0;0;0;0;0;0;0;0;0;0;0;0;0;0
FR;9;2021-08-13;0;0;0;0;0;0;0;0;0;0;0;0;0;0;0;0;0;0
FR;9;2021-08-14;0;0;0;0;0;0;0;0;0;0;0;0;0;0;0;0;0;0
FR;9;2021-08-15;0;0;0;0;0;0;0;0;0;0;0;0;0;0;0;0;0;0
FR;9;2021-08-16;0;0;0;0;0;0;0;0;0;0;0;0;0;0;0;0;0;0
FR;9;2021-08-17;0;0;0;0;0;0;0;0;0;0;0;0;0;0;0;0;0;0
FR;9;2021-08-18;0;0;0;0;0;0;0;0;0;0;0;0;0;0;0;0;0;0
FR;9;2021-08-19;0;0;0;0;0;0;0;0;0;0;0;0;0;0;0;0;0;0
FR;9;2021-08-20;0;0;0;0;0;0;0;0;0;0;0;0;0;0;0;0;0;0
FR;9;2021-08-21;0;0;0;0;0;0;0;0;0;0;0;0;0;0;0;0;0;0
FR;9;2021-08-22;0;0;0;0;0;0;0;0;0;0;0;0;0;0;0;0;0;0
FR;9;2021-08-23;0;0;0;0;0;0;0;0;0;0;0;0;0;0;0;0;0;0
FR;9;2021-08-24;0;0;0;0;0;0;0;0;0;0;0;0;0;0;0;0;0;0
FR;9;2021-08-25;0;0;0;0;0;0;0;0;0;0;0;0;0;0;0;0;0;0
FR;9;2021-08-26;0;0;0;0;0;0;0;0;0;0;0;0;0;0;0;0;0;0
FR;9;2021-08-27;0;0;0;0;0;0;0;0;0;0;0;0;0;0;0;0;0;0
FR;9;2021-08-28;0;0;0;0;0;0;0;0;0;0;0;0;0;0;0;0;0;0
FR;9;2021-08-29;0;0;0;0;0;0;0;0;0;0;0;0;0;0;0;0;0;0
FR;9;2021-08-30;0;0;0;0;0;0;0;0;0;0;0;0;0;0;0;0;0;0
FR;9;2021-08-31;0;0;0;0;0;0;0;0;0;0;0;0;0;0;0;0;0;0
FR;9;2021-09-01;0;0;0;0;0;0;0;0;0;0;0;0;0;0;0;0;0;0
FR;9;2021-09-02;0;0;0;0;0;0;0;0;0;0;0;0;0;0;0;0;0;0
FR;9;2021-09-03;0;0;0;0;0;0;0;0;0;0;0;0;0;0;0;0;0;0
FR;9;2021-09-04;0;0;0;0;0;0;0;0;0;0;0;0;0;0;0;0;0;0
FR;9;2021-09-05;0;0;0;0;0;0;0;0;0;0;0;0;0;0;0;0;0;0
FR;9;2021-09-06;0;0;0;0;0;0;0;0;0;0;0;0;0;0;0;0;0;0
FR;9;2021-09-07;0;0;0;0;0;0;0;0;0;0;0;0;0;0;0;0;0;0
FR;9;2021-09-08;0;0;0;0;0;0;0;0;0;0;0;0;0;0;0;0;0;0
FR;9;2021-09-09;0;0;0;0;0;0;0;0;0;0;0;0;0;0;0;0;0;0
FR;9;2021-09-10;0;0;0;0;0;0;0;0;0;0;0;0;0;0;0;0;0;0
FR;9;2021-09-11;0;0;0;0;0;0;0;0;0;0;0;0;0;0;0;0;0;0
FR;9;2021-09-12;0;0;0;0;0;0;0;0;0;0;0;0;0;0;0;0;0;0
FR;9;2021-09-13;0;0;0;0;0;0;0;0;0;0;0;0;0;0;0;0;0;0
FR;9;2021-09-14;0;0;0;0;0;0;0;0;0;0;0;0;0;0;0;0;0;0
FR;9;2021-09-15;0;0;0;0;0;0;0;0;0;0;0;0;0;0;0;0;0;0
FR;9;2021-09-16;0;0;0;0;0;0;0;0;0;0;0;0;0;0;0;0;0;0
FR;9;2021-09-17;0;0;0;0;0;0;0;0;0;0;0;0;0;0;0;0;0;0
FR;9;2021-09-18;0;0;0;0;0;0;0;0;0;0;0;0;0;0;0;0;0;0
FR;9;2021-09-19;0;0;0;0;0;0;0;0;0;0;0;0;0;0;0;0;0;0
FR;9;2021-09-20;0;0;0;0;0;0;0;0;0;0;0;0;0;0;0;0;0;0
FR;9;2021-09-21;0;0;0;0;0;0;0;0;0;0;0;0;0;0;0;0;0;0
FR;9;2021-09-22;0;0;0;0;0;0;0;0;0;0;0;0;0;0;0;0;0;0
FR;9;2021-09-23;0;0;0;0;0;0;0;0;0;0;0;0;0;0;0;0;0;0
FR;9;2021-09-24;0;0;0;0;0;0;0;0;0;0;0;0;0;0;0;0;0;0
FR;9;2021-09-25;0;0;0;0;0;0;0;0;0;0;0;0;0;0;0;0;0;0
FR;9;2021-09-26;0;0;0;0;0;0;0;0;0;0;0;0;0;0;0;0;0;0
FR;9;2021-09-27;0;0;0;0;0;0;0;0;0;0;0;0;0;0;0;0;0;0
FR;9;2021-09-28;0;0;0;0;0;0;0;0;0;0;0;0;0;0;0;0;0;0
FR;9;2021-09-29;0;0;0;0;0;0;0;0;0;0;0;0;0;0;0;0;0;0
FR;9;2021-09-30;0;0;0;0;0;0;0;0;0;0;0;0;0;0;0;0;0;0
FR;9;2021-10-01;0;0;0;0;0;0;0;0;0;0;0;0;0;0;0;0;0;0
FR;9;2021-10-02;0;0;0;0;0;0;0;0;0;0;0;0;0;0;0;0;0;0
FR;9;2021-10-03;0;0;0;0;0;0;0;0;0;0;0;0;0;0;0;0;0;0
FR;9;2021-10-04;0;0;0;0;0;0;0;0;0;0;0;0;0;0;0;0;0;0
FR;9;2021-10-05;0;0;0;0;0;0;0;0;0;0;0;0;0;0;0;0;0;0
FR;9;2021-10-06;0;0;0;0;0;0;0;0;0;0;0;0;0;0;0;0;0;0
FR;9;2021-10-07;0;0;0;0;0;0;0;0;0;0;0;0;0;0;0;0;0;0
FR;9;2021-10-08;0;0;0;0;0;0;0;0;0;0;0;0;0;0;0;0;0;0
FR;9;2021-10-09;0;0;0;0;0;0;0;0;0;0;0;0;0;0;0;0;0;0
FR;9;2021-10-10;0;0;0;0;0;0;0;0;0;0;0;0;0;0;0;0;0;0
FR;9;2021-10-11;0;0;0;0;0;0;0;0;0;0;0;0;0;0;0;0;0;0
FR;9;2021-10-12;0;0;0;0;0;0;0;0;0;0;0;0;0;0;0;0;0;0
FR;9;2021-10-13;0;0;0;0;0;0;0;0;0;0;0;0;0;0;0;0;0;0
FR;9;2021-10-14;0;0;0;0;0;0;0;0;0;0;0;0;0;0;0;0;0;0
FR;9;2021-10-15;0;0;0;0;0;0;0;0;0;0;0;0;0;0;0;0;0;0
FR;9;2021-10-16;0;0;0;0;0;0;0;0;0;0;0;0;0;0;0;0;0;0
FR;9;2021-10-17;0;0;0;0;0;0;0;0;0;0;0;0;0;0;0;0;0;0
FR;9;2021-10-18;0;0;0;0;0;0;0;0;0;0;0;0;0;0;0;0;0;0
FR;9;2021-10-19;0;0;0;0;0;0;0;0;0;0;0;0;0;0;0;0;0;0
FR;9;2021-10-20;0;0;0;0;0;0;0;0;0;0;0;0;0;0;0;0;0;0
FR;9;2021-10-21;0;0;0;0;0;0;0;0;0;0;0;0;0;0;0;0;0;0
FR;9;2021-10-22;0;0;0;0;0;0;0;0;0;0;0;0;0;0;0;0;0;0
FR;9;2021-10-23;0;0;0;0;0;0;0;0;0;0;0;0;0;0;0;0;0;0
FR;9;2021-10-24;0;0;0;0;0;0;0;0;0;0;0;0;0;0;0;0;0;0
FR;9;2021-10-25;0;0;0;0;0;0;0;0;0;0;0;0;0;0;0;0;0;0
FR;9;2021-10-26;0;0;0;0;0;0;0;0;0;0;0;0;0;0;0;0;0;0
FR;9;2021-10-27;0;0;0;0;0;0;0;0;0;0;0;0;0;0;0;0;0;0
FR;9;2021-10-28;0;0;0;0;0;0;0;0;0;0;0;0;0;0;0;0;0;0
FR;9;2021-10-29;0;0;0;0;0;0;0;0;0;0;0;0;0;0;0;0;0;0
FR;9;2021-10-30;0;0;0;0;0;0;0;0;0;0;0;0;0;0;0;0;0;0
FR;9;2021-10-31;0;0;0;0;0;0;0;0;0;0;0;0;0;0;0;0;0;0
FR;9;2021-11-01;0;0;0;0;0;0;0;0;0;0;0;0;0;0;0;0;0;0
FR;9;2021-11-02;0;0;0;0;0;0;0;0;0;0;0;0;0;0;0;0;0;0
FR;9;2021-11-03;0;0;0;0;0;0;0;0;0;0;0;0;0;0;0;0;0;0
FR;9;2021-11-04;0;0;0;0;0;0;0;0;0;0;0;0;0;0;0;0;0;0
FR;9;2021-11-05;0;0;0;0;0;0;0;0;0;0;0;0;0;0;0;0;0;0
FR;9;2021-11-06;0;0;0;0;0;0;0;0;0;0;0;0;0;0;0;0;0;0
FR;9;2021-11-07;0;0;0;0;0;0;0;0;0;0;0;0;0;0;0;0;0;0
FR;9;2021-11-08;0;0;0;0;0;0;0;0;0;0;0;0;0;0;0;0;0;0
FR;9;2021-11-09;0;0;0;0;0;0;0;0;0;0;0;0;0;0;0;0;0;0
FR;9;2021-11-10;0;0;0;0;0;0;0;0;0;0;0;0;0;0;0;0;0;0
FR;9;2021-11-11;0;0;0;0;0;0;0;0;0;0;0;0;0;0;0;0;0;0
FR;9;2021-11-12;0;0;0;0;0;0;0;0;0;0;0;0;0;0;0;0;0;0
FR;9;2021-11-13;0;0;0;0;0;0;0;0;0;0;0;0;0;0;0;0;0;0
FR;9;2021-11-14;0;0;0;0;0;0;0;0;0;0;0;0;0;0;0;0;0;0
FR;9;2021-11-15;0;0;0;0;0;0;0;0;0;0;0;0;0;0;0;0;0;0
FR;9;2021-11-16;0;0;0;0;0;0;0;0;0;0;0;0;0;0;0;0;0;0
FR;9;2021-11-17;0;0;0;0;0;0;0;0;0;0;0;0;0;0;0;0;0;0
FR;9;2021-11-18;0;0;0;0;0;0;0;0;0;0;0;0;0;0;0;0;0;0
FR;9;2021-11-19;0;0;0;0;0;0;0;0;0;0;0;0;0;0;0;0;0;0
FR;9;2021-11-20;0;0;0;0;0;0;0;0;0;0;0;0;0;0;0;0;0;0
FR;9;2021-11-21;0;0;0;0;0;0;0;0;0;0;0;0;0;0;0;0;0;0
FR;9;2021-11-22;0;0;0;0;0;0;0;0;0;0;0;0;0;0;0;0;0;0
FR;9;2021-11-23;0;0;0;0;0;0;0;0;0;0;0;0;0;0;0;0;0;0
FR;9;2021-11-24;0;0;0;0;0;0;0;0;0;0;0;0;0;0;0;0;0;0
FR;9;2021-11-25;0;0;0;0;0;0;0;0;0;0;0;0;0;0;0;0;0;0
FR;9;2021-11-26;0;0;0;0;0;0;0;0;0;0;0;0;0;0;0;0;0;0
FR;9;2021-11-27;0;0;0;0;0;0;0;0;0;0;0;0;0;0;0;0;0;0
FR;9;2021-11-28;0;0;0;0;0;0;0;0;0;0;0;0;0;0;0;0;0;0
FR;9;2021-11-29;0;0;0;0;0;0;0;0;0;0;0;0;0;0;0;0;0;0
FR;9;2021-11-30;0;0;0;0;0;0;0;0;0;0;0;0;0;0;0;0;0;0
FR;9;2021-12-01;0;0;0;0;0;0;0;0;0;0;0;0;0;0;0;0;0;0
FR;9;2021-12-02;0;0;0;0;0;0;0;0;0;0;0;0;0;0;0;0;0;0
FR;9;2021-12-03;0;0;0;0;0;0;0;0;0;0;0;0;0;0;0;0;0;0
FR;9;2021-12-04;0;0;0;0;0;0;0;0;0;0;0;0;0;0;0;0;0;0
FR;9;2021-12-05;0;0;0;0;0;0;0;0;0;0;0;0;0;0;0;0;0;0
FR;9;2021-12-06;0;0;0;0;0;0;0;0;0;0;0;0;0;0;0;0;0;0
FR;9;2021-12-07;0;0;0;0;0;0;0;0;0;0;0;0;0;0;0;0;0;0
FR;9;2021-12-08;0;0;0;0;0;0;0;0;0;0;0;0;0;0;0;0;0;0
FR;9;2021-12-09;0;0;0;0;0;0;0;0;0;0;0;0;0;0;0;0;0;0
FR;9;2021-12-10;0;0;0;0;0;0;0;0;0;0;0;0;0;0;0;0;0;0
FR;9;2021-12-11;0;0;0;0;0;0;0;0;0;0;0;0;0;0;0;0;0;0
FR;9;2021-12-12;0;0;0;0;0;0;0;0;0;0;0;0;0;0;0;0;0;0
FR;9;2021-12-13;0;0;0;0;0;0;0;0;0;0;0;0;0;0;0;0;0;0
FR;9;2021-12-14;0;0;0;0;0;0;0;0;0;0;0;0;0;0;0;0;0;0
FR;9;2021-12-15;0;0;0;0;0;0;0;0;0;0;0;0;0;0;0;0;0;0
FR;9;2021-12-16;0;0;0;0;0;0;0;0;0;0;0;0;0;0;0;0;0;0
FR;9;2021-12-17;0;0;0;0;0;0;0;0;0;0;0;0;0;0;0;0;0;0
FR;9;2021-12-18;0;0;0;0;0;0;0;0;0;0;0;0;0;0;0;0;0;0
FR;9;2021-12-19;0;0;0;0;0;0;0;0;0;0;0;0;0;0;0;0;0;0
FR;9;2021-12-20;0;0;0;0;0;0;0;0;0;0;0;0;0;0;0;0;0;0
FR;9;2021-12-21;0;0;0;0;0;0;0;0;0;0;0;0;0;0;0;0;0;0
FR;9;2021-12-22;0;0;0;0;0;0;0;0;0;0;0;0;0;0;0;0;0;0
FR;9;2021-12-23;0;0;0;0;0;0;0;0;0;0;0;0;0;0;0;0;0;0
FR;9;2021-12-24;0;0;0;0;0;0;0;0;0;0;0;0;0;0;0;0;0;0
FR;9;2021-12-25;0;0;0;0;0;0;0;0;0;0;0;0;0;0;0;0;0;0
FR;9;2021-12-26;0;0;0;0;0;0;0;0;0;0;0;0;0;0;0;0;0;0
FR;9;2021-12-27;0;0;0;0;0;0;0;0;0;0;0;0;0;0;0;0;0;0
FR;9;2021-12-28;0;0;0;0;0;0;0;0;0;0;0;0;0;0;0;0;0;0
FR;9;2021-12-29;0;0;0;0;0;0;0;0;0;0;0;0;0;0;0;0;0;0
FR;9;2021-12-30;0;0;0;0;0;0;0;0;0;0;0;0;0;0;0;0;0;0
FR;9;2021-12-31;0;0;0;0;0;0;0;0;0;0;0;0;0;0;0;0;0;0
FR;9;2022-01-01;0;0;0;0;0;0;0;0;0;0;0;0;0;0;0;0;0;0
FR;9;2022-01-02;0;0;0;0;0;0;0;0;0;0;0;0;0;0;0;0;0;0
FR;9;2022-01-03;0;0;0;0;0;0;0;0;0;0;0;0;0;0;0;0;0;0
FR;9;2022-01-04;0;0;0;0;0;0;0;0;0;0;0;0;0;0;0;0;0;0
FR;9;2022-01-05;0;0;0;0;0;0;0;0;0;0;0;0;0;0;0;0;0;0
FR;9;2022-01-06;0;0;0;0;0;0;0;0;0;0;0;0;0;0;0;0;0;0
FR;9;2022-01-07;0;0;0;0;0;0;0;0;0;0;0;0;0;0;0;0;0;0
FR;9;2022-01-08;0;0;0;0;0;0;0;0;0;0;0;0;0;0;0;0;0;0
FR;9;2022-01-09;0;0;0;0;0;0;0;0;0;0;0;0;0;0;0;0;0;0
FR;9;2022-01-10;0;0;0;0;0;0;0;0;0;0;0;0;0;0;0;0;0;0
FR;9;2022-01-11;0;0;0;0;0;0;0;0;0;0;0;0;0;0;0;0;0;0
FR;9;2022-01-12;0;0;0;0;0;0;0;0;0;0;0;0;0;0;0;0;0;0
FR;9;2022-01-13;0;0;0;0;0;0;0;0;0;0;0;0;0;0;0;0;0;0
FR;9;2022-01-14;0;0;0;0;0;0;0;0;0;0;0;0;0;0;0;0;0;0
FR;9;2022-01-15;0;0;0;0;0;0;0;0;0;0;0;0;0;0;0;0;0;0
FR;9;2022-01-16;0;0;0;0;0;0;0;0;0;0;0;0;0;0;0;0;0;0
FR;9;2022-01-17;0;0;0;0;0;0;0;0;0;0;0;0;0;0;0;0;0;0
FR;9;2022-01-18;0;0;0;0;0;0;0;0;0;0;0;0;0;0;0;0;0;0
FR;9;2022-01-19;0;0;0;0;0;0;0;0;0;0;0;0;0;0;0;0;0;0
FR;9;2022-01-20;0;0;0;0;0;0;0;0;0;0;0;0;0;0;0;0;0;0
FR;9;2022-01-21;0;0;0;0;0;0;0;0;0;0;0;0;0;0;0;0;0;0
FR;9;2022-01-22;0;0;0;0;0;0;0;0;0;0;0;0;0;0;0;0;0;0
FR;9;2022-01-23;0;0;0;0;0;0;0;0;0;0;0;0;0;0;0;0;0;0
FR;9;2022-01-24;0;0;0;0;0;0;0;0;0;0;0;0;0;0;0;0;0;0
FR;9;2022-01-25;0;0;0;0;0;0;0;0;0;0;0;0;0;0;0;0;0;0
FR;9;2022-01-26;0;0;0;0;0;0;0;0;0;0;0;0;0;0;0;0;0;0
FR;9;2022-01-27;0;0;0;0;0;0;0;0;0;0;0;0;0;0;0;0;0;0
FR;9;2022-01-28;0;0;0;0;0;0;0;0;0;0;0;0;0;0;0;0;0;0
FR;9;2022-01-29;0;0;0;0;0;0;0;0;0;0;0;0;0;0;0;0;0;0
FR;9;2022-01-30;0;0;0;0;0;0;0;0;0;0;0;0;0;0;0;0;0;0
FR;9;2022-01-31;0;0;0;0;0;0;0;0;0;0;0;0;0;0;0;0;0;0
FR;9;2022-02-01;0;0;0;0;0;0;0;0;0;0;0;0;0;0;0;0;0;0
FR;9;2022-02-02;0;0;0;0;0;0;0;0;0;0;0;0;0;0;0;0;0;0
FR;9;2022-02-03;0;0;0;0;0;0;0;0;0;0;0;0;0;0;0;0;0;0
FR;9;2022-02-04;0;0;0;0;0;0;0;0;0;0;0;0;0;0;0;0;0;0
FR;9;2022-02-05;0;0;0;0;0;0;0;0;0;0;0;0;0;0;0;0;0;0
FR;9;2022-02-06;0;0;0;0;0;0;0;0;0;0;0;0;0;0;0;0;0;0
FR;9;2022-02-07;0;0;0;0;0;0;0;0;0;0;0;0;0;0;0;0;0;0
FR;9;2022-02-08;0;0;0;0;0;0;0;0;0;0;0;0;0;0;0;0;0;0
FR;9;2022-02-09;0;0;0;0;0;0;0;0;0;0;0;0;0;0;0;0;0;0
FR;9;2022-02-10;0;0;0;0;0;0;0;0;0;0;0;0;0;0;0;0;0;0
FR;9;2022-02-11;0;0;0;0;0;0;0;0;0;0;0;0;0;0;0;0;0;0
FR;9;2022-02-12;0;0;0;0;0;0;0;0;0;0;0;0;0;0;0;0;0;0
FR;9;2022-02-13;0;0;0;0;0;0;0;0;0;0;0;0;0;0;0;0;0;0
FR;9;2022-02-14;0;0;0;0;0;0;0;0;0;0;0;0;0;0;0;0;0;0
FR;9;2022-02-15;0;0;0;0;0;0;0;0;0;0;0;0;0;0;0;0;0;0
FR;9;2022-02-16;0;0;0;0;0;0;0;0;0;0;0;0;0;0;0;0;0;0
FR;9;2022-02-17;0;0;0;0;0;0;0;0;0;0;0;0;0;0;0;0;0;0
FR;9;2022-02-18;0;0;0;0;0;0;0;0;0;0;0;0;0;0;0;0;0;0
FR;9;2022-02-19;0;0;0;0;0;0;0;0;0;0;0;0;0;0;0;0;0;0
FR;9;2022-02-20;0;0;0;0;0;0;0;0;0;0;0;0;0;0;0;0;0;0
FR;9;2022-02-21;0;0;0;0;0;0;0;0;0;0;0;0;0;0;0;0;0;0
FR;9;2022-02-22;0;0;0;0;0;0;0;0;0;0;0;0;0;0;0;0;0;0
FR;9;2022-02-23;0;0;0;0;0;0;0;0;0;0;0;0;0;0;0;0;0;0
FR;9;2022-02-24;0;0;0;0;0;0;0;0;0;0;0;0;0;0;0;0;0;0
FR;9;2022-02-25;0;0;0;0;0;0;0;0;0;0;0;0;0;0;0;0;0;0
FR;9;2022-02-26;0;0;0;0;0;0;0;0;0;0;0;0;0;0;0;0;0;0
FR;9;2022-02-27;0;0;0;0;0;0;0;0;0;0;0;0;0;0;0;0;0;0
FR;9;2022-02-28;0;0;0;0;0;0;0;0;0;0;0;0;0;0;0;0;0;0
FR;9;2022-03-01;0;0;0;0;0;0;0;0;0;0;0;0;0;0;0;0;0;0
FR;9;2022-03-02;0;0;0;0;0;0;0;0;0;0;0;0;0;0;0;0;0;0
FR;9;2022-03-03;0;0;0;0;0;0;0;0;0;0;0;0;0;0;0;0;0;0
FR;9;2022-03-04;0;0;0;0;0;0;0;0;0;0;0;0;0;0;0;0;0;0
FR;9;2022-03-05;0;0;0;0;0;0;0;0;0;0;0;0;0;0;0;0;0;0
FR;9;2022-03-06;0;0;0;0;0;0;0;0;0;0;0;0;0;0;0;0;0;0
FR;9;2022-03-07;0;0;0;0;0;0;0;0;0;0;0;0;0;0;0;0;0;0
FR;9;2022-03-08;0;0;0;0;0;0;0;0;0;0;0;0;0;0;0;0;0;0
FR;9;2022-03-09;0;0;0;0;0;0;0;0;0;0;0;0;0;0;0;0;0;0
FR;9;2022-03-10;0;0;0;0;0;0;0;0;0;0;0;0;0;0;0;0;0;0
FR;9;2022-03-11;0;0;0;0;0;0;0;0;0;0;0;0;0;0;0;0;0;0
FR;9;2022-03-12;0;0;0;0;0;0;0;0;0;0;0;0;0;0;0;0;0;0
FR;9;2022-03-13;0;0;0;0;0;0;0;0;0;0;0;0;0;0;0;0;0;0
FR;9;2022-03-14;0;0;0;0;0;0;0;0;0;0;0;0;0;0;0;0;0;0
FR;9;2022-03-15;0;0;0;0;0;0;0;0;0;0;0;0;0;0;0;0;0;0
FR;9;2022-03-16;0;0;0;0;0;0;0;0;0;0;0;0;0;0;0;0;0;0
FR;9;2022-03-17;0;0;0;0;0;0;0;0;0;0;0;0;0;0;0;0;0;0
FR;9;2022-03-18;0;0;0;0;0;0;0;0;0;0;0;0;0;0;0;0;0;0
FR;9;2022-03-19;0;0;0;0;0;0;0;0;0;0;0;0;0;0;0;0;0;0
FR;9;2022-03-20;0;0;0;0;0;0;0;0;0;0;0;0;0;0;0;0;0;0
FR;9;2022-03-21;0;0;0;0;0;0;0;0;0;0;0;0;0;0;0;0;0;0
FR;9;2022-03-22;0;0;0;0;0;0;0;0;0;0;0;0;0;0;0;0;0;0
FR;9;2022-03-23;0;0;0;0;0;0;0;0;0;0;0;0;0;0;0;0;0;0
FR;9;2022-03-24;0;0;0;0;0;0;0;0;0;0;0;0;0;0;0;0;0;0
FR;9;2022-03-25;0;0;0;0;0;0;0;0;0;0;0;0;0;0;0;0;0;0
FR;9;2022-03-26;0;0;0;0;0;0;0;0;0;0;0;0;0;0;0;0;0;0
FR;9;2022-03-27;0;0;0;0;0;0;0;0;0;0;0;0;0;0;0;0;0;0
FR;9;2022-03-28;0;0;0;0;0;0;0;0;0;0;0;0;0;0;0;0;0;0
FR;9;2022-03-29;0;0;0;0;0;0;0;0;0;0;0;0;0;0;0;0;0;0
FR;9;2022-03-30;0;0;0;0;0;0;0;0;0;0;0;0;0;0;0;0;0;0
FR;9;2022-03-31;0;0;0;0;0;0;0;0;0;0;0;0;0;0;0;0;0;0
FR;9;2022-04-01;0;0;0;0;0;0;0;0;0;0;0;0;0;0;0;0;0;0
FR;9;2022-04-02;0;0;0;0;0;0;0;0;0;0;0;0;0;0;0;0;0;0
FR;9;2022-04-03;0;0;0;0;0;0;0;0;0;0;0;0;0;0;0;0;0;0
FR;9;2022-04-04;0;0;0;0;0;0;0;0;0;0;0;0;0;0;0;0;0;0
FR;9;2022-04-05;0;0;0;0;0;0;0;0;0;0;0;0;0;0;0;0;0;0
FR;9;2022-04-06;0;0;0;0;0;0;0;0;0;0;0;0;0;0;0;0;0;0
FR;9;2022-04-07;0;0;0;0;0;0;0;0;0;0;0;0;0;0;0;0;0;0
FR;9;2022-04-08;0;0;0;0;0;0;0;0;0;0;0;0;0;0;0;0;0;0
FR;9;2022-04-09;0;0;0;0;0;0;0;0;0;0;0;0;0;0;0;0;0;0
FR;9;2022-04-10;0;0;0;0;0;0;0;0;0;0;0;0;0;0;0;0;0;0
FR;9;2022-04-11;0;0;0;0;0;0;0;0;0;0;0;0;0;0;0;0;0;0
FR;9;2022-04-12;0;0;0;0;0;0;0;0;0;0;0;0;0;0;0;0;0;0
FR;9;2022-04-13;0;0;0;0;0;0;0;0;0;0;0;0;0;0;0;0;0;0
FR;9;2022-04-14;0;0;0;0;0;0;0;0;0;0;0;0;0;0;0;0;0;0
FR;9;2022-04-15;0;0;0;0;0;0;0;0;0;0;0;0;0;0;0;0;0;0
FR;9;2022-04-16;0;0;0;0;0;0;0;0;0;0;0;0;0;0;0;0;0;0
FR;9;2022-04-17;0;0;0;0;0;0;0;0;0;0;0;0;0;0;0;0;0;0
FR;9;2022-04-18;0;0;0;0;0;0;0;0;0;0;0;0;0;0;0;0;0;0
FR;9;2022-04-19;0;0;0;0;0;0;0;0;0;0;0;0;0;0;0;0;0;0
FR;9;2022-04-20;0;0;0;0;0;0;0;0;0;0;0;0;0;0;0;0;0;0
FR;9;2022-04-21;0;0;0;0;0;0;0;0;0;0;0;0;0;0;0;0;0;0
FR;9;2022-04-22;0;0;0;0;0;0;0;0;0;0;0;0;0;0;0;0;0;0
FR;9;2022-04-23;0;0;0;0;0;0;0;0;0;0;0;0;0;0;0;0;0;0
FR;9;2022-04-24;0;0;0;0;0;0;0;0;0;0;0;0;0;0;0;0;0;0
FR;9;2022-04-25;0;0;0;0;0;0;0;0;0;0;0;0;0;0;0;0;0;0
FR;9;2022-04-26;0;0;0;0;0;0;0;0;0;0;0;0;0;0;0;0;0;0
FR;9;2022-04-27;0;0;0;0;0;0;0;0;0;0;0;0;0;0;0;0;0;0
FR;9;2022-04-28;0;0;0;0;0;0;0;0;0;0;0;0;0;0;0;0;0;0
FR;9;2022-04-29;0;0;0;0;0;0;0;0;0;0;0;0;0;0;0;0;0;0
FR;9;2022-04-30;0;0;0;0;0;0;0;0;0;0;0;0;0;0;0;0;0;0
FR;9;2022-05-01;0;0;0;0;0;0;0;0;0;0;0;0;0;0;0;0;0;0
FR;9;2022-05-02;0;0;0;0;0;0;0;0;0;0;0;0;0;0;0;0;0;0
FR;9;2022-05-03;0;0;0;0;0;0;0;0;0;0;0;0;0;0;0;0;0;0
FR;9;2022-05-04;0;0;0;0;0;0;0;0;0;0;0;0;0;0;0;0;0;0
FR;9;2022-05-05;0;0;0;0;0;0;0;0;0;0;0;0;0;0;0;0;0;0
FR;9;2022-05-06;0;0;0;0;0;0;0;0;0;0;0;0;0;0;0;0;0;0
FR;9;2022-05-07;0;0;0;0;0;0;0;0;0;0;0;0;0;0;0;0;0;0
FR;9;2022-05-08;0;0;0;0;0;0;0;0;0;0;0;0;0;0;0;0;0;0
FR;9;2022-05-09;0;0;0;0;0;0;0;0;0;0;0;0;0;0;0;0;0;0
FR;9;2022-05-10;0;0;0;0;0;0;0;0;0;0;0;0;0;0;0;0;0;0
FR;9;2022-05-11;0;0;0;0;0;0;0;0;0;0;0;0;0;0;0;0;0;0
FR;9;2022-05-12;0;0;0;0;0;0;0;0;0;0;0;0;0;0;0;0;0;0
FR;9;2022-05-13;0;0;0;0;0;0;0;0;0;0;0;0;0;0;0;0;0;0
FR;9;2022-05-14;0;0;0;0;0;0;0;0;0;0;0;0;0;0;0;0;0;0
FR;9;2022-05-15;0;0;0;0;0;0;0;0;0;0;0;0;0;0;0;0;0;0
FR;9;2022-05-16;0;0;0;0;0;0;0;0;0;0;0;0;0;0;0;0;0;0
FR;9;2022-05-17;0;0;0;0;0;0;0;0;0;0;0;0;0;0;0;0;0;0
FR;9;2022-05-18;0;0;0;0;0;0;0;0;0;0;0;0;0;0;0;0;0;0
FR;9;2022-05-19;0;0;0;0;0;0;0;0;0;0;0;0;0;0;0;0;0;0
FR;9;2022-05-20;0;0;0;0;0;0;0;0;0;0;0;0;0;0;0;0;0;0
FR;9;2022-05-21;0;0;0;0;0;0;0;0;0;0;0;0;0;0;0;0;0;0
FR;9;2022-05-22;0;0;0;0;0;0;0;0;0;0;0;0;0;0;0;0;0;0
FR;9;2022-05-23;0;0;0;0;0;0;0;0;0;0;0;0;0;0;0;0;0;0
FR;9;2022-05-24;0;0;0;0;0;0;0;0;0;0;0;0;0;0;0;0;0;0
FR;9;2022-05-25;0;0;0;0;0;0;0;0;0;0;0;0;0;0;0;0;0;0
FR;9;2022-05-26;0;0;0;0;0;0;0;0;0;0;0;0;0;0;0;0;0;0
FR;9;2022-05-27;0;0;0;0;0;0;0;0;0;0;0;0;0;0;0;0;0;0
FR;9;2022-05-28;0;0;0;0;0;0;0;0;0;0;0;0;0;0;0;0;0;0
FR;9;2022-05-29;0;0;0;0;0;0;0;0;0;0;0;0;0;0;0;0;0;0
FR;9;2022-05-30;0;0;0;0;0;0;0;0;0;0;0;0;0;0;0;0;0;0
FR;9;2022-05-31;0;0;0;0;0;0;0;0;0;0;0;0;0;0;0;0;0;0
FR;9;2022-06-01;0;0;0;0;0;0;0;0;0;0;0;0;0;0;0;0;0;0
FR;9;2022-06-02;0;0;0;0;0;0;0;0;0;0;0;0;0;0;0;0;0;0
FR;9;2022-06-03;0;0;0;0;0;0;0;0;0;0;0;0;0;0;0;0;0;0
FR;9;2022-06-04;0;0;0;0;0;0;0;0;0;0;0;0;0;0;0;0;0;0
FR;9;2022-06-05;0;0;0;0;0;0;0;0;0;0;0;0;0;0;0;0;0;0
FR;9;2022-06-06;0;0;0;0;0;0;0;0;0;0;0;0;0;0;0;0;0;0
FR;9;2022-06-07;0;0;0;0;0;0;0;0;0;0;0;0;0;0;0;0;0;0
FR;9;2022-06-08;0;0;0;0;0;0;0;0;0;0;0;0;0;0;0;0;0;0
FR;9;2022-06-09;0;0;0;0;0;0;0;0;0;0;0;0;0;0;0;0;0;0
FR;9;2022-06-10;0;0;0;0;0;0;0;0;0;0;0;0;0;0;0;0;0;0
FR;9;2022-06-11;0;0;0;0;0;0;0;0;0;0;0;0;0;0;0;0;0;0
FR;9;2022-06-12;0;0;0;0;0;0;0;0;0;0;0;0;0;0;0;0;0;0
FR;9;2022-06-13;0;0;0;0;0;0;0;0;0;0;0;0;0;0;0;0;0;0
FR;9;2022-06-14;0;0;0;0;0;0;0;0;0;0;0;0;0;0;0;0;0;0
FR;9;2022-06-15;0;0;0;0;0;0;0;0;0;0;0;0;0;0;0;0;0;0
FR;9;2022-06-16;0;0;0;0;0;0;0;0;0;0;0;0;0;0;0;0;0;0
FR;9;2022-06-17;0;0;0;0;0;0;0;0;0;0;0;0;0;0;0;0;0;0
FR;9;2022-06-18;0;0;0;0;0;0;0;0;0;0;0;0;0;0;0;0;0;0
FR;9;2022-06-19;0;0;0;0;0;0;0;0;0;0;0;0;0;0;0;0;0;0
FR;9;2022-06-20;0;0;0;0;0;0;0;0;0;0;0;0;0;0;0;0;0;0
FR;9;2022-06-21;0;0;0;0;0;0;0;0;0;0;0;0;0;0;0;0;0;0
FR;9;2022-06-22;0;0;0;0;0;0;0;0;0;0;0;0;0;0;0;0;0;0
FR;9;2022-06-23;0;0;0;0;0;0;0;0;0;0;0;0;0;0;0;0;0;0
FR;9;2022-06-24;0;0;0;0;0;0;0;0;0;0;0;0;0;0;0;0;0;0
FR;9;2022-06-25;0;0;0;0;0;0;0;0;0;0;0;0;0;0;0;0;0;0
FR;9;2022-06-26;0;0;0;0;0;0;0;0;0;0;0;0;0;0;0;0;0;0
FR;9;2022-06-27;0;0;0;0;0;0;0;0;0;0;0;0;0;0;0;0;0;0
FR;9;2022-06-28;0;0;0;0;0;0;0;0;0;0;0;0;0;0;0;0;0;0
FR;9;2022-06-29;0;0;0;0;0;0;0;0;0;0;0;0;0;0;0;0;0;0
FR;9;2022-06-30;0;0;0;0;0;0;0;0;0;0;0;0;0;0;0;0;0;0
FR;9;2022-07-01;0;0;0;0;0;0;0;0;0;0;0;0;0;0;0;0;0;0
FR;9;2022-07-02;0;0;0;0;0;0;0;0;0;0;0;0;0;0;0;0;0;0
FR;9;2022-07-03;0;0;0;0;0;0;0;0;0;0;0;0;0;0;0;0;0;0
FR;9;2022-07-04;0;0;0;0;0;0;0;0;0;0;0;0;0;0;0;0;0;0
FR;9;2022-07-05;0;0;0;0;0;0;0;0;0;0;0;0;0;0;0;0;0;0
FR;9;2022-07-06;0;0;0;0;0;0;0;0;0;0;0;0;0;0;0;0;0;0
FR;9;2022-07-07;0;0;0;0;0;0;0;0;0;0;0;0;0;0;0;0;0;0
FR;9;2022-07-08;0;0;0;0;0;0;0;0;0;0;0;0;0;0;0;0;0;0
FR;9;2022-07-09;0;0;0;0;0;0;0;0;0;0;0;0;0;0;0;0;0;0
FR;9;2022-07-10;0;0;0;0;0;0;0;0;0;0;0;0;0;0;0;0;0;0
FR;9;2022-07-11;0;0;0;0;0;0;0;0;0;0;0;0;0;0;0;0;0;0
FR;9;2022-07-12;0;0;0;0;0;0;0;0;0;0;0;0;0;0;0;0;0;0
FR;9;2022-07-13;0;0;0;0;0;0;0;0;0;0;0;0;0;0;0;0;0;0
FR;9;2022-07-14;0;0;0;0;0;0;0;0;0;0;0;0;0;0;0;0;0;0
FR;9;2022-07-15;0;0;0;0;0;0;0;0;0;0;0;0;0;0;0;0;0;0
FR;9;2022-07-16;0;0;0;0;0;0;0;0;0;0;0;0;0;0;0;0;0;0
FR;9;2022-07-17;0;0;0;0;0;0;0;0;0;0;0;0;0;0;0;0;0;0
FR;9;2022-07-18;0;0;0;0;0;0;0;0;0;0;0;0;0;0;0;0;0;0
FR;9;2022-07-19;0;0;0;0;0;0;0;0;0;0;0;0;0;0;0;0;0;0
FR;9;2022-07-20;0;0;0;0;0;0;0;0;0;0;0;0;0;0;0;0;0;0
FR;9;2022-07-21;0;0;0;0;0;0;0;0;0;0;0;0;0;0;0;0;0;0
FR;9;2022-07-22;0;0;0;0;0;0;0;0;0;0;0;0;0;0;0;0;0;0
FR;9;2022-07-23;0;0;0;0;0;0;0;0;0;0;0;0;0;0;0;0;0;0
FR;9;2022-07-24;0;0;0;0;0;0;0;0;0;0;0;0;0;0;0;0;0;0
FR;9;2022-07-25;0;0;0;0;0;0;0;0;0;0;0;0;0;0;0;0;0;0
FR;9;2022-07-26;0;0;0;0;0;0;0;0;0;0;0;0;0;0;0;0;0;0
FR;9;2022-07-27;0;0;0;0;0;0;0;0;0;0;0;0;0;0;0;0;0;0
FR;9;2022-07-28;0;0;0;0;0;0;0;0;0;0;0;0;0;0;0;0;0;0
FR;9;2022-07-29;0;0;0;0;0;0;0;0;0;0;0;0;0;0;0;0;0;0
FR;9;2022-07-30;0;0;0;0;0;0;0;0;0;0;0;0;0;0;0;0;0;0
FR;9;2022-07-31;0;0;0;0;0;0;0;0;0;0;0;0;0;0;0;0;0;0
FR;9;2022-08-01;0;0;0;0;0;0;0;0;0;0;0;0;0;0;0;0;0;0
FR;9;2022-08-02;0;0;0;0;0;0;0;0;0;0;0;0;0;0;0;0;0;0
FR;9;2022-08-03;0;0;0;0;0;0;0;0;0;0;0;0;0;0;0;0;0;0
FR;9;2022-08-04;0;0;0;0;0;0;0;0;0;0;0;0;0;0;0;0;0;0
FR;9;2022-08-05;0;0;0;0;0;0;0;0;0;0;0;0;0;0;0;0;0;0
FR;9;2022-08-06;0;0;0;0;0;0;0;0;0;0;0;0;0;0;0;0;0;0
FR;9;2022-08-07;0;0;0;0;0;0;0;0;0;0;0;0;0;0;0;0;0;0
FR;9;2022-08-08;0;0;0;0;0;0;0;0;0;0;0;0;0;0;0;0;0;0
FR;9;2022-08-09;0;0;0;0;0;0;0;0;0;0;0;0;0;0;0;0;0;0
FR;9;2022-08-10;0;0;0;0;0;0;0;0;0;0;0;0;0;0;0;0;0;0
FR;9;2022-08-11;0;0;0;0;0;0;0;0;0;0;0;0;0;0;0;0;0;0
FR;9;2022-08-12;0;0;0;0;0;0;0;0;0;0;0;0;0;0;0;0;0;0
FR;9;2022-08-13;0;0;0;0;0;0;0;0;0;0;0;0;0;0;0;0;0;0
FR;9;2022-08-14;0;0;0;0;0;0;0;0;0;0;0;0;0;0;0;0;0;0
FR;9;2022-08-15;0;0;0;0;0;0;0;0;0;0;0;0;0;0;0;0;0;0
FR;9;2022-08-16;0;0;0;0;0;0;0;0;0;0;0;0;0;0;0;0;0;0
FR;9;2022-08-17;0;0;0;0;0;0;0;0;0;0;0;0;0;0;0;0;0;0
FR;9;2022-08-18;0;0;0;0;0;0;0;0;0;0;0;0;0;0;0;0;0;0
FR;9;2022-08-19;0;0;0;0;0;0;0;0;0;0;0;0;0;0;0;0;0;0
FR;9;2022-08-20;0;0;0;0;0;0;0;0;0;0;0;0;0;0;0;0;0;0
FR;9;2022-08-21;0;0;0;0;0;0;0;0;0;0;0;0;0;0;0;0;0;0
FR;9;2022-08-22;0;0;0;0;0;0;0;0;0;0;0;0;0;0;0;0;0;0
FR;9;2022-08-23;0;0;0;0;0;0;0;0;0;0;0;0;0;0;0;0;0;0
FR;9;2022-08-24;0;0;0;0;0;0;0;0;0;0;0;0;0;0;0;0;0;0
FR;9;2022-08-25;0;0;0;0;0;0;0;0;0;0;0;0;0;0;0;0;0;0
FR;9;2022-08-26;0;0;0;0;0;0;0;0;0;0;0;0;0;0;0;0;0;0
FR;9;2022-08-27;0;0;0;0;0;0;0;0;0;0;0;0;0;0;0;0;0;0
FR;9;2022-08-28;0;0;0;0;0;0;0;0;0;0;0;0;0;0;0;0;0;0
FR;9;2022-08-29;0;0;0;0;0;0;0;0;0;0;0;0;0;0;0;0;0;0
FR;9;2022-08-30;0;0;0;0;0;0;0;0;0;0;0;0;0;0;0;0;0;0
FR;9;2022-08-31;0;0;0;0;0;0;0;0;0;0;0;0;0;0;0;0;0;0
FR;9;2022-09-01;0;0;0;0;0;0;0;0;0;0;0;0;0;0;0;0;0;0
FR;9;2022-09-02;0;0;0;0;0;0;0;0;0;0;0;0;0;0;0;0;0;0
FR;9;2022-09-03;0;0;0;0;0;0;0;0;0;0;0;0;0;0;0;0;0;0
FR;9;2022-09-04;0;0;0;0;0;0;0;0;0;0;0;0;0;0;0;0;0;0
FR;9;2022-09-05;0;0;0;0;0;0;0;0;0;0;0;0;0;0;0;0;0;0
FR;9;2022-09-06;0;0;0;0;0;0;0;0;0;0;0;0;0;0;0;0;0;0
FR;9;2022-09-07;0;0;0;0;0;0;0;0;0;0;0;0;0;0;0;0;0;0
FR;9;2022-09-08;0;0;0;0;0;0;0;0;0;0;0;0;0;0;0;0;0;0
FR;9;2022-09-09;0;0;0;0;0;0;0;0;0;0;0;0;0;0;0;0;0;0
FR;9;2022-09-10;0;0;0;0;0;0;0;0;0;0;0;0;0;0;0;0;0;0
FR;9;2022-09-11;0;0;0;0;0;0;0;0;0;0;0;0;0;0;0;0;0;0
FR;9;2022-09-12;0;0;0;0;0;0;0;0;0;0;0;0;0;0;0;0;0;0
FR;9;2022-09-13;0;0;0;0;0;0;0;0;0;0;0;0;0;0;0;0;0;0
FR;9;2022-09-14;0;0;0;0;0;0;0;0;0;0;0;0;0;0;0;0;0;0
FR;9;2022-09-15;0;0;0;0;0;0;0;0;0;0;0;0;0;0;0;0;0;0
FR;9;2022-09-16;0;0;0;0;0;0;0;0;0;0;0;0;0;0;0;0;0;0
FR;9;2022-09-17;0;0;0;0;0;0;0;0;0;0;0;0;0;0;0;0;0;0
FR;9;2022-09-18;0;0;0;0;0;0;0;0;0;0;0;0;0;0;0;0;0;0
FR;9;2022-09-19;0;0;0;0;0;0;0;0;0;0;0;0;0;0;0;0;0;0
FR;9;2022-09-20;0;0;0;0;0;0;0;0;0;0;0;0;0;0;0;0;0;0
FR;9;2022-09-21;0;0;0;0;0;0;0;0;0;0;0;0;0;0;0;0;0;0
FR;9;2022-09-22;0;0;0;0;0;0;0;0;0;0;0;0;0;0;0;0;0;0
FR;9;2022-09-23;0;0;0;0;0;0;0;0;0;0;0;0;0;0;0;0;0;0
FR;9;2022-09-24;0;0;0;0;0;0;0;0;0;0;0;0;0;0;0;0;0;0
FR;9;2022-09-25;0;0;0;0;0;0;0;0;0;0;0;0;0;0;0;0;0;0
FR;9;2022-09-26;0;0;0;0;0;0;0;0;0;0;0;0;0;0;0;0;0;0
FR;9;2022-09-27;0;0;0;0;0;0;0;0;0;0;0;0;0;0;0;0;0;0
FR;9;2022-09-28;0;0;0;0;0;0;0;0;0;0;0;0;0;0;0;0;0;0
FR;9;2022-09-29;1;1;8;31;0;6;33;40;1;1;1;8;31;0;6;33;40;1
FR;9;2022-09-30;5;12;60;605;6;47;612;712;51;6;13;68;636;6;53;645;752;52
FR;9;2022-10-01;9;1;43;327;2;26;335;396;35;15;14;111;963;8;79;980;1148;87
FR;9;2022-10-02;1;1;5;50;0;4;51;66;11;16;15;116;1013;8;83;1031;1214;98
FR;9;2022-10-03;10;16;151;1713;10;129;1707;2073;234;26;31;267;2726;18;212;2738;3287;332
FR;9;2022-10-04;20;48;353;3952;18;228;4020;4701;449;46;79;620;6678;36;440;6758;7988;781
FR;9;2022-10-05;27;19;269;2997;16;203;3010;3655;433;73;98;889;9675;52;643;9768;11643;1214
FR;9;2022-10-06;23;34;399;4598;17;300;4631;5608;672;96;132;1288;14273;69;943;14399;17251;1886
FR;9;2022-10-07;29;50;499;5702;19;384;5716;7025;923;125;182;1787;19975;88;1327;20115;24276;2809
FR;9;2022-10-08;10;18;128;1088;8;86;1106;1386;190;135;200;1915;21063;96;1413;21221;25662;2999
FR;9;2022-10-09;1;7;22;197;1;29;198;277;50;136;207;1937;21260;97;1442;21419;25939;3049
FR;9;2022-10-10;11;26;207;2572;14;181;2576;3296;533;147;233;2144;23832;111;1623;23995;29235;3582
FR;9;2022-10-11;31;40;424;5042;27;312;5023;6196;851;178;273;2568;28874;138;1935;29018;35431;4433
FR;9;2022-10-12;22;26;297;2984;16;212;3042;3827;571;200;299;2865;31858;154;2147;32060;39258;5004
FR;9;2022-10-13;25;42;374;3979;16;244;4036;5025;739;225;341;3239;35837;170;2391;36096;44283;5743
FR;9;2022-10-14;27;26;381;4427;12;293;4410;5553;839;252;367;3620;40264;182;2684;40506;49836;6582
FR;9;2022-10-15;13;8;101;1051;7;79;1028;1307;198;265;375;3721;41315;189;2763;41534;51143;6780
FR;9;2022-10-16;4;1;9;131;2;12;125;167;28;269;376;3730;41446;191;2775;41659;51310;6808
FR;9;2022-10-17;4;22;165;1875;11;127;1883;2492;475;273;398;3895;43321;202;2902;43542;53802;7283
FR;9;2022-10-18;35;28;315;3426;17;226;3436;4623;952;308;426;4210;46747;219;3128;46978;58425;8235
FR;9;2022-10-19;22;19;262;2687;16;174;2717;3725;819;330;445;4472;49434;235;3302;49695;62150;9054
FR;9;2022-10-20;21;22;308;3625;8;232;3626;4798;932;351;467;4780;53059;243;3534;53321;66948;9986
FR;9;2022-10-21;14;31;324;3523;10;226;3542;4635;859;365;498;5104;56582;253;3760;56863;71583;10845
FR;9;2022-10-22;10;11;90;914;8;62;919;1193;207;375;509;5194;57496;261;3822;57782;72776;11052
FR;9;2022-10-23;2;2;17;99;2;10;104;147;33;377;511;5211;57595;263;3832;57886;72923;11085
FR;9;2022-10-24;7;17;158;1361;6;104;1430;1934;395;384;528;5369;58956;269;3936;59316;74857;11480
FR;9;2022-10-25;18;22;227;2837;16;188;2846;3907;870;402;550;5596;61793;285;4124;62162;78764;12350
FR;9;2022-10-26;14;16;169;1796;13;123;1810;2518;583;416;566;5765;63589;298;4247;63972;81282;12933
FR;9;2022-10-27;9;26;230;2291;15;173;2324;3170;662;425;592;5995;65880;313;4420;66296;84452;13595
FR;9;2022-10-28;18;27;224;2277;17;151;2301;3139;680;443;619;6219;68157;330;4571;68597;87591;14275
FR;9;2022-10-29;12;8;55;505;5;46;496;662;119;455;627;6274;68662;335;4617;69093;88253;14394
FR;9;2022-10-30;2;1;8;58;1;8;58;82;16;457;628;6282;68720;336;4625;69151;88335;14410
FR;9;2022-10-31;13;7;105;658;9;59;693;986;232;470;635;6387;69378;345;4684;69844;89321;14642
FR;9;2022-11-01;1;1;15;43;0;11;49;71;11;471;636;6402;69421;345;4695;69893;89392;14653
FR;9;2022-11-02;7;12;102;1019;4;76;1037;1567;450;478;648;6504;70440;349;4771;70930;90959;15103
FR;9;2022-11-03;17;17;155;1583;15;90;1631;2325;594;495;665;6659;72023;364;4861;72561;93284;15697
FR;9;2022-11-04;21;18;193;1747;14;121;1795;2522;601;516;683;6852;73770;378;4982;74356;95806;16298
FR;9;2022-11-05;8;10;58;403;9;39;424;573;107;524;693;6910;74173;387;5021;74780;96379;16405
FR;9;2022-11-06;5;4;5;61;6;2;60;87;25;529;697;6915;74234;393;5023;74840;96466;16430
FR;9;2022-11-07;16;19;88;915;16;109;922;1461;424;545;716;7003;75149;409;5132;75762;97927;16854
FR;9;2022-11-08;10;18;164;1798;12;132;1794;2633;702;555;734;7167;76947;421;5264;77556;100560;17556
FR;9;2022-11-09;16;16;123;1260;9;98;1321;1877;453;571;750;7290;78207;430;5362;78877;102437;18009
FR;9;2022-11-10;12;21;155;1584;13;134;1581;2233;515;583;771;7445;79791;443;5496;80458;104670;18524
FR;9;2022-11-11;1;1;13;81;1;6;83;123;34;584;772;7458;79872;444;5502;80541;104793;18558
FR;9;2022-11-12;5;8;44;259;7;19;278;395;97;589;780;7502;80131;451;5521;80819;105188;18655
FR;9;2022-11-13;2;0;4;30;0;4;31;51;16;591;780;7506;80161;451;5525;80850;105239;18671
FR;9;2022-11-14;11;12;56;707;11;44;722;1107;338;602;792;7562;80868;462;5569;81572;106346;19009
FR;9;2022-11-15;16;16;146;1308;7;103;1318;2033;607;618;808;7708;82176;469;5672;82890;108379;19616
FR;9;2022-11-16;10;4;99;977;7;58;996;1486;428;628;812;7807;83153;476;5730;83886;109865;20044
FR;9;2022-11-17;7;15;121;1068;10;74;1091;1638;468;635;827;7928;84221;486;5804;84977;111503;20512
FR;9;2022-11-18;7;16;119;1434;5;76;1450;2011;483;642;843;8047;85655;491;5880;86427;113514;20995
FR;9;2022-11-19;3;5;49;352;1;26;338;475;106;645;848;8096;86007;492;5906;86765;113989;21101
FR;9;2022-11-20;1;0;5;37;0;3;35;54;16;646;848;8101;86044;492;5909;86800;114043;21117
FR;9;2022-11-21;8;12;65;627;5;51;630;949;261;654;860;8166;86671;497;5960;87430;114992;21378
FR;9;2022-11-22;15;12;121;1036;13;74;1066;1590;448;669;872;8287;87707;510;6034;88496;116582;21826
FR;9;2022-11-23;6;10;67;710;5;33;736;1133;359;675;882;8354;88417;515;6067;89232;117715;22185
FR;9;2022-11-24;8;19;91;922;14;66;939;1396;386;683;901;8445;89339;529;6133;90171;119111;22571
FR;9;2022-11-25;7;10;106;1168;7;80;1185;1736;470;690;911;8551;90507;536;6213;91356;120847;23041
FR;9;2022-11-26;6;6;35;217;7;24;211;307;68;696;917;8586;90724;543;6237;91567;121154;23109
FR;9;2022-11-27;1;1;6;42;0;2;46;82;34;697;918;8592;90766;543;6239;91613;121236;23143
FR;9;2022-11-28;5;7;98;689;7;57;716;1107;329;702;925;8690;91455;550;6296;92329;122343;23472
FR;9;2022-11-29;4;17;137;1291;6;83;1320;1923;515;706;942;8827;92746;556;6379;93649;124266;23987
FR;9;2022-11-30;9;12;99;1025;5;76;1048;1598;469;715;954;8926;93771;561;6455;94697;125864;24456
FR;9;2022-12-01;15;14;111;1326;8;80;1311;1933;538;730;968;9037;95097;569;6535;96008;127797;24994
FR;9;2022-12-02;10;13;183;1808;10;99;1808;2597;684;740;981;9220;96905;579;6634;97816;130394;25678
FR;9;2022-12-03;6;9;78;616;5;40;630;883;207;746;990;9298;97521;584;6674;98446;131277;25885
FR;9;2022-12-04;9;4;15;105;5;8;105;153;40;755;994;9313;97626;589;6682;98551;131430;25925
FR;9;2022-12-05;19;24;144;1391;17;98;1407;2092;580;774;1018;9457;99017;606;6780;99958;133522;26505
FR;9;2022-12-06;30;21;260;2425;20;145;2520;3764;1081;804;1039;9717;101442;626;6925;102478;137286;27586
FR;9;2022-12-07;15;22;180;1835;20;108;1880;2800;804;819;1061;9897;103277;646;7033;104358;140086;28390
FR;9;2022-12-08;13;22;218;2368;15;119;2425;3594;1036;832;1083;10115;105645;661;7152;106783;143680;29426
FR;9;2022-12-09;14;25;284;2854;10;141;2934;4250;1167;846;1108;10399;108499;671;7293;109717;147930;30593
FR;9;2022-12-10;12;12;120;1295;4;55;1318;1784;405;858;1120;10519;109794;675;7348;111035;149714;30998
FR;9;2022-12-11;5;4;21;277;5;10;283;363;66;863;1124;10540;110071;680;7358;111318;150077;31064
FR;9;2022-12-12;17;13;209;1923;12;106;2000;2838;727;880;1137;10749;111994;692;7464;113318;152915;31791
FR;9;2022-12-13;27;18;296;2998;13;130;3131;4553;1281;907;1155;11045;114992;705;7594;116449;157468;33072
FR;0;2020-12-27;614;0;0;0;55;0;0;0;0;614;0;0;0;55;0;0;0;0
FR;0;2020-12-28;698;1;0;0;42;0;0;0;0;1312;1;0;0;97;0;0;0;0
FR;0;2020-12-29;387;0;0;0;19;0;0;0;0;1699;1;0;0;116;0;0;0;0
FR;0;2020-12-30;449;0;0;0;18;0;0;0;0;2148;1;0;0;134;0;0;0;0
FR;0;2020-12-31;446;1;0;0;23;0;0;0;0;2594;2;0;0;157;0;0;0;0
FR;0;2021-01-01;1181;2;0;0;65;0;0;0;0;3775;4;0;0;222;0;0;0;0
FR;0;2021-01-02;366;3;0;0;28;0;0;0;0;4141;7;0;0;250;0;0;0;0
FR;0;2021-01-03;409;0;0;0;23;0;0;0;0;4550;7;0;0;273;0;0;0;0
FR;0;2021-01-04;2126;4;0;0;50;0;0;0;0;6676;11;0;0;323;0;0;0;0
FR;0;2021-01-05;7761;6;0;0;129;0;0;0;0;14437;17;0;0;452;0;0;0;0
FR;0;2021-01-06;12466;23;0;0;126;0;0;0;0;26903;40;0;0;578;0;0;0;0
FR;0;2021-01-07;29472;22;0;0;159;0;0;0;0;56375;62;0;0;737;0;0;0;0
FR;0;2021-01-08;37158;33;0;0;204;0;0;0;0;93533;95;0;0;941;0;0;0;0
FR;0;2021-01-09;11219;9;0;0;77;0;0;0;0;104752;104;0;0;1018;0;0;0;0
FR;0;2021-01-10;6011;8;0;0;28;0;0;0;0;110763;112;0;0;1046;0;0;0;0
FR;0;2021-01-11;39951;34;0;0;227;0;0;0;0;150714;146;0;0;1273;0;0;0;0
FR;0;2021-01-12;62153;25;0;0;299;0;0;0;0;212867;171;0;0;1572;0;0;0;0
FR;0;2021-01-13;65142;55;0;0;429;0;0;0;0;278009;226;0;0;2001;0;0;0;0
FR;0;2021-01-14;83111;215;0;0;1170;0;0;0;0;361120;441;0;0;3171;0;0;0;0
FR;0;2021-01-15;69022;88;0;0;550;0;0;0;0;430142;529;0;0;3721;0;0;0;0
FR;0;2021-01-16;20218;73;0;0;184;0;0;0;0;450360;602;0;0;3905;0;0;0;0
FR;0;2021-01-17;10989;52;0;0;136;0;0;0;0;461349;654;0;0;4041;0;0;0;0
FR;0;2021-01-18;85916;176;0;0;614;0;0;0;0;547265;830;0;0;4655;0;0;0;0
FR;0;2021-01-19;130610;205;0;0;865;0;0;0;0;677875;1035;0;0;5520;0;0;0;0
FR;0;2021-01-20;137562;191;0;0;843;0;0;0;0;815437;1226;0;0;6363;0;0;0;0
FR;0;2021-01-21;158420;198;0;0;947;0;0;0;0;973857;1424;0;0;7310;0;0;0;0
FR;0;2021-01-22;121078;249;0;0;841;0;0;0;0;1094935;1673;0;0;8151;0;0;0;0
FR;0;2021-01-23;38489;80;0;0;217;0;0;0;0;1133424;1753;0;0;8368;0;0;0;0
FR;0;2021-01-24;9748;119;0;0;184;0;0;0;0;1143172;1872;0;0;8552;0;0;0;0
FR;0;2021-01-25;78249;1427;0;0;1780;0;0;0;0;1221421;3299;0;0;10332;0;0;0;0
FR;0;2021-01-26;100389;3668;1;0;4147;0;0;0;0;1321810;6967;1;0;14479;0;0;0;0
FR;0;2021-01-27;107260;6360;0;0;7078;0;0;0;0;1429070;13327;1;0;21557;0;0;0;0
FR;0;2021-01-28;124374;16254;0;0;17076;0;0;0;0;1553444;29581;1;0;38633;0;0;0;0
FR;0;2021-01-29;92196;18623;0;0;19197;0;0;0;0;1645640;48204;1;0;57830;0;0;0;0
FR;0;2021-01-30;29128;4500;0;0;4633;0;0;0;0;1674768;52704;1;0;62463;0;0;0;0
FR;0;2021-01-31;5239;1887;0;0;1929;0;0;0;0;1680007;54591;1;0;64392;0;0;0;0
FR;0;2021-02-01;53144;22747;0;0;23008;0;0;0;0;1733151;77338;1;0;87400;0;0;0;0
FR;0;2021-02-02;72329;37825;0;0;38319;0;0;0;0;1805480;115163;1;0;125719;0;0;0;0
FR;0;2021-02-03;72321;39900;0;0;40393;0;0;0;0;1877801;155063;1;0;166112;0;0;0;0
FR;0;2021-02-04;82087;54526;0;0;55114;0;0;0;0;1959888;209589;1;0;221226;0;0;0;0
FR;0;2021-02-05;68247;47828;0;0;48252;0;0;0;0;2028135;257417;1;0;269478;0;0;0;0
FR;0;2021-02-06;22973;11340;0;0;11577;0;0;0;0;2051108;268757;1;0;281055;0;0;0;0
FR;0;2021-02-07;5195;5975;0;0;6099;0;0;0;0;2056303;274732;1;0;287154;0;0;0;0
FR;0;2021-02-08;46853;48553;0;0;49014;0;0;0;0;2103156;323285;1;0;336168;0;0;0;0
FR;0;2021-02-09;66034;77770;0;0;78852;0;0;0;0;2169190;401055;1;0;415020;0;0;0;0
FR;0;2021-02-10;71035;82780;0;0;84067;0;0;0;0;2240225;483835;1;0;499087;0;0;0;0
FR;0;2021-02-11;87300;104883;0;0;106791;0;0;0;0;2327525;588718;1;0;605878;0;0;0;0
FR;0;2021-02-12;79348;75891;0;0;77616;0;0;0;0;2406873;664609;1;0;683494;0;0;0;0
FR;0;2021-02-13;22387;19536;0;0;19901;0;0;0;0;2429260;684145;1;0;703395;0;0;0;0
FR;0;2021-02-14;5079;7366;0;0;7491;0;0;0;0;2434339;691511;1;0;710886;0;0;0;0
FR;0;2021-02-15;38121;76685;0;0;77677;0;0;0;0;2472460;768196;1;0;788563;0;0;0;0
FR;0;2021-02-16;50409;99804;0;0;101122;0;0;0;0;2522869;868000;1;0;889685;0;0;0;0
FR;0;2021-02-17;50549;106559;20;0;107978;0;0;0;0;2573418;974559;21;0;997663;0;0;0;0
FR;0;2021-02-18;69805;123240;0;0;125253;0;0;0;0;2643223;1097799;21;0;1122916;0;0;0;0
FR;0;2021-02-19;65086;92065;1;0;93941;0;0;0;0;2708309;1189864;22;0;1216857;0;0;0;0
FR;0;2021-02-20;18596;28585;0;0;28944;0;0;0;0;2726905;1218449;22;0;1245801;0;0;0;0
FR;0;2021-02-21;3327;6109;0;0;6214;0;0;0;0;2730232;1224558;22;0;1252015;0;0;0;0
FR;0;2021-02-22;37506;73188;2;0;74184;0;0;0;0;2767738;1297746;24;0;1326199;0;0;0;0
FR;0;2021-02-23;53792;85205;1;0;86698;0;0;0;0;2821530;1382951;25;0;1412897;0;0;0;0
FR;0;2021-02-24;60030;82734;1;0;84297;0;0;0;0;2881560;1465685;26;0;1497194;0;0;0;0
FR;0;2021-02-25;100601;91353;1;0;94322;0;0;0;0;2982161;1557038;27;0;1591516;0;0;0;0
FR;0;2021-02-26;113486;70779;1;0;73901;0;0;0;0;3095647;1627817;28;0;1665417;0;0;0;0
FR;0;2021-02-27;52126;22398;1;0;23638;0;0;0;0;3147773;1650215;29;0;1689055;0;0;0;0
FR;0;2021-02-28;6207;4140;2;0;4336;0;0;0;0;3153980;1654355;31;0;1693391;0;0;0;0
FR;0;2021-03-01;65927;54024;1;0;55878;0;0;0;0;3219907;1708379;32;0;1749269;0;0;0;0
FR;0;2021-03-02;101407;67146;3;0;70178;0;0;0;0;3321314;1775525;35;0;1819447;0;0;0;0
FR;0;2021-03-03;116549;65482;0;0;69155;0;0;0;0;3437863;1841007;35;0;1888602;0;0;0;0
FR;0;2021-03-04;163652;72316;3;0;77875;0;0;0;0;3601515;1913323;38;0;1966477;0;0;0;0
FR;0;2021-03-05;200950;62733;3;0;69450;0;0;0;0;3802465;1976056;41;0;2035927;0;0;0;0
FR;0;2021-03-06;207979;17522;3;0;22824;0;0;0;0;4010444;1993578;44;0;2058751;0;0;0;0
FR;0;2021-03-07;121289;4124;1;0;7418;0;0;0;0;4131733;1997702;45;0;2066169;0;0;0;0
FR;0;2021-03-08;107168;49698;2;0;53170;0;0;0;0;4238901;2047400;47;0;2119339;0;0;0;0
FR;0;2021-03-09;172472;56162;2;0;61639;0;0;0;0;4411373;2103562;49;0;2180978;0;0;0;0
FR;0;2021-03-10;179031;57096;5;0;62759;0;0;0;0;4590404;2160658;54;0;2243737;0;0;0;0
FR;0;2021-03-11;242922;63980;2;0;72055;0;0;0;0;4833326;2224638;56;0;2315792;0;0;0;0
FR;0;2021-03-12;294861;53400;1;0;62853;0;0;0;0;5128187;2278038;57;0;2378645;0;0;0;0
FR;0;2021-03-13;231436;15263;1;0;21241;0;0;0;0;5359623;2293301;58;0;2399886;0;0;0;0
FR;0;2021-03-14;63358;3112;1;0;5148;0;0;0;0;5422981;2296413;59;0;2405034;0;0;0;0
FR;0;2021-03-15;158680;31609;3;0;36254;0;0;0;0;5581661;2328022;62;0;2441288;0;0;0;0
FR;0;2021-03-16;141588;38878;6;0;43016;0;0;0;0;5723249;2366900;68;0;2484304;0;0;0;0
FR;0;2021-03-17;150510;37657;4;0;42418;0;0;0;0;5873759;2404557;72;0;2526722;0;0;0;0
FR;0;2021-03-18;167858;44377;5;0;49926;0;0;0;0;6041617;2448934;77;0;2576648;0;0;0;0
FR;0;2021-03-19;230035;36797;2;0;44149;0;0;0;0;6271652;2485731;79;0;2620797;0;0;0;0
FR;0;2021-03-20;166711;11397;1;0;16022;0;0;0;0;6438363;2497128;80;0;2636819;0;0;0;0
FR;0;2021-03-21;49951;2176;1;0;3933;0;0;0;0;6488314;2499304;81;0;2640752;0;0;0;0
FR;0;2021-03-22;170073;33603;2;0;39096;0;0;0;0;6658387;2532907;83;0;2679848;0;0;0;0
FR;0;2021-03-23;250422;42399;1;0;50227;0;0;0;0;6908809;2575306;84;0;2730075;0;0;0;0
FR;0;2021-03-24;256934;43531;0;0;51611;0;0;0;0;7165743;2618837;84;0;2781686;0;0;0;0
FR;0;2021-03-25;341856;45246;5;0;56234;0;0;0;0;7507599;2664083;89;0;2837920;0;0;0;0
FR;0;2021-03-26;358835;41826;5;1;53574;0;0;0;0;7866434;2705909;94;1;2891494;0;0;0;0
FR;0;2021-03-27;195285;16935;1;0;23377;0;0;0;0;8061719;2722844;95;1;2914871;0;0;0;0
FR;0;2021-03-28;59347;4495;3;0;6559;0;0;0;0;8121066;2727339;98;1;2921430;0;0;0;0
FR;0;2021-03-29;203004;53493;4;0;60242;0;0;0;0;8324070;2780832;102;1;2981672;0;0;0;0
FR;0;2021-03-30;285515;69966;5;0;80365;0;0;0;0;8609585;2850798;107;1;3062037;0;0;0;0
FR;0;2021-03-31;263064;73880;4;0;84550;0;0;0;0;8872649;2924678;111;1;3146587;0;0;0;0
FR;0;2021-04-01;315549;92410;11;0;105968;0;0;0;0;9188198;3017088;122;1;3252555;0;0;0;0
FR;0;2021-04-02;281370;94556;7;0;106366;0;0;0;0;9469568;3111644;129;1;3358921;0;0;0;0
FR;0;2021-04-03;141085;62515;6;0;67767;0;0;0;0;9610653;3174159;135;1;3426688;0;0;0;0
FR;0;2021-04-04;46543;18987;2;0;21035;0;0;0;0;9657196;3193146;137;1;3447723;0;0;0;0
FR;0;2021-04-05;63357;10459;11;0;13114;0;0;0;0;9720553;3203605;148;1;3460837;0;0;0;0
FR;0;2021-04-06;217253;112639;17;0;121462;0;0;0;0;9937806;3316244;165;1;3582299;0;0;0;0
FR;0;2021-04-07;260295;115287;17;0;126614;0;0;0;0;10198101;3431531;182;1;3708913;0;0;0;0
FR;0;2021-04-08;337890;122925;15;0;138523;0;0;0;0;10535991;3554456;197;1;3847436;0;0;0;0
FR;0;2021-04-09;410199;116789;49;0;134175;0;0;0;0;10946190;3671245;246;1;3981611;0;0;0;0
FR;0;2021-04-10;212650;82857;15;0;91241;0;0;0;0;11158840;3754102;261;1;4072852;0;0;0;0
FR;0;2021-04-11;56152;34183;7;0;36709;0;0;0;0;11214992;3788285;268;1;4109561;0;0;0;0
FR;0;2021-04-12;237102;115776;46;0;125358;0;0;0;0;11452094;3904061;314;1;4234919;0;0;0;0
FR;0;2021-04-13;309524;144197;98;1;157138;0;0;0;0;11761618;4048258;412;2;4392057;0;0;0;0
FR;0;2021-04-14;294570;139708;215;0;153068;0;0;0;0;12056188;4187966;627;2;4545125;0;0;0;0
FR;0;2021-04-15;337156;150184;340;0;165692;0;0;0;0;12393344;4338150;967;2;4710817;0;0;0;0
FR;0;2021-04-16;339339;146870;354;0;161516;0;0;0;0;12732683;4485020;1321;2;4872333;0;0;0;0
FR;0;2021-04-17;188680;89970;109;0;97661;0;0;0;0;12921363;4574990;1430;2;4969994;0;0;0;0
FR;0;2021-04-18;51631;35446;47;0;37866;0;0;0;0;12972994;4610436;1477;2;5007860;0;0;0;0
FR;0;2021-04-19;205726;138244;456;0;147382;0;0;0;0;13178720;4748680;1933;2;5155242;0;0;0;0
FR;0;2021-04-20;254454;171769;569;0;183407;0;0;0;0;13433174;4920449;2502;2;5338649;0;0;0;0
FR;0;2021-04-21;253305;169900;836;0;181908;0;0;0;0;13686479;5090349;3338;2;5520557;0;0;0;0
FR;0;2021-04-22;287602;190206;819;0;204788;0;0;0;0;13974081;5280555;4157;2;5725345;0;0;0;0
FR;0;2021-04-23;297733;184504;747;0;203311;0;0;0;0;14271814;5465059;4904;2;5928656;0;0;0;0
FR;0;2021-04-24;190471;111965;252;0;122411;0;0;0;0;14462285;5577024;5156;2;6051067;0;0;0;0
FR;0;2021-04-25;69569;38828;51;0;42559;0;0;0;0;14531854;5615852;5207;2;6093626;0;0;0;0
FR;0;2021-04-26;220988;158282;563;0;171469;0;0;0;0;14752842;5774134;5770;2;6265095;0;0;0;0
FR;0;2021-04-27;284639;187903;941;0;211207;0;0;0;0;15037481;5962037;6711;2;6476302;0;0;0;0
FR;0;2021-04-28;299552;184467;1426;1;209539;1;0;0;0;15337033;6146504;8137;3;6685841;1;0;0;0
FR;0;2021-04-29;357179;197950;1281;0;233027;0;0;0;0;15694212;6344454;9418;3;6918868;1;0;0;0
FR;0;2021-04-30;372250;185837;1123;1;225176;0;0;0;0;16066462;6530291;10541;4;7144044;1;0;0;0
FR;0;2021-05-01;167667;52500;179;0;63749;0;0;0;0;16234129;6582791;10720;4;7207793;1;0;0;0
FR;0;2021-05-02;91763;37842;83;0;43564;0;0;0;0;16325892;6620633;10803;4;7251357;1;0;0;0
FR;0;2021-05-03;288955;165810;843;0;186328;0;0;0;0;16614847;6786443;11646;4;7437685;1;0;0;0
FR;0;2021-05-04;315722;225387;1235;0;251551;0;0;0;0;16930569;7011830;12881;4;7689236;1;0;0;0
FR;0;2021-05-05;327256;226233;1315;0;251296;0;0;0;0;17257825;7238063;14196;4;7940532;1;0;0;0
FR;0;2021-05-06;379562;240884;1634;0;275134;0;0;0;0;17637387;7478947;15830;4;8215666;1;0;0;0
FR;0;2021-05-07;372798;258578;1224;0;299639;0;0;0;0;18010185;7737525;17054;4;8515305;1;0;0;0
FR;0;2021-05-08;222173;70800;300;0;86009;0;0;0;0;18232358;7808325;17354;4;8601314;1;0;0;0
FR;0;2021-05-09;129719;44863;243;0;53497;0;0;0;0;18362077;7853188;17597;4;8654811;1;0;0;0
FR;0;2021-05-10;313413;229507;1238;0;255285;0;0;0;0;18675490;8082695;18835;4;8910096;1;0;0;0
FR;0;2021-05-11;403946;258245;1566;0;296663;0;0;0;0;19079436;8340940;20401;4;9206759;1;0;0;0
FR;0;2021-05-12;434164;233691;1544;0;269970;0;0;0;0;19513600;8574631;21945;4;9476729;1;0;0;0
FR;0;2021-05-13;338626;56532;432;0;78027;0;0;0;0;19852226;8631163;22377;4;9554756;1;0;0;0
FR;0;2021-05-14;454160;167476;1126;0;203071;0;0;0;0;20306386;8798639;23503;4;9757827;1;0;0;0
FR;0;2021-05-15;375000;94329;444;0;120723;0;0;0;0;20681386;8892968;23947;4;9878550;1;0;0;0
FR;0;2021-05-16;202766;20693;168;0;34090;0;0;0;0;20884152;8913661;24115;4;9912640;1;0;0;0
FR;0;2021-05-17;376137;148815;1555;0;178609;0;0;0;0;21260289;9062476;25670;4;10091249;1;0;0;0
FR;0;2021-05-18;460182;153924;1990;0;193071;0;0;0;0;21720471;9216400;27660;4;10284320;1;0;0;0
FR;0;2021-05-19;467435;142880;2465;0;180144;0;0;0;0;22187906;9359280;30125;4;10464464;1;0;0;0
FR;0;2021-05-20;507565;160258;2339;0;204236;0;0;0;0;22695471;9519538;32464;4;10668700;1;0;0;0
FR;0;2021-05-21;489695;175084;1996;0;221628;0;0;0;0;23185166;9694622;34460;4;10890328;1;0;0;0
FR;0;2021-05-22;347213;80182;670;0;108612;0;0;0;0;23532379;9774804;35130;4;10998940;1;0;0;0
FR;0;2021-05-23;161703;14234;246;0;26700;0;0;0;0;23694082;9789038;35376;4;11025640;1;0;0;0
FR;0;2021-05-24;263208;33108;604;0;52946;0;0;0;0;23957290;9822146;35980;4;11078586;1;0;0;0
FR;0;2021-05-25;400293;190380;2355;1;226939;0;0;0;0;24357583;10012526;38335;5;11305525;1;0;0;0
FR;0;2021-05-26;413480;190648;2226;0;228706;0;0;0;0;24771063;10203174;40561;5;11534231;1;0;0;0
FR;0;2021-05-27;449841;219854;2163;0;266991;0;0;0;0;25220904;10423028;42724;5;11801222;1;0;0;0
FR;0;2021-05-28;429576;260868;1894;0;318961;0;0;0;0;25650480;10683896;44618;5;12120183;1;0;0;0
FR;0;2021-05-29;298998;150346;586;0;183197;0;0;0;0;25949478;10834242;45204;5;12303380;1;0;0;0
FR;0;2021-05-30;107148;32529;164;0;42111;0;0;0;0;26056626;10866771;45368;5;12345491;1;0;0;0
FR;0;2021-05-31;358059;203410;1471;1;241692;1;0;0;0;26414685;11070181;46839;6;12587183;2;0;0;0
FR;0;2021-06-01;431079;251203;1968;1;302844;1;0;0;0;26845764;11321384;48807;7;12890027;3;0;0;0
FR;0;2021-06-02;420139;232360;1985;0;279729;0;0;0;0;27265903;11553744;50792;7;13169756;3;0;0;0
FR;0;2021-06-03;465649;257724;1825;0;312487;0;0;0;0;27731552;11811468;52617;7;13482243;3;0;0;0
FR;0;2021-06-04;456272;305673;1734;1;363057;1;0;0;0;28187824;12117141;54351;8;13845300;4;0;0;0
FR;0;2021-06-05;304817;189432;653;0;222641;0;0;0;0;28492641;12306573;55004;8;14067941;4;0;0;0
FR;0;2021-06-06;133328;49041;226;0;61181;0;0;0;0;28625969;12355614;55230;8;14129122;4;0;0;0
FR;0;2021-06-07;340005;261533;1528;0;298623;0;0;0;0;28965974;12617147;56758;8;14427745;4;0;0;0
FR;0;2021-06-08;393916;291282;1806;0;338142;0;0;0;0;29359890;12908429;58564;8;14765887;4;0;0;0
FR;0;2021-06-09;384899;274030;1734;0;318445;0;0;0;0;29744789;13182459;60298;8;15084332;4;0;0;0
FR;0;2021-06-10;404210;287003;1726;1;336439;0;0;0;0;30148999;13469462;62024;9;15420771;4;0;0;0
FR;0;2021-06-11;386681;356553;1467;1;406972;0;0;0;0;30535680;13826015;63491;10;15827743;4;0;0;0
FR;0;2021-06-12;283281;210981;497;0;243122;0;0;0;0;30818961;14036996;63988;10;16070865;4;0;0;0
FR;0;2021-06-13;104893;73860;204;0;84849;0;0;0;0;30923854;14110856;64192;10;16155714;4;0;0;0
FR;0;2021-06-14;240859;354264;1427;1;383433;0;0;0;0;31164713;14465120;65619;11;16539147;4;0;0;0
FR;0;2021-06-15;308191;384548;1574;1;423303;0;0;0;0;31472904;14849668;67193;12;16962450;4;0;0;0
FR;0;2021-06-16;313998;357486;1418;1;395238;0;0;0;0;31786902;15207154;68611;13;17357688;4;0;0;0
FR;0;2021-06-17;317710;372977;1431;1;414154;0;0;0;0;32104612;15580131;70042;14;17771842;4;0;0;0
FR;0;2021-06-18;321765;442577;1341;1;485963;0;0;0;0;32426377;16022708;71383;15;18257805;4;0;0;0
FR;0;2021-06-19;224354;273942;449;0;301122;0;0;0;0;32650731;16296650;71832;15;18558927;4;0;0;0
FR;0;2021-06-20;74446;102328;129;0;111519;0;0;0;0;32725177;16398978;71961;15;18670446;4;0;0;0
FR;0;2021-06-21;195792;401648;1038;1;427600;1;0;0;0;32920969;16800626;72999;16;19098046;5;0;0;0
FR;0;2021-06-22;223216;467610;1266;10;500255;1;0;0;0;33144185;17268236;74265;26;19598301;6;0;0;0
FR;0;2021-06-23;234058;439992;1197;1;474098;1;0;0;0;33378243;17708228;75462;27;20072399;7;0;0;0
FR;0;2021-06-24;241881;409632;1359;0;447130;0;0;0;0;33620124;18117860;76821;27;20519529;7;0;0;0
FR;0;2021-06-25;227653;522936;1401;0;561922;0;0;0;0;33847777;18640796;78222;27;21081451;7;0;0;0
FR;0;2021-06-26;153276;370945;587;1;395736;0;0;0;0;34001053;19011741;78809;28;21477187;7;0;0;0
FR;0;2021-06-27;55908;155971;169;1;164882;0;0;0;0;34056961;19167712;78978;29;21642069;7;0;0;0
FR;0;2021-06-28;154798;452523;1177;0;478122;0;0;0;0;34211759;19620235;80155;29;22120191;7;0;0;0
FR;0;2021-06-29;182728;507559;2123;0;538959;0;0;0;0;34394487;20127794;82278;29;22659150;7;0;0;0
FR;0;2021-06-30;204024;485071;2015;21;519357;2;0;0;0;34598511;20612865;84293;50;23178507;9;0;0;0
FR;0;2021-07-01;231419;458359;2224;5;498333;1;0;0;0;34829930;21071224;86517;55;23676840;10;0;0;0
FR;0;2021-07-02;228695;520043;2120;5;562375;2;0;0;0;35058625;21591267;88637;60;24239215;12;0;0;0
FR;0;2021-07-03;142050;368727;908;3;395218;1;0;0;0;35200675;21959994;89545;63;24634433;13;0;0;0
FR;0;2021-07-04;56759;141025;265;0;150723;0;0;0;0;35257434;22101019;89810;63;24785156;13;0;0;0
FR;0;2021-07-05;168527;418726;1668;8;448683;0;0;0;0;35425961;22519745;91478;71;25233839;13;0;0;0
FR;0;2021-07-06;196786;474505;1830;45;511123;8;0;0;0;35622747;22994250;93308;116;25744962;21;0;0;0
FR;0;2021-07-07;213224;439008;1879;25;477481;4;0;0;0;35835971;23433258;95187;141;26222443;25;0;0;0
FR;0;2021-07-08;231659;424128;2089;20;468093;4;0;0;0;36067630;23857386;97276;161;26690536;29;0;0;0
FR;0;2021-07-09;228628;511044;2185;4;557368;2;0;0;0;36296258;24368430;99461;165;27247904;31;0;0;0
FR;0;2021-07-10;148626;339897;986;1;368850;1;0;0;0;36444884;24708327;100447;166;27616754;32;0;0;0
FR;0;2021-07-11;60206;110058;283;0;120976;0;0;0;0;36505090;24818385;100730;166;27737730;32;0;0;0
FR;0;2021-07-12;169432;477826;1764;4;512597;0;0;0;0;36674522;25296211;102494;170;28250327;32;0;0;0
FR;0;2021-07-13;287274;526766;2050;8;585825;1;0;0;0;36961796;25822977;104544;178;28836152;33;0;0;0
FR;0;2021-07-14;181115;157422;435;0;186745;0;0;0;0;37142911;25980399;104979;178;29022897;33;0;0;0
FR;0;2021-07-15;347112;501704;2099;1;571706;0;0;0;0;37490023;26482103;107078;179;29594603;33;0;0;0
FR;0;2021-07-16;380118;495161;2023;3;574386;1;0;0;0;37870141;26977264;109101;182;30168989;34;0;0;0
FR;0;2021-07-17;259742;319650;877;1;368623;0;0;0;0;38129883;27296914;109978;183;30537612;34;0;0;0
FR;0;2021-07-18;109732;114585;310;0;133036;0;0;0;0;38239615;27411499;110288;183;30670648;34;0;0;0
FR;0;2021-07-19;285506;424079;1630;3;479123;0;0;0;0;38525121;27835578;111918;186;31149771;34;0;0;0
FR;0;2021-07-20;376931;451389;1724;0;523760;0;0;0;0;38902052;28286967;113642;186;31673531;34;0;0;0
FR;0;2021-07-21;395821;407051;1549;4;482079;1;0;0;0;39297873;28694018;115191;190;32155610;35;0;0;0
FR;0;2021-07-22;441067;387411;1715;4;471936;2;0;0;0;39738940;29081429;116906;194;32627546;37;0;0;0
FR;0;2021-07-23;440339;422196;1883;4;510193;1;0;0;0;40179279;29503625;118789;198;33137739;38;0;0;0
FR;0;2021-07-24;285256;269321;804;1;322022;0;0;0;0;40464535;29772946;119593;199;33459761;38;0;0;0
FR;0;2021-07-25;121118;79931;234;0;100295;0;0;0;0;40585653;29852877;119827;199;33560056;38;0;0;0
FR;0;2021-07-26;347436;322307;1614;3;384897;1;0;0;0;40933089;30175184;121441;202;33944953;39;0;0;0
FR;0;2021-07-27;464084;319416;1698;4;400596;1;0;0;0;41397173;30494600;123139;206;34345549;40;0;0;0
FR;0;2021-07-28;459452;289419;1636;4;367077;1;0;0;0;41856625;30784019;124775;210;34712626;41;0;0;0
FR;0;2021-07-29;489844;276229;1797;2;357156;0;0;0;0;42346469;31060248;126572;212;35069782;41;0;0;0
FR;0;2021-07-30;461842;302434;1941;5;380971;1;0;0;0;42808311;31362682;128513;217;35450753;42;0;0;0
FR;0;2021-07-31;285408;185013;915;1;231532;0;0;0;0;43093719;31547695;129428;218;35682285;42;0;0;0
FR;0;2021-08-01;112036;49922;255;0;65711;0;0;0;0;43205755;31597617;129683;218;35747996;42;0;0;0
FR;0;2021-08-02;341642;234091;1602;2;284834;0;0;0;0;43547397;31831708;131285;220;36032830;42;0;0;0
FR;0;2021-08-03;398625;244539;1728;2;304658;1;0;0;0;43946022;32076247;133013;222;36337488;43;0;0;0
FR;0;2021-08-04;384868;209568;1593;6;265739;3;0;0;0;44330890;32285815;134606;228;36603227;46;0;0;0
FR;0;2021-08-05;366181;228385;1711;0;281803;0;0;0;0;44697071;32514200;136317;228;36885030;46;0;0;0
FR;0;2021-08-06;359738;271269;1835;4;326714;0;0;0;0;45056809;32785469;138152;232;37211744;46;0;0;0
FR;0;2021-08-07;213135;178326;756;5;210081;1;0;0;0;45269944;32963795;138908;237;37421825;47;0;0;0
FR;0;2021-08-08;74194;63186;276;0;73618;0;0;0;0;45344138;33026981;139184;237;37495443;47;0;0;0
FR;0;2021-08-09;258768;258696;1548;4;297668;2;0;0;0;45602906;33285677;140732;241;37793111;49;0;0;0
FR;0;2021-08-10;306881;277184;1663;2;323621;0;0;0;0;45909787;33562861;142395;243;38116732;49;0;0;0
FR;0;2021-08-11;279753;259622;1441;5;301725;0;0;0;0;46189540;33822483;143836;248;38418457;49;0;0;0
FR;0;2021-08-12;271556;278105;1666;3;320426;0;0;0;0;46461096;34100588;145502;251;38738883;49;0;0;0
FR;0;2021-08-13;252163;278064;1594;3;316952;2;0;0;0;46713259;34378652;147096;254;39055835;51;0;0;0
FR;0;2021-08-14;145352;197106;740;0;219060;0;0;0;0;46858611;34575758;147836;254;39274895;51;0;0;0
FR;0;2021-08-15;39395;50098;218;1;55685;0;0;0;0;46898006;34625856;148054;255;39330580;51;0;0;0
FR;0;2021-08-16;186189;317566;1542;0;345536;0;0;0;0;47084195;34943422;149596;255;39676116;51;0;0;0
FR;0;2021-08-17;215697;335892;1636;7;368974;0;0;0;0;47299892;35279314;151232;262;40045090;51;0;0;0
FR;0;2021-08-18;199061;324416;1599;7;354625;4;0;0;0;47498953;35603730;152831;269;40399715;55;0;0;0
FR;0;2021-08-19;192041;325447;1641;1;356056;0;0;0;0;47690994;35929177;154472;270;40755771;55;0;0;0
FR;0;2021-08-20;186476;366240;1820;3;396734;2;0;0;0;47877470;36295417;156292;273;41152505;57;0;0;0
FR;0;2021-08-21;104805;238118;708;0;254576;0;0;0;0;47982275;36533535;157000;273;41407081;57;0;0;0
FR;0;2021-08-22;31944;87216;256;1;92174;1;0;0;0;48014219;36620751;157256;274;41499255;58;0;0;0
FR;0;2021-08-23;140984;357020;1561;3;379654;1;0;0;0;48155203;36977771;158817;277;41878909;59;0;0;0
FR;0;2021-08-24;162507;376646;1850;5;402941;0;0;0;0;48317710;37354417;160667;282;42281850;59;0;0;0
FR;0;2021-08-25;151152;350756;2034;8;375510;2;0;0;0;48468862;37705173;162701;290;42657360;61;0;0;0
FR;0;2021-08-26;142882;342755;2561;10;367616;0;0;0;0;48611744;38047928;165262;300;43024976;61;0;0;0
FR;0;2021-08-27;148453;388264;2790;11;415024;1;0;0;0;48760197;38436192;168052;311;43440000;62;0;0;0
FR;0;2021-08-28;90671;249611;1407;0;264981;0;0;0;0;48850868;38685803;169459;311;43704981;62;0;0;0
FR;0;2021-08-29;27321;83348;518;1;88277;0;0;0;0;48878189;38769151;169977;312;43793258;62;0;0;0
FR;0;2021-08-30;117425;324608;4713;6;342427;5862;0;0;0;48995614;39093759;174690;318;44135685;5924;0;0;0
FR;0;2021-08-31;128822;334486;10189;19;353962;11795;2;0;0;49124436;39428245;184879;337;44489647;17719;2;0;0
FR;0;2021-09-01;136151;285669;22435;8;302455;24399;1;0;0;49260587;39713914;207314;345;44792102;42118;3;0;0
FR;0;2021-09-02;114659;247207;26520;20;262141;28992;0;0;0;49375246;39961121;233834;365;45054243;71110;3;0;0
FR;0;2021-09-03;118314;292661;29967;24;309353;33071;1;0;0;49493560;40253782;263801;389;45363596;104181;4;0;0
FR;0;2021-09-04;89891;217781;12587;12;230513;14147;7;0;0;49583451;40471563;276388;401;45594109;118328;11;0;0
FR;0;2021-09-05;21361;44816;4395;2;48306;4715;0;0;0;49604812;40516379;280783;403;45642415;123043;11;0;0
FR;0;2021-09-06;75693;180557;31956;16;190748;34314;2;0;0;49680505;40696936;312739;419;45833163;157357;13;0;0
FR;0;2021-09-07;80312;181199;33248;43;191111;36297;2;0;0;49760817;40878135;345987;462;46024274;193654;15;0;0
FR;0;2021-09-08;91001;206074;29668;28;216598;32559;4;0;0;49851818;41084209;375655;490;46240872;226213;19;0;0
FR;0;2021-09-09;76954;165322;33080;27;174160;36688;5;0;0;49928772;41249531;408735;517;46415032;262901;24;0;0
FR;0;2021-09-10;96040;203795;35739;28;214934;40757;7;0;0;50024812;41453326;444474;545;46629966;303658;31;0;0
FR;0;2021-09-11;67166;169318;12140;19;178202;14396;0;0;0;50091978;41622644;456614;564;46808168;318054;31;0;0
FR;0;2021-09-12;12826;32098;2782;1;34150;3187;2;0;0;50104804;41654742;459396;565;46842318;321241;33;0;0
FR;0;2021-09-13;64569;126198;41241;35;134247;44242;17;0;0;50169373;41780940;500637;600;46976565;365483;50;0;0
FR;0;2021-09-14;73496;129027;56378;80;135847;62386;38;0;0;50242869;41909967;557015;680;47112412;427869;88;0;0
FR;0;2021-09-15;76649;167772;55670;58;174728;54848;77;0;0;50319518;42077739;612685;738;47287140;482717;165;0;0
FR;0;2021-09-16;63885;114503;60098;82;117894;60156;74;0;0;50383403;42192242;672783;820;47405034;542873;239;0;0
FR;0;2021-09-17;75088;156830;53858;71;159732;57331;69;0;0;50458491;42349072;726641;891;47564766;600204;308;0;0
FR;0;2021-09-18;48239;139633;15600;25;144323;17316;20;0;0;50506730;42488705;742241;916;47709089;617520;328;0;0
FR;0;2021-09-19;7908;23663;2439;1;24891;2617;1;0;0;50514638;42512368;744680;917;47733980;620137;329;0;0
FR;0;2021-09-20;44574;93774;50084;72;96267;50341;37;0;0;50559212;42606142;794764;989;47830247;670478;366;0;0
FR;0;2021-09-21;45906;98386;62765;77;98399;63495;83;0;0;50605118;42704528;857529;1066;47928646;733973;449;0;0
FR;0;2021-09-22;48692;142386;55375;82;144844;55455;49;0;0;50653810;42846914;912904;1148;48073490;789428;498;0;0
FR;0;2021-09-23;43289;92073;62400;95;91278;63585;96;0;0;50697099;42938987;975304;1243;48164768;853013;594;0;0
FR;0;2021-09-24;52313;133301;54563;107;132413;59216;79;0;0;50749412;43072288;1029867;1350;48297181;912229;673;0;0
FR;0;2021-09-25;35220;115652;16276;36;118648;18309;22;0;0;50784632;43187940;1046143;1386;48415829;930538;695;0;0
FR;0;2021-09-26;5556;17803;2272;5;18686;2331;5;0;0;50790188;43205743;1048415;1391;48434515;932869;700;0;0
FR;0;2021-09-27;33982;76914;47203;97;78806;48184;84;0;1;50824170;43282657;1095618;1488;48513321;981053;784;0;1
FR;0;2021-09-28;36520;75235;54974;90;74329;56577;51;0;0;50860690;43357892;1150592;1578;48587650;1037630;835;0;1
FR;0;2021-09-29;44420;100716;53366;112;102876;54898;45;0;0;50905110;43458608;1203958;1690;48690526;1092528;880;0;1
FR;0;2021-09-30;36344;72962;57043;96;71478;59592;62;0;0;50941454;43531570;1261001;1786;48762004;1152120;942;0;1
FR;0;2021-10-01;61712;102874;57828;108;101449;63991;26;0;0;51003166;43634444;1318829;1894;48863453;1216111;968;0;1
FR;0;2021-10-02;39470;78447;20963;39;81738;23379;12;0;0;51042636;43712891;1339792;1933;48945191;1239490;980;0;1
FR;0;2021-10-03;5288;10495;2533;4;11261;2539;4;0;0;51047924;43723386;1342325;1937;48956452;1242029;984;0;1
FR;0;2021-10-04;35197;58486;52629;84;59502;54841;39;0;0;51083121;43781872;1394954;2021;49015954;1296870;1023;0;1
FR;0;2021-10-05;33928;64372;61027;135;62120;65097;52;0;0;51117049;43846244;1455981;2156;49078074;1361967;1075;0;1
FR;0;2021-10-06;42721;79293;65762;113;80182;68372;31;0;0;51159770;43925537;1521743;2269;49158256;1430339;1106;0;1
FR;0;2021-10-07;30567;62275;65440;89;59509;68867;43;0;0;51190337;43987812;1587183;2358;49217765;1499206;1149;0;1
FR;0;2021-10-08;49480;91931;77769;111;89893;84792;42;0;0;51239817;44079743;1664952;2469;49307658;1583998;1191;0;1
FR;0;2021-10-09;33677;60928;31547;35;64132;33925;17;0;0;51273494;44140671;1696499;2504;49371790;1617923;1208;0;1
FR;0;2021-10-10;4720;7430;3196;9;7945;3476;2;0;0;51278214;44148101;1699695;2513;49379735;1621399;1210;0;1
FR;0;2021-10-11;30732;49918;61047;105;50635;64111;52;0;0;51308946;44198019;1760742;2618;49430370;1685510;1262;0;1
FR;0;2021-10-12;31640;54493;70628;141;51347;76026;27;0;0;51340586;44252512;1831370;2759;49481717;1761536;1289;0;1
FR;0;2021-10-13;40161;62827;74438;137;62802;79367;32;0;1;51380747;44315339;1905808;2896;49544519;1840903;1321;0;2
FR;0;2021-10-14;30360;52867;68772;116;49702;73846;36;0;0;51411107;44368206;1974580;3012;49594221;1914749;1357;0;2
FR;0;2021-10-15;44950;75241;93245;191;70348;103034;28;0;0;51456057;44443447;2067825;3203;49664569;2017783;1385;0;2
FR;0;2021-10-16;31331;44100;36697;44;46710;39654;17;0;0;51487388;44487547;2104522;3247;49711279;2057437;1402;0;2
FR;0;2021-10-17;3891;5227;3601;2;5671;3675;4;0;0;51491279;44492774;2108123;3249;49716950;2061112;1406;0;2
FR;0;2021-10-18;29196;42364;67510;134;42585;71367;29;0;0;51520475;44535138;2175633;3383;49759535;2132479;1435;0;2
FR;0;2021-10-19;27192;45557;76420;140;43225;81665;46;0;0;51547667;44580695;2252053;3523;49802760;2214144;1481;0;2
FR;0;2021-10-20;35341;52419;96950;181;51829;101566;47;0;0;51583008;44633114;2349003;3704;49854589;2315710;1528;0;2
FR;0;2021-10-21;26161;45179;83984;112;41982;89170;34;0;0;51609169;44678293;2432987;3816;49896571;2404880;1562;0;2
FR;0;2021-10-22;38448;62491;104920;200;59377;112630;67;0;0;51647617;44740784;2537907;4016;49955948;2517510;1629;0;2
FR;0;2021-10-23;27030;41202;45465;57;42433;48634;15;0;0;51674647;44781986;2583372;4073;49998381;2566144;1644;0;2
FR;0;2021-10-24;2946;4773;3684;6;5018;3925;1;0;0;51677593;44786759;2587056;4079;50003399;2570069;1645;0;2
FR;0;2021-10-25;26099;36240;82343;144;35522;86671;39;0;0;51703692;44822999;2669399;4223;50038921;2656740;1684;0;2
FR;0;2021-10-26;23767;35010;87273;166;32188;92394;37;0;0;51727459;44858009;2756672;4389;50071109;2749134;1721;0;2
FR;0;2021-10-27;30108;46326;109018;257;44066;114733;54;0;0;51757567;44904335;2865690;4646;50115175;2863867;1775;0;2
FR;0;2021-10-28;23606;34938;88733;153;31220;94517;41;0;0;51781173;44939273;2954423;4799;50146395;2958384;1816;0;2
FR;0;2021-10-29;31580;51462;117339;206;46526;125410;57;0;0;51812753;44990735;3071762;5005;50192921;3083794;1873;0;2
FR;0;2021-10-30;20572;33224;50359;76;32928;53411;21;0;0;51833325;45023959;3122121;5081;50225849;3137205;1894;0;2
FR;0;2021-10-31;2517;3736;3593;3;3847;3880;3;0;0;51835842;45027695;3125714;5084;50229696;3141085;1897;0;2
FR;0;2021-11-01;8529;4867;3220;3;5018;3584;10;0;0;51844371;45032562;3128934;5087;50234714;3144669;1907;0;2
FR;0;2021-11-02;26374;40110;93601;156;36264;99646;44;0;1;51870745;45072672;3222535;5243;50270978;3244315;1951;0;3
FR;0;2021-11-03;30125;47923;118913;222;43590;125878;67;0;0;51900870;45120595;3341448;5465;50314568;3370193;2018;0;3
FR;0;2021-11-04;23817;37491;107589;217;31596;114476;48;0;0;51924687;45158086;3449037;5682;50346164;3484669;2066;0;3
FR;0;2021-11-05;32406;52952;141665;236;44681;151437;57;0;0;51957093;45211038;3590702;5918;50390845;3636106;2123;0;3
FR;0;2021-11-06;21549;34559;64894;123;32403;68326;27;0;0;51978642;45245597;3655596;6041;50423248;3704432;2150;0;3
FR;0;2021-11-07;2427;4174;5206;6;4011;5601;7;0;0;51981069;45249771;3660802;6047;50427259;3710033;2157;0;3
FR;0;2021-11-08;20627;37744;127220;227;30953;134348;51;0;0;52001696;45287515;3788022;6274;50458212;3844381;2208;0;3
FR;0;2021-11-09;22440;44671;161729;339;32895;172321;71;0;0;52024136;45332186;3949751;6613;50491107;4016702;2279;0;3
FR;0;2021-11-10;31612;54923;187049;446;44073;198862;98;0;0;52055748;45387109;4136800;7059;50535180;4215564;2377;0;3
FR;0;2021-11-11;4744;6754;12992;28;5907;13979;17;0;0;52060492;45393863;4149792;7087;50541087;4229543;2394;0;3
FR;0;2021-11-12;29095;55074;183818;252;41764;197452;95;0;0;52089587;45448937;4333610;7339;50582851;4426995;2489;0;3
FR;0;2021-11-13;20353;32605;80721;118;28242;86342;47;0;0;52109940;45481542;4414331;7457;50611093;4513337;2536;0;3
FR;0;2021-11-14;2364;3864;7181;6;3369;7845;9;0;0;52112304;45485406;4421512;7463;50614462;4521182;2545;0;3
FR;0;2021-11-15;20512;38591;160894;314;27829;171621;81;0;0;52132816;45523997;4582406;7777;50642291;4692803;2626;0;3
FR;0;2021-11-16;23662;43901;200462;394;27778;215150;119;0;1;52156478;45567898;4782868;8171;50670069;4907953;2745;0;4
FR;0;2021-11-17;30538;50254;199889;406;36474;212939;102;0;0;52187016;45618152;4982757;8577;50706543;5120892;2847;0;4
FR;0;2021-11-18;23452;45688;191728;468;29421;205688;99;0;0;52210468;45663840;5174485;9045;50735964;5326580;2946;0;4
FR;0;2021-11-19;33690;61299;243273;551;39956;262271;152;0;0;52244158;45725139;5417758;9596;50775920;5588851;3098;0;4
FR;0;2021-11-20;25414;36673;102182;207;29276;109751;48;0;0;52269572;45761812;5519940;9803;50805196;5698602;3146;0;4
FR;0;2021-11-21;2659;4453;9671;19;3442;10607;19;0;0;52272231;45766265;5529611;9822;50808638;5709209;3165;0;4
FR;0;2021-11-22;22817;33169;180422;472;18954;194918;89;0;0;52295048;45799434;5710033;10294;50827592;5904127;3254;0;4
FR;0;2021-11-23;25728;45494;229462;549;24164;247937;85;0;0;52320776;45844928;5939495;10843;50851756;6152064;3339;0;4
FR;0;2021-11-24;31819;53654;224879;716;34547;243325;80;0;0;52352595;45898582;6164374;11559;50886303;6395389;3419;0;4
FR;0;2021-11-25;25649;49149;255991;739;25096;277862;112;0;0;52378244;45947731;6420365;12298;50911399;6673251;3531;0;4
FR;0;2021-11-26;33259;74730;379542;867;37491;414751;171;0;0;52411503;46022461;6799907;13165;50948890;7088002;3702;0;4
FR;0;2021-11-27;23507;49609;214956;390;28512;236749;138;0;0;52435010;46072070;7014863;13555;50977402;7324751;3840;0;4
FR;0;2021-11-28;3524;10482;56775;66;4077;63331;42;0;0;52438534;46082552;7071638;13621;50981479;7388082;3882;0;4
FR;0;2021-11-29;19444;54097;341535;864;23162;371831;178;0;0;52457978;46136649;7413173;14485;51004641;7759913;4060;0;4
FR;0;2021-11-30;24783;71881;457455;988;26925;500874;285;0;0;52482761;46208530;7870628;15473;51031566;8260787;4345;0;4
FR;0;2021-12-01;27383;75595;469184;1162;31477;511409;304;0;0;52510144;46284125;8339812;16635;51063043;8772196;4649;0;4
FR;0;2021-12-02;22121;71644;527206;1280;21163;575011;307;0;0;52532265;46355769;8867018;17915;51084206;9347207;4956;0;4
FR;0;2021-12-03;25576;92913;596481;1420;34498;651249;341;0;0;52557841;46448682;9463499;19335;51118704;9998456;5297;0;4
FR;0;2021-12-04;18340;60421;336279;692;25776;369864;200;0;0;52576181;46509103;9799778;20027;51144480;10368320;5497;0;4
FR;0;2021-12-05;4157;16127;95807;157;4888;107045;92;0;0;52580338;46525230;9895585;20184;51149368;10475365;5589;0;4
FR;0;2021-12-06;28455;72796;493225;1175;25358;540042;382;0;0;52608793;46598026;10388810;21359;51174726;11015407;5971;0;4
FR;0;2021-12-07;23555;91333;645503;1774;28672;706494;415;0;0;52632348;46689359;11034313;23133;51203398;11721901;6386;0;4
FR;0;2021-12-08;25515;92041;591709;1875;35070;647600;440;0;0;52657863;46781400;11626022;25008;51238468;12369501;6826;0;4
FR;0;2021-12-09;24081;94151;663219;2182;29139;726629;462;0;0;52681944;46875551;12289241;27190;51267607;13096130;7288;0;4
FR;0;2021-12-10;28072;110995;736146;2075;38106;806309;468;0;1;52710016;46986546;13025387;29265;51305713;13902439;7756;0;5
FR;0;2021-12-11;20252;76109;435230;990;30032;480432;345;0;0;52730268;47062655;13460617;30255;51335745;14382871;8101;0;5
FR;0;2021-12-12;5677;23162;142337;262;6428;159225;108;0;0;52735945;47085817;13602954;30517;51342173;14542096;8209;0;5
FR;0;2021-12-13;21361;90836;587759;1699;29805;649360;395;0;0;52757306;47176653;14190713;32216;51371978;15191456;8604;0;5
FR;0;2021-12-14;27981;118347;765713;2655;35569;847667;696;0;1;52785287;47295000;14956426;34871;51407547;16039123;9300;0;6
FR;0;2021-12-15;28446;114304;694433;2266;39656;769214;502;0;1;52813733;47409304;15650859;37137;51447203;16808337;9802;0;7
FR;0;2021-12-16;28035;115760;764136;2557;35276;844546;513;0;0;52841768;47525064;16414995;39694;51482479;17652883;10315;0;7
FR;0;2021-12-17;31654;128438;807951;2713;43521;892121;610;0;0;52873422;47653502;17222946;42407;51526000;18545004;10925;0;7
FR;0;2021-12-18;24938;81628;470020;1179;30147;522275;350;0;0;52898360;47735130;17692966;43586;51556147;19067279;11275;0;7
FR;0;2021-12-19;8760;28618;169421;376;7880;191079;141;0;0;52907120;47763748;17862387;43962;51564027;19258358;11416;0;7
FR;0;2021-12-20;31757;97264;591566;1787;34023;658804;498;0;0;52938877;47861012;18453953;45749;51598050;19917162;11914;0;7
FR;0;2021-12-21;39464;112058;682498;2392;38953;759645;601;0;0;52978341;47973070;19136451;48141;51637003;20676807;12515;0;7
FR;0;2021-12-22;39555;99319;575826;2169;37252;642177;686;0;2;53017896;48072389;19712277;50310;51674255;21318984;13201;0;9
FR;0;2021-12-23;33781;79500;441053;1657;30254;494411;590;0;0;53051677;48151889;20153330;51967;51704509;21813395;13791;0;9
FR;0;2021-12-24;10696;26086;111040;398;11690;126672;236;0;1;53062373;48177975;20264370;52365;51716199;21940067;14027;0;10
FR;0;2021-12-25;777;3589;7596;25;2057;9026;72;0;0;53063150;48181564;20271966;52390;51718256;21949093;14099;0;10
FR;0;2021-12-26;4697;11891;52108;142;4746;60152;170;0;0;53067847;48193455;20324074;52532;51723002;22009245;14269;0;10
FR;0;2021-12-27;30512;83998;453590;1364;33133;509208;666;0;0;53098359;48277453;20777664;53896;51756135;22518453;14935;0;10
FR;0;2021-12-28;38369;98946;564200;1769;35231;632296;1557;0;2;53136728;48376399;21341864;55665;51791366;23150749;16492;0;12
FR;0;2021-12-29;39878;88298;501244;1687;33215;561033;1741;0;1;53176606;48464697;21843108;57352;51824581;23711782;18233;0;13
FR;0;2021-12-30;35926;75162;421054;1521;29604;471152;1883;0;0;53212532;48539859;22264162;58873;51854185;24182934;20116;0;13
FR;0;2021-12-31;12050;25119;116888;405;11304;131678;741;0;0;53224582;48564978;22381050;59278;51865489;24314612;20857;0;13
FR;0;2022-01-01;1579;3217;8526;37;1799;9943;102;0;0;53226161;48568195;22389576;59315;51867288;24324555;20959;0;13
FR;0;2022-01-02;6118;13014;58430;125;5110;66959;408;0;0;53232279;48581209;22448006;59440;51872398;24391514;21367;0;13
FR;0;2022-01-03;38216;90254;494859;1596;36961;551755;2647;0;1;53270495;48671463;22942865;61036;51909359;24943269;24014;0;14
FR;0;2022-01-04;42117;111099;641426;2307;40768;714419;3838;0;3;53312612;48782562;23584291;63343;51950127;25657688;27852;0;17
FR;0;2022-01-05;61195;103683;569221;1984;43874;634267;3426;0;2;53373807;48886245;24153512;65327;51994001;26291955;31278;0;19
FR;0;2022-01-06;44295;110373;639002;2697;40300;711500;4555;0;2;53418102;48996618;24792514;68024;52034301;27003455;35833;0;21
FR;0;2022-01-07;50832;123415;711027;2811;46946;790531;4996;0;2;53468934;49120033;25503541;70835;52081247;27793986;40829;0;23
FR;0;2022-01-08;45010;80309;423821;1213;35081;472889;2445;0;3;53513944;49200342;25927362;72048;52116328;28266875;43274;0;26
FR;0;2022-01-09;15614;26643;128568;300;11516;145663;829;0;0;53529558;49226985;26055930;72348;52127844;28412538;44103;0;26
FR;0;2022-01-10;35396;93362;469354;1813;43108;522751;3720;0;1;53564954;49320347;26525284;74161;52170952;28935289;47823;0;27
FR;0;2022-01-11;41934;100520;548280;2306;42473;608544;5215;0;2;53606888;49420867;27073564;76467;52213425;29543833;53038;0;29
FR;0;2022-01-12;60407;95772;452707;1968;49557;504370;4497;0;8;53667295;49516639;27526271;78435;52262982;30048203;57535;0;37
FR;0;2022-01-13;38264;92582;487367;2084;40620;541046;5468;0;8;53705559;49609221;28013638;80519;52303602;30589249;63003;0;45
FR;0;2022-01-14;42578;103395;568629;2286;43591;629026;6465;0;2;53748137;49712616;28582267;82805;52347193;31218275;69468;0;47
FR;0;2022-01-15;39423;65933;340146;984;31476;377573;3294;0;1;53787560;49778549;28922413;83789;52378669;31595848;72762;0;48
FR;0;2022-01-16;11412;19232;87434;216;9033;99411;763;0;0;53798972;49797781;29009847;84005;52387702;31695259;73525;0;48
FR;0;2022-01-17;24739;60071;320296;1382;28108;354150;3961;0;4;53823711;49857852;29330143;85387;52415810;32049409;77486;0;52
FR;0;2022-01-18;28326;68729;361107;1801;32046;397566;5773;0;1;53852037;49926581;29691250;87188;52447856;32446975;83259;0;53
FR;0;2022-01-19;43219;67082;281319;1450;40423;311089;4387;0;5;53895256;49993663;29972569;88638;52488279;32758064;87646;0;58
FR;0;2022-01-20;23667;59649;299031;1741;29586;328516;5633;0;4;53918923;50053312;30271600;90379;52517865;33086580;93279;0;62
FR;0;2022-01-21;28205;68839;366386;2086;33129;401207;6579;0;3;53947128;50122151;30637986;92465;52550994;33487787;99858;0;65
FR;0;2022-01-22;27629;48000;218793;839;27330;241774;2838;0;2;53974757;50170151;30856779;93304;52578324;33729561;102696;0;67
FR;0;2022-01-23;6738;12978;48682;173;7507;55166;591;0;1;53981495;50183129;30905461;93477;52585831;33784727;103287;0;68
FR;0;2022-01-24;16274;47491;217327;1142;25434;239341;4100;0;3;53997769;50230620;31122788;94619;52611265;34024068;107387;0;71
FR;0;2022-01-25;19029;54367;243070;1548;28826;267097;6065;0;5;54016798;50284987;31365858;96167;52640091;34291165;113452;0;76
FR;0;2022-01-26;28147;60540;209292;1298;41363;229507;4479;0;3;54044945;50345527;31575150;97465;52681454;34520672;117931;0;79
FR;0;2022-01-27;16335;46461;207651;1276;26147;226011;5690;0;4;54061280;50391988;31782801;98741;52707601;34746683;123621;0;83
FR;0;2022-01-28;21588;78701;290066;1572;44989;321359;7411;0;4;54082868;50470689;32072867;100313;52752590;35068042;131032;0;87
FR;0;2022-01-29;18419;52878;184131;689;32764;204576;3256;0;2;54101287;50523567;32256998;101002;52785354;35272618;134288;0;89
FR;0;2022-01-30;4476;14486;39143;124;9136;45065;638;0;1;54105763;50538053;32296141;101126;52794490;35317683;134926;0;90
FR;0;2022-01-31;11259;43955;148209;742;26159;164753;4234;0;5;54117022;50582008;32444350;101868;52820649;35482436;139160;0;95
FR;0;2022-02-01;13635;48334;174135;1144;27353;191369;7048;0;1;54130657;50630342;32618485;103012;52848002;35673805;146208;0;96
FR;0;2022-02-02;20636;66337;171541;1034;46173;190098;5977;0;10;54151293;50696679;32790026;104046;52894175;35863903;152185;0;106
FR;0;2022-02-03;11526;44806;157565;990;25344;173300;6949;0;6;54162819;50741485;32947591;105036;52919519;36037203;159134;0;112
FR;0;2022-02-04;14633;66868;239255;1266;36474;264118;9169;0;6;54177452;50808353;33186846;106302;52955993;36301321;168303;0;118
FR;0;2022-02-05;12898;51465;153557;523;31990;172312;3794;0;3;54190350;50859818;33340403;106825;52987983;36473633;172097;0;121
FR;0;2022-02-06;2725;12175;28893;101;7288;33831;662;0;0;54193075;50871993;33369296;106926;52995271;36507464;172759;0;121
FR;0;2022-02-07;9586;46669;156890;593;24539;176312;5294;0;6;54202661;50918662;33526186;107519;53019810;36683776;178053;0;127
FR;0;2022-02-08;9803;43095;166642;868;20959;184436;7053;0;6;54212464;50961757;33692828;108387;53040769;36868212;185106;0;133
FR;0;2022-02-09;14372;58250;172349;875;35351;193056;5787;0;9;54226836;51020007;33865177;109262;53076120;37061268;190893;0;142
FR;0;2022-02-10;8718;39203;150236;878;18678;166713;6501;0;2;54235554;51059210;34015413;110140;53094798;37227981;197394;0;144
FR;0;2022-02-11;10859;55678;218514;1101;25819;243109;8322;0;3;54246413;51114888;34233927;111241;53120617;37471090;205716;0;147
FR;0;2022-02-12;8404;40959;134736;465;22627;151764;3508;0;4;54254817;51155847;34368663;111706;53143244;37622854;209224;0;151
FR;0;2022-02-13;1932;8601;26564;86;4409;30924;544;0;3;54256749;51164448;34395227;111792;53147653;37653778;209768;0;154
FR;0;2022-02-14;6990;35251;148384;485;14663;166379;4787;0;5;54263739;51199699;34543611;112277;53162316;37820157;214555;0;159
FR;0;2022-02-15;7064;36224;146986;751;15993;162570;6850;0;3;54270803;51235923;34690597;113028;53178309;37982727;221405;0;162
FR;0;2022-02-16;9410;42980;132538;720;25967;146757;5725;0;6;54280213;51278903;34823135;113748;53204276;38129484;227130;0;168
FR;0;2022-02-17;5578;24333;87308;585;13139;94881;5405;0;5;54285791;51303236;34910443;114333;53217415;38224365;232535;0;173
FR;0;2022-02-18;6994;33581;119665;807;18752;129329;7416;0;2;54292785;51336817;35030108;115140;53236167;38353694;239951;0;175
FR;0;2022-02-19;5369;24557;70029;370;15908;77339;3019;0;2;54298154;51361374;35100137;115510;53252075;38431033;242970;0;177
FR;0;2022-02-20;1148;4656;12175;39;2913;13954;460;0;1;54299302;51366030;35112312;115549;53254988;38444987;243430;0;178
FR;0;2022-02-21;4096;17887;61957;351;10166;67184;4059;0;2;54303398;51383917;35174269;115900;53265154;38512171;247489;0;180
FR;0;2022-02-22;4461;18656;60835;577;11258;64477;5254;0;1;54307859;51402573;35235104;116477;53276412;38576648;252743;0;181
FR;0;2022-02-23;6590;27357;66498;591;19627;71894;4595;0;3;54314449;51429930;35301602;117068;53296039;38648542;257338;0;184
FR;0;2022-02-24;3850;15543;50426;519;9506;53244;4533;0;2;54318299;51445473;35352028;117587;53305545;38701786;261871;0;186
FR;0;2022-02-25;5283;24084;76362;803;15060;80095;7334;0;7;54323582;51469557;35428390;118390;53320605;38781881;269205;0;193
FR;0;2022-02-26;3990;17767;47416;359;12169;51483;3083;0;3;54327572;51487324;35475806;118749;53332774;38833364;272288;0;196
FR;0;2022-02-27;880;3009;8036;47;1978;8947;529;0;0;54328452;51490333;35483842;118796;53334752;38842311;272817;0;196
FR;0;2022-02-28;3122;12550;40488;359;7586;42922;3857;0;0;54331574;51502883;35524330;119155;53342338;38885233;276674;0;196
FR;0;2022-03-01;4001;12603;44199;437;7630;44870;5518;0;6;54335575;51515486;35568529;119592;53349968;38930103;282192;0;202
FR;0;2022-03-02;5328;17796;47140;445;12854;49073;4927;0;2;54340903;51533282;35615669;120037;53362822;38979176;287119;0;204
FR;0;2022-03-03;2823;9350;29894;369;6247;30017;4048;0;2;54343726;51542632;35645563;120406;53369069;39009193;291167;0;206
FR;0;2022-03-04;3222;12448;40309;667;8447;39458;6231;0;4;54346948;51555080;35685872;121073;53377516;39048651;297398;0;210
FR;0;2022-03-05;3072;9282;24956;314;7126;25119;3134;0;1;54350020;51564362;35710828;121387;53384642;39073770;300532;0;211
FR;0;2022-03-06;520;1399;3198;43;1022;3441;379;0;0;54350540;51565761;35714026;121430;53385664;39077211;300911;0;211
FR;0;2022-03-07;2348;5628;18431;315;3848;17699;3307;0;4;54352888;51571389;35732457;121745;53389512;39094910;304218;0;215
FR;0;2022-03-08;2145;6077;19448;363;4331;17919;4095;0;3;54355033;51577466;35751905;122108;53393843;39112829;308313;0;218
FR;0;2022-03-09;3579;10498;22187;407;8726;21284;4037;0;4;54358612;51587964;35774092;122515;53402569;39134113;312350;0;222
FR;0;2022-03-10;1822;5830;17000;344;4375;15827;3407;0;3;54360434;51593794;35791092;122859;53406944;39149940;315757;0;225
FR;0;2022-03-11;2415;7557;24501;542;5435;22269;5476;0;2;54362849;51601351;35815593;123401;53412379;39172209;321233;0;227
FR;0;2022-03-12;2683;6777;17163;309;5497;16518;3135;0;2;54365532;51608128;35832756;123710;53417876;39188727;324368;0;229
FR;0;2022-03-13;404;791;2324;149;599;2273;537;0;0;54365936;51608919;35835080;123859;53418475;39191000;324905;0;229
FR;0;2022-03-14;1549;4273;14984;4410;2808;13839;7292;0;8;54367485;51613192;35850064;128269;53421283;39204839;332197;0;237
FR;0;2022-03-15;1748;6295;16379;7553;4812;14609;11031;0;9;54369233;51619487;35866443;135822;53426095;39219448;343228;0;246
FR;0;2022-03-16;3034;7404;19425;13138;6206;18104;16294;0;8;54372267;51626891;35885868;148960;53432301;39237552;359522;0;254
FR;0;2022-03-17;1453;3986;13149;10847;2805;11991;13313;0;8;54373720;51630877;35899017;159807;53435106;39249543;372835;0;262
FR;0;2022-03-18;2270;5755;20007;18305;4097;18103;22037;0;15;54375990;51636632;35919024;178112;53439203;39267646;394872;0;277
FR;0;2022-03-19;2294;4803;13114;9404;4139;12417;11407;0;6;54378284;51641435;35932138;187516;53443342;39280063;406279;0;283
FR;0;2022-03-20;300;734;1918;1073;526;1929;1340;0;2;54378584;51642169;35934056;188589;53443868;39281992;407619;0;285
FR;0;2022-03-21;1392;3218;12725;14951;2153;11949;16911;0;11;54379976;51645387;35946781;203540;53446021;39293941;424530;0;296
FR;0;2022-03-22;1516;3736;13798;20550;2576;12553;22841;0;5;54381492;51649123;35960579;224090;53448597;39306494;447371;0;301
FR;0;2022-03-23;2683;6291;17724;23152;5222;17239;25266;0;40;54384175;51655414;35978303;247242;53453819;39323733;472637;0;341
FR;0;2022-03-24;1405;3159;11593;17612;2248;10679;19386;0;23;54385580;51658573;35989896;264854;53456067;39334412;492023;0;364
FR;0;2022-03-25;2083;5156;18570;27763;3683;16908;30797;0;31;54387663;51663729;36008466;292617;53459750;39351320;522820;0;395
FR;0;2022-03-26;2230;4413;12079;12678;3860;11519;14400;0;26;54389893;51668142;36020545;305295;53463610;39362839;537220;0;421
FR;0;2022-03-27;360;693;1909;1482;514;1943;1739;0;1;54390253;51668835;36022454;306777;53464124;39364782;538959;0;422
FR;0;2022-03-28;1464;3075;11128;17489;2112;10619;19066;0;16;54391717;51671910;36033582;324266;53466236;39375401;558025;0;438
FR;0;2022-03-29;1454;3269;12907;27582;2085;12051;29280;0;34;54393171;51675179;36046489;351848;53468321;39387452;587305;0;472
FR;0;2022-03-30;2852;5504;15684;27415;4688;15076;29332;0;21;54396023;51680683;36062173;379263;53473009;39402528;616637;0;493
FR;0;2022-03-31;1610;3565;12986;25022;2546;12326;26631;0;43;54397633;51684248;36075159;404285;53475555;39414854;643268;0;536
FR;0;2022-04-01;2680;4584;20074;30894;2967;18716;33487;0;61;54400313;51688832;36095233;435179;53478522;39433570;676755;0;597
FR;0;2022-04-02;1530;2644;9052;10133;2009;8722;11295;0;29;54401843;51691476;36104285;445312;53480531;39442292;688050;0;626
FR;0;2022-04-03;290;514;1562;1170;359;1579;1381;0;2;54402133;51691990;36105847;446482;53480890;39443871;689431;0;628
FR;0;2022-04-04;2590;2883;12374;19127;1895;11581;20601;0;35;54404723;51694873;36118221;465609;53482785;39455452;710032;0;663
FR;0;2022-04-05;2413;3156;14340;34139;2036;13193;35755;0;85;54407136;51698029;36132561;499748;53484821;39468645;745787;0;748
FR;0;2022-04-06;2527;3944;13539;26488;3010;12808;27961;0;72;54409663;51701973;36146100;526236;53487831;39481453;773748;0;820
FR;0;2022-04-07;1811;3133;13674;33773;1984;12884;35131;0;76;54411474;51705106;36159774;560009;53489815;39494337;808879;0;896
FR;0;2022-04-08;2208;4276;19221;43982;2609;17828;46349;0;89;54413682;51709382;36178995;603991;53492424;39512165;855228;0;985
FR;0;2022-04-09;1366;2679;9313;13564;1900;8866;14798;0;30;54415048;51712061;36188308;617555;53494324;39521031;870026;0;1015
FR;0;2022-04-10;293;744;1982;2015;540;2003;2278;0;7;54415341;51712805;36190290;619570;53494864;39523034;872304;0;1022
FR;0;2022-04-11;1322;2621;11869;23907;1636;11479;25178;0;74;54416663;51715426;36202159;643477;53496500;39534513;897482;0;1096
FR;0;2022-04-12;1703;3072;14015;40907;1954;13389;41796;0;127;54418366;51718498;36216174;684384;53498454;39547902;939278;0;1223
FR;0;2022-04-13;1970;3717;13407;33107;2715;13030;34074;0;96;54420336;51722215;36229581;717491;53501169;39560932;973352;0;1319
FR;0;2022-04-14;1497;2967;13212;36312;1896;13068;36982;0;106;54421833;51725182;36242793;753803;53503065;39574000;1010334;0;1425
FR;0;2022-04-15;1866;3749;15632;35566;2496;14910;37215;0;115;54423699;51728931;36258425;789369;53505561;39588910;1047549;0;1540
FR;0;2022-04-16;1043;1829;6399;8552;1259;6261;9435;0;40;54424742;51730760;36264824;797921;53506820;39595171;1056984;0;1580
FR;0;2022-04-17;193;337;993;1174;221;1036;1242;0;7;54424935;51731097;36265817;799095;53507041;39596207;1058226;0;1587
FR;0;2022-04-18;196;541;2766;1072;342;2785;1286;0;5;54425131;51731638;36268583;800167;53507383;39598992;1059512;0;1592
FR;0;2022-04-19;1538;3028;12915;29666;1871;12475;30713;0;78;54426669;51734666;36281498;829833;53509254;39611467;1090225;0;1670
FR;0;2022-04-20;1996;3479;13304;29043;2591;12981;30070;0;96;54428665;51738145;36294802;858876;53511845;39624448;1120295;0;1766
FR;0;2022-04-21;1512;2850;12546;35166;1822;12617;35761;0;117;54430177;51740995;36307348;894042;53513667;39637065;1156056;0;1883
FR;0;2022-04-22;1866;3612;16475;37605;2387;15833;39145;0;131;54432043;51744607;36323823;931647;53516054;39652898;1195201;0;2014
FR;0;2022-04-23;1144;2062;7385;10657;1470;7236;11442;0;38;54433187;51746669;36331208;942304;53517524;39660134;1206643;0;2052
FR;0;2022-04-24;250;461;1475;1589;320;1413;1845;0;7;54433437;51747130;36332683;943893;53517844;39661547;1208488;0;2059
FR;0;2022-04-25;1306;2532;10681;21055;1611;10489;22076;0;79;54434743;51749662;36343364;964948;53519455;39672036;1230564;0;2138
FR;0;2022-04-26;1622;3003;13664;38591;1962;13108;39387;0;181;54436365;51752665;36357028;1003539;53521417;39685144;1269951;0;2319
FR;0;2022-04-27;1964;3060;11537;31015;2271;11593;31435;0;130;54438329;51755725;36368565;1034554;53523688;39696737;1301386;0;2449
FR;0;2022-04-28;1569;2769;12527;36213;1851;12269;36529;0;139;54439898;51758494;36381092;1070767;53525539;39709006;1337915;0;2588
FR;0;2022-04-29;2007;4807;15553;37268;3614;14929;38737;0;164;54441905;51763301;36396645;1108035;53529153;39723935;1376652;0;2752
FR;0;2022-04-30;1215;2602;6926;9717;2098;6754;10608;0;44;54443120;51765903;36403571;1117752;53531251;39730689;1387260;0;2796
FR;0;2022-05-01;218;325;914;997;229;909;1138;0;6;54443338;51766228;36404485;1118749;53531480;39731598;1388398;0;2802
FR;0;2022-05-02;2041;2941;11150;18171;2038;10983;19016;0;69;54445379;51769169;36415635;1136920;53533518;39742581;1407414;0;2871
FR;0;2022-05-03;1988;3259;13719;34679;2123;13560;35601;0;163;54447367;51772428;36429354;1171599;53535641;39756141;1443015;0;3034
FR;0;2022-05-04;1911;3293;12181;25631;2294;12298;26181;0;110;54449278;51775721;36441535;1197230;53537935;39768439;1469196;0;3144
FR;0;2022-05-05;1767;2980;13054;33570;1956;12901;34238;0;178;54451045;51778701;36454589;1230800;53539891;39781340;1503434;0;3322
FR;0;2022-05-06;2213;3656;15345;36784;2315;14854;38247;0;182;54453258;51782357;36469934;1267584;53542206;39796194;1541681;0;3504
FR;0;2022-05-07;1206;1779;6461;9611;1253;6452;10336;0;48;54454464;51784136;36476395;1277195;53543459;39802646;1552017;0;3552
FR;0;2022-05-08;267;400;1172;1546;289;1233;1652;0;8;54454731;51784536;36477567;1278741;53543748;39803879;1553669;0;3560
FR;0;2022-05-09;1377;2299;9925;20258;1406;9795;21175;0;102;54456108;51786835;36487492;1298999;53545154;39813674;1574844;0;3662
FR;0;2022-05-10;1777;3350;13575;38982;2212;13130;40010;0;200;54457885;51790185;36501067;1337981;53547366;39826804;1614854;0;3862
FR;0;2022-05-11;1996;3009;10749;27919;2313;10692;28427;0;148;54459881;51793194;36511816;1365900;53549679;39837496;1643281;0;4010
FR;0;2022-05-12;1587;2714;11373;35696;1783;11045;36456;0;211;54461468;51795908;36523189;1401596;53551462;39848541;1679737;0;4221
FR;0;2022-05-13;1975;3215;13756;37970;2056;13344;39235;0;162;54463443;51799123;36536945;1439566;53553518;39861885;1718972;0;4383
FR;0;2022-05-14;1148;1637;5937;10775;1195;5800;11363;0;57;54464591;51800760;36542882;1450341;53554713;39867685;1730335;0;4440
FR;0;2022-05-15;281;474;1278;1438;298;1361;1591;0;6;54464872;51801234;36544160;1451779;53555011;39869046;1731926;0;4446
FR;0;2022-05-16;1194;2039;8684;21044;1241;8681;21581;0;128;54466066;51803273;36552844;1472823;53556252;39877727;1753507;0;4574
FR;0;2022-05-17;1587;2595;11822;37874;1661;11400;38713;0;180;54467653;51805868;36564666;1510697;53557913;39889127;1792220;0;4754
FR;0;2022-05-18;1811;2650;9686;27154;1953;9660;27771;0;109;54469464;51808518;36574352;1537851;53559866;39898787;1819991;0;4863
FR;0;2022-05-19;1444;2651;10572;35832;1625;10713;36020;0;162;54470908;51811169;36584924;1573683;53561491;39909500;1856011;0;5025
FR;0;2022-05-20;1872;3111;13418;39364;2070;12909;40382;0;168;54472780;51814280;36598342;1613047;53563561;39922409;1896393;0;5193
FR;0;2022-05-21;1158;1706;5660;9897;1300;5532;10533;0;45;54473938;51815986;36604002;1622944;53564861;39927941;1906926;0;5238
FR;0;2022-05-22;238;341;1028;1437;262;1016;1580;0;10;54474176;51816327;36605030;1624381;53565123;39928957;1908506;0;5248
FR;0;2022-05-23;1173;2119;8877;20346;1401;8827;21000;0;86;54475349;51818446;36613907;1644727;53566524;39937784;1929506;0;5334
FR;0;2022-05-24;1538;2758;11358;38873;1733;11228;39504;0;190;54476887;51821204;36625265;1683600;53568257;39949012;1969010;0;5524
FR;0;2022-05-25;1814;2831;9342;24840;2070;9478;25317;0;116;54478701;51824035;36634607;1708440;53570327;39958490;1994327;0;5640
FR;0;2022-05-26;209;422;1661;1198;286;1672;1337;0;29;54478910;51824457;36636268;1709638;53570613;39960162;1995664;0;5669
FR;0;2022-05-27;1384;2469;9259;21289;1661;9000;22322;0;94;54480294;51826926;36645527;1730927;53572274;39969162;2017986;0;5763
FR;0;2022-05-28;668;1264;3915;6791;844;3965;7201;0;38;54480962;51828190;36649442;1737718;53573118;39973127;2025187;0;5801
FR;0;2022-05-29;157;315;752;918;200;773;1030;0;4;54481119;51828505;36650194;1738636;53573318;39973900;2026217;0;5805
FR;0;2022-05-30;1025;1956;6993;19295;1238;7010;19807;0;91;54482144;51830461;36657187;1757931;53574556;39980910;2046024;0;5896
FR;0;2022-05-31;1489;2501;9817;35654;1631;9639;36285;0;171;54483633;51832962;36667004;1793585;53576187;39990549;2082309;0;6067
FR;0;2022-06-01;1733;3096;11019;24529;2242;10884;25483;0;121;54485366;51836058;36678023;1818114;53578429;40001433;2107792;0;6188
FR;0;2022-06-02;1475;2610;11305;35556;1711;10861;36503;0;173;54486841;51838668;36689328;1853670;53580140;40012294;2144295;0;6361
FR;0;2022-06-03;1724;3067;13392;38718;2035;12756;39988;0;176;54488565;51841735;36702720;1892388;53582175;40025050;2184283;0;6537
FR;0;2022-06-04;970;1515;5042;9112;1075;5113;9648;0;73;54489535;51843250;36707762;1901500;53583250;40030163;2193931;0;6610
FR;0;2022-06-05;177;335;875;1106;205;886;1228;0;4;54489712;51843585;36708637;1902606;53583455;40031049;2195159;0;6614
FR;0;2022-06-06;542;1200;2118;1326;1026;2133;1506;0;12;54490254;51844785;36710755;1903932;53584481;40033182;2196665;0;6626
FR;0;2022-06-07;1402;2699;9850;35583;1777;9429;36809;0;153;54491656;51847484;36720605;1939515;53586258;40042611;2233474;0;6779
FR;0;2022-06-08;1561;2692;9163;28724;1939;9004;29691;0;112;54493217;51850176;36729768;1968239;53588197;40051615;2263165;0;6891
FR;0;2022-06-09;1287;2436;10620;39490;1551;10264;40266;0;167;54494504;51852612;36740388;2007729;53589748;40061879;2303431;0;7058
FR;0;2022-06-10;1626;3057;13082;44803;2023;12628;46142;0;224;54496130;51855669;36753470;2052532;53591771;40074507;2349573;0;7282
FR;0;2022-06-11;957;1737;5436;11625;1122;5468;12211;0;55;54497087;51857406;36758906;2064157;53592893;40079975;2361784;0;7337
FR;0;2022-06-12;197;442;1074;1762;252;1136;1864;0;11;54497284;51857848;36759980;2065919;53593145;40081111;2363648;0;7348
FR;0;2022-06-13;1089;2057;7437;23181;1331;7268;24095;0;90;54498373;51859905;36767417;2089100;53594476;40088379;2387743;0;7438
FR;0;2022-06-14;1319;2525;10447;44939;1575;9803;46135;0;200;54499692;51862430;36777864;2134039;53596051;40098182;2433878;0;7638
FR;0;2022-06-15;1508;2450;9318;30880;1919;8951;31575;0;178;54501200;51864880;36787182;2164919;53597970;40107133;2465453;0;7816
FR;0;2022-06-16;1180;2031;9908;39917;1264;9319;40937;0;201;54502380;51866911;36797090;2204836;53599234;40116452;2506390;0;8017
FR;0;2022-06-17;1486;2844;12470;46628;1768;11893;47853;0;239;54503866;51869755;36809560;2251464;53601002;40128345;2554243;0;8256
FR;0;2022-06-18;854;1522;4563;11124;1032;4498;11718;0;67;54504720;51871277;36814123;2262588;53602034;40132843;2565961;0;8323
FR;0;2022-06-19;183;363;1058;1615;208;1130;1701;0;14;54504903;51871640;36815181;2264203;53602242;40133973;2567662;0;8337
FR;0;2022-06-20;1024;1917;8905;26069;1189;8564;27013;0;153;54505927;51873557;36824086;2290272;53603431;40142537;2594675;0;8490
FR;0;2022-06-21;1325;2397;10305;49888;1531;9334;51275;0;264;54507252;51875954;36834391;2340160;53604962;40151871;2645950;0;8754
FR;0;2022-06-22;1389;2499;8911;39049;1790;8417;39994;0;256;54508641;51878453;36843302;2379209;53606752;40160288;2685944;0;9010
FR;0;2022-06-23;1226;2359;10677;55092;1355;9883;56224;0;320;54509867;51880812;36853979;2434301;53608107;40170171;2742168;0;9330
FR;0;2022-06-24;1486;2986;13643;69170;1741;12304;70988;0;405;54511353;51883798;36867622;2503471;53609848;40182475;2813156;0;9735
FR;0;2022-06-25;938;1778;6233;19915;1109;5985;20770;0;176;54512291;51885576;36873855;2523386;53610957;40188460;2833926;0;9911
FR;0;2022-06-26;229;459;1953;3688;259;1817;3967;0;39;54512520;51886035;36875808;2527074;53611216;40190277;2837893;0;9950
FR;0;2022-06-27;1129;2016;10496;48480;1172;9637;49748;0;339;54513649;51888051;36886304;2575554;53612388;40199914;2887641;0;10289
FR;0;2022-06-28;1456;2810;14662;91372;1577;13082;93140;0;623;54515105;51890861;36900966;2666926;53613965;40212996;2980781;0;10912
FR;0;2022-06-29;1708;2825;12291;71877;1838;11238;73020;0;548;54516813;51893686;36913257;2738803;53615803;40224234;3053801;0;11460
FR;0;2022-06-30;1532;2712;14387;95159;1631;12467;97174;0;724;54518345;51896398;36927644;2833962;53617434;40236701;3150975;0;12184
FR;0;2022-07-01;1991;3793;21493;115922;2299;18847;118566;0;954;54520336;51900191;36949137;2949884;53619733;40255548;3269541;0;13138
FR;0;2022-07-02;1085;1856;8524;35749;1102;7701;36870;0;342;54521421;51902047;36957661;2985633;53620835;40263249;3306411;0;13480
FR;0;2022-07-03;291;539;2091;6454;316;1894;6804;0;78;54521712;51902586;36959752;2992087;53621151;40265143;3313215;0;13558
FR;0;2022-07-04;1678;3266;14700;79213;2127;12972;81289;0;639;54523390;51905852;36974452;3071300;53623278;40278115;3394504;0;14197
FR;0;2022-07-05;1713;3131;18828;133239;1762;16006;135531;0;1145;54525103;51908983;36993280;3204539;53625040;40294121;3530035;0;15342
FR;0;2022-07-06;1818;2769;15849;99568;1831;13637;101136;0;900;54526921;51911752;37009129;3304107;53626871;40307758;3631171;0;16242
FR;0;2022-07-07;1705;2865;17998;126027;1702;14775;128355;0;1180;54528626;51914617;37027127;3430134;53628573;40322533;3759526;0;17422
FR;0;2022-07-08;1887;3147;20748;137078;1847;16761;140073;0;1346;54530513;51917764;37047875;3567212;53630420;40339294;3899599;0;18768
FR;0;2022-07-09;866;1455;7738;37921;873;6684;38764;0;426;54531379;51919219;37055613;3605133;53631293;40345978;3938363;0;19194
FR;0;2022-07-10;263;546;2345;7003;299;2124;7394;0;94;54531642;51919765;37057958;3612136;53631592;40348102;3945757;0;19288
FR;0;2022-07-11;1429;2454;15013;88263;1377;12498;90457;0;801;54533071;51922219;37072971;3700399;53632969;40360600;4036214;0;20089
FR;0;2022-07-12;1796;3097;20524;143943;1692;16718;146643;0;1604;54534867;51925316;37093495;3844342;53634661;40377318;4182857;0;21693
FR;0;2022-07-13;1735;2732;15687;94527;1642;13266;96386;0;1080;54536602;51928048;37109182;3938869;53636303;40390584;4279243;0;22773
FR;0;2022-07-14;183;367;1952;5533;215;1831;5700;0;82;54536785;51928415;37111134;3944402;53636518;40392415;4284943;0;22855
FR;0;2022-07-15;1477;2553;15113;84447;1414;12595;86606;0;1034;54538262;51930968;37126247;4028849;53637932;40405010;4371549;0;23889
FR;0;2022-07-16;617;1178;5947;24975;683;5154;25666;0;327;54538879;51932146;37132194;4053824;53638615;40410164;4397215;0;24216
FR;0;2022-07-17;177;389;1736;4663;213;1566;4935;0;66;54539056;51932535;37133930;4058487;53638828;40411730;4402150;0;24282
FR;0;2022-07-18;1130;2243;11824;61796;1331;9973;63660;0;780;54540186;51934778;37145754;4120283;53640159;40421703;4465810;0;25062
FR;0;2022-07-19;1414;2344;15468;103673;1383;12290;105864;0;1459;54541600;51937122;37161222;4223956;53641542;40433993;4571674;0;26521
FR;0;2022-07-20;1417;2288;12953;77559;1456;10728;79146;0;1051;54543017;51939410;37174175;4301515;53642998;40444721;4650820;0;27572
FR;0;2022-07-21;1284;2161;13085;88225;1361;10488;89707;0;1315;54544301;51941571;37187260;4389740;53644359;40455209;4740527;0;28887
FR;0;2022-07-22;1399;2448;14804;89514;1435;11954;91384;0;1347;54545700;51944019;37202064;4479254;53645794;40467163;4831911;0;30234
FR;0;2022-07-23;670;1301;5529;22478;812;4852;23074;0;412;54546370;51945320;37207593;4501732;53646606;40472015;4854985;0;30646
FR;0;2022-07-24;183;351;1397;3900;199;1238;4128;0;72;54546553;51945671;37208990;4505632;53646805;40473253;4859113;0;30718
FR;0;2022-07-25;1055;1790;9487;48064;1140;7836;49504;0;737;54547608;51947461;37218477;4553696;53647945;40481089;4908617;0;31455
FR;0;2022-07-26;1287;2206;13303;85414;1311;10827;87112;0;1310;54548895;51949667;37231780;4639110;53649256;40491916;4995729;0;32765
FR;0;2022-07-27;1219;2001;10233;61271;1330;8528;62475;0;971;54550114;51951668;37242013;4700381;53650586;40500444;5058204;0;33736
FR;0;2022-07-28;1088;1859;10307;64383;1249;8214;65618;0;1046;54551202;51953527;37252320;4764764;53651835;40508658;5123822;0;34782
FR;0;2022-07-29;1281;2050;10993;65840;1357;8751;67267;0;1139;54552483;51955577;37263313;4830604;53653192;40517409;5191089;0;35921
FR;0;2022-07-30;498;854;3518;15281;589;2971;15661;0;303;54552981;51956431;37266831;4845885;53653781;40520380;5206750;0;36224
FR;0;2022-07-31;151;288;929;2438;184;788;2587;0;49;54553132;51956719;37267760;4848323;53653965;40521168;5209337;0;36273
FR;0;2022-08-01;839;1540;7586;30232;1133;6382;31305;0;548;54553971;51958259;37275346;4878555;53655098;40527550;5240642;0;36821
FR;0;2022-08-02;1020;1632;8568;56101;1135;6882;56788;0;1169;54554991;51959891;37283914;4934656;53656233;40534432;5297430;0;37990
FR;0;2022-08-03;833;1255;6414;38668;889;5135;39404;0;702;54555824;51961146;37290328;4973324;53657122;40539567;5336834;0;38692
FR;0;2022-08-04;730;1179;6566;43151;774;5296;43717;0;916;54556554;51962325;37296894;5016475;53657896;40544863;5380551;0;39608
FR;0;2022-08-05;851;1354;7090;44932;959;5663;45601;0;993;54557405;51963679;37303984;5061407;53658855;40550526;5426152;0;40601
FR;0;2022-08-06;338;555;2098;9366;396;1756;9566;0;226;54557743;51964234;37306082;5070773;53659251;40552282;5435718;0;40827
FR;0;2022-08-07;103;155;536;1621;112;453;1701;0;38;54557846;51964389;37306618;5072394;53659363;40552735;5437419;0;40865
FR;0;2022-08-08;561;994;4015;22095;750;3275;22538;0;490;54558407;51965383;37310633;5094489;53660113;40556010;5459957;0;41355
FR;0;2022-08-09;684;1135;5964;39934;822;4794;40424;0;843;54559091;51966518;37316597;5134423;53660935;40560804;5500381;0;42198
FR;0;2022-08-10;631;1115;4653;28054;828;3793;28389;0;652;54559722;51967633;37321250;5162477;53661763;40564597;5528770;0;42850
FR;0;2022-08-11;613;1021;4481;29243;734;3701;29579;0;676;54560335;51968654;37325731;5191720;53662497;40568298;5558349;0;43526
FR;0;2022-08-12;706;1141;4741;28207;824;3913;28643;0;702;54561041;51969795;37330472;5219927;53663321;40572211;5586992;0;44228
FR;0;2022-08-13;211;409;1294;5255;307;1117;5414;0;121;54561252;51970204;37331766;5225182;53663628;40573328;5592406;0;44349
FR;0;2022-08-14;71;120;288;923;103;246;995;0;25;54561323;51970324;37332054;5226105;53663731;40573574;5593401;0;44374
FR;0;2022-08-15;82;180;606;562;146;554;616;0;19;54561405;51970504;37332660;5226667;53663877;40574128;5594017;0;44393
FR;0;2022-08-16;617;1052;3952;22172;814;3346;22364;0;616;54562022;51971556;37336612;5248839;53664691;40577474;5616381;0;45009
FR;0;2022-08-17;628;1013;3886;22893;790;3291;23137;0;620;54562650;51972569;37340498;5271732;53665481;40580765;5639518;0;45629
FR;0;2022-08-18;614;979;4106;26288;779;3247;26518;0;673;54563264;51973548;37344604;5298020;53666260;40584012;5666036;0;46302
FR;0;2022-08-19;601;1152;4484;27224;859;3685;27530;0;766;54563865;51974700;37349088;5325244;53667119;40587697;5693566;0;47068
FR;0;2022-08-20;289;492;1353;5567;389;1168;5727;0;145;54564154;51975192;37350441;5330811;53667508;40588865;5699293;0;47213
FR;0;2022-08-21;94;133;299;1008;94;263;1041;0;27;54564248;51975325;37350740;5331819;53667602;40589128;5700334;0;47240
FR;0;2022-08-22;546;979;3272;15346;755;2794;15677;0;425;54564794;51976304;37354012;5347165;53668357;40591922;5716011;0;47665
FR;0;2022-08-23;711;1171;4292;28989;846;3606;29074;0;870;54565505;51977475;37358304;5376154;53669203;40595528;5745085;0;48535
FR;0;2022-08-24;656;929;3492;19529;772;2855;19718;0;608;54566161;51978404;37361796;5395683;53669975;40598383;5764803;0;49143
FR;0;2022-08-25;623;1010;3934;23397;720;3282;23662;0;672;54566784;51979414;37365730;5419080;53670695;40601665;5788465;0;49815
FR;0;2022-08-26;848;1252;4473;25878;944;3664;26252;0;777;54567632;51980666;37370203;5444958;53671639;40605329;5814717;0;50592
FR;0;2022-08-27;292;496;1377;5462;357;1243;5526;0;194;54567924;51981162;37371580;5450420;53671996;40606572;5820243;0;50786
FR;0;2022-08-28;123;160;303;919;114;288;964;0;38;54568047;51981322;37371883;5451339;53672110;40606860;5821207;0;50824
FR;0;2022-08-29;617;963;3071;14632;762;2608;14948;0;432;54568664;51982285;37374954;5465971;53672872;40609468;5836155;0;51256
FR;0;2022-08-30;847;1205;4791;28541;882;3908;28871;0;823;54569511;51983490;37379745;5494512;53673754;40613376;5865026;0;52079
FR;0;2022-08-31;688;945;3196;17632;730;2707;17896;0;508;54570199;51984435;37382941;5512144;53674484;40616083;5882922;0;52587
FR;0;2022-09-01;725;979;4471;22463;691;3816;22738;0;622;54570924;51985414;37387412;5534607;53675175;40619899;5905660;0;53209
FR;0;2022-09-02;867;1135;5035;28609;819;4246;28902;0;914;54571791;51986549;37392447;5563216;53675994;40624145;5934562;0;54123
FR;0;2022-09-03;415;557;1917;6083;412;1663;6320;0;181;54572206;51987106;37394364;5569299;53676406;40625808;5940882;0;54304
FR;0;2022-09-04;131;149;351;873;85;347;942;0;24;54572337;51987255;37394715;5570172;53676491;40626155;5941824;0;54328
FR;0;2022-09-05;617;694;3136;16051;515;2614;16363;0;523;54572954;51987949;37397851;5586223;53677006;40628769;5958187;0;54851
FR;0;2022-09-06;790;1011;4729;31840;642;3860;32071;0;1040;54573744;51988960;37402580;5618063;53677648;40632629;5990258;0;55891
FR;0;2022-09-07;641;763;2994;16818;543;2474;16967;0;572;54574385;51989723;37405574;5634881;53678191;40635103;6007225;0;56463
FR;0;2022-09-08;616;848;3800;24842;580;3134;24930;0;818;54575001;51990571;37409374;5659723;53678771;40638237;6032155;0;57281
FR;0;2022-09-09;835;1008;4433;27641;649;3669;27819;0;948;54575836;51991579;37413807;5687364;53679420;40641906;6059974;0;58229
FR;0;2022-09-10;384;533;1730;5709;359;1530;5913;0;207;54576220;51992112;37415537;5693073;53679779;40643436;6065887;0;58436
FR;0;2022-09-11;122;129;320;656;90;304;714;0;17;54576342;51992241;37415857;5693729;53679869;40643740;6066601;0;58453
FR;0;2022-09-12;485;614;2680;13282;433;2287;13573;0;478;54576827;51992855;37418537;5707011;53680302;40646027;6080174;0;58931
FR;0;2022-09-13;610;830;3991;26499;514;3478;26382;0;875;54577437;51993685;37422528;5733510;53680816;40649505;6106556;0;59806
FR;0;2022-09-14;650;767;2949;16174;559;2464;16407;0;573;54578087;51994452;37425477;5749684;53681375;40651969;6122963;0;60379
FR;0;2022-09-15;552;774;3463;23536;524;2927;23630;0;725;54578639;51995226;37428940;5773220;53681899;40654896;6146593;0;61104
FR;0;2022-09-16;785;1028;4136;25898;708;3474;26121;0;932;54579424;51996254;37433076;5799118;53682607;40658370;6172714;0;62036
FR;0;2022-09-17;384;488;1449;6144;365;1279;6236;0;242;54579808;51996742;37434525;5805262;53682972;40659649;6178950;0;62278
FR;0;2022-09-18;115;138;323;960;116;291;1015;0;36;54579923;51996880;37434848;5806222;53683088;40659940;6179965;0;62314
FR;0;2022-09-19;445;630;2251;13198;429;1926;13380;0;436;54580368;51997510;37437099;5819420;53683517;40661866;6193345;0;62750
FR;0;2022-09-20;633;861;3777;26414;613;3146;26469;0;891;54581001;51998371;37440876;5845834;53684130;40665012;6219814;0;63641
FR;0;2022-09-21;575;763;2736;16257;567;2351;16249;0;586;54581576;51999134;37443612;5862091;53684697;40667363;6236063;0;64227
FR;0;2022-09-22;580;818;3410;23572;543;2779;23798;0;772;54582156;51999952;37447022;5885663;53685240;40670142;6259861;0;64999
FR;0;2022-09-23;827;1033;4490;28699;752;3758;28875;0;1017;54582983;52000985;37451512;5914362;53685992;40673900;6288736;0;66016
FR;0;2022-09-24;423;608;1639;6892;468;1412;7076;0;306;54583406;52001593;37453151;5921254;53686460;40675312;6295812;0;66322
FR;0;2022-09-25;98;186;335;1100;140;306;1142;0;37;54583504;52001779;37453486;5922354;53686600;40675618;6296954;0;66359
FR;0;2022-09-26;437;694;2283;13506;466;2012;13614;0;432;54583941;52002473;37455769;5935860;53687066;40677630;6310568;0;66791
FR;0;2022-09-27;609;831;3625;25936;602;2908;26090;0;959;54584550;52003304;37459394;5961796;53687668;40680538;6336658;0;67750
FR;0;2022-09-28;626;814;2548;15386;621;2294;15501;0;622;54585176;52004118;37461942;5977182;53688289;40682832;6352159;0;68372
FR;0;2022-09-29;562;757;3111;21028;534;2625;21055;40;809;54585738;52004875;37465053;5998210;53688823;40685457;6373214;40;69181
FR;0;2022-09-30;768;1088;3950;25546;797;3295;25813;712;1048;54586506;52005963;37469003;6023756;53689620;40688752;6399027;752;70229
FR;0;2022-10-01;418;609;1990;5969;456;1720;6208;396;317;54586924;52006572;37470993;6029725;53690076;40690472;6405235;1148;70546
FR;0;2022-10-02;57;131;217;638;93;213;664;66;42;54586981;52006703;37471210;6030363;53690169;40690685;6405899;1214;70588
FR;0;2022-10-03;463;726;2428;12019;560;2136;12213;2073;744;54587444;52007429;37473638;6042382;53690729;40692821;6418112;3287;71332
FR;0;2022-10-04;611;777;3379;23500;522;2768;23679;4701;1579;54588055;52008206;37477017;6065882;53691251;40695589;6441791;7988;72911
FR;0;2022-10-05;543;801;2427;14583;577;2143;14728;3655;1208;54588598;52009007;37479444;6080465;53691828;40697732;6456519;11643;74119
FR;0;2022-10-06;531;700;3078;21677;501;2509;21889;6662;1909;54589129;52009707;37482522;6102142;53692329;40700241;6478408;18305;76028
FR;0;2022-10-07;714;973;4123;30287;703;3469;30375;16861;3201;54589843;52010680;37486645;6132429;53693032;40703710;6508783;35166;79229
FR;0;2022-10-08;345;510;1648;8421;368;1408;8589;6691;1168;54590188;52011190;37488293;6140850;53693400;40705118;6517372;41857;80397
FR;0;2022-10-09;107;137;335;1587;111;310;1650;1510;295;54590295;52011327;37488628;6142437;53693511;40705428;6519022;43367;80692
FR;0;2022-10-10;472;698;2908;20473;513;2492;20796;19462;3231;54590767;52012025;37491536;6162910;53694024;40707920;6539818;62829;83923
FR;0;2022-10-11;566;781;4257;40275;527;3549;40626;40123;6369;54591333;52012806;37495793;6203185;53694551;40711469;6580444;102952;90292
FR;0;2022-10-12;560;787;3242;26678;572;2749;27003;27268;4685;54591893;52013593;37499035;6229863;53695123;40714218;6607447;130220;94977
FR;0;2022-10-13;605;743;3994;38381;533;3113;38842;40549;6601;54592498;52014336;37503029;6268244;53695656;40717331;6646289;170769;101578
FR;0;2022-10-14;751;1041;4860;47630;751;3943;48104;51089;7847;54593249;52015377;37507889;6315874;53696407;40721274;6694393;221858;109425
FR;0;2022-10-15;351;492;1848;11839;331;1607;11958;13085;2273;54593600;52015869;37509737;6327713;53696738;40722881;6706351;234943;111698
FR;0;2022-10-16;92;123;371;1959;76;353;2005;2342;476;54593692;52015992;37510108;6329672;53696814;40723234;6708356;237285;112174
FR;0;2022-10-17;434;684;3030;26404;473;2467;26776;30717;5402;54594126;52016676;37513138;6356076;53697287;40725701;6735132;268002;117576
FR;0;2022-10-18;596;723;4692;46021;519;3743;46538;55328;11669;54594722;52017399;37517830;6402097;53697806;40729444;6781670;323330;129245
FR;0;2022-10-19;545;770;3624;34294;574;3054;34637;42305;9154;54595267;52018169;37521454;6436391;53698380;40732498;6816307;365635;138399
FR;0;2022-10-20;594;755;4817;49349;540;3677;50026;60358;12872;54595861;52018924;37526271;6485740;53698920;40736175;6866333;425993;151271
FR;0;2022-10-21;680;969;5688;56941;688;4493;57629;70845;14271;54596541;52019893;37531959;6542681;53699608;40740668;6923962;496838;165542
FR;0;2022-10-22;329;393;1652;12931;312;1316;13092;15924;3377;54596870;52020286;37533611;6555612;53699920;40741984;6937054;512762;168919
FR;0;2022-10-23;92;100;349;2054;95;265;2156;2745;628;54596962;52020386;37533960;6557666;53700015;40742249;6939210;515507;169547
FR;0;2022-10-24;546;590;3126;27065;414;2666;27501;35377;7758;54597508;52020976;37537086;6584731;53700429;40744915;6966711;550884;177305
FR;0;2022-10-25;583;712;4856;49011;521;3790;49684;65067;15373;54598091;52021688;37541942;6633742;53700950;40748705;7016395;615951;192678
FR;0;2022-10-26;526;631;3439;32425;465;2865;32770;43627;10826;54598617;52022319;37545381;6666167;53701415;40751570;7049165;659578;203504
FR;0;2022-10-27;585;678;4060;40654;478;3319;41145;54208;12989;54599202;52022997;37549441;6706821;53701893;40754889;7090310;713786;216493
FR;0;2022-10-28;695;838;4590;44001;606;3486;44838;57934;13004;54599897;52023835;37554031;6750822;53702499;40758375;7135148;771720;229497
FR;0;2022-10-29;251;353;1323;9482;249;1077;9615;12494;2995;54600148;52024188;37555354;6760304;53702748;40759452;7144763;784214;232492
FR;0;2022-10-30;86;110;282;1579;87;245;1626;2126;539;54600234;52024298;37555636;6761883;53702835;40759697;7146389;786340;233031
FR;0;2022-10-31;377;474;2066;16015;340;1617;16375;22053;5410;54600611;52024772;37557702;6777898;53703175;40761314;7162764;808393;238441
FR;0;2022-11-01;61;118;892;1079;86;915;1125;1631;460;54600672;52024890;37558594;6778977;53703261;40762229;7163889;810024;238901
FR;0;2022-11-02;492;646;3012;25276;477;2554;25737;36379;10002;54601164;52025536;37561606;6804253;53703738;40764783;7189626;846403;248903
FR;0;2022-11-03;634;678;4066;39829;512;3078;40559;56563;15165;54601798;52026214;37565672;6844082;53704250;40767861;7230185;902966;264068
FR;0;2022-11-04;644;814;4407;43596;558;3503;44212;60409;15189;54602442;52027028;37570079;6887678;53704808;40771364;7274397;963375;279257
FR;0;2022-11-05;247;353;1438;9683;276;1157;9879;13398;3275;54602689;52027381;37571517;6897361;53705084;40772521;7284276;976773;282532
FR;0;2022-11-06;87;109;260;1581;90;245;1606;2290;631;54602776;52027490;37571777;6898942;53705174;40772766;7285882;979063;283163
FR;0;2022-11-07;451;512;2696;26462;425;2179;27088;38564;10812;54603227;52028002;37574473;6925404;53705599;40774945;7312970;1017627;293975
FR;0;2022-11-08;585;764;4948;51765;549;3782;52748;73816;19843;54603812;52028766;37579421;6977169;53706148;40778727;7365718;1091443;313818
FR;0;2022-11-09;497;637;3316;31477;461;2644;32245;46040;13049;54604309;52029403;37582737;7008646;53706609;40781371;7397963;1137483;326867
FR;0;2022-11-10;594;844;4528;43416;591;3583;44313;62339;17102;54604903;52030247;37587265;7052062;53707200;40784954;7442276;1199822;343969
FR;0;2022-11-11;67;104;358;1645;70;302;1709;2761;991;54604970;52030351;37587623;7053707;53707270;40785256;7443985;1202583;344960
FR;0;2022-11-12;194;309;1177;7087;219;957;7325;10272;2758;54605164;52030660;37588800;7060794;53707489;40786213;7451310;1212855;347718
FR;0;2022-11-13;61;82;237;1199;58;203;1248;1954;617;54605225;52030742;37589037;7061993;53707547;40786416;7452558;1214809;348335
FR;0;2022-11-14;423;507;2540;23836;355;2020;24454;35852;10729;54605648;52031249;37591577;7085829;53707902;40788436;7477012;1250661;359064
FR;0;2022-11-15;563;682;4258;44731;509;3291;45687;66247;19270;54606211;52031931;37595835;7130560;53708411;40791727;7522699;1316908;378334
FR;0;2022-11-16;529;604;3014;28238;474;2530;28760;42688;13137;54606740;52032535;37598849;7158798;53708885;40794257;7551459;1359596;391471
FR;0;2022-11-17;541;634;3755;38961;483;2916;39562;57638;17018;54607281;52033169;37602604;7197759;53709368;40797173;7591021;1417234;408489
FR;0;2022-11-18;607;752;4552;44893;560;3411;45773;65160;18095;54607888;52033921;37607156;7242652;53709928;40800584;7636794;1482394;426584
FR;0;2022-11-19;262;323;1459;9716;253;1044;9913;14162;3932;54608150;52034244;37608615;7252368;53710181;40801628;7646707;1496556;430516
FR;0;2022-11-20;61;84;293;1661;66;245;1738;2647;828;54608211;52034328;37608908;7254029;53710247;40801873;7648445;1499203;431344
FR;0;2022-11-21;420;497;2375;21182;336;1898;21733;32541;10072;54608631;52034825;37611283;7275211;53710583;40803771;7670178;1531744;441416
FR;0;2022-11-22;521;572;3920;39398;398;3059;39968;58880;17730;54609152;52035397;37615203;7314609;53710981;40806830;7710146;1590624;459146
FR;0;2022-11-23;451;527;2699;25718;367;2265;26210;39762;12605;54609603;52035924;37617902;7340327;53711348;40809095;7736356;1630386;471751
FR;0;2022-11-24;494;571;3703;36728;407;2874;37395;55842;17456;54610097;52036495;37621605;7377055;53711755;40811969;7773751;1686228;489207
FR;0;2022-11-25;556;684;4124;39850;538;3080;40704;59024;17163;54610653;52037179;37625729;7416905;53712293;40815049;7814455;1745252;506370
FR;0;2022-11-26;288;331;1312;9307;252;1044;9442;13917;3938;54610941;52037510;37627041;7426212;53712545;40816093;7823897;1759169;510308
FR;0;2022-11-27;69;72;257;1652;54;218;1677;2535;799;54611010;52037582;37627298;7427864;53712599;40816311;7825574;1761704;511107
FR;0;2022-11-28;392;451;2578;24451;333;1924;25141;37792;11821;54611402;52038033;37629876;7452315;53712932;40818235;7850715;1799496;522928
FR;0;2022-11-29;481;582;4310;46016;356;3207;46722;70183;21949;54611883;52038615;37634186;7498331;53713288;40821442;7897437;1869679;544877
FR;0;2022-11-30;489;650;3653;36583;453;2819;37357;55618;16933;54612372;52039265;37637839;7534914;53713741;40824261;7934794;1925297;561810
FR;0;2022-12-01;468;584;4788;51133;377;3355;51952;78364;24711;54612840;52039849;37642627;7586047;53714118;40827616;7986746;2003661;586521
FR;0;2022-12-02;598;693;5815;60867;477;4041;62080;91301;27012;54613438;52040542;37648442;7646914;53714595;40831657;8048826;2094962;613533
FR;0;2022-12-03;292;326;2131;17875;210;1478;18300;26468;7530;54613730;52040868;37650573;7664789;53714805;40833135;8067126;2121430;621063
FR;0;2022-12-04;92;115;513;4257;83;418;4313;6356;1824;54613822;52040983;37651086;7669046;53714888;40833553;8071439;2127786;622887
FR;0;2022-12-05;426;526;4132;44202;372;2754;45152;68046;21447;54614248;52041509;37655218;7713248;53715260;40836307;8116591;2195832;644334
FR;0;2022-12-06;589;700;6699;77293;435;4507;78819;119917;38805;54614837;52042209;37661917;7790541;53715695;40840814;8195410;2315749;683139
FR;0;2022-12-07;512;584;5203;57374;425;3445;58488;88986;28906;54615349;52042793;37667120;7847915;53716120;40844259;8253898;2404735;712045
FR;0;2022-12-08;565;661;6758;78238;409;4367;79880;121520;39755;54615914;52043454;37673878;7926153;53716529;40848626;8333778;2526255;751800
FR;0;2022-12-09;744;791;8366;94064;509;5445;95897;144244;45463;54616658;52044245;37682244;8020217;53717038;40854071;8429675;2670499;797263
FR;0;2022-12-10;379;391;3540;33330;246;2203;34207;49562;14359;54617037;52044636;37685784;8053547;53717284;40856274;8463882;2720061;811622
FR;0;2022-12-11;129;120;963;8089;88;655;8324;11875;3145;54617166;52044756;37686747;8061636;53717372;40856929;8472206;2731936;814767
FR;0;2022-12-12;467;519;5929;65389;319;3762;66910;102196;33032;54617633;52045275;37692676;8127025;53717691;40860691;8539116;2834132;847799
FR;0;2022-12-13;614;684;8435;99344;412;5140;101764;157257;52036;54618247;52045959;37701111;8226369;53718103;40865831;8640880;2991389;899835
