fra;vaccin;jour;n_dose1;n_dose2;n_dose3;n_dose4;n_rappel;n_cum_dose1;n_cum_dose2;n_cum_dose3;n_cum_dose4;n_cum_rappel
FR;1;2020-12-27;611;0;0;0;0;611;0;0;0;0
FR;1;2020-12-28;687;1;0;0;0;1298;1;0;0;0
FR;1;2020-12-29;385;0;0;0;0;1683;1;0;0;0
FR;1;2020-12-30;444;0;0;0;0;2127;1;0;0;0
FR;1;2020-12-31;444;1;0;0;0;2571;2;0;0;0
FR;1;2021-01-01;1162;2;0;0;0;3733;4;0;0;0
FR;1;2021-01-02;365;3;0;0;0;4098;7;0;0;0
FR;1;2021-01-03;405;0;0;0;0;4503;7;0;0;0
FR;1;2021-01-04;2117;4;0;0;0;6620;11;0;0;0
FR;1;2021-01-05;7755;4;0;0;0;14375;15;0;0;0
FR;1;2021-01-06;12460;19;0;0;0;26835;34;0;0;0
FR;1;2021-01-07;29471;19;0;0;0;56306;53;0;0;0
FR;1;2021-01-08;37151;22;0;0;0;93457;75;0;0;0
FR;1;2021-01-09;11212;9;0;0;0;104669;84;0;0;0
FR;1;2021-01-10;6009;7;0;0;0;110678;91;0;0;0
FR;1;2021-01-11;39944;27;0;0;0;150622;118;0;0;0
FR;1;2021-01-12;62146;21;0;0;0;212768;139;0;0;0
FR;1;2021-01-13;65130;47;0;0;0;277898;186;0;0;0
FR;1;2021-01-14;81457;175;0;0;0;359355;361;0;0;0
FR;1;2021-01-15;68615;71;0;0;0;427970;432;0;0;0
FR;1;2021-01-16;19901;72;0;0;0;447871;504;0;0;0
FR;1;2021-01-17;10903;48;0;0;0;458774;552;0;0;0
FR;1;2021-01-18;82838;172;0;0;0;541612;724;0;0;0
FR;1;2021-01-19;125923;191;0;0;0;667535;915;0;0;0
FR;1;2021-01-20;132421;183;0;0;0;799956;1098;0;0;0
FR;1;2021-01-21;153068;177;0;0;0;953024;1275;0;0;0
FR;1;2021-01-22;115951;222;0;0;0;1068975;1497;0;0;0
FR;1;2021-01-23;36612;69;0;0;0;1105587;1566;0;0;0
FR;1;2021-01-24;9583;104;0;0;0;1115170;1670;0;0;0
FR;1;2021-01-25;74428;1360;0;0;0;1189598;3030;0;0;0
FR;1;2021-01-26;96458;3548;1;0;0;1286056;6578;1;0;0
FR;1;2021-01-27;103650;6249;0;0;0;1389706;12827;1;0;0
FR;1;2021-01-28;120611;15846;0;0;0;1510317;28673;1;0;0
FR;1;2021-01-29;88893;18390;0;0;0;1599210;47063;1;0;0
FR;1;2021-01-30;27995;4427;0;0;0;1627205;51490;1;0;0
FR;1;2021-01-31;5191;1844;0;0;0;1632396;53334;1;0;0
FR;1;2021-02-01;49730;22315;0;0;0;1682126;75649;1;0;0
FR;1;2021-02-02;67824;37170;0;0;0;1749950;112819;1;0;0
FR;1;2021-02-03;67087;39367;0;0;0;1817037;152186;1;0;0
FR;1;2021-02-04;77143;53680;0;0;0;1894180;205866;1;0;0
FR;1;2021-02-05;63424;47214;0;0;0;1957604;253080;1;0;0
FR;1;2021-02-06;19426;11189;0;0;0;1977030;264269;1;0;0
FR;1;2021-02-07;3666;5758;0;0;0;1980696;270027;1;0;0
FR;1;2021-02-08;36501;48089;0;0;0;2017197;318116;1;0;0
FR;1;2021-02-09;50812;76854;0;0;0;2068009;394970;1;0;0
FR;1;2021-02-10;52073;81627;0;0;0;2120082;476597;1;0;0
FR;1;2021-02-11;63383;103919;0;0;0;2183465;580516;1;0;0
FR;1;2021-02-12;55872;75214;0;0;0;2239337;655730;1;0;0
FR;1;2021-02-13;15463;19312;0;0;0;2254800;675042;1;0;0
FR;1;2021-02-14;3747;7347;0;0;0;2258547;682389;1;0;0
FR;1;2021-02-15;24157;73611;0;0;0;2282704;756000;1;0;0
FR;1;2021-02-16;32777;96115;0;0;0;2315481;852115;1;0;0
FR;1;2021-02-17;35127;101682;20;0;0;2350608;953797;21;0;0
FR;1;2021-02-18;49450;117425;0;0;0;2400058;1071222;21;0;0
FR;1;2021-02-19;45384;87328;1;0;0;2445442;1158550;22;0;0
FR;1;2021-02-20;13392;27151;0;0;0;2458834;1185701;22;0;0
FR;1;2021-02-21;2461;6069;0;0;0;2461295;1191770;22;0;0
FR;1;2021-02-22;24721;69425;2;0;0;2486016;1261195;24;0;0
FR;1;2021-02-23;37431;81384;1;0;0;2523447;1342579;25;0;0
FR;1;2021-02-24;40699;79023;1;0;0;2564146;1421602;26;0;0
FR;1;2021-02-25;50161;87946;1;0;0;2614307;1509548;27;0;0
FR;1;2021-02-26;47225;67633;1;0;0;2661532;1577181;28;0;0
FR;1;2021-02-27;15683;21242;1;0;0;2677215;1598423;29;0;0
FR;1;2021-02-28;3564;4178;2;0;0;2680779;1602601;31;0;0
FR;1;2021-03-01;40202;50127;1;0;0;2720981;1652728;32;0;0
FR;1;2021-03-02;55987;62357;3;0;0;2776968;1715085;35;0;0
FR;1;2021-03-03;61247;60595;0;0;0;2838215;1775680;35;0;0
FR;1;2021-03-04;73000;67712;3;0;0;2911215;1843392;38;0;0
FR;1;2021-03-05;74774;58739;3;0;0;2985989;1902131;41;0;0
FR;1;2021-03-06;82463;15802;2;0;0;3068452;1917933;43;0;0
FR;1;2021-03-07;63724;4328;1;0;0;3132176;1922261;44;0;0
FR;1;2021-03-08;60182;41471;2;0;0;3192358;1963732;46;0;0
FR;1;2021-03-09;85999;47696;1;0;0;3278357;2011428;47;0;0
FR;1;2021-03-10;90930;47825;5;0;0;3369287;2059253;52;0;0
FR;1;2021-03-11;105091;54513;1;0;0;3474378;2113766;53;0;0
FR;1;2021-03-12;104135;44987;1;0;0;3578513;2158753;54;0;0
FR;1;2021-03-13;89209;12622;1;0;0;3667722;2171375;55;0;0
FR;1;2021-03-14;44457;2765;1;0;0;3712179;2174140;56;0;0
FR;1;2021-03-15;95524;28258;3;0;0;3807703;2202398;59;0;0
FR;1;2021-03-16;123595;34285;5;0;0;3931298;2236683;64;0;0
FR;1;2021-03-17;129314;33734;4;0;0;4060612;2270417;68;0;0
FR;1;2021-03-18;142907;39338;5;0;0;4203519;2309755;73;0;0
FR;1;2021-03-19;136260;32227;2;0;0;4339779;2341982;75;0;0
FR;1;2021-03-20;76014;9813;1;0;0;4415793;2351795;76;0;0
FR;1;2021-03-21;26516;2092;1;0;0;4442309;2353887;77;0;0
FR;1;2021-03-22;114767;30420;2;0;0;4557076;2384307;79;0;0
FR;1;2021-03-23;143043;38051;1;0;0;4700119;2422358;80;0;0
FR;1;2021-03-24;142010;38461;0;0;0;4842129;2460819;80;0;0
FR;1;2021-03-25;165013;39805;4;0;0;5007142;2500624;84;0;0
FR;1;2021-03-26;166405;37507;5;1;0;5173547;2538131;89;1;0
FR;1;2021-03-27;110883;15444;1;0;0;5284430;2553575;90;1;0
FR;1;2021-03-28;42304;4270;3;0;0;5326734;2557845;93;1;0
FR;1;2021-03-29;129826;49196;4;0;0;5456560;2607041;97;1;0
FR;1;2021-03-30;167724;63695;5;0;0;5624284;2670736;102;1;0
FR;1;2021-03-31;170946;67744;4;0;0;5795230;2738480;106;1;0
FR;1;2021-04-01;194838;83115;10;0;0;5990068;2821595;116;1;0
FR;1;2021-04-02;164459;86278;7;0;0;6154527;2907873;123;1;0
FR;1;2021-04-03;88250;58106;6;0;0;6242777;2965979;129;1;0
FR;1;2021-04-04;33653;17724;0;0;0;6276430;2983703;129;1;0
FR;1;2021-04-05;46409;9713;11;0;0;6322839;2993416;140;1;0
FR;1;2021-04-06;160321;104527;17;0;0;6483160;3097943;157;1;0
FR;1;2021-04-07;196999;108108;16;0;0;6680159;3206051;173;1;0
FR;1;2021-04-08;222146;113729;13;0;0;6902305;3319780;186;1;0
FR;1;2021-04-09;214574;107803;21;0;0;7116879;3427583;207;1;0
FR;1;2021-04-10;117185;73212;14;0;0;7234064;3500795;221;1;0
FR;1;2021-04-11;40896;29917;6;0;0;7274960;3530712;227;1;0
FR;1;2021-04-12;168477;104454;46;0;0;7443437;3635166;273;1;0
FR;1;2021-04-13;203813;127888;97;1;0;7647250;3763054;370;2;0
FR;1;2021-04-14;208635;122831;208;0;0;7855885;3885885;578;2;0
FR;1;2021-04-15;221694;127859;312;0;0;8077579;4013744;890;2;0
FR;1;2021-04-16;206073;125465;309;0;0;8283652;4139209;1199;2;0
FR;1;2021-04-17;122096;67163;103;0;0;8405748;4206372;1302;2;0
FR;1;2021-04-18;35966;20973;41;0;0;8441714;4227345;1343;2;0
FR;1;2021-04-19;163760;121567;432;0;0;8605474;4348912;1775;2;0
FR;1;2021-04-20;189442;149406;531;0;0;8794916;4498318;2306;2;0
FR;1;2021-04-21;194011;147321;760;0;0;8988927;4645639;3066;2;0
FR;1;2021-04-22;209043;164080;777;0;0;9197970;4809719;3843;2;0
FR;1;2021-04-23;198962;157653;671;0;0;9396932;4967372;4514;2;0
FR;1;2021-04-24;126335;95713;148;0;0;9523267;5063085;4662;2;0
FR;1;2021-04-25;53631;30034;46;0;0;9576898;5093119;4708;2;0
FR;1;2021-04-26;181152;139555;542;0;0;9758050;5232674;5250;2;0
FR;1;2021-04-27;221375;162287;901;0;0;9979425;5394961;6151;2;0
FR;1;2021-04-28;238310;155748;1314;1;1;10217735;5550709;7465;3;1
FR;1;2021-04-29;270301;161099;1211;0;0;10488036;5711808;8676;3;1
FR;1;2021-04-30;272000;148636;1072;0;0;10760036;5860444;9748;3;1
FR;1;2021-05-01;141154;40596;173;0;0;10901190;5901040;9921;3;1
FR;1;2021-05-02;81552;28161;81;0;0;10982742;5929201;10002;3;1
FR;1;2021-05-03;250792;143601;803;0;0;11233534;6072802;10805;3;1
FR;1;2021-05-04;265886;187502;1202;0;0;11499420;6260304;12007;3;1
FR;1;2021-05-05;283886;185648;1267;0;0;11783306;6445952;13274;3;1
FR;1;2021-05-06;309976;183955;1502;0;0;12093282;6629907;14776;3;1
FR;1;2021-05-07;284110;196151;1126;0;0;12377392;6826058;15902;3;1
FR;1;2021-05-08;191664;50503;285;0;0;12569056;6876561;16187;3;1
FR;1;2021-05-09;114058;34900;236;0;0;12683114;6911461;16423;3;1
FR;1;2021-05-10;258216;194635;1186;0;0;12941330;7106096;17609;3;1
FR;1;2021-05-11;318890;210993;1465;0;0;13260220;7317089;19074;3;1
FR;1;2021-05-12;356637;185879;1400;0;0;13616857;7502968;20474;3;1
FR;1;2021-05-13;283449;47468;401;0;0;13900306;7550436;20875;3;1
FR;1;2021-05-14;370504;128511;994;0;0;14270810;7678947;21869;3;1
FR;1;2021-05-15;298095;66157;403;0;0;14568905;7745104;22272;3;1
FR;1;2021-05-16;157779;15485;158;0;0;14726684;7760589;22430;3;1
FR;1;2021-05-17;318933;116172;1441;0;0;15045617;7876761;23871;3;1
FR;1;2021-05-18;383340;111443;1799;0;0;15428957;7988204;25670;3;1
FR;1;2021-05-19;395275;101967;2183;0;0;15824232;8090171;27853;3;1
FR;1;2021-05-20;421815;95835;2048;0;0;16246047;8186006;29901;3;1
FR;1;2021-05-21;399809;97306;1764;0;0;16645856;8283312;31665;3;1
FR;1;2021-05-22;275692;41911;603;0;0;16921548;8325223;32268;3;1
FR;1;2021-05-23;123015;11014;224;0;0;17044563;8336237;32492;3;1
FR;1;2021-05-24;244014;26241;569;0;0;17288577;8362478;33061;3;1
FR;1;2021-05-25;366226;131548;2114;1;0;17654803;8494026;35175;4;1
FR;1;2021-05-26;380814;126746;1993;0;0;18035617;8620772;37168;4;1
FR;1;2021-05-27;406154;128122;1977;0;0;18441771;8748894;39145;4;1
FR;1;2021-05-28;366033;145451;1700;0;0;18807804;8894345;40845;4;1
FR;1;2021-05-29;253834;80997;527;0;0;19061638;8975342;41372;4;1
FR;1;2021-05-30;100974;22575;157;0;0;19162612;8997917;41529;4;1
FR;1;2021-05-31;314317;148969;1284;1;1;19476929;9146886;42813;5;2
FR;1;2021-06-01;361638;166548;1729;1;1;19838567;9313434;44542;6;3
FR;1;2021-06-02;365387;153886;1796;0;0;20203954;9467320;46338;6;3
FR;1;2021-06-03;391426;147441;1653;0;0;20595380;9614761;47991;6;3
FR;1;2021-06-04;364118;175673;1495;1;1;20959498;9790434;49486;7;4
FR;1;2021-06-05;258511;112721;596;0;0;21218009;9903155;50082;7;4
FR;1;2021-06-06;126810;37541;215;0;0;21344819;9940696;50297;7;4
FR;1;2021-06-07;301105;207765;1365;0;0;21645924;10148461;51662;7;4
FR;1;2021-06-08;330849;220879;1643;0;0;21976773;10369340;53305;7;4
FR;1;2021-06-09;336590;211559;1613;0;0;22313363;10580899;54918;7;4
FR;1;2021-06-10;343896;201030;1613;0;0;22657259;10781929;56531;7;4
FR;1;2021-06-11;311900;234839;1299;1;0;22969159;11016768;57830;8;4
FR;1;2021-06-12;244081;150624;437;0;0;23213240;11167392;58267;8;4
FR;1;2021-06-13;100368;61000;188;0;0;23313608;11228392;58455;8;4
FR;1;2021-06-14;207847;288009;1318;1;0;23521455;11516401;59773;9;4
FR;1;2021-06-15;256860;281573;1398;1;0;23778315;11797974;61171;10;4
FR;1;2021-06-16;273649;270565;1263;1;0;24051964;12068539;62434;11;4
FR;1;2021-06-17;268219;244894;1236;1;0;24320183;12313433;63670;12;4
FR;1;2021-06-18;260600;295405;1153;1;0;24580783;12608838;64823;13;4
FR;1;2021-06-19;193454;209518;388;0;0;24774237;12818356;65211;13;4
FR;1;2021-06-20;69710;89094;120;0;0;24843947;12907450;65331;13;4
FR;1;2021-06-21;172375;319718;934;1;1;25016322;13227168;66265;14;5
FR;1;2021-06-22;185871;347905;1102;10;1;25202193;13575073;67367;24;6
FR;1;2021-06-23;204203;339505;1049;0;0;25406396;13914578;68416;24;6
FR;1;2021-06-24;203532;282041;1175;0;0;25609928;14196619;69591;24;6
FR;1;2021-06-25;182665;371775;1198;0;0;25792593;14568394;70789;24;6
FR;1;2021-06-26;131396;278404;504;0;0;25923989;14846798;71293;24;6
FR;1;2021-06-27;52408;122901;145;0;0;25976397;14969699;71438;24;6
FR;1;2021-06-28;136661;368196;1064;0;0;26113058;15337895;72502;24;6
FR;1;2021-06-29;154899;390949;1848;0;0;26267957;15728844;74350;24;6
FR;1;2021-06-30;180058;381941;1666;4;2;26448015;16110785;76016;28;8
FR;1;2021-07-01;201491;332336;1887;5;1;26649506;16443121;77903;33;9
FR;1;2021-07-02;193885;367427;1765;5;2;26843391;16810548;79668;38;11
FR;1;2021-07-03;124479;280422;704;3;1;26967870;17090970;80372;41;12
FR;1;2021-07-04;53964;113700;244;0;0;27021834;17204670;80616;41;12
FR;1;2021-07-05;153961;355916;1500;8;2;27175795;17560586;82116;49;14
FR;1;2021-07-06;173506;382357;1603;45;8;27349301;17942943;83719;94;22
FR;1;2021-07-07;190836;362433;1658;25;4;27540137;18305376;85377;119;26
FR;1;2021-07-08;201570;323058;1826;20;6;27741707;18628434;87203;139;32
FR;1;2021-07-09;189979;387815;1854;3;2;27931686;19016249;89057;142;34
FR;1;2021-07-10;129955;281154;816;1;1;28061641;19297403;89873;143;35
FR;1;2021-07-11;57678;102529;262;0;0;28119319;19399932;90135;143;35
FR;1;2021-07-12;149915;416918;1584;4;0;28269234;19816850;91719;147;35
FR;1;2021-07-13;234276;439229;1807;8;1;28503510;20256079;93526;155;36
FR;1;2021-07-14;171919;151426;418;0;0;28675429;20407505;93944;155;36
FR;1;2021-07-15;279682;424408;1858;1;0;28955111;20831913;95802;156;36
FR;1;2021-07-16;290439;400835;1711;3;1;29245550;21232748;97513;159;37
FR;1;2021-07-17;217346;282029;755;1;0;29462896;21514777;98268;160;37
FR;1;2021-07-18;102011;107218;288;0;0;29564907;21621995;98556;160;37
FR;1;2021-07-19;238218;378682;1497;3;0;29803125;22000677;100053;163;37
FR;1;2021-07-20;305759;380139;1469;0;0;30108884;22380816;101522;163;37
FR;1;2021-07-21;333283;352946;1412;4;2;30442167;22733762;102934;167;39
FR;1;2021-07-22;364679;318787;1502;3;2;30806846;23052549;104436;170;41
FR;1;2021-07-23;349400;343092;1588;4;1;31156246;23395641;106024;174;42
FR;1;2021-07-24;238961;240807;697;1;0;31395207;23636448;106721;175;42
FR;1;2021-07-25;112802;76019;223;0;0;31508009;23712467;106944;175;42
FR;1;2021-07-26;299143;289555;1495;2;2;31807152;24002022;108439;177;44
FR;1;2021-07-27;385833;268116;1459;4;2;32192985;24270138;109898;181;46
FR;1;2021-07-28;390200;251068;1462;4;1;32583185;24521206;111360;185;47
FR;1;2021-07-29;406135;227815;1540;2;0;32989320;24749021;112900;187;47
FR;1;2021-07-30;370743;246667;1638;4;1;33360063;24995688;114538;191;48
FR;1;2021-07-31;243381;165110;793;1;0;33603444;25160798;115331;192;48
FR;1;2021-08-01;105592;47209;233;0;0;33709036;25208007;115564;192;48
FR;1;2021-08-02;297402;212922;1479;2;0;34006438;25420929;117043;194;48
FR;1;2021-08-03;331337;208822;1557;2;1;34337775;25629751;118600;196;49
FR;1;2021-08-04;328036;184001;1439;5;3;34665811;25813752;120039;201;52
FR;1;2021-08-05;301281;193226;1482;0;0;34967092;26006978;121521;201;52
FR;1;2021-08-06;290982;224242;1560;3;1;35258074;26231220;123081;204;53
FR;1;2021-08-07;182662;158788;654;5;2;35440736;26390008;123735;209;55
FR;1;2021-08-08;68887;59104;253;0;0;35509623;26449112;123988;209;55
FR;1;2021-08-09;222787;235381;1444;4;3;35732410;26684493;125432;213;58
FR;1;2021-08-10;252740;240079;1492;2;1;35985150;26924572;126924;215;59
FR;1;2021-08-11;236234;231890;1271;5;0;36221384;27156462;128195;220;59
FR;1;2021-08-12;220784;239896;1487;3;0;36442168;27396358;129682;223;59
FR;1;2021-08-13;201720;238578;1360;2;2;36643888;27634936;131042;225;61
FR;1;2021-08-14;122862;174062;646;0;0;36766750;27808998;131688;225;61
FR;1;2021-08-15;34706;46122;200;1;0;36801456;27855120;131888;226;61
FR;1;2021-08-16;156963;289499;1423;0;0;36958419;28144619;133311;226;61
FR;1;2021-08-17;171612;291134;1422;5;0;37130031;28435753;134733;231;61
FR;1;2021-08-18;161433;286809;1392;6;3;37291464;28722562;136125;237;64
FR;1;2021-08-19;148947;277537;1403;1;0;37440411;29000099;137528;238;64
FR;1;2021-08-20;140510;309043;1532;2;2;37580921;29309142;139060;240;66
FR;1;2021-08-21;84276;213210;589;0;0;37665197;29522352;139649;240;66
FR;1;2021-08-22;28580;82695;233;0;0;37693777;29605047;139882;240;66
FR;1;2021-08-23;118662;321020;1422;2;1;37812439;29926067;141304;242;67
FR;1;2021-08-24;126664;319722;1603;5;1;37939103;30245789;142907;247;68
FR;1;2021-08-25;121531;306498;1779;8;2;38060634;30552287;144686;255;70
FR;1;2021-08-26;106628;286107;2162;10;0;38167262;30838394;146848;265;70
FR;1;2021-08-27;107656;321661;2302;9;3;38274918;31160055;149150;274;73
FR;1;2021-08-28;71020;220693;1102;0;0;38345938;31380748;150252;274;73
FR;1;2021-08-29;24152;78194;469;1;0;38370090;31458942;150721;275;73
FR;1;2021-08-30;96895;286349;4313;6;5002;38466985;31745291;155034;281;5075
FR;1;2021-08-31;98119;276295;9294;15;10095;38565104;32021586;164328;296;15170
FR;1;2021-09-01;112345;245320;21117;8;22131;38677449;32266906;185445;304;37301
FR;1;2021-09-02;86770;197934;24529;18;25507;38764219;32464840;209974;322;62808
FR;1;2021-09-03;82421;227527;26953;21;28032;38846640;32692367;236927;343;90840
FR;1;2021-09-04;71631;189719;11140;11;11696;38918271;32882086;248067;354;102536
FR;1;2021-09-05;18613;41153;4124;2;4277;38936884;32923239;252191;356;106813
FR;1;2021-09-06;59809;151470;30182;15;31202;38996693;33074709;282373;371;138015
FR;1;2021-09-07;57396;139671;30209;30;31219;39054089;33214380;312582;401;169234
FR;1;2021-09-08;72340;173799;26925;22;27931;39126429;33388179;339507;423;197165
FR;1;2021-09-09;54484;124470;28621;24;29720;39180913;33512649;368128;447;226885
FR;1;2021-09-10;66215;152086;30449;24;31654;39247128;33664735;398577;471;258539
FR;1;2021-09-11;52689;146632;9730;14;10343;39299817;33811367;408307;485;268882
FR;1;2021-09-12;10796;29271;2486;1;2649;39310613;33840638;410793;486;271531
FR;1;2021-09-13;51506;104459;38757;31;40043;39362119;33945097;449550;517;311574
FR;1;2021-09-14;53341;96024;51276;67;53153;39415460;34041121;500826;584;364727
FR;1;2021-09-15;60569;139258;50491;55;47047;39476029;34180379;551317;639;411774
FR;1;2021-09-16;46633;81406;53349;70;49587;39522662;34261785;604666;709;461361
FR;1;2021-09-17;53220;109343;45069;61;42678;39575882;34371128;649735;770;504039
FR;1;2021-09-18;37876;118497;11796;19;11275;39613758;34489625;661531;789;515314
FR;1;2021-09-19;6531;21042;2040;1;1983;39620289;34510667;663571;790;517297
FR;1;2021-09-20;36537;74877;46227;65;44181;39656826;34585544;709798;855;561478
FR;1;2021-09-21;34186;68138;56260;71;52710;39691012;34653682;766058;926;614188
FR;1;2021-09-22;38827;118602;49872;76;46899;39729839;34772284;815930;1002;661087
FR;1;2021-09-23;32024;62916;54503;85;50896;39761863;34835200;870433;1087;711983
FR;1;2021-09-24;36782;90050;43669;89;41936;39798645;34925250;914102;1176;753919
FR;1;2021-09-25;27649;96699;12306;27;12180;39826294;35021949;926408;1203;766099
FR;1;2021-09-26;4384;15194;1774;5;1696;39830678;35037143;928182;1208;767795
FR;1;2021-09-27;27350;60219;42911;89;41629;39858028;35097362;971093;1297;809424
FR;1;2021-09-28;26911;49451;47195;76;44464;39884939;35146813;1018288;1373;853888
FR;1;2021-09-29;35924;80323;47277;87;45589;39920863;35227136;1065565;1460;899477
FR;1;2021-09-30;26074;46894;47524;81;45448;39946937;35274030;1113089;1541;944925
FR;1;2021-10-01;47294;66948;44894;83;44599;39994231;35340978;1157983;1624;989524
FR;1;2021-10-02;32383;62415;16112;32;16317;40026614;35403393;1174095;1656;1005841
FR;1;2021-10-03;4342;8561;2039;3;2033;40030956;35411954;1176134;1659;1007874
FR;1;2021-10-04;28972;44435;47105;79;46959;40059928;35456389;1223239;1738;1054833
FR;1;2021-10-05;24566;41669;49876;116;49308;40084494;35498058;1273115;1854;1104141
FR;1;2021-10-06;34653;61380;57499;102;57233;40119147;35559438;1330614;1956;1161374
FR;1;2021-10-07;21079;39911;53040;75;51963;40140226;35599349;1383654;2031;1213337
FR;1;2021-10-08;35660;59657;60396;83;61137;40175886;35659006;1444050;2114;1274474
FR;1;2021-10-09;27463;48010;25495;29;26018;40203349;35707016;1469545;2143;1300492
FR;1;2021-10-10;3723;5810;2754;7;2860;40207072;35712826;1472299;2150;1303352
FR;1;2021-10-11;24852;38238;54583;88;55252;40231924;35751064;1526882;2238;1358604
FR;1;2021-10-12;23377;36595;58067;127;59207;40255301;35787659;1584949;2365;1417811
FR;1;2021-10-13;32962;47839;64167;124;65679;40288263;35835498;1649116;2489;1483490
FR;1;2021-10-14;21711;34790;53763;103;54349;40309974;35870288;1702879;2592;1537839
FR;1;2021-10-15;32745;48796;72326;165;75000;40342719;35919084;1775205;2757;1612839
FR;1;2021-10-16;26009;35293;34867;44;36410;40368728;35954377;1810072;2801;1649249
FR;1;2021-10-17;3156;4053;3413;2;3316;40371884;35958430;1813485;2803;1652565
FR;1;2021-10-18;24297;34896;66836;131;69708;40396181;35993326;1880321;2934;1722273
FR;1;2021-10-19;20718;35591;75656;135;79568;40416899;36028917;1955977;3069;1801841
FR;1;2021-10-20;29908;44228;96174;178;99847;40446807;36073145;2052151;3247;1901688
FR;1;2021-10-21;19797;35059;83176;107;87019;40466604;36108204;2135327;3354;1988707
FR;1;2021-10-22;29751;47783;103737;196;109682;40496355;36155987;2239064;3550;2098389
FR;1;2021-10-23;23048;35139;44869;57;47379;40519403;36191126;2283933;3607;2145768
FR;1;2021-10-24;2405;3838;3583;6;3720;40521808;36194964;2287516;3613;2149488
FR;1;2021-10-25;22493;30766;82020;143;85816;40544301;36225730;2369536;3756;2235304
FR;1;2021-10-26;19364;27682;86107;162;90331;40563665;36253412;2455643;3918;2325635
FR;1;2021-10-27;26193;39641;107804;252;112696;40589858;36293053;2563447;4170;2438331
FR;1;2021-10-28;18778;27135;86952;150;91694;40608636;36320188;2650399;4320;2530025
FR;1;2021-10-29;25925;40282;114825;202;121627;40634561;36360470;2765224;4522;2651652
FR;1;2021-10-30;17693;28724;49362;74;51951;40652254;36389194;2814586;4596;2703603
FR;1;2021-10-31;2060;3171;3450;2;3685;40654314;36392365;2818036;4598;2707288
FR;1;2021-11-01;7990;4265;3029;3;3287;40662304;36396630;2821065;4601;2710575
FR;1;2021-11-02;22884;33242;92394;156;97818;40685188;36429872;2913459;4757;2808393
FR;1;2021-11-03;26607;41594;117501;217;123865;40711795;36471466;3030960;4974;2932258
FR;1;2021-11-04;19600;30335;105802;213;111934;40731395;36501801;3136762;5187;3044192
FR;1;2021-11-05;27010;42342;138772;229;147424;40758405;36544143;3275534;5416;3191616
FR;1;2021-11-06;18848;29830;63480;123;66488;40777253;36573973;3339014;5539;3258104
FR;1;2021-11-07;1810;3285;4976;6;5301;40779063;36577258;3343990;5545;3263405
FR;1;2021-11-08;17847;32272;125999;224;132621;40796910;36609530;3469989;5769;3396026
FR;1;2021-11-09;19486;37661;159295;334;169080;40816396;36647191;3629284;6103;3565106
FR;1;2021-11-10;28865;49144;181896;440;192507;40845261;36696335;3811180;6543;3757613
FR;1;2021-11-11;4173;5946;12228;26;13020;40849434;36702281;3823408;6569;3770633
FR;1;2021-11-12;26013;46870;174812;244;186478;40875447;36749151;3998220;6813;3957111
FR;1;2021-11-13;18731;29171;76832;111;81774;40894178;36778322;4075052;6924;4038885
FR;1;2021-11-14;2044;3260;6820;5;7356;40896222;36781582;4081872;6929;4046241
FR;1;2021-11-15;18760;34809;156417;304;166238;40914982;36816391;4238289;7233;4212479
FR;1;2021-11-16;21348;37930;192112;380;204990;40936330;36854321;4430401;7613;4417469
FR;1;2021-11-17;28646;45618;193224;398;205028;40964976;36899939;4623625;8011;4622497
FR;1;2021-11-18;21129;39548;182489;458;194531;40986105;36939487;4806114;8469;4817028
FR;1;2021-11-19;30880;53393;230246;532;246713;41016985;36992880;5036360;9001;5063741
FR;1;2021-11-20;23761;33248;96984;201;103617;41040746;37026128;5133344;9202;5167358
FR;1;2021-11-21;2330;3926;9115;19;9942;41043076;37030054;5142459;9221;5177300
FR;1;2021-11-22;21408;30391;175900;465;189432;41064484;37060445;5318359;9686;5366732
FR;1;2021-11-23;24019;41055;221205;540;237936;41088503;37101500;5539564;10226;5604668
FR;1;2021-11-24;30285;49740;217337;701;234507;41118788;37151240;5756901;10927;5839175
FR;1;2021-11-25;23719;44100;244468;718;264124;41142507;37195340;6001369;11645;6103299
FR;1;2021-11-26;30625;66752;356794;836;388533;41173132;37262092;6358163;12481;6491832
FR;1;2021-11-27;21947;45354;202622;371;222632;41195079;37307446;6560785;12852;6714464
FR;1;2021-11-28;3168;9605;54787;63;61017;41198247;37317051;6615572;12915;6775481
FR;1;2021-11-29;17880;49534;326378;841;354452;41216127;37366585;6941950;13756;7129933
FR;1;2021-11-30;22786;64942;431137;952;470759;41238913;37431527;7373087;14708;7600692
FR;1;2021-12-01;25337;69293;442880;1131;481748;41264250;37500820;7815967;15839;8082440
FR;1;2021-12-02;20071;64556;489382;1228;532895;41284321;37565376;8305349;17067;8615335
FR;1;2021-12-03;22899;82549;542763;1309;591766;41307220;37647925;8848112;18376;9207101
FR;1;2021-12-04;16395;53938;299089;654;328944;41323615;37701863;9147201;19030;9536045
FR;1;2021-12-05;3633;13848;81522;143;91047;41327248;37715711;9228723;19173;9627092
FR;1;2021-12-06;25821;62633;415435;1066;455161;41353069;37778344;9644158;20239;10082253
FR;1;2021-12-07;19999;75632;522959;1535;572556;41373068;37853976;10167117;21774;10654809
FR;1;2021-12-08;21697;75750;458396;1544;502106;41394765;37929726;10625513;23318;11156915
FR;1;2021-12-09;19447;74069;492921;1625;540860;41414212;38003795;11118434;24943;11697775
FR;1;2021-12-10;23308;87726;547378;1585;600021;41437520;38091521;11665812;26528;12297796
FR;1;2021-12-11;16533;59222;302741;749;335484;41454053;38150743;11968553;27277;12633280
FR;1;2021-12-12;4376;15954;83214;179;94044;41458429;38166697;12051767;27456;12727324
FR;1;2021-12-13;15751;63629;366963;1094;406241;41474180;38230326;12418730;28550;13133565
FR;1;2021-12-14;20856;80346;464744;1746;515198;41495036;38310672;12883474;30296;13648763
FR;1;2021-12-15;21607;77524;409065;1309;453146;41516643;38388196;13292539;31605;14101909
FR;1;2021-12-16;20043;77351;451850;1578;500616;41536686;38465547;13744389;33183;14602525
FR;1;2021-12-17;22616;86634;479929;1735;530971;41559302;38552181;14224318;34918;15133496
FR;1;2021-12-18;17603;54691;257618;730;288519;41576905;38606872;14481936;35648;15422015
FR;1;2021-12-19;5551;17020;79180;194;90712;41582456;38623892;14561116;35842;15512727
FR;1;2021-12-20;20932;63153;316233;1080;355305;41603388;38687045;14877349;36922;15868032
FR;1;2021-12-21;26326;73104;372735;1423;418083;41629714;38760149;15250084;38345;16286115
FR;1;2021-12-22;24977;65907;310624;1216;349590;41654691;38826056;15560708;39561;16635705
FR;1;2021-12-23;21272;52297;241482;956;273034;41675963;38878353;15802190;40517;16908739
FR;1;2021-12-24;7125;18344;67154;258;77063;41683088;38896697;15869344;40775;16985802
FR;1;2021-12-25;507;2872;5585;15;6538;41683595;38899569;15874929;40790;16992340
FR;1;2021-12-26;2749;7586;26935;71;31455;41686344;38907155;15901864;40861;17023795
FR;1;2021-12-27;18306;53594;235111;705;265769;41704650;38960749;16136975;41566;17289564
FR;1;2021-12-28;23298;62039;292034;1026;330213;41727948;39022788;16429009;42592;17619777
FR;1;2021-12-29;22215;55555;254995;920;288220;41750163;39078343;16684004;43512;17907997
FR;1;2021-12-30;21239;46553;212156;858;239632;41771402;39124896;16896160;44370;18147629
FR;1;2021-12-31;7465;16593;61870;229;70408;41778867;39141489;16958030;44599;18218037
FR;1;2022-01-01;1153;2487;5656;30;6575;41780020;39143976;16963686;44629;18224612
FR;1;2022-01-02;3081;8060;28890;50;33523;41783101;39152036;16992576;44679;18258135
FR;1;2022-01-03;24538;54256;228232;789;257699;41807639;39206292;17220808;45468;18515834
FR;1;2022-01-04;26065;65089;299249;1238;337283;41833704;39271381;17520057;46706;18853117
FR;1;2022-01-05;30459;64340;274869;1099;310234;41864163;39335721;17794926;47805;19163351
FR;1;2022-01-06;26817;66258;306879;1399;346532;41890980;39401979;18101805;49204;19509883
FR;1;2022-01-07;31561;75080;349830;1538;393980;41922541;39477059;18451635;50742;19903863
FR;1;2022-01-08;23386;51397;222491;698;251120;41945927;39528456;18674126;51440;20154983
FR;1;2022-01-09;7088;17144;66024;163;76140;41953015;39545600;18740150;51603;20231123
FR;1;2022-01-10;21779;60707;236797;954;267625;41974794;39606307;18976947;52557;20498748
FR;1;2022-01-11;26758;63508;282281;1277;317808;42001552;39669815;19259228;53834;20816556
FR;1;2022-01-12;28949;62551;246254;1105;278040;42030501;39732366;19505482;54939;21094596
FR;1;2022-01-13;24773;60245;262794;1253;296127;42055274;39792611;19768276;56192;21390723
FR;1;2022-01-14;27965;66774;313998;1366;351261;42083239;39859385;20082274;57558;21741984
FR;1;2022-01-15;19358;44441;199306;619;223859;42102597;39903826;20281580;58177;21965843
FR;1;2022-01-16;5158;12994;51526;135;59565;42107755;39916820;20333106;58312;22025408
FR;1;2022-01-17;16862;39786;184827;781;206849;42124617;39956606;20517933;59093;22232257
FR;1;2022-01-18;19452;46029;212420;1154;237047;42144069;40002635;20730353;60247;22469304
FR;1;2022-01-19;20301;44027;176102;897;197188;42164370;40046662;20906455;61144;22666492
FR;1;2022-01-20;16836;40639;183675;1138;204743;42181206;40087301;21090130;62282;22871235
FR;1;2022-01-21;19911;47099;228948;1405;253352;42201117;40134400;21319078;63687;23124587
FR;1;2022-01-22;13843;33366;144493;578;161386;42214960;40167766;21463571;64265;23285973
FR;1;2022-01-23;3377;8785;33426;132;38325;42218337;40176551;21496997;64397;23324298
FR;1;2022-01-24;11804;33018;142207;710;158255;42230141;40209569;21639204;65107;23482553
FR;1;2022-01-25;14210;38229;163397;1047;181564;42244351;40247798;21802601;66154;23664117
FR;1;2022-01-26;14860;37710;150251;932;166353;42259211;40285508;21952852;67086;23830470
FR;1;2022-01-27;12334;33269;143451;889;157990;42271545;40318777;22096303;67975;23988460
FR;1;2022-01-28;16322;56932;198310;1143;222417;42287867;40375709;22294613;69118;24210877
FR;1;2022-01-29;10268;35504;135205;525;151548;42298135;40411213;22429818;69643;24362425
FR;1;2022-01-30;2483;9274;29681;86;34461;42300618;40420487;22459499;69729;24396886
FR;1;2022-01-31;8757;32502;104339;533;117381;42309375;40452989;22563838;70262;24514267
FR;1;2022-02-01;10977;36515;127069;864;141255;42320352;40489504;22690907;71126;24655522
FR;1;2022-02-02;11987;41623;130350;782;145841;42332339;40531127;22821257;71908;24801363
FR;1;2022-02-03;9238;34028;117006;784;130355;42341577;40565155;22938263;72692;24931718
FR;1;2022-02-04;11521;48196;172577;967;192773;42353098;40613351;23110840;73659;25124491
FR;1;2022-02-05;7993;33954;117580;391;133049;42361091;40647305;23228420;74050;25257540
FR;1;2022-02-06;1706;8008;22752;85;26912;42362797;40655313;23251172;74135;25284452
FR;1;2022-02-07;7311;35439;119082;458;134964;42370108;40690752;23370254;74593;25419416
FR;1;2022-02-08;7756;31940;125642;693;140631;42377864;40722692;23495896;75286;25560047
FR;1;2022-02-09;8652;36513;135246;698;152490;42386516;40759205;23631142;75984;25712537
FR;1;2022-02-10;7019;30053;116370;674;130157;42393535;40789258;23747512;76658;25842694
FR;1;2022-02-11;8655;41535;165134;878;185357;42402190;40830793;23912646;77536;26028051
FR;1;2022-02-12;5335;27603;106702;379;120887;42407525;40858396;24019348;77915;26148938
FR;1;2022-02-13;1244;5718;21717;66;25333;42408769;40864114;24041065;77981;26174271
FR;1;2022-02-14;5453;27216;118082;392;133110;42414222;40891330;24159147;78373;26307381
FR;1;2022-02-15;5785;28847;118918;610;132549;42420007;40920177;24278065;78983;26439930
FR;1;2022-02-16;5751;28473;110417;596;123048;42425758;40948650;24388482;79579;26562978
FR;1;2022-02-17;4610;19727;73138;487;80242;42430368;40968377;24461620;80066;26643220
FR;1;2022-02-18;5604;26781;99198;670;108157;42435972;40995158;24560818;80736;26751377
FR;1;2022-02-19;3550;17173;59475;304;66056;42439522;41012331;24620293;81040;26817433
FR;1;2022-02-20;791;3253;10705;36;12332;42440313;41015584;24630998;81076;26829765
FR;1;2022-02-21;3423;14587;52824;286;57670;42443736;41030171;24683822;81362;26887435
FR;1;2022-02-22;3789;15535;51913;500;55651;42447525;41045706;24735735;81862;26943086
FR;1;2022-02-23;4231;17813;57469;508;62570;42451756;41063519;24793204;82370;27005656
FR;1;2022-02-24;3341;13061;43612;436;46401;42455097;41076580;24836816;82806;27052057
FR;1;2022-02-25;4471;19883;64921;696;68792;42459568;41096463;24901737;83502;27120849
FR;1;2022-02-26;2693;12800;41368;310;45121;42462261;41109263;24943105;83812;27165970
FR;1;2022-02-27;644;2189;7127;42;7992;42462905;41111452;24950232;83854;27173962
FR;1;2022-02-28;2612;10477;34954;306;37379;42465517;41121929;24985186;84160;27211341
FR;1;2022-03-01;3555;10747;38698;390;39653;42469072;41132676;25023884;84550;27250994
FR;1;2022-03-02;3664;12178;41854;397;43924;42472736;41144854;25065738;84947;27294918
FR;1;2022-03-03;2449;7970;26175;326;26513;42475185;41152824;25091913;85273;27321431
FR;1;2022-03-04;2684;10450;35429;591;34924;42477869;41163274;25127342;85864;27356355
FR;1;2022-03-05;1820;6359;21964;277;22360;42479689;41169633;25149306;86141;27378715
FR;1;2022-03-06;358;955;2917;38;3120;42480047;41170588;25152223;86179;27381835
FR;1;2022-03-07;1739;4713;16433;245;15900;42481786;41175301;25168656;86424;27397735
FR;1;2022-03-08;1687;5254;17167;308;15994;42483473;41180555;25185823;86732;27413729
FR;1;2022-03-09;1984;6678;19804;368;19164;42485457;41187233;25205627;87100;27432893
FR;1;2022-03-10;1404;4971;15278;308;14318;42486861;41192204;25220905;87408;27447211
FR;1;2022-03-11;1753;6399;21703;483;19857;42488614;41198603;25242608;87891;27467068
FR;1;2022-03-12;1240;4649;15361;280;14910;42489854;41203252;25257969;88171;27481978
FR;1;2022-03-13;249;612;2120;119;2066;42490103;41203864;25260089;88290;27484044
FR;1;2022-03-14;1143;3675;13400;3879;12523;42491246;41207539;25273489;92169;27496567
FR;1;2022-03-15;1393;5728;14653;6862;13252;42492639;41213267;25288142;99031;27509819
FR;1;2022-03-16;1691;5071;17391;11518;16454;42494330;41218338;25305533;110549;27526273
FR;1;2022-03-17;1170;3434;11723;9648;10821;42495500;41221772;25317256;120197;27537094
FR;1;2022-03-18;1726;4925;17963;16502;16401;42497226;41226697;25335219;136699;27553495
FR;1;2022-03-19;1124;3299;11889;8455;11357;42498350;41229996;25347108;145154;27564852
FR;1;2022-03-20;224;559;1725;1014;1759;42498574;41230555;25348833;146168;27566611
FR;1;2022-03-21;1085;2763;11492;13447;10841;42499659;41233318;25360325;159615;27577452
FR;1;2022-03-22;1231;3207;12253;18704;11243;42500890;41236525;25372578;178319;27588695
FR;1;2022-03-23;1502;4343;16024;20111;15708;42502392;41240868;25388602;198430;27604403
FR;1;2022-03-24;1114;2748;10394;16050;9657;42503506;41243616;25398996;214480;27614060
FR;1;2022-03-25;1533;4354;16742;25300;15395;42505039;41247970;25415738;239780;27629455
FR;1;2022-03-26;1108;3011;10854;11450;10515;42506147;41250981;25426592;251230;27639970
FR;1;2022-03-27;233;544;1749;1381;1802;42506380;41251525;25428341;252611;27641772
FR;1;2022-03-28;1080;2483;9973;15883;9596;42507460;41254008;25438314;268494;27651368
FR;1;2022-03-29;1140;2738;11551;25097;10919;42508600;41256746;25449865;293591;27662287
FR;1;2022-03-30;1625;3591;14163;24187;13696;42510225;41260337;25464028;317778;27675983
FR;1;2022-03-31;1278;3009;11689;22649;11196;42511503;41263346;25475717;340427;27687179
FR;1;2022-04-01;2227;4018;18462;28517;17333;42513730;41267364;25494179;368944;27704512
FR;1;2022-04-02;907;1884;8190;9222;7938;42514637;41269248;25502369;378166;27712450
FR;1;2022-04-03;201;379;1432;1056;1433;42514838;41269627;25503801;379222;27713883
FR;1;2022-04-04;1879;2460;11364;17670;10753;42516717;41272087;25515165;396892;27724636
FR;1;2022-04-05;1699;2700;12995;31171;12020;42518416;41274787;25528160;428063;27736656
FR;1;2022-04-06;1644;2982;12195;23916;11625;42520060;41277769;25540355;451979;27748281
FR;1;2022-04-07;1278;2706;12342;31054;11808;42521338;41280475;25552697;483033;27760089
FR;1;2022-04-08;1611;3607;17554;40579;16461;42522949;41284082;25570251;523612;27776550
FR;1;2022-04-09;817;1992;8404;12496;8102;42523766;41286074;25578655;536108;27784652
FR;1;2022-04-10;199;588;1834;1852;1878;42523965;41286662;25580489;537960;27786530
FR;1;2022-04-11;1064;2237;10963;22326;10678;42525029;41288899;25591452;560286;27797208
FR;1;2022-04-12;1308;2619;12818;38108;12305;42526337;41291518;25604270;598394;27809513
FR;1;2022-04-13;1259;2850;12268;30607;11998;42527596;41294368;25616538;629001;27821511
FR;1;2022-04-14;1218;2515;12097;33594;12099;42528814;41296883;25628635;662595;27833610
FR;1;2022-04-15;1480;2934;14392;33206;13768;42530294;41299817;25643027;695801;27847378
FR;1;2022-04-16;658;1403;5840;7985;5765;42530952;41301220;25648867;703786;27853143
FR;1;2022-04-17;155;287;929;1119;974;42531107;41301507;25649796;704905;27854117
FR;1;2022-04-18;164;466;2633;999;2657;42531271;41301973;25652429;705904;27856774
FR;1;2022-04-19;1239;2585;11777;27894;11508;42532510;41304558;25664206;733798;27868282
FR;1;2022-04-20;1337;2627;12172;26846;12012;42533847;41307185;25676378;760644;27880294
FR;1;2022-04-21;1237;2456;11533;33219;11744;42535084;41309641;25687911;793863;27892038
FR;1;2022-04-22;1511;3070;15204;35483;14785;42536595;41312711;25703115;829346;27906823
FR;1;2022-04-23;760;1580;6731;9890;6637;42537355;41314291;25709846;839236;27913460
FR;1;2022-04-24;196;372;1373;1520;1327;42537551;41314663;25711219;840756;27914787
FR;1;2022-04-25;1035;2128;9849;19688;9750;42538586;41316791;25721068;860444;27924537
FR;1;2022-04-26;1344;2620;12592;36544;12199;42539930;41319411;25733660;896988;27936736
FR;1;2022-04-27;1324;2404;10647;29182;10784;42541254;41321815;25744307;926170;27947520
FR;1;2022-04-28;1277;2390;11558;34251;11400;42542531;41324205;25755865;960421;27958920
FR;1;2022-04-29;1611;3938;14393;35508;13836;42544142;41328143;25770258;995929;27972756
FR;1;2022-04-30;828;1558;6446;9163;6288;42544970;41329701;25776704;1005092;27979044
FR;1;2022-05-01;176;286;829;948;822;42545146;41329987;25777533;1006040;27979866
FR;1;2022-05-02;1602;2582;10370;16905;10279;42546748;41332569;25787903;1022945;27990145
FR;1;2022-05-03;1514;2854;12701;32879;12593;42548262;41335423;25800604;1055824;28002738
FR;1;2022-05-04;1347;2727;11226;23798;11383;42549609;41338150;25811830;1079622;28014121
FR;1;2022-05-05;1461;2600;12171;31808;12095;42551070;41340750;25824001;1111430;28026216
FR;1;2022-05-06;1810;3230;14224;34884;13792;42552880;41343980;25838225;1146314;28040008
FR;1;2022-05-07;852;1468;5974;9089;6008;42553732;41345448;25844199;1155403;28046016
FR;1;2022-05-08;190;328;1059;1470;1121;42553922;41345776;25845258;1156873;28047137
FR;1;2022-05-09;1114;2005;9243;19257;9157;42555036;41347781;25854501;1176130;28056294
FR;1;2022-05-10;1462;2819;12605;37090;12204;42556498;41350600;25867106;1213220;28068498
FR;1;2022-05-11;1431;2456;9905;26012;9850;42557929;41353056;25877011;1239232;28078348
FR;1;2022-05-12;1313;2409;10511;33572;10212;42559242;41355465;25887522;1272804;28088560
FR;1;2022-05-13;1603;2793;12757;35715;12403;42560845;41358258;25900279;1308519;28100963
FR;1;2022-05-14;779;1317;5479;10210;5364;42561624;41359575;25905758;1318729;28106327
FR;1;2022-05-15;220;413;1183;1349;1251;42561844;41359988;25906941;1320078;28107578
FR;1;2022-05-16;967;1767;8069;20061;8122;42562811;41361755;25915010;1340139;28115700
FR;1;2022-05-17;1288;2288;11115;36150;10722;42564099;41364043;25926125;1376289;28126422
FR;1;2022-05-18;1302;2119;9032;25696;8983;42565401;41366162;25935157;1401985;28135405
FR;1;2022-05-19;1194;2387;9845;33981;9939;42566595;41368549;25945002;1435966;28145344
FR;1;2022-05-20;1562;2749;12520;37636;12104;42568157;41371298;25957522;1473602;28157448
FR;1;2022-05-21;774;1373;5246;9373;5164;42568931;41372671;25962768;1482975;28162612
FR;1;2022-05-22;191;288;948;1395;948;42569122;41372959;25963716;1484370;28163560
FR;1;2022-05-23;968;1876;8368;19404;8344;42570090;41374835;25972084;1503774;28171904
FR;1;2022-05-24;1284;2443;10716;37225;10585;42571374;41377278;25982800;1540999;28182489
FR;1;2022-05-25;1271;2286;8789;23661;8949;42572645;41379564;25991589;1564660;28191438
FR;1;2022-05-26;167;368;1576;1148;1570;42572812;41379932;25993165;1565808;28193008
FR;1;2022-05-27;1104;2173;8778;20436;8529;42573916;41382105;26001943;1586244;28201537
FR;1;2022-05-28;481;1041;3685;6529;3723;42574397;41383146;26005628;1592773;28205260
FR;1;2022-05-29;120;257;706;893;717;42574517;41383403;26006334;1593666;28205977
FR;1;2022-05-30;829;1722;6558;18529;6587;42575346;41385125;26012892;1612195;28212564
FR;1;2022-05-31;1265;2213;9240;34366;9109;42576611;41387338;26022132;1646561;28221673
FR;1;2022-06-01;1303;2589;10430;23447;10292;42577914;41389927;26032562;1670008;28231965
FR;1;2022-06-02;1219;2303;10665;34114;10233;42579133;41392230;26043227;1704122;28242198
FR;1;2022-06-03;1437;2728;12690;37088;12110;42580570;41394958;26055917;1741210;28254308
FR;1;2022-06-04;679;1260;4745;8675;4822;42581249;41396218;26060662;1749885;28259130
FR;1;2022-06-05;130;286;810;1048;832;42581379;41396504;26061472;1750933;28259962
FR;1;2022-06-06;349;1076;2012;1182;2025;42581728;41397580;26063484;1752115;28261987
FR;1;2022-06-07;1141;2302;9175;34033;8836;42582869;41399882;26072659;1786148;28270823
FR;1;2022-06-08;1102;2225;8666;27534;8548;42583971;41402107;26081325;1813682;28279371
FR;1;2022-06-09;1061;2142;9977;37543;9659;42585032;41404249;26091302;1851225;28289030
FR;1;2022-06-10;1328;2562;12390;43094;11967;42586360;41406811;26103692;1894319;28300997
FR;1;2022-06-11;656;1443;5136;11080;5184;42587016;41408254;26108828;1905399;28306181
FR;1;2022-06-12;151;371;1013;1683;1069;42587167;41408625;26109841;1907082;28307250
FR;1;2022-06-13;904;1825;7007;22217;6864;42588071;41410450;26116848;1929299;28314114
FR;1;2022-06-14;1085;2178;9834;42826;9236;42589156;41412628;26126682;1972125;28323350
FR;1;2022-06-15;1069;1959;8776;29363;8455;42590225;41414587;26135458;2001488;28331805
FR;1;2022-06-16;938;1821;9393;38461;8870;42591163;41416408;26144851;2039949;28340675
FR;1;2022-06-17;1209;2536;11861;44762;11349;42592372;41418944;26156712;2084711;28352024
FR;1;2022-06-18;560;1267;4316;10543;4254;42592932;41420211;26161028;2095254;28356278
FR;1;2022-06-19;137;324;1002;1543;1081;42593069;41420535;26162030;2096797;28357359
FR;1;2022-06-20;854;1694;8489;25034;8152;42593923;41422229;26170519;2121831;28365511
FR;1;2022-06-21;1097;2133;9757;47740;8848;42595020;41424362;26180276;2169571;28374359
FR;1;2022-06-22;1026;2039;8431;37128;7947;42596046;41426401;26188707;2206699;28382306
FR;1;2022-06-23;1048;2160;10118;52787;9404;42597094;41428561;26198825;2259486;28391710
FR;1;2022-06-24;1246;2700;12910;65926;11693;42598340;41431261;26211735;2325412;28403403
FR;1;2022-06-25;681;1501;5922;18914;5704;42599021;41432762;26217657;2344326;28409107
FR;1;2022-06-26;166;407;1817;3493;1712;42599187;41433169;26219474;2347819;28410819
FR;1;2022-06-27;935;1764;9901;45959;9126;42600122;41434933;26229375;2393778;28419945
FR;1;2022-06-28;1205;2566;13830;86498;12396;42601327;41437499;26243205;2480276;28432341
FR;1;2022-06-29;1232;2282;11476;67354;10543;42602559;41439781;26254681;2547630;28442884
FR;1;2022-06-30;1276;2434;13510;89948;11819;42603835;41442215;26268191;2637578;28454703
FR;1;2022-07-01;1632;3465;20272;109183;17936;42605467;41445680;26288463;2746761;28472639
FR;1;2022-07-02;760;1521;8014;33770;7247;42606227;41447201;26296477;2780531;28479886
FR;1;2022-07-03;226;479;1940;6115;1755;42606453;41447680;26298417;2786646;28481641
FR;1;2022-07-04;1296;2837;13902;75386;12322;42607749;41450517;26312319;2862032;28493963
FR;1;2022-07-05;1408;2792;17671;126318;15125;42609157;41453309;26329990;2988350;28509088
FR;1;2022-07-06;1340;2380;14880;93689;12900;42610497;41455689;26344870;3082039;28521988
FR;1;2022-07-07;1428;2529;16916;119387;13987;42611925;41458218;26361786;3201426;28535975
FR;1;2022-07-08;1524;2811;19598;129968;15960;42613449;41461029;26381384;3331394;28551935
FR;1;2022-07-09;660;1268;7302;36007;6345;42614109;41462297;26388686;3367401;28558280
FR;1;2022-07-10;235;479;2239;6684;2033;42614344;41462776;26390925;3374085;28560313
FR;1;2022-07-11;1196;2206;14310;84392;11920;42615540;41464982;26405235;3458477;28572233
FR;1;2022-07-12;1549;2765;19442;137365;15878;42617089;41467747;26424677;3595842;28588111
FR;1;2022-07-13;1398;2393;14772;89807;12616;42618487;41470140;26439449;3685649;28600727
FR;1;2022-07-14;156;342;1860;5283;1769;42618643;41470482;26441309;3690932;28602496
FR;1;2022-07-15;1252;2294;14356;80564;12000;42619895;41472776;26455665;3771496;28614496
FR;1;2022-07-16;502;1041;5630;23942;4885;42620397;41473817;26461295;3795438;28619381
FR;1;2022-07-17;157;363;1655;4459;1498;42620554;41474180;26462950;3799897;28620879
FR;1;2022-07-18;970;2023;11292;59263;9559;42621524;41476203;26474242;3859160;28630438
FR;1;2022-07-19;1222;2115;14684;99375;11714;42622746;41478318;26488926;3958535;28642152
FR;1;2022-07-20;1165;1984;12349;74334;10261;42623911;41480302;26501275;4032869;28652413
FR;1;2022-07-21;1118;1938;12400;84483;9977;42625029;41482240;26513675;4117352;28662390
FR;1;2022-07-22;1238;2194;14079;85859;11408;42626267;41484434;26527754;4203211;28673798
FR;1;2022-07-23;533;1082;5228;21290;4605;42626800;41485516;26532982;4224501;28678403
FR;1;2022-07-24;147;300;1324;3695;1164;42626947;41485816;26534306;4228196;28679567
FR;1;2022-07-25;884;1620;9065;46095;7511;42627831;41487436;26543371;4274291;28687078
FR;1;2022-07-26;1123;1955;12667;81929;10324;42628954;41489391;26556038;4356220;28697402
FR;1;2022-07-27;1013;1712;9737;58406;8114;42629967;41491103;26565775;4414626;28705516
FR;1;2022-07-28;976;1695;9842;61862;7837;42630943;41492798;26575617;4476488;28713353
FR;1;2022-07-29;1110;1797;10422;62892;8349;42632053;41494595;26586039;4539380;28721702
FR;1;2022-07-30;390;707;3340;14475;2843;42632443;41495302;26589379;4553855;28724545
FR;1;2022-07-31;138;259;900;2333;766;42632581;41495561;26590279;4556188;28725311
FR;1;2022-08-01;714;1277;7235;28950;6093;42633295;41496838;26597514;4585138;28731404
FR;1;2022-08-02;889;1459;8213;53979;6605;42634184;41498297;26605727;4639117;28738009
FR;1;2022-08-03;715;1082;6130;37023;4912;42634899;41499379;26611857;4676140;28742921
FR;1;2022-08-04;639;1068;6250;41387;5038;42635538;41500447;26618107;4717527;28747959
FR;1;2022-08-05;733;1187;6748;43022;5407;42636271;41501634;26624855;4760549;28753366
FR;1;2022-08-06;270;459;1990;8996;1670;42636541;41502093;26626845;4769545;28755036
FR;1;2022-08-07;85;141;519;1551;435;42636626;41502234;26627364;4771096;28755471
FR;1;2022-08-08;482;827;3785;21206;3112;42637108;41503061;26631149;4792302;28758583
FR;1;2022-08-09;605;1017;5668;38442;4544;42637713;41504078;26636817;4830744;28763127
FR;1;2022-08-10;523;982;4426;26877;3621;42638236;41505060;26641243;4857621;28766748
FR;1;2022-08-11;536;899;4298;28141;3566;42638772;41505959;26645541;4885762;28770314
FR;1;2022-08-12;587;1017;4542;27149;3750;42639359;41506976;26650083;4912911;28774064
FR;1;2022-08-13;173;346;1247;5101;1062;42639532;41507322;26651330;4918012;28775126
FR;1;2022-08-14;64;113;275;868;234;42639596;41507435;26651605;4918880;28775360
FR;1;2022-08-15;70;155;560;540;521;42639666;41507590;26652165;4919420;28775881
FR;1;2022-08-16;522;921;3776;21465;3204;42640188;41508511;26655941;4940885;28779085
FR;1;2022-08-17;522;873;3757;22097;3181;42640710;41509384;26659698;4962982;28782266
FR;1;2022-08-18;537;863;3899;25416;3101;42641247;41510247;26663597;4988398;28785367
FR;1;2022-08-19;534;1030;4354;26505;3589;42641781;41511277;26667951;5014903;28788956
FR;1;2022-08-20;230;401;1283;5362;1097;42642011;41511678;26669234;5020265;28790053
FR;1;2022-08-21;81;109;281;988;249;42642092;41511787;26669515;5021253;28790302
FR;1;2022-08-22;471;872;3133;14929;2705;42642563;41512659;26672648;5036182;28793007
FR;1;2022-08-23;631;1046;4141;28308;3477;42643194;41513705;26676789;5064490;28796484
FR;1;2022-08-24;549;820;3390;19052;2760;42643743;41514525;26680179;5083542;28799244
FR;1;2022-08-25;558;915;3810;22892;3191;42644301;41515440;26683989;5106434;28802435
FR;1;2022-08-26;745;1117;4338;25140;3553;42645046;41516557;26688327;5131574;28805988
FR;1;2022-08-27;215;426;1322;5301;1190;42645261;41516983;26689649;5136875;28807178
FR;1;2022-08-28;110;144;298;894;279;42645371;41517127;26689947;5137769;28807457
FR;1;2022-08-29;501;850;2971;14211;2510;42645872;41517977;26692918;5151980;28809967
FR;1;2022-08-30;733;1085;4613;27683;3769;42646605;41519062;26697531;5179663;28813736
FR;1;2022-08-31;574;812;3096;17187;2607;42647179;41519874;26700627;5196850;28816343
FR;1;2022-09-01;654;889;4288;21836;3646;42647833;41520763;26704915;5218686;28819989
FR;1;2022-09-02;765;1026;4866;27841;4064;42648598;41521789;26709781;5246527;28824053
FR;1;2022-09-03;313;493;1825;5865;1583;42648911;41522282;26711606;5252392;28825636
FR;1;2022-09-04;106;134;339;840;333;42649017;41522416;26711945;5253232;28825969
FR;1;2022-09-05;557;628;2984;15676;2489;42649574;41523044;26714929;5268908;28828458
FR;1;2022-09-06;714;909;4542;31001;3682;42650288;41523953;26719471;5299909;28832140
FR;1;2022-09-07;528;672;2911;16389;2415;42650816;41524625;26722382;5316298;28834555
FR;1;2022-09-08;561;772;3680;24168;3023;42651377;41525397;26726062;5340466;28837578
FR;1;2022-09-09;757;950;4262;26756;3548;42652134;41526347;26730324;5367222;28841126
FR;1;2022-09-10;315;455;1665;5570;1467;42652449;41526802;26731989;5372792;28842593
FR;1;2022-09-11;105;116;307;642;289;42652554;41526918;26732296;5373434;28842882
FR;1;2022-09-12;444;556;2590;12920;2209;42652998;41527474;26734886;5386354;28845091
FR;1;2022-09-13;570;781;3851;25669;3303;42653568;41528255;26738737;5412023;28848394
FR;1;2022-09-14;567;684;2847;15616;2373;42654135;41528939;26741584;5427639;28850767
FR;1;2022-09-15;500;691;3301;22986;2786;42654635;41529630;26744885;5450625;28853553
FR;1;2022-09-16;711;920;3995;25248;3361;42655346;41530550;26748880;5475873;28856914
FR;1;2022-09-17;290;398;1385;5957;1210;42655636;41530948;26750265;5481830;28858124
FR;1;2022-09-18;96;120;310;921;278;42655732;41531068;26750575;5482751;28858402
FR;1;2022-09-19;359;551;2122;12811;1816;42656091;41531619;26752697;5495562;28860218
FR;1;2022-09-20;547;789;3637;25700;3039;42656638;41532408;26756334;5521262;28863257
FR;1;2022-09-21;466;674;2614;15842;2245;42657104;41533082;26758948;5537104;28865502
FR;1;2022-09-22;530;735;3256;22914;2656;42657634;41533817;26762204;5560018;28868158
FR;1;2022-09-23;745;917;4329;28057;3612;42658379;41534734;26766533;5588075;28871770
FR;1;2022-09-24;346;528;1573;6689;1354;42658725;41535262;26768106;5594764;28873124
FR;1;2022-09-25;76;147;321;1071;293;42658801;41535409;26768427;5595835;28873417
FR;1;2022-09-26;369;627;2158;12964;1911;42659170;41536036;26770585;5608799;28875328
FR;1;2022-09-27;537;749;3439;24989;2772;42659707;41536785;26774024;5633788;28878100
FR;1;2022-09-28;503;705;2436;14946;2202;42660210;41537490;26776460;5648734;28880302
FR;1;2022-09-29;493;679;2960;20230;2480;42660703;41538169;26779420;5668964;28882782
FR;1;2022-09-30;668;955;3748;24350;3128;42661371;41539124;26783168;5693314;28885910
FR;1;2022-10-01;316;528;1782;5471;1541;42661687;41539652;26784950;5698785;28887451
FR;1;2022-10-02;46;113;201;561;200;42661733;41539765;26785151;5699346;28887651
FR;1;2022-10-03;376;545;2115;9982;1861;42662109;41540310;26787266;5709328;28889512
FR;1;2022-10-04;529;656;2794;18878;2351;42662638;41540966;26790060;5728206;28891863
FR;1;2022-10-05;413;665;2039;11067;1815;42663051;41541631;26792099;5739273;28893678
FR;1;2022-10-06;424;591;2435;15697;2013;42663475;41542222;26794534;5754970;28895691
FR;1;2022-10-07;538;725;2623;15988;2241;42664013;41542947;26797157;5770958;28897932
FR;1;2022-10-08;222;300;828;3148;717;42664235;41543247;26797985;5774106;28898649
FR;1;2022-10-09;70;84;148;460;132;42664305;41543331;26798133;5774566;28898781
FR;1;2022-10-10;279;387;989;4911;914;42664584;41543718;26799122;5779477;28899695
FR;1;2022-10-11;311;418;1229;7940;1104;42664895;41544136;26800351;5787417;28900799
FR;1;2022-10-12;312;409;991;5128;993;42665207;41544545;26801342;5792545;28901792
FR;1;2022-10-13;308;366;1008;5999;864;42665515;41544911;26802350;5798544;28902656
FR;1;2022-10-14;395;504;1102;6656;980;42665910;41545415;26803452;5805200;28903636
FR;1;2022-10-15;186;234;434;1830;421;42666096;41545649;26803886;5807030;28904057
FR;1;2022-10-16;45;56;104;281;112;42666141;41545705;26803990;5807311;28904169
FR;1;2022-10-17;220;290;558;2593;520;42666361;41545995;26804548;5809904;28904689
FR;1;2022-10-18;251;294;804;4528;684;42666612;41546289;26805352;5814432;28905373
FR;1;2022-10-19;266;343;585;3139;549;42666878;41546632;26805937;5817571;28905922
FR;1;2022-10-20;253;282;710;4109;616;42667131;41546914;26806647;5821680;28906538
FR;1;2022-10-21;290;382;638;3678;546;42667421;41547296;26807285;5825358;28907084
FR;1;2022-10-22;130;155;239;1209;235;42667551;41547451;26807524;5826567;28907319
FR;1;2022-10-23;28;30;59;194;54;42667579;41547481;26807583;5826761;28907373
FR;1;2022-10-24;258;199;361;1473;346;42667837;41547680;26807944;5828234;28907719
FR;1;2022-10-25;203;229;444;2491;376;42668040;41547909;26808388;5830725;28908095
FR;1;2022-10-26;214;206;325;1766;307;42668254;41548115;26808713;5832491;28908402
FR;2;2020-12-27;0;0;0;0;0;0;0;0;0;0
FR;2;2020-12-28;0;0;0;0;0;0;0;0;0;0
FR;2;2020-12-29;0;0;0;0;0;0;0;0;0;0
FR;2;2020-12-30;0;0;0;0;0;0;0;0;0;0
FR;2;2020-12-31;0;0;0;0;0;0;0;0;0;0
FR;2;2021-01-01;0;0;0;0;0;0;0;0;0;0
FR;2;2021-01-02;0;0;0;0;0;0;0;0;0;0
FR;2;2021-01-03;0;0;0;0;0;0;0;0;0;0
FR;2;2021-01-04;0;0;0;0;0;0;0;0;0;0
FR;2;2021-01-05;0;0;0;0;0;0;0;0;0;0
FR;2;2021-01-06;0;0;0;0;0;0;0;0;0;0
FR;2;2021-01-07;0;0;0;0;0;0;0;0;0;0
FR;2;2021-01-08;0;0;0;0;0;0;0;0;0;0
FR;2;2021-01-09;0;0;0;0;0;0;0;0;0;0
FR;2;2021-01-10;0;0;0;0;0;0;0;0;0;0
FR;2;2021-01-11;0;0;0;0;0;0;0;0;0;0
FR;2;2021-01-12;0;0;0;0;0;0;0;0;0;0
FR;2;2021-01-13;0;0;0;0;0;0;0;0;0;0
FR;2;2021-01-14;1656;0;0;0;0;1656;0;0;0;0
FR;2;2021-01-15;398;0;0;0;0;2054;0;0;0;0
FR;2;2021-01-16;316;0;0;0;0;2370;0;0;0;0
FR;2;2021-01-17;83;0;0;0;0;2453;0;0;0;0
FR;2;2021-01-18;3074;2;0;0;0;5527;2;0;0;0
FR;2;2021-01-19;4681;1;0;0;0;10208;3;0;0;0
FR;2;2021-01-20;5135;6;0;0;0;15343;9;0;0;0
FR;2;2021-01-21;5345;9;0;0;0;20688;18;0;0;0
FR;2;2021-01-22;5118;16;0;0;0;25806;34;0;0;0
FR;2;2021-01-23;1874;2;0;0;0;27680;36;0;0;0
FR;2;2021-01-24;163;2;0;0;0;27843;38;0;0;0
FR;2;2021-01-25;3814;3;0;0;0;31657;41;0;0;0
FR;2;2021-01-26;3924;5;0;0;0;35581;46;0;0;0
FR;2;2021-01-27;3603;4;0;0;0;39184;50;0;0;0
FR;2;2021-01-28;3754;8;0;0;0;42938;58;0;0;0
FR;2;2021-01-29;3295;4;0;0;0;46233;62;0;0;0
FR;2;2021-01-30;1133;3;0;0;0;47366;65;0;0;0
FR;2;2021-01-31;46;2;0;0;0;47412;67;0;0;0
FR;2;2021-02-01;3405;11;0;0;0;50817;78;0;0;0
FR;2;2021-02-02;4493;17;0;0;0;55310;95;0;0;0
FR;2;2021-02-03;5222;7;0;0;0;60532;102;0;0;0
FR;2;2021-02-04;4939;11;0;0;0;65471;113;0;0;0
FR;2;2021-02-05;4815;15;0;0;0;70286;128;0;0;0
FR;2;2021-02-06;2044;15;0;0;0;72330;143;0;0;0
FR;2;2021-02-07;102;4;0;0;0;72432;147;0;0;0
FR;2;2021-02-08;7557;25;0;0;0;79989;172;0;0;0
FR;2;2021-02-09;8428;28;0;0;0;88417;200;0;0;0
FR;2;2021-02-10;9342;60;0;0;0;97759;260;0;0;0
FR;2;2021-02-11;10289;124;0;0;0;108048;384;0;0;0
FR;2;2021-02-12;10056;272;0;0;0;118104;656;0;0;0
FR;2;2021-02-13;3120;225;0;0;0;121224;881;0;0;0
FR;2;2021-02-14;355;10;0;0;0;121579;891;0;0;0
FR;2;2021-02-15;3460;3112;0;0;0;125039;4003;0;0;0
FR;2;2021-02-16;5073;4120;0;0;0;130112;8123;0;0;0
FR;2;2021-02-17;4258;4533;0;0;0;134370;12656;0;0;0
FR;2;2021-02-18;5403;5166;0;0;0;139773;17822;0;0;0
FR;2;2021-02-19;5327;4465;0;0;0;145100;22287;0;0;0
FR;2;2021-02-20;1871;1518;0;0;0;146971;23805;0;0;0
FR;2;2021-02-21;244;95;0;0;0;147215;23900;0;0;0
FR;2;2021-02-22;3613;3767;0;0;0;150828;27667;0;0;0
FR;2;2021-02-23;4954;3727;0;0;0;155782;31394;0;0;0
FR;2;2021-02-24;5015;3531;0;0;0;160797;34925;0;0;0
FR;2;2021-02-25;5494;3475;0;0;0;166291;38400;0;0;0
FR;2;2021-02-26;4363;3168;0;0;0;170654;41568;0;0;0
FR;2;2021-02-27;1628;1065;0;0;0;172282;42633;0;0;0
FR;2;2021-02-28;179;18;0;0;0;172461;42651;0;0;0
FR;2;2021-03-01;5187;3759;0;0;0;177648;46410;0;0;0
FR;2;2021-03-02;6536;4719;0;0;0;184184;51129;0;0;0
FR;2;2021-03-03;6539;4945;0;0;0;190723;56074;0;0;0
FR;2;2021-03-04;8409;4166;0;0;0;199132;60240;0;0;0
FR;2;2021-03-05;8035;4053;0;0;0;207167;64293;0;0;0
FR;2;2021-03-06;4787;1680;0;0;0;211954;65973;0;0;0
FR;2;2021-03-07;2372;31;0;0;0;214326;66004;0;0;0
FR;2;2021-03-08;4166;8386;0;0;0;218492;74390;0;0;0
FR;2;2021-03-09;7491;8574;1;0;0;225983;82964;1;0;0
FR;2;2021-03-10;7103;9205;0;0;0;233086;92169;1;0;0
FR;2;2021-03-11;9376;9324;1;0;0;242462;101493;2;0;0
FR;2;2021-03-12;7979;8330;0;0;0;250441;109823;2;0;0
FR;2;2021-03-13;10055;2583;0;0;0;260496;112406;2;0;0
FR;2;2021-03-14;4841;384;0;0;0;265337;112790;2;0;0
FR;2;2021-03-15;10913;3483;0;0;0;276250;116273;2;0;0
FR;2;2021-03-16;16766;4678;1;0;0;293016;120951;3;0;0
FR;2;2021-03-17;20239;3996;0;0;0;313255;124947;3;0;0
FR;2;2021-03-18;23372;5087;0;0;0;336627;130034;3;0;0
FR;2;2021-03-19;23309;4651;0;0;0;359936;134685;3;0;0
FR;2;2021-03-20;25452;1572;0;0;0;385388;136257;3;0;0
FR;2;2021-03-21;17671;154;0;0;0;403059;136411;3;0;0
FR;2;2021-03-22;17787;3215;0;0;0;420846;139626;3;0;0
FR;2;2021-03-23;22697;4257;0;0;0;443543;143883;3;0;0
FR;2;2021-03-24;23957;5031;0;0;0;467500;148914;3;0;0
FR;2;2021-03-25;26751;5210;1;0;0;494251;154124;4;0;0
FR;2;2021-03-26;26986;4226;0;0;0;521237;158350;4;0;0
FR;2;2021-03-27;15920;1359;0;0;0;537157;159709;4;0;0
FR;2;2021-03-28;10562;137;0;0;0;547719;159846;4;0;0
FR;2;2021-03-29;18996;4311;0;0;0;566715;164157;4;0;0
FR;2;2021-03-30;24588;6087;0;0;0;591303;170244;4;0;0
FR;2;2021-03-31;28561;5921;0;0;0;619864;176165;4;0;0
FR;2;2021-04-01;34552;8559;1;0;0;654416;184724;5;0;0
FR;2;2021-04-02;29984;7706;0;0;0;684400;192430;5;0;0
FR;2;2021-04-03;16955;4131;0;0;0;701355;196561;5;0;0
FR;2;2021-04-04;9306;1199;2;0;0;710661;197760;7;0;0
FR;2;2021-04-05;12445;796;0;0;0;723106;198556;7;0;0
FR;2;2021-04-06;27154;7235;0;0;0;750260;205791;7;0;0
FR;2;2021-04-07;30931;7109;1;0;0;781191;212900;8;0;0
FR;2;2021-04-08;36894;8600;1;0;0;818085;221500;9;0;0
FR;2;2021-04-09;33846;8409;28;0;0;851931;229909;37;0;0
FR;2;2021-04-10;19684;9232;1;0;0;871615;239141;38;0;0
FR;2;2021-04-11;7942;4251;1;0;0;879557;243392;39;0;0
FR;2;2021-04-12;17128;11035;0;0;0;896685;254427;39;0;0
FR;2;2021-04-13;19459;16053;1;0;0;916144;270480;40;0;0
FR;2;2021-04-14;18068;16409;7;0;0;934212;286889;47;0;0
FR;2;2021-04-15;22200;21558;27;0;0;956412;308447;74;0;0
FR;2;2021-04-16;20712;20444;45;0;0;977124;328891;119;0;0
FR;2;2021-04-17;13256;22495;5;0;0;990380;351386;124;0;0
FR;2;2021-04-18;5911;14399;6;0;0;996291;365785;130;0;0
FR;2;2021-04-19;16843;16351;24;0;0;1013134;382136;154;0;0
FR;2;2021-04-20;19325;21694;38;0;0;1032459;403830;192;0;0
FR;2;2021-04-21;20290;21785;76;0;0;1052749;425615;268;0;0
FR;2;2021-04-22;23819;24921;41;0;0;1076568;450536;309;0;0
FR;2;2021-04-23;24528;25414;76;0;0;1101096;475950;385;0;0
FR;2;2021-04-24;25304;15062;104;0;0;1126400;491012;489;0;0
FR;2;2021-04-25;9595;8612;5;0;0;1135995;499624;494;0;0
FR;2;2021-04-26;17164;17495;21;0;0;1153159;517119;515;0;0
FR;2;2021-04-27;19244;24133;40;0;0;1172403;541252;555;0;0
FR;2;2021-04-28;22338;26354;112;0;0;1194741;567606;667;0;0
FR;2;2021-04-29;25472;30315;69;0;0;1220213;597921;736;0;0
FR;2;2021-04-30;25533;27898;49;1;0;1245746;625819;785;1;0
FR;2;2021-05-01;14987;9861;6;0;0;1260733;635680;791;1;0
FR;2;2021-05-02;6639;9169;2;0;0;1267372;644849;793;1;0
FR;2;2021-05-03;20021;19185;40;0;0;1287393;664034;833;1;0
FR;2;2021-05-04;18284;29132;33;0;0;1305677;693166;866;1;0
FR;2;2021-05-05;18376;29445;48;0;0;1324053;722611;914;1;0
FR;2;2021-05-06;23547;35349;132;0;0;1347600;757960;1046;1;0
FR;2;2021-05-07;25335;33236;97;0;0;1372935;791196;1143;1;0
FR;2;2021-05-08;21342;10357;14;0;0;1394277;801553;1157;1;0
FR;2;2021-05-09;13166;7707;7;0;0;1407443;809260;1164;1;0
FR;2;2021-05-10;32941;21855;50;0;0;1440384;831115;1214;1;0
FR;2;2021-05-11;43607;20955;101;0;0;1483991;852070;1315;1;0
FR;2;2021-05-12;50054;19703;143;0;0;1534045;871773;1458;1;0
FR;2;2021-05-13;51295;5673;31;0;0;1585340;877446;1489;1;0
FR;2;2021-05-14;61353;12887;132;0;0;1646693;890333;1621;1;0
FR;2;2021-05-15;65934;7117;39;0;0;1712627;897450;1660;1;0
FR;2;2021-05-16;43587;2574;10;0;0;1756214;900024;1670;1;0
FR;2;2021-05-17;44751;12475;114;0;0;1800965;912499;1784;1;0
FR;2;2021-05-18;54645;12269;191;0;0;1855610;924768;1975;1;0
FR;2;2021-05-19;57176;10528;281;0;0;1912786;935296;2256;1;0
FR;2;2021-05-20;63440;10809;288;0;0;1976226;946105;2544;1;0
FR;2;2021-05-21;64297;11625;230;0;0;2040523;957730;2774;1;0
FR;2;2021-05-22;61485;4520;65;0;0;2102008;962250;2839;1;0
FR;2;2021-05-23;37534;575;22;0;0;2139542;962825;2861;1;0
FR;2;2021-05-24;17243;2037;35;0;0;2156785;964862;2896;1;0
FR;2;2021-05-25;21114;12214;240;0;0;2177899;977076;3136;1;0
FR;2;2021-05-26;19939;11486;230;0;0;2197838;988562;3366;1;0
FR;2;2021-05-27;22997;12652;182;0;0;2220835;1001214;3548;1;0
FR;2;2021-05-28;29393;14997;190;0;0;2250228;1016211;3738;1;0
FR;2;2021-05-29;30421;8189;57;0;0;2280649;1024400;3795;1;0
FR;2;2021-05-30;4647;1817;6;0;0;2285296;1026217;3801;1;0
FR;2;2021-05-31;28589;18744;184;0;0;2313885;1044961;3985;1;0
FR;2;2021-06-01;45733;19925;224;0;0;2359618;1064886;4209;1;0
FR;2;2021-06-02;37475;19278;182;0;0;2397093;1084164;4391;1;0
FR;2;2021-06-03;51278;23170;161;0;0;2448371;1107334;4552;1;0
FR;2;2021-06-04;65511;24072;217;0;0;2513882;1131406;4769;1;0
FR;2;2021-06-05;34601;24076;52;0;0;2548483;1155482;4821;1;0
FR;2;2021-06-06;4956;6193;10;0;0;2553439;1161675;4831;1;0
FR;2;2021-06-07;28174;23014;150;0;0;2581613;1184689;4981;1;0
FR;2;2021-06-08;46377;22916;143;0;0;2627990;1207605;5124;1;0
FR;2;2021-06-09;34291;20945;107;0;0;2662281;1228550;5231;1;0
FR;2;2021-06-10;42640;19139;95;1;0;2704921;1247689;5326;2;0
FR;2;2021-06-11;55300;25157;134;0;0;2760221;1272846;5460;2;0
FR;2;2021-06-12;30561;19783;53;0;0;2790782;1292629;5513;2;0
FR;2;2021-06-13;3331;9195;13;0;0;2794113;1301824;5526;2;0
FR;2;2021-06-14;25300;24128;92;0;0;2819413;1325952;5618;2;0
FR;2;2021-06-15;39047;22837;154;0;0;2858460;1348789;5772;2;0
FR;2;2021-06-16;30163;21387;135;0;0;2888623;1370176;5907;2;0
FR;2;2021-06-17;36912;25808;150;0;0;2925535;1395984;6057;2;0
FR;2;2021-06-18;46859;28855;123;0;0;2972394;1424839;6180;2;0
FR;2;2021-06-19;24525;24906;39;0;0;2996919;1449745;6219;2;0
FR;2;2021-06-20;3744;10064;9;0;0;3000663;1459809;6228;2;0
FR;2;2021-06-21;17529;42840;88;0;0;3018192;1502649;6316;2;0
FR;2;2021-06-22;28361;49578;110;0;0;3046553;1552227;6426;2;0
FR;2;2021-06-23;21790;49595;107;1;1;3068343;1601822;6533;3;1
FR;2;2021-06-24;28376;50286;134;0;0;3096719;1652108;6667;3;1
FR;2;2021-06-25;33400;60427;128;0;0;3130119;1712535;6795;3;1
FR;2;2021-06-26;16387;59313;54;1;0;3146506;1771848;6849;4;1
FR;2;2021-06-27;2566;29316;22;1;0;3149072;1801164;6871;5;1
FR;2;2021-06-28;12640;54333;84;0;0;3161712;1855497;6955;5;1
FR;2;2021-06-29;19853;59949;178;0;0;3181565;1915446;7133;5;1
FR;2;2021-06-30;16330;57993;253;17;0;3197895;1973439;7386;22;1
FR;2;2021-07-01;20491;59883;228;0;0;3218386;2033322;7614;22;1
FR;2;2021-07-02;24080;62141;184;0;0;3242466;2095463;7798;22;1
FR;2;2021-07-03;12117;57114;153;0;0;3254583;2152577;7951;22;1
FR;2;2021-07-04;1959;23306;18;0;0;3256542;2175883;7969;22;1
FR;2;2021-07-05;9177;29338;106;0;0;3265719;2205221;8075;22;1
FR;2;2021-07-06;14582;36239;135;0;0;3280301;2241460;8210;22;1
FR;2;2021-07-07;14414;33654;139;0;0;3294715;2275114;8349;22;1
FR;2;2021-07-08;19722;40317;162;0;0;3314437;2315431;8511;22;1
FR;2;2021-07-09;27101;54311;202;1;0;3341538;2369742;8713;23;1
FR;2;2021-07-10;13386;33694;107;0;0;3354924;2403436;8820;23;1
FR;2;2021-07-11;1809;4353;16;0;0;3356733;2407789;8836;23;1
FR;2;2021-07-12;12970;37292;119;0;0;3369703;2445081;8955;23;1
FR;2;2021-07-13;37114;53181;152;0;0;3406817;2498262;9107;23;1
FR;2;2021-07-14;6626;3547;15;0;0;3413443;2501809;9122;23;1
FR;2;2021-07-15;47241;47026;156;0;0;3460684;2548835;9278;23;1
FR;2;2021-07-16;64316;55797;188;0;0;3525000;2604632;9466;23;1
FR;2;2021-07-17;31600;23926;96;0;0;3556600;2628558;9562;23;1
FR;2;2021-07-18;6088;4836;19;0;0;3562688;2633394;9581;23;1
FR;2;2021-07-19;33004;28625;94;0;0;3595692;2662019;9675;23;1
FR;2;2021-07-20;51998;44529;155;0;0;3647690;2706548;9830;23;1
FR;2;2021-07-21;45254;34695;93;0;0;3692944;2741243;9923;23;1
FR;2;2021-07-22;56280;41081;128;1;0;3749224;2782324;10051;24;1
FR;2;2021-07-23;68296;48998;170;0;0;3817520;2831322;10221;24;1
FR;2;2021-07-24;36176;21603;82;0;0;3853696;2852925;10303;24;1
FR;2;2021-07-25;6749;2622;10;0;0;3860445;2855547;10313;24;1
FR;2;2021-07-26;36315;22385;91;1;0;3896760;2877932;10404;25;1
FR;2;2021-07-27;62386;34591;180;0;0;3959146;2912523;10584;25;1
FR;2;2021-07-28;55320;26429;132;0;0;4014466;2938952;10716;25;1
FR;2;2021-07-29;68476;32803;189;0;0;4082942;2971755;10905;25;1
FR;2;2021-07-30;74463;37800;222;1;0;4157405;3009555;11127;26;1
FR;2;2021-07-31;34770;16205;105;0;0;4192175;3025760;11232;26;1
FR;2;2021-08-01;5413;2256;19;0;0;4197588;3028016;11251;26;1
FR;2;2021-08-02;35884;16183;101;0;0;4233472;3044199;11352;26;1
FR;2;2021-08-03;55986;28280;142;0;0;4289458;3072479;11494;26;1
FR;2;2021-08-04;46635;20841;128;1;0;4336093;3093320;11622;27;1
FR;2;2021-08-05;54637;31567;215;0;0;4390730;3124887;11837;27;1
FR;2;2021-08-06;58094;42401;242;1;0;4448824;3167288;12079;28;1
FR;2;2021-08-07;25149;17624;89;0;0;4473973;3184912;12168;28;1
FR;2;2021-08-08;3838;3652;21;0;0;4477811;3188564;12189;28;1
FR;2;2021-08-09;29307;21074;92;0;0;4507118;3209638;12281;28;1
FR;2;2021-08-10;45007;33486;155;0;0;4552125;3243124;12436;28;1
FR;2;2021-08-11;35275;25155;151;0;0;4587400;3268279;12587;28;1
FR;2;2021-08-12;41903;35698;163;0;0;4629303;3303977;12750;28;1
FR;2;2021-08-13;42603;37260;218;0;0;4671906;3341237;12968;28;1
FR;2;2021-08-14;18520;22170;94;0;0;4690426;3363407;13062;28;1
FR;2;2021-08-15;3854;3804;17;0;0;4694280;3367211;13079;28;1
FR;2;2021-08-16;25092;27143;111;0;0;4719372;3394354;13190;28;1
FR;2;2021-08-17;38260;43421;205;2;0;4757632;3437775;13395;30;1
FR;2;2021-08-18;32252;36364;195;1;1;4789884;3474139;13590;31;2
FR;2;2021-08-19;37434;46578;224;0;0;4827318;3520717;13814;31;2
FR;2;2021-08-20;40567;55641;271;1;0;4867885;3576358;14085;32;2
FR;2;2021-08-21;18120;24311;116;0;0;4886005;3600669;14201;32;2
FR;2;2021-08-22;2907;4327;22;1;1;4888912;3604996;14223;33;3
FR;2;2021-08-23;19248;35154;131;1;0;4908160;3640150;14354;34;3
FR;2;2021-08-24;31947;56048;236;0;0;4940107;3696198;14590;34;3
FR;2;2021-08-25;25934;43453;250;0;0;4966041;3739651;14840;34;3
FR;2;2021-08-26;32361;55816;388;0;0;4998402;3795467;15228;34;3
FR;2;2021-08-27;37003;65671;477;2;0;5035405;3861138;15705;36;3
FR;2;2021-08-28;17819;28528;300;0;0;5053224;3889666;16005;36;3
FR;2;2021-08-29;2656;5015;47;0;0;5055880;3894681;16052;36;3
FR;2;2021-08-30;18416;37741;400;0;761;5074296;3932422;16452;36;764
FR;2;2021-08-31;28076;57500;887;4;1549;5102372;3989922;17339;40;2313
FR;2;2021-09-01;21592;39866;1309;0;2117;5123964;4029788;18648;40;4430
FR;2;2021-09-02;25485;48661;1962;2;3347;5149449;4078449;20610;42;7777
FR;2;2021-09-03;33411;64539;2988;3;4870;5182860;4142988;23598;45;12647
FR;2;2021-09-04;16832;27744;1442;1;2379;5199692;4170732;25040;46;15026
FR;2;2021-09-05;2262;3609;266;0;412;5201954;4174341;25306;46;15438
FR;2;2021-09-06;14043;28712;1770;1;2945;5215997;4203053;27076;47;18383
FR;2;2021-09-07;21107;41096;3021;13;4912;5237104;4244149;30097;60;23295
FR;2;2021-09-08;17248;31924;2734;6;4495;5254352;4276073;32831;66;27790
FR;2;2021-09-09;20979;40473;4436;3;6813;5275331;4316546;37267;69;34603
FR;2;2021-09-10;28201;51262;5285;4;8921;5303532;4367808;42552;73;43524
FR;2;2021-09-11;13654;22427;2404;5;3973;5317186;4390235;44956;78;47497
FR;2;2021-09-12;1824;2776;291;0;510;5319010;4393011;45247;78;48007
FR;2;2021-09-13;11659;21443;2473;4;4033;5330669;4414454;47720;82;52040
FR;2;2021-09-14;18573;32746;5089;13;9054;5349242;4447200;52809;95;61094
FR;2;2021-09-15;14913;28260;5169;3;7763;5364155;4475460;57978;98;68857
FR;2;2021-09-16;16079;32784;6737;12;10533;5380234;4508244;64715;110;79390
FR;2;2021-09-17;20914;47141;8780;10;14609;5401148;4555385;73495;120;93999
FR;2;2021-09-18;9858;20959;3803;6;6033;5411006;4576344;77298;126;100032
FR;2;2021-09-19;1166;2604;396;0;633;5412172;4578948;77694;126;100665
FR;2;2021-09-20;7499;18724;3855;7;6143;5419671;4597672;81549;133;106808
FR;2;2021-09-21;11214;29997;6495;5;10743;5430885;4627669;88044;138;117551
FR;2;2021-09-22;9408;23535;5490;6;8517;5440293;4651204;93534;144;126068
FR;2;2021-09-23;10728;28906;7881;10;12651;5451021;4680110;101415;154;138719
FR;2;2021-09-24;15072;42925;10876;18;17237;5466093;4723035;112291;172;155956
FR;2;2021-09-25;7258;18783;3965;9;6111;5473351;4741818;116256;181;162067
FR;2;2021-09-26;1079;2549;495;0;629;5474430;4744367;116751;181;162696
FR;2;2021-09-27;6313;16416;4285;8;6535;5480743;4760783;121036;189;169231
FR;2;2021-09-28;9240;25551;7769;14;12074;5489983;4786334;128805;203;181305
FR;2;2021-09-29;8081;20210;6067;25;9260;5498064;4806544;134872;228;190565
FR;2;2021-09-30;9864;25829;9506;16;14103;5507928;4832373;144378;244;204668
FR;2;2021-10-01;13976;35721;12918;25;19308;5521904;4868094;157296;269;223976
FR;2;2021-10-02;6874;15919;4849;7;7032;5528778;4884013;162145;276;231008
FR;2;2021-10-03;841;1918;492;1;503;5529619;4885931;162637;277;231511
FR;2;2021-10-04;5824;13900;5515;5;7854;5535443;4899831;168152;282;239365
FR;2;2021-10-05;9058;22548;11121;19;15729;5544501;4922379;179273;301;255094
FR;2;2021-10-06;7783;17745;8242;11;11078;5552284;4940124;187515;312;266172
FR;2;2021-10-07;9202;22206;12383;15;16866;5561486;4962330;199898;327;283038
FR;2;2021-10-08;13431;32100;17349;27;23579;5574917;4994430;217247;354;306617
FR;2;2021-10-09;6000;12844;6042;6;7893;5580917;5007274;223289;360;314510
FR;2;2021-10-10;885;1600;436;2;609;5581802;5008874;223725;362;315119
FR;2;2021-10-11;5607;11560;6455;17;8831;5587409;5020434;230180;379;323950
FR;2;2021-10-12;8031;17788;12548;13;16775;5595440;5038222;242728;392;340725
FR;2;2021-10-13;6943;14853;10255;12;13634;5602383;5053075;252983;404;354359
FR;2;2021-10-14;8314;17931;14996;13;19462;5610697;5071006;267979;417;373821
FR;2;2021-10-15;11853;26306;20903;26;27973;5622550;5097312;288882;443;401794
FR;2;2021-10-16;5139;8739;1819;0;3219;5627689;5106051;290701;443;405013
FR;2;2021-10-17;651;1159;184;0;363;5628340;5107210;290885;443;405376
FR;2;2021-10-18;4562;7358;664;2;1641;5632902;5114568;291549;445;407017
FR;2;2021-10-19;6238;9864;732;5;2041;5639140;5124432;292281;450;409058
FR;2;2021-10-20;5170;8069;758;3;1683;5644310;5132501;293039;453;410741
FR;2;2021-10-21;6090;9972;779;5;2103;5650400;5142473;293818;458;412844
FR;2;2021-10-22;8450;14596;1148;4;2887;5658850;5157069;294966;462;415731
FR;2;2021-10-23;3845;5997;586;0;1233;5662695;5163066;295552;462;416964
FR;2;2021-10-24;494;887;101;0;206;5663189;5163953;295653;462;417170
FR;2;2021-10-25;3358;5348;307;1;825;5666547;5169301;295960;463;417995
FR;2;2021-10-26;4176;7252;1132;4;2023;5670723;5176553;297092;467;420018
FR;2;2021-10-27;3676;6601;1193;5;1993;5674399;5183154;298285;472;422011
FR;2;2021-10-28;4597;7695;1735;3;2748;5678996;5190849;300020;475;424759
FR;2;2021-10-29;5413;11089;2436;4;3679;5684409;5201938;302456;479;428438
FR;2;2021-10-30;2749;4445;976;1;1437;5687158;5206383;303432;480;429875
FR;2;2021-10-31;364;533;139;1;190;5687522;5206916;303571;481;430065
FR;2;2021-11-01;428;548;179;0;265;5687950;5207464;303750;481;430330
FR;2;2021-11-02;3293;6761;1183;0;1763;5691243;5214225;304933;481;432093
FR;2;2021-11-03;3340;6235;1388;2;1968;5694583;5220460;306321;483;434061
FR;2;2021-11-04;3986;7078;1768;4;2497;5698569;5227538;308089;487;436558
FR;2;2021-11-05;5233;10502;2867;5;3955;5703802;5238040;310956;492;440513
FR;2;2021-11-06;2595;4680;1403;0;1817;5706397;5242720;312359;492;442330
FR;2;2021-11-07;505;867;220;0;289;5706902;5243587;312579;492;442619
FR;2;2021-11-08;2578;5354;1203;3;1676;5709480;5248941;313782;495;444295
FR;2;2021-11-09;2750;6917;2402;5;3179;5712230;5255858;316184;500;447474
FR;2;2021-11-10;2589;5682;5111;6;6284;5714819;5261540;321295;506;453758
FR;2;2021-11-11;444;752;746;2;928;5715263;5262292;322041;508;454686
FR;2;2021-11-12;2953;8097;8972;8;10915;5718216;5270389;331013;516;465601
FR;2;2021-11-13;1539;3382;3870;7;4541;5719755;5273771;334883;523;470142
FR;2;2021-11-14;257;590;351;1;482;5720012;5274361;335234;524;470624
FR;2;2021-11-15;1622;3666;4445;8;5327;5721634;5278027;339679;532;475951
FR;2;2021-11-16;2184;5894;8308;14;10077;5723818;5283921;347987;546;486028
FR;2;2021-11-17;1741;4534;6630;8;7852;5725559;5288455;354617;554;493880
FR;2;2021-11-18;2192;5930;9181;10;11012;5727751;5294385;363798;564;504892
FR;2;2021-11-19;2700;7778;12973;19;15475;5730451;5302163;376771;583;520367
FR;2;2021-11-20;1565;3342;5180;5;6090;5732016;5305505;381951;588;526457
FR;2;2021-11-21;247;512;541;0;661;5732263;5306017;382492;588;527118
FR;2;2021-11-22;1278;2593;4479;5;5404;5733541;5308610;386971;593;532522
FR;2;2021-11-23;1617;4291;8199;9;9910;5735158;5312901;395170;602;542432
FR;2;2021-11-24;1418;3760;7475;14;8729;5736576;5316661;402645;616;551161
FR;2;2021-11-25;1813;4879;11471;21;13667;5738389;5321540;414116;637;564828
FR;2;2021-11-26;2540;7751;22669;31;26075;5740929;5329291;436785;668;590903
FR;2;2021-11-27;1497;4158;12271;18;14031;5742426;5333449;449056;686;604934
FR;2;2021-11-28;292;840;1972;3;2296;5742718;5334289;451028;689;607230
FR;2;2021-11-29;1447;4367;15090;23;17258;5744165;5338656;466118;712;624488
FR;2;2021-11-30;1912;6679;26242;36;29994;5746077;5345335;492360;748;654482
FR;2;2021-12-01;1915;6055;26202;31;29521;5747992;5351390;518562;779;684003
FR;2;2021-12-02;1913;6801;37715;52;41961;5749905;5358191;556277;831;725964
FR;2;2021-12-03;2556;10088;53621;111;59366;5752461;5368279;609898;942;785330
FR;2;2021-12-04;1848;6293;37116;38;40807;5754309;5374572;647014;980;826137
FR;2;2021-12-05;458;2252;14259;14;15988;5754767;5376824;661273;994;842125
FR;2;2021-12-06;2486;9880;77714;109;84770;5757253;5386704;738987;1103;926895
FR;2;2021-12-07;3455;15317;122445;238;133760;5760708;5402021;861432;1341;1060655
FR;2;2021-12-08;3725;16009;133201;330;145389;5764433;5418030;994633;1671;1206044
FR;2;2021-12-09;4547;19648;170210;555;185603;5768980;5437678;1164843;2226;1391647
FR;2;2021-12-10;4675;22849;188681;490;206169;5773655;5460527;1353524;2716;1597816
FR;2;2021-12-11;3685;16636;132446;239;144895;5777340;5477163;1485970;2955;1742711
FR;2;2021-12-12;1257;7133;59097;83;65155;5778597;5484296;1545067;3038;1807866
FR;2;2021-12-13;5528;26847;220700;605;242996;5784125;5511143;1765767;3643;2050862
FR;2;2021-12-14;7016;37463;300784;908;332224;5791141;5548606;2066551;4551;2383086
FR;2;2021-12-15;6555;36248;285234;957;315864;5797696;5584854;2351785;5508;2698950
FR;2;2021-12-16;7764;37942;312142;979;343762;5805460;5622796;2663927;6487;3042712
FR;2;2021-12-17;8680;41215;327888;976;360963;5814140;5664011;2991815;7463;3403675
FR;2;2021-12-18;6515;26557;212349;448;233660;5820655;5690568;3204164;7911;3637335
FR;2;2021-12-19;2603;11433;90212;182;100352;5823258;5702001;3294376;8093;3737687
FR;2;2021-12-20;9545;33561;275230;706;303385;5832803;5735562;3569606;8799;4041072
FR;2;2021-12-21;11563;38325;309632;968;341439;5844366;5773887;3879238;9767;4382511
FR;2;2021-12-22;10458;32807;265117;952;292477;5854824;5806694;4144355;10719;4674988
FR;2;2021-12-23;9427;26684;199509;701;221302;5864251;5833378;4343864;11420;4896290
FR;2;2021-12-24;2783;7481;43860;140;49559;5867034;5840859;4387724;11560;4945849
FR;2;2021-12-25;201;682;2002;10;2485;5867235;5841541;4389726;11570;4948334
FR;2;2021-12-26;1319;4209;25156;71;28680;5868554;5845750;4414882;11641;4977014
FR;2;2021-12-27;8076;29919;218416;659;243339;5876630;5875669;4633298;12300;5220353
FR;2;2021-12-28;9837;36327;272095;742;302000;5886467;5911996;4905393;13042;5522353
FR;2;2021-12-29;9497;32259;246135;765;272695;5895964;5944255;5151528;13807;5795048
FR;2;2021-12-30;9461;28099;208832;663;231455;5905425;5972354;5360360;14470;6026503
FR;2;2021-12-31;3010;8348;54991;176;61236;5908435;5980702;5415351;14646;6087739
FR;2;2022-01-01;230;692;2855;7;3353;5908665;5981394;5418206;14653;6091092
FR;2;2022-01-02;1505;4854;29514;75;33403;5910170;5986248;5447720;14728;6124495
FR;2;2022-01-03;9593;35407;266532;806;293909;5919763;6021655;5714252;15534;6418404
FR;2;2022-01-04;12852;45411;342089;1068;377016;5932615;6067066;6056341;16602;6795420
FR;2;2022-01-05;11271;38656;294192;884;323838;5943886;6105722;6350533;17486;7119258
FR;2;2022-01-06;13654;43499;331948;1298;364738;5957540;6149221;6682481;18784;7483996
FR;2;2022-01-07;14225;47646;361096;1270;396451;5971765;6196867;7043577;20054;7880447
FR;2;2022-01-08;7947;28145;201262;515;221702;5979712;6225012;7244839;20569;8102149
FR;2;2022-01-09;2749;8974;62524;137;69507;5982461;6233986;7307363;20706;8171656
FR;2;2022-01-10;10097;31914;232481;858;255052;5992558;6265900;7539844;21564;8426708
FR;2;2022-01-11;11469;36251;265922;1029;290623;6004027;6302151;7805766;22593;8717331
FR;2;2022-01-12;8765;29814;206323;863;226173;6012792;6331965;8012089;23456;8943504
FR;2;2022-01-13;9387;31344;224495;832;244842;6022179;6363309;8236584;24288;9188346
FR;2;2022-01-14;9741;35614;254541;920;277659;6031920;6398923;8491125;25208;9466005
FR;2;2022-01-15;5359;19454;140779;363;153637;6037279;6418377;8631904;25571;9619642
FR;2;2022-01-16;1512;5479;35887;81;39830;6038791;6423856;8667791;25652;9659472
FR;2;2022-01-17;5546;19278;135415;601;147261;6044337;6443134;8803206;26253;9806733
FR;2;2022-01-18;6422;21498;148632;648;160462;6050759;6464632;8951838;26901;9967195
FR;2;2022-01-19;4395;16323;105102;551;113699;6055154;6480955;9056940;27452;10080894
FR;2;2022-01-20;4872;17591;115296;603;123695;6060026;6498546;9172236;28055;10204589
FR;2;2022-01-21;5197;20059;137349;679;147771;6065223;6518605;9309585;28734;10352360
FR;2;2022-01-22;3030;10949;74263;260;80325;6068253;6529554;9383848;28994;10432685
FR;2;2022-01-23;724;2717;15241;41;16831;6068977;6532271;9399089;29035;10449516
FR;2;2022-01-24;3289;12814;75079;430;81032;6072266;6545085;9474168;29465;10530548
FR;2;2022-01-25;3574;14415;79627;496;85452;6075840;6559500;9553795;29961;10616000
FR;2;2022-01-26;2515;10701;58975;363;63026;6078355;6570201;9612770;30324;10679026
FR;2;2022-01-27;2682;11356;64176;388;67936;6081037;6581557;9676946;30712;10746962
FR;2;2022-01-28;3550;18294;91719;429;98913;6084587;6599851;9768665;31141;10845875
FR;2;2022-01-29;1894;9243;48851;164;52930;6086481;6609094;9817516;31305;10898805
FR;2;2022-01-30;464;2227;9455;38;10602;6086945;6611321;9826971;31343;10909407
FR;2;2022-01-31;1888;9565;43830;208;47328;6088833;6620886;9870801;31551;10956735
FR;2;2022-02-01;1916;10038;47030;279;50098;6090749;6630924;9917831;31830;11006833
FR;2;2022-02-02;1614;9002;41118;250;44161;6092363;6639926;9958949;32080;11050994
FR;2;2022-02-03;1725;8948;40526;205;42926;6094088;6648874;9999475;32285;11093920
FR;2;2022-02-04;2151;15193;66646;299;71338;6096239;6664067;10066121;32584;11165258
FR;2;2022-02-05;1360;8524;35945;132;39227;6097599;6672591;10102066;32716;11204485
FR;2;2022-02-06;275;1762;6127;16;6898;6097874;6674353;10108193;32732;11211383
FR;2;2022-02-07;1351;9562;37756;134;41297;6099225;6683915;10145949;32866;11252680
FR;2;2022-02-08;1299;9832;40952;173;43746;6100524;6693747;10186901;33039;11296426
FR;2;2022-02-09;1160;8838;37038;174;40462;6101684;6702585;10223939;33213;11336888
FR;2;2022-02-10;1028;7996;33837;204;36509;6102712;6710581;10257776;33417;11373397
FR;2;2022-02-11;1391;12085;53345;223;57698;6104103;6722666;10311121;33640;11431095
FR;2;2022-02-12;754;6533;27985;86;30804;6104857;6729199;10339106;33726;11461899
FR;2;2022-02-13;200;1340;4836;20;5577;6105057;6730539;10343942;33746;11467476
FR;2;2022-02-14;835;6731;30272;91;33231;6105892;6737270;10374214;33837;11500707
FR;2;2022-02-15;774;6472;28049;141;29992;6106666;6743742;10402263;33978;11530699
FR;2;2022-02-16;657;5361;22064;123;23629;6107323;6749103;10424327;34101;11554328
FR;2;2022-02-17;518;3783;14152;98;14617;6107841;6752886;10438479;34199;11568945
FR;2;2022-02-18;723;5368;20441;134;21128;6108564;6758254;10458920;34333;11590073
FR;2;2022-02-19;430;3056;10531;66;11245;6108994;6761310;10469451;34399;11601318
FR;2;2022-02-20;102;516;1460;3;1608;6109096;6761826;10470911;34402;11602926
FR;2;2022-02-21;422;2685;9122;65;9499;6109518;6764511;10480033;34467;11612425
FR;2;2022-02-22;391;2567;8893;76;8796;6109909;6767078;10488926;34543;11621221
FR;2;2022-02-23;432;2604;8991;82;9267;6110341;6769682;10497917;34625;11630488
FR;2;2022-02-24;314;2036;6800;82;6828;6110655;6771718;10504717;34707;11637316
FR;2;2022-02-25;457;3206;11418;107;11282;6111112;6774924;10516135;34814;11648598
FR;2;2022-02-26;297;1892;6035;49;6342;6111409;6776816;10522170;34863;11654940
FR;2;2022-02-27;76;313;907;5;950;6111485;6777129;10523077;34868;11655890
FR;2;2022-02-28;330;1688;5524;53;5531;6111815;6778817;10528601;34921;11661421
FR;2;2022-03-01;277;1569;5479;46;5197;6112092;6780386;10534080;34967;11666618
FR;2;2022-03-02;298;1445;5246;45;5090;6112390;6781831;10539326;35012;11671708
FR;2;2022-03-03;225;1111;3708;42;3485;6112615;6782942;10543034;35054;11675193
FR;2;2022-03-04;243;1468;4857;74;4505;6112858;6784410;10547891;35128;11679698
FR;2;2022-03-05;174;906;2979;32;2723;6113032;6785316;10550870;35160;11682421
FR;2;2022-03-06;42;183;280;5;320;6113074;6785499;10551150;35165;11682741
FR;2;2022-03-07;156;658;1987;70;1777;6113230;6786157;10553137;35235;11684518
FR;2;2022-03-08;144;668;2273;52;1906;6113374;6786825;10555410;35287;11686424
FR;2;2022-03-09;154;708;2348;37;2050;6113528;6787533;10557758;35324;11688474
FR;2;2022-03-10;123;603;1694;35;1469;6113651;6788136;10559452;35359;11689943
FR;2;2022-03-11;172;756;2769;57;2368;6113823;6788892;10562221;35416;11692311
FR;2;2022-03-12;149;484;1785;27;1554;6113972;6789376;10564006;35443;11693865
FR;2;2022-03-13;25;75;203;30;204;6113997;6789451;10564209;35473;11694069
FR;2;2022-03-14;128;470;1567;529;1297;6114125;6789921;10565776;36002;11695366
FR;2;2022-03-15;138;439;1712;690;1332;6114263;6790360;10567488;36692;11696698
FR;2;2022-03-16;142;476;2013;1615;1593;6114405;6790836;10569501;38307;11698291
FR;2;2022-03-17;93;413;1408;1193;1144;6114498;6791249;10570909;39500;11699435
FR;2;2022-03-18;146;496;2023;1794;1666;6114644;6791745;10572932;41294;11701101
FR;2;2022-03-19;108;321;1210;941;1015;6114752;6792066;10574142;42235;11702116
FR;2;2022-03-20;13;77;191;59;168;6114765;6792143;10574333;42294;11702284
FR;2;2022-03-21;97;307;1214;1483;1077;6114862;6792450;10575547;43777;11703361
FR;2;2022-03-22;118;388;1530;1830;1291;6114980;6792838;10577077;45607;11704652
FR;2;2022-03-23;139;361;1674;3032;1470;6115119;6793199;10578751;48639;11706122
FR;2;2022-03-24;116;293;1183;1547;1001;6115235;6793492;10579934;50186;11707123
FR;2;2022-03-25;119;361;1805;2450;1475;6115354;6793853;10581739;52636;11708598
FR;2;2022-03-26;79;247;1204;1222;952;6115433;6794100;10582943;53858;11709550
FR;2;2022-03-27;19;36;153;100;132;6115452;6794136;10583096;53958;11709682
FR;2;2022-03-28;94;288;1138;1601;995;6115546;6794424;10584234;55559;11710677
FR;2;2022-03-29;108;258;1325;2467;1105;6115654;6794682;10585559;58026;11711782
FR;2;2022-03-30;91;312;1488;3184;1320;6115745;6794994;10587047;61210;11713102
FR;2;2022-03-31;104;284;1275;2331;1090;6115849;6795278;10588322;63541;11714192
FR;2;2022-04-01;123;323;1567;2348;1322;6115972;6795601;10589889;65889;11715514
FR;2;2022-04-02;76;161;845;891;737;6116048;6795762;10590734;66780;11716251
FR;2;2022-04-03;16;53;128;113;142;6116064;6795815;10590862;66893;11716393
FR;2;2022-04-04;113;238;987;1439;796;6116177;6796053;10591849;68332;11717189
FR;2;2022-04-05;143;295;1316;2910;1143;6116320;6796348;10593165;71242;11718332
FR;2;2022-04-06;89;259;1305;2520;1129;6116409;6796607;10594470;73762;11719461
FR;2;2022-04-07;120;224;1301;2682;1041;6116529;6796831;10595771;76444;11720502
FR;2;2022-04-08;125;336;1632;3340;1325;6116654;6797167;10597403;79784;11721827
FR;2;2022-04-09;90;219;899;1046;731;6116744;6797386;10598302;80830;11722558
FR;2;2022-04-10;37;48;143;162;119;6116781;6797434;10598445;80992;11722677
FR;2;2022-04-11;88;195;889;1559;779;6116869;6797629;10599334;82551;11723456
FR;2;2022-04-12;176;270;1182;2768;1061;6117045;6797899;10600516;85319;11724517
FR;2;2022-04-13;146;230;1125;2456;987;6117191;6798129;10601641;87775;11725504
FR;2;2022-04-14;115;222;1085;2677;917;6117306;6798351;10602726;90452;11726421
FR;2;2022-04-15;114;249;1214;2291;1068;6117420;6798600;10603940;92743;11727489
FR;2;2022-04-16;67;108;548;549;459;6117487;6798708;10604488;93292;11727948
FR;2;2022-04-17;15;27;57;53;53;6117502;6798735;10604545;93345;11728001
FR;2;2022-04-18;12;35;120;70;115;6117514;6798770;10604665;93415;11728116
FR;2;2022-04-19;112;237;1120;1729;951;6117626;6799007;10605785;95144;11729067
FR;2;2022-04-20;95;241;1108;2172;932;6117721;6799248;10606893;97316;11729999
FR;2;2022-04-21;111;231;982;1912;837;6117832;6799479;10607875;99228;11730836
FR;2;2022-04-22;99;274;1242;2091;1023;6117931;6799753;10609117;101319;11731859
FR;2;2022-04-23;67;156;644;762;573;6117998;6799909;10609761;102081;11732432
FR;2;2022-04-24;12;29;101;68;79;6118010;6799938;10609862;102149;11732511
FR;2;2022-04-25;103;204;820;1314;710;6118113;6800142;10610682;103463;11733221
FR;2;2022-04-26;108;184;1041;2017;878;6118221;6800326;10611723;105480;11734099
FR;2;2022-04-27;98;178;860;1783;764;6118319;6800504;10612583;107263;11734863
FR;2;2022-04-28;93;214;950;1929;843;6118412;6800718;10613533;109192;11735706
FR;2;2022-04-29;81;280;1130;1696;1040;6118493;6800998;10614663;110888;11736746
FR;2;2022-04-30;65;126;470;539;429;6118558;6801124;10615133;111427;11737175
FR;2;2022-05-01;23;24;84;48;85;6118581;6801148;10615217;111475;11737260
FR;2;2022-05-02;116;232;762;1215;660;6118697;6801380;10615979;112690;11737920
FR;2;2022-05-03;148;233;999;1777;938;6118845;6801613;10616978;114467;11738858
FR;2;2022-05-04;90;226;923;1809;866;6118935;6801839;10617901;116276;11739724
FR;2;2022-05-05;127;197;852;1717;769;6119062;6802036;10618753;117993;11740493
FR;2;2022-05-06;133;246;1099;1849;1015;6119195;6802282;10619852;119842;11741508
FR;2;2022-05-07;40;98;470;504;406;6119235;6802380;10620322;120346;11741914
FR;2;2022-05-08;47;54;107;71;102;6119282;6802434;10620429;120417;11742016
FR;2;2022-05-09;101;174;654;984;604;6119383;6802608;10621083;121401;11742620
FR;2;2022-05-10;121;250;938;1840;893;6119504;6802858;10622021;123241;11743513
FR;2;2022-05-11;101;176;811;1873;791;6119605;6803034;10622832;125114;11744304
FR;2;2022-05-12;111;173;844;2094;802;6119716;6803207;10623676;127208;11745106
FR;2;2022-05-13;100;233;969;2096;899;6119816;6803440;10624645;129304;11746005
FR;2;2022-05-14;76;117;451;554;409;6119892;6803557;10625096;129858;11746414
FR;2;2022-05-15;24;39;94;87;108;6119916;6803596;10625190;129945;11746522
FR;2;2022-05-16;102;170;600;924;536;6120018;6803766;10625790;130869;11747058
FR;2;2022-05-17;95;184;689;1685;657;6120113;6803950;10626479;132554;11747715
FR;2;2022-05-18;80;181;641;1431;646;6120193;6804131;10627120;133985;11748361
FR;2;2022-05-19;70;160;708;1831;750;6120263;6804291;10627828;135816;11749111
FR;2;2022-05-20;107;180;874;1700;779;6120370;6804471;10628702;137516;11749890
FR;2;2022-05-21;48;96;397;517;338;6120418;6804567;10629099;138033;11750228
FR;2;2022-05-22;8;23;69;37;57;6120426;6804590;10629168;138070;11750285
FR;2;2022-05-23;86;133;498;931;469;6120512;6804723;10629666;139001;11750754
FR;2;2022-05-24;87;163;627;1621;615;6120599;6804886;10630293;140622;11751369
FR;2;2022-05-25;72;145;538;1148;492;6120671;6805031;10630831;141770;11751861
FR;2;2022-05-26;11;31;77;42;85;6120682;6805062;10630908;141812;11751946
FR;2;2022-05-27;44;123;456;818;438;6120726;6805185;10631364;142630;11752384
FR;2;2022-05-28;28;60;221;244;221;6120754;6805245;10631585;142874;11752605
FR;2;2022-05-29;13;34;43;25;51;6120767;6805279;10631628;142899;11752656
FR;2;2022-05-30;65;108;424;755;409;6120832;6805387;10632052;143654;11753065
FR;2;2022-05-31;76;135;563;1276;510;6120908;6805522;10632615;144930;11753575
FR;2;2022-06-01;59;157;562;1074;541;6120967;6805679;10633177;146004;11754116
FR;2;2022-06-02;92;175;625;1412;591;6121059;6805854;10633802;147416;11754707
FR;2;2022-06-03;71;155;666;1604;593;6121130;6806009;10634468;149020;11755300
FR;2;2022-06-04;69;93;283;433;269;6121199;6806102;10634751;149453;11755569
FR;2;2022-06-05;12;17;62;57;47;6121211;6806119;10634813;149510;11755616
FR;2;2022-06-06;11;33;92;75;92;6121222;6806152;10634905;149585;11755708
FR;2;2022-06-07;99;220;666;1533;576;6121321;6806372;10635571;151118;11756284
FR;2;2022-06-08;70;118;475;1166;411;6121391;6806490;10636046;152284;11756695
FR;2;2022-06-09;93;166;612;1921;570;6121484;6806656;10636658;154205;11757265
FR;2;2022-06-10;91;167;650;1683;621;6121575;6806823;10637308;155888;11757886
FR;2;2022-06-11;43;84;286;528;258;6121618;6806907;10637594;156416;11758144
FR;2;2022-06-12;18;38;58;78;60;6121636;6806945;10637652;156494;11758204
FR;2;2022-06-13;39;119;393;952;378;6121675;6807064;10638045;157446;11758582
FR;2;2022-06-14;68;157;599;2087;537;6121743;6807221;10638644;159533;11759119
FR;2;2022-06-15;78;104;520;1501;444;6121821;6807325;10639164;161034;11759563
FR;2;2022-06-16;127;127;495;1411;422;6121948;6807452;10639659;162445;11759985
FR;2;2022-06-17;73;136;586;1817;514;6122021;6807588;10640245;164262;11760499
FR;2;2022-06-18;75;92;224;578;196;6122096;6807680;10640469;164840;11760695
FR;2;2022-06-19;11;16;53;71;41;6122107;6807696;10640522;164911;11760736
FR;2;2022-06-20;62;125;401;1027;392;6122169;6807821;10640923;165938;11761128
FR;2;2022-06-21;107;115;524;2123;453;6122276;6807936;10641447;168061;11761581
FR;2;2022-06-22;39;107;462;1889;414;6122315;6808043;10641909;169950;11761995
FR;2;2022-06-23;57;108;537;2281;452;6122372;6808151;10642446;172231;11762447
FR;2;2022-06-24;66;122;708;3198;570;6122438;6808273;10643154;175429;11763017
FR;2;2022-06-25;30;90;295;987;252;6122468;6808363;10643449;176416;11763269
FR;2;2022-06-26;30;27;131;194;97;6122498;6808390;10643580;176610;11763366
FR;2;2022-06-27;79;137;581;2488;482;6122577;6808527;10644161;179098;11763848
FR;2;2022-06-28;110;140;812;4816;650;6122687;6808667;10644973;183914;11764498
FR;2;2022-06-29;73;150;776;4432;637;6122760;6808817;10645749;188346;11765135
FR;2;2022-06-30;72;133;832;5177;618;6122832;6808950;10646581;193523;11765753
FR;2;2022-07-01;112;158;1149;6691;848;6122944;6809108;10647730;200214;11766601
FR;2;2022-07-02;68;132;474;1976;392;6123012;6809240;10648204;202190;11766993
FR;2;2022-07-03;23;30;146;334;130;6123035;6809270;10648350;202524;11767123
FR;2;2022-07-04;120;180;775;3774;611;6123155;6809450;10649125;206298;11767734
FR;2;2022-07-05;118;186;1121;6817;828;6123273;6809636;10650246;213115;11768562
FR;2;2022-07-06;92;148;949;5807;695;6123365;6809784;10651195;218922;11769257
FR;2;2022-07-07;81;185;1021;6498;750;6123446;6809969;10652216;225420;11770007
FR;2;2022-07-08;65;122;1095;7044;758;6123511;6810091;10653311;232464;11770765
FR;2;2022-07-09;34;61;418;1869;299;6123545;6810152;10653729;234333;11771064
FR;2;2022-07-10;6;17;96;315;82;6123551;6810169;10653825;234648;11771146
FR;2;2022-07-11;68;119;683;3825;540;6123619;6810288;10654508;238473;11771686
FR;2;2022-07-12;102;178;1054;6517;809;6123721;6810466;10655562;244990;11772495
FR;2;2022-07-13;64;126;878;4664;590;6123785;6810592;10656440;249654;11773085
FR;2;2022-07-14;6;13;88;248;59;6123791;6810605;10656528;249902;11773144
FR;2;2022-07-15;61;129;739;3791;560;6123852;6810734;10657267;253693;11773704
FR;2;2022-07-16;27;54;289;1029;242;6123879;6810788;10657556;254722;11773946
FR;2;2022-07-17;5;12;77;201;66;6123884;6810800;10657633;254923;11774012
FR;2;2022-07-18;57;103;514;2509;384;6123941;6810903;10658147;257432;11774396
FR;2;2022-07-19;66;133;769;4247;555;6124007;6811036;10658916;261679;11774951
FR;2;2022-07-20;59;118;580;3179;430;6124066;6811154;10659496;264858;11775381
FR;2;2022-07-21;60;109;671;3678;485;6124126;6811263;10660167;268536;11775866
FR;2;2022-07-22;51;98;698;3548;506;6124177;6811361;10660865;272084;11776372
FR;2;2022-07-23;39;97;290;1173;229;6124216;6811458;10661155;273257;11776601
FR;2;2022-07-24;14;23;68;201;67;6124230;6811481;10661223;273458;11776668
FR;2;2022-07-25;50;71;404;1936;299;6124280;6811552;10661627;275394;11776967
FR;2;2022-07-26;57;133;607;3423;478;6124337;6811685;10662234;278817;11777445
FR;2;2022-07-27;42;81;457;2782;361;6124379;6811766;10662691;281599;11777806
FR;2;2022-07-28;29;75;449;2476;356;6124408;6811841;10663140;284075;11778162
FR;2;2022-07-29;68;87;535;2857;347;6124476;6811928;10663675;286932;11778509
FR;2;2022-07-30;22;38;162;774;110;6124498;6811966;10663837;287706;11778619
FR;2;2022-07-31;6;13;27;104;21;6124504;6811979;10663864;287810;11778640
FR;2;2022-08-01;38;105;323;1261;260;6124542;6812084;10664187;289071;11778900
FR;2;2022-08-02;49;73;325;2060;247;6124591;6812157;10664512;291131;11779147
FR;2;2022-08-03;29;53;258;1610;187;6124620;6812210;10664770;292741;11779334
FR;2;2022-08-04;40;63;306;1686;240;6124660;6812273;10665076;294427;11779574
FR;2;2022-08-05;33;94;327;1879;235;6124693;6812367;10665403;296306;11779809
FR;2;2022-08-06;22;40;106;365;82;6124715;6812407;10665509;296671;11779891
FR;2;2022-08-07;7;8;14;69;16;6124722;6812415;10665523;296740;11779907
FR;2;2022-08-08;19;35;216;876;144;6124741;6812450;10665739;297616;11780051
FR;2;2022-08-09;29;51;279;1475;238;6124770;6812501;10666018;299091;11780289
FR;2;2022-08-10;15;21;213;1126;150;6124785;6812522;10666231;300217;11780439
FR;2;2022-08-11;21;41;174;1037;117;6124806;6812563;10666405;301254;11780556
FR;2;2022-08-12;36;49;184;1044;140;6124842;6812612;10666589;302298;11780696
FR;2;2022-08-13;8;19;46;149;52;6124850;6812631;10666635;302447;11780748
FR;2;2022-08-14;1;2;12;52;11;6124851;6812633;10666647;302499;11780759
FR;2;2022-08-15;0;5;32;22;21;6124851;6812638;10666679;302521;11780780
FR;2;2022-08-16;27;32;144;672;120;6124878;6812670;10666823;303193;11780900
FR;2;2022-08-17;16;26;108;738;87;6124894;6812696;10666931;303931;11780987
FR;2;2022-08-18;13;28;159;835;106;6124907;6812724;10667090;304766;11781093
FR;2;2022-08-19;8;38;116;703;86;6124915;6812762;10667206;305469;11781179
FR;2;2022-08-20;6;26;56;196;47;6124921;6812788;10667262;305665;11781226
FR;2;2022-08-21;4;14;15;19;13;6124925;6812802;10667277;305684;11781239
FR;2;2022-08-22;10;24;116;395;73;6124935;6812826;10667393;306079;11781312
FR;2;2022-08-23;11;40;134;671;112;6124946;6812866;10667527;306750;11781424
FR;2;2022-08-24;11;28;86;466;79;6124957;6812894;10667613;307216;11781503
FR;2;2022-08-25;8;32;109;481;69;6124965;6812926;10667722;307697;11781572
FR;2;2022-08-26;15;46;117;720;91;6124980;6812972;10667839;308417;11781663
FR;2;2022-08-27;10;18;47;156;42;6124990;6812990;10667886;308573;11781705
FR;2;2022-08-28;1;5;5;15;7;6124991;6812995;10667891;308588;11781712
FR;2;2022-08-29;24;43;93;400;87;6125015;6813038;10667984;308988;11781799
FR;2;2022-08-30;31;54;154;787;119;6125046;6813092;10668138;309775;11781918
FR;2;2022-08-31;19;34;85;391;79;6125065;6813126;10668223;310166;11781997
FR;2;2022-09-01;19;42;139;600;122;6125084;6813168;10668362;310766;11782119
FR;2;2022-09-02;34;54;145;744;157;6125118;6813222;10668507;311510;11782276
FR;2;2022-09-03;17;20;83;204;67;6125135;6813242;10668590;311714;11782343
FR;2;2022-09-04;8;5;9;31;10;6125143;6813247;10668599;311745;11782353
FR;2;2022-09-05;28;28;124;367;95;6125171;6813275;10668723;312112;11782448
FR;2;2022-09-06;43;61;158;761;153;6125214;6813336;10668881;312873;11782601
FR;2;2022-09-07;21;20;74;375;49;6125235;6813356;10668955;313248;11782650
FR;2;2022-09-08;31;57;109;636;100;6125266;6813413;10669064;313884;11782750
FR;2;2022-09-09;17;24;126;751;74;6125283;6813437;10669190;314635;11782824
FR;2;2022-09-10;14;24;57;117;48;6125297;6813461;10669247;314752;11782872
FR;2;2022-09-11;11;5;10;11;12;6125308;6813466;10669257;314763;11782884
FR;2;2022-09-12;20;30;68;340;55;6125328;6813496;10669325;315103;11782939
FR;2;2022-09-13;15;34;126;670;99;6125343;6813530;10669451;315773;11783038
FR;2;2022-09-14;19;21;81;479;59;6125362;6813551;10669532;316252;11783097
FR;2;2022-09-15;22;42;124;486;101;6125384;6813593;10669656;316738;11783198
FR;2;2022-09-16;19;30;122;563;89;6125403;6813623;10669778;317301;11783287
FR;2;2022-09-17;6;19;56;160;52;6125409;6813642;10669834;317461;11783339
FR;2;2022-09-18;4;7;13;36;10;6125413;6813649;10669847;317497;11783349
FR;2;2022-09-19;26;24;114;353;87;6125439;6813673;10669961;317850;11783436
FR;2;2022-09-20;27;27;117;624;84;6125466;6813700;10670078;318474;11783520
FR;2;2022-09-21;15;30;100;393;78;6125481;6813730;10670178;318867;11783598
FR;2;2022-09-22;16;39;122;582;94;6125497;6813769;10670300;319449;11783692
FR;2;2022-09-23;21;38;134;555;111;6125518;6813807;10670434;320004;11783803
FR;2;2022-09-24;10;8;50;190;35;6125528;6813815;10670484;320194;11783838
FR;2;2022-09-25;9;11;14;29;11;6125537;6813826;10670498;320223;11783849
FR;2;2022-09-26;21;40;103;447;79;6125558;6813866;10670601;320670;11783928
FR;2;2022-09-27;29;46;158;906;107;6125587;6813912;10670759;321576;11784035
FR;2;2022-09-28;14;31;93;421;73;6125601;6813943;10670852;321997;11784108
FR;2;2022-09-29;26;47;114;618;110;6125627;6813990;10670966;322615;11784218
FR;2;2022-09-30;24;44;111;519;84;6125651;6814034;10671077;323134;11784302
FR;2;2022-10-01;10;20;50;128;35;6125661;6814054;10671127;323262;11784337
FR;2;2022-10-02;0;5;8;21;5;6125661;6814059;10671135;323283;11784342
FR;2;2022-10-03;21;26;83;291;64;6125682;6814085;10671218;323574;11784406
FR;2;2022-10-04;17;20;104;599;68;6125699;6814105;10671322;324173;11784474
FR;2;2022-10-05;20;29;75;491;67;6125719;6814134;10671397;324664;11784541
FR;2;2022-10-06;29;23;73;441;70;6125748;6814157;10671470;325105;11784611
FR;2;2022-10-07;21;28;85;498;63;6125769;6814185;10671555;325603;11784674
FR;2;2022-10-08;12;8;19;108;20;6125781;6814193;10671574;325711;11784694
FR;2;2022-10-09;1;8;15;17;11;6125782;6814201;10671589;325728;11784705
FR;2;2022-10-10;18;24;43;224;46;6125800;6814225;10671632;325952;11784751
FR;2;2022-10-11;15;14;44;253;37;6125815;6814239;10671676;326205;11784788
FR;2;2022-10-12;8;17;49;286;34;6125823;6814256;10671725;326491;11784822
FR;2;2022-10-13;11;13;47;269;46;6125834;6814269;10671772;326760;11784868
FR;2;2022-10-14;11;25;33;228;37;6125845;6814294;10671805;326988;11784905
FR;2;2022-10-15;4;8;20;110;13;6125849;6814302;10671825;327098;11784918
FR;2;2022-10-16;0;5;4;10;6;6125849;6814307;10671829;327108;11784924
FR;2;2022-10-17;14;17;27;118;22;6125863;6814324;10671856;327226;11784946
FR;2;2022-10-18;13;11;49;173;30;6125876;6814335;10671905;327399;11784976
FR;2;2022-10-19;9;17;32;181;27;6125885;6814352;10671937;327580;11785003
FR;2;2022-10-20;11;27;31;193;30;6125896;6814379;10671968;327773;11785033
FR;2;2022-10-21;5;15;47;215;43;6125901;6814394;10672015;327988;11785076
FR;2;2022-10-22;8;7;21;89;21;6125909;6814401;10672036;328077;11785097
FR;2;2022-10-23;0;3;1;5;0;6125909;6814404;10672037;328082;11785097
FR;2;2022-10-24;12;11;13;105;13;6125921;6814415;10672050;328187;11785110
FR;2;2022-10-25;12;7;22;128;13;6125933;6814422;10672072;328315;11785123
FR;2;2022-10-26;4;3;14;77;8;6125937;6814425;10672086;328392;11785131
FR;3;2020-12-27;0;0;0;0;0;0;0;0;0;0
FR;3;2020-12-28;0;0;0;0;0;0;0;0;0;0
FR;3;2020-12-29;0;0;0;0;0;0;0;0;0;0
FR;3;2020-12-30;0;0;0;0;0;0;0;0;0;0
FR;3;2020-12-31;0;0;0;0;0;0;0;0;0;0
FR;3;2021-01-01;0;0;0;0;0;0;0;0;0;0
FR;3;2021-01-02;0;0;0;0;0;0;0;0;0;0
FR;3;2021-01-03;0;0;0;0;0;0;0;0;0;0
FR;3;2021-01-04;0;0;0;0;0;0;0;0;0;0
FR;3;2021-01-05;0;0;0;0;0;0;0;0;0;0
FR;3;2021-01-06;0;0;0;0;0;0;0;0;0;0
FR;3;2021-01-07;0;0;0;0;0;0;0;0;0;0
FR;3;2021-01-08;0;0;0;0;0;0;0;0;0;0
FR;3;2021-01-09;0;0;0;0;0;0;0;0;0;0
FR;3;2021-01-10;0;0;0;0;0;0;0;0;0;0
FR;3;2021-01-11;0;0;0;0;0;0;0;0;0;0
FR;3;2021-01-12;0;0;0;0;0;0;0;0;0;0
FR;3;2021-01-13;0;0;0;0;0;0;0;0;0;0
FR;3;2021-01-14;0;0;0;0;0;0;0;0;0;0
FR;3;2021-01-15;0;0;0;0;0;0;0;0;0;0
FR;3;2021-01-16;0;0;0;0;0;0;0;0;0;0
FR;3;2021-01-17;0;0;0;0;0;0;0;0;0;0
FR;3;2021-01-18;0;0;0;0;0;0;0;0;0;0
FR;3;2021-01-19;0;0;0;0;0;0;0;0;0;0
FR;3;2021-01-20;0;0;0;0;0;0;0;0;0;0
FR;3;2021-01-21;0;0;0;0;0;0;0;0;0;0
FR;3;2021-01-22;0;0;0;0;0;0;0;0;0;0
FR;3;2021-01-23;0;0;0;0;0;0;0;0;0;0
FR;3;2021-01-24;0;0;0;0;0;0;0;0;0;0
FR;3;2021-01-25;0;0;0;0;0;0;0;0;0;0
FR;3;2021-01-26;0;0;0;0;0;0;0;0;0;0
FR;3;2021-01-27;0;0;0;0;0;0;0;0;0;0
FR;3;2021-01-28;0;0;0;0;0;0;0;0;0;0
FR;3;2021-01-29;0;0;0;0;0;0;0;0;0;0
FR;3;2021-01-30;0;0;0;0;0;0;0;0;0;0
FR;3;2021-01-31;0;0;0;0;0;0;0;0;0;0
FR;3;2021-02-01;0;0;0;0;0;0;0;0;0;0
FR;3;2021-02-02;0;0;0;0;0;0;0;0;0;0
FR;3;2021-02-03;0;0;0;0;0;0;0;0;0;0
FR;3;2021-02-04;0;0;0;0;0;0;0;0;0;0
FR;3;2021-02-05;0;0;0;0;0;0;0;0;0;0
FR;3;2021-02-06;1547;0;0;0;0;1547;0;0;0;0
FR;3;2021-02-07;1423;1;0;0;0;2970;1;0;0;0
FR;3;2021-02-08;2788;1;0;0;0;5758;2;0;0;0
FR;3;2021-02-09;6784;0;0;0;0;12542;2;0;0;0
FR;3;2021-02-10;9611;0;0;0;0;22153;2;0;0;0
FR;3;2021-02-11;13617;3;0;0;0;35770;5;0;0;0
FR;3;2021-02-12;13408;0;0;0;0;49178;5;0;0;0
FR;3;2021-02-13;3798;1;0;0;0;52976;6;0;0;0
FR;3;2021-02-14;975;1;0;0;0;53951;7;0;0;0
FR;3;2021-02-15;10494;2;0;0;0;64445;9;0;0;0
FR;3;2021-02-16;12552;4;0;0;0;76997;13;0;0;0
FR;3;2021-02-17;11158;1;0;0;0;88155;14;0;0;0
FR;3;2021-02-18;14943;2;0;0;0;103098;16;0;0;0
FR;3;2021-02-19;14364;1;0;0;0;117462;17;0;0;0
FR;3;2021-02-20;3330;0;0;0;0;120792;17;0;0;0
FR;3;2021-02-21;619;0;0;0;0;121411;17;0;0;0
FR;3;2021-02-22;9168;1;0;0;0;130579;18;0;0;0
FR;3;2021-02-23;11400;3;0;0;0;141979;21;0;0;0
FR;3;2021-02-24;14305;1;0;0;0;156284;22;0;0;0
FR;3;2021-02-25;44932;3;0;0;0;201216;25;0;0;0
FR;3;2021-02-26;61889;9;0;0;0;263105;34;0;0;0
FR;3;2021-02-27;34807;11;0;0;0;297912;45;0;0;0
FR;3;2021-02-28;2463;0;0;0;0;300375;45;0;0;0
FR;3;2021-03-01;20519;18;0;0;0;320894;63;0;0;0
FR;3;2021-03-02;38873;22;0;0;0;359767;85;0;0;0
FR;3;2021-03-03;48746;17;0;0;0;408513;102;0;0;0
FR;3;2021-03-04;82223;25;0;0;0;490736;127;0;0;0
FR;3;2021-03-05;118129;41;0;0;0;608865;168;0;0;0
FR;3;2021-03-06;120720;64;1;0;0;729585;232;1;0;0
FR;3;2021-03-07;55182;24;0;0;0;784767;256;1;0;0
FR;3;2021-03-08;42813;25;0;0;0;827580;281;1;0;0
FR;3;2021-03-09;78976;51;0;0;0;906556;332;1;0;0
FR;3;2021-03-10;80981;59;0;0;0;987537;391;1;0;0
FR;3;2021-03-11;128442;58;0;0;0;1115979;449;1;0;0
FR;3;2021-03-12;182720;113;0;0;0;1298699;562;1;0;0
FR;3;2021-03-13;132159;80;0;0;0;1430858;642;1;0;0
FR;3;2021-03-14;14057;5;0;0;0;1444915;647;1;0;0
FR;3;2021-03-15;52234;71;0;0;0;1497149;718;1;0;0
FR;3;2021-03-16;1216;45;0;0;0;1498365;763;1;0;0
FR;3;2021-03-17;947;51;0;0;0;1499312;814;1;0;0
FR;3;2021-03-18;1571;35;0;0;0;1500883;849;1;0;0
FR;3;2021-03-19;70456;53;0;0;0;1571339;902;1;0;0
FR;3;2021-03-20;65238;46;0;0;0;1636577;948;1;0;0
FR;3;2021-03-21;5760;8;0;0;0;1642337;956;1;0;0
FR;3;2021-03-22;37508;44;0;0;0;1679845;1000;1;0;0
FR;3;2021-03-23;84663;81;0;0;0;1764508;1081;1;0;0
FR;3;2021-03-24;90952;95;0;0;0;1855460;1176;1;0;0
FR;3;2021-03-25;150064;138;0;0;0;2005524;1314;1;0;0
FR;3;2021-03-26;165428;158;0;0;0;2170952;1472;1;0;0
FR;3;2021-03-27;68462;101;0;0;0;2239414;1573;1;0;0
FR;3;2021-03-28;6479;20;0;0;0;2245893;1593;1;0;0
FR;3;2021-03-29;54168;75;0;0;0;2300061;1668;1;0;0
FR;3;2021-03-30;93180;102;0;0;0;2393241;1770;1;0;0
FR;3;2021-03-31;63541;109;0;0;0;2456782;1879;1;0;0
FR;3;2021-04-01;86133;113;0;0;0;2542915;1992;1;0;0
FR;3;2021-04-02;86911;179;0;0;0;2629826;2171;1;0;0
FR;3;2021-04-03;35876;129;0;0;0;2665702;2300;1;0;0
FR;3;2021-04-04;3576;19;0;0;0;2669278;2319;1;0;0
FR;3;2021-04-05;4491;38;0;0;0;2673769;2357;1;0;0
FR;3;2021-04-06;29758;97;0;0;0;2703527;2454;1;0;0
FR;3;2021-04-07;32345;98;0;0;0;2735872;2552;1;0;0
FR;3;2021-04-08;78822;256;0;0;0;2814694;2808;1;0;0
FR;3;2021-04-09;161754;435;0;0;0;2976448;3243;1;0;0
FR;3;2021-04-10;75761;359;0;0;0;3052209;3602;1;0;0
FR;3;2021-04-11;7312;46;0;0;0;3059521;3648;1;0;0
FR;3;2021-04-12;51483;217;0;0;0;3111004;3865;1;0;0
FR;3;2021-04-13;86234;346;0;0;0;3197238;4211;1;0;0
FR;3;2021-04-14;67845;368;0;0;0;3265083;4579;1;0;0
FR;3;2021-04-15;93233;391;0;0;0;3358316;4970;1;0;0
FR;3;2021-04-16;112524;603;0;0;0;3470840;5573;1;0;0
FR;3;2021-04-17;53318;346;1;0;0;3524158;5919;2;0;0
FR;3;2021-04-18;9749;44;0;0;0;3533907;5963;2;0;0
FR;3;2021-04-19;25112;270;0;0;0;3559019;6233;2;0;0
FR;3;2021-04-20;45673;426;0;0;0;3604692;6659;2;0;0
FR;3;2021-04-21;38985;511;0;0;0;3643677;7170;2;0;0
FR;3;2021-04-22;54716;838;0;0;0;3698393;8008;2;0;0
FR;3;2021-04-23;70490;1060;0;0;0;3768883;9068;2;0;0
FR;3;2021-04-24;37250;1066;0;0;0;3806133;10134;2;0;0
FR;3;2021-04-25;6212;155;0;0;0;3812345;10289;2;0;0
FR;3;2021-04-26;19788;684;0;0;0;3832133;10973;2;0;0
FR;3;2021-04-27;34483;1300;0;0;0;3866616;12273;2;0;0
FR;3;2021-04-28;28967;1998;0;0;0;3895583;14271;2;0;0
FR;3;2021-04-29;45387;6061;0;0;0;3940970;20332;2;0;0
FR;3;2021-04-30;55464;9030;1;0;0;3996434;29362;3;0;0
FR;3;2021-05-01;9516;2034;0;0;0;4005950;31396;3;0;0
FR;3;2021-05-02;3077;476;0;0;0;4009027;31872;3;0;0
FR;3;2021-05-03;13063;3903;0;0;0;4022090;35775;3;0;0
FR;3;2021-05-04;23115;8439;0;0;0;4045205;44214;3;0;0
FR;3;2021-05-05;18760;10755;0;0;0;4063965;54969;3;0;0
FR;3;2021-05-06;34628;21135;0;0;0;4098593;76104;3;0;0
FR;3;2021-05-07;44204;28744;0;0;0;4142797;104848;3;0;0
FR;3;2021-05-08;6785;9207;0;0;0;4149582;114055;3;0;0
FR;3;2021-05-09;1795;2653;0;0;0;4151377;116708;3;0;0
FR;3;2021-05-10;14999;12832;0;0;0;4166376;129540;3;0;0
FR;3;2021-05-11;27098;26125;0;0;0;4193474;155665;3;0;0
FR;3;2021-05-12;17268;27948;0;0;0;4210742;183613;3;0;0
FR;3;2021-05-13;2285;3501;0;0;0;4213027;187114;3;0;0
FR;3;2021-05-14;14520;26010;0;0;0;4227547;213124;3;0;0
FR;3;2021-05-15;7233;20985;0;0;0;4234780;234109;3;0;0
FR;3;2021-05-16;977;2652;0;0;0;4235757;236761;3;0;0
FR;3;2021-05-17;7965;20093;0;0;0;4243722;256854;3;0;0
FR;3;2021-05-18;13414;30028;0;0;0;4257136;286882;3;0;0
FR;3;2021-05-19;9274;30845;0;0;0;4266410;317727;3;0;0
FR;3;2021-05-20;12806;53655;3;0;0;4279216;371382;6;0;0
FR;3;2021-05-21;12768;66016;2;0;0;4291984;437398;8;0;0
FR;3;2021-05-22;4963;33655;1;0;0;4296947;471053;9;0;0
FR;3;2021-05-23;651;2661;0;0;0;4297598;473714;9;0;0
FR;3;2021-05-24;883;4834;0;0;0;4298481;478548;9;0;0
FR;3;2021-05-25;5311;46273;1;0;0;4303792;524821;10;0;0
FR;3;2021-05-26;4978;51860;1;0;0;4308770;576681;11;0;0
FR;3;2021-05-27;6334;78756;3;0;0;4315104;655437;14;0;0
FR;3;2021-05-28;7542;99962;2;0;0;4322646;755399;16;0;0
FR;3;2021-05-29;3349;60909;1;0;0;4325995;816308;17;0;0
FR;3;2021-05-30;549;8135;0;0;0;4326544;824443;17;0;0
FR;3;2021-05-31;2441;35608;3;0;0;4328985;860051;20;0;0
FR;3;2021-06-01;3411;64836;10;0;0;4332396;924887;30;0;0
FR;3;2021-06-02;2734;58710;6;0;0;4335130;983597;36;0;0
FR;3;2021-06-03;3495;87237;10;0;0;4338625;1070834;46;0;0
FR;3;2021-06-04;4117;105677;22;0;0;4342742;1176511;68;0;0
FR;3;2021-06-05;1983;52497;4;0;0;4344725;1229008;72;0;0
FR;3;2021-06-06;509;5310;1;0;0;4345234;1234318;73;0;0
FR;3;2021-06-07;1483;30800;11;0;0;4346717;1265118;84;0;0
FR;3;2021-06-08;2061;47369;18;0;0;4348778;1312487;102;0;0
FR;3;2021-06-09;1793;41931;13;0;0;4350571;1354418;115;0;0
FR;3;2021-06-10;2254;67761;17;0;0;4352825;1422179;132;0;0
FR;3;2021-06-11;2484;96636;34;0;0;4355309;1518815;166;0;0
FR;3;2021-06-12;1177;40644;6;0;0;4356486;1559459;172;0;0
FR;3;2021-06-13;283;3654;3;0;0;4356769;1563113;175;0;0
FR;3;2021-06-14;1047;42407;17;0;0;4357816;1605520;192;0;0
FR;3;2021-06-15;1375;80440;20;0;0;4359191;1685960;212;0;0
FR;3;2021-06-16;1261;65539;20;0;0;4360452;1751499;232;0;0
FR;3;2021-06-17;1666;102130;41;0;0;4362118;1853629;273;0;0
FR;3;2021-06-18;1870;118304;62;0;0;4363988;1971933;335;0;0
FR;3;2021-06-19;802;39442;22;0;0;4364790;2011375;357;0;0
FR;3;2021-06-20;161;3234;0;0;0;4364951;2014609;357;0;0
FR;3;2021-06-21;772;39100;16;0;0;4365723;2053709;373;0;0
FR;3;2021-06-22;1065;70044;52;0;0;4366788;2123753;425;0;0
FR;3;2021-06-23;944;50822;39;0;0;4367732;2174575;464;0;0
FR;3;2021-06-24;1310;77221;48;0;0;4369042;2251796;512;0;0
FR;3;2021-06-25;1410;90584;73;0;0;4370452;2342380;585;0;0
FR;3;2021-06-26;631;33109;29;0;0;4371083;2375489;614;0;0
FR;3;2021-06-27;166;3844;1;0;0;4371249;2379333;615;0;0
FR;3;2021-06-28;654;30113;27;0;0;4371903;2409446;642;0;0
FR;3;2021-06-29;857;56474;95;0;0;4372760;2465920;737;0;0
FR;3;2021-06-30;905;45167;93;0;0;4373665;2511087;830;0;0
FR;3;2021-07-01;1164;65956;108;0;0;4374829;2577043;938;0;0
FR;3;2021-07-02;1305;90491;170;0;0;4376134;2667534;1108;0;0
FR;3;2021-07-03;602;31183;51;0;0;4376736;2698717;1159;0;0
FR;3;2021-07-04;144;4056;3;0;0;4376880;2702773;1162;0;0
FR;3;2021-07-05;612;33687;60;0;0;4377492;2736460;1222;0;0
FR;3;2021-07-06;963;55973;88;0;0;4378455;2792433;1310;0;0
FR;3;2021-07-07;872;42976;80;0;0;4379327;2835409;1390;0;0
FR;3;2021-07-08;1127;60769;99;0;0;4380454;2896178;1489;0;0
FR;3;2021-07-09;1260;68891;128;0;0;4381714;2965069;1617;0;0
FR;3;2021-07-10;643;25040;59;0;0;4382357;2990109;1676;0;0
FR;3;2021-07-11;132;3203;4;0;0;4382489;2993312;1680;0;0
FR;3;2021-07-12;662;23712;59;0;0;4383151;3017024;1739;0;0
FR;3;2021-07-13;1647;34535;90;0;0;4384798;3051559;1829;0;0
FR;3;2021-07-14;269;2507;2;0;0;4385067;3054066;1831;0;0
FR;3;2021-07-15;1941;30499;85;0;0;4387008;3084565;1916;0;0
FR;3;2021-07-16;2520;38717;122;0;0;4389528;3123282;2038;0;0
FR;3;2021-07-17;1051;13731;26;0;0;4390579;3137013;2064;0;0
FR;3;2021-07-18;266;2565;3;0;0;4390845;3139578;2067;0;0
FR;3;2021-07-19;1278;16966;38;0;0;4392123;3156544;2105;0;0
FR;3;2021-07-20;1823;26989;98;0;0;4393946;3183533;2203;0;0
FR;3;2021-07-21;1651;19569;44;0;0;4395597;3203102;2247;0;0
FR;3;2021-07-22;1856;27672;83;0;0;4397453;3230774;2330;0;0
FR;3;2021-07-23;2216;30288;117;0;0;4399669;3261062;2447;0;0
FR;3;2021-07-24;826;6956;25;0;0;4400495;3268018;2472;0;0
FR;3;2021-07-25;210;1300;1;0;0;4400705;3269318;2473;0;0
FR;3;2021-07-26;931;10562;28;0;0;4401636;3279880;2501;0;0
FR;3;2021-07-27;1169;16856;56;0;0;4402805;3296736;2557;0;0
FR;3;2021-07-28;989;12032;40;0;0;4403794;3308768;2597;0;0
FR;3;2021-07-29;1127;15734;63;0;0;4404921;3324502;2660;0;0
FR;3;2021-07-30;1128;18017;79;0;0;4406049;3342519;2739;0;0
FR;3;2021-07-31;406;3725;15;0;0;4406455;3346244;2754;0;0
FR;3;2021-08-01;116;457;1;0;0;4406571;3346701;2755;0;0
FR;3;2021-08-02;421;5054;22;0;0;4406992;3351755;2777;0;0
FR;3;2021-08-03;496;7499;27;0;0;4407488;3359254;2804;0;0
FR;3;2021-08-04;439;4851;26;0;0;4407927;3364105;2830;0;0
FR;3;2021-08-05;431;3671;13;0;0;4408358;3367776;2843;0;0
FR;3;2021-08-06;456;4727;30;0;0;4408814;3372503;2873;0;0
FR;3;2021-08-07;214;1900;11;0;0;4409028;3374403;2884;0;0
FR;3;2021-08-08;250;423;2;0;0;4409278;3374826;2886;0;0
FR;3;2021-08-09;318;2413;11;0;0;4409596;3377239;2897;0;0
FR;3;2021-08-10;368;3785;15;0;0;4409964;3381024;2912;0;0
FR;3;2021-08-11;291;2675;15;0;0;4410255;3383699;2927;0;0
FR;3;2021-08-12;277;2596;13;0;0;4410532;3386295;2940;0;0
FR;3;2021-08-13;278;2260;16;0;0;4410810;3388555;2956;0;0
FR;3;2021-08-14;172;892;1;0;0;4410982;3389447;2957;0;0
FR;3;2021-08-15;56;176;0;0;0;4411038;3389623;2957;0;0
FR;3;2021-08-16;124;1037;8;0;0;4411162;3390660;2965;0;0
FR;3;2021-08-17;189;1450;8;0;0;4411351;3392110;2973;0;0
FR;3;2021-08-18;204;1319;10;0;0;4411555;3393429;2983;0;0
FR;3;2021-08-19;165;1383;10;0;0;4411720;3394812;2993;0;0
FR;3;2021-08-20;167;1605;16;0;0;4411887;3396417;3009;0;0
FR;3;2021-08-21;93;585;2;0;0;4411980;3397002;3011;0;0
FR;3;2021-08-22;42;190;1;0;0;4412022;3397192;3012;0;0
FR;3;2021-08-23;141;903;7;0;0;4412163;3398095;3019;0;0
FR;3;2021-08-24;125;930;10;0;0;4412288;3399025;3029;0;0
FR;3;2021-08-25;137;825;3;0;0;4412425;3399850;3032;0;0
FR;3;2021-08-26;172;836;9;0;0;4412597;3400686;3041;0;0
FR;3;2021-08-27;178;942;9;0;0;4412775;3401628;3050;0;0
FR;3;2021-08-28;101;373;4;0;0;4412876;3402001;3054;0;0
FR;3;2021-08-29;128;132;1;0;0;4413004;3402133;3055;0;0
FR;3;2021-08-30;100;574;0;0;117;4413104;3402707;3055;0;117
FR;3;2021-08-31;133;694;7;0;140;4413237;3403401;3062;0;257
FR;3;2021-09-01;121;465;5;0;112;4413358;3403866;3067;0;369
FR;3;2021-09-02;100;610;22;0;107;4413458;3404476;3089;0;476
FR;3;2021-09-03;116;569;17;0;120;4413574;3405045;3106;0;596
FR;3;2021-09-04;55;298;3;0;53;4413629;3405343;3109;0;649
FR;3;2021-09-05;51;67;5;0;26;4413680;3405410;3114;0;675
FR;3;2021-09-06;118;376;4;0;135;4413798;3405786;3118;0;810
FR;3;2021-09-07;124;441;14;0;118;4413922;3406227;3132;0;928
FR;3;2021-09-08;121;350;2;0;93;4414043;3406577;3134;0;1021
FR;3;2021-09-09;94;382;8;0;104;4414137;3406959;3142;0;1125
FR;3;2021-09-10;101;405;3;0;97;4414238;3407364;3145;0;1222
FR;3;2021-09-11;76;233;4;0;66;4414314;3407597;3149;0;1288
FR;3;2021-09-12;37;47;1;0;16;4414351;3407644;3150;0;1304
FR;3;2021-09-13;75;307;7;0;102;4414426;3407951;3157;0;1406
FR;3;2021-09-14;75;278;6;0;97;4414501;3408229;3163;0;1503
FR;3;2021-09-15;62;258;3;0;6;4414563;3408487;3166;0;1509
FR;3;2021-09-16;65;322;6;0;6;4414628;3408809;3172;0;1515
FR;3;2021-09-17;52;330;3;0;7;4414680;3409139;3175;0;1522
FR;3;2021-09-18;37;174;1;0;1;4414717;3409313;3176;0;1523
FR;3;2021-09-19;28;31;2;0;1;4414745;3409344;3178;0;1524
FR;3;2021-09-20;81;195;0;0;1;4414826;3409539;3178;0;1525
FR;3;2021-09-21;60;276;6;0;7;4414886;3409815;3184;0;1532
FR;3;2021-09-22;65;234;6;0;7;4414951;3410049;3190;0;1539
FR;3;2021-09-23;37;261;11;0;7;4414988;3410310;3201;0;1546
FR;3;2021-09-24;28;319;12;0;18;4415016;3410629;3213;0;1564
FR;3;2021-09-25;31;143;3;0;3;4415047;3410772;3216;0;1567
FR;3;2021-09-26;16;59;1;0;1;4415063;3410831;3217;0;1568
FR;3;2021-09-27;48;288;3;0;5;4415111;3411119;3220;0;1573
FR;3;2021-09-28;49;246;6;0;8;4415160;3411365;3226;0;1581
FR;3;2021-09-29;38;222;10;0;15;4415198;3411587;3236;0;1596
FR;3;2021-09-30;40;201;8;0;10;4415238;3411788;3244;0;1606
FR;3;2021-10-01;23;163;6;0;8;4415261;3411951;3250;0;1614
FR;3;2021-10-02;17;84;0;0;0;4415278;3412035;3250;0;1614
FR;3;2021-10-03;19;18;1;0;2;4415297;3412053;3251;0;1616
FR;3;2021-10-04;33;159;4;0;4;4415330;3412212;3255;0;1620
FR;3;2021-10-05;17;148;10;0;12;4415347;3412360;3265;0;1632
FR;3;2021-10-06;32;148;8;0;9;4415379;3412508;3273;0;1641
FR;3;2021-10-07;19;136;6;0;6;4415398;3412644;3279;0;1647
FR;3;2021-10-08;25;138;10;0;9;4415423;3412782;3289;0;1656
FR;3;2021-10-09;16;72;1;0;1;4415439;3412854;3290;0;1657
FR;3;2021-10-10;13;17;2;0;3;4415452;3412871;3292;0;1660
FR;3;2021-10-11;16;117;4;0;5;4415468;3412988;3296;0;1665
FR;3;2021-10-12;20;103;5;0;5;4415488;3413091;3301;0;1670
FR;3;2021-10-13;25;116;9;0;7;4415513;3413207;3310;0;1677
FR;3;2021-10-14;18;151;3;0;4;4415531;3413358;3313;0;1681
FR;3;2021-10-15;23;144;8;0;12;4415554;3413502;3321;0;1693
FR;3;2021-10-16;13;72;6;0;8;4415567;3413574;3327;0;1701
FR;3;2021-10-17;12;25;0;0;0;4415579;3413599;3327;0;1701
FR;3;2021-10-18;18;116;2;0;2;4415597;3413715;3329;0;1703
FR;3;2021-10-19;16;115;19;0;21;4415613;3413830;3348;0;1724
FR;3;2021-10-20;26;126;6;0;7;4415639;3413956;3354;0;1731
FR;3;2021-10-21;28;128;17;0;13;4415667;3414084;3371;0;1744
FR;3;2021-10-22;24;107;16;0;19;4415691;3414191;3387;0;1763
FR;3;2021-10-23;17;55;2;0;1;4415708;3414246;3389;0;1764
FR;3;2021-10-24;7;36;0;0;0;4415715;3414282;3389;0;1764
FR;3;2021-10-25;24;146;7;0;7;4415739;3414428;3396;0;1771
FR;3;2021-10-26;25;99;22;0;19;4415764;3414527;3418;0;1790
FR;3;2021-10-27;18;98;9;0;9;4415782;3414625;3427;0;1799
FR;3;2021-10-28;22;118;33;0;36;4415804;3414743;3460;0;1835
FR;3;2021-10-29;12;103;64;0;54;4415816;3414846;3524;0;1889
FR;3;2021-10-30;11;63;11;1;10;4415827;3414909;3535;1;1899
FR;3;2021-10-31;8;25;1;0;1;4415835;3414934;3536;1;1900
FR;3;2021-11-01;11;22;2;0;1;4415846;3414956;3538;1;1901
FR;3;2021-11-02;10;102;10;0;12;4415856;3415058;3548;1;1913
FR;3;2021-11-03;20;110;10;0;10;4415876;3415168;3558;1;1923
FR;3;2021-11-04;20;91;5;0;4;4415896;3415259;3563;1;1927
FR;3;2021-11-05;19;124;9;1;6;4415915;3415383;3572;2;1933
FR;3;2021-11-06;10;59;3;0;3;4415925;3415442;3575;2;1936
FR;3;2021-11-07;6;22;1;0;1;4415931;3415464;3576;2;1937
FR;3;2021-11-08;11;135;7;0;5;4415942;3415599;3583;2;1942
FR;3;2021-11-09;13;132;5;0;5;4415955;3415731;3588;2;1947
FR;3;2021-11-10;14;156;14;0;15;4415969;3415887;3602;2;1962
FR;3;2021-11-11;11;50;3;0;3;4415980;3415937;3605;2;1965
FR;3;2021-11-12;15;131;6;0;4;4415995;3416068;3611;2;1969
FR;3;2021-11-13;7;67;9;0;10;4416002;3416135;3620;2;1979
FR;3;2021-11-14;3;24;1;0;1;4416005;3416159;3621;2;1980
FR;3;2021-11-15;5;171;10;0;11;4416010;3416330;3631;2;1991
FR;3;2021-11-16;7;134;11;0;10;4416017;3416464;3642;2;2001
FR;3;2021-11-17;8;144;11;0;8;4416025;3416608;3653;2;2009
FR;3;2021-11-18;15;144;10;0;11;4416040;3416752;3663;2;2020
FR;3;2021-11-19;11;194;22;0;27;4416051;3416946;3685;2;2047
FR;3;2021-11-20;6;105;6;0;6;4416057;3417051;3691;2;2053
FR;3;2021-11-21;3;26;4;0;4;4416060;3417077;3695;2;2057
FR;3;2021-11-22;11;198;11;0;11;4416071;3417275;3706;2;2068
FR;3;2021-11-23;9;197;15;0;14;4416080;3417472;3721;2;2082
FR;3;2021-11-24;9;200;9;0;17;4416089;3417672;3730;2;2099
FR;3;2021-11-25;12;221;11;0;11;4416101;3417893;3741;2;2110
FR;3;2021-11-26;9;294;35;0;33;4416110;3418187;3776;2;2143
FR;3;2021-11-27;8;139;20;0;21;4416118;3418326;3796;2;2164
FR;3;2021-11-28;3;60;7;0;7;4416121;3418386;3803;2;2171
FR;3;2021-11-29;5;249;21;0;22;4416126;3418635;3824;2;2193
FR;3;2021-11-30;7;330;29;0;32;4416133;3418965;3853;2;2225
FR;3;2021-12-01;30;361;37;0;39;4416163;3419326;3890;2;2264
FR;3;2021-12-02;9;379;33;0;36;4416172;3419705;3923;2;2300
FR;3;2021-12-03;4;422;37;0;38;4416176;3420127;3960;2;2338
FR;3;2021-12-04;3;231;26;0;28;4416179;3420358;3986;2;2366
FR;3;2021-12-05;1;65;5;0;5;4416180;3420423;3991;2;2371
FR;3;2021-12-06;6;400;14;0;15;4416186;3420823;4005;2;2386
FR;3;2021-12-07;4;468;20;0;24;4416190;3421291;4025;2;2410
FR;3;2021-12-08;7;424;29;0;30;4416197;3421715;4054;2;2440
FR;3;2021-12-09;3;482;17;0;22;4416200;3422197;4071;2;2462
FR;3;2021-12-10;10;500;29;0;25;4416210;3422697;4100;2;2487
FR;3;2021-12-11;4;324;10;0;9;4416214;3423021;4110;2;2496
FR;3;2021-12-12;1;106;3;0;3;4416215;3423127;4113;2;2499
FR;3;2021-12-13;2;476;19;0;21;4416217;3423603;4132;2;2520
FR;3;2021-12-14;8;610;18;0;21;4416225;3424213;4150;2;2541
FR;3;2021-12-15;9;594;17;0;21;4416234;3424807;4167;2;2562
FR;3;2021-12-16;10;598;19;0;18;4416244;3425405;4186;2;2580
FR;3;2021-12-17;5;671;18;0;19;4416249;3426076;4204;2;2599
FR;3;2021-12-18;4;371;4;0;5;4416253;3426447;4208;2;2604
FR;3;2021-12-19;3;193;2;0;2;4416256;3426640;4210;2;2606
FR;3;2021-12-20;8;621;23;0;28;4416264;3427261;4233;2;2634
FR;3;2021-12-21;3;711;10;0;13;4416267;3427972;4243;2;2647
FR;3;2021-12-22;10;661;9;0;10;4416277;3428633;4252;2;2657
FR;3;2021-12-23;3;579;8;0;8;4416280;3429212;4260;2;2665
FR;3;2021-12-24;2;245;3;0;6;4416282;3429457;4263;2;2671
FR;3;2021-12-25;0;25;0;0;0;4416282;3429482;4263;2;2671
FR;3;2021-12-26;0;92;1;0;1;4416282;3429574;4264;2;2672
FR;3;2021-12-27;7;491;17;0;20;4416289;3430065;4281;2;2692
FR;3;2021-12-28;3;625;6;0;5;4416292;3430690;4287;2;2697
FR;3;2021-12-29;4;523;14;0;16;4416296;3431213;4301;2;2713
FR;3;2021-12-30;3;543;7;0;10;4416299;3431756;4308;2;2723
FR;3;2021-12-31;0;192;5;0;7;4416299;3431948;4313;2;2730
FR;3;2022-01-01;0;26;0;0;2;4416299;3431974;4313;2;2732
FR;3;2022-01-02;0;80;0;0;0;4416299;3432054;4313;2;2732
FR;3;2022-01-03;4;521;17;0;21;4416303;3432575;4330;2;2753
FR;3;2022-01-04;6;567;9;0;8;4416309;3433142;4339;2;2761
FR;3;2022-01-05;5;514;10;0;14;4416314;3433656;4349;2;2775
FR;3;2022-01-06;6;493;9;0;10;4416320;3434149;4358;2;2785
FR;3;2022-01-07;2;521;11;0;13;4416322;3434670;4369;2;2798
FR;3;2022-01-08;4;263;4;0;5;4416326;3434933;4373;2;2803
FR;3;2022-01-09;0;117;0;0;0;4416326;3435050;4373;2;2803
FR;3;2022-01-10;2;449;12;0;12;4416328;3435499;4385;2;2815
FR;3;2022-01-11;3;479;1;0;1;4416331;3435978;4386;2;2816
FR;3;2022-01-12;2;412;9;0;10;4416333;3436390;4395;2;2826
FR;3;2022-01-13;3;400;11;0;12;4416336;3436790;4406;2;2838
FR;3;2022-01-14;3;443;10;0;13;4416339;3437233;4416;2;2851
FR;3;2022-01-15;0;287;2;0;3;4416339;3437520;4418;2;2854
FR;3;2022-01-16;1;110;1;0;1;4416340;3437630;4419;2;2855
FR;3;2022-01-17;2;332;8;0;9;4416342;3437962;4427;2;2864
FR;3;2022-01-18;2;377;1;0;2;4416344;3438339;4428;2;2866
FR;3;2022-01-19;2;335;5;0;10;4416346;3438674;4433;2;2876
FR;3;2022-01-20;1;359;5;0;3;4416347;3439033;4438;2;2879
FR;3;2022-01-21;4;352;5;0;7;4416351;3439385;4443;2;2886
FR;3;2022-01-22;2;229;1;0;2;4416353;3439614;4444;2;2888
FR;3;2022-01-23;0;79;0;0;1;4416353;3439693;4444;2;2889
FR;3;2022-01-24;2;327;1;0;6;4416355;3440020;4445;2;2895
FR;3;2022-01-25;0;179;0;0;0;4416355;3440199;4445;2;2895
FR;3;2022-01-26;0;79;0;0;0;4416355;3440278;4445;2;2895
FR;3;2022-01-27;0;54;0;0;0;4416355;3440332;4445;2;2895
FR;3;2022-01-28;0;123;0;0;0;4416355;3440455;4445;2;2895
FR;3;2022-01-29;0;100;0;0;0;4416355;3440555;4445;2;2895
FR;3;2022-01-30;0;51;0;0;0;4416355;3440606;4445;2;2895
FR;3;2022-01-31;0;93;0;0;0;4416355;3440699;4445;2;2895
FR;3;2022-02-01;0;100;0;0;1;4416355;3440799;4445;2;2896
FR;3;2022-02-02;0;86;0;0;0;4416355;3440885;4445;2;2896
FR;3;2022-02-03;0;96;0;0;0;4416355;3440981;4445;2;2896
FR;3;2022-02-04;0;117;0;0;0;4416355;3441098;4445;2;2896
FR;3;2022-02-05;0;71;0;0;0;4416355;3441169;4445;2;2896
FR;3;2022-02-06;0;11;0;0;0;4416355;3441180;4445;2;2896
FR;3;2022-02-07;0;80;0;0;0;4416355;3441260;4445;2;2896
FR;3;2022-02-08;0;0;0;0;0;4416355;3441260;4445;2;2896
FR;3;2022-02-09;0;0;0;0;0;4416355;3441260;4445;2;2896
FR;3;2022-02-10;0;0;0;0;0;4416355;3441260;4445;2;2896
FR;3;2022-02-11;0;0;0;0;0;4416355;3441260;4445;2;2896
FR;3;2022-02-12;0;0;0;0;0;4416355;3441260;4445;2;2896
FR;3;2022-02-13;0;0;0;0;0;4416355;3441260;4445;2;2896
FR;3;2022-02-14;0;0;0;0;0;4416355;3441260;4445;2;2896
FR;3;2022-02-15;0;0;0;0;0;4416355;3441260;4445;2;2896
FR;3;2022-02-16;0;0;0;0;0;4416355;3441260;4445;2;2896
FR;3;2022-02-17;0;0;0;0;0;4416355;3441260;4445;2;2896
FR;3;2022-02-18;0;0;0;0;0;4416355;3441260;4445;2;2896
FR;3;2022-02-19;0;0;0;0;0;4416355;3441260;4445;2;2896
FR;3;2022-02-20;0;0;0;0;0;4416355;3441260;4445;2;2896
FR;3;2022-02-21;2;0;0;0;0;4416357;3441260;4445;2;2896
FR;3;2022-02-22;0;0;0;0;0;4416357;3441260;4445;2;2896
FR;3;2022-02-23;0;0;0;0;0;4416357;3441260;4445;2;2896
FR;3;2022-02-24;0;0;0;0;0;4416357;3441260;4445;2;2896
FR;3;2022-02-25;0;0;0;0;0;4416357;3441260;4445;2;2896
FR;3;2022-02-26;0;0;0;0;0;4416357;3441260;4445;2;2896
FR;3;2022-02-27;0;0;0;0;0;4416357;3441260;4445;2;2896
FR;3;2022-02-28;1;0;0;0;0;4416358;3441260;4445;2;2896
FR;3;2022-03-01;1;0;0;0;0;4416359;3441260;4445;2;2896
FR;3;2022-03-02;0;0;0;0;0;4416359;3441260;4445;2;2896
FR;3;2022-03-03;0;0;0;0;0;4416359;3441260;4445;2;2896
FR;3;2022-03-04;0;0;0;0;0;4416359;3441260;4445;2;2896
FR;3;2022-03-05;0;0;0;0;0;4416359;3441260;4445;2;2896
FR;3;2022-03-06;1;0;0;0;0;4416360;3441260;4445;2;2896
FR;3;2022-03-07;0;0;0;0;0;4416360;3441260;4445;2;2896
FR;3;2022-03-08;1;0;0;0;0;4416361;3441260;4445;2;2896
FR;3;2022-03-09;0;0;0;0;0;4416361;3441260;4445;2;2896
FR;3;2022-03-10;0;0;0;0;0;4416361;3441260;4445;2;2896
FR;3;2022-03-11;0;0;0;0;0;4416361;3441260;4445;2;2896
FR;3;2022-03-12;0;0;0;0;0;4416361;3441260;4445;2;2896
FR;3;2022-03-13;0;0;0;0;0;4416361;3441260;4445;2;2896
FR;3;2022-03-14;0;0;0;0;0;4416361;3441260;4445;2;2896
FR;3;2022-03-15;0;0;0;0;0;4416361;3441260;4445;2;2896
FR;3;2022-03-16;0;0;0;0;0;4416361;3441260;4445;2;2896
FR;3;2022-03-17;0;0;0;0;0;4416361;3441260;4445;2;2896
FR;3;2022-03-18;0;0;0;0;0;4416361;3441260;4445;2;2896
FR;3;2022-03-19;0;0;0;0;0;4416361;3441260;4445;2;2896
FR;3;2022-03-20;1;0;0;0;0;4416362;3441260;4445;2;2896
FR;3;2022-03-21;0;0;0;0;0;4416362;3441260;4445;2;2896
FR;3;2022-03-22;0;0;0;0;0;4416362;3441260;4445;2;2896
FR;3;2022-03-23;1;0;0;0;0;4416363;3441260;4445;2;2896
FR;3;2022-03-24;0;0;0;0;0;4416363;3441260;4445;2;2896
FR;3;2022-03-25;1;0;0;0;0;4416364;3441260;4445;2;2896
FR;3;2022-03-26;0;0;0;0;0;4416364;3441260;4445;2;2896
FR;3;2022-03-27;0;0;0;0;0;4416364;3441260;4445;2;2896
FR;3;2022-03-28;0;0;0;0;0;4416364;3441260;4445;2;2896
FR;3;2022-03-29;0;0;0;0;0;4416364;3441260;4445;2;2896
FR;3;2022-03-30;0;0;0;0;0;4416364;3441260;4445;2;2896
FR;3;2022-03-31;0;0;0;0;0;4416364;3441260;4445;2;2896
FR;3;2022-04-01;0;0;0;0;0;4416364;3441260;4445;2;2896
FR;3;2022-04-02;0;0;0;0;0;4416364;3441260;4445;2;2896
FR;3;2022-04-03;0;0;0;0;0;4416364;3441260;4445;2;2896
FR;3;2022-04-04;0;0;0;0;0;4416364;3441260;4445;2;2896
FR;3;2022-04-05;0;0;0;0;0;4416364;3441260;4445;2;2896
FR;3;2022-04-06;0;0;0;0;0;4416364;3441260;4445;2;2896
FR;3;2022-04-07;0;0;0;0;0;4416364;3441260;4445;2;2896
FR;3;2022-04-08;0;0;0;0;0;4416364;3441260;4445;2;2896
FR;3;2022-04-09;0;0;0;0;0;4416364;3441260;4445;2;2896
FR;3;2022-04-10;0;0;0;0;0;4416364;3441260;4445;2;2896
FR;3;2022-04-11;0;0;0;0;0;4416364;3441260;4445;2;2896
FR;3;2022-04-12;0;0;0;0;0;4416364;3441260;4445;2;2896
FR;3;2022-04-13;0;0;0;0;0;4416364;3441260;4445;2;2896
FR;3;2022-04-14;0;0;0;0;0;4416364;3441260;4445;2;2896
FR;3;2022-04-15;1;0;0;0;0;4416365;3441260;4445;2;2896
FR;3;2022-04-16;0;0;0;0;0;4416365;3441260;4445;2;2896
FR;3;2022-04-17;0;0;0;0;0;4416365;3441260;4445;2;2896
FR;3;2022-04-18;0;0;0;0;0;4416365;3441260;4445;2;2896
FR;3;2022-04-19;0;0;0;0;0;4416365;3441260;4445;2;2896
FR;3;2022-04-20;0;0;0;0;0;4416365;3441260;4445;2;2896
FR;3;2022-04-21;0;0;0;0;0;4416365;3441260;4445;2;2896
FR;3;2022-04-22;0;0;0;0;0;4416365;3441260;4445;2;2896
FR;3;2022-04-23;0;0;0;0;0;4416365;3441260;4445;2;2896
FR;3;2022-04-24;0;0;0;0;0;4416365;3441260;4445;2;2896
FR;3;2022-04-25;0;0;0;0;0;4416365;3441260;4445;2;2896
FR;3;2022-04-26;0;0;0;0;0;4416365;3441260;4445;2;2896
FR;3;2022-04-27;0;0;0;0;0;4416365;3441260;4445;2;2896
FR;3;2022-04-28;0;0;0;0;0;4416365;3441260;4445;2;2896
FR;3;2022-04-29;0;0;0;0;0;4416365;3441260;4445;2;2896
FR;3;2022-04-30;0;0;0;0;0;4416365;3441260;4445;2;2896
FR;3;2022-05-01;0;0;0;0;0;4416365;3441260;4445;2;2896
FR;3;2022-05-02;0;0;0;0;0;4416365;3441260;4445;2;2896
FR;3;2022-05-03;0;0;0;0;0;4416365;3441260;4445;2;2896
FR;3;2022-05-04;0;0;0;0;0;4416365;3441260;4445;2;2896
FR;3;2022-05-05;0;0;0;0;0;4416365;3441260;4445;2;2896
FR;3;2022-05-06;0;0;0;0;0;4416365;3441260;4445;2;2896
FR;3;2022-05-07;0;0;0;0;0;4416365;3441260;4445;2;2896
FR;3;2022-05-08;0;0;0;0;0;4416365;3441260;4445;2;2896
FR;3;2022-05-09;0;0;0;0;0;4416365;3441260;4445;2;2896
FR;3;2022-05-10;0;0;0;0;0;4416365;3441260;4445;2;2896
FR;3;2022-05-11;0;0;0;0;0;4416365;3441260;4445;2;2896
FR;3;2022-05-12;0;0;0;0;0;4416365;3441260;4445;2;2896
FR;3;2022-05-13;0;0;0;0;0;4416365;3441260;4445;2;2896
FR;3;2022-05-14;1;0;0;0;0;4416366;3441260;4445;2;2896
FR;3;2022-05-15;0;0;0;0;0;4416366;3441260;4445;2;2896
FR;3;2022-05-16;0;0;0;0;0;4416366;3441260;4445;2;2896
FR;3;2022-05-17;0;0;0;0;0;4416366;3441260;4445;2;2896
FR;3;2022-05-18;0;0;0;0;0;4416366;3441260;4445;2;2896
FR;3;2022-05-19;0;0;0;0;0;4416366;3441260;4445;2;2896
FR;3;2022-05-20;0;0;0;0;0;4416366;3441260;4445;2;2896
FR;3;2022-05-21;0;0;0;0;0;4416366;3441260;4445;2;2896
FR;3;2022-05-22;0;0;0;0;0;4416366;3441260;4445;2;2896
FR;3;2022-05-23;0;0;0;0;0;4416366;3441260;4445;2;2896
FR;3;2022-05-24;0;0;0;0;0;4416366;3441260;4445;2;2896
FR;3;2022-05-25;0;0;0;0;0;4416366;3441260;4445;2;2896
FR;3;2022-05-26;0;0;0;0;0;4416366;3441260;4445;2;2896
FR;3;2022-05-27;0;0;0;0;0;4416366;3441260;4445;2;2896
FR;3;2022-05-28;0;0;0;0;0;4416366;3441260;4445;2;2896
FR;3;2022-05-29;0;0;0;0;0;4416366;3441260;4445;2;2896
FR;3;2022-05-30;0;0;0;0;0;4416366;3441260;4445;2;2896
FR;3;2022-05-31;0;0;0;0;0;4416366;3441260;4445;2;2896
FR;3;2022-06-01;0;0;0;0;0;4416366;3441260;4445;2;2896
FR;3;2022-06-02;0;0;0;0;0;4416366;3441260;4445;2;2896
FR;3;2022-06-03;0;0;0;0;0;4416366;3441260;4445;2;2896
FR;3;2022-06-04;0;0;0;0;0;4416366;3441260;4445;2;2896
FR;3;2022-06-05;0;0;0;0;0;4416366;3441260;4445;2;2896
FR;3;2022-06-06;0;0;0;0;0;4416366;3441260;4445;2;2896
FR;3;2022-06-07;0;0;0;0;0;4416366;3441260;4445;2;2896
FR;3;2022-06-08;0;0;0;0;0;4416366;3441260;4445;2;2896
FR;3;2022-06-09;0;0;0;0;0;4416366;3441260;4445;2;2896
FR;3;2022-06-10;0;0;0;0;0;4416366;3441260;4445;2;2896
FR;3;2022-06-11;0;0;0;0;0;4416366;3441260;4445;2;2896
FR;3;2022-06-12;0;0;0;0;0;4416366;3441260;4445;2;2896
FR;3;2022-06-13;1;0;0;0;0;4416367;3441260;4445;2;2896
FR;3;2022-06-14;0;0;0;0;0;4416367;3441260;4445;2;2896
FR;3;2022-06-15;0;0;0;0;0;4416367;3441260;4445;2;2896
FR;3;2022-06-16;0;0;0;0;0;4416367;3441260;4445;2;2896
FR;3;2022-06-17;0;0;0;0;0;4416367;3441260;4445;2;2896
FR;3;2022-06-18;0;0;0;0;0;4416367;3441260;4445;2;2896
FR;3;2022-06-19;0;0;0;0;0;4416367;3441260;4445;2;2896
FR;3;2022-06-20;0;0;0;0;0;4416367;3441260;4445;2;2896
FR;3;2022-06-21;0;0;0;0;0;4416367;3441260;4445;2;2896
FR;3;2022-06-22;0;0;0;0;0;4416367;3441260;4445;2;2896
FR;3;2022-06-23;0;0;0;0;0;4416367;3441260;4445;2;2896
FR;3;2022-06-24;0;0;0;0;0;4416367;3441260;4445;2;2896
FR;3;2022-06-25;0;0;0;0;0;4416367;3441260;4445;2;2896
FR;3;2022-06-26;0;0;0;0;0;4416367;3441260;4445;2;2896
FR;3;2022-06-27;0;0;0;0;0;4416367;3441260;4445;2;2896
FR;3;2022-06-28;0;0;0;0;0;4416367;3441260;4445;2;2896
FR;3;2022-06-29;1;0;0;0;0;4416368;3441260;4445;2;2896
FR;3;2022-06-30;0;0;0;0;0;4416368;3441260;4445;2;2896
FR;3;2022-07-01;0;0;0;0;0;4416368;3441260;4445;2;2896
FR;3;2022-07-02;0;0;0;0;0;4416368;3441260;4445;2;2896
FR;3;2022-07-03;0;0;0;0;0;4416368;3441260;4445;2;2896
FR;3;2022-07-04;0;0;0;0;0;4416368;3441260;4445;2;2896
FR;3;2022-07-05;0;0;0;0;0;4416368;3441260;4445;2;2896
FR;3;2022-07-06;0;0;0;0;0;4416368;3441260;4445;2;2896
FR;3;2022-07-07;0;0;0;0;0;4416368;3441260;4445;2;2896
FR;3;2022-07-08;0;0;0;0;0;4416368;3441260;4445;2;2896
FR;3;2022-07-09;0;0;0;0;0;4416368;3441260;4445;2;2896
FR;3;2022-07-10;0;0;0;0;0;4416368;3441260;4445;2;2896
FR;3;2022-07-11;0;0;0;0;0;4416368;3441260;4445;2;2896
FR;3;2022-07-12;0;0;0;0;0;4416368;3441260;4445;2;2896
FR;3;2022-07-13;0;0;0;0;0;4416368;3441260;4445;2;2896
FR;3;2022-07-14;0;0;0;0;0;4416368;3441260;4445;2;2896
FR;3;2022-07-15;0;0;0;0;0;4416368;3441260;4445;2;2896
FR;3;2022-07-16;0;0;0;0;0;4416368;3441260;4445;2;2896
FR;3;2022-07-17;0;0;0;0;0;4416368;3441260;4445;2;2896
FR;3;2022-07-18;0;0;0;0;0;4416368;3441260;4445;2;2896
FR;3;2022-07-19;0;0;0;0;0;4416368;3441260;4445;2;2896
FR;3;2022-07-20;0;0;0;0;0;4416368;3441260;4445;2;2896
FR;3;2022-07-21;0;0;0;0;0;4416368;3441260;4445;2;2896
FR;3;2022-07-22;0;0;0;0;0;4416368;3441260;4445;2;2896
FR;3;2022-07-23;0;0;0;0;0;4416368;3441260;4445;2;2896
FR;3;2022-07-24;0;0;0;0;0;4416368;3441260;4445;2;2896
FR;3;2022-07-25;0;0;0;0;0;4416368;3441260;4445;2;2896
FR;3;2022-07-26;0;0;0;0;0;4416368;3441260;4445;2;2896
FR;3;2022-07-27;0;0;0;0;0;4416368;3441260;4445;2;2896
FR;3;2022-07-28;0;0;0;0;0;4416368;3441260;4445;2;2896
FR;3;2022-07-29;0;0;0;0;0;4416368;3441260;4445;2;2896
FR;3;2022-07-30;0;0;0;0;0;4416368;3441260;4445;2;2896
FR;3;2022-07-31;0;0;0;0;0;4416368;3441260;4445;2;2896
FR;3;2022-08-01;0;0;0;0;0;4416368;3441260;4445;2;2896
FR;3;2022-08-02;0;0;0;0;0;4416368;3441260;4445;2;2896
FR;3;2022-08-03;0;0;0;0;0;4416368;3441260;4445;2;2896
FR;3;2022-08-04;0;0;0;0;0;4416368;3441260;4445;2;2896
FR;3;2022-08-05;0;0;0;0;0;4416368;3441260;4445;2;2896
FR;3;2022-08-06;0;0;0;0;0;4416368;3441260;4445;2;2896
FR;3;2022-08-07;0;0;0;0;0;4416368;3441260;4445;2;2896
FR;3;2022-08-08;0;0;0;0;0;4416368;3441260;4445;2;2896
FR;3;2022-08-09;0;0;0;0;0;4416368;3441260;4445;2;2896
FR;3;2022-08-10;0;0;0;0;0;4416368;3441260;4445;2;2896
FR;3;2022-08-11;0;0;0;0;0;4416368;3441260;4445;2;2896
FR;3;2022-08-12;0;0;0;0;0;4416368;3441260;4445;2;2896
FR;3;2022-08-13;0;0;0;0;0;4416368;3441260;4445;2;2896
FR;3;2022-08-14;0;0;0;0;0;4416368;3441260;4445;2;2896
FR;3;2022-08-15;0;0;0;0;0;4416368;3441260;4445;2;2896
FR;3;2022-08-16;0;0;0;0;0;4416368;3441260;4445;2;2896
FR;3;2022-08-17;0;0;0;0;0;4416368;3441260;4445;2;2896
FR;3;2022-08-18;0;0;0;0;0;4416368;3441260;4445;2;2896
FR;3;2022-08-19;0;0;0;0;0;4416368;3441260;4445;2;2896
FR;3;2022-08-20;0;0;0;0;0;4416368;3441260;4445;2;2896
FR;3;2022-08-21;0;0;0;0;0;4416368;3441260;4445;2;2896
FR;3;2022-08-22;0;0;0;0;0;4416368;3441260;4445;2;2896
FR;3;2022-08-23;0;0;0;0;0;4416368;3441260;4445;2;2896
FR;3;2022-08-24;0;0;0;0;0;4416368;3441260;4445;2;2896
FR;3;2022-08-25;0;0;0;0;0;4416368;3441260;4445;2;2896
FR;3;2022-08-26;0;0;0;0;0;4416368;3441260;4445;2;2896
FR;3;2022-08-27;0;0;0;0;0;4416368;3441260;4445;2;2896
FR;3;2022-08-28;0;0;0;0;0;4416368;3441260;4445;2;2896
FR;3;2022-08-29;0;0;0;0;0;4416368;3441260;4445;2;2896
FR;3;2022-08-30;0;0;0;0;0;4416368;3441260;4445;2;2896
FR;3;2022-08-31;0;0;0;0;0;4416368;3441260;4445;2;2896
FR;3;2022-09-01;0;0;0;0;0;4416368;3441260;4445;2;2896
FR;3;2022-09-02;0;0;0;0;0;4416368;3441260;4445;2;2896
FR;3;2022-09-03;0;0;0;0;0;4416368;3441260;4445;2;2896
FR;3;2022-09-04;0;0;0;0;0;4416368;3441260;4445;2;2896
FR;3;2022-09-05;0;0;0;0;0;4416368;3441260;4445;2;2896
FR;3;2022-09-06;0;0;0;0;0;4416368;3441260;4445;2;2896
FR;3;2022-09-07;0;0;0;0;0;4416368;3441260;4445;2;2896
FR;3;2022-09-08;0;0;0;0;0;4416368;3441260;4445;2;2896
FR;3;2022-09-09;0;0;0;0;0;4416368;3441260;4445;2;2896
FR;3;2022-09-10;0;0;0;0;0;4416368;3441260;4445;2;2896
FR;3;2022-09-11;0;0;0;0;0;4416368;3441260;4445;2;2896
FR;3;2022-09-12;0;0;0;0;0;4416368;3441260;4445;2;2896
FR;3;2022-09-13;0;0;0;0;0;4416368;3441260;4445;2;2896
FR;3;2022-09-14;0;0;0;0;0;4416368;3441260;4445;2;2896
FR;3;2022-09-15;0;0;0;0;0;4416368;3441260;4445;2;2896
FR;3;2022-09-16;0;0;0;0;0;4416368;3441260;4445;2;2896
FR;3;2022-09-17;0;0;0;0;0;4416368;3441260;4445;2;2896
FR;3;2022-09-18;0;0;0;0;0;4416368;3441260;4445;2;2896
FR;3;2022-09-19;0;0;0;0;0;4416368;3441260;4445;2;2896
FR;3;2022-09-20;0;0;0;0;0;4416368;3441260;4445;2;2896
FR;3;2022-09-21;0;0;0;0;0;4416368;3441260;4445;2;2896
FR;3;2022-09-22;0;0;0;0;0;4416368;3441260;4445;2;2896
FR;3;2022-09-23;0;0;0;0;0;4416368;3441260;4445;2;2896
FR;3;2022-09-24;0;0;0;0;0;4416368;3441260;4445;2;2896
FR;3;2022-09-25;0;0;0;0;0;4416368;3441260;4445;2;2896
FR;3;2022-09-26;0;0;0;0;0;4416368;3441260;4445;2;2896
FR;3;2022-09-27;0;0;0;0;0;4416368;3441260;4445;2;2896
FR;3;2022-09-28;0;0;0;0;0;4416368;3441260;4445;2;2896
FR;3;2022-09-29;0;0;0;0;0;4416368;3441260;4445;2;2896
FR;3;2022-09-30;0;0;0;0;0;4416368;3441260;4445;2;2896
FR;3;2022-10-01;0;0;0;0;0;4416368;3441260;4445;2;2896
FR;3;2022-10-02;0;0;0;0;0;4416368;3441260;4445;2;2896
FR;3;2022-10-03;0;0;0;0;0;4416368;3441260;4445;2;2896
FR;3;2022-10-04;0;0;0;0;0;4416368;3441260;4445;2;2896
FR;3;2022-10-05;0;0;0;0;0;4416368;3441260;4445;2;2896
FR;3;2022-10-06;0;0;0;0;0;4416368;3441260;4445;2;2896
FR;3;2022-10-07;0;0;0;0;0;4416368;3441260;4445;2;2896
FR;3;2022-10-08;0;0;0;0;0;4416368;3441260;4445;2;2896
FR;3;2022-10-09;0;0;0;0;0;4416368;3441260;4445;2;2896
FR;3;2022-10-10;0;0;0;0;0;4416368;3441260;4445;2;2896
FR;3;2022-10-11;0;0;0;0;0;4416368;3441260;4445;2;2896
FR;3;2022-10-12;0;0;0;0;0;4416368;3441260;4445;2;2896
FR;3;2022-10-13;0;0;0;0;0;4416368;3441260;4445;2;2896
FR;3;2022-10-14;0;0;0;0;0;4416368;3441260;4445;2;2896
FR;3;2022-10-15;0;0;0;0;0;4416368;3441260;4445;2;2896
FR;3;2022-10-16;0;0;0;0;0;4416368;3441260;4445;2;2896
FR;3;2022-10-17;0;0;0;0;0;4416368;3441260;4445;2;2896
FR;3;2022-10-18;0;0;0;0;0;4416368;3441260;4445;2;2896
FR;3;2022-10-19;0;0;0;0;0;4416368;3441260;4445;2;2896
FR;3;2022-10-20;0;0;0;0;0;4416368;3441260;4445;2;2896
FR;3;2022-10-21;0;0;0;0;0;4416368;3441260;4445;2;2896
FR;3;2022-10-22;0;0;0;0;0;4416368;3441260;4445;2;2896
FR;3;2022-10-23;0;0;0;0;0;4416368;3441260;4445;2;2896
FR;3;2022-10-24;0;0;0;0;0;4416368;3441260;4445;2;2896
FR;3;2022-10-25;0;0;0;0;0;4416368;3441260;4445;2;2896
FR;3;2022-10-26;0;0;0;0;0;4416368;3441260;4445;2;2896
FR;4;2020-12-27;0;0;0;0;0;0;0;0;0;0
FR;4;2020-12-28;0;0;0;0;0;0;0;0;0;0
FR;4;2020-12-29;0;0;0;0;0;0;0;0;0;0
FR;4;2020-12-30;0;0;0;0;0;0;0;0;0;0
FR;4;2020-12-31;0;0;0;0;0;0;0;0;0;0
FR;4;2021-01-01;0;0;0;0;0;0;0;0;0;0
FR;4;2021-01-02;0;0;0;0;0;0;0;0;0;0
FR;4;2021-01-03;0;0;0;0;0;0;0;0;0;0
FR;4;2021-01-04;0;0;0;0;0;0;0;0;0;0
FR;4;2021-01-05;0;0;0;0;0;0;0;0;0;0
FR;4;2021-01-06;0;0;0;0;0;0;0;0;0;0
FR;4;2021-01-07;0;0;0;0;0;0;0;0;0;0
FR;4;2021-01-08;0;0;0;0;0;0;0;0;0;0
FR;4;2021-01-09;0;0;0;0;0;0;0;0;0;0
FR;4;2021-01-10;0;0;0;0;0;0;0;0;0;0
FR;4;2021-01-11;0;0;0;0;0;0;0;0;0;0
FR;4;2021-01-12;0;0;0;0;0;0;0;0;0;0
FR;4;2021-01-13;0;0;0;0;0;0;0;0;0;0
FR;4;2021-01-14;0;0;0;0;0;0;0;0;0;0
FR;4;2021-01-15;0;0;0;0;0;0;0;0;0;0
FR;4;2021-01-16;0;0;0;0;0;0;0;0;0;0
FR;4;2021-01-17;0;0;0;0;0;0;0;0;0;0
FR;4;2021-01-18;0;0;0;0;0;0;0;0;0;0
FR;4;2021-01-19;0;0;0;0;0;0;0;0;0;0
FR;4;2021-01-20;0;0;0;0;0;0;0;0;0;0
FR;4;2021-01-21;0;0;0;0;0;0;0;0;0;0
FR;4;2021-01-22;0;0;0;0;0;0;0;0;0;0
FR;4;2021-01-23;0;0;0;0;0;0;0;0;0;0
FR;4;2021-01-24;0;0;0;0;0;0;0;0;0;0
FR;4;2021-01-25;0;0;0;0;0;0;0;0;0;0
FR;4;2021-01-26;0;0;0;0;0;0;0;0;0;0
FR;4;2021-01-27;0;0;0;0;0;0;0;0;0;0
FR;4;2021-01-28;0;0;0;0;0;0;0;0;0;0
FR;4;2021-01-29;0;0;0;0;0;0;0;0;0;0
FR;4;2021-01-30;0;0;0;0;0;0;0;0;0;0
FR;4;2021-01-31;0;0;0;0;0;0;0;0;0;0
FR;4;2021-02-01;0;0;0;0;0;0;0;0;0;0
FR;4;2021-02-02;0;0;0;0;0;0;0;0;0;0
FR;4;2021-02-03;0;0;0;0;0;0;0;0;0;0
FR;4;2021-02-04;0;0;0;0;0;0;0;0;0;0
FR;4;2021-02-05;0;0;0;0;0;0;0;0;0;0
FR;4;2021-02-06;0;0;0;0;0;0;0;0;0;0
FR;4;2021-02-07;0;0;0;0;0;0;0;0;0;0
FR;4;2021-02-08;0;0;0;0;0;0;0;0;0;0
FR;4;2021-02-09;0;0;0;0;0;0;0;0;0;0
FR;4;2021-02-10;0;0;0;0;0;0;0;0;0;0
FR;4;2021-02-11;0;0;0;0;0;0;0;0;0;0
FR;4;2021-02-12;0;0;0;0;0;0;0;0;0;0
FR;4;2021-02-13;0;0;0;0;0;0;0;0;0;0
FR;4;2021-02-14;0;0;0;0;0;0;0;0;0;0
FR;4;2021-02-15;0;0;0;0;0;0;0;0;0;0
FR;4;2021-02-16;0;0;0;0;0;0;0;0;0;0
FR;4;2021-02-17;0;0;0;0;0;0;0;0;0;0
FR;4;2021-02-18;0;0;0;0;0;0;0;0;0;0
FR;4;2021-02-19;0;0;0;0;0;0;0;0;0;0
FR;4;2021-02-20;0;0;0;0;0;0;0;0;0;0
FR;4;2021-02-21;0;0;0;0;0;0;0;0;0;0
FR;4;2021-02-22;0;0;0;0;0;0;0;0;0;0
FR;4;2021-02-23;0;0;0;0;0;0;0;0;0;0
FR;4;2021-02-24;0;0;0;0;0;0;0;0;0;0
FR;4;2021-02-25;0;0;0;0;0;0;0;0;0;0
FR;4;2021-02-26;0;0;0;0;0;0;0;0;0;0
FR;4;2021-02-27;0;0;0;0;0;0;0;0;0;0
FR;4;2021-02-28;0;0;0;0;0;0;0;0;0;0
FR;4;2021-03-01;0;0;0;0;0;0;0;0;0;0
FR;4;2021-03-02;0;0;0;0;0;0;0;0;0;0
FR;4;2021-03-03;0;0;0;0;0;0;0;0;0;0
FR;4;2021-03-04;0;0;0;0;0;0;0;0;0;0
FR;4;2021-03-05;0;0;0;0;0;0;0;0;0;0
FR;4;2021-03-06;0;0;0;0;0;0;0;0;0;0
FR;4;2021-03-07;0;0;0;0;0;0;0;0;0;0
FR;4;2021-03-08;0;0;0;0;0;0;0;0;0;0
FR;4;2021-03-09;0;0;0;0;0;0;0;0;0;0
FR;4;2021-03-10;0;0;0;0;0;0;0;0;0;0
FR;4;2021-03-11;0;0;0;0;0;0;0;0;0;0
FR;4;2021-03-12;0;0;0;0;0;0;0;0;0;0
FR;4;2021-03-13;0;0;0;0;0;0;0;0;0;0
FR;4;2021-03-14;0;0;0;0;0;0;0;0;0;0
FR;4;2021-03-15;0;0;0;0;0;0;0;0;0;0
FR;4;2021-03-16;0;0;0;0;0;0;0;0;0;0
FR;4;2021-03-17;0;0;0;0;0;0;0;0;0;0
FR;4;2021-03-18;0;0;0;0;0;0;0;0;0;0
FR;4;2021-03-19;0;0;0;0;0;0;0;0;0;0
FR;4;2021-03-20;0;0;0;0;0;0;0;0;0;0
FR;4;2021-03-21;0;0;0;0;0;0;0;0;0;0
FR;4;2021-03-22;0;0;0;0;0;0;0;0;0;0
FR;4;2021-03-23;0;0;0;0;0;0;0;0;0;0
FR;4;2021-03-24;0;0;0;0;0;0;0;0;0;0
FR;4;2021-03-25;0;0;0;0;0;0;0;0;0;0
FR;4;2021-03-26;0;0;0;0;0;0;0;0;0;0
FR;4;2021-03-27;0;0;0;0;0;0;0;0;0;0
FR;4;2021-03-28;0;0;0;0;0;0;0;0;0;0
FR;4;2021-03-29;0;0;0;0;0;0;0;0;0;0
FR;4;2021-03-30;0;0;0;0;0;0;0;0;0;0
FR;4;2021-03-31;0;0;0;0;0;0;0;0;0;0
FR;4;2021-04-01;0;0;0;0;0;0;0;0;0;0
FR;4;2021-04-02;0;0;0;0;0;0;0;0;0;0
FR;4;2021-04-03;0;0;0;0;0;0;0;0;0;0
FR;4;2021-04-04;0;0;0;0;0;0;0;0;0;0
FR;4;2021-04-05;0;0;0;0;0;0;0;0;0;0
FR;4;2021-04-06;0;0;0;0;0;0;0;0;0;0
FR;4;2021-04-07;0;0;0;0;0;0;0;0;0;0
FR;4;2021-04-08;0;0;0;0;0;0;0;0;0;0
FR;4;2021-04-09;0;0;0;0;0;0;0;0;0;0
FR;4;2021-04-10;0;0;0;0;0;0;0;0;0;0
FR;4;2021-04-11;0;0;0;0;0;0;0;0;0;0
FR;4;2021-04-12;0;0;0;0;0;0;0;0;0;0
FR;4;2021-04-13;0;0;0;0;0;0;0;0;0;0
FR;4;2021-04-14;0;0;0;0;0;0;0;0;0;0
FR;4;2021-04-15;0;0;0;0;0;0;0;0;0;0
FR;4;2021-04-16;0;0;0;0;0;0;0;0;0;0
FR;4;2021-04-17;0;0;0;0;0;0;0;0;0;0
FR;4;2021-04-18;0;0;0;0;0;0;0;0;0;0
FR;4;2021-04-19;0;0;0;0;0;0;0;0;0;0
FR;4;2021-04-20;0;0;0;0;0;0;0;0;0;0
FR;4;2021-04-21;0;0;0;0;0;0;0;0;0;0
FR;4;2021-04-22;0;0;0;0;0;0;0;0;0;0
FR;4;2021-04-23;3804;0;0;0;0;3804;0;0;0;0
FR;4;2021-04-24;1569;1;0;0;0;5373;1;0;0;0
FR;4;2021-04-25;125;0;0;0;0;5498;1;0;0;0
FR;4;2021-04-26;2869;1;0;0;0;8367;2;0;0;0
FR;4;2021-04-27;9521;3;0;0;0;17888;5;0;0;0
FR;4;2021-04-28;9908;6;0;0;0;27796;11;0;0;0
FR;4;2021-04-29;15993;8;0;0;0;43789;19;0;0;0
FR;4;2021-04-30;19233;10;0;0;0;63022;29;0;0;0
FR;4;2021-05-01;1993;6;0;0;0;65015;35;0;0;0
FR;4;2021-05-02;483;0;0;0;0;65498;35;0;0;0
FR;4;2021-05-03;5064;2;0;0;0;70562;37;0;0;0
FR;4;2021-05-04;8407;11;0;0;0;78969;48;0;0;0
FR;4;2021-05-05;6190;7;0;0;0;85159;55;0;0;0
FR;4;2021-05-06;11385;11;0;0;0;96544;66;0;0;0
FR;4;2021-05-07;19124;9;0;0;0;115668;75;0;0;0
FR;4;2021-05-08;2378;6;0;0;0;118046;81;0;0;0
FR;4;2021-05-09;688;3;0;0;0;118734;84;0;0;0
FR;4;2021-05-10;7244;5;1;0;0;125978;89;1;0;0
FR;4;2021-05-11;14323;12;0;0;0;140301;101;1;0;0
FR;4;2021-05-12;10173;15;0;0;0;150474;116;1;0;0
FR;4;2021-05-13;1583;4;0;0;0;152057;120;1;0;0
FR;4;2021-05-14;7766;7;0;0;0;159823;127;1;0;0
FR;4;2021-05-15;3720;8;1;0;0;163543;135;2;0;0
FR;4;2021-05-16;417;1;0;0;0;163960;136;2;0;0
FR;4;2021-05-17;4479;6;0;0;0;168439;142;2;0;0
FR;4;2021-05-18;8765;10;0;0;0;177204;152;2;0;0
FR;4;2021-05-19;5694;7;0;0;0;182898;159;2;0;0
FR;4;2021-05-20;9485;8;0;0;0;192383;167;2;0;0
FR;4;2021-05-21;12808;30;0;0;0;205191;197;2;0;0
FR;4;2021-05-22;5060;15;0;0;0;210251;212;2;0;0
FR;4;2021-05-23;495;4;0;0;0;210746;216;2;0;0
FR;4;2021-05-24;1058;7;0;0;0;211804;223;2;0;0
FR;4;2021-05-25;7632;16;0;0;0;219436;239;2;0;0
FR;4;2021-05-26;7729;16;0;0;0;227165;255;2;0;0
FR;4;2021-05-27;14335;35;0;0;0;241500;290;2;0;0
FR;4;2021-05-28;26591;82;1;0;0;268091;372;3;0;0
FR;4;2021-05-29;11385;18;0;0;0;279476;390;3;0;0
FR;4;2021-05-30;973;6;0;0;0;280449;396;3;0;0
FR;4;2021-05-31;12695;21;0;0;0;293144;417;3;0;0
FR;4;2021-06-01;20264;48;1;0;0;313408;465;4;0;0
FR;4;2021-06-02;14520;33;0;0;0;327928;498;4;0;0
FR;4;2021-06-03;19429;24;1;0;0;347357;522;5;0;0
FR;4;2021-06-04;22514;47;0;0;0;369871;569;5;0;0
FR;4;2021-06-05;9714;32;0;0;0;379585;601;5;0;0
FR;4;2021-06-06;1039;1;0;0;0;380624;602;5;0;0
FR;4;2021-06-07;9227;19;0;0;0;389851;621;5;0;0
FR;4;2021-06-08;14612;32;0;0;0;404463;653;5;0;0
FR;4;2021-06-09;12209;25;0;0;0;416672;678;5;0;0
FR;4;2021-06-10;15404;30;0;0;0;432076;708;5;0;0
FR;4;2021-06-11;16987;57;0;0;0;449063;765;5;0;0
FR;4;2021-06-12;7450;27;0;0;0;456513;792;5;0;0
FR;4;2021-06-13;908;3;0;0;0;457421;795;5;0;0
FR;4;2021-06-14;6649;27;0;0;0;464070;822;5;0;0
FR;4;2021-06-15;10891;37;0;0;0;474961;859;5;0;0
FR;4;2021-06-16;8909;16;0;0;0;483870;875;5;0;0
FR;4;2021-06-17;10899;37;0;0;0;494769;912;5;0;0
FR;4;2021-06-18;12424;45;0;0;0;507193;957;5;0;0
FR;4;2021-06-19;5567;25;0;0;0;512760;982;5;0;0
FR;4;2021-06-20;824;5;0;0;0;513584;987;5;0;0
FR;4;2021-06-21;5100;20;0;0;0;518684;1007;5;0;0
FR;4;2021-06-22;7913;28;2;0;0;526597;1035;7;0;0
FR;4;2021-06-23;7102;42;2;0;0;533699;1077;9;0;0
FR;4;2021-06-24;8653;46;1;0;0;542352;1123;10;0;0
FR;4;2021-06-25;10174;41;2;0;0;552526;1164;12;0;0
FR;4;2021-06-26;4849;21;0;0;0;557375;1185;12;0;0
FR;4;2021-06-27;764;4;0;0;0;558139;1189;12;0;0
FR;4;2021-06-28;4831;16;1;0;0;562970;1205;13;0;0
FR;4;2021-06-29;7110;28;2;0;0;570080;1233;15;0;0
FR;4;2021-06-30;6723;39;2;0;0;576803;1272;17;0;0
FR;4;2021-07-01;8209;42;0;0;0;585012;1314;17;0;0
FR;4;2021-07-02;9427;53;1;0;0;594439;1367;18;0;0
FR;4;2021-07-03;4846;20;0;0;0;599285;1387;18;0;0
FR;4;2021-07-04;689;5;0;0;0;599974;1392;18;0;0
FR;4;2021-07-05;4771;19;2;0;0;604745;1411;20;0;0
FR;4;2021-07-06;7726;29;4;0;0;612471;1440;24;0;0
FR;4;2021-07-07;7084;34;2;0;0;619555;1474;26;0;0
FR;4;2021-07-08;9231;39;2;0;0;628786;1513;28;0;0
FR;4;2021-07-09;10278;34;1;0;0;639064;1547;29;0;0
FR;4;2021-07-10;4639;14;2;0;0;643703;1561;31;0;0
FR;4;2021-07-11;583;4;1;0;0;644286;1565;32;0;0
FR;4;2021-07-12;5875;29;0;0;0;650161;1594;32;0;0
FR;4;2021-07-13;14234;29;0;0;0;664395;1623;32;0;0
FR;4;2021-07-14;2289;15;0;0;0;666684;1638;32;0;0
FR;4;2021-07-15;18236;36;0;0;0;684920;1674;32;0;0
FR;4;2021-07-16;22835;71;2;0;0;707755;1745;34;0;0
FR;4;2021-07-17;9738;20;0;0;0;717493;1765;34;0;0
FR;4;2021-07-18;1357;4;0;0;0;718850;1769;34;0;0
FR;4;2021-07-19;12989;30;1;0;0;731839;1799;35;0;0
FR;4;2021-07-20;17343;26;1;0;0;749182;1825;36;0;0
FR;4;2021-07-21;15616;33;0;0;0;764798;1858;36;0;0
FR;4;2021-07-22;18244;44;2;0;0;783042;1902;38;0;0
FR;4;2021-07-23;20417;57;7;0;0;803459;1959;45;0;0
FR;4;2021-07-24;9289;32;0;0;0;812748;1991;45;0;0
FR;4;2021-07-25;1354;8;0;0;0;814102;1999;45;0;0
FR;4;2021-07-26;11041;23;0;0;0;825143;2022;45;0;0
FR;4;2021-07-27;14681;35;3;0;0;839824;2057;48;0;0
FR;4;2021-07-28;12933;26;2;0;0;852757;2083;50;0;0
FR;4;2021-07-29;14089;54;4;0;0;866846;2137;54;0;0
FR;4;2021-07-30;15499;46;2;0;0;882345;2183;56;0;0
FR;4;2021-07-31;6840;14;2;0;0;889185;2197;58;0;0
FR;4;2021-08-01;906;1;0;0;0;890091;2198;58;0;0
FR;4;2021-08-02;7917;31;0;0;0;898008;2229;58;0;0
FR;4;2021-08-03;10798;31;2;0;0;908806;2260;60;0;0
FR;4;2021-08-04;9746;29;0;0;0;918552;2289;60;0;0
FR;4;2021-08-05;9823;41;0;0;0;928375;2330;60;0;0
FR;4;2021-08-06;10200;31;3;0;0;938575;2361;63;0;0
FR;4;2021-08-07;5098;30;1;0;0;943673;2391;64;0;0
FR;4;2021-08-08;1219;13;0;0;0;944892;2404;64;0;0
FR;4;2021-08-09;6348;31;0;0;0;951240;2435;64;0;0
FR;4;2021-08-10;8749;18;0;0;0;959989;2453;64;0;0
FR;4;2021-08-11;7943;34;4;0;0;967932;2487;68;0;0
FR;4;2021-08-12;8585;31;1;0;0;976517;2518;69;0;0
FR;4;2021-08-13;7558;25;0;1;0;984075;2543;69;1;0
FR;4;2021-08-14;3791;20;0;0;0;987866;2563;69;1;0
FR;4;2021-08-15;771;5;0;0;0;988637;2568;69;1;0
FR;4;2021-08-16;4008;17;0;0;0;992645;2585;69;1;0
FR;4;2021-08-17;5628;17;1;0;0;998273;2602;70;1;0
FR;4;2021-08-18;5166;37;0;0;0;1003439;2639;70;1;0
FR;4;2021-08-19;5486;33;3;0;0;1008925;2672;73;1;0
FR;4;2021-08-20;5222;25;1;0;0;1014147;2697;74;1;0
FR;4;2021-08-21;2310;21;1;0;0;1016457;2718;75;1;0
FR;4;2021-08-22;414;2;0;0;0;1016871;2720;75;1;0
FR;4;2021-08-23;2932;19;1;0;0;1019803;2739;76;1;0
FR;4;2021-08-24;3757;15;0;0;0;1023560;2754;76;1;0
FR;4;2021-08-25;3542;25;1;0;0;1027102;2779;77;1;0
FR;4;2021-08-26;3714;21;2;0;0;1030816;2800;79;1;0
FR;4;2021-08-27;3617;31;2;0;0;1034433;2831;81;1;0
FR;4;2021-08-28;1725;10;1;0;0;1036158;2841;82;1;0
FR;4;2021-08-29;385;7;1;0;0;1036543;2848;83;1;0
FR;4;2021-08-30;2009;25;0;0;15;1038552;2873;83;1;15
FR;4;2021-08-31;2485;21;0;0;14;1041037;2894;83;1;29
FR;4;2021-09-01;2083;38;1;0;21;1043120;2932;84;1;50
FR;4;2021-09-02;2306;31;4;0;18;1045426;2963;88;1;68
FR;4;2021-09-03;2363;44;5;0;36;1047789;3007;93;1;104
FR;4;2021-09-04;1373;18;0;0;9;1049162;3025;93;1;113
FR;4;2021-09-05;433;2;0;0;2;1049595;3027;93;1;115
FR;4;2021-09-06;1713;62;0;0;23;1051308;3089;93;1;138
FR;4;2021-09-07;1679;18;0;0;8;1052987;3107;93;1;146
FR;4;2021-09-08;1285;26;3;0;19;1054272;3133;96;1;165
FR;4;2021-09-09;1389;23;2;0;9;1055661;3156;98;1;174
FR;4;2021-09-10;1521;31;2;0;23;1057182;3187;100;1;197
FR;4;2021-09-11;744;11;0;0;3;1057926;3198;100;1;200
FR;4;2021-09-12;169;4;0;0;3;1058095;3202;100;1;203
FR;4;2021-09-13;1322;22;1;0;16;1059417;3224;101;1;219
FR;4;2021-09-14;1503;9;2;0;6;1060920;3233;103;1;225
FR;4;2021-09-15;1095;28;1;0;25;1062015;3261;104;1;250
FR;4;2021-09-16;1105;22;2;0;15;1063120;3283;106;1;265
FR;4;2021-09-17;896;21;1;0;12;1064016;3304;107;1;277
FR;4;2021-09-18;464;6;1;0;5;1064480;3310;108;1;282
FR;4;2021-09-19;182;3;0;0;2;1064662;3313;108;1;284
FR;4;2021-09-20;453;19;0;0;13;1065115;3332;108;1;297
FR;4;2021-09-21;432;11;0;0;7;1065547;3343;108;1;304
FR;4;2021-09-22;374;19;2;0;13;1065921;3362;110;1;317
FR;4;2021-09-23;483;16;1;0;15;1066404;3378;111;1;332
FR;4;2021-09-24;413;13;2;0;9;1066817;3391;113;1;341
FR;4;2021-09-25;280;10;1;0;5;1067097;3401;114;1;346
FR;4;2021-09-26;74;2;0;0;1;1067171;3403;114;1;347
FR;4;2021-09-27;264;10;1;0;8;1067435;3413;115;1;355
FR;4;2021-09-28;318;8;0;0;8;1067753;3421;115;1;363
FR;4;2021-09-29;375;19;1;0;13;1068128;3440;116;1;376
FR;4;2021-09-30;364;41;0;0;22;1068492;3481;116;1;398
FR;4;2021-10-01;411;56;0;0;50;1068903;3537;116;1;448
FR;4;2021-10-02;196;22;1;0;13;1069099;3559;117;1;461
FR;4;2021-10-03;85;1;0;0;0;1069184;3560;117;1;461
FR;4;2021-10-04;360;20;1;0;16;1069544;3580;118;1;477
FR;4;2021-10-05;286;19;2;0;15;1069830;3599;120;1;492
FR;4;2021-10-06;248;23;1;0;18;1070078;3622;121;1;510
FR;4;2021-10-07;265;25;2;0;13;1070343;3647;123;1;523
FR;4;2021-10-08;356;24;2;0;20;1070699;3671;125;1;543
FR;4;2021-10-09;194;6;6;0;7;1070893;3677;131;1;550
FR;4;2021-10-10;97;3;2;0;3;1070990;3680;133;1;553
FR;4;2021-10-11;250;15;1;0;14;1071240;3695;134;1;567
FR;4;2021-10-12;208;14;0;0;13;1071448;3709;134;1;580
FR;4;2021-10-13;219;28;1;0;25;1071667;3737;135;1;605
FR;4;2021-10-14;314;21;4;0;15;1071981;3758;139;1;620
FR;4;2021-10-15;322;24;5;0;25;1072303;3782;144;1;645
FR;4;2021-10-16;166;6;2;0;6;1072469;3788;146;1;651
FR;4;2021-10-17;70;2;0;0;1;1072539;3790;146;1;652
FR;4;2021-10-18;281;16;1;0;13;1072820;3806;147;1;665
FR;4;2021-10-19;215;14;2;0;15;1073035;3820;149;1;680
FR;4;2021-10-20;230;27;4;0;15;1073265;3847;153;1;695
FR;4;2021-10-21;243;17;0;0;13;1073508;3864;153;1;708
FR;4;2021-10-22;217;25;2;0;20;1073725;3889;155;1;728
FR;4;2021-10-23;116;16;1;0;15;1073841;3905;156;1;743
FR;4;2021-10-24;38;4;0;0;1;1073879;3909;156;1;744
FR;4;2021-10-25;214;7;2;0;9;1074093;3916;158;1;753
FR;4;2021-10-26;200;14;0;0;12;1074293;3930;158;1;765
FR;4;2021-10-27;196;11;4;0;11;1074489;3941;162;1;776
FR;4;2021-10-28;184;18;5;0;22;1074673;3959;167;1;798
FR;4;2021-10-29;224;15;2;0;13;1074897;3974;169;1;811
FR;4;2021-10-30;102;2;1;0;2;1074999;3976;170;1;813
FR;4;2021-10-31;58;3;2;0;3;1075057;3979;172;1;816
FR;4;2021-11-01;75;27;4;0;24;1075132;4006;176;1;840
FR;4;2021-11-02;160;21;2;0;21;1075292;4027;178;1;861
FR;4;2021-11-03;130;20;8;1;18;1075422;4047;186;2;879
FR;4;2021-11-04;185;15;1;0;12;1075607;4062;187;2;891
FR;4;2021-11-05;130;17;1;0;16;1075737;4079;188;2;907
FR;4;2021-11-06;80;6;1;0;6;1075817;4085;189;2;913
FR;4;2021-11-07;81;2;2;0;4;1075898;4087;191;2;917
FR;4;2021-11-08;160;20;1;0;20;1076058;4107;192;2;937
FR;4;2021-11-09;156;14;3;0;16;1076214;4121;195;2;953
FR;4;2021-11-10;121;30;6;0;32;1076335;4151;201;2;985
FR;4;2021-11-11;98;10;1;0;11;1076433;4161;202;2;996
FR;4;2021-11-12;105;19;2;0;18;1076538;4180;204;2;1014
FR;4;2021-11-13;74;15;2;0;14;1076612;4195;206;2;1028
FR;4;2021-11-14;55;5;4;0;8;1076667;4200;210;2;1036
FR;4;2021-11-15;99;26;2;0;24;1076766;4226;212;2;1060
FR;4;2021-11-16;105;13;2;0;15;1076871;4239;214;2;1075
FR;4;2021-11-17;119;30;4;0;30;1076990;4269;218;2;1105
FR;4;2021-11-18;100;34;14;0;43;1077090;4303;232;2;1148
FR;4;2021-11-19;87;21;3;0;22;1077177;4324;235;2;1170
FR;4;2021-11-20;77;8;1;0;8;1077254;4332;236;2;1178
FR;4;2021-11-21;68;7;2;0;9;1077322;4339;238;2;1187
FR;4;2021-11-22;107;28;9;0;33;1077429;4367;247;2;1220
FR;4;2021-11-23;76;31;6;0;29;1077505;4398;253;2;1249
FR;4;2021-11-24;89;23;11;0;24;1077594;4421;264;2;1273
FR;4;2021-11-25;93;28;16;0;32;1077687;4449;280;2;1305
FR;4;2021-11-26;84;43;12;0;45;1077771;4492;292;2;1350
FR;4;2021-11-27;41;22;15;0;25;1077812;4514;307;2;1375
FR;4;2021-11-28;50;8;0;0;7;1077862;4522;307;2;1382
FR;4;2021-11-29;90;31;16;0;40;1077952;4553;323;2;1422
FR;4;2021-11-30;75;37;12;0;41;1078027;4590;335;2;1463
FR;4;2021-12-01;88;60;19;0;67;1078115;4650;354;2;1530
FR;4;2021-12-02;107;48;22;0;56;1078222;4698;376;2;1586
FR;4;2021-12-03;101;36;15;0;44;1078323;4734;391;2;1630
FR;4;2021-12-04;72;31;18;0;44;1078395;4765;409;2;1674
FR;4;2021-12-05;62;7;1;0;7;1078457;4772;410;2;1681
FR;4;2021-12-06;109;46;19;0;59;1078566;4818;429;2;1740
FR;4;2021-12-07;82;37;9;0;36;1078648;4855;438;2;1776
FR;4;2021-12-08;70;31;17;0;38;1078718;4886;455;2;1814
FR;4;2021-12-09;63;32;10;1;39;1078781;4918;465;3;1853
FR;4;2021-12-10;63;64;20;0;68;1078844;4982;485;3;1921
FR;4;2021-12-11;28;34;7;0;34;1078872;5016;492;3;1955
FR;4;2021-12-12;26;10;3;0;13;1078898;5026;495;3;1968
FR;4;2021-12-13;73;40;14;0;49;1078971;5066;509;3;2017
FR;4;2021-12-14;59;43;17;0;54;1079030;5109;526;3;2071
FR;4;2021-12-15;67;64;28;0;84;1079097;5173;554;3;2155
FR;4;2021-12-16;33;45;19;0;58;1079130;5218;573;3;2213
FR;4;2021-12-17;39;55;12;0;60;1079169;5273;585;3;2273
FR;4;2021-12-18;49;30;2;0;31;1079218;5303;587;3;2304
FR;4;2021-12-19;15;4;1;0;4;1079233;5307;588;3;2308
FR;4;2021-12-20;43;38;10;0;41;1079276;5345;598;3;2349
FR;4;2021-12-21;29;32;16;0;38;1079305;5377;614;3;2387
FR;4;2021-12-22;37;37;10;0;38;1079342;5414;624;3;2425
FR;4;2021-12-23;39;45;8;0;49;1079381;5459;632;3;2474
FR;4;2021-12-24;23;26;10;0;30;1079404;5485;642;3;2504
FR;4;2021-12-25;7;3;3;0;4;1079411;5488;645;3;2508
FR;4;2021-12-26;5;3;1;0;2;1079416;5491;646;3;2510
FR;4;2021-12-27;31;41;9;0;43;1079447;5532;655;3;2553
FR;4;2021-12-28;25;28;7;0;29;1079472;5560;662;3;2582
FR;4;2021-12-29;52;25;11;0;30;1079524;5585;673;3;2612
FR;4;2021-12-30;46;19;12;0;22;1079570;5604;685;3;2634
FR;4;2021-12-31;18;6;8;0;11;1079588;5610;693;3;2645
FR;4;2022-01-01;5;4;4;0;6;1079593;5614;697;3;2651
FR;4;2022-01-02;40;5;16;0;20;1079633;5619;713;3;2671
FR;4;2022-01-03;43;55;22;1;62;1079676;5674;735;4;2733
FR;4;2022-01-04;37;28;15;0;33;1079713;5702;750;4;2766
FR;4;2022-01-05;51;22;19;0;25;1079764;5724;769;4;2791
FR;4;2022-01-06;49;22;24;0;38;1079813;5746;793;4;2829
FR;4;2022-01-07;30;20;15;0;20;1079843;5766;808;4;2849
FR;4;2022-01-08;11;6;10;0;12;1079854;5772;818;4;2861
FR;4;2022-01-09;18;2;3;0;4;1079872;5774;821;4;2865
FR;4;2022-01-10;47;22;19;0;36;1079919;5796;840;4;2901
FR;4;2022-01-11;27;31;12;0;35;1079946;5827;852;4;2936
FR;4;2022-01-12;33;21;13;0;23;1079979;5848;865;4;2959
FR;4;2022-01-13;53;20;27;0;38;1080032;5868;892;4;2997
FR;4;2022-01-14;23;29;13;0;32;1080055;5897;905;4;3029
FR;4;2022-01-15;13;6;8;0;12;1080068;5903;913;4;3041
FR;4;2022-01-16;12;9;14;0;22;1080080;5912;927;4;3063
FR;4;2022-01-17;26;19;12;0;25;1080106;5931;939;4;3088
FR;4;2022-01-18;16;13;8;0;18;1080122;5944;947;4;3106
FR;4;2022-01-19;31;23;13;0;34;1080153;5967;960;4;3140
FR;4;2022-01-20;32;34;13;0;39;1080185;6001;973;4;3179
FR;4;2022-01-21;11;12;19;1;16;1080196;6013;992;5;3195
FR;4;2022-01-22;30;13;2;0;13;1080226;6026;994;5;3208
FR;4;2022-01-23;8;2;5;0;7;1080234;6028;999;5;3215
FR;4;2022-01-24;14;21;8;0;27;1080248;6049;1007;5;3242
FR;4;2022-01-25;22;32;10;1;38;1080270;6081;1017;6;3280
FR;4;2022-01-26;19;16;8;1;20;1080289;6097;1025;7;3300
FR;4;2022-01-27;21;18;8;0;24;1080310;6115;1033;7;3324
FR;4;2022-01-28;13;23;8;0;26;1080323;6138;1041;7;3350
FR;4;2022-01-29;17;6;5;0;10;1080340;6144;1046;7;3360
FR;4;2022-01-30;18;3;1;0;4;1080358;6147;1047;7;3364
FR;4;2022-01-31;22;27;8;0;31;1080380;6174;1055;7;3395
FR;4;2022-02-01;12;22;12;0;23;1080392;6196;1067;7;3418
FR;4;2022-02-02;18;11;12;2;18;1080410;6207;1079;9;3436
FR;4;2022-02-03;14;23;10;0;27;1080424;6230;1089;9;3463
FR;4;2022-02-04;7;5;7;0;9;1080431;6235;1096;9;3472
FR;4;2022-02-05;7;14;1;0;13;1080438;6249;1097;9;3485
FR;4;2022-02-06;7;4;4;0;7;1080445;6253;1101;9;3492
FR;4;2022-02-07;15;19;8;0;19;1080460;6272;1109;9;3511
FR;4;2022-02-08;19;21;13;1;22;1080479;6293;1122;10;3533
FR;4;2022-02-09;17;11;8;0;15;1080496;6304;1130;10;3548
FR;4;2022-02-10;22;23;9;0;24;1080518;6327;1139;10;3572
FR;4;2022-02-11;18;15;8;0;20;1080536;6342;1147;10;3592
FR;4;2022-02-12;24;6;2;0;6;1080560;6348;1149;10;3598
FR;4;2022-02-13;7;3;3;0;6;1080567;6351;1152;10;3604
FR;4;2022-02-14;20;10;9;0;15;1080587;6361;1161;10;3619
FR;4;2022-02-15;18;7;1;0;7;1080605;6368;1162;10;3626
FR;4;2022-02-16;16;9;11;0;16;1080621;6377;1173;10;3642
FR;4;2022-02-17;11;4;4;0;6;1080632;6381;1177;10;3648
FR;4;2022-02-18;16;15;8;0;21;1080648;6396;1185;10;3669
FR;4;2022-02-19;16;4;2;0;5;1080664;6400;1187;10;3674
FR;4;2022-02-20;7;3;0;0;2;1080671;6403;1187;10;3676
FR;4;2022-02-21;23;4;4;0;6;1080694;6407;1191;10;3682
FR;4;2022-02-22;8;5;10;0;10;1080702;6412;1201;10;3692
FR;4;2022-02-23;16;6;10;0;10;1080718;6418;1211;10;3702
FR;4;2022-02-24;11;5;3;0;6;1080729;6423;1214;10;3708
FR;4;2022-02-25;15;5;7;0;6;1080744;6428;1221;10;3714
FR;4;2022-02-26;27;3;0;0;3;1080771;6431;1221;10;3717
FR;4;2022-02-27;9;0;1;0;1;1080780;6431;1222;10;3718
FR;4;2022-02-28;18;3;2;0;3;1080798;6434;1224;10;3721
FR;4;2022-03-01;8;4;7;0;5;1080806;6438;1231;10;3726
FR;4;2022-03-02;15;3;4;0;6;1080821;6441;1235;10;3732
FR;4;2022-03-03;17;5;3;0;6;1080838;6446;1238;10;3738
FR;4;2022-03-04;7;7;2;1;5;1080845;6453;1240;11;3743
FR;4;2022-03-05;9;2;0;0;2;1080854;6455;1240;11;3745
FR;4;2022-03-06;4;0;1;0;1;1080858;6455;1241;11;3746
FR;4;2022-03-07;10;4;2;0;3;1080868;6459;1243;11;3749
FR;4;2022-03-08;14;3;0;0;3;1080882;6462;1243;11;3752
FR;4;2022-03-09;8;7;2;0;7;1080890;6469;1245;11;3759
FR;4;2022-03-10;5;1;6;0;3;1080895;6470;1251;11;3762
FR;4;2022-03-11;10;4;5;0;2;1080905;6474;1256;11;3764
FR;4;2022-03-12;10;2;0;0;0;1080915;6476;1256;11;3764
FR;4;2022-03-13;6;1;1;0;2;1080921;6477;1257;11;3766
FR;4;2022-03-14;4;2;1;0;3;1080925;6479;1258;11;3769
FR;4;2022-03-15;7;6;3;0;5;1080932;6485;1261;11;3774
FR;4;2022-03-16;7;3;3;0;3;1080939;6488;1264;11;3777
FR;4;2022-03-17;3;4;1;0;5;1080942;6492;1265;11;3782
FR;4;2022-03-18;9;3;0;0;3;1080951;6495;1265;11;3785
FR;4;2022-03-19;1;1;1;0;2;1080952;6496;1266;11;3787
FR;4;2022-03-20;2;0;2;0;1;1080954;6496;1268;11;3788
FR;4;2022-03-21;6;3;1;0;4;1080960;6499;1269;11;3792
FR;4;2022-03-22;4;2;2;0;3;1080964;6501;1271;11;3795
FR;4;2022-03-23;6;4;4;0;7;1080970;6505;1275;11;3802
FR;4;2022-03-24;2;5;3;1;7;1080972;6510;1278;12;3809
FR;4;2022-03-25;3;1;2;0;1;1080975;6511;1280;12;3810
FR;4;2022-03-26;5;5;0;0;5;1080980;6516;1280;12;3815
FR;4;2022-03-27;1;0;3;0;2;1080981;6516;1283;12;3817
FR;4;2022-03-28;5;1;3;0;3;1080986;6517;1286;12;3820
FR;4;2022-03-29;9;0;4;1;0;1080995;6517;1290;13;3820
FR;4;2022-03-30;3;4;0;0;4;1080998;6521;1290;13;3824
FR;4;2022-03-31;2;3;2;1;4;1081000;6524;1292;14;3828
FR;4;2022-04-01;14;2;5;0;5;1081014;6526;1297;14;3833
FR;4;2022-04-02;4;4;0;0;3;1081018;6530;1297;14;3836
FR;4;2022-04-03;0;1;0;0;1;1081018;6531;1297;14;3837
FR;4;2022-04-04;4;4;4;0;5;1081022;6535;1301;14;3842
FR;4;2022-04-05;4;3;2;1;3;1081026;6538;1303;15;3845
FR;4;2022-04-06;6;0;0;0;0;1081032;6538;1303;15;3845
FR;4;2022-04-07;3;2;3;2;5;1081035;6540;1306;17;3850
FR;4;2022-04-08;4;2;1;0;2;1081039;6542;1307;17;3852
FR;4;2022-04-09;0;0;1;1;1;1081039;6542;1308;18;3853
FR;4;2022-04-10;1;2;0;0;2;1081040;6544;1308;18;3855
FR;4;2022-04-11;4;3;4;0;5;1081044;6547;1312;18;3860
FR;4;2022-04-12;5;1;4;0;2;1081049;6548;1316;18;3862
FR;4;2022-04-13;5;7;2;0;9;1081054;6555;1318;18;3871
FR;4;2022-04-14;6;4;2;1;5;1081060;6559;1320;19;3876
FR;4;2022-04-15;5;8;1;0;9;1081065;6567;1321;19;3885
FR;4;2022-04-16;1;0;0;0;0;1081066;6567;1321;19;3885
FR;4;2022-04-17;3;2;1;0;3;1081069;6569;1322;19;3888
FR;4;2022-04-18;2;2;6;0;4;1081071;6571;1328;19;3892
FR;4;2022-04-19;2;0;1;0;0;1081073;6571;1329;19;3892
FR;4;2022-04-20;14;4;1;1;3;1081087;6575;1330;20;3895
FR;4;2022-04-21;7;1;0;0;1;1081094;6576;1330;20;3896
FR;4;2022-04-22;1;1;2;0;2;1081095;6577;1332;20;3898
FR;4;2022-04-23;2;3;3;0;6;1081097;6580;1335;20;3904
FR;4;2022-04-24;0;2;0;0;2;1081097;6582;1335;20;3906
FR;4;2022-04-25;3;4;3;0;7;1081100;6586;1338;20;3913
FR;4;2022-04-26;5;6;1;0;6;1081105;6592;1339;20;3919
FR;4;2022-04-27;4;1;1;1;1;1081109;6593;1340;21;3920
FR;4;2022-04-28;3;5;5;0;6;1081112;6598;1345;21;3926
FR;4;2022-04-29;6;3;0;0;2;1081118;6601;1345;21;3928
FR;4;2022-04-30;2;1;1;0;2;1081120;6602;1346;21;3930
FR;4;2022-05-01;0;0;0;0;0;1081120;6602;1346;21;3930
FR;4;2022-05-02;5;16;6;0;19;1081125;6618;1352;21;3949
FR;4;2022-05-03;2;6;2;0;7;1081127;6624;1354;21;3956
FR;4;2022-05-04;7;4;1;0;4;1081134;6628;1355;21;3960
FR;4;2022-05-05;2;2;1;1;1;1081136;6630;1356;22;3961
FR;4;2022-05-06;5;3;1;0;2;1081141;6633;1357;22;3963
FR;4;2022-05-07;0;0;0;0;0;1081141;6633;1357;22;3963
FR;4;2022-05-08;1;1;0;0;1;1081142;6634;1357;22;3964
FR;4;2022-05-09;5;1;0;0;1;1081147;6635;1357;22;3965
FR;4;2022-05-10;2;1;0;2;3;1081149;6636;1357;24;3968
FR;4;2022-05-11;3;2;3;0;5;1081152;6638;1360;24;3973
FR;4;2022-05-12;6;4;1;1;5;1081158;6642;1361;25;3978
FR;4;2022-05-13;1;0;2;0;2;1081159;6642;1363;25;3980
FR;4;2022-05-14;0;2;0;0;2;1081159;6644;1363;25;3982
FR;4;2022-05-15;2;2;0;0;0;1081161;6646;1363;25;3982
FR;4;2022-05-16;5;2;2;0;2;1081166;6648;1365;25;3984
FR;4;2022-05-17;5;1;2;0;3;1081171;6649;1367;25;3987
FR;4;2022-05-18;3;6;0;0;6;1081174;6655;1367;25;3993
FR;4;2022-05-19;2;3;3;0;5;1081176;6658;1370;25;3998
FR;4;2022-05-20;4;2;3;0;2;1081180;6660;1373;25;4000
FR;4;2022-05-21;2;0;1;0;1;1081182;6660;1374;25;4001
FR;4;2022-05-22;0;0;1;0;1;1081182;6660;1375;25;4002
FR;4;2022-05-23;0;0;2;0;0;1081182;6660;1377;25;4002
FR;4;2022-05-24;2;4;0;0;4;1081184;6664;1377;25;4006
FR;4;2022-05-25;1;3;1;0;2;1081185;6667;1378;25;4008
FR;4;2022-05-26;5;0;1;0;1;1081190;6667;1379;25;4009
FR;4;2022-05-27;0;2;0;1;2;1081190;6669;1379;26;4011
FR;4;2022-05-28;1;0;0;0;0;1081191;6669;1379;26;4011
FR;4;2022-05-29;1;0;1;0;1;1081192;6669;1380;26;4012
FR;4;2022-05-30;2;4;2;0;5;1081194;6673;1382;26;4017
FR;4;2022-05-31;2;1;0;0;1;1081196;6674;1382;26;4018
FR;4;2022-06-01;3;11;7;0;15;1081199;6685;1389;26;4033
FR;4;2022-06-02;5;6;3;0;7;1081204;6691;1392;26;4040
FR;4;2022-06-03;2;5;4;1;6;1081206;6696;1396;27;4046
FR;4;2022-06-04;0;1;1;0;1;1081206;6697;1397;27;4047
FR;4;2022-06-05;0;0;0;0;0;1081206;6697;1397;27;4047
FR;4;2022-06-06;6;0;3;0;2;1081212;6697;1400;27;4049
FR;4;2022-06-07;5;2;0;1;2;1081217;6699;1400;28;4051
FR;4;2022-06-08;0;3;3;0;6;1081217;6702;1403;28;4057
FR;4;2022-06-09;1;2;0;0;1;1081218;6704;1403;28;4058
FR;4;2022-06-10;3;0;3;0;1;1081221;6704;1406;28;4059
FR;4;2022-06-11;1;0;0;0;0;1081222;6704;1406;28;4059
FR;4;2022-06-12;4;0;0;0;0;1081226;6704;1406;28;4059
FR;4;2022-06-13;5;2;3;0;2;1081231;6706;1409;28;4061
FR;4;2022-06-14;4;3;0;0;2;1081235;6709;1409;28;4063
FR;4;2022-06-15;8;3;4;0;3;1081243;6712;1413;28;4066
FR;4;2022-06-16;1;3;1;1;2;1081244;6715;1414;29;4068
FR;4;2022-06-17;6;1;0;0;1;1081250;6716;1414;29;4069
FR;4;2022-06-18;0;0;0;0;0;1081250;6716;1414;29;4069
FR;4;2022-06-19;0;0;0;0;0;1081250;6716;1414;29;4069
FR;4;2022-06-20;4;2;2;1;3;1081254;6718;1416;30;4072
FR;4;2022-06-21;5;2;3;1;3;1081259;6720;1419;31;4075
FR;4;2022-06-22;3;1;0;3;1;1081262;6721;1419;34;4076
FR;4;2022-06-23;3;3;3;0;5;1081265;6724;1422;34;4081
FR;4;2022-06-24;3;0;2;0;0;1081268;6724;1424;34;4081
FR;4;2022-06-25;1;0;1;1;1;1081269;6724;1425;35;4082
FR;4;2022-06-26;0;0;1;0;1;1081269;6724;1426;35;4083
FR;4;2022-06-27;2;2;0;3;2;1081271;6726;1426;38;4085
FR;4;2022-06-28;0;4;2;1;5;1081271;6730;1428;39;4090
FR;4;2022-06-29;1;2;0;0;2;1081272;6732;1428;39;4092
FR;4;2022-06-30;2;0;0;0;0;1081274;6732;1428;39;4092
FR;4;2022-07-01;2;4;8;0;4;1081276;6736;1436;39;4096
FR;4;2022-07-02;0;1;0;0;0;1081276;6737;1436;39;4096
FR;4;2022-07-03;0;0;0;0;0;1081276;6737;1436;39;4096
FR;4;2022-07-04;3;1;0;0;1;1081279;6738;1436;39;4097
FR;4;2022-07-05;2;0;2;0;2;1081281;6738;1438;39;4099
FR;4;2022-07-06;5;0;1;1;0;1081286;6738;1439;40;4099
FR;4;2022-07-07;1;0;2;1;0;1081287;6738;1441;41;4099
FR;4;2022-07-08;3;1;0;0;1;1081290;6739;1441;41;4100
FR;4;2022-07-09;2;2;1;0;3;1081292;6741;1442;41;4103
FR;4;2022-07-10;2;0;1;0;0;1081294;6741;1443;41;4103
FR;4;2022-07-11;2;0;2;0;0;1081296;6741;1445;41;4103
FR;4;2022-07-12;0;0;2;0;2;1081296;6741;1447;41;4105
FR;4;2022-07-13;2;2;3;0;2;1081298;6743;1450;41;4107
FR;4;2022-07-14;4;0;1;0;0;1081302;6743;1451;41;4107
FR;4;2022-07-15;8;2;0;0;2;1081310;6745;1451;41;4109
FR;4;2022-07-16;4;0;0;2;0;1081314;6745;1451;43;4109
FR;4;2022-07-17;0;0;0;0;0;1081314;6745;1451;43;4109
FR;4;2022-07-18;3;2;2;0;2;1081317;6747;1453;43;4111
FR;4;2022-07-19;4;0;1;0;1;1081321;6747;1454;43;4112
FR;4;2022-07-20;10;0;0;0;0;1081331;6747;1454;43;4112
FR;4;2022-07-21;2;1;1;0;1;1081333;6748;1455;43;4113
FR;4;2022-07-22;4;0;3;0;1;1081337;6748;1458;43;4114
FR;4;2022-07-23;1;2;0;0;1;1081338;6750;1458;43;4115
FR;4;2022-07-24;0;0;0;0;0;1081338;6750;1458;43;4115
FR;4;2022-07-25;5;0;2;0;2;1081343;6750;1460;43;4117
FR;4;2022-07-26;2;0;0;0;0;1081345;6750;1460;43;4117
FR;4;2022-07-27;2;1;0;0;0;1081347;6751;1460;43;4117
FR;4;2022-07-28;10;0;0;0;0;1081357;6751;1460;43;4117
FR;4;2022-07-29;3;0;1;0;0;1081360;6751;1461;43;4117
FR;4;2022-07-30;3;0;2;0;0;1081363;6751;1463;43;4117
FR;4;2022-07-31;0;0;0;0;0;1081363;6751;1463;43;4117
FR;4;2022-08-01;1;0;2;0;1;1081364;6751;1465;43;4118
FR;4;2022-08-02;6;0;0;0;0;1081370;6751;1465;43;4118
FR;4;2022-08-03;0;2;1;0;2;1081370;6753;1466;43;4120
FR;4;2022-08-04;3;2;0;1;2;1081373;6755;1466;44;4122
FR;4;2022-08-05;2;0;1;0;0;1081375;6755;1467;44;4122
FR;4;2022-08-06;2;0;0;0;0;1081377;6755;1467;44;4122
FR;4;2022-08-07;3;0;0;0;0;1081380;6755;1467;44;4122
FR;4;2022-08-08;1;0;1;1;1;1081381;6755;1468;45;4123
FR;4;2022-08-09;1;1;1;2;2;1081382;6756;1469;47;4125
FR;4;2022-08-10;5;1;1;0;1;1081387;6757;1470;47;4126
FR;4;2022-08-11;2;0;1;0;1;1081389;6757;1471;47;4127
FR;4;2022-08-12;4;0;1;0;0;1081393;6757;1472;47;4127
FR;4;2022-08-13;1;0;0;0;0;1081394;6757;1472;47;4127
FR;4;2022-08-14;0;0;0;0;0;1081394;6757;1472;47;4127
FR;4;2022-08-15;1;1;3;0;1;1081395;6758;1475;47;4128
FR;4;2022-08-16;0;0;1;0;1;1081395;6758;1476;47;4129
FR;4;2022-08-17;2;0;0;0;0;1081397;6758;1476;47;4129
FR;4;2022-08-18;0;0;0;0;0;1081397;6758;1476;47;4129
FR;4;2022-08-19;5;0;0;0;0;1081402;6758;1476;47;4129
FR;4;2022-08-20;1;0;0;0;0;1081403;6758;1476;47;4129
FR;4;2022-08-21;1;0;0;0;0;1081404;6758;1476;47;4129
FR;4;2022-08-22;3;9;0;0;9;1081407;6767;1476;47;4138
FR;4;2022-08-23;1;3;3;0;4;1081408;6770;1479;47;4142
FR;4;2022-08-24;3;0;0;1;0;1081411;6770;1479;48;4142
FR;4;2022-08-25;0;3;1;0;3;1081411;6773;1480;48;4145
FR;4;2022-08-26;1;0;0;1;0;1081412;6773;1480;49;4145
FR;4;2022-08-27;1;0;0;0;0;1081413;6773;1480;49;4145
FR;4;2022-08-28;0;0;0;0;0;1081413;6773;1480;49;4145
FR;4;2022-08-29;6;0;0;0;0;1081419;6773;1480;49;4145
FR;4;2022-08-30;4;0;0;0;0;1081423;6773;1480;49;4145
FR;4;2022-08-31;1;1;0;0;1;1081424;6774;1480;49;4146
FR;4;2022-09-01;1;7;2;0;6;1081425;6781;1482;49;4152
FR;4;2022-09-02;1;1;1;0;2;1081426;6782;1483;49;4154
FR;4;2022-09-03;2;0;0;0;0;1081428;6782;1483;49;4154
FR;4;2022-09-04;0;0;0;0;0;1081428;6782;1483;49;4154
FR;4;2022-09-05;2;2;0;0;2;1081430;6784;1483;49;4156
FR;4;2022-09-06;0;0;0;0;0;1081430;6784;1483;49;4156
FR;4;2022-09-07;0;0;1;1;1;1081430;6784;1484;50;4157
FR;4;2022-09-08;3;0;0;0;0;1081433;6784;1484;50;4157
FR;4;2022-09-09;2;0;0;0;0;1081435;6784;1484;50;4157
FR;4;2022-09-10;0;0;0;3;1;1081435;6784;1484;53;4158
FR;4;2022-09-11;2;0;0;0;0;1081437;6784;1484;53;4158
FR;4;2022-09-12;0;1;1;0;1;1081437;6785;1485;53;4159
FR;4;2022-09-13;1;0;0;0;0;1081438;6785;1485;53;4159
FR;4;2022-09-14;0;0;0;0;0;1081438;6785;1485;53;4159
FR;4;2022-09-15;2;0;0;0;0;1081440;6785;1485;53;4159
FR;4;2022-09-16;0;0;0;0;0;1081440;6785;1485;53;4159
FR;4;2022-09-17;2;0;0;0;0;1081442;6785;1485;53;4159
FR;4;2022-09-18;0;0;0;0;0;1081442;6785;1485;53;4159
FR;4;2022-09-19;2;0;2;0;2;1081444;6785;1487;53;4161
FR;4;2022-09-20;1;0;0;0;0;1081445;6785;1487;53;4161
FR;4;2022-09-21;2;0;0;0;0;1081447;6785;1487;53;4161
FR;4;2022-09-22;1;0;0;0;0;1081448;6785;1487;53;4161
FR;4;2022-09-23;2;3;0;0;2;1081450;6788;1487;53;4163
FR;4;2022-09-24;1;0;0;0;0;1081451;6788;1487;53;4163
FR;4;2022-09-25;0;0;0;0;0;1081451;6788;1487;53;4163
FR;4;2022-09-26;2;0;1;0;0;1081453;6788;1488;53;4163
FR;4;2022-09-27;0;0;0;1;0;1081453;6788;1488;54;4163
FR;4;2022-09-28;3;0;0;0;0;1081456;6788;1488;54;4163
FR;4;2022-09-29;2;0;0;1;0;1081458;6788;1488;55;4163
FR;4;2022-09-30;1;0;0;0;0;1081459;6788;1488;55;4163
FR;4;2022-10-01;0;1;0;0;0;1081459;6789;1488;55;4163
FR;4;2022-10-02;0;0;0;0;0;1081459;6789;1488;55;4163
FR;4;2022-10-03;2;1;0;0;0;1081461;6790;1488;55;4163
FR;4;2022-10-04;2;0;0;0;0;1081463;6790;1488;55;4163
FR;4;2022-10-05;0;1;0;0;1;1081463;6791;1488;55;4164
FR;4;2022-10-06;1;0;0;0;0;1081464;6791;1488;55;4164
FR;4;2022-10-07;3;0;1;0;0;1081467;6791;1489;55;4164
FR;4;2022-10-08;3;1;0;0;0;1081470;6792;1489;55;4164
FR;4;2022-10-09;0;0;0;0;0;1081470;6792;1489;55;4164
FR;4;2022-10-10;1;0;0;1;0;1081471;6792;1489;56;4164
FR;4;2022-10-11;1;2;0;0;1;1081472;6794;1489;56;4165
FR;4;2022-10-12;0;0;0;0;0;1081472;6794;1489;56;4165
FR;4;2022-10-13;5;0;0;0;0;1081477;6794;1489;56;4165
FR;4;2022-10-14;0;0;0;0;0;1081477;6794;1489;56;4165
FR;4;2022-10-15;0;0;0;0;0;1081477;6794;1489;56;4165
FR;4;2022-10-16;0;0;0;0;0;1081477;6794;1489;56;4165
FR;4;2022-10-17;2;0;1;0;1;1081479;6794;1490;56;4166
FR;4;2022-10-18;1;0;0;1;0;1081480;6794;1490;57;4166
FR;4;2022-10-19;1;0;0;2;0;1081481;6794;1490;59;4166
FR;4;2022-10-20;2;0;0;0;0;1081483;6794;1490;59;4166
FR;4;2022-10-21;0;0;0;0;0;1081483;6794;1490;59;4166
FR;4;2022-10-22;1;0;0;0;0;1081484;6794;1490;59;4166
FR;4;2022-10-23;0;0;0;0;0;1081484;6794;1490;59;4166
FR;4;2022-10-24;0;0;0;0;0;1081484;6794;1490;59;4166
FR;4;2022-10-25;1;0;0;0;0;1081485;6794;1490;59;4166
FR;4;2022-10-26;2;1;0;0;1;1081487;6795;1490;59;4167
FR;5;2020-12-27;0;0;0;0;0;0;0;0;0;0
FR;5;2020-12-28;0;0;0;0;0;0;0;0;0;0
FR;5;2020-12-29;0;0;0;0;0;0;0;0;0;0
FR;5;2020-12-30;0;0;0;0;0;0;0;0;0;0
FR;5;2020-12-31;0;0;0;0;0;0;0;0;0;0
FR;5;2021-01-01;0;0;0;0;0;0;0;0;0;0
FR;5;2021-01-02;0;0;0;0;0;0;0;0;0;0
FR;5;2021-01-03;0;0;0;0;0;0;0;0;0;0
FR;5;2021-01-04;0;0;0;0;0;0;0;0;0;0
FR;5;2021-01-05;0;0;0;0;0;0;0;0;0;0
FR;5;2021-01-06;0;0;0;0;0;0;0;0;0;0
FR;5;2021-01-07;0;0;0;0;0;0;0;0;0;0
FR;5;2021-01-08;0;0;0;0;0;0;0;0;0;0
FR;5;2021-01-09;0;0;0;0;0;0;0;0;0;0
FR;5;2021-01-10;0;0;0;0;0;0;0;0;0;0
FR;5;2021-01-11;0;0;0;0;0;0;0;0;0;0
FR;5;2021-01-12;0;0;0;0;0;0;0;0;0;0
FR;5;2021-01-13;0;0;0;0;0;0;0;0;0;0
FR;5;2021-01-14;0;0;0;0;0;0;0;0;0;0
FR;5;2021-01-15;0;0;0;0;0;0;0;0;0;0
FR;5;2021-01-16;0;0;0;0;0;0;0;0;0;0
FR;5;2021-01-17;0;0;0;0;0;0;0;0;0;0
FR;5;2021-01-18;0;0;0;0;0;0;0;0;0;0
FR;5;2021-01-19;0;0;0;0;0;0;0;0;0;0
FR;5;2021-01-20;0;0;0;0;0;0;0;0;0;0
FR;5;2021-01-21;0;0;0;0;0;0;0;0;0;0
FR;5;2021-01-22;0;0;0;0;0;0;0;0;0;0
FR;5;2021-01-23;0;0;0;0;0;0;0;0;0;0
FR;5;2021-01-24;0;0;0;0;0;0;0;0;0;0
FR;5;2021-01-25;0;0;0;0;0;0;0;0;0;0
FR;5;2021-01-26;0;0;0;0;0;0;0;0;0;0
FR;5;2021-01-27;0;0;0;0;0;0;0;0;0;0
FR;5;2021-01-28;0;0;0;0;0;0;0;0;0;0
FR;5;2021-01-29;0;0;0;0;0;0;0;0;0;0
FR;5;2021-01-30;0;0;0;0;0;0;0;0;0;0
FR;5;2021-01-31;0;0;0;0;0;0;0;0;0;0
FR;5;2021-02-01;0;0;0;0;0;0;0;0;0;0
FR;5;2021-02-02;0;0;0;0;0;0;0;0;0;0
FR;5;2021-02-03;0;0;0;0;0;0;0;0;0;0
FR;5;2021-02-04;0;0;0;0;0;0;0;0;0;0
FR;5;2021-02-05;0;0;0;0;0;0;0;0;0;0
FR;5;2021-02-06;0;0;0;0;0;0;0;0;0;0
FR;5;2021-02-07;0;0;0;0;0;0;0;0;0;0
FR;5;2021-02-08;0;0;0;0;0;0;0;0;0;0
FR;5;2021-02-09;0;0;0;0;0;0;0;0;0;0
FR;5;2021-02-10;0;0;0;0;0;0;0;0;0;0
FR;5;2021-02-11;0;0;0;0;0;0;0;0;0;0
FR;5;2021-02-12;0;0;0;0;0;0;0;0;0;0
FR;5;2021-02-13;0;0;0;0;0;0;0;0;0;0
FR;5;2021-02-14;0;0;0;0;0;0;0;0;0;0
FR;5;2021-02-15;0;0;0;0;0;0;0;0;0;0
FR;5;2021-02-16;0;0;0;0;0;0;0;0;0;0
FR;5;2021-02-17;0;0;0;0;0;0;0;0;0;0
FR;5;2021-02-18;0;0;0;0;0;0;0;0;0;0
FR;5;2021-02-19;0;0;0;0;0;0;0;0;0;0
FR;5;2021-02-20;0;0;0;0;0;0;0;0;0;0
FR;5;2021-02-21;0;0;0;0;0;0;0;0;0;0
FR;5;2021-02-22;0;0;0;0;0;0;0;0;0;0
FR;5;2021-02-23;0;0;0;0;0;0;0;0;0;0
FR;5;2021-02-24;0;0;0;0;0;0;0;0;0;0
FR;5;2021-02-25;0;0;0;0;0;0;0;0;0;0
FR;5;2021-02-26;0;0;0;0;0;0;0;0;0;0
FR;5;2021-02-27;0;0;0;0;0;0;0;0;0;0
FR;5;2021-02-28;0;0;0;0;0;0;0;0;0;0
FR;5;2021-03-01;0;0;0;0;0;0;0;0;0;0
FR;5;2021-03-02;0;0;0;0;0;0;0;0;0;0
FR;5;2021-03-03;0;0;0;0;0;0;0;0;0;0
FR;5;2021-03-04;0;0;0;0;0;0;0;0;0;0
FR;5;2021-03-05;0;0;0;0;0;0;0;0;0;0
FR;5;2021-03-06;0;0;0;0;0;0;0;0;0;0
FR;5;2021-03-07;0;0;0;0;0;0;0;0;0;0
FR;5;2021-03-08;0;0;0;0;0;0;0;0;0;0
FR;5;2021-03-09;0;0;0;0;0;0;0;0;0;0
FR;5;2021-03-10;0;0;0;0;0;0;0;0;0;0
FR;5;2021-03-11;0;0;0;0;0;0;0;0;0;0
FR;5;2021-03-12;0;0;0;0;0;0;0;0;0;0
FR;5;2021-03-13;0;0;0;0;0;0;0;0;0;0
FR;5;2021-03-14;0;0;0;0;0;0;0;0;0;0
FR;5;2021-03-15;0;0;0;0;0;0;0;0;0;0
FR;5;2021-03-16;0;0;0;0;0;0;0;0;0;0
FR;5;2021-03-17;0;0;0;0;0;0;0;0;0;0
FR;5;2021-03-18;0;0;0;0;0;0;0;0;0;0
FR;5;2021-03-19;0;0;0;0;0;0;0;0;0;0
FR;5;2021-03-20;0;0;0;0;0;0;0;0;0;0
FR;5;2021-03-21;0;0;0;0;0;0;0;0;0;0
FR;5;2021-03-22;0;0;0;0;0;0;0;0;0;0
FR;5;2021-03-23;0;0;0;0;0;0;0;0;0;0
FR;5;2021-03-24;0;0;0;0;0;0;0;0;0;0
FR;5;2021-03-25;0;0;0;0;0;0;0;0;0;0
FR;5;2021-03-26;0;0;0;0;0;0;0;0;0;0
FR;5;2021-03-27;0;0;0;0;0;0;0;0;0;0
FR;5;2021-03-28;0;0;0;0;0;0;0;0;0;0
FR;5;2021-03-29;0;0;0;0;0;0;0;0;0;0
FR;5;2021-03-30;0;0;0;0;0;0;0;0;0;0
FR;5;2021-03-31;0;0;0;0;0;0;0;0;0;0
FR;5;2021-04-01;0;0;0;0;0;0;0;0;0;0
FR;5;2021-04-02;0;0;0;0;0;0;0;0;0;0
FR;5;2021-04-03;0;0;0;0;0;0;0;0;0;0
FR;5;2021-04-04;0;0;0;0;0;0;0;0;0;0
FR;5;2021-04-05;0;0;0;0;0;0;0;0;0;0
FR;5;2021-04-06;0;0;0;0;0;0;0;0;0;0
FR;5;2021-04-07;0;0;0;0;0;0;0;0;0;0
FR;5;2021-04-08;0;0;0;0;0;0;0;0;0;0
FR;5;2021-04-09;0;0;0;0;0;0;0;0;0;0
FR;5;2021-04-10;0;0;0;0;0;0;0;0;0;0
FR;5;2021-04-11;0;0;0;0;0;0;0;0;0;0
FR;5;2021-04-12;0;0;0;0;0;0;0;0;0;0
FR;5;2021-04-13;0;0;0;0;0;0;0;0;0;0
FR;5;2021-04-14;0;0;0;0;0;0;0;0;0;0
FR;5;2021-04-15;0;0;0;0;0;0;0;0;0;0
FR;5;2021-04-16;0;0;0;0;0;0;0;0;0;0
FR;5;2021-04-17;0;0;0;0;0;0;0;0;0;0
FR;5;2021-04-18;0;0;0;0;0;0;0;0;0;0
FR;5;2021-04-19;0;0;0;0;0;0;0;0;0;0
FR;5;2021-04-20;0;0;0;0;0;0;0;0;0;0
FR;5;2021-04-21;0;0;0;0;0;0;0;0;0;0
FR;5;2021-04-22;0;0;0;0;0;0;0;0;0;0
FR;5;2021-04-23;0;0;0;0;0;0;0;0;0;0
FR;5;2021-04-24;0;0;0;0;0;0;0;0;0;0
FR;5;2021-04-25;0;0;0;0;0;0;0;0;0;0
FR;5;2021-04-26;0;0;0;0;0;0;0;0;0;0
FR;5;2021-04-27;0;0;0;0;0;0;0;0;0;0
FR;5;2021-04-28;0;0;0;0;0;0;0;0;0;0
FR;5;2021-04-29;0;0;0;0;0;0;0;0;0;0
FR;5;2021-04-30;0;0;0;0;0;0;0;0;0;0
FR;5;2021-05-01;0;0;0;0;0;0;0;0;0;0
FR;5;2021-05-02;0;0;0;0;0;0;0;0;0;0
FR;5;2021-05-03;0;0;0;0;0;0;0;0;0;0
FR;5;2021-05-04;0;0;0;0;0;0;0;0;0;0
FR;5;2021-05-05;0;0;0;0;0;0;0;0;0;0
FR;5;2021-05-06;0;0;0;0;0;0;0;0;0;0
FR;5;2021-05-07;0;0;0;0;0;0;0;0;0;0
FR;5;2021-05-08;0;0;0;0;0;0;0;0;0;0
FR;5;2021-05-09;0;0;0;0;0;0;0;0;0;0
FR;5;2021-05-10;0;0;0;0;0;0;0;0;0;0
FR;5;2021-05-11;0;0;0;0;0;0;0;0;0;0
FR;5;2021-05-12;0;0;0;0;0;0;0;0;0;0
FR;5;2021-05-13;0;0;0;0;0;0;0;0;0;0
FR;5;2021-05-14;0;0;0;0;0;0;0;0;0;0
FR;5;2021-05-15;0;0;0;0;0;0;0;0;0;0
FR;5;2021-05-16;0;0;0;0;0;0;0;0;0;0
FR;5;2021-05-17;0;0;0;0;0;0;0;0;0;0
FR;5;2021-05-18;0;0;0;0;0;0;0;0;0;0
FR;5;2021-05-19;0;0;0;0;0;0;0;0;0;0
FR;5;2021-05-20;0;0;0;0;0;0;0;0;0;0
FR;5;2021-05-21;0;0;0;0;0;0;0;0;0;0
FR;5;2021-05-22;0;0;0;0;0;0;0;0;0;0
FR;5;2021-05-23;0;0;0;0;0;0;0;0;0;0
FR;5;2021-05-24;0;0;0;0;0;0;0;0;0;0
FR;5;2021-05-25;0;0;0;0;0;0;0;0;0;0
FR;5;2021-05-26;0;0;0;0;0;0;0;0;0;0
FR;5;2021-05-27;0;0;0;0;0;0;0;0;0;0
FR;5;2021-05-28;0;0;0;0;0;0;0;0;0;0
FR;5;2021-05-29;0;0;0;0;0;0;0;0;0;0
FR;5;2021-05-30;0;0;0;0;0;0;0;0;0;0
FR;5;2021-05-31;0;0;0;0;0;0;0;0;0;0
FR;5;2021-06-01;0;0;0;0;0;0;0;0;0;0
FR;5;2021-06-02;0;0;0;0;0;0;0;0;0;0
FR;5;2021-06-03;0;0;0;0;0;0;0;0;0;0
FR;5;2021-06-04;0;0;0;0;0;0;0;0;0;0
FR;5;2021-06-05;0;0;0;0;0;0;0;0;0;0
FR;5;2021-06-06;0;0;0;0;0;0;0;0;0;0
FR;5;2021-06-07;0;0;0;0;0;0;0;0;0;0
FR;5;2021-06-08;0;0;0;0;0;0;0;0;0;0
FR;5;2021-06-09;0;0;0;0;0;0;0;0;0;0
FR;5;2021-06-10;0;0;0;0;0;0;0;0;0;0
FR;5;2021-06-11;0;0;0;0;0;0;0;0;0;0
FR;5;2021-06-12;0;0;0;0;0;0;0;0;0;0
FR;5;2021-06-13;0;0;0;0;0;0;0;0;0;0
FR;5;2021-06-14;0;0;0;0;0;0;0;0;0;0
FR;5;2021-06-15;0;0;0;0;0;0;0;0;0;0
FR;5;2021-06-16;0;0;0;0;0;0;0;0;0;0
FR;5;2021-06-17;0;0;0;0;0;0;0;0;0;0
FR;5;2021-06-18;0;0;0;0;0;0;0;0;0;0
FR;5;2021-06-19;0;0;0;0;0;0;0;0;0;0
FR;5;2021-06-20;0;0;0;0;0;0;0;0;0;0
FR;5;2021-06-21;0;0;0;0;0;0;0;0;0;0
FR;5;2021-06-22;0;0;0;0;0;0;0;0;0;0
FR;5;2021-06-23;0;0;0;0;0;0;0;0;0;0
FR;5;2021-06-24;0;0;0;0;0;0;0;0;0;0
FR;5;2021-06-25;0;0;0;0;0;0;0;0;0;0
FR;5;2021-06-26;0;0;0;0;0;0;0;0;0;0
FR;5;2021-06-27;0;0;0;0;0;0;0;0;0;0
FR;5;2021-06-28;0;0;0;0;0;0;0;0;0;0
FR;5;2021-06-29;0;0;0;0;0;0;0;0;0;0
FR;5;2021-06-30;0;0;0;0;0;0;0;0;0;0
FR;5;2021-07-01;0;0;0;0;0;0;0;0;0;0
FR;5;2021-07-02;0;0;0;0;0;0;0;0;0;0
FR;5;2021-07-03;0;0;0;0;0;0;0;0;0;0
FR;5;2021-07-04;0;0;0;0;0;0;0;0;0;0
FR;5;2021-07-05;0;0;0;0;0;0;0;0;0;0
FR;5;2021-07-06;0;0;0;0;0;0;0;0;0;0
FR;5;2021-07-07;0;0;0;0;0;0;0;0;0;0
FR;5;2021-07-08;0;0;0;0;0;0;0;0;0;0
FR;5;2021-07-09;0;0;0;0;0;0;0;0;0;0
FR;5;2021-07-10;0;0;0;0;0;0;0;0;0;0
FR;5;2021-07-11;0;0;0;0;0;0;0;0;0;0
FR;5;2021-07-12;0;0;0;0;0;0;0;0;0;0
FR;5;2021-07-13;0;0;0;0;0;0;0;0;0;0
FR;5;2021-07-14;0;0;0;0;0;0;0;0;0;0
FR;5;2021-07-15;0;0;0;0;0;0;0;0;0;0
FR;5;2021-07-16;0;0;0;0;0;0;0;0;0;0
FR;5;2021-07-17;0;0;0;0;0;0;0;0;0;0
FR;5;2021-07-18;0;0;0;0;0;0;0;0;0;0
FR;5;2021-07-19;0;0;0;0;0;0;0;0;0;0
FR;5;2021-07-20;0;0;0;0;0;0;0;0;0;0
FR;5;2021-07-21;0;0;0;0;0;0;0;0;0;0
FR;5;2021-07-22;0;0;0;0;0;0;0;0;0;0
FR;5;2021-07-23;0;0;0;0;0;0;0;0;0;0
FR;5;2021-07-24;0;0;0;0;0;0;0;0;0;0
FR;5;2021-07-25;0;0;0;0;0;0;0;0;0;0
FR;5;2021-07-26;0;0;0;0;0;0;0;0;0;0
FR;5;2021-07-27;0;0;0;0;0;0;0;0;0;0
FR;5;2021-07-28;0;0;0;0;0;0;0;0;0;0
FR;5;2021-07-29;0;0;0;0;0;0;0;0;0;0
FR;5;2021-07-30;0;0;0;0;0;0;0;0;0;0
FR;5;2021-07-31;0;0;0;0;0;0;0;0;0;0
FR;5;2021-08-01;0;0;0;0;0;0;0;0;0;0
FR;5;2021-08-02;0;0;0;0;0;0;0;0;0;0
FR;5;2021-08-03;0;0;0;0;0;0;0;0;0;0
FR;5;2021-08-04;0;0;0;0;0;0;0;0;0;0
FR;5;2021-08-05;0;0;0;0;0;0;0;0;0;0
FR;5;2021-08-06;0;0;0;0;0;0;0;0;0;0
FR;5;2021-08-07;0;0;0;0;0;0;0;0;0;0
FR;5;2021-08-08;0;0;0;0;0;0;0;0;0;0
FR;5;2021-08-09;0;0;0;0;0;0;0;0;0;0
FR;5;2021-08-10;0;0;0;0;0;0;0;0;0;0
FR;5;2021-08-11;0;0;0;0;0;0;0;0;0;0
FR;5;2021-08-12;0;0;0;0;0;0;0;0;0;0
FR;5;2021-08-13;0;0;0;0;0;0;0;0;0;0
FR;5;2021-08-14;0;0;0;0;0;0;0;0;0;0
FR;5;2021-08-15;0;0;0;0;0;0;0;0;0;0
FR;5;2021-08-16;0;0;0;0;0;0;0;0;0;0
FR;5;2021-08-17;0;0;0;0;0;0;0;0;0;0
FR;5;2021-08-18;0;0;0;0;0;0;0;0;0;0
FR;5;2021-08-19;0;0;0;0;0;0;0;0;0;0
FR;5;2021-08-20;0;0;0;0;0;0;0;0;0;0
FR;5;2021-08-21;0;0;0;0;0;0;0;0;0;0
FR;5;2021-08-22;0;0;0;0;0;0;0;0;0;0
FR;5;2021-08-23;0;0;0;0;0;0;0;0;0;0
FR;5;2021-08-24;0;0;0;0;0;0;0;0;0;0
FR;5;2021-08-25;0;0;0;0;0;0;0;0;0;0
FR;5;2021-08-26;0;0;0;0;0;0;0;0;0;0
FR;5;2021-08-27;0;0;0;0;0;0;0;0;0;0
FR;5;2021-08-28;0;0;0;0;0;0;0;0;0;0
FR;5;2021-08-29;0;0;0;0;0;0;0;0;0;0
FR;5;2021-08-30;0;0;0;0;0;0;0;0;0;0
FR;5;2021-08-31;0;0;0;0;0;0;0;0;0;0
FR;5;2021-09-01;0;0;0;0;0;0;0;0;0;0
FR;5;2021-09-02;0;0;0;0;0;0;0;0;0;0
FR;5;2021-09-03;0;0;0;0;0;0;0;0;0;0
FR;5;2021-09-04;0;0;0;0;0;0;0;0;0;0
FR;5;2021-09-05;0;0;0;0;0;0;0;0;0;0
FR;5;2021-09-06;0;0;0;0;0;0;0;0;0;0
FR;5;2021-09-07;0;0;0;0;0;0;0;0;0;0
FR;5;2021-09-08;0;0;0;0;0;0;0;0;0;0
FR;5;2021-09-09;0;0;0;0;0;0;0;0;0;0
FR;5;2021-09-10;0;0;0;0;0;0;0;0;0;0
FR;5;2021-09-11;0;0;0;0;0;0;0;0;0;0
FR;5;2021-09-12;0;0;0;0;0;0;0;0;0;0
FR;5;2021-09-13;0;0;0;0;0;0;0;0;0;0
FR;5;2021-09-14;0;0;0;0;0;0;0;0;0;0
FR;5;2021-09-15;0;0;0;0;0;0;0;0;0;0
FR;5;2021-09-16;0;0;0;0;0;0;0;0;0;0
FR;5;2021-09-17;0;0;0;0;0;0;0;0;0;0
FR;5;2021-09-18;0;0;0;0;0;0;0;0;0;0
FR;5;2021-09-19;0;0;0;0;0;0;0;0;0;0
FR;5;2021-09-20;0;0;0;0;0;0;0;0;0;0
FR;5;2021-09-21;0;0;0;0;0;0;0;0;0;0
FR;5;2021-09-22;0;0;0;0;0;0;0;0;0;0
FR;5;2021-09-23;0;0;0;0;0;0;0;0;0;0
FR;5;2021-09-24;0;0;0;0;0;0;0;0;0;0
FR;5;2021-09-25;0;0;0;0;0;0;0;0;0;0
FR;5;2021-09-26;0;0;0;0;0;0;0;0;0;0
FR;5;2021-09-27;0;0;0;0;0;0;0;0;0;0
FR;5;2021-09-28;0;0;0;0;0;0;0;0;0;0
FR;5;2021-09-29;0;0;0;0;0;0;0;0;0;0
FR;5;2021-09-30;0;0;0;0;0;0;0;0;0;0
FR;5;2021-10-01;0;0;0;0;0;0;0;0;0;0
FR;5;2021-10-02;0;0;0;0;0;0;0;0;0;0
FR;5;2021-10-03;0;0;0;0;0;0;0;0;0;0
FR;5;2021-10-04;0;0;0;0;0;0;0;0;0;0
FR;5;2021-10-05;0;0;0;0;0;0;0;0;0;0
FR;5;2021-10-06;0;0;0;0;0;0;0;0;0;0
FR;5;2021-10-07;0;0;0;0;0;0;0;0;0;0
FR;5;2021-10-08;0;0;0;0;0;0;0;0;0;0
FR;5;2021-10-09;0;0;0;0;0;0;0;0;0;0
FR;5;2021-10-10;0;0;0;0;0;0;0;0;0;0
FR;5;2021-10-11;0;0;0;0;0;0;0;0;0;0
FR;5;2021-10-12;0;0;0;0;0;0;0;0;0;0
FR;5;2021-10-13;0;0;0;0;0;0;0;0;0;0
FR;5;2021-10-14;0;0;0;0;0;0;0;0;0;0
FR;5;2021-10-15;0;0;0;0;0;0;0;0;0;0
FR;5;2021-10-16;0;0;0;0;0;0;0;0;0;0
FR;5;2021-10-17;0;0;0;0;0;0;0;0;0;0
FR;5;2021-10-18;0;0;0;0;0;0;0;0;0;0
FR;5;2021-10-19;0;0;0;0;0;0;0;0;0;0
FR;5;2021-10-20;0;0;0;0;0;0;0;0;0;0
FR;5;2021-10-21;0;0;0;0;0;0;0;0;0;0
FR;5;2021-10-22;0;0;0;0;0;0;0;0;0;0
FR;5;2021-10-23;0;0;0;0;0;0;0;0;0;0
FR;5;2021-10-24;0;0;0;0;0;0;0;0;0;0
FR;5;2021-10-25;0;0;0;0;0;0;0;0;0;0
FR;5;2021-10-26;0;0;0;0;0;0;0;0;0;0
FR;5;2021-10-27;0;0;0;0;0;0;0;0;0;0
FR;5;2021-10-28;0;0;0;0;0;0;0;0;0;0
FR;5;2021-10-29;0;0;0;0;0;0;0;0;0;0
FR;5;2021-10-30;0;0;0;0;0;0;0;0;0;0
FR;5;2021-10-31;0;0;0;0;0;0;0;0;0;0
FR;5;2021-11-01;0;0;0;0;0;0;0;0;0;0
FR;5;2021-11-02;0;0;0;0;0;0;0;0;0;0
FR;5;2021-11-03;0;0;0;0;0;0;0;0;0;0
FR;5;2021-11-04;0;0;0;0;0;0;0;0;0;0
FR;5;2021-11-05;0;0;0;0;0;0;0;0;0;0
FR;5;2021-11-06;0;0;0;0;0;0;0;0;0;0
FR;5;2021-11-07;0;0;0;0;0;0;0;0;0;0
FR;5;2021-11-08;0;0;0;0;0;0;0;0;0;0
FR;5;2021-11-09;0;0;0;0;0;0;0;0;0;0
FR;5;2021-11-10;0;0;0;0;0;0;0;0;0;0
FR;5;2021-11-11;0;0;0;0;0;0;0;0;0;0
FR;5;2021-11-12;0;0;0;0;0;0;0;0;0;0
FR;5;2021-11-13;0;0;0;0;0;0;0;0;0;0
FR;5;2021-11-14;0;0;0;0;0;0;0;0;0;0
FR;5;2021-11-15;0;0;0;0;0;0;0;0;0;0
FR;5;2021-11-16;0;0;0;0;0;0;0;0;0;0
FR;5;2021-11-17;0;0;0;0;0;0;0;0;0;0
FR;5;2021-11-18;0;0;0;0;0;0;0;0;0;0
FR;5;2021-11-19;0;0;0;0;0;0;0;0;0;0
FR;5;2021-11-20;0;0;0;0;0;0;0;0;0;0
FR;5;2021-11-21;0;0;0;0;0;0;0;0;0;0
FR;5;2021-11-22;0;0;0;0;0;0;0;0;0;0
FR;5;2021-11-23;0;0;0;0;0;0;0;0;0;0
FR;5;2021-11-24;0;0;0;0;0;0;0;0;0;0
FR;5;2021-11-25;0;0;0;0;0;0;0;0;0;0
FR;5;2021-11-26;0;0;0;0;0;0;0;0;0;0
FR;5;2021-11-27;0;0;0;0;0;0;0;0;0;0
FR;5;2021-11-28;0;0;0;0;0;0;0;0;0;0
FR;5;2021-11-29;0;0;0;0;0;0;0;0;0;0
FR;5;2021-11-30;0;0;0;0;0;0;0;0;0;0
FR;5;2021-12-01;0;0;0;0;0;0;0;0;0;0
FR;5;2021-12-02;0;0;0;0;0;0;0;0;0;0
FR;5;2021-12-03;0;0;0;0;0;0;0;0;0;0
FR;5;2021-12-04;0;0;0;0;0;0;0;0;0;0
FR;5;2021-12-05;0;0;0;0;0;0;0;0;0;0
FR;5;2021-12-06;0;0;0;0;0;0;0;0;0;0
FR;5;2021-12-07;0;0;0;0;0;0;0;0;0;0
FR;5;2021-12-08;0;0;0;0;0;0;0;0;0;0
FR;5;2021-12-09;0;0;0;0;0;0;0;0;0;0
FR;5;2021-12-10;0;0;0;0;0;0;0;0;0;0
FR;5;2021-12-11;0;0;0;0;0;0;0;0;0;0
FR;5;2021-12-12;0;0;0;0;0;0;0;0;0;0
FR;5;2021-12-13;0;0;0;0;0;0;0;0;0;0
FR;5;2021-12-14;33;45;77;0;88;33;45;77;0;88
FR;5;2021-12-15;196;45;37;0;49;229;90;114;0;137
FR;5;2021-12-16;181;21;44;0;48;410;111;158;0;185
FR;5;2021-12-17;312;16;72;0;74;722;127;230;0;259
FR;5;2021-12-18;766;24;22;0;29;1488;151;252;0;288
FR;5;2021-12-19;586;15;15;0;17;2074;166;267;0;305
FR;5;2021-12-20;1223;31;35;0;38;3297;197;302;0;343
FR;5;2021-12-21;1535;22;54;1;60;4832;219;356;1;403
FR;5;2021-12-22;4069;40;37;0;46;8901;259;393;1;449
FR;5;2021-12-23;3042;16;21;0;25;11943;275;414;1;474
FR;5;2021-12-24;761;18;9;0;14;12704;293;423;1;488
FR;5;2021-12-25;61;5;2;0;3;12765;298;425;1;491
FR;5;2021-12-26;623;6;3;0;4;13388;304;428;1;495
FR;5;2021-12-27;4085;25;21;0;23;17473;329;449;1;518
FR;5;2021-12-28;5204;23;41;1;43;22677;352;490;2;561
FR;5;2021-12-29;8107;34;66;2;69;30784;386;556;4;630
FR;5;2021-12-30;5173;18;33;0;39;35957;404;589;4;669
FR;5;2021-12-31;1553;8;10;0;11;37510;412;599;4;680
FR;5;2022-01-01;185;2;2;0;3;37695;414;601;4;683
FR;5;2022-01-02;1489;1;1;0;1;39184;415;602;4;684
FR;5;2022-01-03;3066;36;33;0;32;42250;451;635;4;716
FR;5;2022-01-04;3033;39;33;0;42;45283;490;668;4;758
FR;5;2022-01-05;19323;203;97;1;108;64606;693;765;5;866
FR;5;2022-01-06;3746;134;122;0;142;68352;827;887;5;1008
FR;5;2022-01-07;5007;202;48;2;56;73359;1029;935;7;1064
FR;5;2022-01-08;13659;514;45;0;52;87018;1543;980;7;1116
FR;5;2022-01-09;5754;399;15;0;20;92772;1942;995;7;1136
FR;5;2022-01-10;3455;326;25;0;29;96227;2268;1020;7;1165
FR;5;2022-01-11;3671;284;38;0;41;99898;2552;1058;7;1206
FR;5;2022-01-12;22652;3005;89;0;112;122550;5557;1147;7;1318
FR;5;2022-01-13;4037;622;30;0;32;126587;6179;1177;7;1350
FR;5;2022-01-14;4843;582;44;0;51;131430;6761;1221;7;1401
FR;5;2022-01-15;14686;1746;38;3;49;146116;8507;1259;10;1450
FR;5;2022-01-16;4727;666;3;0;5;150843;9173;1262;10;1455
FR;5;2022-01-17;2297;718;26;0;29;153140;9891;1288;10;1484
FR;5;2022-01-18;2430;870;30;0;40;155570;10761;1318;10;1524
FR;5;2022-01-19;18483;6423;74;2;143;174053;17184;1392;12;1667
FR;5;2022-01-20;1920;1068;25;0;34;175973;18252;1417;12;1701
FR;5;2022-01-21;3077;1372;47;1;59;179050;19624;1464;13;1760
FR;5;2022-01-22;10720;3454;33;1;43;189770;23078;1497;14;1803
FR;5;2022-01-23;2629;1415;6;0;10;192399;24493;1503;14;1813
FR;5;2022-01-24;1161;1340;19;0;23;193560;25833;1522;14;1836
FR;5;2022-01-25;1220;1549;20;2;31;194780;27382;1542;16;1867
FR;5;2022-01-26;10751;12028;50;1;89;205531;39410;1592;17;1956
FR;5;2022-01-27;1291;1693;10;0;17;206822;41103;1602;17;1973
FR;5;2022-01-28;1699;3347;16;0;19;208521;44450;1618;17;1992
FR;5;2022-01-29;6241;8041;68;0;96;214762;52491;1686;17;2088
FR;5;2022-01-30;1509;2950;5;0;18;216271;55441;1691;17;2106
FR;5;2022-01-31;589;1773;23;0;24;216860;57214;1714;17;2130
FR;5;2022-02-01;712;1706;10;0;15;217572;58920;1724;17;2145
FR;5;2022-02-02;6958;15656;52;0;94;224530;74576;1776;17;2239
FR;5;2022-02-03;491;1690;14;0;13;225021;76266;1790;17;2252
FR;5;2022-02-04;945;3002;19;0;31;225966;79268;1809;17;2283
FR;5;2022-02-05;3535;8918;23;0;37;229501;88186;1832;17;2320
FR;5;2022-02-06;737;2397;10;0;19;230238;90583;1842;17;2339
FR;5;2022-02-07;884;1596;23;0;25;231122;92179;1865;17;2364
FR;5;2022-02-08;722;1287;18;0;20;231844;93466;1883;17;2384
FR;5;2022-02-09;4544;12878;44;0;76;236388;106344;1927;17;2460
FR;5;2022-02-10;646;1059;14;0;15;237034;107403;1941;17;2475
FR;5;2022-02-11;793;2032;16;0;21;237827;109435;1957;17;2496
FR;5;2022-02-12;2286;6812;33;0;53;240113;116247;1990;17;2549
FR;5;2022-02-13;464;1540;8;0;8;240577;117787;1998;17;2557
FR;5;2022-02-14;678;1288;10;0;13;241255;119075;2008;17;2570
FR;5;2022-02-15;482;886;9;0;14;241737;119961;2017;17;2584
FR;5;2022-02-16;2980;9123;41;1;58;244717;129084;2058;18;2642
FR;5;2022-02-17;436;809;6;0;7;245153;129893;2064;18;2649
FR;5;2022-02-18;649;1408;13;0;17;245802;131301;2077;18;2666
FR;5;2022-02-19;1373;4315;16;0;28;247175;135616;2093;18;2694
FR;5;2022-02-20;247;879;6;0;8;247422;136495;2099;18;2702
FR;5;2022-02-21;221;607;2;0;4;247643;137102;2101;18;2706
FR;5;2022-02-22;262;545;17;0;17;247905;137647;2118;18;2723
FR;5;2022-02-23;1909;6926;23;1;43;249814;144573;2141;19;2766
FR;5;2022-02-24;182;374;6;1;7;249996;144947;2147;20;2773
FR;5;2022-02-25;336;950;13;0;12;250332;145897;2160;20;2785
FR;5;2022-02-26;972;3071;11;0;15;251304;148968;2171;20;2800
FR;5;2022-02-27;150;506;0;0;3;251454;149474;2171;20;2803
FR;5;2022-02-28;162;369;1;0;1;251616;149843;2172;20;2804
FR;5;2022-03-01;130;280;6;0;7;251746;150123;2178;20;2811
FR;5;2022-03-02;1241;4156;28;3;40;252987;154279;2206;23;2851
FR;5;2022-03-03;121;251;5;0;10;253108;154530;2211;23;2861
FR;5;2022-03-04;197;488;13;0;14;253305;155018;2224;23;2875
FR;5;2022-03-05;677;1990;8;0;16;253982;157008;2232;23;2891
FR;5;2022-03-06;108;260;0;0;0;254090;157268;2232;23;2891
FR;5;2022-03-07;71;228;5;0;3;254161;157496;2237;23;2894
FR;5;2022-03-08;46;134;7;1;8;254207;157630;2244;24;2902
FR;5;2022-03-09;910;3078;24;0;36;255117;160708;2268;24;2938
FR;5;2022-03-10;82;202;9;0;13;255199;160910;2277;24;2951
FR;5;2022-03-11;148;369;13;1;15;255347;161279;2290;25;2966
FR;5;2022-03-12;758;1613;13;1;30;256105;162892;2303;26;2996
FR;5;2022-03-13;78;100;0;0;0;256183;162992;2303;26;2996
FR;5;2022-03-14;67;119;7;1;7;256250;163111;2310;27;3003
FR;5;2022-03-15;83;99;4;0;7;256333;163210;2314;27;3010
FR;5;2022-03-16;882;1827;15;3;36;257215;165037;2329;30;3046
FR;5;2022-03-17;68;123;8;4;10;257283;165160;2337;34;3056
FR;5;2022-03-18;172;318;13;4;18;257455;165478;2350;38;3074
FR;5;2022-03-19;751;1163;12;5;33;258206;166641;2362;43;3107
FR;5;2022-03-20;45;93;1;0;1;258251;166734;2363;43;3108
FR;5;2022-03-21;71;120;10;6;15;258322;166854;2373;49;3123
FR;5;2022-03-22;56;119;8;7;9;258378;166973;2381;56;3132
FR;5;2022-03-23;805;1461;14;8;36;259183;168434;2395;64;3168
FR;5;2022-03-24;70;93;8;7;7;259253;168527;2403;71;3175
FR;5;2022-03-25;222;293;14;8;18;259475;168820;2417;79;3193
FR;5;2022-03-26;707;853;12;5;26;260182;169673;2429;84;3219
FR;5;2022-03-27;75;80;0;0;3;260257;169753;2429;84;3222
FR;5;2022-03-28;81;93;1;2;3;260338;169846;2430;86;3225
FR;5;2022-03-29;71;82;10;4;12;260409;169928;2440;90;3237
FR;5;2022-03-30;823;1116;16;13;29;261232;171044;2456;103;3266
FR;5;2022-03-31;102;125;1;4;6;261334;171169;2457;107;3272
FR;5;2022-04-01;114;86;7;12;11;261448;171255;2464;119;3283
FR;5;2022-04-02;330;349;3;3;15;261778;171604;2467;122;3298
FR;5;2022-04-03;54;59;1;0;1;261832;171663;2468;122;3299
FR;5;2022-04-04;40;57;4;1;8;261872;171720;2472;123;3307
FR;5;2022-04-05;52;60;6;7;9;261924;171780;2478;130;3316
FR;5;2022-04-06;421;439;7;15;16;262345;172219;2485;145;3332
FR;5;2022-04-07;45;69;5;7;7;262390;172288;2490;152;3339
FR;5;2022-04-08;134;112;12;13;14;262524;172400;2502;165;3353
FR;5;2022-04-09;311;324;2;5;17;262835;172724;2504;170;3370
FR;5;2022-04-10;44;31;2;0;2;262879;172755;2506;170;3372
FR;5;2022-04-11;50;60;3;2;4;262929;172815;2509;172;3376
FR;5;2022-04-12;59;54;3;3;5;262988;172869;2512;175;3381
FR;5;2022-04-13;382;413;3;8;16;263370;173282;2515;183;3397
FR;5;2022-04-14;48;48;5;5;9;263418;173330;2520;188;3406
FR;5;2022-04-15;91;109;4;4;5;263509;173439;2524;192;3411
FR;5;2022-04-16;188;184;2;1;13;263697;173623;2526;193;3424
FR;5;2022-04-17;12;11;1;0;1;263709;173634;2527;193;3425
FR;5;2022-04-18;9;10;2;0;3;263718;173644;2529;193;3428
FR;5;2022-04-19;75;71;6;1;6;263793;173715;2535;194;3434
FR;5;2022-04-20;361;349;9;6;12;264154;174064;2544;200;3446
FR;5;2022-04-21;42;64;9;10;12;264196;174128;2553;210;3458
FR;5;2022-04-22;113;96;5;4;5;264309;174224;2558;214;3463
FR;5;2022-04-23;209;193;4;2;11;264518;174417;2562;216;3474
FR;5;2022-04-24;37;35;0;0;3;264555;174452;2562;216;3477
FR;5;2022-04-25;69;65;1;1;4;264624;174517;2563;217;3481
FR;5;2022-04-26;60;63;2;1;5;264684;174580;2565;218;3486
FR;5;2022-04-27;335;316;3;7;14;265019;174896;2568;225;3500
FR;5;2022-04-28;81;54;4;5;8;265100;174950;2572;230;3508
FR;5;2022-04-29;117;84;5;19;12;265217;175034;2577;249;3520
FR;5;2022-04-30;183;114;2;3;10;265400;175148;2579;252;3530
FR;5;2022-05-01;11;7;0;0;0;265411;175155;2579;252;3530
FR;5;2022-05-02;52;28;4;5;2;265463;175183;2583;257;3532
FR;5;2022-05-03;84;57;2;5;11;265547;175240;2585;262;3543
FR;5;2022-05-04;278;205;1;2;7;265825;175445;2586;264;3550
FR;5;2022-05-05;62;32;3;4;5;265887;175477;2589;268;3555
FR;5;2022-05-06;105;65;2;3;5;265992;175542;2591;271;3560
FR;5;2022-05-07;171;117;3;10;13;266163;175659;2594;281;3573
FR;5;2022-05-08;8;8;0;0;2;266171;175667;2594;281;3575
FR;5;2022-05-09;44;34;15;3;16;266215;175701;2609;284;3591
FR;5;2022-05-10;54;49;3;4;5;266269;175750;2612;288;3596
FR;5;2022-05-11;326;237;12;7;21;266595;175987;2624;295;3617
FR;5;2022-05-12;46;34;2;2;2;266641;176021;2626;297;3619
FR;5;2022-05-13;109;83;3;8;8;266750;176104;2629;305;3627
FR;5;2022-05-14;209;131;0;1;8;266959;176235;2629;306;3635
FR;5;2022-05-15;22;9;2;0;1;266981;176244;2631;306;3636
FR;5;2022-05-16;52;34;4;5;4;267033;176278;2635;311;3640
FR;5;2022-05-17;72;40;5;0;2;267105;176318;2640;311;3642
FR;5;2022-05-18;289;215;4;4;8;267394;176533;2644;315;3650
FR;5;2022-05-19;45;35;5;3;3;267439;176568;2649;318;3653
FR;5;2022-05-20;76;63;3;10;1;267515;176631;2652;328;3654
FR;5;2022-05-21;242;166;2;3;17;267757;176797;2654;331;3671
FR;5;2022-05-22;20;14;2;5;2;267777;176811;2656;336;3673
FR;5;2022-05-23;42;31;4;3;6;267819;176842;2660;339;3679
FR;5;2022-05-24;47;45;3;2;5;267866;176887;2663;341;3684
FR;5;2022-05-25;329;257;4;1;16;268195;177144;2667;342;3700
FR;5;2022-05-26;17;5;0;1;2;268212;177149;2667;343;3702
FR;5;2022-05-27;99;54;4;4;9;268311;177203;2671;347;3711
FR;5;2022-05-28;100;78;5;3;10;268411;177281;2676;350;3721
FR;5;2022-05-29;14;14;1;0;2;268425;177295;2677;350;3723
FR;5;2022-05-30;56;41;2;1;2;268481;177336;2679;351;3725
FR;5;2022-05-31;57;43;1;8;1;268538;177379;2680;359;3726
FR;5;2022-06-01;257;241;9;2;25;268795;177620;2689;361;3751
FR;5;2022-06-02;63;61;5;0;9;268858;177681;2694;361;3760
FR;5;2022-06-03;82;71;4;5;10;268940;177752;2698;366;3770
FR;5;2022-06-04;157;109;2;1;9;269097;177861;2700;367;3779
FR;5;2022-06-05;18;11;0;0;1;269115;177872;2700;367;3780
FR;5;2022-06-06;16;9;0;1;0;269131;177881;2700;368;3780
FR;5;2022-06-07;50;56;1;1;2;269181;177937;2701;369;3782
FR;5;2022-06-08;283;225;3;4;17;269464;178162;2704;373;3799
FR;5;2022-06-09;52;41;6;3;7;269516;178203;2710;376;3806
FR;5;2022-06-10;81;72;1;1;6;269597;178275;2711;377;3812
FR;5;2022-06-11;173;141;3;3;10;269770;178416;2714;380;3822
FR;5;2022-06-12;17;16;0;0;2;269787;178432;2714;380;3824
FR;5;2022-06-13;56;47;9;3;10;269843;178479;2723;383;3834
FR;5;2022-06-14;59;56;1;4;6;269902;178535;2724;387;3840
FR;5;2022-06-15;266;260;5;2;27;270168;178795;2729;389;3867
FR;5;2022-06-16;47;30;5;2;5;270215;178825;2734;391;3872
FR;5;2022-06-17;100;67;5;5;10;270315;178892;2739;396;3882
FR;5;2022-06-18;146;95;10;2;26;270461;178987;2749;398;3908
FR;5;2022-06-19;26;15;0;1;4;270487;179002;2749;399;3912
FR;5;2022-06-20;56;50;8;0;11;270543;179052;2757;399;3923
FR;5;2022-06-21;52;73;5;3;7;270595;179125;2762;402;3930
FR;5;2022-06-22;224;247;7;9;33;270819;179372;2769;411;3963
FR;5;2022-06-23;50;38;2;5;6;270869;179410;2771;416;3969
FR;5;2022-06-24;91;70;12;5;16;270960;179480;2783;421;3985
FR;5;2022-06-25;154;124;3;7;14;271114;179604;2786;428;3999
FR;5;2022-06-26;26;19;2;0;5;271140;179623;2788;428;4004
FR;5;2022-06-27;57;60;5;7;11;271197;179683;2793;435;4015
FR;5;2022-06-28;70;49;8;2;14;271267;179732;2801;437;4029
FR;5;2022-06-29;297;268;9;21;34;271564;180000;2810;458;4063
FR;5;2022-06-30;89;57;10;12;17;271653;180057;2820;470;4080
FR;5;2022-07-01;127;65;7;11;12;271780;180122;2827;481;4092
FR;5;2022-07-02;191;132;4;0;22;271971;180254;2831;481;4114
FR;5;2022-07-03;30;25;1;0;4;272001;180279;2832;481;4118
FR;5;2022-07-04;103;64;2;5;6;272104;180343;2834;486;4124
FR;5;2022-07-05;104;72;3;8;13;272208;180415;2837;494;4137
FR;5;2022-07-06;277;168;9;36;27;272485;180583;2846;530;4164
FR;5;2022-07-07;88;68;6;9;13;272573;180651;2852;539;4177
FR;5;2022-07-08;152;120;7;14;25;272725;180771;2859;553;4202
FR;5;2022-07-09;116;68;1;8;10;272841;180839;2860;561;4212
FR;5;2022-07-10;15;6;0;0;1;272856;180845;2860;561;4213
FR;5;2022-07-11;92;72;10;2;19;272948;180917;2870;563;4232
FR;5;2022-07-12;67;63;5;10;7;273015;180980;2875;573;4239
FR;5;2022-07-13;169;118;10;19;16;273184;181098;2885;592;4255
FR;5;2022-07-14;8;4;0;0;0;273192;181102;2885;592;4255
FR;5;2022-07-15;74;66;5;14;15;273266;181168;2890;606;4270
FR;5;2022-07-16;54;44;3;0;3;273320;181212;2893;606;4273
FR;5;2022-07-17;10;7;3;0;2;273330;181219;2896;606;4275
FR;5;2022-07-18;60;47;0;5;4;273390;181266;2896;611;4279
FR;5;2022-07-19;63;42;5;3;7;273453;181308;2901;614;4286
FR;5;2022-07-20;119;106;4;11;14;273572;181414;2905;625;4300
FR;5;2022-07-21;38;43;2;10;5;273610;181457;2907;635;4305
FR;5;2022-07-22;48;69;11;13;23;273658;181526;2918;648;4328
FR;5;2022-07-23;59;78;2;1;11;273717;181604;2920;649;4339
FR;5;2022-07-24;11;9;3;1;3;273728;181613;2923;650;4342
FR;5;2022-07-25;53;48;2;7;8;273781;181661;2925;657;4350
FR;5;2022-07-26;58;52;5;41;6;273839;181713;2930;698;4356
FR;5;2022-07-27;106;118;4;4;13;273945;181831;2934;702;4369
FR;5;2022-07-28;39;35;2;2;6;273984;181866;2936;704;4375
FR;5;2022-07-29;56;74;3;14;8;274040;181940;2939;718;4383
FR;5;2022-07-30;55;53;5;1;7;274095;181993;2944;719;4390
FR;5;2022-07-31;7;11;1;0;1;274102;182004;2945;719;4391
FR;5;2022-08-01;39;53;1;2;6;274141;182057;2946;721;4397
FR;5;2022-08-02;32;43;8;7;8;274173;182100;2954;728;4405
FR;5;2022-08-03;54;51;4;10;9;274227;182151;2958;738;4414
FR;5;2022-08-04;20;18;1;6;1;274247;182169;2959;744;4415
FR;5;2022-08-05;35;26;3;3;3;274282;182195;2962;747;4418
FR;5;2022-08-06;23;26;1;0;1;274305;182221;2963;747;4419
FR;5;2022-08-07;2;2;1;0;1;274307;182223;2964;747;4420
FR;5;2022-08-08;26;19;1;2;2;274333;182242;2965;749;4422
FR;5;2022-08-09;26;28;3;3;3;274359;182270;2968;752;4425
FR;5;2022-08-10;47;47;2;0;5;274406;182317;2970;752;4430
FR;5;2022-08-11;19;36;2;2;5;274425;182353;2972;754;4435
FR;5;2022-08-12;27;28;2;0;2;274452;182381;2974;754;4437
FR;5;2022-08-13;16;18;0;0;0;274468;182399;2974;754;4437
FR;5;2022-08-14;2;3;0;0;0;274470;182402;2974;754;4437
FR;5;2022-08-15;2;5;0;0;0;274472;182407;2974;754;4437
FR;5;2022-08-16;33;26;2;0;5;274505;182433;2976;754;4442
FR;5;2022-08-17;52;55;2;1;1;274557;182488;2978;755;4443
FR;5;2022-08-18;26;18;5;17;7;274583;182506;2983;772;4450
FR;5;2022-08-19;25;33;1;2;2;274608;182539;2984;774;4452
FR;5;2022-08-20;25;27;2;1;4;274633;182566;2986;775;4456
FR;5;2022-08-21;7;4;1;0;1;274640;182570;2987;775;4457
FR;5;2022-08-22;39;26;1;6;2;274679;182596;2988;781;4459
FR;5;2022-08-23;27;26;1;1;2;274706;182622;2989;782;4461
FR;5;2022-08-24;50;43;0;0;0;274756;182665;2989;782;4461
FR;5;2022-08-25;27;26;3;1;2;274783;182691;2992;783;4463
FR;5;2022-08-26;48;38;7;2;5;274831;182729;2999;785;4468
FR;5;2022-08-27;46;28;1;0;3;274877;182757;3000;785;4471
FR;5;2022-08-28;5;6;0;0;0;274882;182763;3000;785;4471
FR;5;2022-08-29;58;44;1;1;4;274940;182807;3001;786;4475
FR;5;2022-08-30;43;23;12;29;10;274983;182830;3013;815;4485
FR;5;2022-08-31;52;47;6;1;11;275035;182877;3019;816;4496
FR;5;2022-09-01;14;8;1;4;1;275049;182885;3020;820;4497
FR;5;2022-09-02;42;22;8;2;9;275091;182907;3028;822;4506
FR;5;2022-09-03;69;37;2;0;2;275160;182944;3030;822;4508
FR;5;2022-09-04;12;7;1;0;3;275172;182951;3031;822;4511
FR;5;2022-09-05;7;4;1;0;1;275179;182955;3032;822;4512
FR;5;2022-09-06;21;14;3;15;2;275200;182969;3035;837;4514
FR;5;2022-09-07;79;53;1;1;3;275279;183022;3036;838;4517
FR;5;2022-09-08;9;4;0;4;0;275288;183026;3036;842;4517
FR;5;2022-09-09;40;11;9;2;10;275328;183037;3045;844;4527
FR;5;2022-09-10;40;45;1;1;8;275368;183082;3046;845;4535
FR;5;2022-09-11;3;3;0;0;1;275371;183085;3046;845;4536
FR;5;2022-09-12;7;5;2;2;2;275378;183090;3048;847;4538
FR;5;2022-09-13;9;6;0;1;3;275387;183096;3048;848;4541
FR;5;2022-09-14;52;46;4;7;9;275439;183142;3052;855;4550
FR;5;2022-09-15;11;13;2;3;5;275450;183155;3054;858;4555
FR;5;2022-09-16;25;33;1;4;3;275475;183188;3055;862;4558
FR;5;2022-09-17;60;43;1;1;5;275535;183231;3056;863;4563
FR;5;2022-09-18;9;6;0;1;1;275544;183237;3056;864;4564
FR;5;2022-09-19;22;17;2;1;5;275566;183254;3058;865;4569
FR;5;2022-09-20;15;11;3;3;1;275581;183265;3061;868;4570
FR;5;2022-09-21;68;45;9;0;13;275649;183310;3070;868;4583
FR;5;2022-09-22;12;6;4;24;4;275661;183316;3074;892;4587
FR;5;2022-09-23;19;24;2;3;8;275680;183340;3076;895;4595
FR;5;2022-09-24;44;51;1;8;5;275724;183391;3077;903;4600
FR;5;2022-09-25;6;12;0;0;1;275730;183403;3077;903;4601
FR;5;2022-09-26;14;7;0;2;0;275744;183410;3077;905;4601
FR;5;2022-09-27;7;12;4;9;4;275751;183422;3081;914;4605
FR;5;2022-09-28;65;64;5;0;7;275816;183486;3086;914;4612
FR;5;2022-09-29;17;9;1;0;1;275833;183495;3087;914;4613
FR;5;2022-09-30;28;44;2;2;4;275861;183539;3089;916;4617
FR;5;2022-10-01;39;35;5;5;8;275900;183574;3094;921;4625
FR;5;2022-10-02;1;9;1;0;1;275901;183583;3095;921;4626
FR;5;2022-10-03;5;6;3;0;4;275906;183589;3098;921;4630
FR;5;2022-10-04;10;8;0;3;1;275916;183597;3098;924;4631
FR;5;2022-10-05;56;61;2;2;13;275972;183658;3100;926;4644
FR;5;2022-10-06;11;10;0;4;1;275983;183668;3100;930;4645
FR;5;2022-10-07;21;31;1;0;5;276004;183699;3101;930;4650
FR;5;2022-10-08;33;51;1;0;7;276037;183750;3102;930;4657
FR;5;2022-10-09;7;10;0;0;1;276044;183760;3102;930;4658
FR;5;2022-10-10;14;5;0;1;0;276058;183765;3102;931;4658
FR;5;2022-10-11;6;13;2;0;2;276064;183778;3104;931;4660
FR;5;2022-10-12;38;56;3;2;8;276102;183834;3107;933;4668
FR;5;2022-10-13;11;16;2;0;4;276113;183850;3109;933;4672
FR;5;2022-10-14;21;21;1;0;5;276134;183871;3110;933;4677
FR;5;2022-10-15;19;26;9;0;10;276153;183897;3119;933;4687
FR;5;2022-10-16;3;1;0;0;1;276156;183898;3119;933;4688
FR;5;2022-10-17;7;8;2;1;3;276163;183906;3121;934;4691
FR;5;2022-10-18;4;7;0;2;0;276167;183913;3121;936;4691
FR;5;2022-10-19;38;42;8;0;11;276205;183955;3129;936;4702
FR;5;2022-10-20;18;15;2;1;3;276223;183970;3131;937;4705
FR;5;2022-10-21;22;15;6;0;8;276245;183985;3137;937;4713
FR;5;2022-10-22;34;27;2;11;5;276279;184012;3139;948;4718
FR;5;2022-10-23;9;3;0;0;0;276288;184015;3139;948;4718
FR;5;2022-10-24;14;7;6;7;9;276302;184022;3145;955;4727
FR;5;2022-10-25;12;8;6;3;8;276314;184030;3151;958;4735
FR;5;2022-10-26;32;20;6;0;10;276346;184050;3157;958;4745
FR;6;2020-12-27;0;0;0;0;0;0;0;0;0;0
FR;6;2020-12-28;0;0;0;0;0;0;0;0;0;0
FR;6;2020-12-29;0;0;0;0;0;0;0;0;0;0
FR;6;2020-12-30;0;0;0;0;0;0;0;0;0;0
FR;6;2020-12-31;0;0;0;0;0;0;0;0;0;0
FR;6;2021-01-01;0;0;0;0;0;0;0;0;0;0
FR;6;2021-01-02;0;0;0;0;0;0;0;0;0;0
FR;6;2021-01-03;0;0;0;0;0;0;0;0;0;0
FR;6;2021-01-04;0;0;0;0;0;0;0;0;0;0
FR;6;2021-01-05;0;0;0;0;0;0;0;0;0;0
FR;6;2021-01-06;0;0;0;0;0;0;0;0;0;0
FR;6;2021-01-07;0;0;0;0;0;0;0;0;0;0
FR;6;2021-01-08;0;0;0;0;0;0;0;0;0;0
FR;6;2021-01-09;0;0;0;0;0;0;0;0;0;0
FR;6;2021-01-10;0;0;0;0;0;0;0;0;0;0
FR;6;2021-01-11;0;0;0;0;0;0;0;0;0;0
FR;6;2021-01-12;0;0;0;0;0;0;0;0;0;0
FR;6;2021-01-13;0;0;0;0;0;0;0;0;0;0
FR;6;2021-01-14;0;0;0;0;0;0;0;0;0;0
FR;6;2021-01-15;0;0;0;0;0;0;0;0;0;0
FR;6;2021-01-16;0;0;0;0;0;0;0;0;0;0
FR;6;2021-01-17;0;0;0;0;0;0;0;0;0;0
FR;6;2021-01-18;0;0;0;0;0;0;0;0;0;0
FR;6;2021-01-19;0;0;0;0;0;0;0;0;0;0
FR;6;2021-01-20;0;0;0;0;0;0;0;0;0;0
FR;6;2021-01-21;0;0;0;0;0;0;0;0;0;0
FR;6;2021-01-22;0;0;0;0;0;0;0;0;0;0
FR;6;2021-01-23;0;0;0;0;0;0;0;0;0;0
FR;6;2021-01-24;0;0;0;0;0;0;0;0;0;0
FR;6;2021-01-25;0;0;0;0;0;0;0;0;0;0
FR;6;2021-01-26;0;0;0;0;0;0;0;0;0;0
FR;6;2021-01-27;0;0;0;0;0;0;0;0;0;0
FR;6;2021-01-28;0;0;0;0;0;0;0;0;0;0
FR;6;2021-01-29;0;0;0;0;0;0;0;0;0;0
FR;6;2021-01-30;0;0;0;0;0;0;0;0;0;0
FR;6;2021-01-31;0;0;0;0;0;0;0;0;0;0
FR;6;2021-02-01;0;0;0;0;0;0;0;0;0;0
FR;6;2021-02-02;0;0;0;0;0;0;0;0;0;0
FR;6;2021-02-03;0;0;0;0;0;0;0;0;0;0
FR;6;2021-02-04;0;0;0;0;0;0;0;0;0;0
FR;6;2021-02-05;0;0;0;0;0;0;0;0;0;0
FR;6;2021-02-06;0;0;0;0;0;0;0;0;0;0
FR;6;2021-02-07;0;0;0;0;0;0;0;0;0;0
FR;6;2021-02-08;0;0;0;0;0;0;0;0;0;0
FR;6;2021-02-09;0;0;0;0;0;0;0;0;0;0
FR;6;2021-02-10;0;0;0;0;0;0;0;0;0;0
FR;6;2021-02-11;0;0;0;0;0;0;0;0;0;0
FR;6;2021-02-12;0;0;0;0;0;0;0;0;0;0
FR;6;2021-02-13;0;0;0;0;0;0;0;0;0;0
FR;6;2021-02-14;0;0;0;0;0;0;0;0;0;0
FR;6;2021-02-15;0;0;0;0;0;0;0;0;0;0
FR;6;2021-02-16;0;0;0;0;0;0;0;0;0;0
FR;6;2021-02-17;0;0;0;0;0;0;0;0;0;0
FR;6;2021-02-18;0;0;0;0;0;0;0;0;0;0
FR;6;2021-02-19;0;0;0;0;0;0;0;0;0;0
FR;6;2021-02-20;0;0;0;0;0;0;0;0;0;0
FR;6;2021-02-21;0;0;0;0;0;0;0;0;0;0
FR;6;2021-02-22;0;0;0;0;0;0;0;0;0;0
FR;6;2021-02-23;0;0;0;0;0;0;0;0;0;0
FR;6;2021-02-24;0;0;0;0;0;0;0;0;0;0
FR;6;2021-02-25;0;0;0;0;0;0;0;0;0;0
FR;6;2021-02-26;0;0;0;0;0;0;0;0;0;0
FR;6;2021-02-27;0;0;0;0;0;0;0;0;0;0
FR;6;2021-02-28;0;0;0;0;0;0;0;0;0;0
FR;6;2021-03-01;0;0;0;0;0;0;0;0;0;0
FR;6;2021-03-02;0;0;0;0;0;0;0;0;0;0
FR;6;2021-03-03;0;0;0;0;0;0;0;0;0;0
FR;6;2021-03-04;0;0;0;0;0;0;0;0;0;0
FR;6;2021-03-05;0;0;0;0;0;0;0;0;0;0
FR;6;2021-03-06;0;0;0;0;0;0;0;0;0;0
FR;6;2021-03-07;0;0;0;0;0;0;0;0;0;0
FR;6;2021-03-08;0;0;0;0;0;0;0;0;0;0
FR;6;2021-03-09;0;0;0;0;0;0;0;0;0;0
FR;6;2021-03-10;0;0;0;0;0;0;0;0;0;0
FR;6;2021-03-11;0;0;0;0;0;0;0;0;0;0
FR;6;2021-03-12;0;0;0;0;0;0;0;0;0;0
FR;6;2021-03-13;0;0;0;0;0;0;0;0;0;0
FR;6;2021-03-14;0;0;0;0;0;0;0;0;0;0
FR;6;2021-03-15;0;0;0;0;0;0;0;0;0;0
FR;6;2021-03-16;0;0;0;0;0;0;0;0;0;0
FR;6;2021-03-17;0;0;0;0;0;0;0;0;0;0
FR;6;2021-03-18;0;0;0;0;0;0;0;0;0;0
FR;6;2021-03-19;0;0;0;0;0;0;0;0;0;0
FR;6;2021-03-20;0;0;0;0;0;0;0;0;0;0
FR;6;2021-03-21;0;0;0;0;0;0;0;0;0;0
FR;6;2021-03-22;0;0;0;0;0;0;0;0;0;0
FR;6;2021-03-23;0;0;0;0;0;0;0;0;0;0
FR;6;2021-03-24;0;0;0;0;0;0;0;0;0;0
FR;6;2021-03-25;0;0;0;0;0;0;0;0;0;0
FR;6;2021-03-26;0;0;0;0;0;0;0;0;0;0
FR;6;2021-03-27;0;0;0;0;0;0;0;0;0;0
FR;6;2021-03-28;0;0;0;0;0;0;0;0;0;0
FR;6;2021-03-29;0;0;0;0;0;0;0;0;0;0
FR;6;2021-03-30;0;0;0;0;0;0;0;0;0;0
FR;6;2021-03-31;0;0;0;0;0;0;0;0;0;0
FR;6;2021-04-01;0;0;0;0;0;0;0;0;0;0
FR;6;2021-04-02;0;0;0;0;0;0;0;0;0;0
FR;6;2021-04-03;0;0;0;0;0;0;0;0;0;0
FR;6;2021-04-04;0;0;0;0;0;0;0;0;0;0
FR;6;2021-04-05;0;0;0;0;0;0;0;0;0;0
FR;6;2021-04-06;0;0;0;0;0;0;0;0;0;0
FR;6;2021-04-07;0;0;0;0;0;0;0;0;0;0
FR;6;2021-04-08;0;0;0;0;0;0;0;0;0;0
FR;6;2021-04-09;0;0;0;0;0;0;0;0;0;0
FR;6;2021-04-10;0;0;0;0;0;0;0;0;0;0
FR;6;2021-04-11;0;0;0;0;0;0;0;0;0;0
FR;6;2021-04-12;0;0;0;0;0;0;0;0;0;0
FR;6;2021-04-13;0;0;0;0;0;0;0;0;0;0
FR;6;2021-04-14;0;0;0;0;0;0;0;0;0;0
FR;6;2021-04-15;0;0;0;0;0;0;0;0;0;0
FR;6;2021-04-16;0;0;0;0;0;0;0;0;0;0
FR;6;2021-04-17;0;0;0;0;0;0;0;0;0;0
FR;6;2021-04-18;0;0;0;0;0;0;0;0;0;0
FR;6;2021-04-19;0;0;0;0;0;0;0;0;0;0
FR;6;2021-04-20;0;0;0;0;0;0;0;0;0;0
FR;6;2021-04-21;0;0;0;0;0;0;0;0;0;0
FR;6;2021-04-22;0;0;0;0;0;0;0;0;0;0
FR;6;2021-04-23;0;0;0;0;0;0;0;0;0;0
FR;6;2021-04-24;0;0;0;0;0;0;0;0;0;0
FR;6;2021-04-25;0;0;0;0;0;0;0;0;0;0
FR;6;2021-04-26;0;0;0;0;0;0;0;0;0;0
FR;6;2021-04-27;0;0;0;0;0;0;0;0;0;0
FR;6;2021-04-28;0;0;0;0;0;0;0;0;0;0
FR;6;2021-04-29;0;0;0;0;0;0;0;0;0;0
FR;6;2021-04-30;0;0;0;0;0;0;0;0;0;0
FR;6;2021-05-01;0;0;0;0;0;0;0;0;0;0
FR;6;2021-05-02;0;0;0;0;0;0;0;0;0;0
FR;6;2021-05-03;0;0;0;0;0;0;0;0;0;0
FR;6;2021-05-04;0;0;0;0;0;0;0;0;0;0
FR;6;2021-05-05;0;0;0;0;0;0;0;0;0;0
FR;6;2021-05-06;0;0;0;0;0;0;0;0;0;0
FR;6;2021-05-07;0;0;0;0;0;0;0;0;0;0
FR;6;2021-05-08;0;0;0;0;0;0;0;0;0;0
FR;6;2021-05-09;0;0;0;0;0;0;0;0;0;0
FR;6;2021-05-10;0;0;0;0;0;0;0;0;0;0
FR;6;2021-05-11;0;0;0;0;0;0;0;0;0;0
FR;6;2021-05-12;0;0;0;0;0;0;0;0;0;0
FR;6;2021-05-13;0;0;0;0;0;0;0;0;0;0
FR;6;2021-05-14;0;0;0;0;0;0;0;0;0;0
FR;6;2021-05-15;0;0;0;0;0;0;0;0;0;0
FR;6;2021-05-16;0;0;0;0;0;0;0;0;0;0
FR;6;2021-05-17;0;0;0;0;0;0;0;0;0;0
FR;6;2021-05-18;0;0;0;0;0;0;0;0;0;0
FR;6;2021-05-19;0;0;0;0;0;0;0;0;0;0
FR;6;2021-05-20;0;0;0;0;0;0;0;0;0;0
FR;6;2021-05-21;0;0;0;0;0;0;0;0;0;0
FR;6;2021-05-22;0;0;0;0;0;0;0;0;0;0
FR;6;2021-05-23;0;0;0;0;0;0;0;0;0;0
FR;6;2021-05-24;0;0;0;0;0;0;0;0;0;0
FR;6;2021-05-25;0;0;0;0;0;0;0;0;0;0
FR;6;2021-05-26;0;0;0;0;0;0;0;0;0;0
FR;6;2021-05-27;0;0;0;0;0;0;0;0;0;0
FR;6;2021-05-28;0;0;0;0;0;0;0;0;0;0
FR;6;2021-05-29;0;0;0;0;0;0;0;0;0;0
FR;6;2021-05-30;0;0;0;0;0;0;0;0;0;0
FR;6;2021-05-31;0;0;0;0;0;0;0;0;0;0
FR;6;2021-06-01;0;0;0;0;0;0;0;0;0;0
FR;6;2021-06-02;0;0;0;0;0;0;0;0;0;0
FR;6;2021-06-03;0;0;0;0;0;0;0;0;0;0
FR;6;2021-06-04;0;0;0;0;0;0;0;0;0;0
FR;6;2021-06-05;0;0;0;0;0;0;0;0;0;0
FR;6;2021-06-06;0;0;0;0;0;0;0;0;0;0
FR;6;2021-06-07;0;0;0;0;0;0;0;0;0;0
FR;6;2021-06-08;0;0;0;0;0;0;0;0;0;0
FR;6;2021-06-09;0;0;0;0;0;0;0;0;0;0
FR;6;2021-06-10;0;0;0;0;0;0;0;0;0;0
FR;6;2021-06-11;0;0;0;0;0;0;0;0;0;0
FR;6;2021-06-12;0;0;0;0;0;0;0;0;0;0
FR;6;2021-06-13;0;0;0;0;0;0;0;0;0;0
FR;6;2021-06-14;0;0;0;0;0;0;0;0;0;0
FR;6;2021-06-15;0;0;0;0;0;0;0;0;0;0
FR;6;2021-06-16;0;0;0;0;0;0;0;0;0;0
FR;6;2021-06-17;0;0;0;0;0;0;0;0;0;0
FR;6;2021-06-18;0;0;0;0;0;0;0;0;0;0
FR;6;2021-06-19;0;0;0;0;0;0;0;0;0;0
FR;6;2021-06-20;0;0;0;0;0;0;0;0;0;0
FR;6;2021-06-21;0;0;0;0;0;0;0;0;0;0
FR;6;2021-06-22;0;0;0;0;0;0;0;0;0;0
FR;6;2021-06-23;0;0;0;0;0;0;0;0;0;0
FR;6;2021-06-24;0;0;0;0;0;0;0;0;0;0
FR;6;2021-06-25;0;0;0;0;0;0;0;0;0;0
FR;6;2021-06-26;0;0;0;0;0;0;0;0;0;0
FR;6;2021-06-27;0;0;0;0;0;0;0;0;0;0
FR;6;2021-06-28;0;0;0;0;0;0;0;0;0;0
FR;6;2021-06-29;0;0;0;0;0;0;0;0;0;0
FR;6;2021-06-30;0;0;0;0;0;0;0;0;0;0
FR;6;2021-07-01;0;0;0;0;0;0;0;0;0;0
FR;6;2021-07-02;0;0;0;0;0;0;0;0;0;0
FR;6;2021-07-03;0;0;0;0;0;0;0;0;0;0
FR;6;2021-07-04;0;0;0;0;0;0;0;0;0;0
FR;6;2021-07-05;0;0;0;0;0;0;0;0;0;0
FR;6;2021-07-06;0;0;0;0;0;0;0;0;0;0
FR;6;2021-07-07;0;0;0;0;0;0;0;0;0;0
FR;6;2021-07-08;0;0;0;0;0;0;0;0;0;0
FR;6;2021-07-09;0;0;0;0;0;0;0;0;0;0
FR;6;2021-07-10;0;0;0;0;0;0;0;0;0;0
FR;6;2021-07-11;0;0;0;0;0;0;0;0;0;0
FR;6;2021-07-12;0;0;0;0;0;0;0;0;0;0
FR;6;2021-07-13;0;0;0;0;0;0;0;0;0;0
FR;6;2021-07-14;0;0;0;0;0;0;0;0;0;0
FR;6;2021-07-15;0;0;0;0;0;0;0;0;0;0
FR;6;2021-07-16;0;0;0;0;0;0;0;0;0;0
FR;6;2021-07-17;0;0;0;0;0;0;0;0;0;0
FR;6;2021-07-18;0;0;0;0;0;0;0;0;0;0
FR;6;2021-07-19;0;0;0;0;0;0;0;0;0;0
FR;6;2021-07-20;0;0;0;0;0;0;0;0;0;0
FR;6;2021-07-21;0;0;0;0;0;0;0;0;0;0
FR;6;2021-07-22;0;0;0;0;0;0;0;0;0;0
FR;6;2021-07-23;0;0;0;0;0;0;0;0;0;0
FR;6;2021-07-24;0;0;0;0;0;0;0;0;0;0
FR;6;2021-07-25;0;0;0;0;0;0;0;0;0;0
FR;6;2021-07-26;0;0;0;0;0;0;0;0;0;0
FR;6;2021-07-27;0;0;0;0;0;0;0;0;0;0
FR;6;2021-07-28;0;0;0;0;0;0;0;0;0;0
FR;6;2021-07-29;0;0;0;0;0;0;0;0;0;0
FR;6;2021-07-30;0;0;0;0;0;0;0;0;0;0
FR;6;2021-07-31;0;0;0;0;0;0;0;0;0;0
FR;6;2021-08-01;0;0;0;0;0;0;0;0;0;0
FR;6;2021-08-02;0;0;0;0;0;0;0;0;0;0
FR;6;2021-08-03;0;0;0;0;0;0;0;0;0;0
FR;6;2021-08-04;0;0;0;0;0;0;0;0;0;0
FR;6;2021-08-05;0;0;0;0;0;0;0;0;0;0
FR;6;2021-08-06;0;0;0;0;0;0;0;0;0;0
FR;6;2021-08-07;0;0;0;0;0;0;0;0;0;0
FR;6;2021-08-08;0;0;0;0;0;0;0;0;0;0
FR;6;2021-08-09;0;0;0;0;0;0;0;0;0;0
FR;6;2021-08-10;0;0;0;0;0;0;0;0;0;0
FR;6;2021-08-11;0;0;0;0;0;0;0;0;0;0
FR;6;2021-08-12;0;0;0;0;0;0;0;0;0;0
FR;6;2021-08-13;0;0;0;0;0;0;0;0;0;0
FR;6;2021-08-14;0;0;0;0;0;0;0;0;0;0
FR;6;2021-08-15;0;0;0;0;0;0;0;0;0;0
FR;6;2021-08-16;0;0;0;0;0;0;0;0;0;0
FR;6;2021-08-17;0;0;0;0;0;0;0;0;0;0
FR;6;2021-08-18;0;0;0;0;0;0;0;0;0;0
FR;6;2021-08-19;0;0;0;0;0;0;0;0;0;0
FR;6;2021-08-20;0;0;0;0;0;0;0;0;0;0
FR;6;2021-08-21;0;0;0;0;0;0;0;0;0;0
FR;6;2021-08-22;0;0;0;0;0;0;0;0;0;0
FR;6;2021-08-23;0;0;0;0;0;0;0;0;0;0
FR;6;2021-08-24;0;0;0;0;0;0;0;0;0;0
FR;6;2021-08-25;0;0;0;0;0;0;0;0;0;0
FR;6;2021-08-26;0;0;0;0;0;0;0;0;0;0
FR;6;2021-08-27;0;0;0;0;0;0;0;0;0;0
FR;6;2021-08-28;0;0;0;0;0;0;0;0;0;0
FR;6;2021-08-29;0;0;0;0;0;0;0;0;0;0
FR;6;2021-08-30;0;0;0;0;0;0;0;0;0;0
FR;6;2021-08-31;0;0;0;0;0;0;0;0;0;0
FR;6;2021-09-01;0;0;0;0;0;0;0;0;0;0
FR;6;2021-09-02;0;0;0;0;0;0;0;0;0;0
FR;6;2021-09-03;0;0;0;0;0;0;0;0;0;0
FR;6;2021-09-04;0;0;0;0;0;0;0;0;0;0
FR;6;2021-09-05;0;0;0;0;0;0;0;0;0;0
FR;6;2021-09-06;0;0;0;0;0;0;0;0;0;0
FR;6;2021-09-07;0;0;0;0;0;0;0;0;0;0
FR;6;2021-09-08;0;0;0;0;0;0;0;0;0;0
FR;6;2021-09-09;0;0;0;0;0;0;0;0;0;0
FR;6;2021-09-10;0;0;0;0;0;0;0;0;0;0
FR;6;2021-09-11;0;0;0;0;0;0;0;0;0;0
FR;6;2021-09-12;0;0;0;0;0;0;0;0;0;0
FR;6;2021-09-13;0;0;0;0;0;0;0;0;0;0
FR;6;2021-09-14;0;0;0;0;0;0;0;0;0;0
FR;6;2021-09-15;0;0;0;0;0;0;0;0;0;0
FR;6;2021-09-16;0;0;0;0;0;0;0;0;0;0
FR;6;2021-09-17;0;0;0;0;0;0;0;0;0;0
FR;6;2021-09-18;0;0;0;0;0;0;0;0;0;0
FR;6;2021-09-19;0;0;0;0;0;0;0;0;0;0
FR;6;2021-09-20;0;0;0;0;0;0;0;0;0;0
FR;6;2021-09-21;0;0;0;0;0;0;0;0;0;0
FR;6;2021-09-22;0;0;0;0;0;0;0;0;0;0
FR;6;2021-09-23;0;0;0;0;0;0;0;0;0;0
FR;6;2021-09-24;0;0;0;0;0;0;0;0;0;0
FR;6;2021-09-25;0;0;0;0;0;0;0;0;0;0
FR;6;2021-09-26;0;0;0;0;0;0;0;0;0;0
FR;6;2021-09-27;0;0;0;0;0;0;0;0;0;0
FR;6;2021-09-28;0;0;0;0;0;0;0;0;0;0
FR;6;2021-09-29;0;0;0;0;0;0;0;0;0;0
FR;6;2021-09-30;0;0;0;0;0;0;0;0;0;0
FR;6;2021-10-01;0;0;0;0;0;0;0;0;0;0
FR;6;2021-10-02;0;0;0;0;0;0;0;0;0;0
FR;6;2021-10-03;0;0;0;0;0;0;0;0;0;0
FR;6;2021-10-04;0;0;0;0;0;0;0;0;0;0
FR;6;2021-10-05;0;0;0;0;0;0;0;0;0;0
FR;6;2021-10-06;0;0;0;0;0;0;0;0;0;0
FR;6;2021-10-07;0;0;0;0;0;0;0;0;0;0
FR;6;2021-10-08;0;0;0;0;0;0;0;0;0;0
FR;6;2021-10-09;0;0;0;0;0;0;0;0;0;0
FR;6;2021-10-10;0;0;0;0;0;0;0;0;0;0
FR;6;2021-10-11;0;0;0;0;0;0;0;0;0;0
FR;6;2021-10-12;0;0;0;0;0;0;0;0;0;0
FR;6;2021-10-13;0;0;0;0;0;0;0;0;0;0
FR;6;2021-10-14;0;0;0;0;0;0;0;0;0;0
FR;6;2021-10-15;0;0;0;0;0;0;0;0;0;0
FR;6;2021-10-16;0;0;0;0;0;0;0;0;0;0
FR;6;2021-10-17;0;0;0;0;0;0;0;0;0;0
FR;6;2021-10-18;0;0;0;0;0;0;0;0;0;0
FR;6;2021-10-19;0;0;0;0;0;0;0;0;0;0
FR;6;2021-10-20;0;0;0;0;0;0;0;0;0;0
FR;6;2021-10-21;0;0;0;0;0;0;0;0;0;0
FR;6;2021-10-22;0;0;0;0;0;0;0;0;0;0
FR;6;2021-10-23;0;0;0;0;0;0;0;0;0;0
FR;6;2021-10-24;0;0;0;0;0;0;0;0;0;0
FR;6;2021-10-25;0;0;0;0;0;0;0;0;0;0
FR;6;2021-10-26;0;0;0;0;0;0;0;0;0;0
FR;6;2021-10-27;0;0;0;0;0;0;0;0;0;0
FR;6;2021-10-28;0;0;0;0;0;0;0;0;0;0
FR;6;2021-10-29;0;0;0;0;0;0;0;0;0;0
FR;6;2021-10-30;0;0;0;0;0;0;0;0;0;0
FR;6;2021-10-31;0;0;0;0;0;0;0;0;0;0
FR;6;2021-11-01;0;0;0;0;0;0;0;0;0;0
FR;6;2021-11-02;0;0;0;0;0;0;0;0;0;0
FR;6;2021-11-03;0;0;0;0;0;0;0;0;0;0
FR;6;2021-11-04;0;0;0;0;0;0;0;0;0;0
FR;6;2021-11-05;0;0;0;0;0;0;0;0;0;0
FR;6;2021-11-06;0;0;0;0;0;0;0;0;0;0
FR;6;2021-11-07;0;0;0;0;0;0;0;0;0;0
FR;6;2021-11-08;0;0;0;0;0;0;0;0;0;0
FR;6;2021-11-09;0;0;0;0;0;0;0;0;0;0
FR;6;2021-11-10;0;0;0;0;0;0;0;0;0;0
FR;6;2021-11-11;0;0;0;0;0;0;0;0;0;0
FR;6;2021-11-12;0;0;0;0;0;0;0;0;0;0
FR;6;2021-11-13;0;0;0;0;0;0;0;0;0;0
FR;6;2021-11-14;0;0;0;0;0;0;0;0;0;0
FR;6;2021-11-15;0;0;0;0;0;0;0;0;0;0
FR;6;2021-11-16;0;0;0;0;0;0;0;0;0;0
FR;6;2021-11-17;0;0;0;0;0;0;0;0;0;0
FR;6;2021-11-18;0;0;0;0;0;0;0;0;0;0
FR;6;2021-11-19;0;0;0;0;0;0;0;0;0;0
FR;6;2021-11-20;0;0;0;0;0;0;0;0;0;0
FR;6;2021-11-21;0;0;0;0;0;0;0;0;0;0
FR;6;2021-11-22;0;0;0;0;0;0;0;0;0;0
FR;6;2021-11-23;0;0;0;0;0;0;0;0;0;0
FR;6;2021-11-24;0;0;0;0;0;0;0;0;0;0
FR;6;2021-11-25;0;0;0;0;0;0;0;0;0;0
FR;6;2021-11-26;0;0;0;0;0;0;0;0;0;0
FR;6;2021-11-27;0;0;0;0;0;0;0;0;0;0
FR;6;2021-11-28;0;0;0;0;0;0;0;0;0;0
FR;6;2021-11-29;0;0;0;0;0;0;0;0;0;0
FR;6;2021-11-30;0;0;0;0;0;0;0;0;0;0
FR;6;2021-12-01;0;0;0;0;0;0;0;0;0;0
FR;6;2021-12-02;0;0;0;0;0;0;0;0;0;0
FR;6;2021-12-03;0;0;0;0;0;0;0;0;0;0
FR;6;2021-12-04;0;0;0;0;0;0;0;0;0;0
FR;6;2021-12-05;0;0;0;0;0;0;0;0;0;0
FR;6;2021-12-06;0;0;0;0;0;0;0;0;0;0
FR;6;2021-12-07;0;0;0;0;0;0;0;0;0;0
FR;6;2021-12-08;0;0;0;0;0;0;0;0;0;0
FR;6;2021-12-09;0;0;0;0;0;0;0;0;0;0
FR;6;2021-12-10;0;0;0;0;0;0;0;0;0;0
FR;6;2021-12-11;0;0;0;0;0;0;0;0;0;0
FR;6;2021-12-12;0;0;0;0;0;0;0;0;0;0
FR;6;2021-12-13;0;0;0;0;0;0;0;0;0;0
FR;6;2021-12-14;0;0;0;0;0;0;0;0;0;0
FR;6;2021-12-15;0;0;0;0;0;0;0;0;0;0
FR;6;2021-12-16;0;0;0;0;0;0;0;0;0;0
FR;6;2021-12-17;0;0;0;0;0;0;0;0;0;0
FR;6;2021-12-18;0;0;0;0;0;0;0;0;0;0
FR;6;2021-12-19;0;0;0;0;0;0;0;0;0;0
FR;6;2021-12-20;0;0;0;0;0;0;0;0;0;0
FR;6;2021-12-21;0;0;0;0;0;0;0;0;0;0
FR;6;2021-12-22;0;0;0;0;0;0;0;0;0;0
FR;6;2021-12-23;0;0;0;0;0;0;0;0;0;0
FR;6;2021-12-24;0;0;0;0;0;0;0;0;0;0
FR;6;2021-12-25;0;0;0;0;0;0;0;0;0;0
FR;6;2021-12-26;0;0;0;0;0;0;0;0;0;0
FR;6;2021-12-27;0;0;0;0;0;0;0;0;0;0
FR;6;2021-12-28;0;0;0;0;0;0;0;0;0;0
FR;6;2021-12-29;0;0;0;0;0;0;0;0;0;0
FR;6;2021-12-30;0;0;0;0;0;0;0;0;0;0
FR;6;2021-12-31;0;0;0;0;0;0;0;0;0;0
FR;6;2022-01-01;0;0;0;0;0;0;0;0;0;0
FR;6;2022-01-02;0;0;0;0;0;0;0;0;0;0
FR;6;2022-01-03;0;0;0;0;0;0;0;0;0;0
FR;6;2022-01-04;0;0;0;0;0;0;0;0;0;0
FR;6;2022-01-05;0;0;0;0;0;0;0;0;0;0
FR;6;2022-01-06;0;0;0;0;0;0;0;0;0;0
FR;6;2022-01-07;0;0;0;0;0;0;0;0;0;0
FR;6;2022-01-08;0;0;0;0;0;0;0;0;0;0
FR;6;2022-01-09;0;0;0;0;0;0;0;0;0;0
FR;6;2022-01-10;0;0;0;0;0;0;0;0;0;0
FR;6;2022-01-11;0;0;0;0;0;0;0;0;0;0
FR;6;2022-01-12;0;0;0;0;0;0;0;0;0;0
FR;6;2022-01-13;0;0;0;0;0;0;0;0;0;0
FR;6;2022-01-14;0;0;0;0;0;0;0;0;0;0
FR;6;2022-01-15;0;0;0;0;0;0;0;0;0;0
FR;6;2022-01-16;0;0;0;0;0;0;0;0;0;0
FR;6;2022-01-17;0;0;0;0;0;0;0;0;0;0
FR;6;2022-01-18;0;0;0;0;0;0;0;0;0;0
FR;6;2022-01-19;0;0;0;0;0;0;0;0;0;0
FR;6;2022-01-20;0;0;0;0;0;0;0;0;0;0
FR;6;2022-01-21;0;0;0;0;0;0;0;0;0;0
FR;6;2022-01-22;0;0;0;0;0;0;0;0;0;0
FR;6;2022-01-23;0;0;0;0;0;0;0;0;0;0
FR;6;2022-01-24;0;0;0;0;0;0;0;0;0;0
FR;6;2022-01-25;0;0;0;0;0;0;0;0;0;0
FR;6;2022-01-26;0;0;0;0;0;0;0;0;0;0
FR;6;2022-01-27;0;0;0;0;0;0;0;0;0;0
FR;6;2022-01-28;0;0;0;0;0;0;0;0;0;0
FR;6;2022-01-29;0;0;0;0;0;0;0;0;0;0
FR;6;2022-01-30;0;0;0;0;0;0;0;0;0;0
FR;6;2022-01-31;0;0;0;0;0;0;0;0;0;0
FR;6;2022-02-01;0;0;0;0;0;0;0;0;0;0
FR;6;2022-02-02;0;0;0;0;0;0;0;0;0;0
FR;6;2022-02-03;0;0;0;0;0;0;0;0;0;0
FR;6;2022-02-04;0;0;0;0;0;0;0;0;0;0
FR;6;2022-02-05;0;0;0;0;0;0;0;0;0;0
FR;6;2022-02-06;0;0;0;0;0;0;0;0;0;0
FR;6;2022-02-07;0;0;0;0;0;0;0;0;0;0
FR;6;2022-02-08;0;0;0;0;0;0;0;0;0;0
FR;6;2022-02-09;0;0;0;0;0;0;0;0;0;0
FR;6;2022-02-10;0;0;0;0;0;0;0;0;0;0
FR;6;2022-02-11;0;0;0;0;0;0;0;0;0;0
FR;6;2022-02-12;0;0;0;0;0;0;0;0;0;0
FR;6;2022-02-13;0;0;0;0;0;0;0;0;0;0
FR;6;2022-02-14;0;0;0;0;0;0;0;0;0;0
FR;6;2022-02-15;0;0;0;0;0;0;0;0;0;0
FR;6;2022-02-16;0;0;0;0;0;0;0;0;0;0
FR;6;2022-02-17;0;0;0;0;0;0;0;0;0;0
FR;6;2022-02-18;0;0;0;0;0;0;0;0;0;0
FR;6;2022-02-19;0;0;0;0;0;0;0;0;0;0
FR;6;2022-02-20;0;0;0;0;0;0;0;0;0;0
FR;6;2022-02-21;0;0;0;0;0;0;0;0;0;0
FR;6;2022-02-22;0;0;0;0;0;0;0;0;0;0
FR;6;2022-02-23;0;0;0;0;0;0;0;0;0;0
FR;6;2022-02-24;0;0;0;0;0;0;0;0;0;0
FR;6;2022-02-25;0;0;0;0;0;0;0;0;0;0
FR;6;2022-02-26;1;0;0;0;0;1;0;0;0;0
FR;6;2022-02-27;0;0;0;0;0;1;0;0;0;0
FR;6;2022-02-28;0;0;0;0;0;1;0;0;0;0
FR;6;2022-03-01;3;0;0;0;0;4;0;0;0;0
FR;6;2022-03-02;97;9;2;0;7;101;9;2;0;7
FR;6;2022-03-03;0;0;0;0;0;101;9;2;0;7
FR;6;2022-03-04;91;4;0;0;4;192;13;2;0;11
FR;6;2022-03-05;391;23;2;0;14;583;36;4;0;25
FR;6;2022-03-06;7;1;0;0;0;590;37;4;0;25
FR;6;2022-03-07;337;19;0;0;13;927;56;4;0;38
FR;6;2022-03-08;230;14;0;0;5;1157;70;4;0;43
FR;6;2022-03-09;519;29;2;0;21;1676;99;6;0;64
FR;6;2022-03-10;206;19;0;1;12;1882;118;6;1;76
FR;6;2022-03-11;331;22;6;0;21;2213;140;12;1;97
FR;6;2022-03-12;518;25;1;0;20;2731;165;13;1;117
FR;6;2022-03-13;40;2;0;0;1;2771;167;13;1;118
FR;6;2022-03-14;201;4;2;0;3;2972;171;15;1;121
FR;6;2022-03-15;112;11;2;0;9;3084;182;17;1;130
FR;6;2022-03-16;310;17;1;1;14;3394;199;18;2;144
FR;6;2022-03-17;117;6;1;2;4;3511;205;19;4;148
FR;6;2022-03-18;215;10;0;0;6;3726;215;19;4;154
FR;6;2022-03-19;307;19;2;0;9;4033;234;21;4;163
FR;6;2022-03-20;15;5;0;0;1;4048;239;21;4;164
FR;6;2022-03-21;132;23;1;0;4;4180;262;22;4;168
FR;6;2022-03-22;97;15;0;0;4;4277;277;22;4;172
FR;6;2022-03-23;226;108;3;0;14;4503;385;25;4;186
FR;6;2022-03-24;100;15;1;3;4;4603;400;26;7;190
FR;6;2022-03-25;203;141;2;1;15;4806;541;28;8;205
FR;6;2022-03-26;331;295;7;1;19;5137;836;35;9;224
FR;6;2022-03-27;32;30;1;0;1;5169;866;36;9;225
FR;6;2022-03-28;201;208;8;1;17;5370;1074;44;10;242
FR;6;2022-03-29;124;189;12;2;12;5494;1263;56;12;254
FR;6;2022-03-30;305;476;10;2;22;5799;1739;66;14;276
FR;6;2022-03-31;123;140;10;0;14;5922;1879;76;14;290
FR;6;2022-04-01;195;150;11;2;23;6117;2029;87;16;313
FR;6;2022-04-02;206;241;9;1;13;6323;2270;96;17;326
FR;6;2022-04-03;17;21;0;0;1;6340;2291;96;17;327
FR;6;2022-04-04;137;114;6;1;9;6477;2405;102;18;336
FR;6;2022-04-05;146;88;15;1;11;6623;2493;117;19;347
FR;6;2022-04-06;204;245;22;26;27;6827;2738;139;45;374
FR;6;2022-04-07;127;96;15;9;17;6954;2834;154;54;391
FR;6;2022-04-08;199;170;16;3;17;7153;3004;170;57;408
FR;6;2022-04-09;145;139;6;12;13;7298;3143;176;69;421
FR;6;2022-04-10;10;20;3;0;1;7308;3163;179;69;422
FR;6;2022-04-11;101;106;4;0;5;7409;3269;183;69;427
FR;6;2022-04-12;136;75;5;8;10;7545;3344;188;77;437
FR;6;2022-04-13;162;175;7;5;13;7707;3519;195;82;450
FR;6;2022-04-14;100;103;5;10;8;7807;3622;200;92;458
FR;6;2022-04-15;158;149;11;7;19;7965;3771;211;99;477
FR;6;2022-04-16;127;132;5;0;14;8092;3903;216;99;491
FR;6;2022-04-17;8;9;4;0;4;8100;3912;220;99;495
FR;6;2022-04-18;8;15;3;0;4;8108;3927;223;99;499
FR;6;2022-04-19;97;112;4;3;3;8205;4039;227;102;502
FR;6;2022-04-20;178;227;8;7;15;8383;4266;235;109;517
FR;6;2022-04-21;111;93;8;4;11;8494;4359;243;113;528
FR;6;2022-04-22;138;160;13;12;13;8632;4519;256;125;541
FR;6;2022-04-23;106;129;1;1;7;8738;4648;257;126;548
FR;6;2022-04-24;5;21;1;0;0;8743;4669;258;126;548
FR;6;2022-04-25;91;128;3;8;11;8834;4797;261;134;559
FR;6;2022-04-26;101;128;19;2;17;8935;4925;280;136;576
FR;6;2022-04-27;197;159;21;1;27;9132;5084;301;137;603
FR;6;2022-04-28;109;87;7;1;8;9241;5171;308;138;611
FR;6;2022-04-29;191;169;16;2;20;9432;5340;324;140;631
FR;6;2022-04-30;133;125;7;1;24;9565;5465;331;141;655
FR;6;2022-05-01;7;6;0;0;0;9572;5471;331;141;655
FR;6;2022-05-02;94;65;3;4;3;9666;5536;334;145;658
FR;6;2022-05-03;136;93;11;2;7;9802;5629;345;147;665
FR;6;2022-05-04;167;118;25;12;29;9969;5747;370;159;694
FR;6;2022-05-05;101;70;8;3;12;10070;5817;378;162;706
FR;6;2022-05-06;152;110;10;9;16;10222;5927;388;171;722
FR;6;2022-05-07;139;93;13;3;23;10361;6020;401;174;745
FR;6;2022-05-08;20;8;6;5;7;10381;6028;407;179;752
FR;6;2022-05-09;86;78;9;7;13;10467;6106;416;186;765
FR;6;2022-05-10;112;80;15;7;12;10579;6186;431;193;777
FR;6;2022-05-11;130;124;11;14;20;10709;6310;442;207;797
FR;6;2022-05-12;105;76;7;5;15;10814;6386;449;212;812
FR;6;2022-05-13;155;97;17;21;22;10969;6483;466;233;834
FR;6;2022-05-14;81;60;6;7;15;11050;6543;472;240;849
FR;6;2022-05-15;12;7;0;0;0;11062;6550;472;240;849
FR;6;2022-05-16;65;54;6;2;12;11127;6604;478;242;861
FR;6;2022-05-17;123;77;5;7;11;11250;6681;483;249;872
FR;6;2022-05-18;131;116;5;1;13;11381;6797;488;250;885
FR;6;2022-05-19;124;57;6;8;9;11505;6854;494;258;894
FR;6;2022-05-20;125;115;13;3;18;11630;6969;507;261;912
FR;6;2022-05-21;92;69;14;3;12;11722;7038;521;264;924
FR;6;2022-05-22;19;12;5;0;4;11741;7050;526;264;928
FR;6;2022-05-23;77;72;4;2;7;11818;7122;530;266;935
FR;6;2022-05-24;117;98;8;2;16;11935;7220;538;268;951
FR;6;2022-05-25;139;129;6;3;11;12074;7349;544;271;962
FR;6;2022-05-26;7;9;3;0;9;12081;7358;547;271;971
FR;6;2022-05-27;127;105;15;11;18;12208;7463;562;282;989
FR;6;2022-05-28;53;75;1;5;8;12261;7538;563;287;997
FR;6;2022-05-29;8;10;0;0;1;12269;7548;563;287;998
FR;6;2022-05-30;70;70;7;4;4;12339;7618;570;291;1002
FR;6;2022-05-31;87;102;10;2;14;12426;7720;580;293;1016
FR;6;2022-06-01;97;89;10;1;11;12523;7809;590;294;1027
FR;6;2022-06-02;91;60;6;3;9;12614;7869;596;297;1036
FR;6;2022-06-03;126;102;13;7;21;12740;7971;609;304;1057
FR;6;2022-06-04;63;51;10;0;12;12803;8022;619;304;1069
FR;6;2022-06-05;16;15;2;1;4;12819;8037;621;305;1073
FR;6;2022-06-06;9;6;0;0;0;12828;8043;621;305;1073
FR;6;2022-06-07;79;90;3;4;8;12907;8133;624;309;1081
FR;6;2022-06-08;92;110;13;5;20;12999;8243;637;314;1101
FR;6;2022-06-09;75;81;15;3;15;13074;8324;652;317;1116
FR;6;2022-06-10;116;93;26;10;22;13190;8417;678;327;1138
FR;6;2022-06-11;83;62;6;10;12;13273;8479;684;337;1150
FR;6;2022-06-12;6;14;1;0;2;13279;8493;685;337;1152
FR;6;2022-06-13;74;59;18;1;7;13353;8552;703;338;1159
FR;6;2022-06-14;98;100;8;5;16;13451;8652;711;343;1175
FR;6;2022-06-15;80;86;7;8;15;13531;8738;718;351;1190
FR;6;2022-06-16;53;40;11;7;14;13584;8778;729;358;1204
FR;6;2022-06-17;86;85;3;13;11;13670;8863;732;371;1215
FR;6;2022-06-18;71;61;13;0;21;13741;8924;745;371;1236
FR;6;2022-06-19;6;6;3;0;4;13747;8930;748;371;1240
FR;6;2022-06-20;42;41;4;1;6;13789;8971;752;372;1246
FR;6;2022-06-21;59;73;10;7;17;13848;9044;762;379;1263
FR;6;2022-06-22;86;85;8;2;17;13934;9129;770;381;1280
FR;6;2022-06-23;64;39;13;7;15;13998;9168;783;388;1295
FR;6;2022-06-24;77;85;7;14;20;14075;9253;790;402;1315
FR;6;2022-06-25;67;61;4;3;8;14142;9314;794;405;1323
FR;6;2022-06-26;6;7;1;0;1;14148;9321;795;405;1324
FR;6;2022-06-27;53;50;4;9;12;14201;9371;799;414;1336
FR;6;2022-06-28;68;47;6;3;15;14269;9418;805;417;1351
FR;6;2022-06-29;98;117;26;37;19;14367;9535;831;454;1370
FR;6;2022-06-30;84;60;33;10;12;14451;9595;864;464;1382
FR;6;2022-07-01;115;94;25;33;18;14566;9689;889;497;1400
FR;6;2022-07-02;58;67;26;2;37;14624;9756;915;499;1437
FR;6;2022-07-03;11;4;4;3;4;14635;9760;919;502;1441
FR;6;2022-07-04;61;43;3;23;13;14696;9803;922;525;1454
FR;6;2022-07-05;65;53;19;67;27;14761;9856;941;592;1481
FR;6;2022-07-06;94;64;7;11;12;14855;9920;948;603;1493
FR;6;2022-07-07;99;79;42;37;14;14954;9999;990;640;1507
FR;6;2022-07-08;139;87;42;27;10;15093;10086;1032;667;1517
FR;6;2022-07-09;53;51;16;29;27;15146;10137;1048;696;1544
FR;6;2022-07-10;3;7;8;0;9;15149;10144;1056;696;1553
FR;6;2022-07-11;54;44;5;4;12;15203;10188;1061;700;1565
FR;6;2022-07-12;70;72;12;23;12;15273;10260;1073;723;1577
FR;6;2022-07-13;84;65;14;21;25;15357;10325;1087;744;1602
FR;6;2022-07-14;4;3;1;0;1;15361;10328;1088;744;1603
FR;6;2022-07-15;74;59;9;57;16;15435;10387;1097;801;1619
FR;6;2022-07-16;27;31;17;0;17;15462;10418;1114;801;1636
FR;6;2022-07-17;3;7;0;0;0;15465;10425;1114;801;1636
FR;6;2022-07-18;37;62;11;14;15;15502;10487;1125;815;1651
FR;6;2022-07-19;54;48;4;19;6;15556;10535;1129;834;1657
FR;6;2022-07-20;53;70;7;22;11;15609;10605;1136;856;1668
FR;6;2022-07-21;51;60;4;7;11;15660;10665;1140;863;1679
FR;6;2022-07-22;55;74;7;26;8;15715;10739;1147;889;1687
FR;6;2022-07-23;38;40;6;10;6;15753;10779;1153;899;1693
FR;6;2022-07-24;11;14;1;3;3;15764;10793;1154;902;1696
FR;6;2022-07-25;60;44;8;12;9;15824;10837;1162;914;1705
FR;6;2022-07-26;47;64;14;6;10;15871;10901;1176;920;1715
FR;6;2022-07-27;54;78;15;11;17;15925;10979;1191;931;1732
FR;6;2022-07-28;30;48;4;6;8;15955;11027;1195;937;1740
FR;6;2022-07-29;43;71;10;38;24;15998;11098;1205;975;1764
FR;6;2022-07-30;26;48;4;15;7;16024;11146;1209;990;1771
FR;6;2022-07-31;0;1;1;0;0;16024;11147;1210;990;1771
FR;6;2022-08-01;39;36;14;8;10;16063;11183;1224;998;1781
FR;6;2022-08-02;37;46;10;14;6;16100;11229;1234;1012;1787
FR;6;2022-08-03;29;52;7;16;11;16129;11281;1241;1028;1798
FR;6;2022-08-04;25;21;4;9;6;16154;11302;1245;1037;1804
FR;6;2022-08-05;43;45;1;7;5;16197;11347;1246;1044;1809
FR;6;2022-08-06;17;27;1;3;2;16214;11374;1247;1047;1811
FR;6;2022-08-07;1;2;0;0;0;16215;11376;1247;1047;1811
FR;6;2022-08-08;24;33;1;0;1;16239;11409;1248;1047;1812
FR;6;2022-08-09;22;30;6;3;3;16261;11439;1254;1050;1815
FR;6;2022-08-10;31;36;5;9;5;16292;11475;1259;1059;1820
FR;6;2022-08-11;33;33;1;1;1;16325;11508;1260;1060;1821
FR;6;2022-08-12;50;44;6;2;15;16375;11552;1266;1062;1836
FR;6;2022-08-13;9;20;0;0;1;16384;11572;1266;1062;1837
FR;6;2022-08-14;3;1;0;0;0;16387;11573;1266;1062;1837
FR;6;2022-08-15;2;3;1;0;0;16389;11576;1267;1062;1837
FR;6;2022-08-16;35;66;21;7;7;16424;11642;1288;1069;1844
FR;6;2022-08-17;32;44;10;9;10;16456;11686;1298;1078;1854
FR;6;2022-08-18;29;55;14;4;4;16485;11741;1312;1082;1858
FR;6;2022-08-19;30;45;5;4;3;16515;11786;1317;1086;1861
FR;6;2022-08-20;26;29;3;0;8;16541;11815;1320;1086;1869
FR;6;2022-08-21;1;5;2;0;0;16542;11820;1322;1086;1869
FR;6;2022-08-22;20;42;15;1;0;16562;11862;1337;1087;1869
FR;6;2022-08-23;34;45;6;7;6;16596;11907;1343;1094;1875
FR;6;2022-08-24;34;30;6;3;6;16630;11937;1349;1097;1881
FR;6;2022-08-25;25;27;1;1;5;16655;11964;1350;1098;1886
FR;6;2022-08-26;38;44;4;4;7;16693;12008;1354;1102;1893
FR;6;2022-08-27;19;21;7;3;8;16712;12029;1361;1105;1901
FR;6;2022-08-28;6;3;0;6;1;16718;12032;1361;1111;1902
FR;6;2022-08-29;26;22;2;6;3;16744;12054;1363;1117;1905
FR;6;2022-08-30;28;35;4;12;8;16772;12089;1367;1129;1913
FR;6;2022-08-31;35;38;2;11;3;16807;12127;1369;1140;1916
FR;6;2022-09-01;16;11;5;1;4;16823;12138;1374;1141;1920
FR;6;2022-09-02;19;14;2;1;3;16842;12152;1376;1142;1923
FR;6;2022-09-03;10;3;1;5;2;16852;12155;1377;1147;1925
FR;6;2022-09-04;4;1;0;0;0;16856;12156;1377;1147;1925
FR;6;2022-09-05;8;7;0;0;0;16864;12163;1377;1147;1925
FR;6;2022-09-06;7;9;7;12;6;16871;12172;1384;1159;1931
FR;6;2022-09-07;3;8;1;0;1;16874;12180;1385;1159;1932
FR;6;2022-09-08;6;4;0;2;1;16880;12184;1385;1161;1933
FR;6;2022-09-09;7;9;2;7;3;16887;12193;1387;1168;1936
FR;6;2022-09-10;3;4;1;0;1;16890;12197;1388;1168;1937
FR;6;2022-09-11;1;3;0;0;0;16891;12200;1388;1168;1937
FR;6;2022-09-12;10;4;1;0;3;16901;12204;1389;1168;1940
FR;6;2022-09-13;7;2;3;0;2;16908;12206;1392;1168;1942
FR;6;2022-09-14;9;8;2;0;4;16917;12214;1394;1168;1946
FR;6;2022-09-15;8;13;5;5;9;16925;12227;1399;1173;1955
FR;6;2022-09-16;25;38;1;1;3;16950;12265;1400;1174;1958
FR;6;2022-09-17;24;22;0;6;5;16974;12287;1400;1180;1963
FR;6;2022-09-18;5;4;0;0;1;16979;12291;1400;1180;1964
FR;6;2022-09-19;30;30;2;1;5;17009;12321;1402;1181;1969
FR;6;2022-09-20;34;25;1;4;6;17043;12346;1403;1185;1975
FR;6;2022-09-21;21;9;3;3;7;17064;12355;1406;1188;1982
FR;6;2022-09-22;19;28;1;22;3;17083;12383;1407;1210;1985
FR;6;2022-09-23;28;41;5;9;9;17111;12424;1412;1219;1994
FR;6;2022-09-24;16;16;4;2;6;17127;12440;1416;1221;2000
FR;6;2022-09-25;3;14;0;0;1;17130;12454;1416;1221;2001
FR;6;2022-09-26;16;13;0;18;5;17146;12467;1416;1239;2006
FR;6;2022-09-27;32;19;2;3;4;17178;12486;1418;1242;2010
FR;6;2022-09-28;27;10;9;11;5;17205;12496;1427;1253;2015
FR;6;2022-09-29;13;13;10;34;6;17218;12509;1437;1287;2021
FR;6;2022-09-30;34;24;5;6;5;17252;12533;1442;1293;2026
FR;6;2022-10-01;14;12;5;8;8;17266;12545;1447;1301;2034
FR;6;2022-10-02;3;0;0;0;0;17269;12545;1447;1301;2034
FR;6;2022-10-03;11;10;3;5;4;17280;12555;1450;1306;2038
FR;6;2022-10-04;19;17;4;28;3;17299;12572;1454;1334;2041
FR;6;2022-10-05;11;12;3;2;7;17310;12584;1457;1336;2048
FR;6;2022-10-06;19;13;4;6;2;17329;12597;1461;1342;2050
FR;6;2022-10-07;27;26;5;24;10;17356;12623;1466;1366;2060
FR;6;2022-10-08;18;13;0;0;0;17374;12636;1466;1366;2060
FR;6;2022-10-09;7;3;4;25;4;17381;12639;1470;1391;2064
FR;6;2022-10-10;15;14;1;16;6;17396;12653;1471;1407;2070
FR;6;2022-10-11;21;23;3;11;8;17417;12676;1474;1418;2078
FR;6;2022-10-12;20;14;7;19;2;17437;12690;1481;1437;2080
FR;6;2022-10-13;28;14;2;36;0;17465;12704;1483;1473;2080
FR;6;2022-10-14;28;23;5;49;11;17493;12727;1488;1522;2091
FR;6;2022-10-15;13;9;0;22;4;17506;12736;1488;1544;2095
FR;6;2022-10-16;4;4;0;6;2;17510;12740;1488;1550;2097
FR;6;2022-10-17;14;13;2;10;1;17524;12753;1490;1560;2098
FR;6;2022-10-18;12;19;9;25;4;17536;12772;1499;1585;2102
FR;6;2022-10-19;10;20;6;16;5;17546;12792;1505;1601;2107
FR;6;2022-10-20;16;15;10;57;3;17562;12807;1515;1658;2110
FR;6;2022-10-21;16;21;8;34;10;17578;12828;1523;1692;2120
FR;6;2022-10-22;19;14;1;4;3;17597;12842;1524;1696;2123
FR;6;2022-10-23;3;2;1;0;0;17600;12844;1525;1696;2123
FR;6;2022-10-24;12;14;2;6;5;17612;12858;1527;1702;2128
FR;6;2022-10-25;20;13;6;17;7;17632;12871;1533;1719;2135
FR;6;2022-10-26;16;9;4;13;4;17648;12880;1537;1732;2139
FR;8;2020-12-27;0;0;0;0;0;0;0;0;0;0
FR;8;2020-12-28;0;0;0;0;0;0;0;0;0;0
FR;8;2020-12-29;0;0;0;0;0;0;0;0;0;0
FR;8;2020-12-30;0;0;0;0;0;0;0;0;0;0
FR;8;2020-12-31;0;0;0;0;0;0;0;0;0;0
FR;8;2021-01-01;0;0;0;0;0;0;0;0;0;0
FR;8;2021-01-02;0;0;0;0;0;0;0;0;0;0
FR;8;2021-01-03;0;0;0;0;0;0;0;0;0;0
FR;8;2021-01-04;0;0;0;0;0;0;0;0;0;0
FR;8;2021-01-05;0;0;0;0;0;0;0;0;0;0
FR;8;2021-01-06;0;0;0;0;0;0;0;0;0;0
FR;8;2021-01-07;0;0;0;0;0;0;0;0;0;0
FR;8;2021-01-08;0;0;0;0;0;0;0;0;0;0
FR;8;2021-01-09;0;0;0;0;0;0;0;0;0;0
FR;8;2021-01-10;0;0;0;0;0;0;0;0;0;0
FR;8;2021-01-11;0;0;0;0;0;0;0;0;0;0
FR;8;2021-01-12;0;0;0;0;0;0;0;0;0;0
FR;8;2021-01-13;0;0;0;0;0;0;0;0;0;0
FR;8;2021-01-14;0;0;0;0;0;0;0;0;0;0
FR;8;2021-01-15;0;0;0;0;0;0;0;0;0;0
FR;8;2021-01-16;0;0;0;0;0;0;0;0;0;0
FR;8;2021-01-17;0;0;0;0;0;0;0;0;0;0
FR;8;2021-01-18;0;0;0;0;0;0;0;0;0;0
FR;8;2021-01-19;0;0;0;0;0;0;0;0;0;0
FR;8;2021-01-20;0;0;0;0;0;0;0;0;0;0
FR;8;2021-01-21;0;0;0;0;0;0;0;0;0;0
FR;8;2021-01-22;0;0;0;0;0;0;0;0;0;0
FR;8;2021-01-23;0;0;0;0;0;0;0;0;0;0
FR;8;2021-01-24;0;0;0;0;0;0;0;0;0;0
FR;8;2021-01-25;0;0;0;0;0;0;0;0;0;0
FR;8;2021-01-26;0;0;0;0;0;0;0;0;0;0
FR;8;2021-01-27;0;0;0;0;0;0;0;0;0;0
FR;8;2021-01-28;0;0;0;0;0;0;0;0;0;0
FR;8;2021-01-29;0;0;0;0;0;0;0;0;0;0
FR;8;2021-01-30;0;0;0;0;0;0;0;0;0;0
FR;8;2021-01-31;0;0;0;0;0;0;0;0;0;0
FR;8;2021-02-01;0;0;0;0;0;0;0;0;0;0
FR;8;2021-02-02;0;0;0;0;0;0;0;0;0;0
FR;8;2021-02-03;0;0;0;0;0;0;0;0;0;0
FR;8;2021-02-04;0;0;0;0;0;0;0;0;0;0
FR;8;2021-02-05;0;0;0;0;0;0;0;0;0;0
FR;8;2021-02-06;0;0;0;0;0;0;0;0;0;0
FR;8;2021-02-07;0;0;0;0;0;0;0;0;0;0
FR;8;2021-02-08;0;0;0;0;0;0;0;0;0;0
FR;8;2021-02-09;0;0;0;0;0;0;0;0;0;0
FR;8;2021-02-10;0;0;0;0;0;0;0;0;0;0
FR;8;2021-02-11;0;0;0;0;0;0;0;0;0;0
FR;8;2021-02-12;0;0;0;0;0;0;0;0;0;0
FR;8;2021-02-13;0;0;0;0;0;0;0;0;0;0
FR;8;2021-02-14;0;0;0;0;0;0;0;0;0;0
FR;8;2021-02-15;0;0;0;0;0;0;0;0;0;0
FR;8;2021-02-16;0;0;0;0;0;0;0;0;0;0
FR;8;2021-02-17;0;0;0;0;0;0;0;0;0;0
FR;8;2021-02-18;0;0;0;0;0;0;0;0;0;0
FR;8;2021-02-19;0;0;0;0;0;0;0;0;0;0
FR;8;2021-02-20;0;0;0;0;0;0;0;0;0;0
FR;8;2021-02-21;0;0;0;0;0;0;0;0;0;0
FR;8;2021-02-22;0;0;0;0;0;0;0;0;0;0
FR;8;2021-02-23;0;0;0;0;0;0;0;0;0;0
FR;8;2021-02-24;0;0;0;0;0;0;0;0;0;0
FR;8;2021-02-25;0;0;0;0;0;0;0;0;0;0
FR;8;2021-02-26;0;0;0;0;0;0;0;0;0;0
FR;8;2021-02-27;0;0;0;0;0;0;0;0;0;0
FR;8;2021-02-28;0;0;0;0;0;0;0;0;0;0
FR;8;2021-03-01;0;0;0;0;0;0;0;0;0;0
FR;8;2021-03-02;0;0;0;0;0;0;0;0;0;0
FR;8;2021-03-03;0;0;0;0;0;0;0;0;0;0
FR;8;2021-03-04;0;0;0;0;0;0;0;0;0;0
FR;8;2021-03-05;0;0;0;0;0;0;0;0;0;0
FR;8;2021-03-06;0;0;0;0;0;0;0;0;0;0
FR;8;2021-03-07;0;0;0;0;0;0;0;0;0;0
FR;8;2021-03-08;0;0;0;0;0;0;0;0;0;0
FR;8;2021-03-09;0;0;0;0;0;0;0;0;0;0
FR;8;2021-03-10;0;0;0;0;0;0;0;0;0;0
FR;8;2021-03-11;0;0;0;0;0;0;0;0;0;0
FR;8;2021-03-12;0;0;0;0;0;0;0;0;0;0
FR;8;2021-03-13;0;0;0;0;0;0;0;0;0;0
FR;8;2021-03-14;0;0;0;0;0;0;0;0;0;0
FR;8;2021-03-15;0;0;0;0;0;0;0;0;0;0
FR;8;2021-03-16;0;0;0;0;0;0;0;0;0;0
FR;8;2021-03-17;0;0;0;0;0;0;0;0;0;0
FR;8;2021-03-18;0;0;0;0;0;0;0;0;0;0
FR;8;2021-03-19;0;0;0;0;0;0;0;0;0;0
FR;8;2021-03-20;0;0;0;0;0;0;0;0;0;0
FR;8;2021-03-21;0;0;0;0;0;0;0;0;0;0
FR;8;2021-03-22;0;0;0;0;0;0;0;0;0;0
FR;8;2021-03-23;0;0;0;0;0;0;0;0;0;0
FR;8;2021-03-24;0;0;0;0;0;0;0;0;0;0
FR;8;2021-03-25;0;0;0;0;0;0;0;0;0;0
FR;8;2021-03-26;0;0;0;0;0;0;0;0;0;0
FR;8;2021-03-27;0;0;0;0;0;0;0;0;0;0
FR;8;2021-03-28;0;0;0;0;0;0;0;0;0;0
FR;8;2021-03-29;0;0;0;0;0;0;0;0;0;0
FR;8;2021-03-30;0;0;0;0;0;0;0;0;0;0
FR;8;2021-03-31;0;0;0;0;0;0;0;0;0;0
FR;8;2021-04-01;0;0;0;0;0;0;0;0;0;0
FR;8;2021-04-02;0;0;0;0;0;0;0;0;0;0
FR;8;2021-04-03;0;0;0;0;0;0;0;0;0;0
FR;8;2021-04-04;0;0;0;0;0;0;0;0;0;0
FR;8;2021-04-05;0;0;0;0;0;0;0;0;0;0
FR;8;2021-04-06;0;0;0;0;0;0;0;0;0;0
FR;8;2021-04-07;0;0;0;0;0;0;0;0;0;0
FR;8;2021-04-08;0;0;0;0;0;0;0;0;0;0
FR;8;2021-04-09;0;0;0;0;0;0;0;0;0;0
FR;8;2021-04-10;0;0;0;0;0;0;0;0;0;0
FR;8;2021-04-11;0;0;0;0;0;0;0;0;0;0
FR;8;2021-04-12;0;0;0;0;0;0;0;0;0;0
FR;8;2021-04-13;0;0;0;0;0;0;0;0;0;0
FR;8;2021-04-14;0;0;0;0;0;0;0;0;0;0
FR;8;2021-04-15;0;0;0;0;0;0;0;0;0;0
FR;8;2021-04-16;0;0;0;0;0;0;0;0;0;0
FR;8;2021-04-17;0;0;0;0;0;0;0;0;0;0
FR;8;2021-04-18;0;0;0;0;0;0;0;0;0;0
FR;8;2021-04-19;0;0;0;0;0;0;0;0;0;0
FR;8;2021-04-20;0;0;0;0;0;0;0;0;0;0
FR;8;2021-04-21;0;0;0;0;0;0;0;0;0;0
FR;8;2021-04-22;0;0;0;0;0;0;0;0;0;0
FR;8;2021-04-23;0;0;0;0;0;0;0;0;0;0
FR;8;2021-04-24;0;0;0;0;0;0;0;0;0;0
FR;8;2021-04-25;0;0;0;0;0;0;0;0;0;0
FR;8;2021-04-26;0;0;0;0;0;0;0;0;0;0
FR;8;2021-04-27;0;0;0;0;0;0;0;0;0;0
FR;8;2021-04-28;0;0;0;0;0;0;0;0;0;0
FR;8;2021-04-29;0;0;0;0;0;0;0;0;0;0
FR;8;2021-04-30;0;0;0;0;0;0;0;0;0;0
FR;8;2021-05-01;0;0;0;0;0;0;0;0;0;0
FR;8;2021-05-02;0;0;0;0;0;0;0;0;0;0
FR;8;2021-05-03;0;0;0;0;0;0;0;0;0;0
FR;8;2021-05-04;0;0;0;0;0;0;0;0;0;0
FR;8;2021-05-05;0;0;0;0;0;0;0;0;0;0
FR;8;2021-05-06;0;0;0;0;0;0;0;0;0;0
FR;8;2021-05-07;0;0;0;0;0;0;0;0;0;0
FR;8;2021-05-08;0;0;0;0;0;0;0;0;0;0
FR;8;2021-05-09;0;0;0;0;0;0;0;0;0;0
FR;8;2021-05-10;0;0;0;0;0;0;0;0;0;0
FR;8;2021-05-11;0;0;0;0;0;0;0;0;0;0
FR;8;2021-05-12;0;0;0;0;0;0;0;0;0;0
FR;8;2021-05-13;0;0;0;0;0;0;0;0;0;0
FR;8;2021-05-14;0;0;0;0;0;0;0;0;0;0
FR;8;2021-05-15;0;0;0;0;0;0;0;0;0;0
FR;8;2021-05-16;0;0;0;0;0;0;0;0;0;0
FR;8;2021-05-17;0;0;0;0;0;0;0;0;0;0
FR;8;2021-05-18;0;0;0;0;0;0;0;0;0;0
FR;8;2021-05-19;0;0;0;0;0;0;0;0;0;0
FR;8;2021-05-20;0;0;0;0;0;0;0;0;0;0
FR;8;2021-05-21;0;0;0;0;0;0;0;0;0;0
FR;8;2021-05-22;0;0;0;0;0;0;0;0;0;0
FR;8;2021-05-23;0;0;0;0;0;0;0;0;0;0
FR;8;2021-05-24;0;0;0;0;0;0;0;0;0;0
FR;8;2021-05-25;0;0;0;0;0;0;0;0;0;0
FR;8;2021-05-26;0;0;0;0;0;0;0;0;0;0
FR;8;2021-05-27;0;0;0;0;0;0;0;0;0;0
FR;8;2021-05-28;0;0;0;0;0;0;0;0;0;0
FR;8;2021-05-29;0;0;0;0;0;0;0;0;0;0
FR;8;2021-05-30;0;0;0;0;0;0;0;0;0;0
FR;8;2021-05-31;0;0;0;0;0;0;0;0;0;0
FR;8;2021-06-01;0;0;0;0;0;0;0;0;0;0
FR;8;2021-06-02;0;0;0;0;0;0;0;0;0;0
FR;8;2021-06-03;0;0;0;0;0;0;0;0;0;0
FR;8;2021-06-04;0;0;0;0;0;0;0;0;0;0
FR;8;2021-06-05;0;0;0;0;0;0;0;0;0;0
FR;8;2021-06-06;0;0;0;0;0;0;0;0;0;0
FR;8;2021-06-07;0;0;0;0;0;0;0;0;0;0
FR;8;2021-06-08;0;0;0;0;0;0;0;0;0;0
FR;8;2021-06-09;0;0;0;0;0;0;0;0;0;0
FR;8;2021-06-10;0;0;0;0;0;0;0;0;0;0
FR;8;2021-06-11;0;0;0;0;0;0;0;0;0;0
FR;8;2021-06-12;0;0;0;0;0;0;0;0;0;0
FR;8;2021-06-13;0;0;0;0;0;0;0;0;0;0
FR;8;2021-06-14;0;0;0;0;0;0;0;0;0;0
FR;8;2021-06-15;0;0;0;0;0;0;0;0;0;0
FR;8;2021-06-16;0;0;0;0;0;0;0;0;0;0
FR;8;2021-06-17;0;0;0;0;0;0;0;0;0;0
FR;8;2021-06-18;0;0;0;0;0;0;0;0;0;0
FR;8;2021-06-19;0;0;0;0;0;0;0;0;0;0
FR;8;2021-06-20;0;0;0;0;0;0;0;0;0;0
FR;8;2021-06-21;0;0;0;0;0;0;0;0;0;0
FR;8;2021-06-22;0;0;0;0;0;0;0;0;0;0
FR;8;2021-06-23;0;0;0;0;0;0;0;0;0;0
FR;8;2021-06-24;0;0;0;0;0;0;0;0;0;0
FR;8;2021-06-25;0;0;0;0;0;0;0;0;0;0
FR;8;2021-06-26;0;0;0;0;0;0;0;0;0;0
FR;8;2021-06-27;0;0;0;0;0;0;0;0;0;0
FR;8;2021-06-28;0;0;0;0;0;0;0;0;0;0
FR;8;2021-06-29;0;0;0;0;0;0;0;0;0;0
FR;8;2021-06-30;0;0;0;0;0;0;0;0;0;0
FR;8;2021-07-01;0;0;0;0;0;0;0;0;0;0
FR;8;2021-07-02;0;0;0;0;0;0;0;0;0;0
FR;8;2021-07-03;0;0;0;0;0;0;0;0;0;0
FR;8;2021-07-04;0;0;0;0;0;0;0;0;0;0
FR;8;2021-07-05;0;0;0;0;0;0;0;0;0;0
FR;8;2021-07-06;0;0;0;0;0;0;0;0;0;0
FR;8;2021-07-07;0;0;0;0;0;0;0;0;0;0
FR;8;2021-07-08;0;0;0;0;0;0;0;0;0;0
FR;8;2021-07-09;0;0;0;0;0;0;0;0;0;0
FR;8;2021-07-10;0;0;0;0;0;0;0;0;0;0
FR;8;2021-07-11;0;0;0;0;0;0;0;0;0;0
FR;8;2021-07-12;0;0;0;0;0;0;0;0;0;0
FR;8;2021-07-13;0;0;0;0;0;0;0;0;0;0
FR;8;2021-07-14;0;0;0;0;0;0;0;0;0;0
FR;8;2021-07-15;0;0;0;0;0;0;0;0;0;0
FR;8;2021-07-16;0;0;0;0;0;0;0;0;0;0
FR;8;2021-07-17;0;0;0;0;0;0;0;0;0;0
FR;8;2021-07-18;0;0;0;0;0;0;0;0;0;0
FR;8;2021-07-19;0;0;0;0;0;0;0;0;0;0
FR;8;2021-07-20;0;0;0;0;0;0;0;0;0;0
FR;8;2021-07-21;0;0;0;0;0;0;0;0;0;0
FR;8;2021-07-22;0;0;0;0;0;0;0;0;0;0
FR;8;2021-07-23;0;0;0;0;0;0;0;0;0;0
FR;8;2021-07-24;0;0;0;0;0;0;0;0;0;0
FR;8;2021-07-25;0;0;0;0;0;0;0;0;0;0
FR;8;2021-07-26;0;0;0;0;0;0;0;0;0;0
FR;8;2021-07-27;0;0;0;0;0;0;0;0;0;0
FR;8;2021-07-28;0;0;0;0;0;0;0;0;0;0
FR;8;2021-07-29;0;0;0;0;0;0;0;0;0;0
FR;8;2021-07-30;0;0;0;0;0;0;0;0;0;0
FR;8;2021-07-31;0;0;0;0;0;0;0;0;0;0
FR;8;2021-08-01;0;0;0;0;0;0;0;0;0;0
FR;8;2021-08-02;0;0;0;0;0;0;0;0;0;0
FR;8;2021-08-03;0;0;0;0;0;0;0;0;0;0
FR;8;2021-08-04;0;0;0;0;0;0;0;0;0;0
FR;8;2021-08-05;0;0;0;0;0;0;0;0;0;0
FR;8;2021-08-06;0;0;0;0;0;0;0;0;0;0
FR;8;2021-08-07;0;0;0;0;0;0;0;0;0;0
FR;8;2021-08-08;0;0;0;0;0;0;0;0;0;0
FR;8;2021-08-09;0;0;0;0;0;0;0;0;0;0
FR;8;2021-08-10;0;0;0;0;0;0;0;0;0;0
FR;8;2021-08-11;0;0;0;0;0;0;0;0;0;0
FR;8;2021-08-12;0;0;0;0;0;0;0;0;0;0
FR;8;2021-08-13;0;0;0;0;0;0;0;0;0;0
FR;8;2021-08-14;0;0;0;0;0;0;0;0;0;0
FR;8;2021-08-15;0;0;0;0;0;0;0;0;0;0
FR;8;2021-08-16;0;0;0;0;0;0;0;0;0;0
FR;8;2021-08-17;0;0;0;0;0;0;0;0;0;0
FR;8;2021-08-18;0;0;0;0;0;0;0;0;0;0
FR;8;2021-08-19;0;0;0;0;0;0;0;0;0;0
FR;8;2021-08-20;0;0;0;0;0;0;0;0;0;0
FR;8;2021-08-21;0;0;0;0;0;0;0;0;0;0
FR;8;2021-08-22;0;0;0;0;0;0;0;0;0;0
FR;8;2021-08-23;0;0;0;0;0;0;0;0;0;0
FR;8;2021-08-24;0;0;0;0;0;0;0;0;0;0
FR;8;2021-08-25;0;0;0;0;0;0;0;0;0;0
FR;8;2021-08-26;0;0;0;0;0;0;0;0;0;0
FR;8;2021-08-27;0;0;0;0;0;0;0;0;0;0
FR;8;2021-08-28;0;0;0;0;0;0;0;0;0;0
FR;8;2021-08-29;0;0;0;0;0;0;0;0;0;0
FR;8;2021-08-30;0;0;0;0;0;0;0;0;0;0
FR;8;2021-08-31;0;0;0;0;0;0;0;0;0;0
FR;8;2021-09-01;0;0;0;0;0;0;0;0;0;0
FR;8;2021-09-02;0;0;0;0;0;0;0;0;0;0
FR;8;2021-09-03;0;0;0;0;0;0;0;0;0;0
FR;8;2021-09-04;0;0;0;0;0;0;0;0;0;0
FR;8;2021-09-05;0;0;0;0;0;0;0;0;0;0
FR;8;2021-09-06;0;0;0;0;0;0;0;0;0;0
FR;8;2021-09-07;0;0;0;0;0;0;0;0;0;0
FR;8;2021-09-08;0;0;0;0;0;0;0;0;0;0
FR;8;2021-09-09;0;0;0;0;0;0;0;0;0;0
FR;8;2021-09-10;0;0;0;0;0;0;0;0;0;0
FR;8;2021-09-11;0;0;0;0;0;0;0;0;0;0
FR;8;2021-09-12;0;0;0;0;0;0;0;0;0;0
FR;8;2021-09-13;0;0;0;0;0;0;0;0;0;0
FR;8;2021-09-14;0;0;0;0;0;0;0;0;0;0
FR;8;2021-09-15;0;0;0;0;0;0;0;0;0;0
FR;8;2021-09-16;0;0;0;0;0;0;0;0;0;0
FR;8;2021-09-17;0;0;0;0;0;0;0;0;0;0
FR;8;2021-09-18;0;0;0;0;0;0;0;0;0;0
FR;8;2021-09-19;0;0;0;0;0;0;0;0;0;0
FR;8;2021-09-20;0;0;0;0;0;0;0;0;0;0
FR;8;2021-09-21;0;0;0;0;0;0;0;0;0;0
FR;8;2021-09-22;0;0;0;0;0;0;0;0;0;0
FR;8;2021-09-23;0;0;0;0;0;0;0;0;0;0
FR;8;2021-09-24;0;0;0;0;0;0;0;0;0;0
FR;8;2021-09-25;0;0;0;0;0;0;0;0;0;0
FR;8;2021-09-26;0;0;0;0;0;0;0;0;0;0
FR;8;2021-09-27;0;0;0;0;0;0;0;0;0;0
FR;8;2021-09-28;0;0;0;0;0;0;0;0;0;0
FR;8;2021-09-29;0;0;0;0;0;0;0;0;0;0
FR;8;2021-09-30;0;0;0;0;0;0;0;0;0;0
FR;8;2021-10-01;0;0;0;0;0;0;0;0;0;0
FR;8;2021-10-02;0;0;0;0;0;0;0;0;0;0
FR;8;2021-10-03;0;0;0;0;0;0;0;0;0;0
FR;8;2021-10-04;0;0;0;0;0;0;0;0;0;0
FR;8;2021-10-05;0;0;0;0;0;0;0;0;0;0
FR;8;2021-10-06;0;0;0;0;0;0;0;0;0;0
FR;8;2021-10-07;0;0;0;0;0;0;0;0;0;0
FR;8;2021-10-08;0;0;0;0;0;0;0;0;0;0
FR;8;2021-10-09;0;0;0;0;0;0;0;0;0;0
FR;8;2021-10-10;0;0;0;0;0;0;0;0;0;0
FR;8;2021-10-11;0;0;0;0;0;0;0;0;0;0
FR;8;2021-10-12;0;0;0;0;0;0;0;0;0;0
FR;8;2021-10-13;0;0;0;0;0;0;0;0;0;0
FR;8;2021-10-14;0;0;0;0;0;0;0;0;0;0
FR;8;2021-10-15;0;0;0;0;0;0;0;0;0;0
FR;8;2021-10-16;0;0;0;0;0;0;0;0;0;0
FR;8;2021-10-17;0;0;0;0;0;0;0;0;0;0
FR;8;2021-10-18;0;0;0;0;0;0;0;0;0;0
FR;8;2021-10-19;0;0;0;0;0;0;0;0;0;0
FR;8;2021-10-20;0;0;0;0;0;0;0;0;0;0
FR;8;2021-10-21;0;0;0;0;0;0;0;0;0;0
FR;8;2021-10-22;0;0;0;0;0;0;0;0;0;0
FR;8;2021-10-23;0;0;0;0;0;0;0;0;0;0
FR;8;2021-10-24;0;0;0;0;0;0;0;0;0;0
FR;8;2021-10-25;0;0;0;0;0;0;0;0;0;0
FR;8;2021-10-26;0;0;0;0;0;0;0;0;0;0
FR;8;2021-10-27;0;0;0;0;0;0;0;0;0;0
FR;8;2021-10-28;0;0;0;0;0;0;0;0;0;0
FR;8;2021-10-29;0;0;0;0;0;0;0;0;0;0
FR;8;2021-10-30;0;0;0;0;0;0;0;0;0;0
FR;8;2021-10-31;0;0;0;0;0;0;0;0;0;0
FR;8;2021-11-01;0;0;0;0;0;0;0;0;0;0
FR;8;2021-11-02;0;0;0;0;0;0;0;0;0;0
FR;8;2021-11-03;0;0;0;0;0;0;0;0;0;0
FR;8;2021-11-04;0;0;0;0;0;0;0;0;0;0
FR;8;2021-11-05;0;0;0;0;0;0;0;0;0;0
FR;8;2021-11-06;0;0;0;0;0;0;0;0;0;0
FR;8;2021-11-07;0;0;0;0;0;0;0;0;0;0
FR;8;2021-11-08;0;0;0;0;0;0;0;0;0;0
FR;8;2021-11-09;0;0;0;0;0;0;0;0;0;0
FR;8;2021-11-10;0;0;0;0;0;0;0;0;0;0
FR;8;2021-11-11;0;0;0;0;0;0;0;0;0;0
FR;8;2021-11-12;0;0;0;0;0;0;0;0;0;0
FR;8;2021-11-13;0;0;0;0;0;0;0;0;0;0
FR;8;2021-11-14;0;0;0;0;0;0;0;0;0;0
FR;8;2021-11-15;0;0;0;0;0;0;0;0;0;0
FR;8;2021-11-16;0;0;0;0;0;0;0;0;0;0
FR;8;2021-11-17;0;0;0;0;0;0;0;0;0;0
FR;8;2021-11-18;0;0;0;0;0;0;0;0;0;0
FR;8;2021-11-19;0;0;0;0;0;0;0;0;0;0
FR;8;2021-11-20;0;0;0;0;0;0;0;0;0;0
FR;8;2021-11-21;0;0;0;0;0;0;0;0;0;0
FR;8;2021-11-22;0;0;0;0;0;0;0;0;0;0
FR;8;2021-11-23;0;0;0;0;0;0;0;0;0;0
FR;8;2021-11-24;0;0;0;0;0;0;0;0;0;0
FR;8;2021-11-25;0;0;0;0;0;0;0;0;0;0
FR;8;2021-11-26;0;0;0;0;0;0;0;0;0;0
FR;8;2021-11-27;0;0;0;0;0;0;0;0;0;0
FR;8;2021-11-28;0;0;0;0;0;0;0;0;0;0
FR;8;2021-11-29;0;0;0;0;0;0;0;0;0;0
FR;8;2021-11-30;0;0;0;0;0;0;0;0;0;0
FR;8;2021-12-01;0;0;0;0;0;0;0;0;0;0
FR;8;2021-12-02;0;0;0;0;0;0;0;0;0;0
FR;8;2021-12-03;0;0;0;0;0;0;0;0;0;0
FR;8;2021-12-04;0;0;0;0;0;0;0;0;0;0
FR;8;2021-12-05;0;0;0;0;0;0;0;0;0;0
FR;8;2021-12-06;0;0;0;0;0;0;0;0;0;0
FR;8;2021-12-07;0;0;0;0;0;0;0;0;0;0
FR;8;2021-12-08;0;0;0;0;0;0;0;0;0;0
FR;8;2021-12-09;0;0;0;0;0;0;0;0;0;0
FR;8;2021-12-10;0;0;0;0;0;0;0;0;0;0
FR;8;2021-12-11;0;0;0;0;0;0;0;0;0;0
FR;8;2021-12-12;0;0;0;0;0;0;0;0;0;0
FR;8;2021-12-13;0;0;0;0;0;0;0;0;0;0
FR;8;2021-12-14;0;0;0;0;0;0;0;0;0;0
FR;8;2021-12-15;0;0;0;0;0;0;0;0;0;0
FR;8;2021-12-16;0;0;0;0;0;0;0;0;0;0
FR;8;2021-12-17;0;0;0;0;0;0;0;0;0;0
FR;8;2021-12-18;0;0;0;0;0;0;0;0;0;0
FR;8;2021-12-19;0;0;0;0;0;0;0;0;0;0
FR;8;2021-12-20;0;0;0;0;0;0;0;0;0;0
FR;8;2021-12-21;0;0;0;0;0;0;0;0;0;0
FR;8;2021-12-22;0;0;0;0;0;0;0;0;0;0
FR;8;2021-12-23;0;0;0;0;0;0;0;0;0;0
FR;8;2021-12-24;0;0;0;0;0;0;0;0;0;0
FR;8;2021-12-25;0;0;0;0;0;0;0;0;0;0
FR;8;2021-12-26;0;0;0;0;0;0;0;0;0;0
FR;8;2021-12-27;0;0;0;0;0;0;0;0;0;0
FR;8;2021-12-28;0;0;0;0;0;0;0;0;0;0
FR;8;2021-12-29;0;0;0;0;0;0;0;0;0;0
FR;8;2021-12-30;0;0;0;0;0;0;0;0;0;0
FR;8;2021-12-31;0;0;0;0;0;0;0;0;0;0
FR;8;2022-01-01;0;0;0;0;0;0;0;0;0;0
FR;8;2022-01-02;0;0;0;0;0;0;0;0;0;0
FR;8;2022-01-03;0;0;0;0;0;0;0;0;0;0
FR;8;2022-01-04;0;0;0;0;0;0;0;0;0;0
FR;8;2022-01-05;0;0;0;0;0;0;0;0;0;0
FR;8;2022-01-06;0;0;0;0;0;0;0;0;0;0
FR;8;2022-01-07;0;0;0;0;0;0;0;0;0;0
FR;8;2022-01-08;0;0;0;0;0;0;0;0;0;0
FR;8;2022-01-09;0;0;0;0;0;0;0;0;0;0
FR;8;2022-01-10;0;0;0;0;0;0;0;0;0;0
FR;8;2022-01-11;0;0;0;0;0;0;0;0;0;0
FR;8;2022-01-12;0;0;0;0;0;0;0;0;0;0
FR;8;2022-01-13;0;0;0;0;0;0;0;0;0;0
FR;8;2022-01-14;0;0;0;0;0;0;0;0;0;0
FR;8;2022-01-15;0;0;0;0;0;0;0;0;0;0
FR;8;2022-01-16;0;0;0;0;0;0;0;0;0;0
FR;8;2022-01-17;0;0;0;0;0;0;0;0;0;0
FR;8;2022-01-18;0;0;0;0;0;0;0;0;0;0
FR;8;2022-01-19;0;0;0;0;0;0;0;0;0;0
FR;8;2022-01-20;0;0;0;0;0;0;0;0;0;0
FR;8;2022-01-21;0;0;0;0;0;0;0;0;0;0
FR;8;2022-01-22;0;0;0;0;0;0;0;0;0;0
FR;8;2022-01-23;0;0;0;0;0;0;0;0;0;0
FR;8;2022-01-24;0;0;0;0;0;0;0;0;0;0
FR;8;2022-01-25;0;0;0;0;0;0;0;0;0;0
FR;8;2022-01-26;0;0;0;0;0;0;0;0;0;0
FR;8;2022-01-27;0;0;0;0;0;0;0;0;0;0
FR;8;2022-01-28;0;0;0;0;0;0;0;0;0;0
FR;8;2022-01-29;0;0;0;0;0;0;0;0;0;0
FR;8;2022-01-30;0;0;0;0;0;0;0;0;0;0
FR;8;2022-01-31;0;0;0;0;0;0;0;0;0;0
FR;8;2022-02-01;0;0;0;0;0;0;0;0;0;0
FR;8;2022-02-02;0;0;0;0;0;0;0;0;0;0
FR;8;2022-02-03;0;0;0;0;0;0;0;0;0;0
FR;8;2022-02-04;0;0;0;0;0;0;0;0;0;0
FR;8;2022-02-05;0;0;0;0;0;0;0;0;0;0
FR;8;2022-02-06;0;0;0;0;0;0;0;0;0;0
FR;8;2022-02-07;0;0;0;0;0;0;0;0;0;0
FR;8;2022-02-08;0;0;0;0;0;0;0;0;0;0
FR;8;2022-02-09;0;0;0;0;0;0;0;0;0;0
FR;8;2022-02-10;0;0;0;0;0;0;0;0;0;0
FR;8;2022-02-11;0;0;0;0;0;0;0;0;0;0
FR;8;2022-02-12;0;0;0;0;0;0;0;0;0;0
FR;8;2022-02-13;0;0;0;0;0;0;0;0;0;0
FR;8;2022-02-14;0;0;0;0;0;0;0;0;0;0
FR;8;2022-02-15;0;0;0;0;0;0;0;0;0;0
FR;8;2022-02-16;0;0;0;0;0;0;0;0;0;0
FR;8;2022-02-17;0;0;0;0;0;0;0;0;0;0
FR;8;2022-02-18;0;0;0;0;0;0;0;0;0;0
FR;8;2022-02-19;0;0;0;0;0;0;0;0;0;0
FR;8;2022-02-20;0;0;0;0;0;0;0;0;0;0
FR;8;2022-02-21;0;0;0;0;0;0;0;0;0;0
FR;8;2022-02-22;0;0;0;0;0;0;0;0;0;0
FR;8;2022-02-23;0;0;0;0;0;0;0;0;0;0
FR;8;2022-02-24;0;0;0;0;0;0;0;0;0;0
FR;8;2022-02-25;0;0;0;0;0;0;0;0;0;0
FR;8;2022-02-26;0;0;0;0;0;0;0;0;0;0
FR;8;2022-02-27;0;0;0;0;0;0;0;0;0;0
FR;8;2022-02-28;0;0;0;0;0;0;0;0;0;0
FR;8;2022-03-01;0;0;0;0;0;0;0;0;0;0
FR;8;2022-03-02;0;0;0;0;0;0;0;0;0;0
FR;8;2022-03-03;0;0;0;0;0;0;0;0;0;0
FR;8;2022-03-04;0;0;0;0;0;0;0;0;0;0
FR;8;2022-03-05;0;0;0;0;0;0;0;0;0;0
FR;8;2022-03-06;0;0;0;0;0;0;0;0;0;0
FR;8;2022-03-07;0;0;0;0;0;0;0;0;0;0
FR;8;2022-03-08;0;0;0;0;0;0;0;0;0;0
FR;8;2022-03-09;0;0;0;0;0;0;0;0;0;0
FR;8;2022-03-10;0;0;0;0;0;0;0;0;0;0
FR;8;2022-03-11;0;0;0;0;0;0;0;0;0;0
FR;8;2022-03-12;0;0;0;0;0;0;0;0;0;0
FR;8;2022-03-13;0;0;0;0;0;0;0;0;0;0
FR;8;2022-03-14;0;0;0;0;0;0;0;0;0;0
FR;8;2022-03-15;0;0;0;0;0;0;0;0;0;0
FR;8;2022-03-16;0;0;0;0;0;0;0;0;0;0
FR;8;2022-03-17;0;0;0;0;0;0;0;0;0;0
FR;8;2022-03-18;0;0;0;0;0;0;0;0;0;0
FR;8;2022-03-19;0;0;0;0;0;0;0;0;0;0
FR;8;2022-03-20;0;0;0;0;0;0;0;0;0;0
FR;8;2022-03-21;0;0;0;0;0;0;0;0;0;0
FR;8;2022-03-22;0;0;0;0;0;0;0;0;0;0
FR;8;2022-03-23;0;0;0;0;0;0;0;0;0;0
FR;8;2022-03-24;0;0;0;0;0;0;0;0;0;0
FR;8;2022-03-25;0;0;0;0;0;0;0;0;0;0
FR;8;2022-03-26;0;0;0;0;0;0;0;0;0;0
FR;8;2022-03-27;0;0;0;0;0;0;0;0;0;0
FR;8;2022-03-28;0;0;0;0;0;0;0;0;0;0
FR;8;2022-03-29;0;0;0;0;0;0;0;0;0;0
FR;8;2022-03-30;0;0;0;0;0;0;0;0;0;0
FR;8;2022-03-31;0;0;0;0;0;0;0;0;0;0
FR;8;2022-04-01;0;0;0;0;0;0;0;0;0;0
FR;8;2022-04-02;0;0;0;0;0;0;0;0;0;0
FR;8;2022-04-03;0;0;0;0;0;0;0;0;0;0
FR;8;2022-04-04;0;0;0;0;0;0;0;0;0;0
FR;8;2022-04-05;0;0;0;0;0;0;0;0;0;0
FR;8;2022-04-06;0;0;0;0;0;0;0;0;0;0
FR;8;2022-04-07;0;0;0;0;0;0;0;0;0;0
FR;8;2022-04-08;0;0;0;0;0;0;0;0;0;0
FR;8;2022-04-09;0;0;0;0;0;0;0;0;0;0
FR;8;2022-04-10;0;0;0;0;0;0;0;0;0;0
FR;8;2022-04-11;0;0;0;0;0;0;0;0;0;0
FR;8;2022-04-12;0;0;0;0;0;0;0;0;0;0
FR;8;2022-04-13;0;0;0;0;0;0;0;0;0;0
FR;8;2022-04-14;0;0;0;0;0;0;0;0;0;0
FR;8;2022-04-15;0;0;0;0;0;0;0;0;0;0
FR;8;2022-04-16;0;0;0;0;0;0;0;0;0;0
FR;8;2022-04-17;0;0;0;0;0;0;0;0;0;0
FR;8;2022-04-18;0;0;0;0;0;0;0;0;0;0
FR;8;2022-04-19;0;0;0;0;0;0;0;0;0;0
FR;8;2022-04-20;0;0;0;0;0;0;0;0;0;0
FR;8;2022-04-21;0;0;0;0;0;0;0;0;0;0
FR;8;2022-04-22;0;0;0;0;0;0;0;0;0;0
FR;8;2022-04-23;0;0;0;0;0;0;0;0;0;0
FR;8;2022-04-24;0;0;0;0;0;0;0;0;0;0
FR;8;2022-04-25;0;0;0;0;0;0;0;0;0;0
FR;8;2022-04-26;0;0;0;0;0;0;0;0;0;0
FR;8;2022-04-27;0;0;0;0;0;0;0;0;0;0
FR;8;2022-04-28;0;0;0;0;0;0;0;0;0;0
FR;8;2022-04-29;0;0;0;0;0;0;0;0;0;0
FR;8;2022-04-30;0;0;0;0;0;0;0;0;0;0
FR;8;2022-05-01;0;0;0;0;0;0;0;0;0;0
FR;8;2022-05-02;0;0;0;0;0;0;0;0;0;0
FR;8;2022-05-03;0;0;0;0;0;0;0;0;0;0
FR;8;2022-05-04;0;0;0;0;0;0;0;0;0;0
FR;8;2022-05-05;0;0;0;0;0;0;0;0;0;0
FR;8;2022-05-06;0;0;0;0;0;0;0;0;0;0
FR;8;2022-05-07;0;0;0;0;0;0;0;0;0;0
FR;8;2022-05-08;0;0;0;0;0;0;0;0;0;0
FR;8;2022-05-09;0;0;0;0;0;0;0;0;0;0
FR;8;2022-05-10;0;0;0;0;0;0;0;0;0;0
FR;8;2022-05-11;0;0;0;0;0;0;0;0;0;0
FR;8;2022-05-12;0;0;0;0;0;0;0;0;0;0
FR;8;2022-05-13;0;0;0;0;0;0;0;0;0;0
FR;8;2022-05-14;0;0;0;0;0;0;0;0;0;0
FR;8;2022-05-15;0;0;0;0;0;0;0;0;0;0
FR;8;2022-05-16;0;0;0;0;0;0;0;0;0;0
FR;8;2022-05-17;0;0;0;0;0;0;0;0;0;0
FR;8;2022-05-18;0;0;0;0;0;0;0;0;0;0
FR;8;2022-05-19;0;0;0;0;0;0;0;0;0;0
FR;8;2022-05-20;0;0;0;0;0;0;0;0;0;0
FR;8;2022-05-21;0;0;0;0;0;0;0;0;0;0
FR;8;2022-05-22;0;0;0;0;0;0;0;0;0;0
FR;8;2022-05-23;0;0;0;0;0;0;0;0;0;0
FR;8;2022-05-24;0;0;0;0;0;0;0;0;0;0
FR;8;2022-05-25;0;0;0;0;0;0;0;0;0;0
FR;8;2022-05-26;0;0;0;0;0;0;0;0;0;0
FR;8;2022-05-27;0;0;0;0;0;0;0;0;0;0
FR;8;2022-05-28;0;0;0;0;0;0;0;0;0;0
FR;8;2022-05-29;0;0;0;0;0;0;0;0;0;0
FR;8;2022-05-30;0;0;0;0;0;0;0;0;0;0
FR;8;2022-05-31;0;0;0;0;0;0;0;0;0;0
FR;8;2022-06-01;0;0;0;0;0;0;0;0;0;0
FR;8;2022-06-02;0;0;0;0;0;0;0;0;0;0
FR;8;2022-06-03;0;0;0;0;0;0;0;0;0;0
FR;8;2022-06-04;0;0;0;0;0;0;0;0;0;0
FR;8;2022-06-05;0;0;0;0;0;0;0;0;0;0
FR;8;2022-06-06;0;0;0;0;0;0;0;0;0;0
FR;8;2022-06-07;0;0;0;0;0;0;0;0;0;0
FR;8;2022-06-08;0;0;0;0;0;0;0;0;0;0
FR;8;2022-06-09;0;0;0;0;0;0;0;0;0;0
FR;8;2022-06-10;0;0;0;0;0;0;0;0;0;0
FR;8;2022-06-11;0;0;0;0;0;0;0;0;0;0
FR;8;2022-06-12;0;0;0;0;0;0;0;0;0;0
FR;8;2022-06-13;0;0;0;0;0;0;0;0;0;0
FR;8;2022-06-14;0;0;0;0;0;0;0;0;0;0
FR;8;2022-06-15;0;0;0;0;0;0;0;0;0;0
FR;8;2022-06-16;0;0;0;0;0;0;0;0;0;0
FR;8;2022-06-17;0;0;0;0;0;0;0;0;0;0
FR;8;2022-06-18;0;0;0;0;0;0;0;0;0;0
FR;8;2022-06-19;0;0;0;0;0;0;0;0;0;0
FR;8;2022-06-20;0;0;0;0;0;0;0;0;0;0
FR;8;2022-06-21;0;0;0;0;0;0;0;0;0;0
FR;8;2022-06-22;0;0;0;0;0;0;0;0;0;0
FR;8;2022-06-23;0;0;0;0;0;0;0;0;0;0
FR;8;2022-06-24;0;0;0;0;0;0;0;0;0;0
FR;8;2022-06-25;0;0;0;0;0;0;0;0;0;0
FR;8;2022-06-26;0;0;0;0;0;0;0;0;0;0
FR;8;2022-06-27;0;0;0;0;0;0;0;0;0;0
FR;8;2022-06-28;0;0;0;0;0;0;0;0;0;0
FR;8;2022-06-29;0;0;0;0;0;0;0;0;0;0
FR;8;2022-06-30;0;0;0;0;0;0;0;0;0;0
FR;8;2022-07-01;0;0;0;0;0;0;0;0;0;0
FR;8;2022-07-02;0;0;0;0;0;0;0;0;0;0
FR;8;2022-07-03;0;0;0;0;0;0;0;0;0;0
FR;8;2022-07-04;0;0;0;0;0;0;0;0;0;0
FR;8;2022-07-05;0;0;0;0;0;0;0;0;0;0
FR;8;2022-07-06;0;0;0;0;0;0;0;0;0;0
FR;8;2022-07-07;0;0;0;0;0;0;0;0;0;0
FR;8;2022-07-08;0;0;0;0;0;0;0;0;0;0
FR;8;2022-07-09;0;0;0;0;0;0;0;0;0;0
FR;8;2022-07-10;0;0;0;0;0;0;0;0;0;0
FR;8;2022-07-11;0;0;0;0;0;0;0;0;0;0
FR;8;2022-07-12;0;0;0;0;0;0;0;0;0;0
FR;8;2022-07-13;0;0;0;0;0;0;0;0;0;0
FR;8;2022-07-14;0;0;0;0;0;0;0;0;0;0
FR;8;2022-07-15;0;0;0;0;0;0;0;0;0;0
FR;8;2022-07-16;0;0;0;0;0;0;0;0;0;0
FR;8;2022-07-17;0;0;0;0;0;0;0;0;0;0
FR;8;2022-07-18;0;0;0;0;0;0;0;0;0;0
FR;8;2022-07-19;0;0;0;0;0;0;0;0;0;0
FR;8;2022-07-20;0;0;0;0;0;0;0;0;0;0
FR;8;2022-07-21;0;0;0;0;0;0;0;0;0;0
FR;8;2022-07-22;0;0;0;0;0;0;0;0;0;0
FR;8;2022-07-23;0;0;0;0;0;0;0;0;0;0
FR;8;2022-07-24;0;0;0;0;0;0;0;0;0;0
FR;8;2022-07-25;0;0;0;0;0;0;0;0;0;0
FR;8;2022-07-26;0;0;0;0;0;0;0;0;0;0
FR;8;2022-07-27;0;0;0;0;0;0;0;0;0;0
FR;8;2022-07-28;0;0;0;0;0;0;0;0;0;0
FR;8;2022-07-29;0;0;0;0;0;0;0;0;0;0
FR;8;2022-07-30;0;0;0;0;0;0;0;0;0;0
FR;8;2022-07-31;0;0;0;0;0;0;0;0;0;0
FR;8;2022-08-01;0;0;0;0;0;0;0;0;0;0
FR;8;2022-08-02;0;0;0;0;0;0;0;0;0;0
FR;8;2022-08-03;0;0;0;0;0;0;0;0;0;0
FR;8;2022-08-04;0;0;0;0;0;0;0;0;0;0
FR;8;2022-08-05;0;0;0;0;0;0;0;0;0;0
FR;8;2022-08-06;0;0;0;0;0;0;0;0;0;0
FR;8;2022-08-07;0;0;0;0;0;0;0;0;0;0
FR;8;2022-08-08;0;0;0;0;0;0;0;0;0;0
FR;8;2022-08-09;0;0;0;0;0;0;0;0;0;0
FR;8;2022-08-10;0;0;0;0;0;0;0;0;0;0
FR;8;2022-08-11;0;0;0;0;0;0;0;0;0;0
FR;8;2022-08-12;0;0;0;0;0;0;0;0;0;0
FR;8;2022-08-13;0;0;0;0;0;0;0;0;0;0
FR;8;2022-08-14;0;0;0;0;0;0;0;0;0;0
FR;8;2022-08-15;0;0;0;0;0;0;0;0;0;0
FR;8;2022-08-16;0;0;0;0;0;0;0;0;0;0
FR;8;2022-08-17;0;0;0;0;0;0;0;0;0;0
FR;8;2022-08-18;0;0;0;0;0;0;0;0;0;0
FR;8;2022-08-19;0;0;0;0;0;0;0;0;0;0
FR;8;2022-08-20;0;0;0;0;0;0;0;0;0;0
FR;8;2022-08-21;0;0;0;0;0;0;0;0;0;0
FR;8;2022-08-22;0;0;0;0;0;0;0;0;0;0
FR;8;2022-08-23;0;0;0;0;0;0;0;0;0;0
FR;8;2022-08-24;0;0;0;0;0;0;0;0;0;0
FR;8;2022-08-25;0;0;0;0;0;0;0;0;0;0
FR;8;2022-08-26;0;0;0;0;0;0;0;0;0;0
FR;8;2022-08-27;0;0;0;0;0;0;0;0;0;0
FR;8;2022-08-28;0;0;0;0;0;0;0;0;0;0
FR;8;2022-08-29;0;0;0;0;0;0;0;0;0;0
FR;8;2022-08-30;0;0;0;0;0;0;0;0;0;0
FR;8;2022-08-31;0;0;0;0;0;0;0;0;0;0
FR;8;2022-09-01;0;0;0;0;0;0;0;0;0;0
FR;8;2022-09-02;0;0;0;0;0;0;0;0;0;0
FR;8;2022-09-03;0;0;0;0;0;0;0;0;0;0
FR;8;2022-09-04;0;0;0;0;0;0;0;0;0;0
FR;8;2022-09-05;0;0;0;0;0;0;0;0;0;0
FR;8;2022-09-06;0;0;0;0;0;0;0;0;0;0
FR;8;2022-09-07;0;0;0;0;0;0;0;0;0;0
FR;8;2022-09-08;0;0;0;0;0;0;0;0;0;0
FR;8;2022-09-09;0;0;0;0;0;0;0;0;0;0
FR;8;2022-09-10;0;0;0;0;0;0;0;0;0;0
FR;8;2022-09-11;0;0;0;0;0;0;0;0;0;0
FR;8;2022-09-12;0;0;0;0;0;0;0;0;0;0
FR;8;2022-09-13;0;0;0;0;0;0;0;0;0;0
FR;8;2022-09-14;0;0;0;0;0;0;0;0;0;0
FR;8;2022-09-15;0;0;0;0;0;0;0;0;0;0
FR;8;2022-09-16;0;0;0;0;0;0;0;0;0;0
FR;8;2022-09-17;0;0;0;0;0;0;0;0;0;0
FR;8;2022-09-18;0;0;0;0;0;0;0;0;0;0
FR;8;2022-09-19;0;0;0;0;0;0;0;0;0;0
FR;8;2022-09-20;0;0;0;0;0;0;0;0;0;0
FR;8;2022-09-21;0;0;0;0;0;0;0;0;0;0
FR;8;2022-09-22;0;0;0;0;0;0;0;0;0;0
FR;8;2022-09-23;0;0;0;0;0;0;0;0;0;0
FR;8;2022-09-24;0;0;0;0;0;0;0;0;0;0
FR;8;2022-09-25;0;0;0;0;0;0;0;0;0;0
FR;8;2022-09-26;0;0;0;0;0;0;0;0;0;0
FR;8;2022-09-27;0;0;0;0;0;0;0;0;0;0
FR;8;2022-09-28;0;0;0;0;0;0;0;0;0;0
FR;8;2022-09-29;0;0;0;0;0;0;0;0;0;0
FR;8;2022-09-30;0;0;0;0;0;0;0;0;0;0
FR;8;2022-10-01;0;0;0;0;0;0;0;0;0;0
FR;8;2022-10-02;0;0;0;0;0;0;0;0;0;0
FR;8;2022-10-03;0;0;0;0;0;0;0;0;0;0
FR;8;2022-10-04;0;0;0;0;0;0;0;0;0;0
FR;8;2022-10-05;0;0;0;0;0;0;0;0;0;0
FR;8;2022-10-06;7;17;108;838;78;7;17;108;838;78
FR;8;2022-10-07;68;99;837;7991;696;75;116;945;8829;774
FR;8;2022-10-08;35;116;608;4029;515;110;232;1553;12858;1289
FR;8;2022-10-09;17;22;144;879;131;127;254;1697;13737;1420
FR;8;2022-10-10;114;190;1322;12539;1014;241;444;3019;26276;2434
FR;8;2022-10-11;170;258;2468;26704;2000;411;702;5487;52980;4434
FR;8;2022-10-12;143;245;1821;18129;1433;554;947;7308;71109;5867
FR;8;2022-10-13;200;272;2483;27867;1875;754;1219;9791;98976;7742
FR;8;2022-10-14;253;415;3255;36073;2541;1007;1634;13046;135049;10283
FR;8;2022-10-15;100;176;1184;8746;988;1107;1810;14230;143795;11271
FR;8;2022-10-16;34;53;241;1507;206;1141;1863;14471;145302;11477
FR;8;2022-10-17;151;303;2062;21552;1593;1292;2166;16533;166854;13070
FR;8;2022-10-18;260;343;3312;37460;2615;1552;2509;19845;204314;15685
FR;8;2022-10-19;186;300;2590;27994;2132;1738;2809;22435;232308;17817
FR;8;2022-10-20;241;350;3511;40439;2559;1979;3159;25946;272747;20376
FR;8;2022-10-21;316;478;4371;48813;3360;2295;3637;30317;321560;23736
FR;8;2022-10-22;117;160;1208;10537;902;2412;3797;31525;332097;24638
FR;8;2022-10-23;48;50;255;1723;190;2460;3847;31780;333820;24828
FR;8;2022-10-24;214;299;2402;23363;1949;2674;4146;34182;357183;26777
FR;8;2022-10-25;294;395;3897;41769;2951;2968;4541;38079;398952;29728
FR;8;2022-10-26;194;317;2655;26667;2156;3162;4858;40734;425619;31884
FR;9;2020-12-27;0;0;0;0;0;0;0;0;0;0
FR;9;2020-12-28;0;0;0;0;0;0;0;0;0;0
FR;9;2020-12-29;0;0;0;0;0;0;0;0;0;0
FR;9;2020-12-30;0;0;0;0;0;0;0;0;0;0
FR;9;2020-12-31;0;0;0;0;0;0;0;0;0;0
FR;9;2021-01-01;0;0;0;0;0;0;0;0;0;0
FR;9;2021-01-02;0;0;0;0;0;0;0;0;0;0
FR;9;2021-01-03;0;0;0;0;0;0;0;0;0;0
FR;9;2021-01-04;0;0;0;0;0;0;0;0;0;0
FR;9;2021-01-05;0;0;0;0;0;0;0;0;0;0
FR;9;2021-01-06;0;0;0;0;0;0;0;0;0;0
FR;9;2021-01-07;0;0;0;0;0;0;0;0;0;0
FR;9;2021-01-08;0;0;0;0;0;0;0;0;0;0
FR;9;2021-01-09;0;0;0;0;0;0;0;0;0;0
FR;9;2021-01-10;0;0;0;0;0;0;0;0;0;0
FR;9;2021-01-11;0;0;0;0;0;0;0;0;0;0
FR;9;2021-01-12;0;0;0;0;0;0;0;0;0;0
FR;9;2021-01-13;0;0;0;0;0;0;0;0;0;0
FR;9;2021-01-14;0;0;0;0;0;0;0;0;0;0
FR;9;2021-01-15;0;0;0;0;0;0;0;0;0;0
FR;9;2021-01-16;0;0;0;0;0;0;0;0;0;0
FR;9;2021-01-17;0;0;0;0;0;0;0;0;0;0
FR;9;2021-01-18;0;0;0;0;0;0;0;0;0;0
FR;9;2021-01-19;0;0;0;0;0;0;0;0;0;0
FR;9;2021-01-20;0;0;0;0;0;0;0;0;0;0
FR;9;2021-01-21;0;0;0;0;0;0;0;0;0;0
FR;9;2021-01-22;0;0;0;0;0;0;0;0;0;0
FR;9;2021-01-23;0;0;0;0;0;0;0;0;0;0
FR;9;2021-01-24;0;0;0;0;0;0;0;0;0;0
FR;9;2021-01-25;0;0;0;0;0;0;0;0;0;0
FR;9;2021-01-26;0;0;0;0;0;0;0;0;0;0
FR;9;2021-01-27;0;0;0;0;0;0;0;0;0;0
FR;9;2021-01-28;0;0;0;0;0;0;0;0;0;0
FR;9;2021-01-29;0;0;0;0;0;0;0;0;0;0
FR;9;2021-01-30;0;0;0;0;0;0;0;0;0;0
FR;9;2021-01-31;0;0;0;0;0;0;0;0;0;0
FR;9;2021-02-01;0;0;0;0;0;0;0;0;0;0
FR;9;2021-02-02;0;0;0;0;0;0;0;0;0;0
FR;9;2021-02-03;0;0;0;0;0;0;0;0;0;0
FR;9;2021-02-04;0;0;0;0;0;0;0;0;0;0
FR;9;2021-02-05;0;0;0;0;0;0;0;0;0;0
FR;9;2021-02-06;0;0;0;0;0;0;0;0;0;0
FR;9;2021-02-07;0;0;0;0;0;0;0;0;0;0
FR;9;2021-02-08;0;0;0;0;0;0;0;0;0;0
FR;9;2021-02-09;0;0;0;0;0;0;0;0;0;0
FR;9;2021-02-10;0;0;0;0;0;0;0;0;0;0
FR;9;2021-02-11;0;0;0;0;0;0;0;0;0;0
FR;9;2021-02-12;0;0;0;0;0;0;0;0;0;0
FR;9;2021-02-13;0;0;0;0;0;0;0;0;0;0
FR;9;2021-02-14;0;0;0;0;0;0;0;0;0;0
FR;9;2021-02-15;0;0;0;0;0;0;0;0;0;0
FR;9;2021-02-16;0;0;0;0;0;0;0;0;0;0
FR;9;2021-02-17;0;0;0;0;0;0;0;0;0;0
FR;9;2021-02-18;0;0;0;0;0;0;0;0;0;0
FR;9;2021-02-19;0;0;0;0;0;0;0;0;0;0
FR;9;2021-02-20;0;0;0;0;0;0;0;0;0;0
FR;9;2021-02-21;0;0;0;0;0;0;0;0;0;0
FR;9;2021-02-22;0;0;0;0;0;0;0;0;0;0
FR;9;2021-02-23;0;0;0;0;0;0;0;0;0;0
FR;9;2021-02-24;0;0;0;0;0;0;0;0;0;0
FR;9;2021-02-25;0;0;0;0;0;0;0;0;0;0
FR;9;2021-02-26;0;0;0;0;0;0;0;0;0;0
FR;9;2021-02-27;0;0;0;0;0;0;0;0;0;0
FR;9;2021-02-28;0;0;0;0;0;0;0;0;0;0
FR;9;2021-03-01;0;0;0;0;0;0;0;0;0;0
FR;9;2021-03-02;0;0;0;0;0;0;0;0;0;0
FR;9;2021-03-03;0;0;0;0;0;0;0;0;0;0
FR;9;2021-03-04;0;0;0;0;0;0;0;0;0;0
FR;9;2021-03-05;0;0;0;0;0;0;0;0;0;0
FR;9;2021-03-06;0;0;0;0;0;0;0;0;0;0
FR;9;2021-03-07;0;0;0;0;0;0;0;0;0;0
FR;9;2021-03-08;0;0;0;0;0;0;0;0;0;0
FR;9;2021-03-09;0;0;0;0;0;0;0;0;0;0
FR;9;2021-03-10;0;0;0;0;0;0;0;0;0;0
FR;9;2021-03-11;0;0;0;0;0;0;0;0;0;0
FR;9;2021-03-12;0;0;0;0;0;0;0;0;0;0
FR;9;2021-03-13;0;0;0;0;0;0;0;0;0;0
FR;9;2021-03-14;0;0;0;0;0;0;0;0;0;0
FR;9;2021-03-15;0;0;0;0;0;0;0;0;0;0
FR;9;2021-03-16;0;0;0;0;0;0;0;0;0;0
FR;9;2021-03-17;0;0;0;0;0;0;0;0;0;0
FR;9;2021-03-18;0;0;0;0;0;0;0;0;0;0
FR;9;2021-03-19;0;0;0;0;0;0;0;0;0;0
FR;9;2021-03-20;0;0;0;0;0;0;0;0;0;0
FR;9;2021-03-21;0;0;0;0;0;0;0;0;0;0
FR;9;2021-03-22;0;0;0;0;0;0;0;0;0;0
FR;9;2021-03-23;0;0;0;0;0;0;0;0;0;0
FR;9;2021-03-24;0;0;0;0;0;0;0;0;0;0
FR;9;2021-03-25;0;0;0;0;0;0;0;0;0;0
FR;9;2021-03-26;0;0;0;0;0;0;0;0;0;0
FR;9;2021-03-27;0;0;0;0;0;0;0;0;0;0
FR;9;2021-03-28;0;0;0;0;0;0;0;0;0;0
FR;9;2021-03-29;0;0;0;0;0;0;0;0;0;0
FR;9;2021-03-30;0;0;0;0;0;0;0;0;0;0
FR;9;2021-03-31;0;0;0;0;0;0;0;0;0;0
FR;9;2021-04-01;0;0;0;0;0;0;0;0;0;0
FR;9;2021-04-02;0;0;0;0;0;0;0;0;0;0
FR;9;2021-04-03;0;0;0;0;0;0;0;0;0;0
FR;9;2021-04-04;0;0;0;0;0;0;0;0;0;0
FR;9;2021-04-05;0;0;0;0;0;0;0;0;0;0
FR;9;2021-04-06;0;0;0;0;0;0;0;0;0;0
FR;9;2021-04-07;0;0;0;0;0;0;0;0;0;0
FR;9;2021-04-08;0;0;0;0;0;0;0;0;0;0
FR;9;2021-04-09;0;0;0;0;0;0;0;0;0;0
FR;9;2021-04-10;0;0;0;0;0;0;0;0;0;0
FR;9;2021-04-11;0;0;0;0;0;0;0;0;0;0
FR;9;2021-04-12;0;0;0;0;0;0;0;0;0;0
FR;9;2021-04-13;0;0;0;0;0;0;0;0;0;0
FR;9;2021-04-14;0;0;0;0;0;0;0;0;0;0
FR;9;2021-04-15;0;0;0;0;0;0;0;0;0;0
FR;9;2021-04-16;0;0;0;0;0;0;0;0;0;0
FR;9;2021-04-17;0;0;0;0;0;0;0;0;0;0
FR;9;2021-04-18;0;0;0;0;0;0;0;0;0;0
FR;9;2021-04-19;0;0;0;0;0;0;0;0;0;0
FR;9;2021-04-20;0;0;0;0;0;0;0;0;0;0
FR;9;2021-04-21;0;0;0;0;0;0;0;0;0;0
FR;9;2021-04-22;0;0;0;0;0;0;0;0;0;0
FR;9;2021-04-23;0;0;0;0;0;0;0;0;0;0
FR;9;2021-04-24;0;0;0;0;0;0;0;0;0;0
FR;9;2021-04-25;0;0;0;0;0;0;0;0;0;0
FR;9;2021-04-26;0;0;0;0;0;0;0;0;0;0
FR;9;2021-04-27;0;0;0;0;0;0;0;0;0;0
FR;9;2021-04-28;0;0;0;0;0;0;0;0;0;0
FR;9;2021-04-29;0;0;0;0;0;0;0;0;0;0
FR;9;2021-04-30;0;0;0;0;0;0;0;0;0;0
FR;9;2021-05-01;0;0;0;0;0;0;0;0;0;0
FR;9;2021-05-02;0;0;0;0;0;0;0;0;0;0
FR;9;2021-05-03;0;0;0;0;0;0;0;0;0;0
FR;9;2021-05-04;0;0;0;0;0;0;0;0;0;0
FR;9;2021-05-05;0;0;0;0;0;0;0;0;0;0
FR;9;2021-05-06;0;0;0;0;0;0;0;0;0;0
FR;9;2021-05-07;0;0;0;0;0;0;0;0;0;0
FR;9;2021-05-08;0;0;0;0;0;0;0;0;0;0
FR;9;2021-05-09;0;0;0;0;0;0;0;0;0;0
FR;9;2021-05-10;0;0;0;0;0;0;0;0;0;0
FR;9;2021-05-11;0;0;0;0;0;0;0;0;0;0
FR;9;2021-05-12;0;0;0;0;0;0;0;0;0;0
FR;9;2021-05-13;0;0;0;0;0;0;0;0;0;0
FR;9;2021-05-14;0;0;0;0;0;0;0;0;0;0
FR;9;2021-05-15;0;0;0;0;0;0;0;0;0;0
FR;9;2021-05-16;0;0;0;0;0;0;0;0;0;0
FR;9;2021-05-17;0;0;0;0;0;0;0;0;0;0
FR;9;2021-05-18;0;0;0;0;0;0;0;0;0;0
FR;9;2021-05-19;0;0;0;0;0;0;0;0;0;0
FR;9;2021-05-20;0;0;0;0;0;0;0;0;0;0
FR;9;2021-05-21;0;0;0;0;0;0;0;0;0;0
FR;9;2021-05-22;0;0;0;0;0;0;0;0;0;0
FR;9;2021-05-23;0;0;0;0;0;0;0;0;0;0
FR;9;2021-05-24;0;0;0;0;0;0;0;0;0;0
FR;9;2021-05-25;0;0;0;0;0;0;0;0;0;0
FR;9;2021-05-26;0;0;0;0;0;0;0;0;0;0
FR;9;2021-05-27;0;0;0;0;0;0;0;0;0;0
FR;9;2021-05-28;0;0;0;0;0;0;0;0;0;0
FR;9;2021-05-29;0;0;0;0;0;0;0;0;0;0
FR;9;2021-05-30;0;0;0;0;0;0;0;0;0;0
FR;9;2021-05-31;0;0;0;0;0;0;0;0;0;0
FR;9;2021-06-01;0;0;0;0;0;0;0;0;0;0
FR;9;2021-06-02;0;0;0;0;0;0;0;0;0;0
FR;9;2021-06-03;0;0;0;0;0;0;0;0;0;0
FR;9;2021-06-04;0;0;0;0;0;0;0;0;0;0
FR;9;2021-06-05;0;0;0;0;0;0;0;0;0;0
FR;9;2021-06-06;0;0;0;0;0;0;0;0;0;0
FR;9;2021-06-07;0;0;0;0;0;0;0;0;0;0
FR;9;2021-06-08;0;0;0;0;0;0;0;0;0;0
FR;9;2021-06-09;0;0;0;0;0;0;0;0;0;0
FR;9;2021-06-10;0;0;0;0;0;0;0;0;0;0
FR;9;2021-06-11;0;0;0;0;0;0;0;0;0;0
FR;9;2021-06-12;0;0;0;0;0;0;0;0;0;0
FR;9;2021-06-13;0;0;0;0;0;0;0;0;0;0
FR;9;2021-06-14;0;0;0;0;0;0;0;0;0;0
FR;9;2021-06-15;0;0;0;0;0;0;0;0;0;0
FR;9;2021-06-16;0;0;0;0;0;0;0;0;0;0
FR;9;2021-06-17;0;0;0;0;0;0;0;0;0;0
FR;9;2021-06-18;0;0;0;0;0;0;0;0;0;0
FR;9;2021-06-19;0;0;0;0;0;0;0;0;0;0
FR;9;2021-06-20;0;0;0;0;0;0;0;0;0;0
FR;9;2021-06-21;0;0;0;0;0;0;0;0;0;0
FR;9;2021-06-22;0;0;0;0;0;0;0;0;0;0
FR;9;2021-06-23;0;0;0;0;0;0;0;0;0;0
FR;9;2021-06-24;0;0;0;0;0;0;0;0;0;0
FR;9;2021-06-25;0;0;0;0;0;0;0;0;0;0
FR;9;2021-06-26;0;0;0;0;0;0;0;0;0;0
FR;9;2021-06-27;0;0;0;0;0;0;0;0;0;0
FR;9;2021-06-28;0;0;0;0;0;0;0;0;0;0
FR;9;2021-06-29;0;0;0;0;0;0;0;0;0;0
FR;9;2021-06-30;0;0;0;0;0;0;0;0;0;0
FR;9;2021-07-01;0;0;0;0;0;0;0;0;0;0
FR;9;2021-07-02;0;0;0;0;0;0;0;0;0;0
FR;9;2021-07-03;0;0;0;0;0;0;0;0;0;0
FR;9;2021-07-04;0;0;0;0;0;0;0;0;0;0
FR;9;2021-07-05;0;0;0;0;0;0;0;0;0;0
FR;9;2021-07-06;0;0;0;0;0;0;0;0;0;0
FR;9;2021-07-07;0;0;0;0;0;0;0;0;0;0
FR;9;2021-07-08;0;0;0;0;0;0;0;0;0;0
FR;9;2021-07-09;0;0;0;0;0;0;0;0;0;0
FR;9;2021-07-10;0;0;0;0;0;0;0;0;0;0
FR;9;2021-07-11;0;0;0;0;0;0;0;0;0;0
FR;9;2021-07-12;0;0;0;0;0;0;0;0;0;0
FR;9;2021-07-13;0;0;0;0;0;0;0;0;0;0
FR;9;2021-07-14;0;0;0;0;0;0;0;0;0;0
FR;9;2021-07-15;0;0;0;0;0;0;0;0;0;0
FR;9;2021-07-16;0;0;0;0;0;0;0;0;0;0
FR;9;2021-07-17;0;0;0;0;0;0;0;0;0;0
FR;9;2021-07-18;0;0;0;0;0;0;0;0;0;0
FR;9;2021-07-19;0;0;0;0;0;0;0;0;0;0
FR;9;2021-07-20;0;0;0;0;0;0;0;0;0;0
FR;9;2021-07-21;0;0;0;0;0;0;0;0;0;0
FR;9;2021-07-22;0;0;0;0;0;0;0;0;0;0
FR;9;2021-07-23;0;0;0;0;0;0;0;0;0;0
FR;9;2021-07-24;0;0;0;0;0;0;0;0;0;0
FR;9;2021-07-25;0;0;0;0;0;0;0;0;0;0
FR;9;2021-07-26;0;0;0;0;0;0;0;0;0;0
FR;9;2021-07-27;0;0;0;0;0;0;0;0;0;0
FR;9;2021-07-28;0;0;0;0;0;0;0;0;0;0
FR;9;2021-07-29;0;0;0;0;0;0;0;0;0;0
FR;9;2021-07-30;0;0;0;0;0;0;0;0;0;0
FR;9;2021-07-31;0;0;0;0;0;0;0;0;0;0
FR;9;2021-08-01;0;0;0;0;0;0;0;0;0;0
FR;9;2021-08-02;0;0;0;0;0;0;0;0;0;0
FR;9;2021-08-03;0;0;0;0;0;0;0;0;0;0
FR;9;2021-08-04;0;0;0;0;0;0;0;0;0;0
FR;9;2021-08-05;0;0;0;0;0;0;0;0;0;0
FR;9;2021-08-06;0;0;0;0;0;0;0;0;0;0
FR;9;2021-08-07;0;0;0;0;0;0;0;0;0;0
FR;9;2021-08-08;0;0;0;0;0;0;0;0;0;0
FR;9;2021-08-09;0;0;0;0;0;0;0;0;0;0
FR;9;2021-08-10;0;0;0;0;0;0;0;0;0;0
FR;9;2021-08-11;0;0;0;0;0;0;0;0;0;0
FR;9;2021-08-12;0;0;0;0;0;0;0;0;0;0
FR;9;2021-08-13;0;0;0;0;0;0;0;0;0;0
FR;9;2021-08-14;0;0;0;0;0;0;0;0;0;0
FR;9;2021-08-15;0;0;0;0;0;0;0;0;0;0
FR;9;2021-08-16;0;0;0;0;0;0;0;0;0;0
FR;9;2021-08-17;0;0;0;0;0;0;0;0;0;0
FR;9;2021-08-18;0;0;0;0;0;0;0;0;0;0
FR;9;2021-08-19;0;0;0;0;0;0;0;0;0;0
FR;9;2021-08-20;0;0;0;0;0;0;0;0;0;0
FR;9;2021-08-21;0;0;0;0;0;0;0;0;0;0
FR;9;2021-08-22;0;0;0;0;0;0;0;0;0;0
FR;9;2021-08-23;0;0;0;0;0;0;0;0;0;0
FR;9;2021-08-24;0;0;0;0;0;0;0;0;0;0
FR;9;2021-08-25;0;0;0;0;0;0;0;0;0;0
FR;9;2021-08-26;0;0;0;0;0;0;0;0;0;0
FR;9;2021-08-27;0;0;0;0;0;0;0;0;0;0
FR;9;2021-08-28;0;0;0;0;0;0;0;0;0;0
FR;9;2021-08-29;0;0;0;0;0;0;0;0;0;0
FR;9;2021-08-30;0;0;0;0;0;0;0;0;0;0
FR;9;2021-08-31;0;0;0;0;0;0;0;0;0;0
FR;9;2021-09-01;0;0;0;0;0;0;0;0;0;0
FR;9;2021-09-02;0;0;0;0;0;0;0;0;0;0
FR;9;2021-09-03;0;0;0;0;0;0;0;0;0;0
FR;9;2021-09-04;0;0;0;0;0;0;0;0;0;0
FR;9;2021-09-05;0;0;0;0;0;0;0;0;0;0
FR;9;2021-09-06;0;0;0;0;0;0;0;0;0;0
FR;9;2021-09-07;0;0;0;0;0;0;0;0;0;0
FR;9;2021-09-08;0;0;0;0;0;0;0;0;0;0
FR;9;2021-09-09;0;0;0;0;0;0;0;0;0;0
FR;9;2021-09-10;0;0;0;0;0;0;0;0;0;0
FR;9;2021-09-11;0;0;0;0;0;0;0;0;0;0
FR;9;2021-09-12;0;0;0;0;0;0;0;0;0;0
FR;9;2021-09-13;0;0;0;0;0;0;0;0;0;0
FR;9;2021-09-14;0;0;0;0;0;0;0;0;0;0
FR;9;2021-09-15;0;0;0;0;0;0;0;0;0;0
FR;9;2021-09-16;0;0;0;0;0;0;0;0;0;0
FR;9;2021-09-17;0;0;0;0;0;0;0;0;0;0
FR;9;2021-09-18;0;0;0;0;0;0;0;0;0;0
FR;9;2021-09-19;0;0;0;0;0;0;0;0;0;0
FR;9;2021-09-20;0;0;0;0;0;0;0;0;0;0
FR;9;2021-09-21;0;0;0;0;0;0;0;0;0;0
FR;9;2021-09-22;0;0;0;0;0;0;0;0;0;0
FR;9;2021-09-23;0;0;0;0;0;0;0;0;0;0
FR;9;2021-09-24;0;0;0;0;0;0;0;0;0;0
FR;9;2021-09-25;0;0;0;0;0;0;0;0;0;0
FR;9;2021-09-26;0;0;0;0;0;0;0;0;0;0
FR;9;2021-09-27;0;0;0;0;0;0;0;0;0;0
FR;9;2021-09-28;0;0;0;0;0;0;0;0;0;0
FR;9;2021-09-29;0;0;0;0;0;0;0;0;0;0
FR;9;2021-09-30;0;0;0;0;0;0;0;0;0;0
FR;9;2021-10-01;0;0;0;0;0;0;0;0;0;0
FR;9;2021-10-02;0;0;0;0;0;0;0;0;0;0
FR;9;2021-10-03;0;0;0;0;0;0;0;0;0;0
FR;9;2021-10-04;0;0;0;0;0;0;0;0;0;0
FR;9;2021-10-05;0;0;0;0;0;0;0;0;0;0
FR;9;2021-10-06;0;0;0;0;0;0;0;0;0;0
FR;9;2021-10-07;0;0;0;0;0;0;0;0;0;0
FR;9;2021-10-08;0;0;0;0;0;0;0;0;0;0
FR;9;2021-10-09;0;0;0;0;0;0;0;0;0;0
FR;9;2021-10-10;0;0;0;0;0;0;0;0;0;0
FR;9;2021-10-11;0;0;0;0;0;0;0;0;0;0
FR;9;2021-10-12;0;0;0;0;0;0;0;0;0;0
FR;9;2021-10-13;0;0;0;0;0;0;0;0;0;0
FR;9;2021-10-14;0;0;0;0;0;0;0;0;0;0
FR;9;2021-10-15;0;0;0;0;0;0;0;0;0;0
FR;9;2021-10-16;0;0;0;0;0;0;0;0;0;0
FR;9;2021-10-17;0;0;0;0;0;0;0;0;0;0
FR;9;2021-10-18;0;0;0;0;0;0;0;0;0;0
FR;9;2021-10-19;0;0;0;0;0;0;0;0;0;0
FR;9;2021-10-20;0;0;0;0;0;0;0;0;0;0
FR;9;2021-10-21;0;0;0;0;0;0;0;0;0;0
FR;9;2021-10-22;0;0;0;0;0;0;0;0;0;0
FR;9;2021-10-23;0;0;0;0;0;0;0;0;0;0
FR;9;2021-10-24;0;0;0;0;0;0;0;0;0;0
FR;9;2021-10-25;0;0;0;0;0;0;0;0;0;0
FR;9;2021-10-26;0;0;0;0;0;0;0;0;0;0
FR;9;2021-10-27;0;0;0;0;0;0;0;0;0;0
FR;9;2021-10-28;0;0;0;0;0;0;0;0;0;0
FR;9;2021-10-29;0;0;0;0;0;0;0;0;0;0
FR;9;2021-10-30;0;0;0;0;0;0;0;0;0;0
FR;9;2021-10-31;0;0;0;0;0;0;0;0;0;0
FR;9;2021-11-01;0;0;0;0;0;0;0;0;0;0
FR;9;2021-11-02;0;0;0;0;0;0;0;0;0;0
FR;9;2021-11-03;0;0;0;0;0;0;0;0;0;0
FR;9;2021-11-04;0;0;0;0;0;0;0;0;0;0
FR;9;2021-11-05;0;0;0;0;0;0;0;0;0;0
FR;9;2021-11-06;0;0;0;0;0;0;0;0;0;0
FR;9;2021-11-07;0;0;0;0;0;0;0;0;0;0
FR;9;2021-11-08;0;0;0;0;0;0;0;0;0;0
FR;9;2021-11-09;0;0;0;0;0;0;0;0;0;0
FR;9;2021-11-10;0;0;0;0;0;0;0;0;0;0
FR;9;2021-11-11;0;0;0;0;0;0;0;0;0;0
FR;9;2021-11-12;0;0;0;0;0;0;0;0;0;0
FR;9;2021-11-13;0;0;0;0;0;0;0;0;0;0
FR;9;2021-11-14;0;0;0;0;0;0;0;0;0;0
FR;9;2021-11-15;0;0;0;0;0;0;0;0;0;0
FR;9;2021-11-16;0;0;0;0;0;0;0;0;0;0
FR;9;2021-11-17;0;0;0;0;0;0;0;0;0;0
FR;9;2021-11-18;0;0;0;0;0;0;0;0;0;0
FR;9;2021-11-19;0;0;0;0;0;0;0;0;0;0
FR;9;2021-11-20;0;0;0;0;0;0;0;0;0;0
FR;9;2021-11-21;0;0;0;0;0;0;0;0;0;0
FR;9;2021-11-22;0;0;0;0;0;0;0;0;0;0
FR;9;2021-11-23;0;0;0;0;0;0;0;0;0;0
FR;9;2021-11-24;0;0;0;0;0;0;0;0;0;0
FR;9;2021-11-25;0;0;0;0;0;0;0;0;0;0
FR;9;2021-11-26;0;0;0;0;0;0;0;0;0;0
FR;9;2021-11-27;0;0;0;0;0;0;0;0;0;0
FR;9;2021-11-28;0;0;0;0;0;0;0;0;0;0
FR;9;2021-11-29;0;0;0;0;0;0;0;0;0;0
FR;9;2021-11-30;0;0;0;0;0;0;0;0;0;0
FR;9;2021-12-01;0;0;0;0;0;0;0;0;0;0
FR;9;2021-12-02;0;0;0;0;0;0;0;0;0;0
FR;9;2021-12-03;0;0;0;0;0;0;0;0;0;0
FR;9;2021-12-04;0;0;0;0;0;0;0;0;0;0
FR;9;2021-12-05;0;0;0;0;0;0;0;0;0;0
FR;9;2021-12-06;0;0;0;0;0;0;0;0;0;0
FR;9;2021-12-07;0;0;0;0;0;0;0;0;0;0
FR;9;2021-12-08;0;0;0;0;0;0;0;0;0;0
FR;9;2021-12-09;0;0;0;0;0;0;0;0;0;0
FR;9;2021-12-10;0;0;0;0;0;0;0;0;0;0
FR;9;2021-12-11;0;0;0;0;0;0;0;0;0;0
FR;9;2021-12-12;0;0;0;0;0;0;0;0;0;0
FR;9;2021-12-13;0;0;0;0;0;0;0;0;0;0
FR;9;2021-12-14;0;0;0;0;0;0;0;0;0;0
FR;9;2021-12-15;0;0;0;0;0;0;0;0;0;0
FR;9;2021-12-16;0;0;0;0;0;0;0;0;0;0
FR;9;2021-12-17;0;0;0;0;0;0;0;0;0;0
FR;9;2021-12-18;0;0;0;0;0;0;0;0;0;0
FR;9;2021-12-19;0;0;0;0;0;0;0;0;0;0
FR;9;2021-12-20;0;0;0;0;0;0;0;0;0;0
FR;9;2021-12-21;0;0;0;0;0;0;0;0;0;0
FR;9;2021-12-22;0;0;0;0;0;0;0;0;0;0
FR;9;2021-12-23;0;0;0;0;0;0;0;0;0;0
FR;9;2021-12-24;0;0;0;0;0;0;0;0;0;0
FR;9;2021-12-25;0;0;0;0;0;0;0;0;0;0
FR;9;2021-12-26;0;0;0;0;0;0;0;0;0;0
FR;9;2021-12-27;0;0;0;0;0;0;0;0;0;0
FR;9;2021-12-28;0;0;0;0;0;0;0;0;0;0
FR;9;2021-12-29;0;0;0;0;0;0;0;0;0;0
FR;9;2021-12-30;0;0;0;0;0;0;0;0;0;0
FR;9;2021-12-31;0;0;0;0;0;0;0;0;0;0
FR;9;2022-01-01;0;0;0;0;0;0;0;0;0;0
FR;9;2022-01-02;0;0;0;0;0;0;0;0;0;0
FR;9;2022-01-03;0;0;0;0;0;0;0;0;0;0
FR;9;2022-01-04;0;0;0;0;0;0;0;0;0;0
FR;9;2022-01-05;0;0;0;0;0;0;0;0;0;0
FR;9;2022-01-06;0;0;0;0;0;0;0;0;0;0
FR;9;2022-01-07;0;0;0;0;0;0;0;0;0;0
FR;9;2022-01-08;0;0;0;0;0;0;0;0;0;0
FR;9;2022-01-09;0;0;0;0;0;0;0;0;0;0
FR;9;2022-01-10;0;0;0;0;0;0;0;0;0;0
FR;9;2022-01-11;0;0;0;0;0;0;0;0;0;0
FR;9;2022-01-12;0;0;0;0;0;0;0;0;0;0
FR;9;2022-01-13;0;0;0;0;0;0;0;0;0;0
FR;9;2022-01-14;0;0;0;0;0;0;0;0;0;0
FR;9;2022-01-15;0;0;0;0;0;0;0;0;0;0
FR;9;2022-01-16;0;0;0;0;0;0;0;0;0;0
FR;9;2022-01-17;0;0;0;0;0;0;0;0;0;0
FR;9;2022-01-18;0;0;0;0;0;0;0;0;0;0
FR;9;2022-01-19;0;0;0;0;0;0;0;0;0;0
FR;9;2022-01-20;0;0;0;0;0;0;0;0;0;0
FR;9;2022-01-21;0;0;0;0;0;0;0;0;0;0
FR;9;2022-01-22;0;0;0;0;0;0;0;0;0;0
FR;9;2022-01-23;0;0;0;0;0;0;0;0;0;0
FR;9;2022-01-24;0;0;0;0;0;0;0;0;0;0
FR;9;2022-01-25;0;0;0;0;0;0;0;0;0;0
FR;9;2022-01-26;0;0;0;0;0;0;0;0;0;0
FR;9;2022-01-27;0;0;0;0;0;0;0;0;0;0
FR;9;2022-01-28;0;0;0;0;0;0;0;0;0;0
FR;9;2022-01-29;0;0;0;0;0;0;0;0;0;0
FR;9;2022-01-30;0;0;0;0;0;0;0;0;0;0
FR;9;2022-01-31;0;0;0;0;0;0;0;0;0;0
FR;9;2022-02-01;0;0;0;0;0;0;0;0;0;0
FR;9;2022-02-02;0;0;0;0;0;0;0;0;0;0
FR;9;2022-02-03;0;0;0;0;0;0;0;0;0;0
FR;9;2022-02-04;0;0;0;0;0;0;0;0;0;0
FR;9;2022-02-05;0;0;0;0;0;0;0;0;0;0
FR;9;2022-02-06;0;0;0;0;0;0;0;0;0;0
FR;9;2022-02-07;0;0;0;0;0;0;0;0;0;0
FR;9;2022-02-08;0;0;0;0;0;0;0;0;0;0
FR;9;2022-02-09;0;0;0;0;0;0;0;0;0;0
FR;9;2022-02-10;0;0;0;0;0;0;0;0;0;0
FR;9;2022-02-11;0;0;0;0;0;0;0;0;0;0
FR;9;2022-02-12;0;0;0;0;0;0;0;0;0;0
FR;9;2022-02-13;0;0;0;0;0;0;0;0;0;0
FR;9;2022-02-14;0;0;0;0;0;0;0;0;0;0
FR;9;2022-02-15;0;0;0;0;0;0;0;0;0;0
FR;9;2022-02-16;0;0;0;0;0;0;0;0;0;0
FR;9;2022-02-17;0;0;0;0;0;0;0;0;0;0
FR;9;2022-02-18;0;0;0;0;0;0;0;0;0;0
FR;9;2022-02-19;0;0;0;0;0;0;0;0;0;0
FR;9;2022-02-20;0;0;0;0;0;0;0;0;0;0
FR;9;2022-02-21;0;0;0;0;0;0;0;0;0;0
FR;9;2022-02-22;0;0;0;0;0;0;0;0;0;0
FR;9;2022-02-23;0;0;0;0;0;0;0;0;0;0
FR;9;2022-02-24;0;0;0;0;0;0;0;0;0;0
FR;9;2022-02-25;0;0;0;0;0;0;0;0;0;0
FR;9;2022-02-26;0;0;0;0;0;0;0;0;0;0
FR;9;2022-02-27;0;0;0;0;0;0;0;0;0;0
FR;9;2022-02-28;0;0;0;0;0;0;0;0;0;0
FR;9;2022-03-01;0;0;0;0;0;0;0;0;0;0
FR;9;2022-03-02;0;0;0;0;0;0;0;0;0;0
FR;9;2022-03-03;0;0;0;0;0;0;0;0;0;0
FR;9;2022-03-04;0;0;0;0;0;0;0;0;0;0
FR;9;2022-03-05;0;0;0;0;0;0;0;0;0;0
FR;9;2022-03-06;0;0;0;0;0;0;0;0;0;0
FR;9;2022-03-07;0;0;0;0;0;0;0;0;0;0
FR;9;2022-03-08;0;0;0;0;0;0;0;0;0;0
FR;9;2022-03-09;0;0;0;0;0;0;0;0;0;0
FR;9;2022-03-10;0;0;0;0;0;0;0;0;0;0
FR;9;2022-03-11;0;0;0;0;0;0;0;0;0;0
FR;9;2022-03-12;0;0;0;0;0;0;0;0;0;0
FR;9;2022-03-13;0;0;0;0;0;0;0;0;0;0
FR;9;2022-03-14;0;0;0;0;0;0;0;0;0;0
FR;9;2022-03-15;0;0;0;0;0;0;0;0;0;0
FR;9;2022-03-16;0;0;0;0;0;0;0;0;0;0
FR;9;2022-03-17;0;0;0;0;0;0;0;0;0;0
FR;9;2022-03-18;0;0;0;0;0;0;0;0;0;0
FR;9;2022-03-19;0;0;0;0;0;0;0;0;0;0
FR;9;2022-03-20;0;0;0;0;0;0;0;0;0;0
FR;9;2022-03-21;0;0;0;0;0;0;0;0;0;0
FR;9;2022-03-22;0;0;0;0;0;0;0;0;0;0
FR;9;2022-03-23;0;0;0;0;0;0;0;0;0;0
FR;9;2022-03-24;0;0;0;0;0;0;0;0;0;0
FR;9;2022-03-25;0;0;0;0;0;0;0;0;0;0
FR;9;2022-03-26;0;0;0;0;0;0;0;0;0;0
FR;9;2022-03-27;0;0;0;0;0;0;0;0;0;0
FR;9;2022-03-28;0;0;0;0;0;0;0;0;0;0
FR;9;2022-03-29;0;0;0;0;0;0;0;0;0;0
FR;9;2022-03-30;0;0;0;0;0;0;0;0;0;0
FR;9;2022-03-31;0;0;0;0;0;0;0;0;0;0
FR;9;2022-04-01;0;0;0;0;0;0;0;0;0;0
FR;9;2022-04-02;0;0;0;0;0;0;0;0;0;0
FR;9;2022-04-03;0;0;0;0;0;0;0;0;0;0
FR;9;2022-04-04;0;0;0;0;0;0;0;0;0;0
FR;9;2022-04-05;0;0;0;0;0;0;0;0;0;0
FR;9;2022-04-06;0;0;0;0;0;0;0;0;0;0
FR;9;2022-04-07;0;0;0;0;0;0;0;0;0;0
FR;9;2022-04-08;0;0;0;0;0;0;0;0;0;0
FR;9;2022-04-09;0;0;0;0;0;0;0;0;0;0
FR;9;2022-04-10;0;0;0;0;0;0;0;0;0;0
FR;9;2022-04-11;0;0;0;0;0;0;0;0;0;0
FR;9;2022-04-12;0;0;0;0;0;0;0;0;0;0
FR;9;2022-04-13;0;0;0;0;0;0;0;0;0;0
FR;9;2022-04-14;0;0;0;0;0;0;0;0;0;0
FR;9;2022-04-15;0;0;0;0;0;0;0;0;0;0
FR;9;2022-04-16;0;0;0;0;0;0;0;0;0;0
FR;9;2022-04-17;0;0;0;0;0;0;0;0;0;0
FR;9;2022-04-18;0;0;0;0;0;0;0;0;0;0
FR;9;2022-04-19;0;0;0;0;0;0;0;0;0;0
FR;9;2022-04-20;0;0;0;0;0;0;0;0;0;0
FR;9;2022-04-21;0;0;0;0;0;0;0;0;0;0
FR;9;2022-04-22;0;0;0;0;0;0;0;0;0;0
FR;9;2022-04-23;0;0;0;0;0;0;0;0;0;0
FR;9;2022-04-24;0;0;0;0;0;0;0;0;0;0
FR;9;2022-04-25;0;0;0;0;0;0;0;0;0;0
FR;9;2022-04-26;0;0;0;0;0;0;0;0;0;0
FR;9;2022-04-27;0;0;0;0;0;0;0;0;0;0
FR;9;2022-04-28;0;0;0;0;0;0;0;0;0;0
FR;9;2022-04-29;0;0;0;0;0;0;0;0;0;0
FR;9;2022-04-30;0;0;0;0;0;0;0;0;0;0
FR;9;2022-05-01;0;0;0;0;0;0;0;0;0;0
FR;9;2022-05-02;0;0;0;0;0;0;0;0;0;0
FR;9;2022-05-03;0;0;0;0;0;0;0;0;0;0
FR;9;2022-05-04;0;0;0;0;0;0;0;0;0;0
FR;9;2022-05-05;0;0;0;0;0;0;0;0;0;0
FR;9;2022-05-06;0;0;0;0;0;0;0;0;0;0
FR;9;2022-05-07;0;0;0;0;0;0;0;0;0;0
FR;9;2022-05-08;0;0;0;0;0;0;0;0;0;0
FR;9;2022-05-09;0;0;0;0;0;0;0;0;0;0
FR;9;2022-05-10;0;0;0;0;0;0;0;0;0;0
FR;9;2022-05-11;0;0;0;0;0;0;0;0;0;0
FR;9;2022-05-12;0;0;0;0;0;0;0;0;0;0
FR;9;2022-05-13;0;0;0;0;0;0;0;0;0;0
FR;9;2022-05-14;0;0;0;0;0;0;0;0;0;0
FR;9;2022-05-15;0;0;0;0;0;0;0;0;0;0
FR;9;2022-05-16;0;0;0;0;0;0;0;0;0;0
FR;9;2022-05-17;0;0;0;0;0;0;0;0;0;0
FR;9;2022-05-18;0;0;0;0;0;0;0;0;0;0
FR;9;2022-05-19;0;0;0;0;0;0;0;0;0;0
FR;9;2022-05-20;0;0;0;0;0;0;0;0;0;0
FR;9;2022-05-21;0;0;0;0;0;0;0;0;0;0
FR;9;2022-05-22;0;0;0;0;0;0;0;0;0;0
FR;9;2022-05-23;0;0;0;0;0;0;0;0;0;0
FR;9;2022-05-24;0;0;0;0;0;0;0;0;0;0
FR;9;2022-05-25;0;0;0;0;0;0;0;0;0;0
FR;9;2022-05-26;0;0;0;0;0;0;0;0;0;0
FR;9;2022-05-27;0;0;0;0;0;0;0;0;0;0
FR;9;2022-05-28;0;0;0;0;0;0;0;0;0;0
FR;9;2022-05-29;0;0;0;0;0;0;0;0;0;0
FR;9;2022-05-30;0;0;0;0;0;0;0;0;0;0
FR;9;2022-05-31;0;0;0;0;0;0;0;0;0;0
FR;9;2022-06-01;0;0;0;0;0;0;0;0;0;0
FR;9;2022-06-02;0;0;0;0;0;0;0;0;0;0
FR;9;2022-06-03;0;0;0;0;0;0;0;0;0;0
FR;9;2022-06-04;0;0;0;0;0;0;0;0;0;0
FR;9;2022-06-05;0;0;0;0;0;0;0;0;0;0
FR;9;2022-06-06;0;0;0;0;0;0;0;0;0;0
FR;9;2022-06-07;0;0;0;0;0;0;0;0;0;0
FR;9;2022-06-08;0;0;0;0;0;0;0;0;0;0
FR;9;2022-06-09;0;0;0;0;0;0;0;0;0;0
FR;9;2022-06-10;0;0;0;0;0;0;0;0;0;0
FR;9;2022-06-11;0;0;0;0;0;0;0;0;0;0
FR;9;2022-06-12;0;0;0;0;0;0;0;0;0;0
FR;9;2022-06-13;0;0;0;0;0;0;0;0;0;0
FR;9;2022-06-14;0;0;0;0;0;0;0;0;0;0
FR;9;2022-06-15;0;0;0;0;0;0;0;0;0;0
FR;9;2022-06-16;0;0;0;0;0;0;0;0;0;0
FR;9;2022-06-17;0;0;0;0;0;0;0;0;0;0
FR;9;2022-06-18;0;0;0;0;0;0;0;0;0;0
FR;9;2022-06-19;0;0;0;0;0;0;0;0;0;0
FR;9;2022-06-20;0;0;0;0;0;0;0;0;0;0
FR;9;2022-06-21;0;0;0;0;0;0;0;0;0;0
FR;9;2022-06-22;0;0;0;0;0;0;0;0;0;0
FR;9;2022-06-23;0;0;0;0;0;0;0;0;0;0
FR;9;2022-06-24;0;0;0;0;0;0;0;0;0;0
FR;9;2022-06-25;0;0;0;0;0;0;0;0;0;0
FR;9;2022-06-26;0;0;0;0;0;0;0;0;0;0
FR;9;2022-06-27;0;0;0;0;0;0;0;0;0;0
FR;9;2022-06-28;0;0;0;0;0;0;0;0;0;0
FR;9;2022-06-29;0;0;0;0;0;0;0;0;0;0
FR;9;2022-06-30;0;0;0;0;0;0;0;0;0;0
FR;9;2022-07-01;0;0;0;0;0;0;0;0;0;0
FR;9;2022-07-02;0;0;0;0;0;0;0;0;0;0
FR;9;2022-07-03;0;0;0;0;0;0;0;0;0;0
FR;9;2022-07-04;0;0;0;0;0;0;0;0;0;0
FR;9;2022-07-05;0;0;0;0;0;0;0;0;0;0
FR;9;2022-07-06;0;0;0;0;0;0;0;0;0;0
FR;9;2022-07-07;0;0;0;0;0;0;0;0;0;0
FR;9;2022-07-08;0;0;0;0;0;0;0;0;0;0
FR;9;2022-07-09;0;0;0;0;0;0;0;0;0;0
FR;9;2022-07-10;0;0;0;0;0;0;0;0;0;0
FR;9;2022-07-11;0;0;0;0;0;0;0;0;0;0
FR;9;2022-07-12;0;0;0;0;0;0;0;0;0;0
FR;9;2022-07-13;0;0;0;0;0;0;0;0;0;0
FR;9;2022-07-14;0;0;0;0;0;0;0;0;0;0
FR;9;2022-07-15;0;0;0;0;0;0;0;0;0;0
FR;9;2022-07-16;0;0;0;0;0;0;0;0;0;0
FR;9;2022-07-17;0;0;0;0;0;0;0;0;0;0
FR;9;2022-07-18;0;0;0;0;0;0;0;0;0;0
FR;9;2022-07-19;0;0;0;0;0;0;0;0;0;0
FR;9;2022-07-20;0;0;0;0;0;0;0;0;0;0
FR;9;2022-07-21;0;0;0;0;0;0;0;0;0;0
FR;9;2022-07-22;0;0;0;0;0;0;0;0;0;0
FR;9;2022-07-23;0;0;0;0;0;0;0;0;0;0
FR;9;2022-07-24;0;0;0;0;0;0;0;0;0;0
FR;9;2022-07-25;0;0;0;0;0;0;0;0;0;0
FR;9;2022-07-26;0;0;0;0;0;0;0;0;0;0
FR;9;2022-07-27;0;0;0;0;0;0;0;0;0;0
FR;9;2022-07-28;0;0;0;0;0;0;0;0;0;0
FR;9;2022-07-29;0;0;0;0;0;0;0;0;0;0
FR;9;2022-07-30;0;0;0;0;0;0;0;0;0;0
FR;9;2022-07-31;0;0;0;0;0;0;0;0;0;0
FR;9;2022-08-01;0;0;0;0;0;0;0;0;0;0
FR;9;2022-08-02;0;0;0;0;0;0;0;0;0;0
FR;9;2022-08-03;0;0;0;0;0;0;0;0;0;0
FR;9;2022-08-04;0;0;0;0;0;0;0;0;0;0
FR;9;2022-08-05;0;0;0;0;0;0;0;0;0;0
FR;9;2022-08-06;0;0;0;0;0;0;0;0;0;0
FR;9;2022-08-07;0;0;0;0;0;0;0;0;0;0
FR;9;2022-08-08;0;0;0;0;0;0;0;0;0;0
FR;9;2022-08-09;0;0;0;0;0;0;0;0;0;0
FR;9;2022-08-10;0;0;0;0;0;0;0;0;0;0
FR;9;2022-08-11;0;0;0;0;0;0;0;0;0;0
FR;9;2022-08-12;0;0;0;0;0;0;0;0;0;0
FR;9;2022-08-13;0;0;0;0;0;0;0;0;0;0
FR;9;2022-08-14;0;0;0;0;0;0;0;0;0;0
FR;9;2022-08-15;0;0;0;0;0;0;0;0;0;0
FR;9;2022-08-16;0;0;0;0;0;0;0;0;0;0
FR;9;2022-08-17;0;0;0;0;0;0;0;0;0;0
FR;9;2022-08-18;0;0;0;0;0;0;0;0;0;0
FR;9;2022-08-19;0;0;0;0;0;0;0;0;0;0
FR;9;2022-08-20;0;0;0;0;0;0;0;0;0;0
FR;9;2022-08-21;0;0;0;0;0;0;0;0;0;0
FR;9;2022-08-22;0;0;0;0;0;0;0;0;0;0
FR;9;2022-08-23;0;0;0;0;0;0;0;0;0;0
FR;9;2022-08-24;0;0;0;0;0;0;0;0;0;0
FR;9;2022-08-25;0;0;0;0;0;0;0;0;0;0
FR;9;2022-08-26;0;0;0;0;0;0;0;0;0;0
FR;9;2022-08-27;0;0;0;0;0;0;0;0;0;0
FR;9;2022-08-28;0;0;0;0;0;0;0;0;0;0
FR;9;2022-08-29;0;0;0;0;0;0;0;0;0;0
FR;9;2022-08-30;0;0;0;0;0;0;0;0;0;0
FR;9;2022-08-31;0;0;0;0;0;0;0;0;0;0
FR;9;2022-09-01;0;0;0;0;0;0;0;0;0;0
FR;9;2022-09-02;0;0;0;0;0;0;0;0;0;0
FR;9;2022-09-03;0;0;0;0;0;0;0;0;0;0
FR;9;2022-09-04;0;0;0;0;0;0;0;0;0;0
FR;9;2022-09-05;0;0;0;0;0;0;0;0;0;0
FR;9;2022-09-06;0;0;0;0;0;0;0;0;0;0
FR;9;2022-09-07;0;0;0;0;0;0;0;0;0;0
FR;9;2022-09-08;0;0;0;0;0;0;0;0;0;0
FR;9;2022-09-09;0;0;0;0;0;0;0;0;0;0
FR;9;2022-09-10;0;0;0;0;0;0;0;0;0;0
FR;9;2022-09-11;0;0;0;0;0;0;0;0;0;0
FR;9;2022-09-12;0;0;0;0;0;0;0;0;0;0
FR;9;2022-09-13;0;0;0;0;0;0;0;0;0;0
FR;9;2022-09-14;0;0;0;0;0;0;0;0;0;0
FR;9;2022-09-15;0;0;0;0;0;0;0;0;0;0
FR;9;2022-09-16;0;0;0;0;0;0;0;0;0;0
FR;9;2022-09-17;0;0;0;0;0;0;0;0;0;0
FR;9;2022-09-18;0;0;0;0;0;0;0;0;0;0
FR;9;2022-09-19;0;0;0;0;0;0;0;0;0;0
FR;9;2022-09-20;0;0;0;0;0;0;0;0;0;0
FR;9;2022-09-21;0;0;0;0;0;0;0;0;0;0
FR;9;2022-09-22;0;0;0;0;0;0;0;0;0;0
FR;9;2022-09-23;0;0;0;0;0;0;0;0;0;0
FR;9;2022-09-24;0;0;0;0;0;0;0;0;0;0
FR;9;2022-09-25;0;0;0;0;0;0;0;0;0;0
FR;9;2022-09-26;0;0;0;0;0;0;0;0;0;0
FR;9;2022-09-27;0;0;0;0;0;0;0;0;0;0
FR;9;2022-09-28;0;0;0;0;0;0;0;0;0;0
FR;9;2022-09-29;1;1;8;31;6;1;1;8;31;6
FR;9;2022-09-30;4;12;60;604;47;5;13;68;635;53
FR;9;2022-10-01;9;1;43;326;26;14;14;111;961;79
FR;9;2022-10-02;1;0;5;50;3;15;14;116;1011;82
FR;9;2022-10-03;10;16;149;1712;128;25;30;265;2723;210
FR;9;2022-10-04;19;48;353;3949;227;44;78;618;6672;437
FR;9;2022-10-05;26;19;269;2994;203;70;97;887;9666;640
FR;9;2022-10-06;22;34;398;4598;300;92;131;1285;14264;940
FR;9;2022-10-07;29;49;498;5696;384;121;180;1783;19960;1324
FR;9;2022-10-08;10;18;127;1088;86;131;198;1910;21048;1410
FR;9;2022-10-09;1;7;22;196;29;132;205;1932;21244;1439
FR;9;2022-10-10;11;26;207;2566;181;143;231;2139;23810;1620
FR;9;2022-10-11;31;40;426;5041;314;174;271;2565;28851;1934
FR;9;2022-10-12;22;26;295;2976;209;196;297;2860;31827;2143
FR;9;2022-10-13;24;43;373;3978;245;220;340;3233;35805;2388
FR;9;2022-10-14;27;26;373;4379;290;247;366;3606;40184;2678
FR;9;2022-10-15;12;7;101;1045;79;259;373;3707;41229;2757
FR;9;2022-10-16;4;1;9;131;12;263;374;3716;41360;2769
FR;9;2022-10-17;4;22;165;1869;127;267;396;3881;43229;2896
FR;9;2022-10-18;34;27;307;3380;217;301;423;4188;46609;3113
FR;9;2022-10-19;20;19;258;2667;169;321;442;4446;49276;3282
FR;9;2022-10-20;20;20;306;3585;228;341;462;4752;52861;3510
FR;9;2022-10-21;12;31;323;3504;225;353;493;5075;56365;3735
FR;9;2022-10-22;10;11;87;907;62;363;504;5162;57272;3797
FR;9;2022-10-23;2;2;17;99;10;365;506;5179;57371;3807
FR;9;2022-10-24;7;16;151;1329;96;372;522;5330;58700;3903
FR;9;2022-10-25;16;19;221;2754;163;388;541;5551;61454;4066
FR;9;2022-10-26;14;13;154;1717;115;402;554;5705;63171;4181
FR;0;2020-12-27;611;0;0;0;0;611;0;0;0;0
FR;0;2020-12-28;687;1;0;0;0;1298;1;0;0;0
FR;0;2020-12-29;385;0;0;0;0;1683;1;0;0;0
FR;0;2020-12-30;444;0;0;0;0;2127;1;0;0;0
FR;0;2020-12-31;444;1;0;0;0;2571;2;0;0;0
FR;0;2021-01-01;1162;2;0;0;0;3733;4;0;0;0
FR;0;2021-01-02;365;3;0;0;0;4098;7;0;0;0
FR;0;2021-01-03;405;0;0;0;0;4503;7;0;0;0
FR;0;2021-01-04;2117;4;0;0;0;6620;11;0;0;0
FR;0;2021-01-05;7755;4;0;0;0;14375;15;0;0;0
FR;0;2021-01-06;12460;19;0;0;0;26835;34;0;0;0
FR;0;2021-01-07;29471;19;0;0;0;56306;53;0;0;0
FR;0;2021-01-08;37151;22;0;0;0;93457;75;0;0;0
FR;0;2021-01-09;11212;9;0;0;0;104669;84;0;0;0
FR;0;2021-01-10;6009;7;0;0;0;110678;91;0;0;0
FR;0;2021-01-11;39944;27;0;0;0;150622;118;0;0;0
FR;0;2021-01-12;62146;21;0;0;0;212768;139;0;0;0
FR;0;2021-01-13;65130;47;0;0;0;277898;186;0;0;0
FR;0;2021-01-14;83113;175;0;0;0;361011;361;0;0;0
FR;0;2021-01-15;69013;71;0;0;0;430024;432;0;0;0
FR;0;2021-01-16;20217;72;0;0;0;450241;504;0;0;0
FR;0;2021-01-17;10986;48;0;0;0;461227;552;0;0;0
FR;0;2021-01-18;85912;174;0;0;0;547139;726;0;0;0
FR;0;2021-01-19;130604;192;0;0;0;677743;918;0;0;0
FR;0;2021-01-20;137556;189;0;0;0;815299;1107;0;0;0
FR;0;2021-01-21;158413;186;0;0;0;973712;1293;0;0;0
FR;0;2021-01-22;121069;238;0;0;0;1094781;1531;0;0;0
FR;0;2021-01-23;38486;71;0;0;0;1133267;1602;0;0;0
FR;0;2021-01-24;9746;106;0;0;0;1143013;1708;0;0;0
FR;0;2021-01-25;78242;1363;0;0;0;1221255;3071;0;0;0
FR;0;2021-01-26;100382;3553;1;0;0;1321637;6624;1;0;0
FR;0;2021-01-27;107253;6253;0;0;0;1428890;12877;1;0;0
FR;0;2021-01-28;124365;15854;0;0;0;1553255;28731;1;0;0
FR;0;2021-01-29;92188;18394;0;0;0;1645443;47125;1;0;0
FR;0;2021-01-30;29128;4430;0;0;0;1674571;51555;1;0;0
FR;0;2021-01-31;5237;1846;0;0;0;1679808;53401;1;0;0
FR;0;2021-02-01;53135;22326;0;0;0;1732943;75727;1;0;0
FR;0;2021-02-02;72317;37187;0;0;0;1805260;112914;1;0;0
FR;0;2021-02-03;72309;39374;0;0;0;1877569;152288;1;0;0
FR;0;2021-02-04;82082;53691;0;0;0;1959651;205979;1;0;0
FR;0;2021-02-05;68239;47229;0;0;0;2027890;253208;1;0;0
FR;0;2021-02-06;23017;11204;0;0;0;2050907;264412;1;0;0
FR;0;2021-02-07;5191;5763;0;0;0;2056098;270175;1;0;0
FR;0;2021-02-08;46846;48115;0;0;0;2102944;318290;1;0;0
FR;0;2021-02-09;66024;76882;0;0;0;2168968;395172;1;0;0
FR;0;2021-02-10;71026;81687;0;0;0;2239994;476859;1;0;0
FR;0;2021-02-11;87289;104046;0;0;0;2327283;580905;1;0;0
FR;0;2021-02-12;79336;75486;0;0;0;2406619;656391;1;0;0
FR;0;2021-02-13;22381;19538;0;0;0;2429000;675929;1;0;0
FR;0;2021-02-14;5077;7358;0;0;0;2434077;683287;1;0;0
FR;0;2021-02-15;38111;76725;0;0;0;2472188;760012;1;0;0
FR;0;2021-02-16;50402;100239;0;0;0;2522590;860251;1;0;0
FR;0;2021-02-17;50543;106216;20;0;0;2573133;966467;21;0;0
FR;0;2021-02-18;69796;122593;0;0;0;2642929;1089060;21;0;0
FR;0;2021-02-19;65075;91794;1;0;0;2708004;1180854;22;0;0
FR;0;2021-02-20;18593;28669;0;0;0;2726597;1209523;22;0;0
FR;0;2021-02-21;3324;6164;0;0;0;2729921;1215687;22;0;0
FR;0;2021-02-22;37502;73193;2;0;0;2767423;1288880;24;0;0
FR;0;2021-02-23;53785;85114;1;0;0;2821208;1373994;25;0;0
FR;0;2021-02-24;60019;82555;1;0;0;2881227;1456549;26;0;0
FR;0;2021-02-25;100587;91424;1;0;0;2981814;1547973;27;0;0
FR;0;2021-02-26;113477;70810;1;0;0;3095291;1618783;28;0;0
FR;0;2021-02-27;52118;22318;1;0;0;3147409;1641101;29;0;0
FR;0;2021-02-28;6206;4196;2;0;0;3153615;1645297;31;0;0
FR;0;2021-03-01;65908;53904;1;0;0;3219523;1699201;32;0;0
FR;0;2021-03-02;101396;67098;3;0;0;3320919;1766299;35;0;0
FR;0;2021-03-03;116532;65557;0;0;0;3437451;1831856;35;0;0
FR;0;2021-03-04;163632;71903;3;0;0;3601083;1903759;38;0;0
FR;0;2021-03-05;200938;62833;3;0;0;3802021;1966592;41;0;0
FR;0;2021-03-06;207970;17546;3;0;0;4009991;1984138;44;0;0
FR;0;2021-03-07;121278;4383;1;0;0;4131269;1988521;45;0;0
FR;0;2021-03-08;107161;49882;2;0;0;4238430;2038403;47;0;0
FR;0;2021-03-09;172466;56321;2;0;0;4410896;2094724;49;0;0
FR;0;2021-03-10;179014;57089;5;0;0;4589910;2151813;54;0;0
FR;0;2021-03-11;242909;63895;2;0;0;4832819;2215708;56;0;0
FR;0;2021-03-12;294834;53430;1;0;0;5127653;2269138;57;0;0
FR;0;2021-03-13;231424;15285;1;0;0;5359077;2284423;58;0;0
FR;0;2021-03-14;63355;3154;1;0;0;5422432;2287577;59;0;0
FR;0;2021-03-15;158671;31812;3;0;0;5581103;2319389;62;0;0
FR;0;2021-03-16;141577;39008;6;0;0;5722680;2358397;68;0;0
FR;0;2021-03-17;150500;37781;4;0;0;5873180;2396178;72;0;0
FR;0;2021-03-18;167850;44460;5;0;0;6041030;2440638;77;0;0
FR;0;2021-03-19;230025;36931;2;0;0;6271055;2477569;79;0;0
FR;0;2021-03-20;166704;11431;1;0;0;6437759;2489000;80;0;0
FR;0;2021-03-21;49947;2254;1;0;0;6487706;2491254;81;0;0
FR;0;2021-03-22;170062;33679;2;0;0;6657768;2524933;83;0;0
FR;0;2021-03-23;250403;42389;1;0;0;6908171;2567322;84;0;0
FR;0;2021-03-24;256919;43587;0;0;0;7165090;2610909;84;0;0
FR;0;2021-03-25;341828;45153;5;0;0;7506918;2656062;89;0;0
FR;0;2021-03-26;358819;41891;5;1;0;7865737;2697953;94;1;0
FR;0;2021-03-27;195265;16904;1;0;0;8061002;2714857;95;1;0
FR;0;2021-03-28;59345;4427;3;0;0;8120347;2719284;98;1;0
FR;0;2021-03-29;202990;53582;4;0;0;8323337;2772866;102;1;0
FR;0;2021-03-30;285492;69884;5;0;0;8608829;2842750;107;1;0
FR;0;2021-03-31;263048;73774;4;0;0;8871877;2916524;111;1;0
FR;0;2021-04-01;315524;91787;11;0;0;9187401;3008311;122;1;0
FR;0;2021-04-02;281354;94163;7;0;0;9468755;3102474;129;1;0
FR;0;2021-04-03;141081;62366;6;0;0;9609836;3164840;135;1;0
FR;0;2021-04-04;46535;18942;2;0;0;9656371;3183782;137;1;0
FR;0;2021-04-05;63345;10547;11;0;0;9719716;3194329;148;1;0
FR;0;2021-04-06;217233;111859;17;0;0;9936949;3306188;165;1;0
FR;0;2021-04-07;260275;115315;17;0;0;10197224;3421503;182;1;0
FR;0;2021-04-08;337862;122585;14;0;0;10535086;3544088;196;1;0
FR;0;2021-04-09;410174;116648;49;0;0;10945260;3660736;245;1;0
FR;0;2021-04-10;212630;82803;15;0;0;11157890;3743539;260;1;0
FR;0;2021-04-11;56150;34214;7;0;0;11214040;3777753;267;1;0
FR;0;2021-04-12;237088;115706;46;0;0;11451128;3893459;313;1;0
FR;0;2021-04-13;309506;144287;98;1;0;11760634;4037746;411;2;0
FR;0;2021-04-14;294548;139608;215;0;0;12055182;4177354;626;2;0
FR;0;2021-04-15;337128;149808;339;0;0;12392310;4327162;965;2;0
FR;0;2021-04-16;339309;146512;354;0;0;12731619;4473674;1319;2;0
FR;0;2021-04-17;188670;90004;109;0;0;12920289;4563678;1428;2;0
FR;0;2021-04-18;51626;35416;47;0;0;12971915;4599094;1475;2;0
FR;0;2021-04-19;205715;138188;456;0;0;13177630;4737282;1931;2;0
FR;0;2021-04-20;254440;171526;569;0;0;13432070;4908808;2500;2;0
FR;0;2021-04-21;253286;169617;836;0;0;13685356;5078425;3336;2;0
FR;0;2021-04-22;287578;189839;818;0;0;13972934;5268264;4154;2;0
FR;0;2021-04-23;297784;184127;747;0;0;14270718;5452391;4901;2;0
FR;0;2021-04-24;190458;111842;252;0;0;14461176;5564233;5153;2;0
FR;0;2021-04-25;69563;38801;51;0;0;14530739;5603034;5204;2;0
FR;0;2021-04-26;220973;157735;563;0;0;14751712;5760769;5767;2;0
FR;0;2021-04-27;284623;187723;941;0;0;15036335;5948492;6708;2;0
FR;0;2021-04-28;299523;184106;1426;1;1;15335858;6132598;8134;3;1
FR;0;2021-04-29;357153;197483;1280;0;0;15693011;6330081;9414;3;1
FR;0;2021-04-30;372230;185574;1122;1;0;16065241;6515655;10536;4;1
FR;0;2021-05-01;167650;52497;179;0;0;16232891;6568152;10715;4;1
FR;0;2021-05-02;91751;37806;83;0;0;16324642;6605958;10798;4;1
FR;0;2021-05-03;288940;166691;843;0;0;16613582;6772649;11641;4;1
FR;0;2021-05-04;315692;225084;1235;0;0;16929274;6997733;12876;4;1
FR;0;2021-05-05;327212;225855;1315;0;0;17256486;7223588;14191;4;1
FR;0;2021-05-06;379536;240450;1634;0;0;17636022;7464038;15825;4;1
FR;0;2021-05-07;372773;258141;1223;0;0;18008795;7722179;17048;4;1
FR;0;2021-05-08;222169;70073;299;0;0;18230964;7792252;17347;4;1
FR;0;2021-05-09;129707;45263;243;0;0;18360671;7837515;17590;4;1
FR;0;2021-05-10;313400;229327;1237;0;0;18674071;8066842;18827;4;1
FR;0;2021-05-11;403918;258085;1566;0;0;19077989;8324927;20393;4;1
FR;0;2021-05-12;434132;233545;1543;0;0;19512121;8558472;21936;4;1
FR;0;2021-05-13;338612;56646;432;0;0;19850733;8615118;22368;4;1
FR;0;2021-05-14;454143;167415;1126;0;0;20304876;8782533;23494;4;1
FR;0;2021-05-15;374982;94267;443;0;0;20679858;8876800;23937;4;1
FR;0;2021-05-16;202760;20712;168;0;0;20882618;8897512;24105;4;1
FR;0;2021-05-17;376128;148746;1555;0;0;21258746;9046258;25660;4;1
FR;0;2021-05-18;460164;153750;1990;0;0;21718910;9200008;27650;4;1
FR;0;2021-05-19;467419;143347;2464;0;0;22186329;9343355;30114;4;1
FR;0;2021-05-20;507546;160307;2339;0;0;22693875;9503662;32453;4;1
FR;0;2021-05-21;489682;174977;1996;0;0;23183557;9678639;34449;4;1
FR;0;2021-05-22;347200;80101;669;0;0;23530757;9758740;35118;4;1
FR;0;2021-05-23;161695;14254;246;0;0;23692452;9772994;35364;4;1
FR;0;2021-05-24;263198;33119;604;0;0;23955650;9806113;35968;4;1
FR;0;2021-05-25;400283;190051;2355;1;0;24355933;9996164;38323;5;1
FR;0;2021-05-26;413460;190108;2224;0;0;24769393;10186272;40547;5;1
FR;0;2021-05-27;449820;219566;2162;0;0;25219213;10405838;42709;5;1
FR;0;2021-05-28;429559;260492;1893;0;0;25648772;10666330;44602;5;1
FR;0;2021-05-29;298989;150113;585;0;0;25947761;10816443;45187;5;1
FR;0;2021-05-30;107143;32533;163;0;0;26054904;10848976;45350;5;1
FR;0;2021-05-31;358042;203342;1471;1;1;26412946;11052318;46821;6;2
FR;0;2021-06-01;431046;251357;1964;1;1;26843992;11303675;48785;7;3
FR;0;2021-06-02;420116;231907;1984;0;0;27264108;11535582;50769;7;3
FR;0;2021-06-03;465628;257872;1825;0;0;27729736;11793454;52594;7;3
FR;0;2021-06-04;456260;305469;1734;1;1;28185996;12098923;54328;8;4
FR;0;2021-06-05;304809;189326;652;0;0;28490805;12288249;54980;8;4
FR;0;2021-06-06;133314;49045;226;0;0;28624119;12337294;55206;8;4
FR;0;2021-06-07;339989;261598;1526;0;0;28964108;12598892;56732;8;4
FR;0;2021-06-08;393899;291196;1804;0;0;29358007;12890088;58536;8;4
FR;0;2021-06-09;384883;274460;1733;0;0;29742890;13164548;60269;8;4
FR;0;2021-06-10;404194;287960;1725;1;0;30147084;13452508;61994;9;4
FR;0;2021-06-11;386671;356689;1467;1;0;30533755;13809197;63461;10;4
FR;0;2021-06-12;283269;211078;496;0;0;30817024;14020275;63957;10;4
FR;0;2021-06-13;104890;73852;204;0;0;30921914;14094127;64161;10;4
FR;0;2021-06-14;240843;354571;1427;1;0;31162757;14448698;65588;11;4
FR;0;2021-06-15;308173;384887;1572;1;0;31470930;14833585;67160;12;4
FR;0;2021-06-16;313982;357507;1418;1;0;31784912;15191092;68578;13;4
FR;0;2021-06-17;317696;372869;1427;1;0;32102608;15563961;70005;14;4
FR;0;2021-06-18;321753;442609;1338;1;0;32424361;16006570;71343;15;4
FR;0;2021-06-19;224348;273891;449;0;0;32648709;16280461;71792;15;4
FR;0;2021-06-20;74439;102397;129;0;0;32723148;16382858;71921;15;4
FR;0;2021-06-21;195776;401678;1038;1;1;32918924;16784536;72959;16;5
FR;0;2021-06-22;223210;467555;1266;10;1;33142134;17252091;74225;26;6
FR;0;2021-06-23;234039;439964;1197;1;1;33376173;17692055;75422;27;7
FR;0;2021-06-24;241871;409594;1358;0;0;33618044;18101649;76780;27;7
FR;0;2021-06-25;227649;522827;1401;0;0;33845693;18624476;78181;27;7
FR;0;2021-06-26;153263;370847;587;1;0;33998956;18995323;78768;28;7
FR;0;2021-06-27;55904;156065;168;1;0;34054860;19151388;78936;29;7
FR;0;2021-06-28;154786;452658;1176;0;0;34209646;19604046;80112;29;7
FR;0;2021-06-29;182719;507400;2123;0;0;34392365;20111446;82235;29;7
FR;0;2021-06-30;204016;485140;2014;21;2;34596381;20596586;84249;50;9
FR;0;2021-07-01;231355;458217;2223;5;1;34827736;21054803;86472;55;10
FR;0;2021-07-02;228697;520112;2120;5;2;35056433;21574915;88592;60;12
FR;0;2021-07-03;142044;368739;908;3;1;35198477;21943654;89500;63;13
FR;0;2021-07-04;56756;141067;265;0;0;35255233;22084721;89765;63;13
FR;0;2021-07-05;168521;418960;1668;8;2;35423754;22503681;91433;71;15
FR;0;2021-07-06;196777;474598;1830;45;8;35620531;22978279;93263;116;23
FR;0;2021-07-07;213206;439097;1879;25;4;35833737;23417376;95142;141;27
FR;0;2021-07-08;231650;424183;2089;20;6;36065387;23841559;97231;161;33
FR;0;2021-07-09;228618;511051;2185;4;2;36294005;24352610;99416;165;35
FR;0;2021-07-10;148623;339902;984;1;1;36442628;24692512;100400;166;36
FR;0;2021-07-11;60202;110089;283;0;0;36502830;24802601;100683;166;36
FR;0;2021-07-12;169422;477951;1762;4;0;36672252;25280552;102445;170;36
FR;0;2021-07-13;287271;526974;2049;8;1;36959523;25807526;104494;178;37
FR;0;2021-07-14;181103;157495;435;0;0;37140626;25965021;104929;178;37
FR;0;2021-07-15;347100;501969;2099;1;0;37487726;26466990;107028;179;37
FR;0;2021-07-16;380110;495420;2023;3;1;37867836;26962410;109051;182;38
FR;0;2021-07-17;259735;319706;877;1;0;38127571;27282116;109928;183;38
FR;0;2021-07-18;109722;114623;310;0;0;38237293;27396739;110238;183;38
FR;0;2021-07-19;285489;424303;1630;3;0;38522782;27821042;111868;186;38
FR;0;2021-07-20;376923;451683;1723;0;0;38899705;28272725;113591;186;38
FR;0;2021-07-21;395804;407243;1549;4;2;39295509;28679968;115140;190;40
FR;0;2021-07-22;441059;387584;1715;4;2;39736568;29067552;116855;194;42
FR;0;2021-07-23;440329;422435;1882;4;1;40176897;29489987;118737;198;43
FR;0;2021-07-24;285252;269398;804;1;0;40462149;29759385;119541;199;43
FR;0;2021-07-25;121115;79949;234;0;0;40583264;29839334;119775;199;43
FR;0;2021-07-26;347430;322525;1614;3;2;40930694;30161859;121389;202;45
FR;0;2021-07-27;464069;319598;1698;4;2;41394763;30481457;123087;206;47
FR;0;2021-07-28;459442;289555;1636;4;1;41854205;30771012;124723;210;48
FR;0;2021-07-29;489827;276406;1796;2;0;42344032;31047418;126519;212;48
FR;0;2021-07-30;461833;302530;1941;5;1;42805865;31349948;128460;217;49
FR;0;2021-07-31;285397;185054;915;1;0;43091262;31535002;129375;218;49
FR;0;2021-08-01;112027;49923;253;0;0;43203289;31584925;129628;218;49
FR;0;2021-08-02;341624;234190;1602;2;0;43544913;31819115;131230;220;49
FR;0;2021-08-03;398617;244632;1728;2;1;43943530;32063747;132958;222;50
FR;0;2021-08-04;384856;209722;1593;6;3;44328386;32273469;134551;228;53
FR;0;2021-08-05;366172;228505;1710;0;0;44694558;32501974;136261;228;53
FR;0;2021-08-06;359732;271401;1835;4;1;45054290;32773375;138096;232;54
FR;0;2021-08-07;213123;178342;755;5;2;45267413;32951717;138851;237;56
FR;0;2021-08-08;74194;63192;276;0;0;45341607;33014909;139127;237;56
FR;0;2021-08-09;258760;258899;1547;4;3;45600367;33273808;140674;241;59
FR;0;2021-08-10;306864;277368;1662;2;1;45907231;33551176;142336;243;60
FR;0;2021-08-11;279743;259754;1441;5;0;46186974;33810930;143777;248;60
FR;0;2021-08-12;271549;278221;1664;3;0;46458523;34089151;145441;251;60
FR;0;2021-08-13;252159;278123;1594;3;2;46710682;34367274;147035;254;62
FR;0;2021-08-14;145345;197144;741;0;0;46856027;34564418;147776;254;62
FR;0;2021-08-15;39387;50107;217;1;0;46895414;34614525;147993;255;62
FR;0;2021-08-16;186187;317696;1542;0;0;47081601;34932221;149535;255;62
FR;0;2021-08-17;215689;336022;1636;7;0;47297290;35268243;151171;262;62
FR;0;2021-08-18;199055;324529;1597;7;4;47496345;35592772;152768;269;66
FR;0;2021-08-19;192032;325531;1640;1;0;47688377;35918303;154408;270;66
FR;0;2021-08-20;186466;366314;1820;3;2;47874843;36284617;156228;273;68
FR;0;2021-08-21;104799;238127;708;0;0;47979642;36522744;156936;273;68
FR;0;2021-08-22;31943;87214;256;1;1;48011585;36609958;157192;274;69
FR;0;2021-08-23;140983;357096;1561;3;1;48152568;36967054;158753;277;70
FR;0;2021-08-24;162493;376715;1849;5;1;48315061;37343769;160602;282;71
FR;0;2021-08-25;151144;350801;2033;8;2;48466205;37694570;162635;290;73
FR;0;2021-08-26;142875;342780;2561;10;0;48609080;38037350;165196;300;73
FR;0;2021-08-27;148454;388305;2790;11;3;48757534;38425655;167986;311;76
FR;0;2021-08-28;90665;249604;1407;0;0;48848199;38675259;169393;311;76
FR;0;2021-08-29;27321;83348;518;1;0;48875520;38758607;169911;312;76
FR;0;2021-08-30;117420;324689;4713;6;5895;48992940;39083296;174624;318;5971
FR;0;2021-08-31;128813;334510;10188;19;11798;49121753;39417806;184812;337;17769
FR;0;2021-09-01;136141;285689;22432;8;24381;49257894;39703495;207244;345;42150
FR;0;2021-09-02;114661;247236;26517;20;28979;49372555;39950731;233761;365;71129
FR;0;2021-09-03;118311;292679;29963;24;33058;49490866;40243410;263724;389;104187
FR;0;2021-09-04;89891;217779;12585;12;14137;49580757;40461189;276309;401;118324
FR;0;2021-09-05;21359;44831;4395;2;4717;49602116;40506020;280704;403;123041
FR;0;2021-09-06;75683;180620;31956;16;34305;49677799;40686640;312660;419;157346
FR;0;2021-09-07;80306;181226;33244;43;36257;49758105;40867866;345904;462;193603
FR;0;2021-09-08;90994;206099;29664;28;32538;49849099;41073965;375568;490;226141
FR;0;2021-09-09;76946;165348;33067;27;36646;49926045;41239313;408635;517;262787
FR;0;2021-09-10;96038;203784;35739;28;40695;50022083;41443097;444374;545;303482
FR;0;2021-09-11;67163;169303;12138;19;14385;50089246;41612400;456512;564;317867
FR;0;2021-09-12;12826;32098;2778;1;3178;50102072;41644498;459290;565;321045
FR;0;2021-09-13;64562;126231;41238;35;44194;50166634;41770729;500528;600;365239
FR;0;2021-09-14;73492;129057;56373;80;62310;50240126;41899786;556901;680;427549
FR;0;2021-09-15;76639;167804;55664;58;54841;50316765;42067590;612565;738;482390
FR;0;2021-09-16;63882;114534;60094;82;60141;50380647;42182124;672659;820;542531
FR;0;2021-09-17;75082;156835;53853;71;57306;50455729;42338959;726512;891;599837
FR;0;2021-09-18;48235;139636;15601;25;17314;50503964;42478595;742113;916;617151
FR;0;2021-09-19;7907;23680;2438;1;2619;50511871;42502275;744551;917;619770
FR;0;2021-09-20;44570;93815;50082;72;50338;50556441;42596090;794633;989;670108
FR;0;2021-09-21;45892;98422;62761;76;63467;50602333;42694512;857394;1065;733575
FR;0;2021-09-22;48674;142390;55370;82;55436;50651007;42836902;912764;1147;789011
FR;0;2021-09-23;43272;92099;62396;95;63569;50694279;42929001;975160;1242;852580
FR;0;2021-09-24;52295;133307;54559;107;59200;50746574;43062308;1029719;1349;911780
FR;0;2021-09-25;35218;115635;16275;36;18299;50781792;43177943;1045994;1385;930079
FR;0;2021-09-26;5553;17804;2270;5;2327;50787345;43195747;1048264;1390;932406
FR;0;2021-09-27;33975;76933;47200;97;48177;50821320;43272680;1095464;1487;980583
FR;0;2021-09-28;36518;75256;54970;90;56554;50857838;43347936;1150434;1577;1037137
FR;0;2021-09-29;44418;100774;53355;112;54877;50902256;43448710;1203789;1689;1092014
FR;0;2021-09-30;36342;72965;57038;97;59583;50938598;43521675;1260827;1786;1151597
FR;0;2021-10-01;61704;102888;57818;108;63965;51000302;43624563;1318645;1894;1215562
FR;0;2021-10-02;39470;78440;20962;39;23362;51039772;43703003;1339607;1933;1238924
FR;0;2021-10-03;5287;10498;2532;4;2538;51045059;43713501;1342139;1937;1241462
FR;0;2021-10-04;35189;58514;52625;84;54833;51080248;43772015;1394764;2021;1296295
FR;0;2021-10-05;33927;64384;61009;135;65064;51114175;43836399;1455773;2156;1361359
FR;0;2021-10-06;42716;79296;65750;113;68338;51156891;43915695;1521523;2269;1429697
FR;0;2021-10-07;30565;62278;65431;90;68848;51187456;43977973;1586954;2359;1498545
FR;0;2021-10-08;49472;91919;77757;110;84745;51236928;44069892;1664711;2469;1583290
FR;0;2021-10-09;33673;60932;31544;35;33919;51270601;44130824;1696255;2504;1617209
FR;0;2021-10-10;4718;7430;3194;9;3475;51275319;44138254;1699449;2513;1620684
FR;0;2021-10-11;30725;49930;61043;105;64102;51306044;44188184;1760492;2618;1684786
FR;0;2021-10-12;31636;54500;70620;140;76000;51337680;44242684;1831112;2758;1760786
FR;0;2021-10-13;40149;62836;74432;136;79345;51377829;44305520;1905544;2894;1840131
FR;0;2021-10-14;30357;52893;68766;116;73830;51408186;44358413;1974310;3010;1913961
FR;0;2021-10-15;44943;75270;93242;191;103010;51453129;44433683;2067552;3201;2016971
FR;0;2021-10-16;31327;44110;36694;44;39643;51484456;44477793;2104246;3245;2056614
FR;0;2021-10-17;3889;5239;3597;2;3680;51488345;44483032;2107843;3247;2060294
FR;0;2021-10-18;29158;42386;67503;133;71364;51517503;44525418;2175346;3380;2131658
FR;0;2021-10-19;27187;45584;76409;140;81645;51544690;44571002;2251755;3520;2213303
FR;0;2021-10-20;35334;52450;96942;181;101552;51580024;44623452;2348697;3701;2314855
FR;0;2021-10-21;26158;45176;83972;112;89148;51606182;44668628;2432669;3813;2404003
FR;0;2021-10-22;38442;62511;104903;200;112608;51644624;44731139;2537572;4013;2516611
FR;0;2021-10-23;27026;41207;45458;57;48628;51671650;44772346;2583030;4070;2565239
FR;0;2021-10-24;2944;4765;3684;6;3927;51674594;44777111;2586714;4076;2569166
FR;0;2021-10-25;26089;36267;82336;144;86657;51700683;44813378;2669050;4220;2655823
FR;0;2021-10-26;23765;35047;87261;166;92385;51724448;44848425;2756311;4386;2748208
FR;0;2021-10-27;30083;46351;109010;257;114709;51754531;44894776;2865321;4643;2862917
FR;0;2021-10-28;23581;34966;88725;153;94500;51778112;44929742;2954046;4796;2957417
FR;0;2021-10-29;31574;51489;117327;206;125373;51809686;44981231;3071373;5002;3082790
FR;0;2021-10-30;20555;33234;50350;76;53400;51830241;45014465;3121723;5078;3136190
FR;0;2021-10-31;2490;3732;3592;3;3879;51832731;45018197;3125315;5081;3140069
FR;0;2021-11-01;8504;4862;3214;3;3577;51841235;45023059;3128529;5084;3143646
FR;0;2021-11-02;26347;40126;93589;156;99614;51867582;45063185;3222118;5240;3243260
FR;0;2021-11-03;30097;47959;118907;220;125861;51897679;45111144;3341025;5460;3369121
FR;0;2021-11-04;23791;37519;107576;217;114447;51921470;45148663;3448601;5677;3483568
FR;0;2021-11-05;32392;52985;141649;235;151401;51953862;45201648;3590250;5912;3634969
FR;0;2021-11-06;21533;34575;64887;123;68314;51975395;45236223;3655137;6035;3703283
FR;0;2021-11-07;2402;4176;5199;6;5595;51977797;45240399;3660336;6041;3708878
FR;0;2021-11-08;20596;37781;127210;227;134322;51998393;45278180;3787546;6268;3843200
FR;0;2021-11-09;22405;44724;161705;339;172280;52020798;45322904;3949251;6607;4015480
FR;0;2021-11-10;31589;55012;187027;446;198838;52052387;45377916;4136278;7053;4214318
FR;0;2021-11-11;4726;6758;12978;28;13962;52057113;45384674;4149256;7081;4228280
FR;0;2021-11-12;29086;55117;183792;252;197415;52086199;45439791;4333048;7333;4425695
FR;0;2021-11-13;20351;32635;80713;118;86339;52106550;45472426;4413761;7451;4512034
FR;0;2021-11-14;2359;3879;7176;6;7847;52108909;45476305;4420937;7457;4519881
FR;0;2021-11-15;20486;38672;160874;312;171600;52129395;45514977;4581811;7769;4691481
FR;0;2021-11-16;23644;43971;200433;394;215092;52153039;45558948;4782244;8163;4906573
FR;0;2021-11-17;30514;50326;199869;406;212918;52183553;45609274;4982113;8569;5119491
FR;0;2021-11-18;23436;45656;191694;468;205597;52206989;45654930;5173807;9037;5325088
FR;0;2021-11-19;33678;61386;243244;551;262237;52240667;45716316;5417051;9588;5587325
FR;0;2021-11-20;25409;36703;102171;206;109721;52266076;45753019;5519222;9794;5697046
FR;0;2021-11-21;2648;4471;9662;19;10616;52268724;45757490;5528884;9813;5707662
FR;0;2021-11-22;22804;33210;180399;470;194880;52291528;45790700;5709283;10283;5902542
FR;0;2021-11-23;25721;45574;229425;549;247889;52317249;45836274;5938708;10832;6150431
FR;0;2021-11-24;31801;53723;224832;715;243277;52349050;45889997;6163540;11547;6393708
FR;0;2021-11-25;25637;49228;255966;739;277834;52374687;45939225;6419506;12286;6671542
FR;0;2021-11-26;33258;74840;379510;867;414686;52407945;46014065;6799016;13153;7086228
FR;0;2021-11-27;23493;49673;214928;389;236709;52431438;46063738;7013944;13542;7322937
FR;0;2021-11-28;3513;10513;56766;66;63327;52434951;46074251;7070710;13608;7386264
FR;0;2021-11-29;19422;54181;341505;864;371772;52454373;46128432;7412215;14472;7758036
FR;0;2021-11-30;24780;71988;457420;988;500826;52479153;46200420;7869635;15460;8258862
FR;0;2021-12-01;27370;75769;469138;1162;511375;52506523;46276189;8338773;16622;8770237
FR;0;2021-12-02;22100;71784;527152;1280;574948;52528623;46347973;8865925;17902;9345185
FR;0;2021-12-03;25560;93095;596436;1420;651214;52554183;46441068;9462361;19322;9996399
FR;0;2021-12-04;18318;60493;336249;692;369823;52572501;46501561;9798610;20014;10366222
FR;0;2021-12-05;4154;16172;95787;157;107047;52576655;46517733;9894397;20171;10473269
FR;0;2021-12-06;28422;72959;493182;1175;540005;52605077;46590692;10387579;21346;11013274
FR;0;2021-12-07;23540;91454;645433;1773;706376;52628617;46682146;11033012;23119;11719650
FR;0;2021-12-08;25499;92214;591643;1874;647563;52654116;46774360;11624655;24993;12367213
FR;0;2021-12-09;24060;94231;663158;2181;726524;52678176;46868591;12287813;27174;13093737
FR;0;2021-12-10;28056;111139;736108;2075;806283;52706232;46979730;13023921;29249;13900020
FR;0;2021-12-11;20250;76216;435204;988;480422;52726482;47055946;13459125;30237;14380442
FR;0;2021-12-12;5660;23203;142317;262;159215;52732142;47079149;13601442;30499;14539657
FR;0;2021-12-13;21354;90992;587696;1699;649307;52753496;47170141;14189138;32198;15188964
FR;0;2021-12-14;27972;118507;765640;2654;847585;52781468;47288648;14954778;34852;16036549
FR;0;2021-12-15;28434;114475;694381;2266;769164;52809902;47403123;15649159;37118;16805713
FR;0;2021-12-16;28031;115957;764074;2557;844502;52837933;47519080;16413233;39675;17650215
FR;0;2021-12-17;31652;128591;807919;2711;892087;52869585;47647671;17221152;42386;18542302
FR;0;2021-12-18;24937;81673;469995;1178;522244;52894522;47729344;17691147;43564;19064546
FR;0;2021-12-19;8758;28665;169410;376;191087;52903280;47758009;17860557;43940;19255633
FR;0;2021-12-20;31751;97404;591531;1786;658797;52935031;47855413;18452088;45726;19914430
FR;0;2021-12-21;39456;112194;682447;2392;759633;52974487;47967607;19134535;48118;20674063
FR;0;2021-12-22;39551;99452;575797;2168;642161;53014038;48067059;19710332;50286;21316224
FR;0;2021-12-23;33783;79621;441028;1657;494418;53047821;48146680;20151360;51943;21810642
FR;0;2021-12-24;10694;26114;111036;398;126672;53058515;48172794;20262396;52341;21937314
FR;0;2021-12-25;776;3587;7592;25;9030;53059291;48176381;20269988;52366;21946344
FR;0;2021-12-26;4696;11896;52096;142;60142;53063987;48188277;20322084;52508;22006486
FR;0;2021-12-27;30505;84070;453574;1364;509194;53094492;48272347;20775658;53872;22515680
FR;0;2021-12-28;38367;99042;564183;1769;632290;53132859;48371389;21339841;55641;23147970
FR;0;2021-12-29;39875;88396;501221;1687;561030;53172734;48459785;21841062;57328;23709000
FR;0;2021-12-30;35922;75232;421040;1521;471158;53208656;48535017;22262102;58849;24180158
FR;0;2021-12-31;12046;25147;116884;405;131673;53220702;48560164;22378986;59254;24311831
FR;0;2022-01-01;1573;3211;8517;37;9939;53222275;48563375;22387503;59291;24321770
FR;0;2022-01-02;6115;13000;58421;125;66947;53228390;48576375;22445924;59416;24388717
FR;0;2022-01-03;37244;90275;494836;1596;551723;53265634;48666650;22940760;61012;24940440
FR;0;2022-01-04;41993;111134;641395;2306;714382;53307627;48777784;23582155;63318;25654822
FR;0;2022-01-05;61109;103735;569187;1984;634219;53368736;48881519;24151342;65302;26289041
FR;0;2022-01-06;44272;110406;638982;2697;711460;53413008;48991925;24790324;67999;27000501
FR;0;2022-01-07;50825;123469;711000;2810;790520;53463833;49115394;25501324;70809;27791021
FR;0;2022-01-08;45007;80325;423812;1213;472891;53508840;49195719;25925136;72022;28263912
FR;0;2022-01-09;15609;26636;128566;300;145671;53524449;49222355;26053702;72322;28409583
FR;0;2022-01-10;35380;93418;469334;1812;522754;53559829;49315773;26523036;74134;28932337
FR;0;2022-01-11;41928;100553;548254;2306;608508;53601757;49416326;27071290;76440;29540845
FR;0;2022-01-12;60401;95803;452688;1968;504358;53662158;49512129;27523978;78408;30045203
FR;0;2022-01-13;38253;92631;487357;2085;541051;53700411;49604760;28011335;80493;30586254
FR;0;2022-01-14;42575;103442;568606;2286;629016;53742986;49708202;28579941;82779;31215270
FR;0;2022-01-15;39416;65934;340133;985;377560;53782402;49774136;28920074;83764;31592830
FR;0;2022-01-16;11410;19258;87431;216;99423;53793812;49793394;29007505;83980;31692253
FR;0;2022-01-17;24733;60133;320288;1382;354173;53818545;49853527;29327793;85362;32046426
FR;0;2022-01-18;28322;68787;361091;1802;397569;53846867;49922314;29688884;87164;32443995
FR;0;2022-01-19;43212;67131;281296;1450;311074;53890079;49989445;29970180;88614;32755069
FR;0;2022-01-20;23661;59691;299014;1741;328514;53913740;50049136;30269194;90355;33083583
FR;0;2022-01-21;28200;68894;366368;2086;401205;53941940;50118030;30635562;92441;33484788
FR;0;2022-01-22;27625;48011;218792;839;241769;53969565;50166041;30854354;93280;33726557
FR;0;2022-01-23;6738;12998;48678;173;55174;53976303;50179039;30903032;93453;33781731
FR;0;2022-01-24;16270;47520;217314;1140;239343;53992573;50226559;31120346;94593;34021074
FR;0;2022-01-25;19026;54404;243054;1546;267085;54011599;50280963;31363400;96139;34288159
FR;0;2022-01-26;28145;60534;209284;1297;229488;54039744;50341497;31572684;97436;34517647
FR;0;2022-01-27;16328;46390;207645;1277;225967;54056072;50387887;31780329;98713;34743614
FR;0;2022-01-28;21584;78719;290053;1572;321375;54077656;50466606;32070382;100285;35064989
FR;0;2022-01-29;18420;52894;184129;689;204584;54096076;50519500;32254511;100974;35269573
FR;0;2022-01-30;4474;14505;39142;124;45085;54100550;50534005;32293653;101098;35314658
FR;0;2022-01-31;11256;43960;148200;741;164764;54111806;50577965;32441853;101839;35479422
FR;0;2022-02-01;13617;48381;174121;1143;191392;54125423;50626346;32615974;102982;35670814
FR;0;2022-02-02;20577;66378;171532;1034;190114;54146000;50692724;32787506;104016;35860928
FR;0;2022-02-03;11468;44785;157556;989;173321;54157468;50737509;32945062;105005;36034249
FR;0;2022-02-04;14624;66513;239249;1266;264151;54172092;50804022;33184311;106271;36298400
FR;0;2022-02-05;12895;51481;153549;523;172326;54184987;50855503;33337860;106794;36470726
FR;0;2022-02-06;2725;12182;28893;101;33836;54187712;50867685;33366753;106895;36504562
FR;0;2022-02-07;9561;46696;156869;592;176305;54197273;50914381;33523622;107487;36680867
FR;0;2022-02-08;9796;43080;166625;867;184419;54207069;50957461;33690247;108354;36865286
FR;0;2022-02-09;14373;58240;172336;872;193043;54221442;51015701;33862583;109226;37058329
FR;0;2022-02-10;8715;39131;150230;878;166705;54230157;51054832;34012813;110104;37225034
FR;0;2022-02-11;10857;55667;218503;1101;243096;54241014;51110499;34231316;111205;37468130
FR;0;2022-02-12;8399;40954;134722;465;151750;54249413;51151453;34366038;111670;37619880
FR;0;2022-02-13;1915;8601;26564;86;30924;54251328;51160054;34392602;111756;37650804
FR;0;2022-02-14;6986;35245;148373;483;166369;54258314;51195299;34540975;112239;37817173
FR;0;2022-02-15;7059;36212;146977;751;162562;54265373;51231511;34687952;112990;37979735
FR;0;2022-02-16;9404;42966;132533;720;146751;54274777;51274477;34820485;113710;38126486
FR;0;2022-02-17;5575;24323;87300;585;94872;54280352;51298800;34907785;114295;38221358
FR;0;2022-02-18;6992;33572;119660;804;129323;54287344;51332372;35027445;115099;38350681
FR;0;2022-02-19;5369;24548;70024;370;77334;54292713;51356920;35097469;115469;38428015
FR;0;2022-02-20;1147;4651;12171;39;13950;54293860;51361571;35109640;115508;38441965
FR;0;2022-02-21;4091;17883;61952;351;67179;54297951;51379454;35171592;115859;38509144
FR;0;2022-02-22;4450;18652;60833;576;64474;54302401;51398106;35232425;116435;38573618
FR;0;2022-02-23;6588;27349;66493;591;71890;54308989;51425455;35298918;117026;38645508
FR;0;2022-02-24;3848;15476;50421;519;53242;54312837;51440931;35349339;117545;38698750
FR;0;2022-02-25;5279;24044;76359;803;80092;54318116;51464975;35425698;118348;38778842
FR;0;2022-02-26;3990;17766;47414;359;51481;54322106;51482741;35473112;118707;38830323
FR;0;2022-02-27;879;3008;8035;47;8946;54322985;51485749;35481147;118754;38839269
FR;0;2022-02-28;3123;12537;40481;359;42914;54326108;51498286;35521628;119113;38882183
FR;0;2022-03-01;3974;12600;44190;436;44862;54330082;51510886;35565818;119549;38927045
FR;0;2022-03-02;5315;17791;47134;445;49067;54335397;51528677;35612952;119994;38976112
FR;0;2022-03-03;2812;9337;29891;368;30014;54338209;51538014;35642843;120362;39006126
FR;0;2022-03-04;3222;12417;40301;666;39452;54341431;51550431;35683144;121028;39045578
FR;0;2022-03-05;3071;9280;24953;309;25115;54344502;51559711;35708097;121337;39070693
FR;0;2022-03-06;520;1399;3198;43;3441;54345022;51561110;35711295;121380;39074134
FR;0;2022-03-07;2313;5622;18427;315;17696;54347335;51566732;35729722;121695;39091830
FR;0;2022-03-08;2122;6073;19447;361;17916;54349457;51572805;35749169;122056;39109746
FR;0;2022-03-09;3575;10500;22180;405;21278;54353032;51583305;35771349;122461;39131024
FR;0;2022-03-10;1820;5796;16987;344;15815;54354852;51589101;35788336;122805;39146839
FR;0;2022-03-11;2414;7550;24496;541;22263;54357266;51596651;35812832;123346;39169102
FR;0;2022-03-12;2675;6773;17160;308;16514;54359941;51603424;35829992;123654;39185616
FR;0;2022-03-13;398;790;2324;149;2273;54360339;51604214;35832316;123803;39187889
FR;0;2022-03-14;1543;4270;14977;4409;13833;54361882;51608484;35847293;128212;39201722
FR;0;2022-03-15;1733;6283;16374;7552;14605;54363615;51614767;35863667;135764;39216327
FR;0;2022-03-16;3032;7394;19423;13137;18100;54366647;51622161;35883090;148901;39234427
FR;0;2022-03-17;1451;3980;13141;10847;11984;54368098;51626141;35896231;159748;39246411
FR;0;2022-03-18;2268;5752;19999;18300;18094;54370366;51631893;35916230;178048;39264505
FR;0;2022-03-19;2291;4803;13114;9401;12416;54372657;51636696;35929344;187449;39276921
FR;0;2022-03-20;300;734;1919;1073;1930;54372957;51637430;35931263;188522;39278851
FR;0;2022-03-21;1391;3216;12718;14936;11941;54374348;51640646;35943981;203458;39290792
FR;0;2022-03-22;1506;3731;13793;20541;12550;54375854;51644377;35957774;223999;39303342
FR;0;2022-03-23;2679;6277;17719;23151;17235;54378533;51650654;35975493;247150;39320577
FR;0;2022-03-24;1402;3154;11589;17608;10676;54379935;51653808;35987082;264758;39331253
FR;0;2022-03-25;2081;5150;18565;27759;16904;54382016;51658958;36005647;292517;39348157
FR;0;2022-03-26;2230;4411;12077;12678;11517;54384246;51663369;36017724;305195;39359674
FR;0;2022-03-27;360;690;1906;1481;1940;54384606;51664059;36019630;306676;39361614
FR;0;2022-03-28;1461;3073;11123;17487;10614;54386067;51667132;36030753;324163;39372228
FR;0;2022-03-29;1452;3267;12902;27571;12048;54387519;51670399;36043655;351734;39384276
FR;0;2022-03-30;2847;5499;15677;27386;15071;54390366;51675898;36059332;379120;39399347
FR;0;2022-03-31;1609;3561;12977;24985;12310;54391975;51679459;36072309;404105;39411657
FR;0;2022-04-01;2673;4579;20052;30879;18694;54394648;51684038;36092361;434984;39430351
FR;0;2022-04-02;1523;2639;9047;10117;8706;54396171;51686677;36101408;445101;39439057
FR;0;2022-04-03;288;513;1561;1169;1578;54396459;51687190;36102969;446270;39440635
FR;0;2022-04-04;2173;2873;12365;19111;11571;54398632;51690063;36115334;465381;39452206
FR;0;2022-04-05;2044;3146;14334;34090;13186;54400676;51693209;36129668;499471;39465392
FR;0;2022-04-06;2364;3925;13529;26477;12797;54403040;51697134;36143197;525948;39478189
FR;0;2022-04-07;1573;3097;13666;33754;12878;54404613;51700231;36156863;559702;39491067
FR;0;2022-04-08;2073;4227;19215;43935;17819;54406686;51704458;36176078;603637;39508886
FR;0;2022-04-09;1363;2674;9312;13560;8864;54408049;51707132;36185390;617197;39517750
FR;0;2022-04-10;291;689;1982;2014;2002;54408340;51707821;36187372;619211;39519752
FR;0;2022-04-11;1307;2601;11863;23887;11471;54409647;51710422;36199235;643098;39531223
FR;0;2022-04-12;1684;3019;14012;40887;13383;54411331;51713441;36213247;683985;39544606
FR;0;2022-04-13;1954;3675;13405;33076;13023;54413285;51717116;36226652;717061;39557629
FR;0;2022-04-14;1487;2892;13194;36287;13038;54414772;51720008;36239846;753348;39570667
FR;0;2022-04-15;1849;3449;15622;35508;14869;54416621;51723457;36255468;788856;39585536
FR;0;2022-04-16;1041;1827;6395;8535;6251;54417662;51725284;36261863;797391;39591787
FR;0;2022-04-17;193;336;992;1172;1035;54417855;51725620;36262855;798563;39592822
FR;0;2022-04-18;195;528;2764;1069;2783;54418050;51726148;36265619;799632;39595605
FR;0;2022-04-19;1525;3005;12908;29627;12468;54419575;51729153;36278527;829259;39608073
FR;0;2022-04-20;1985;3448;13298;29032;12974;54421560;51732601;36291825;858291;39621047
FR;0;2022-04-21;1508;2845;12532;35145;12605;54423068;51735446;36304357;893436;39633652
FR;0;2022-04-22;1862;3601;16466;37590;15828;54424930;51739047;36320823;931026;39649480
FR;0;2022-04-23;1144;2061;7383;10655;7234;54426074;51741108;36328206;941681;39656714
FR;0;2022-04-24;250;459;1475;1588;1411;54426324;51741567;36329681;943269;39658125
FR;0;2022-04-25;1301;2529;10676;21011;10482;54427625;51744096;36340357;964280;39668607
FR;0;2022-04-26;1618;3001;13655;38564;13105;54429243;51747097;36354012;1002844;39681712
FR;0;2022-04-27;1958;3058;11532;30974;11590;54431201;51750155;36365544;1033818;39693302
FR;0;2022-04-28;1563;2750;12524;36186;12265;54432764;51752905;36378068;1070004;39705567
FR;0;2022-04-29;2006;4474;15544;37225;14910;54434770;51757379;36393612;1107229;39720477
FR;0;2022-04-30;1211;1924;6926;9706;6753;54435981;51759303;36400538;1116935;39727230
FR;0;2022-05-01;217;323;913;996;907;54436198;51759626;36401451;1117931;39728137
FR;0;2022-05-02;1869;2923;11145;18129;10963;54438067;51762549;36412596;1136060;39739100
FR;0;2022-05-03;1884;3243;13715;34663;13556;54439951;51765792;36426311;1170723;39752656
FR;0;2022-05-04;1889;3280;12176;25621;12289;54441840;51769072;36438487;1196344;39764945
FR;0;2022-05-05;1753;2901;13035;33533;12882;54443593;51771973;36451522;1229877;39777827
FR;0;2022-05-06;2205;3654;15336;36745;14830;54445798;51775627;36466858;1266622;39792657
FR;0;2022-05-07;1202;1776;6460;9606;6450;54447000;51777403;36473318;1276228;39799107
FR;0;2022-05-08;266;399;1172;1546;1233;54447266;51777802;36474490;1277774;39800340
FR;0;2022-05-09;1350;2292;9921;20251;9791;54448616;51780094;36484411;1298025;39810131
FR;0;2022-05-10;1751;3199;13561;38943;13117;54450367;51783293;36497972;1336968;39823248
FR;0;2022-05-11;1991;2995;10742;27906;10687;54452358;51786288;36508714;1364874;39833935
FR;0;2022-05-12;1581;2696;11365;35674;11036;54453939;51788984;36520079;1400548;39844971
FR;0;2022-05-13;1968;3206;13748;37840;13334;54455907;51792190;36533827;1438388;39858305
FR;0;2022-05-14;1146;1627;5936;10772;5798;54457053;51793817;36539763;1449160;39864103
FR;0;2022-05-15;280;470;1279;1436;1360;54457333;51794287;36541042;1450596;39865463
FR;0;2022-05-16;1191;2027;8681;20992;8676;54458524;51796314;36549723;1471588;39874139
FR;0;2022-05-17;1583;2590;11816;37842;11395;54460107;51798904;36561539;1509430;39885534
FR;0;2022-05-18;1805;2637;9682;27132;9656;54461912;51801541;36571221;1536562;39895190
FR;0;2022-05-19;1435;2642;10567;35823;10706;54463347;51804183;36581788;1572385;39905896
FR;0;2022-05-20;1874;3109;13413;39349;12904;54465221;51807292;36595201;1611734;39918800
FR;0;2022-05-21;1158;1704;5660;9896;5532;54466379;51808996;36600861;1621630;39924332
FR;0;2022-05-22;238;337;1025;1437;1012;54466617;51809333;36601886;1623067;39925344
FR;0;2022-05-23;1173;2112;8876;20340;8826;54467790;51811445;36610762;1643407;39934170
FR;0;2022-05-24;1537;2753;11354;38850;11225;54469327;51814198;36622116;1682257;39945395
FR;0;2022-05-25;1812;2820;9338;24813;9470;54471139;51817018;36631454;1707070;39954865
FR;0;2022-05-26;207;413;1657;1191;1667;54471346;51817431;36633111;1708261;39956532
FR;0;2022-05-27;1374;2457;9253;21270;8996;54472720;51819888;36642364;1729531;39965528
FR;0;2022-05-28;663;1254;3912;6781;3962;54473383;51821142;36646276;1736312;39969490
FR;0;2022-05-29;156;315;751;918;772;54473539;51821457;36647027;1737230;39970262
FR;0;2022-05-30;1022;1945;6993;19289;7007;54474561;51823402;36654020;1756519;39977269
FR;0;2022-05-31;1487;2494;9814;35652;9635;54476048;51825896;36663834;1792171;39986904
FR;0;2022-06-01;1719;3087;11018;24524;10884;54477767;51828983;36674852;1816695;39997788
FR;0;2022-06-02;1470;2605;11304;35529;10849;54479237;51831588;36686156;1852224;40008637
FR;0;2022-06-03;1718;3061;13377;38705;12740;54480955;51834649;36699533;1890929;40021377
FR;0;2022-06-04;968;1514;5041;9109;5113;54481923;51836163;36704574;1900038;40026490
FR;0;2022-06-05;176;329;874;1106;884;54482099;51836492;36705448;1901144;40027374
FR;0;2022-06-06;391;1124;2107;1258;2119;54482490;51837616;36707555;1902402;40029493
FR;0;2022-06-07;1374;2670;9845;35572;9424;54483864;51840286;36717400;1937974;40038917
FR;0;2022-06-08;1547;2681;9160;28709;9002;54485411;51842967;36726560;1966683;40047919
FR;0;2022-06-09;1282;2432;10610;39470;10252;54486693;51845399;36737170;2006153;40058171
FR;0;2022-06-10;1619;2894;13070;44788;12617;54488312;51848293;36750240;2050941;40070788
FR;0;2022-06-11;956;1730;5431;11621;5464;54489268;51850023;36755671;2062562;40076252
FR;0;2022-06-12;196;439;1072;1761;1133;54489464;51850462;36756743;2064323;40077385
FR;0;2022-06-13;1079;2052;7430;23173;7261;54490543;51852514;36764173;2087496;40084646
FR;0;2022-06-14;1314;2494;10442;44922;9797;54491857;51855008;36774615;2132418;40094443
FR;0;2022-06-15;1501;2412;9312;30874;8944;54493358;51857420;36783927;2163292;40103387
FR;0;2022-06-16;1166;2021;9905;39882;9313;54494524;51859441;36793832;2203174;40112700
FR;0;2022-06-17;1474;2825;12455;46597;11885;54495998;51862266;36806287;2249771;40124585
FR;0;2022-06-18;852;1515;4563;11123;4497;54496850;51863781;36810850;2260894;40129082
FR;0;2022-06-19;180;361;1058;1615;1130;54497030;51864142;36811908;2262509;40130212
FR;0;2022-06-20;1018;1912;8904;26063;8564;54498048;51866054;36820812;2288572;40138776
FR;0;2022-06-21;1320;2396;10299;49874;9328;54499368;51868450;36831111;2338446;40148104
FR;0;2022-06-22;1378;2479;8908;39031;8412;54500746;51870929;36840019;2377477;40156516
FR;0;2022-06-23;1222;2348;10673;55080;9882;54501968;51873277;36850692;2432557;40166398
FR;0;2022-06-24;1483;2977;13639;69143;12299;54503451;51876254;36864331;2501700;40178697
FR;0;2022-06-25;933;1776;6225;19912;5979;54504384;51878030;36870556;2521612;40184676
FR;0;2022-06-26;228;460;1952;3687;1816;54504612;51878490;36872508;2525299;40186492
FR;0;2022-06-27;1126;2013;10491;48466;9633;54505738;51880503;36882999;2573765;40196125
FR;0;2022-06-28;1453;2806;14658;91320;13080;54507191;51883309;36897657;2665085;40209205
FR;0;2022-06-29;1702;2819;12287;71844;11235;54508893;51886128;36909944;2736929;40220440
FR;0;2022-06-30;1523;2684;14385;95147;12466;54510416;51888812;36924329;2832076;40232906
FR;0;2022-07-01;1988;3786;21461;115918;18818;54512404;51892598;36945790;2947994;40251724
FR;0;2022-07-02;1077;1853;8518;35748;7698;54513481;51894451;36954308;2983742;40259422
FR;0;2022-07-03;290;538;2091;6452;1893;54513771;51894989;36956399;2990194;40261315
FR;0;2022-07-04;1583;3125;14682;79188;12953;54515354;51898114;36971081;3069382;40274268
FR;0;2022-07-05;1697;3103;18816;133210;15995;54517051;51901217;36989897;3202592;40290263
FR;0;2022-07-06;1808;2760;15846;99544;13634;54518859;51903977;37005743;3302136;40303897
FR;0;2022-07-07;1697;2861;17987;125932;14764;54520556;51906838;37023730;3428068;40318661
FR;0;2022-07-08;1883;3141;20742;137053;16754;54522439;51909979;37044472;3565121;40335415
FR;0;2022-07-09;865;1450;7738;37913;6684;54523304;51911429;37052210;3603034;40342099
FR;0;2022-07-10;261;509;2344;6999;2125;54523565;51911938;37054554;3610033;40344224
FR;0;2022-07-11;1412;2441;15010;88223;12491;54524977;51914379;37069564;3698256;40356715
FR;0;2022-07-12;1788;3078;20515;143915;16708;54526765;51917457;37090079;3842171;40373423
FR;0;2022-07-13;1717;2704;15677;94511;13249;54528482;51920161;37105756;3936682;40386672
FR;0;2022-07-14;178;362;1950;5531;1829;54528660;51920523;37107706;3942213;40388501
FR;0;2022-07-15;1469;2550;15109;84426;12593;54530129;51923073;37122815;4026639;40401094
FR;0;2022-07-16;614;1170;5939;24973;5147;54530743;51924243;37128754;4051612;40406241
FR;0;2022-07-17;175;389;1735;4660;1566;54530918;51924632;37130489;4056272;40407807
FR;0;2022-07-18;1127;2237;11819;61791;9964;54532045;51926869;37142308;4118063;40417771
FR;0;2022-07-19;1409;2338;15463;103644;12283;54533454;51929207;37157771;4221707;40430054
FR;0;2022-07-20;1406;2278;12940;77546;10716;54534860;51931485;37170711;4299253;40440770
FR;0;2022-07-21;1269;2151;13078;88178;10479;54536129;51933636;37183789;4387431;40451249
FR;0;2022-07-22;1396;2435;14798;89446;11946;54537525;51936071;37198587;4476877;40463195
FR;0;2022-07-23;670;1299;5526;22474;4852;54538195;51937370;37204113;4499351;40468047
FR;0;2022-07-24;183;346;1396;3900;1237;54538378;51937716;37205509;4503251;40469284
FR;0;2022-07-25;1052;1783;9481;48050;7829;54539430;51939499;37214990;4551301;40477113
FR;0;2022-07-26;1287;2204;13293;85399;10818;54540717;51941703;37228283;4636700;40487931
FR;0;2022-07-27;1217;1990;10213;61203;8505;54541934;51943693;37238496;4697903;40496436
FR;0;2022-07-28;1084;1853;10297;64346;8207;54543018;51945546;37248793;4762249;40504643
FR;0;2022-07-29;1280;2029;10971;65801;8728;54544298;51947575;37259764;4828050;40513371
FR;0;2022-07-30;496;846;3513;15265;2967;54544794;51948421;37263277;4843315;40516338
FR;0;2022-07-31;151;284;929;2437;788;54544945;51948705;37264206;4845752;40517126
FR;0;2022-08-01;831;1471;7575;30221;6370;54545776;51950176;37271781;4875973;40523496
FR;0;2022-08-02;1013;1621;8556;56060;6866;54546789;51951797;37280337;4932033;40530362
FR;0;2022-08-03;827;1240;6400;38659;5121;54547616;51953037;37286737;4970692;40535483
FR;0;2022-08-04;727;1172;6561;43089;5287;54548343;51954209;37293298;5013781;40540770
FR;0;2022-08-05;846;1352;7080;44911;5650;54549189;51955561;37300378;5058692;40546420
FR;0;2022-08-06;334;552;2098;9364;1755;54549523;51956113;37302476;5068056;40548175
FR;0;2022-08-07;98;153;534;1620;452;54549621;51956266;37303010;5069676;40548627
FR;0;2022-08-08;552;914;4004;22085;3260;54550173;51957180;37307014;5091761;40551887
FR;0;2022-08-09;683;1127;5957;39925;4790;54550856;51958307;37312971;5131686;40556677
FR;0;2022-08-10;621;1087;4647;28012;3782;54551477;51959394;37317618;5159698;40560459
FR;0;2022-08-11;611;1009;4476;29181;3690;54552088;51960403;37322094;5188879;40564149
FR;0;2022-08-12;704;1138;4735;28195;3907;54552792;51961541;37326829;5217074;40568056
FR;0;2022-08-13;207;403;1293;5250;1115;54552999;51961944;37328122;5222324;40569171
FR;0;2022-08-14;70;119;287;920;245;54553069;51962063;37328409;5223244;40569416
FR;0;2022-08-15;75;169;596;562;543;54553144;51962232;37329005;5223806;40569959
FR;0;2022-08-16;617;1045;3944;22144;3337;54553761;51963277;37332949;5245950;40573296
FR;0;2022-08-17;624;998;3877;22845;3279;54554385;51964275;37336826;5268795;40576575
FR;0;2022-08-18;605;964;4077;26272;3218;54554990;51965239;37340903;5295067;40579793
FR;0;2022-08-19;602;1146;4476;27214;3680;54555592;51966385;37345379;5322281;40583473
FR;0;2022-08-20;288;483;1344;5559;1156;54555880;51966868;37346723;5327840;40584629
FR;0;2022-08-21;94;132;299;1007;263;54555974;51967000;37347022;5328847;40584892
FR;0;2022-08-22;543;973;3265;15331;2789;54556517;51967973;37350287;5344178;40587681
FR;0;2022-08-23;704;1160;4285;28987;3601;54557221;51969133;37354572;5373165;40591282
FR;0;2022-08-24;647;921;3482;19522;2845;54557868;51970054;37358054;5392687;40594127
FR;0;2022-08-25;618;1003;3924;23375;3270;54558486;51971057;37361978;5416062;40597397
FR;0;2022-08-26;847;1245;4466;25867;3656;54559333;51972302;37366444;5441929;40601053
FR;0;2022-08-27;291;493;1377;5460;1243;54559624;51972795;37367821;5447389;40602296
FR;0;2022-08-28;122;158;303;915;287;54559746;51972953;37368124;5448304;40602583
FR;0;2022-08-29;615;959;3067;14618;2604;54560361;51973912;37371191;5462922;40605187
FR;0;2022-08-30;839;1197;4783;28511;3906;54561200;51975109;37375974;5491433;40609093
FR;0;2022-08-31;681;932;3189;17590;2701;54561881;51976041;37379163;5509023;40611794
FR;0;2022-09-01;704;957;4435;22441;3779;54562585;51976998;37383598;5531464;40615573
FR;0;2022-09-02;861;1117;5022;28588;4235;54563446;51978115;37388620;5560052;40619808
FR;0;2022-09-03;411;553;1911;6074;1654;54563857;51978668;37390531;5566126;40621462
FR;0;2022-09-04;130;147;349;871;346;54563987;51978815;37390880;5566997;40621808
FR;0;2022-09-05;602;669;3109;16043;2587;54564589;51979484;37393989;5583040;40624395
FR;0;2022-09-06;785;993;4710;31789;3843;54565374;51980477;37398699;5614829;40628238
FR;0;2022-09-07;631;753;2988;16766;2469;54566005;51981230;37401687;5631595;40630707
FR;0;2022-09-08;610;837;3789;24810;3124;54566615;51982067;37405476;5656405;40633831
FR;0;2022-09-09;823;994;4399;27516;3635;54567438;51983061;37409875;5683921;40637466
FR;0;2022-09-10;372;528;1724;5691;1525;54567810;51983589;37411599;5689612;40638991
FR;0;2022-09-11;122;127;317;653;302;54567932;51983716;37411916;5690265;40639293
FR;0;2022-09-12;481;596;2662;13262;2270;54568413;51984312;37414578;5703527;40641563
FR;0;2022-09-13;602;823;3980;26340;3407;54569015;51985135;37418558;5729867;40644970
FR;0;2022-09-14;647;759;2934;16102;2445;54569662;51985894;37421492;5745969;40647415
FR;0;2022-09-15;543;759;3432;23480;2901;54570205;51986653;37424924;5769449;40650316
FR;0;2022-09-16;780;1021;4119;25816;3456;54570985;51987674;37429043;5795265;40653772
FR;0;2022-09-17;382;482;1442;6124;1272;54571367;51988156;37430485;5801389;40655044
FR;0;2022-09-18;114;137;323;958;290;54571481;51988293;37430808;5802347;40655334
FR;0;2022-09-19;439;622;2242;13166;1915;54571920;51988915;37433050;5815513;40657249
FR;0;2022-09-20;624;852;3758;26331;3130;54572544;51989767;37436808;5841844;40660379
FR;0;2022-09-21;572;758;2726;16238;2343;54573116;51990525;37439534;5858082;40662722
FR;0;2022-09-22;578;808;3383;23542;2757;54573694;51991333;37442917;5881624;40665479
FR;0;2022-09-23;815;1023;4470;28624;3742;54574509;51992356;37447387;5910248;40669221
FR;0;2022-09-24;417;603;1628;6889;1400;54574926;51992959;37449015;5917137;40670621
FR;0;2022-09-25;94;184;335;1100;306;54575020;51993143;37449350;5918237;40670927
FR;0;2022-09-26;422;687;2262;13431;1995;54575442;51993830;37451612;5931668;40672922
FR;0;2022-09-27;605;826;3603;25908;2887;54576047;51994656;37455215;5957576;40675809
FR;0;2022-09-28;612;810;2543;15378;2287;54576659;51995466;37457758;5972954;40678096
FR;0;2022-09-29;552;749;3093;20914;2603;54577211;51996215;37460851;5993868;40680699
FR;0;2022-09-30;759;1079;3926;25481;3268;54577970;51997294;37464777;6019349;40683967
FR;0;2022-10-01;388;597;1885;5938;1618;54578358;51997891;37466662;6025287;40685585
FR;0;2022-10-02;51;127;215;632;209;54578409;51998018;37466877;6025919;40685794
FR;0;2022-10-03;425;604;2353;11990;2061;54578834;51998622;37469230;6037909;40687855
FR;0;2022-10-04;596;749;3255;23457;2650;54579430;51999371;37472485;6061366;40690505
FR;0;2022-10-05;526;787;2388;14556;2106;54579956;52000158;37474873;6075922;40692611
FR;0;2022-10-06;513;688;3018;21584;2464;54580469;52000846;37477891;6097506;40695075
FR;0;2022-10-07;707;958;4050;30197;3399;54581176;52001804;37481941;6127703;40698474
FR;0;2022-10-08;333;507;1583;8373;1345;54581509;52002311;37483524;6136076;40699819
FR;0;2022-10-09;103;134;333;1577;308;54581612;52002445;37483857;6137653;40700127
FR;0;2022-10-10;452;646;2562;20258;2161;54582064;52003091;37486419;6157911;40702288
FR;0;2022-10-11;555;768;4172;39949;3466;54582619;52003859;37490591;6197860;40705754
FR;0;2022-10-12;543;767;3166;26540;2679;54583162;52004626;37493757;6224400;40708433
FR;0;2022-10-13;587;724;3915;38149;3034;54583749;52005350;37497672;6262549;40711467
FR;0;2022-10-14;735;1014;4769;47385;3864;54584484;52006364;37502441;6309934;40715331
FR;0;2022-10-15;334;460;1748;11753;1515;54584818;52006824;37504189;6321687;40716846
FR;0;2022-10-16;90;120;358;1935;339;54584908;52006944;37504547;6323622;40717185
FR;0;2022-10-17;412;653;2817;26143;2267;54585320;52007597;37507364;6349765;40719452
FR;0;2022-10-18;575;701;4481;45569;3550;54585895;52008298;37511845;6395334;40723002
FR;0;2022-10-19;530;741;3479;33999;2893;54586425;52009039;37515324;6429333;40725895
FR;0;2022-10-20;561;709;4570;48384;3439;54586986;52009748;37519894;6477717;40729334
FR;0;2022-10-21;661;942;5393;56244;4192;54587647;52010690;37525287;6533961;40733526
FR;0;2022-10-22;319;374;1558;12757;1228;54587966;52011064;37526845;6546718;40734754
FR;0;2022-10-23;90;90;333;2021;254;54588056;52011154;37527178;6548739;40735008
FR;0;2022-10-24;517;546;2935;26283;2418;54588573;52011700;37530113;6575022;40737426
FR;0;2022-10-25;558;671;4596;47162;3518;54589131;52012371;37534709;6622184;40740944
FR;0;2022-10-26;476;569;3158;30240;2601;54589607;52012940;37537867;6652424;40743545
