fra;vaccin;jour;n_dose1;n_dose2;n_dose3;n_dose4;n_rappel;n_cum_dose1;n_cum_dose2;n_cum_dose3;n_cum_dose4;n_cum_rappel
FR;1;2020-12-27;609;0;0;0;0;609;0;0;0;0
FR;1;2020-12-28;678;1;0;0;0;1287;1;0;0;0
FR;1;2020-12-29;380;0;0;0;0;1667;1;0;0;0
FR;1;2020-12-30;442;0;0;0;0;2109;1;0;0;0
FR;1;2020-12-31;439;1;0;0;0;2548;2;0;0;0
FR;1;2021-01-01;1149;2;0;0;0;3697;4;0;0;0
FR;1;2021-01-02;362;3;0;0;0;4059;7;0;0;0
FR;1;2021-01-03;402;0;0;0;0;4461;7;0;0;0
FR;1;2021-01-04;2103;3;0;0;0;6564;10;0;0;0
FR;1;2021-01-05;7745;3;0;0;0;14309;13;0;0;0
FR;1;2021-01-06;12454;16;0;0;0;26763;29;0;0;0
FR;1;2021-01-07;29457;13;0;0;0;56220;42;0;0;0
FR;1;2021-01-08;37140;14;0;0;0;93360;56;0;0;0
FR;1;2021-01-09;11212;7;0;0;0;104572;63;0;0;0
FR;1;2021-01-10;6003;5;0;0;0;110575;68;0;0;0
FR;1;2021-01-11;39929;19;0;0;0;150504;87;0;0;0
FR;1;2021-01-12;62132;18;0;0;0;212636;105;0;0;0
FR;1;2021-01-13;65114;38;0;0;0;277750;143;0;0;0
FR;1;2021-01-14;81443;127;0;0;0;359193;270;0;0;0
FR;1;2021-01-15;68607;44;0;0;0;427800;314;0;0;0
FR;1;2021-01-16;19896;72;0;0;0;447696;386;0;0;0
FR;1;2021-01-17;10901;49;0;0;0;458597;435;0;0;0
FR;1;2021-01-18;82820;167;0;0;0;541417;602;0;0;0
FR;1;2021-01-19;125914;181;0;0;0;667331;783;0;0;0
FR;1;2021-01-20;132405;181;0;0;0;799736;964;0;0;0
FR;1;2021-01-21;153053;164;0;0;0;952789;1128;0;0;0
FR;1;2021-01-22;115938;214;0;0;0;1068727;1342;0;0;0
FR;1;2021-01-23;36606;67;0;0;0;1105333;1409;0;0;0
FR;1;2021-01-24;9581;93;0;0;0;1114914;1502;0;0;0
FR;1;2021-01-25;74418;1315;0;0;0;1189332;2817;0;0;0
FR;1;2021-01-26;96452;3409;1;0;0;1285784;6226;1;0;0
FR;1;2021-01-27;103637;6052;0;0;0;1389421;12278;1;0;0
FR;1;2021-01-28;120591;15306;0;0;0;1510012;27584;1;0;0
FR;1;2021-01-29;88886;17987;0;0;0;1598898;45571;1;0;0
FR;1;2021-01-30;27991;4381;0;0;0;1626889;49952;1;0;0
FR;1;2021-01-31;5186;1791;0;0;0;1632075;51743;1;0;0
FR;1;2021-02-01;49713;21790;0;0;0;1681788;73533;1;0;0
FR;1;2021-02-02;67806;36395;0;0;0;1749594;109928;1;0;0
FR;1;2021-02-03;67080;38671;0;0;0;1816674;148599;1;0;0
FR;1;2021-02-04;77132;52480;0;0;0;1893806;201079;1;0;0
FR;1;2021-02-05;63414;46550;0;0;0;1957220;247629;1;0;0
FR;1;2021-02-06;19415;10936;0;0;0;1976635;258565;1;0;0
FR;1;2021-02-07;3661;5515;0;0;0;1980296;264080;1;0;0
FR;1;2021-02-08;36492;47424;0;0;0;2016788;311504;1;0;0
FR;1;2021-02-09;50795;75563;0;0;0;2067583;387067;1;0;0
FR;1;2021-02-10;52055;80331;0;0;0;2119638;467398;1;0;0
FR;1;2021-02-11;63367;102192;0;0;0;2183005;569590;1;0;0
FR;1;2021-02-12;55848;75046;0;0;0;2238853;644636;1;0;0
FR;1;2021-02-13;15462;19347;0;0;0;2254315;663983;1;0;0
FR;1;2021-02-14;3746;7340;0;0;0;2258061;671323;1;0;0
FR;1;2021-02-15;24136;73639;0;0;0;2282197;744962;1;0;0
FR;1;2021-02-16;32767;96538;0;0;0;2314964;841500;1;0;0
FR;1;2021-02-17;35112;100891;20;0;0;2350076;942391;21;0;0
FR;1;2021-02-18;49440;116319;0;0;0;2399516;1058710;21;0;0
FR;1;2021-02-19;45374;87036;1;0;0;2444890;1145746;22;0;0
FR;1;2021-02-20;13385;27172;0;0;0;2458275;1172918;22;0;0
FR;1;2021-02-21;2456;6176;0;0;0;2460731;1179094;22;0;0
FR;1;2021-02-22;24716;69582;2;0;0;2485447;1248676;24;0;0
FR;1;2021-02-23;37423;81114;1;0;0;2522870;1329790;25;0;0
FR;1;2021-02-24;40689;78644;1;0;0;2563559;1408434;26;0;0
FR;1;2021-02-25;50145;87876;1;0;0;2613704;1496310;27;0;0
FR;1;2021-02-26;47204;67637;1;0;0;2660908;1563947;28;0;0
FR;1;2021-02-27;15671;21214;1;0;0;2676579;1585161;29;0;0
FR;1;2021-02-28;3553;4215;2;0;0;2680132;1589376;31;0;0
FR;1;2021-03-01;40172;49846;1;0;0;2720304;1639222;32;0;0
FR;1;2021-03-02;55971;62111;3;0;0;2776275;1701333;35;0;0
FR;1;2021-03-03;61231;60533;0;0;0;2837506;1761866;35;0;0
FR;1;2021-03-04;72988;66944;3;0;0;2910494;1828810;38;0;0
FR;1;2021-03-05;74753;58827;3;0;0;2985247;1887637;41;0;0
FR;1;2021-03-06;82450;15921;2;0;0;3067697;1903558;43;0;0
FR;1;2021-03-07;63719;4647;1;0;0;3131416;1908205;44;0;0
FR;1;2021-03-08;60157;41711;2;0;0;3191573;1949916;46;0;0
FR;1;2021-03-09;85981;47800;1;0;0;3277554;1997716;47;0;0
FR;1;2021-03-10;90900;47907;5;0;0;3368454;2045623;52;0;0
FR;1;2021-03-11;105058;54350;1;0;0;3473512;2099973;53;0;0
FR;1;2021-03-12;104105;45065;1;0;0;3577617;2145038;54;0;0
FR;1;2021-03-13;89189;12677;1;0;0;3666806;2157715;55;0;0
FR;1;2021-03-14;44451;2827;1;0;0;3711257;2160542;56;0;0
FR;1;2021-03-15;95498;28471;3;0;0;3806755;2189013;59;0;0
FR;1;2021-03-16;123584;34356;5;0;0;3930339;2223369;64;0;0
FR;1;2021-03-17;129294;34006;4;0;0;4059633;2257375;68;0;0
FR;1;2021-03-18;142876;39399;5;0;0;4202509;2296774;73;0;0
FR;1;2021-03-19;136231;32425;2;0;0;4338740;2329199;75;0;0
FR;1;2021-03-20;75987;9896;1;0;0;4414727;2339095;76;0;0
FR;1;2021-03-21;26502;2195;1;0;0;4441229;2341290;77;0;0
FR;1;2021-03-22;114745;30696;2;0;0;4555974;2371986;79;0;0
FR;1;2021-03-23;143018;38086;1;0;0;4698992;2410072;80;0;0
FR;1;2021-03-24;141985;38476;0;0;0;4840977;2448548;80;0;0
FR;1;2021-03-25;164992;39657;4;0;0;5005969;2488205;84;0;0
FR;1;2021-03-26;166384;37526;5;1;0;5172353;2525731;89;1;0
FR;1;2021-03-27;110872;15371;1;0;0;5283225;2541102;90;1;0
FR;1;2021-03-28;42300;4087;3;0;0;5325525;2545189;93;1;0
FR;1;2021-03-29;129804;49402;4;0;0;5455329;2594591;97;1;0
FR;1;2021-03-30;167708;63660;5;0;0;5623037;2658251;102;1;0
FR;1;2021-03-31;170917;67491;4;0;0;5793954;2725742;106;1;0
FR;1;2021-04-01;194768;81972;10;0;0;5988722;2807714;116;1;0
FR;1;2021-04-02;164433;85693;7;0;0;6153155;2893407;123;1;0
FR;1;2021-04-03;88238;58097;5;0;0;6241393;2951504;128;1;0
FR;1;2021-04-04;33648;17698;0;0;0;6275041;2969202;128;1;0
FR;1;2021-04-05;46395;9835;11;0;0;6321436;2979037;139;1;0
FR;1;2021-04-06;160290;103336;17;0;0;6481726;3082373;156;1;0
FR;1;2021-04-07;196966;108045;16;0;0;6678692;3190418;172;1;0
FR;1;2021-04-08;222095;113262;13;0;0;6900787;3303680;185;1;0
FR;1;2021-04-09;214541;107679;21;0;0;7115328;3411359;206;1;0
FR;1;2021-04-10;117169;73253;14;0;0;7232497;3484612;220;1;0
FR;1;2021-04-11;40885;30034;6;0;0;7273382;3514646;226;1;0
FR;1;2021-04-12;168454;104186;46;0;0;7441836;3618832;272;1;0
FR;1;2021-04-13;203781;127902;97;1;0;7645617;3746734;369;2;0
FR;1;2021-04-14;208598;122662;207;0;0;7854215;3869396;576;2;0
FR;1;2021-04-15;221648;127475;311;0;0;8075863;3996871;887;2;0
FR;1;2021-04-16;206037;125319;308;0;0;8281900;4122190;1195;2;0
FR;1;2021-04-17;122075;67156;103;0;0;8403975;4189346;1298;2;0
FR;1;2021-04-18;35958;20951;41;0;0;8439933;4210297;1339;2;0
FR;1;2021-04-19;163727;121629;432;0;0;8603660;4331926;1771;2;0
FR;1;2021-04-20;189395;149152;531;0;0;8793055;4481078;2302;2;0
FR;1;2021-04-21;193971;147142;758;0;0;8987026;4628220;3060;2;0
FR;1;2021-04-22;209005;163533;776;0;0;9196031;4791753;3836;2;0
FR;1;2021-04-23;198936;157325;671;0;0;9394967;4949078;4507;2;0
FR;1;2021-04-24;126323;95594;148;0;0;9521290;5044672;4655;2;0
FR;1;2021-04-25;53623;30011;46;0;0;9574913;5074683;4701;2;0
FR;1;2021-04-26;181119;138971;540;0;0;9756032;5213654;5241;2;0
FR;1;2021-04-27;221345;162111;900;0;0;9977377;5375765;6141;2;0
FR;1;2021-04-28;238272;155397;1311;1;1;10215649;5531162;7452;3;1
FR;1;2021-04-29;270258;160745;1208;0;0;10485907;5691907;8660;3;1
FR;1;2021-04-30;271958;148371;1071;0;0;10757865;5840278;9731;3;1
FR;1;2021-05-01;141137;40611;172;0;0;10899002;5880889;9903;3;1
FR;1;2021-05-02;81535;28119;81;0;0;10980537;5909008;9984;3;1
FR;1;2021-05-03;250759;144352;802;0;0;11231296;6053360;10786;3;1
FR;1;2021-05-04;265850;187224;1199;0;0;11497146;6240584;11985;3;1
FR;1;2021-05-05;283856;185211;1265;0;0;11781002;6425795;13250;3;1
FR;1;2021-05-06;309938;183617;1501;0;0;12090940;6609412;14751;3;1
FR;1;2021-05-07;284072;195926;1125;0;0;12375012;6805338;15876;3;1
FR;1;2021-05-08;191648;49572;285;0;0;12566660;6854910;16161;3;1
FR;1;2021-05-09;114048;35400;236;0;0;12680708;6890310;16397;3;1
FR;1;2021-05-10;258186;194289;1184;0;0;12938894;7084599;17581;3;1
FR;1;2021-05-11;318862;210936;1463;0;0;13257756;7295535;19044;3;1
FR;1;2021-05-12;356601;185814;1399;0;0;13614357;7481349;20443;3;1
FR;1;2021-05-13;283425;47588;399;0;0;13897782;7528937;20842;3;1
FR;1;2021-05-14;370467;128547;993;0;0;14268249;7657484;21835;3;1
FR;1;2021-05-15;298071;66129;403;0;0;14566320;7723613;22238;3;1
FR;1;2021-05-16;157763;15494;158;0;0;14724083;7739107;22396;3;1
FR;1;2021-05-17;318912;116233;1439;0;0;15042995;7855340;23835;3;1
FR;1;2021-05-18;383303;111321;1797;0;0;15426298;7966661;25632;3;1
FR;1;2021-05-19;395241;102208;2178;0;0;15821539;8068869;27810;3;1
FR;1;2021-05-20;421772;95975;2043;0;0;16243311;8164844;29853;3;1
FR;1;2021-05-21;399784;97229;1760;0;0;16643095;8262073;31613;3;1
FR;1;2021-05-22;275670;41960;602;0;0;16918765;8304033;32215;3;1
FR;1;2021-05-23;123006;11076;224;0;0;17041771;8315109;32439;3;1
FR;1;2021-05-24;243994;26253;568;0;0;17285765;8341362;33007;3;1
FR;1;2021-05-25;366214;131604;2110;1;0;17651979;8472966;35117;4;1
FR;1;2021-05-26;380791;126274;1991;0;0;18032770;8599240;37108;4;1
FR;1;2021-05-27;406118;128044;1975;0;0;18438888;8727284;39083;4;1
FR;1;2021-05-28;366006;145356;1698;0;0;18804894;8872640;40781;4;1
FR;1;2021-05-29;253816;80897;526;0;0;19058710;8953537;41307;4;1
FR;1;2021-05-30;100969;22566;157;0;0;19159679;8976103;41464;4;1
FR;1;2021-05-31;314293;148878;1281;1;1;19473972;9124981;42745;5;2
FR;1;2021-06-01;361584;166511;1726;1;1;19835556;9291492;44471;6;3
FR;1;2021-06-02;365350;153499;1794;0;0;20200906;9444991;46265;6;3
FR;1;2021-06-03;391362;147514;1651;0;0;20592268;9592505;47916;6;3
FR;1;2021-06-04;363972;175595;1493;1;1;20956240;9768100;49409;7;4
FR;1;2021-06-05;258490;112689;596;0;0;21214730;9880789;50005;7;4
FR;1;2021-06-06;126791;37556;215;0;0;21341521;9918345;50220;7;4
FR;1;2021-06-07;300798;207828;1363;0;0;21642319;10126173;51583;7;4
FR;1;2021-06-08;330691;220705;1642;0;0;21973010;10346878;53225;7;4
FR;1;2021-06-09;336500;211876;1609;0;0;22309510;10558754;54834;7;4
FR;1;2021-06-10;343836;201479;1610;0;0;22653346;10760233;56444;7;4
FR;1;2021-06-11;311852;235039;1298;0;0;22965198;10995272;57742;7;4
FR;1;2021-06-12;244055;150622;433;0;0;23209253;11145894;58175;7;4
FR;1;2021-06-13;100359;60997;188;0;0;23309612;11206891;58363;7;4
FR;1;2021-06-14;207816;288299;1317;1;0;23517428;11495190;59680;8;4
FR;1;2021-06-15;256806;281813;1392;1;0;23774234;11777003;61072;9;4
FR;1;2021-06-16;273627;270582;1263;1;0;24047861;12047585;62335;10;4
FR;1;2021-06-17;268173;244778;1235;1;0;24316034;12292363;63570;11;4
FR;1;2021-06-18;260572;295521;1152;1;0;24576606;12587884;64722;12;4
FR;1;2021-06-19;193437;209493;387;0;0;24770043;12797377;65109;12;4
FR;1;2021-06-20;69694;89123;117;0;0;24839737;12886500;65226;12;4
FR;1;2021-06-21;172332;319775;931;1;1;25012069;13206275;66157;13;5
FR;1;2021-06-22;185833;347853;1100;10;2;25197902;13554128;67257;23;7
FR;1;2021-06-23;204176;339491;1049;0;0;25402078;13893619;68306;23;7
FR;1;2021-06-24;203498;282055;1171;0;0;25605576;14175674;69477;23;7
FR;1;2021-06-25;182639;371779;1196;0;0;25788215;14547453;70673;23;7
FR;1;2021-06-26;131372;278369;503;0;0;25919587;14825822;71176;23;7
FR;1;2021-06-27;52398;122902;145;0;0;25971985;14948724;71321;23;7
FR;1;2021-06-28;136626;368178;1062;0;0;26108611;15316902;72383;23;7
FR;1;2021-06-29;154856;390862;1849;0;0;26263467;15707764;74232;23;7
FR;1;2021-06-30;180025;381404;1664;4;2;26443492;16089168;75896;27;9
FR;1;2021-07-01;201443;332244;1886;5;1;26644935;16421412;77782;32;10
FR;1;2021-07-02;193755;367557;1765;5;2;26838690;16788969;79547;37;12
FR;1;2021-07-03;124468;280438;704;3;1;26963158;17069407;80251;40;13
FR;1;2021-07-04;53929;113690;244;0;0;27017087;17183097;80495;40;13
FR;1;2021-07-05;153907;355970;1500;8;2;27170994;17539067;81995;48;15
FR;1;2021-07-06;173455;382439;1601;45;8;27344449;17921506;83596;93;23
FR;1;2021-07-07;190751;362480;1657;25;5;27535200;18283986;85253;118;28
FR;1;2021-07-08;201529;323083;1826;20;6;27736729;18607069;87079;138;34
FR;1;2021-07-09;189894;387850;1853;3;2;27926623;18994919;88932;141;36
FR;1;2021-07-10;129927;281167;814;1;1;28056550;19276086;89746;142;37
FR;1;2021-07-11;57663;102514;262;0;0;28114213;19378600;90008;142;37
FR;1;2021-07-12;149634;416975;1581;4;0;28263847;19795575;91589;146;37
FR;1;2021-07-13;234225;439348;1805;8;1;28498072;20234923;93394;154;38
FR;1;2021-07-14;171864;151465;417;0;0;28669936;20386388;93811;154;38
FR;1;2021-07-15;279630;424592;1858;1;0;28949566;20810980;95669;155;38
FR;1;2021-07-16;290388;400987;1711;3;1;29239954;21211967;97380;158;39
FR;1;2021-07-17;217325;282054;754;1;0;29457279;21494021;98134;159;39
FR;1;2021-07-18;101985;107259;288;0;0;29559264;21601280;98422;159;39
FR;1;2021-07-19;238109;378907;1496;3;0;29797373;21980187;99918;162;39
FR;1;2021-07-20;305639;380474;1469;0;0;30103012;22360661;101387;162;39
FR;1;2021-07-21;333170;353192;1412;4;2;30436182;22713853;102799;166;41
FR;1;2021-07-22;364587;319039;1502;3;2;30800769;23032892;104301;169;43
FR;1;2021-07-23;349292;343398;1587;4;1;31150061;23376290;105888;173;44
FR;1;2021-07-24;238928;240894;697;1;0;31388989;23617184;106585;174;44
FR;1;2021-07-25;112767;76031;221;0;0;31501756;23693215;106806;174;44
FR;1;2021-07-26;299048;289799;1496;2;2;31800804;23983014;108302;176;46
FR;1;2021-07-27;385757;268463;1457;4;2;32186561;24251477;109759;180;48
FR;1;2021-07-28;390133;251241;1460;4;2;32576694;24502718;111219;184;50
FR;1;2021-07-29;406054;228049;1538;2;1;32982748;24730767;112757;186;51
FR;1;2021-07-30;370640;246854;1637;4;1;33353388;24977621;114394;190;52
FR;1;2021-07-31;243363;165132;793;1;0;33596751;25142753;115187;191;52
FR;1;2021-08-01;105545;47228;232;0;0;33702296;25189981;115419;191;52
FR;1;2021-08-02;297103;213117;1479;2;0;33999399;25403098;116898;193;52
FR;1;2021-08-03;331242;208964;1549;2;1;34330641;25612062;118447;195;53
FR;1;2021-08-04;327937;184204;1438;5;3;34658578;25796266;119885;200;56
FR;1;2021-08-05;301196;193417;1482;0;0;34959774;25989683;121367;200;56
FR;1;2021-08-06;290896;224417;1560;3;1;35250670;26214100;122927;203;57
FR;1;2021-08-07;182624;158816;654;4;3;35433294;26372916;123581;207;60
FR;1;2021-08-08;68854;59127;251;0;0;35502148;26432043;123832;207;60
FR;1;2021-08-09;222696;235644;1443;4;3;35724844;26667687;125275;211;63
FR;1;2021-08-10;252645;240366;1489;2;1;35977489;26908053;126764;213;64
FR;1;2021-08-11;236144;232090;1271;5;1;36213633;27140143;128035;218;65
FR;1;2021-08-12;220709;240107;1487;3;1;36434342;27380250;129522;221;66
FR;1;2021-08-13;201665;238594;1357;2;2;36636007;27618844;130879;223;68
FR;1;2021-08-14;122834;174099;645;0;0;36758841;27792943;131524;223;68
FR;1;2021-08-15;34673;46128;199;1;0;36793514;27839071;131723;224;68
FR;1;2021-08-16;156896;289723;1421;0;0;36950410;28128794;133144;224;68
FR;1;2021-08-17;171547;291388;1422;5;1;37121957;28420182;134566;229;69
FR;1;2021-08-18;161370;286926;1392;6;3;37283327;28707108;135958;235;72
FR;1;2021-08-19;148876;277668;1400;1;0;37432203;28984776;137358;236;72
FR;1;2021-08-20;140457;309158;1531;2;2;37572660;29293934;138889;238;74
FR;1;2021-08-21;84251;213214;586;0;0;37656911;29507148;139475;238;74
FR;1;2021-08-22;28549;82696;232;0;0;37685460;29589844;139707;238;74
FR;1;2021-08-23;118612;321075;1422;2;1;37804072;29910919;141129;240;75
FR;1;2021-08-24;126620;319832;1602;5;1;37930692;30230751;142731;245;76
FR;1;2021-08-25;121488;306554;1779;8;3;38052180;30537305;144510;253;79
FR;1;2021-08-26;106568;286180;2159;10;0;38158748;30823485;146669;263;79
FR;1;2021-08-27;107616;321688;2301;9;3;38266364;31145173;148970;272;82
FR;1;2021-08-28;70995;220714;1099;0;0;38337359;31365887;150069;272;82
FR;1;2021-08-29;24139;78181;469;1;0;38361498;31444068;150538;273;82
FR;1;2021-08-30;96830;286486;4309;6;5091;38458328;31730554;154847;279;5173
FR;1;2021-08-31;98043;276355;9290;15;10136;38556371;32006909;164137;294;15309
FR;1;2021-09-01;112139;245355;21110;7;22121;38668510;32252264;185247;301;37430
FR;1;2021-09-02;85816;197997;24524;18;25475;38754326;32450261;209771;319;62905
FR;1;2021-09-03;82366;227603;26952;21;28011;38836692;32677864;236723;340;90916
FR;1;2021-09-04;71610;189728;11139;11;11675;38908302;32867592;247862;351;102591
FR;1;2021-09-05;18607;41159;4123;2;4281;38926909;32908751;251985;353;106872
FR;1;2021-09-06;59519;151547;30176;15;31170;38986428;33060298;282161;368;138042
FR;1;2021-09-07;57335;139718;30205;30;31195;39043763;33200016;312366;398;169237
FR;1;2021-09-08;72091;173845;26922;22;27916;39115854;33373861;339288;420;197153
FR;1;2021-09-09;54377;124520;28609;24;29662;39170231;33498381;367897;444;226815
FR;1;2021-09-10;66068;152108;30442;23;31603;39236299;33650489;398339;467;258418
FR;1;2021-09-11;52587;146618;9729;15;10333;39288886;33797107;408068;482;268751
FR;1;2021-09-12;10791;29262;2484;1;2642;39299677;33826369;410552;483;271393
FR;1;2021-09-13;51443;104515;38741;30;39988;39351120;33930884;449293;513;311381
FR;1;2021-09-14;53267;96050;51262;66;53006;39404387;34026934;500555;579;364387
FR;1;2021-09-15;60480;139293;50474;55;47007;39464867;34166227;551029;634;411394
FR;1;2021-09-16;46570;81441;53308;71;49514;39511437;34247668;604337;705;460908
FR;1;2021-09-17;53161;109376;45054;61;42659;39564598;34357044;649391;766;503567
FR;1;2021-09-18;37855;118493;11795;19;11264;39602453;34475537;661186;785;514831
FR;1;2021-09-19;6500;21036;2038;1;1976;39608953;34496573;663224;786;516807
FR;1;2021-09-20;36475;74907;46215;65;44151;39645428;34571480;709439;851;560958
FR;1;2021-09-21;34155;68157;56245;71;52659;39679583;34639637;765684;922;613617
FR;1;2021-09-22;38802;118586;49858;76;46854;39718385;34758223;815542;998;660471
FR;1;2021-09-23;31981;62881;54483;85;50860;39750366;34821104;870025;1083;711331
FR;1;2021-09-24;36758;90114;43650;89;41903;39787124;34911218;913675;1172;753234
FR;1;2021-09-25;27635;96678;12301;27;12172;39814759;35007896;925976;1199;765406
FR;1;2021-09-26;4366;15187;1772;5;1695;39819125;35023083;927748;1204;767101
FR;1;2021-09-27;27324;60229;42898;89;41598;39846449;35083312;970646;1293;808699
FR;1;2021-09-28;26879;49466;47175;75;44422;39873328;35132778;1017821;1368;853121
FR;1;2021-09-29;35874;80364;47258;87;45551;39909202;35213142;1065079;1455;898672
FR;1;2021-09-30;26032;46863;47517;80;45414;39935234;35260005;1112596;1535;944086
FR;1;2021-10-01;47264;65926;44872;83;44496;39982498;35325931;1157468;1618;988582
FR;1;2021-10-02;32362;62404;16108;32;16308;40014860;35388335;1173576;1650;1004890
FR;1;2021-10-03;4337;8565;2035;3;2030;40019197;35396900;1175611;1653;1006920
FR;1;2021-10-04;28904;44454;47091;79;46932;40048101;35441354;1222702;1732;1053852
FR;1;2021-10-05;24476;41643;49860;116;49231;40072577;35482997;1272562;1848;1103083
FR;1;2021-10-06;34609;61404;57478;102;57194;40107186;35544401;1330040;1950;1160277
FR;1;2021-10-07;21025;39866;53020;75;51896;40128211;35584267;1383060;2025;1212173
FR;1;2021-10-08;35485;59638;60380;83;61105;40163696;35643905;1443440;2108;1273278
FR;1;2021-10-09;27438;48016;25485;29;25996;40191134;35691921;1468925;2137;1299274
FR;1;2021-10-10;3702;5805;2750;7;2857;40194836;35697726;1471675;2144;1302131
FR;1;2021-10-11;24814;38191;54576;88;55220;40219650;35735917;1526251;2232;1357351
FR;1;2021-10-12;23309;36548;58045;127;59123;40242959;35772465;1584296;2359;1416474
FR;1;2021-10-13;32896;47851;64156;124;65650;40275855;35820316;1648452;2483;1482124
FR;1;2021-10-14;21656;34781;53741;103;54316;40297511;35855097;1702193;2586;1536440
FR;1;2021-10-15;32638;48811;72315;165;74958;40330149;35903908;1774508;2751;1611398
FR;1;2021-10-16;25980;35292;34862;44;36400;40356129;35939200;1809370;2795;1647798
FR;1;2021-10-17;3103;4055;3408;2;3314;40359232;35943255;1812778;2797;1651112
FR;1;2021-10-18;23841;34920;66817;131;69684;40383073;35978175;1879595;2928;1720796
FR;1;2021-10-19;20674;35428;75643;135;79557;40403747;36013603;1955238;3063;1800353
FR;1;2021-10-20;29857;44245;96163;178;99802;40433604;36057848;2051401;3241;1900155
FR;1;2021-10-21;19692;35083;83150;107;87008;40453296;36092931;2134551;3348;1987163
FR;1;2021-10-22;29652;47727;103716;196;109627;40482948;36140658;2238267;3544;2096790
FR;1;2021-10-23;23024;35157;44859;57;47367;40505972;36175815;2283126;3601;2144157
FR;1;2021-10-24;2376;3868;3580;6;3730;40508348;36179683;2286706;3607;2147887
FR;1;2021-10-25;22407;30779;82005;143;85791;40530755;36210462;2368711;3750;2233678
FR;1;2021-10-26;19317;27676;86079;162;90290;40550072;36238138;2454790;3912;2323968
FR;1;2021-10-27;26176;39670;107783;252;112656;40576248;36277808;2562573;4164;2436624
FR;1;2021-10-28;18773;27142;86918;150;91642;40595021;36304950;2649491;4314;2528266
FR;1;2021-10-29;25918;40285;114802;200;121581;40620939;36345235;2764293;4514;2649847
FR;1;2021-10-30;17687;28719;49353;74;51929;40638626;36373954;2813646;4588;2701776
FR;1;2021-10-31;2058;3180;3445;2;3680;40640684;36377134;2817091;4590;2705456
FR;1;2021-11-01;7859;4254;3027;3;3279;40648543;36381388;2820118;4593;2708735
FR;1;2021-11-02;22179;33239;92368;156;97742;40670722;36414627;2912486;4749;2806477
FR;1;2021-11-03;26546;41607;117466;215;123839;40697268;36456234;3029952;4964;2930316
FR;1;2021-11-04;19574;30348;105772;213;111881;40716842;36486582;3135724;5177;3042197
FR;1;2021-11-05;26961;42332;138747;229;147358;40743803;36528914;3274471;5406;3189555
FR;1;2021-11-06;18830;29836;63459;123;66450;40762633;36558750;3337930;5529;3256005
FR;1;2021-11-07;1800;3311;4964;6;5296;40764433;36562061;3342894;5535;3261301
FR;1;2021-11-08;17824;32299;125968;224;132572;40782257;36594360;3468862;5759;3393873
FR;1;2021-11-09;19460;37714;159261;334;169021;40801717;36632074;3628123;6093;3562894
FR;1;2021-11-10;28830;49201;181861;440;192428;40830547;36681275;3809984;6533;3755322
FR;1;2021-11-11;4016;5945;12211;26;13013;40834563;36687220;3822195;6559;3768335
FR;1;2021-11-12;25992;46879;174781;244;186413;40860555;36734099;3996976;6803;3954748
FR;1;2021-11-13;18718;29227;76810;111;81753;40879273;36763326;4073786;6914;4036501
FR;1;2021-11-14;2037;3283;6815;5;7365;40881310;36766609;4080601;6919;4043866
FR;1;2021-11-15;18734;34836;156372;304;166164;40900044;36801445;4236973;7223;4210030
FR;1;2021-11-16;21293;37927;192063;377;204877;40921337;36839372;4429036;7600;4414907
FR;1;2021-11-17;28613;45687;193190;399;204974;40949950;36885059;4622226;7999;4619881
FR;1;2021-11-18;21110;39171;182442;458;194447;40971060;36924230;4804668;8457;4814328
FR;1;2021-11-19;30848;53386;230192;530;246624;41001908;36977616;5034860;8987;5060952
FR;1;2021-11-20;23749;33283;96962;201;103604;41025657;37010899;5131822;9188;5164556
FR;1;2021-11-21;2320;3986;9102;19;9964;41027977;37014885;5140924;9207;5174520
FR;1;2021-11-22;21378;30484;175851;465;189382;41049355;37045369;5316775;9672;5363902
FR;1;2021-11-23;23936;41104;221131;539;237839;41073291;37086473;5537906;10211;5601741
FR;1;2021-11-24;30280;49790;217283;703;234420;41103571;37136263;5755189;10914;5836161
FR;1;2021-11-25;23567;44028;244414;718;264010;41127138;37180291;5999603;11632;6100171
FR;1;2021-11-26;30596;66812;356737;833;388437;41157734;37247103;6356340;12465;6488608
FR;1;2021-11-27;21874;45392;202588;371;222582;41179608;37292495;6558928;12836;6711190
FR;1;2021-11-28;3158;9637;54769;63;61019;41182766;37302132;6613697;12899;6772209
FR;1;2021-11-29;17867;49525;326319;840;354351;41200633;37351657;6940016;13739;7126560
FR;1;2021-11-30;22751;65000;431081;952;470682;41223384;37416657;7371097;14691;7597242
FR;1;2021-12-01;25236;69385;442815;1129;481682;41248620;37486042;7813912;15820;8078924
FR;1;2021-12-02;20047;64607;489320;1227;532796;41268667;37550649;8303232;17047;8611720
FR;1;2021-12-03;22872;82097;542678;1308;591700;41291539;37632746;8845910;18355;9203420
FR;1;2021-12-04;16387;53970;299052;652;328894;41307926;37686716;9144962;19007;9532314
FR;1;2021-12-05;3629;13893;81507;143;91056;41311555;37700609;9226469;19150;9623370
FR;1;2021-12-06;24527;62680;415369;1065;455066;41336082;37763289;9641838;20215;10078436
FR;1;2021-12-07;19969;75779;522880;1534;572502;41356051;37839068;10164718;21749;10650938
FR;1;2021-12-08;21671;75847;458297;1543;502010;41377722;37914915;10623015;23292;11152948
FR;1;2021-12-09;19427;74101;492848;1626;540720;41397149;37989016;11115863;24918;11693668
FR;1;2021-12-10;23284;87820;547333;1585;599952;41420433;38076836;11663196;26503;12293620
FR;1;2021-12-11;16528;59144;302709;748;335455;41436961;38135980;11965905;27251;12629075
FR;1;2021-12-12;4347;16018;83194;179;94069;41441308;38151998;12049099;27430;12723144
FR;1;2021-12-13;15730;63786;366888;1093;406197;41457038;38215784;12415987;28523;13129341
FR;1;2021-12-14;20750;80462;464624;1743;515111;41477788;38296246;12880611;30266;13644452
FR;1;2021-12-15;21565;77570;408992;1309;453077;41499353;38373816;13289603;31575;14097529
FR;1;2021-12-16;20022;77439;451773;1577;500543;41519375;38451255;13741376;33152;14598072
FR;1;2021-12-17;22581;86783;479862;1733;530937;41541956;38538038;14221238;34885;15129009
FR;1;2021-12-18;17595;54742;257579;730;288492;41559551;38592780;14478817;35615;15417501
FR;1;2021-12-19;5548;17099;79148;194;90722;41565099;38609879;14557965;35809;15508223
FR;1;2021-12-20;20894;63230;316164;1080;355248;41585993;38673109;14874129;36889;15863471
FR;1;2021-12-21;26252;73229;372671;1420;418024;41612245;38746338;15246800;38309;16281495
FR;1;2021-12-22;24938;66040;310562;1215;349559;41637183;38812378;15557362;39524;16631054
FR;1;2021-12-23;21258;52411;241433;953;273016;41658441;38864789;15798795;40477;16904070
FR;1;2021-12-24;7112;18360;67130;258;77046;41665553;38883149;15865925;40735;16981116
FR;1;2021-12-25;503;2819;5577;15;6532;41666056;38885968;15871502;40750;16987648
FR;1;2021-12-26;2751;7589;26929;70;31448;41668807;38893557;15898431;40820;17019096
FR;1;2021-12-27;18250;53608;235061;706;265723;41687057;38947165;16133492;41526;17284819
FR;1;2021-12-28;23276;62077;291992;1026;330178;41710333;39009242;16425484;42552;17614997
FR;1;2021-12-29;22205;55603;254951;918;288169;41732538;39064845;16680435;43470;17903166
FR;1;2021-12-30;21232;46593;212121;857;239592;41753770;39111438;16892556;44327;18142758
FR;1;2021-12-31;7463;16612;61846;229;70388;41761233;39128050;16954402;44556;18213146
FR;1;2022-01-01;1044;2495;5652;30;6583;41762277;39130545;16960054;44586;18219729
FR;1;2022-01-02;3058;8051;28883;50;33520;41765335;39138596;16988937;44636;18253249
FR;1;2022-01-03;22661;54220;228194;786;257641;41787996;39192816;17217131;45422;18510890
FR;1;2022-01-04;25622;65003;299199;1237;337246;41813618;39257819;17516330;46659;18848136
FR;1;2022-01-05;30053;64164;274813;1097;310164;41843671;39321983;17791143;47756;19158300
FR;1;2022-01-06;26750;66190;306844;1397;346494;41870421;39388173;18097987;49153;19504794
FR;1;2022-01-07;31518;74963;349790;1535;393925;41901939;39463136;18447777;50688;19898719
FR;1;2022-01-08;23377;51407;222478;696;251102;41925316;39514543;18670255;51384;20149821
FR;1;2022-01-09;7076;17152;66014;163;76137;41932392;39531695;18736269;51547;20225958
FR;1;2022-01-10;21707;60439;236735;953;267592;41954099;39592134;18973004;52500;20493550
FR;1;2022-01-11;26617;63492;282240;1277;317791;41980716;39655626;19255244;53777;20811341
FR;1;2022-01-12;28863;62472;246194;1104;277985;42009579;39718098;19501438;54881;21089326
FR;1;2022-01-13;24694;60157;262764;1252;296093;42034273;39778255;19764202;56133;21385419
FR;1;2022-01-14;27931;66692;313936;1366;351200;42062204;39844947;20078138;57499;21736619
FR;1;2022-01-15;19320;44406;199289;619;223862;42081524;39889353;20277427;58118;21960481
FR;1;2022-01-16;5142;12969;51514;135;59573;42086666;39902322;20328941;58253;22020054
FR;1;2022-01-17;16832;39777;184802;780;206853;42103498;39942099;20513743;59033;22226907
FR;1;2022-01-18;19376;45944;212380;1151;236998;42122874;39988043;20726123;60184;22463905
FR;1;2022-01-19;20276;43975;176068;897;197177;42143150;40032018;20902191;61081;22661082
FR;1;2022-01-20;16760;40546;183628;1137;204716;42159910;40072564;21085819;62218;22865798
FR;1;2022-01-21;19888;47013;228926;1406;253329;42179798;40119577;21314745;63624;23119127
FR;1;2022-01-22;13834;33335;144480;578;161375;42193632;40152912;21459225;64202;23280502
FR;1;2022-01-23;3349;8786;33415;131;38327;42196981;40161698;21492640;64333;23318829
FR;1;2022-01-24;11790;32969;142176;708;158239;42208771;40194667;21634816;65041;23477068
FR;1;2022-01-25;14183;38228;163359;1048;181539;42222954;40232895;21798175;66089;23658607
FR;1;2022-01-26;14854;37573;150225;932;166311;42237808;40270468;21948400;67021;23824918
FR;1;2022-01-27;12322;33133;143425;885;157932;42250130;40303601;22091825;67906;23982850
FR;1;2022-01-28;16300;55618;198281;1144;222437;42266430;40359219;22290106;69050;24205287
FR;1;2022-01-29;10262;35437;135190;524;151545;42276692;40394656;22425296;69574;24356832
FR;1;2022-01-30;2479;9275;29675;86;34466;42279171;40403931;22454971;69660;24391298
FR;1;2022-01-31;8748;32377;104320;531;117391;42287919;40436308;22559291;70191;24508689
FR;1;2022-02-01;10705;36434;127045;863;141243;42298624;40472742;22686336;71054;24649932
FR;1;2022-02-02;11779;41511;130332;780;145866;42310403;40514253;22816668;71834;24795798
FR;1;2022-02-03;9138;33719;116989;782;130367;42319541;40547972;22933657;72616;24926165
FR;1;2022-02-04;11499;48185;172554;966;192790;42331040;40596157;23106211;73582;25118955
FR;1;2022-02-05;7984;33963;117565;391;133059;42339024;40630120;23223776;73973;25252014
FR;1;2022-02-06;1695;8024;22741;85;26906;42340719;40638144;23246517;74058;25278920
FR;1;2022-02-07;7260;35458;119066;452;134978;42347979;40673602;23365583;74510;25413898
FR;1;2022-02-08;7648;31828;125618;693;140601;42355627;40705430;23491201;75203;25554499
FR;1;2022-02-09;8563;36427;135229;696;152467;42364190;40741857;23626430;75899;25706966
FR;1;2022-02-10;6825;29689;116338;673;130120;42371015;40771546;23742768;76572;25837086
FR;1;2022-02-11;8641;41478;165095;877;185315;42379656;40813024;23907863;77449;26022401
FR;1;2022-02-12;5309;27569;106684;378;120862;42384965;40840593;24014547;77827;26143263
FR;1;2022-02-13;1226;5710;21713;65;25327;42386191;40846303;24036260;77892;26168590
FR;1;2022-02-14;5429;27170;118059;392;133085;42391620;40873473;24154319;78284;26301675
FR;1;2022-02-15;5675;28575;118888;610;132511;42397295;40902048;24273207;78894;26434186
FR;1;2022-02-16;5708;28393;110398;595;123026;42403003;40930441;24383605;79489;26557212
FR;1;2022-02-17;4518;19637;73116;487;80212;42407521;40950078;24456721;79976;26637424
FR;1;2022-02-18;5583;26729;99172;670;108127;42413104;40976807;24555893;80646;26745551
FR;1;2022-02-19;3544;17158;59470;304;66048;42416648;40993965;24615363;80950;26811599
FR;1;2022-02-20;787;3247;10695;36;12319;42417435;40997212;24626058;80986;26823918
FR;1;2022-02-21;3410;14571;52809;286;57657;42420845;41011783;24678867;81272;26881575
FR;1;2022-02-22;3767;15489;51886;499;55616;42424612;41027272;24730753;81771;26937191
FR;1;2022-02-23;4178;17769;57459;508;62561;42428790;41045041;24788212;82279;26999752
FR;1;2022-02-24;3273;13019;43595;435;46384;42432063;41058060;24831807;82714;27046136
FR;1;2022-02-25;4431;19749;64882;695;68746;42436494;41077809;24896689;83409;27114882
FR;1;2022-02-26;2687;12793;41353;309;45106;42439181;41090602;24938042;83718;27159988
FR;1;2022-02-27;642;2181;7119;42;7984;42439823;41092783;24945161;83760;27167972
FR;1;2022-02-28;2581;10435;34938;304;37363;42442404;41103218;24980099;84064;27205335
FR;1;2022-03-01;3243;10630;38677;390;39620;42445647;41113848;25018776;84454;27244955
FR;1;2022-03-02;3571;12084;41833;394;43899;42449218;41125932;25060609;84848;27288854
FR;1;2022-03-03;2376;7889;26151;324;26483;42451594;41133821;25086760;85172;27315337
FR;1;2022-03-04;2667;10375;35409;589;34902;42454261;41144196;25122169;85761;27350239
FR;1;2022-03-05;1813;6328;21953;278;22344;42456074;41150524;25144122;86039;27372583
FR;1;2022-03-06;353;950;2914;38;3117;42456427;41151474;25147036;86077;27375700
FR;1;2022-03-07;1632;4659;16425;245;15889;42458059;41156133;25163461;86322;27391589
FR;1;2022-03-08;1602;5197;17144;307;15969;42459661;41161330;25180605;86629;27407558
FR;1;2022-03-09;1913;6607;19794;368;19148;42461574;41167937;25200399;86997;27426706
FR;1;2022-03-10;1321;4709;15260;306;14295;42462895;41172646;25215659;87303;27441001
FR;1;2022-03-11;1703;6367;21693;481;19843;42464598;41179013;25237352;87784;27460844
FR;1;2022-03-12;1228;4642;15359;278;14908;42465826;41183655;25252711;88062;27475752
FR;1;2022-03-13;242;607;2116;117;2063;42466068;41184262;25254827;88179;27477815
FR;1;2022-03-14;1091;3637;13383;3877;12506;42467159;41187899;25268210;92056;27490321
FR;1;2022-03-15;1294;4251;14620;6861;13124;42468453;41192150;25282830;98917;27503445
FR;1;2022-03-16;1635;4918;17369;11514;16424;42470088;41197068;25300199;110431;27519869
FR;1;2022-03-17;1120;3331;11701;9642;10801;42471208;41200399;25311900;120073;27530670
FR;1;2022-03-18;1683;4858;17939;16489;16373;42472891;41205257;25329839;136562;27547043
FR;1;2022-03-19;1120;3283;11885;8452;11353;42474011;41208540;25341724;145014;27558396
FR;1;2022-03-20;220;551;1721;1013;1755;42474231;41209091;25343445;146027;27560151
FR;1;2022-03-21;1048;2742;11485;13444;10831;42475279;41211833;25354930;159471;27570982
FR;1;2022-03-22;1197;3171;12242;18685;11231;42476476;41215004;25367172;178156;27582213
FR;1;2022-03-23;1476;4241;16002;20101;15682;42477952;41219245;25383174;198257;27597895
FR;1;2022-03-24;1079;2623;10376;16023;9627;42479031;41221868;25393550;214280;27607522
FR;1;2022-03-25;1506;4148;16707;25293;15352;42480537;41226016;25410257;239573;27622874
FR;1;2022-03-26;1100;2986;10846;11449;10508;42481637;41229002;25421103;251022;27633382
FR;1;2022-03-27;229;540;1738;1380;1790;42481866;41229542;25422841;252402;27635172
FR;1;2022-03-28;1046;2450;9958;15877;9581;42482912;41231992;25432799;268279;27644753
FR;1;2022-03-29;1119;2722;11543;25079;10906;42484031;41234714;25444342;293358;27655659
FR;1;2022-03-30;1609;3504;14142;24167;13677;42485640;41238218;25458484;317525;27669336
FR;1;2022-03-31;1275;2768;11673;22619;11180;42486915;41240986;25470157;340144;27680516
FR;1;2022-04-01;2042;3981;18438;28487;17300;42488957;41244967;25488595;368631;27697816
FR;1;2022-04-02;902;1866;8186;9211;7933;42489859;41246833;25496781;377842;27705749
FR;1;2022-04-03;197;369;1432;1054;1432;42490056;41247202;25498213;378896;27707181
FR;1;2022-04-04;1370;2310;11322;17639;10698;42491426;41249512;25509535;396535;27717879
FR;1;2022-04-05;1343;2589;12971;31141;11994;42492769;41252101;25522506;427676;27729873
FR;1;2022-04-06;1352;2826;12172;23828;11596;42494121;41254927;25534678;451504;27741469
FR;1;2022-04-07;1158;2608;12316;31005;11779;42495279;41257535;25546994;482509;27753248
FR;1;2022-04-08;1569;3534;17526;40541;16431;42496848;41261069;25564520;523050;27769679
FR;1;2022-04-09;812;1980;8393;12485;8090;42497660;41263049;25572913;535535;27777769
FR;1;2022-04-10;193;487;1829;1833;1871;42497853;41263536;25574742;537368;27779640
FR;1;2022-04-11;968;2157;10948;22206;10657;42498821;41265693;25585690;559574;27790297
FR;1;2022-04-12;1229;2442;12774;37967;12263;42500050;41268135;25598464;597541;27802560
FR;1;2022-04-13;1189;2693;12236;30539;11964;42501239;41270828;25610700;628080;27814524
FR;1;2022-04-14;1180;2387;12048;33474;12055;42502419;41273215;25622748;661554;27826579
FR;1;2022-04-15;1445;2881;14368;33167;13743;42503864;41276096;25637116;694721;27840322
FR;1;2022-04-16;653;1388;5831;7975;5751;42504517;41277484;25642947;702696;27846073
FR;1;2022-04-17;153;273;929;1116;971;42504670;41277757;25643876;703812;27847044
FR;1;2022-04-18;132;416;2631;997;2655;42504802;41278173;25646507;704809;27849699
FR;1;2022-04-19;1207;2545;11754;27776;11449;42506009;41280718;25658261;732585;27861148
FR;1;2022-04-20;1298;2573;12148;26793;11981;42507307;41283291;25670409;759378;27873129
FR;1;2022-04-21;1215;2388;11497;33075;11651;42508522;41285679;25681906;792453;27884780
FR;1;2022-04-22;1487;3020;15179;35402;14766;42510009;41288699;25697085;827855;27899546
FR;1;2022-04-23;753;1563;6725;9884;6631;42510762;41290262;25703810;837739;27906177
FR;1;2022-04-24;194;359;1372;1518;1324;42510956;41290621;25705182;839257;27907501
FR;1;2022-04-25;1003;2071;9843;19616;9741;42511959;41292692;25715025;858873;27917242
FR;1;2022-04-26;1304;2588;12581;36521;12184;42513263;41295280;25727606;895394;27929426
FR;1;2022-04-27;1295;2375;10620;29125;10760;42514558;41297655;25738226;924519;27940186
FR;1;2022-04-28;1257;2315;11534;34082;11361;42515815;41299970;25749760;958601;27951547
FR;1;2022-04-29;1585;3214;14376;35411;13807;42517400;41303184;25764136;994012;27965354
FR;1;2022-04-30;819;1442;6432;9149;6276;42518219;41304626;25770568;1003161;27971630
FR;1;2022-05-01;169;277;818;946;813;42518388;41304903;25771386;1004107;27972443
FR;1;2022-05-02;986;2252;10317;16842;10201;42519374;41307155;25781703;1020949;27982644
FR;1;2022-05-03;1428;2753;12652;32704;12545;42520802;41309908;25794355;1053653;27995189
FR;1;2022-05-04;1298;2580;11175;23683;11332;42522100;41312488;25805530;1077336;28006521
FR;1;2022-05-05;1353;2451;12125;31554;12021;42523453;41314939;25817655;1108890;28018542
FR;1;2022-05-06;1692;3157;14183;34761;13744;42525145;41318096;25831838;1143651;28032286
FR;1;2022-05-07;840;1456;5960;9076;5991;42525985;41319552;25837798;1152727;28038277
FR;1;2022-05-08;185;323;1057;1457;1118;42526170;41319875;25838855;1154184;28039395
FR;1;2022-05-09;1034;1912;9216;19134;9126;42527204;41321787;25848071;1173318;28048521
FR;1;2022-05-10;1396;2564;12505;36882;12091;42528600;41324351;25860576;1210200;28060612
FR;1;2022-05-11;1385;2255;9851;25891;9760;42529985;41326606;25870427;1236091;28070372
FR;1;2022-05-12;1268;2286;10427;33364;10127;42531253;41328892;25880854;1269455;28080499
FR;1;2022-05-13;1588;2729;12733;35581;12374;42532841;41331621;25893587;1305036;28092873
FR;1;2022-05-14;768;1295;5474;10202;5355;42533609;41332916;25899061;1315238;28098228
FR;1;2022-05-15;216;386;1176;1344;1239;42533825;41333302;25900237;1316582;28099467
FR;1;2022-05-16;946;1693;8032;19968;8071;42534771;41334995;25908269;1336550;28107538
FR;1;2022-05-17;1256;2208;11082;35974;10681;42536027;41337203;25919351;1372524;28118219
FR;1;2022-05-18;1271;2038;8988;25576;8946;42537298;41339241;25928339;1398100;28127165
FR;1;2022-05-19;1165;2304;9802;33770;9865;42538463;41341545;25938141;1431870;28137030
FR;1;2022-05-20;1539;2674;12389;37553;11974;42540002;41344219;25950530;1469423;28149004
FR;1;2022-05-21;769;1354;5235;9368;5152;42540771;41345573;25955765;1478791;28154156
FR;1;2022-05-22;189;281;942;1385;943;42540960;41345854;25956707;1480176;28155099
FR;1;2022-05-23;942;1785;8350;19357;8302;42541902;41347639;25965057;1499533;28163401
FR;1;2022-05-24;1262;2396;10668;37000;10520;42543164;41350035;25975725;1536533;28173921
FR;1;2022-05-25;1251;2224;8764;23579;8912;42544415;41352259;25984489;1560112;28182833
FR;1;2022-05-26;156;302;1566;1109;1559;42544571;41352561;25986055;1561221;28184392
FR;1;2022-05-27;1088;2102;8742;20399;8494;42545659;41354663;25994797;1581620;28192886
FR;1;2022-05-28;481;1030;3677;6525;3716;42546140;41355693;25998474;1588145;28196602
FR;1;2022-05-29;114;252;701;888;710;42546254;41355945;25999175;1589033;28197312
FR;1;2022-05-30;803;1692;6539;18484;6563;42547057;41357637;26005714;1607517;28203875
FR;1;2022-05-31;1248;2134;9204;34212;9081;42548305;41359771;26014918;1641729;28212956
FR;1;2022-06-01;1199;2282;10365;23262;10205;42549504;41362053;26025283;1664991;28223161
FR;1;2022-06-02;1179;2207;10610;33993;10166;42550683;41364260;26035893;1698984;28233327
FR;1;2022-06-03;1344;2661;12638;37043;12064;42552027;41366921;26048531;1736027;28245391
FR;1;2022-06-04;661;1249;4713;8629;4787;42552688;41368170;26053244;1744656;28250178
FR;1;2022-06-05;123;279;806;1043;828;42552811;41368449;26054050;1745699;28251006
FR;1;2022-06-06;145;347;1967;1167;1943;42552956;41368796;26056017;1746866;28252949
FR;1;2022-06-07;1108;2208;9126;33980;8790;42554064;41371004;26065143;1780846;28261739
FR;1;2022-06-08;1073;2151;8617;27478;8491;42555137;41373155;26073760;1808324;28270230
FR;1;2022-06-09;1034;2082;9912;37379;9569;42556171;41375237;26083672;1845703;28279799
FR;1;2022-06-10;1293;2512;12324;42959;11903;42557464;41377749;26095996;1888662;28291702
FR;1;2022-06-11;643;1428;5123;11063;5164;42558107;41379177;26101119;1899725;28296866
FR;1;2022-06-12;143;357;1006;1675;1064;42558250;41379534;26102125;1901400;28297930
FR;1;2022-06-13;870;1713;6968;22159;6821;42559120;41381247;26109093;1923559;28304751
FR;1;2022-06-14;1051;2099;9775;42688;9177;42560171;41383346;26118868;1966247;28313928
FR;1;2022-06-15;1018;1860;8647;29261;8322;42561189;41385206;26127515;1995508;28322250
FR;1;2022-06-16;911;1758;9285;38286;8752;42562100;41386964;26136800;2033794;28331002
FR;1;2022-06-17;1186;2496;11809;44665;11287;42563286;41389460;26148609;2078459;28342289
FR;1;2022-06-18;544;1247;4299;10529;4236;42563830;41390707;26152908;2088988;28346525
FR;1;2022-06-19;131;312;997;1539;1075;42563961;41391019;26153905;2090527;28347600
FR;1;2022-06-20;822;1641;8338;24927;8032;42564783;41392660;26162243;2115454;28355632
FR;1;2022-06-21;1067;2075;9703;47637;8800;42565850;41394735;26171946;2163091;28364432
FR;1;2022-06-22;1003;1969;8340;36952;7818;42566853;41396704;26180286;2200043;28372250
FR;1;2022-06-23;1015;2082;9984;52644;9258;42567868;41398786;26190270;2252687;28381508
FR;1;2022-06-24;1217;2647;12788;65736;11577;42569085;41401433;26203058;2318423;28393085
FR;1;2022-06-25;665;1480;5873;18884;5661;42569750;41402913;26208931;2337307;28398746
FR;1;2022-06-26;161;389;1766;3485;1657;42569911;41403302;26210697;2340792;28400403
FR;1;2022-06-27;907;1736;9795;45808;9028;42570818;41405038;26220492;2386600;28409431
FR;1;2022-06-28;1183;2529;13735;86280;12304;42572001;41407567;26234227;2472880;28421735
FR;1;2022-06-29;1198;2254;11361;67163;10431;42573199;41409821;26245588;2540043;28432166
FR;1;2022-06-30;1239;2307;13315;89698;11665;42574438;41412128;26258903;2629741;28443831
FR;1;2022-07-01;1511;2969;17377;108754;15159;42575949;41415097;26276280;2738495;28458990
FR;1;2022-07-02;725;1489;7503;33647;6750;42576674;41416586;26283783;2772142;28465740
FR;1;2022-07-03;222;458;1909;6046;1714;42576896;41417044;26285692;2778188;28467454
FR;1;2022-07-04;1169;2214;12725;75145;11155;42578065;41419258;26298417;2853333;28478609
FR;1;2022-07-05;1361;2629;16840;125540;14315;42579426;41421887;26315257;2978873;28492924
FR;1;2022-07-06;1291;2237;14006;92974;12036;42580717;41424124;26329263;3071847;28504960
FR;1;2022-07-07;1378;2417;16138;118640;13254;42582095;41426541;26345401;3190487;28518214
FR;1;2022-07-08;1467;2738;18754;129079;15142;42583562;41429279;26364155;3319566;28533356
FR;1;2022-07-09;641;1229;7086;35679;6124;42584203;41430508;26371241;3355245;28539480
FR;1;2022-07-10;218;443;2179;6621;1972;42584421;41430951;26373420;3361866;28541452
FR;1;2022-07-11;1133;2064;13533;83685;11288;42585554;41433015;26386953;3445551;28552740
FR;1;2022-07-12;1461;2634;18667;135870;15112;42587015;41435649;26405620;3581421;28567852
FR;1;2022-07-13;1335;2220;13930;88383;11855;42588350;41437869;26419550;3669804;28579707
FR;1;2022-07-14;142;258;1358;5034;1279;42588492;41438127;26420908;3674838;28580986
FR;1;2022-07-15;1180;2126;13088;79203;10822;42589672;41440253;26433996;3754041;28591808
FR;1;2022-07-16;486;948;5151;23429;4455;42590158;41441201;26439147;3777470;28596263
FR;1;2022-07-17;143;305;1534;4258;1385;42590301;41441506;26440681;3781728;28597648
FR;1;2022-07-18;851;1740;9916;56944;8244;42591152;41443246;26450597;3838672;28605892
FR;2;2020-12-27;0;0;0;0;0;0;0;0;0;0
FR;2;2020-12-28;0;0;0;0;0;0;0;0;0;0
FR;2;2020-12-29;0;0;0;0;0;0;0;0;0;0
FR;2;2020-12-30;0;0;0;0;0;0;0;0;0;0
FR;2;2020-12-31;0;0;0;0;0;0;0;0;0;0
FR;2;2021-01-01;0;0;0;0;0;0;0;0;0;0
FR;2;2021-01-02;0;0;0;0;0;0;0;0;0;0
FR;2;2021-01-03;0;0;0;0;0;0;0;0;0;0
FR;2;2021-01-04;0;0;0;0;0;0;0;0;0;0
FR;2;2021-01-05;0;0;0;0;0;0;0;0;0;0
FR;2;2021-01-06;0;0;0;0;0;0;0;0;0;0
FR;2;2021-01-07;0;0;0;0;0;0;0;0;0;0
FR;2;2021-01-08;0;0;0;0;0;0;0;0;0;0
FR;2;2021-01-09;0;0;0;0;0;0;0;0;0;0
FR;2;2021-01-10;0;0;0;0;0;0;0;0;0;0
FR;2;2021-01-11;0;0;0;0;0;0;0;0;0;0
FR;2;2021-01-12;0;0;0;0;0;0;0;0;0;0
FR;2;2021-01-13;0;0;0;0;0;0;0;0;0;0
FR;2;2021-01-14;1671;0;0;0;0;1671;0;0;0;0
FR;2;2021-01-15;397;0;0;0;0;2068;0;0;0;0
FR;2;2021-01-16;316;0;0;0;0;2384;0;0;0;0
FR;2;2021-01-17;81;0;0;0;0;2465;0;0;0;0
FR;2;2021-01-18;3074;2;0;0;0;5539;2;0;0;0
FR;2;2021-01-19;4680;0;0;0;0;10219;2;0;0;0
FR;2;2021-01-20;5135;6;0;0;0;15354;8;0;0;0
FR;2;2021-01-21;5342;9;0;0;0;20696;17;0;0;0
FR;2;2021-01-22;5118;11;0;0;0;25814;28;0;0;0
FR;2;2021-01-23;1870;1;0;0;0;27684;29;0;0;0
FR;2;2021-01-24;160;2;0;0;0;27844;31;0;0;0
FR;2;2021-01-25;3812;3;0;0;0;31656;34;0;0;0
FR;2;2021-01-26;3921;5;0;0;0;35577;39;0;0;0
FR;2;2021-01-27;3600;2;0;0;0;39177;41;0;0;0
FR;2;2021-01-28;3752;8;0;0;0;42929;49;0;0;0
FR;2;2021-01-29;3294;3;0;0;0;46223;52;0;0;0
FR;2;2021-01-30;1130;2;0;0;0;47353;54;0;0;0
FR;2;2021-01-31;45;2;0;0;0;47398;56;0;0;0
FR;2;2021-02-01;3402;7;0;0;0;50800;63;0;0;0
FR;2;2021-02-02;4490;13;0;0;0;55290;76;0;0;0
FR;2;2021-02-03;5220;7;0;0;0;60510;83;0;0;0
FR;2;2021-02-04;4934;11;0;0;0;65444;94;0;0;0
FR;2;2021-02-05;4811;13;0;0;0;70255;107;0;0;0
FR;2;2021-02-06;2040;14;0;0;0;72295;121;0;0;0
FR;2;2021-02-07;101;4;0;0;0;72396;125;0;0;0
FR;2;2021-02-08;7554;23;0;0;0;79950;148;0;0;0
FR;2;2021-02-09;8424;27;0;0;0;88374;175;0;0;0
FR;2;2021-02-10;9341;58;0;0;0;97715;233;0;0;0
FR;2;2021-02-11;10284;109;0;0;0;107999;342;0;0;0
FR;2;2021-02-12;10055;266;0;0;0;118054;608;0;0;0
FR;2;2021-02-13;3120;224;0;0;0;121174;832;0;0;0
FR;2;2021-02-14;355;9;0;0;0;121529;841;0;0;0
FR;2;2021-02-15;3456;3108;0;0;0;124985;3949;0;0;0
FR;2;2021-02-16;5071;4085;0;0;0;130056;8034;0;0;0
FR;2;2021-02-17;4255;4504;0;0;0;134311;12538;0;0;0
FR;2;2021-02-18;5400;5140;0;0;0;139711;17678;0;0;0
FR;2;2021-02-19;5326;4430;0;0;0;145037;22108;0;0;0
FR;2;2021-02-20;1869;1517;0;0;0;146906;23625;0;0;0
FR;2;2021-02-21;242;90;0;0;0;147148;23715;0;0;0
FR;2;2021-02-22;3613;3764;0;0;0;150761;27479;0;0;0
FR;2;2021-02-23;4954;3720;0;0;0;155715;31199;0;0;0
FR;2;2021-02-24;5012;3511;0;0;0;160727;34710;0;0;0
FR;2;2021-02-25;5486;3467;0;0;0;166213;38177;0;0;0
FR;2;2021-02-26;4364;3163;0;0;0;170577;41340;0;0;0
FR;2;2021-02-27;1624;1058;0;0;0;172201;42398;0;0;0
FR;2;2021-02-28;177;27;0;0;0;172378;42425;0;0;0
FR;2;2021-03-01;5182;3714;0;0;0;177560;46139;0;0;0
FR;2;2021-03-02;6531;4734;0;0;0;184091;50873;0;0;0
FR;2;2021-03-03;6536;4936;0;0;0;190627;55809;0;0;0
FR;2;2021-03-04;8403;4105;0;0;0;199030;59914;0;0;0
FR;2;2021-03-05;8029;4065;0;0;0;207059;63979;0;0;0
FR;2;2021-03-06;4785;1680;0;0;0;211844;65659;0;0;0
FR;2;2021-03-07;2372;30;0;0;0;214216;65689;0;0;0
FR;2;2021-03-08;4165;8358;0;0;0;218381;74047;0;0;0
FR;2;2021-03-09;7491;8537;1;0;0;225872;82584;1;0;0
FR;2;2021-03-10;7102;9160;0;0;0;232974;91744;1;0;0
FR;2;2021-03-11;9377;9277;1;0;0;242351;101021;2;0;0
FR;2;2021-03-12;7974;8277;0;0;0;250325;109298;2;0;0
FR;2;2021-03-13;10048;2572;0;0;0;260373;111870;2;0;0
FR;2;2021-03-14;4839;393;0;0;0;265212;112263;2;0;0
FR;2;2021-03-15;10909;3494;0;0;0;276121;115757;2;0;0
FR;2;2021-03-16;16764;4663;1;0;0;292885;120420;3;0;0
FR;2;2021-03-17;20233;3983;0;0;0;313118;124403;3;0;0
FR;2;2021-03-18;23368;5026;0;0;0;336486;129429;3;0;0
FR;2;2021-03-19;23304;4612;0;0;0;359790;134041;3;0;0
FR;2;2021-03-20;25447;1573;0;0;0;385237;135614;3;0;0
FR;2;2021-03-21;17670;152;0;0;0;402907;135766;3;0;0
FR;2;2021-03-22;17784;3183;0;0;0;420691;138949;3;0;0
FR;2;2021-03-23;22690;4212;0;0;0;443381;143161;3;0;0
FR;2;2021-03-24;23955;5042;0;0;0;467336;148203;3;0;0
FR;2;2021-03-25;26749;5157;1;0;0;494085;153360;4;0;0
FR;2;2021-03-26;26982;4225;0;0;0;521067;157585;4;0;0
FR;2;2021-03-27;15919;1343;0;0;0;536986;158928;4;0;0
FR;2;2021-03-28;10561;135;0;0;0;547547;159063;4;0;0
FR;2;2021-03-29;18990;4308;0;0;0;566537;163371;4;0;0
FR;2;2021-03-30;24582;6053;0;0;0;591119;169424;4;0;0
FR;2;2021-03-31;28557;5934;0;0;0;619676;175358;4;0;0
FR;2;2021-04-01;34547;8534;1;0;0;654223;183892;5;0;0
FR;2;2021-04-02;29978;7691;0;0;0;684201;191583;5;0;0
FR;2;2021-04-03;16954;3944;0;0;0;701155;195527;5;0;0
FR;2;2021-04-04;9305;1118;2;0;0;710460;196645;7;0;0
FR;2;2021-04-05;12443;802;0;0;0;722903;197447;7;0;0
FR;2;2021-04-06;27148;7122;0;0;0;750051;204569;7;0;0
FR;2;2021-04-07;30928;7120;1;0;0;780979;211689;8;0;0
FR;2;2021-04-08;36888;8673;1;0;0;817867;220362;9;0;0
FR;2;2021-04-09;33837;8489;28;0;0;851704;228851;37;0;0
FR;2;2021-04-10;19681;9125;1;0;0;871385;237976;38;0;0
FR;2;2021-04-11;7942;4249;1;0;0;879327;242225;39;0;0
FR;2;2021-04-12;17122;11088;0;0;0;896449;253313;39;0;0
FR;2;2021-04-13;19452;16089;1;0;0;915901;269402;40;0;0
FR;2;2021-04-14;18062;16346;7;0;0;933963;285748;47;0;0
FR;2;2021-04-15;22194;21334;27;0;0;956157;307082;74;0;0
FR;2;2021-04-16;20706;20335;45;0;0;976863;327417;119;0;0
FR;2;2021-04-17;13255;22469;5;0;0;990118;349886;124;0;0
FR;2;2021-04-18;5908;14393;6;0;0;996026;364279;130;0;0
FR;2;2021-04-19;16837;16293;24;0;0;1012863;380572;154;0;0
FR;2;2021-04-20;19323;21630;38;0;0;1032186;402202;192;0;0
FR;2;2021-04-21;20285;21750;76;0;0;1052471;423952;268;0;0
FR;2;2021-04-22;23816;24878;41;0;0;1076287;448830;309;0;0
FR;2;2021-04-23;24523;25381;76;0;0;1100810;474211;385;0;0
FR;2;2021-04-24;25304;15070;104;0;0;1126114;489281;489;0;0
FR;2;2021-04-25;9595;8607;5;0;0;1135709;497888;494;0;0
FR;2;2021-04-26;17159;17383;21;0;0;1152868;515271;515;0;0
FR;2;2021-04-27;19241;24151;40;0;0;1172109;539422;555;0;0
FR;2;2021-04-28;22333;26303;112;0;0;1194442;565725;667;0;0
FR;2;2021-04-29;25469;30254;69;0;0;1219911;595979;736;0;0
FR;2;2021-04-30;25530;27827;49;1;0;1245441;623806;785;1;0
FR;2;2021-05-01;14985;9862;6;0;0;1260426;633668;791;1;0
FR;2;2021-05-02;6637;9174;2;0;0;1267063;642842;793;1;0
FR;2;2021-05-03;20017;19202;40;0;0;1287080;662044;833;1;0
FR;2;2021-05-04;18281;29071;33;0;0;1305361;691115;866;1;0
FR;2;2021-05-05;18369;29421;48;0;0;1323730;720536;914;1;0
FR;2;2021-05-06;23542;35279;131;0;0;1347272;755815;1045;1;0
FR;2;2021-05-07;25328;33207;97;0;0;1372600;789022;1142;1;0
FR;2;2021-05-08;21338;10116;14;0;0;1393938;799138;1156;1;0
FR;2;2021-05-09;13163;7783;7;0;0;1407101;806921;1163;1;0
FR;2;2021-05-10;32938;21961;49;0;0;1440039;828882;1212;1;0
FR;2;2021-05-11;43599;20981;101;0;0;1483638;849863;1313;1;0
FR;2;2021-05-12;50046;19746;143;0;0;1533684;869609;1456;1;0
FR;2;2021-05-13;51293;5699;31;0;0;1584977;875308;1487;1;0
FR;2;2021-05-14;61347;12891;132;0;0;1646324;888199;1619;1;0
FR;2;2021-05-15;65931;7128;39;0;0;1712255;895327;1658;1;0
FR;2;2021-05-16;43584;2571;10;0;0;1755839;897898;1668;1;0
FR;2;2021-05-17;44744;12532;114;0;0;1800583;910430;1782;1;0
FR;2;2021-05-18;54640;12254;191;0;0;1855223;922684;1973;1;0
FR;2;2021-05-19;57172;10571;281;0;0;1912395;933255;2254;1;0
FR;2;2021-05-20;63433;10829;288;0;0;1975828;944084;2542;1;0
FR;2;2021-05-21;64295;11628;230;0;0;2040123;955712;2772;1;0
FR;2;2021-05-22;61480;4512;65;0;0;2101603;960224;2837;1;0
FR;2;2021-05-23;37532;571;22;0;0;2139135;960795;2859;1;0
FR;2;2021-05-24;17238;2042;35;0;0;2156373;962837;2894;1;0
FR;2;2021-05-25;21108;12213;240;0;0;2177481;975050;3134;1;0
FR;2;2021-05-26;19934;11464;229;0;0;2197415;986514;3363;1;0
FR;2;2021-05-27;22995;12651;182;0;0;2220410;999165;3545;1;0
FR;2;2021-05-28;29391;14973;190;0;0;2249801;1014138;3735;1;0
FR;2;2021-05-29;30419;8187;57;0;0;2280220;1022325;3792;1;0
FR;2;2021-05-30;4646;1817;6;0;0;2284866;1024142;3798;1;0
FR;2;2021-05-31;28587;18731;184;0;0;2313453;1042873;3982;1;0
FR;2;2021-06-01;45719;19965;224;0;0;2359172;1062838;4206;1;0
FR;2;2021-06-02;37470;19241;182;0;0;2396642;1082079;4388;1;0
FR;2;2021-06-03;51276;23255;161;0;0;2447918;1105334;4549;1;0
FR;2;2021-06-04;65512;24052;215;0;0;2513430;1129386;4764;1;0
FR;2;2021-06-05;34597;24048;52;0;0;2548027;1153434;4816;1;0
FR;2;2021-06-06;4954;6192;10;0;0;2552981;1159626;4826;1;0
FR;2;2021-06-07;28171;23035;149;0;0;2581152;1182661;4975;1;0
FR;2;2021-06-08;46372;22900;143;0;0;2627524;1205561;5118;1;0
FR;2;2021-06-09;34288;20933;107;0;0;2661812;1226494;5225;1;0
FR;2;2021-06-10;42638;19116;95;1;0;2704450;1245610;5320;2;0
FR;2;2021-06-11;55296;25186;134;0;0;2759746;1270796;5454;2;0
FR;2;2021-06-12;30558;19773;53;0;0;2790304;1290569;5507;2;0
FR;2;2021-06-13;3330;9190;13;0;0;2793634;1299759;5520;2;0
FR;2;2021-06-14;25298;24151;92;0;0;2818932;1323910;5612;2;0
FR;2;2021-06-15;39042;22828;154;0;0;2857974;1346738;5766;2;0
FR;2;2021-06-16;30160;21410;134;0;0;2888134;1368148;5900;2;0
FR;2;2021-06-17;36907;25841;150;0;0;2925041;1393989;6050;2;0
FR;2;2021-06-18;46852;28847;122;0;0;2971893;1422836;6172;2;0
FR;2;2021-06-19;24525;24892;39;0;0;2996418;1447728;6211;2;0
FR;2;2021-06-20;3741;10060;9;0;0;3000159;1457788;6220;2;0
FR;2;2021-06-21;17527;42840;87;0;0;3017686;1500628;6307;2;0
FR;2;2021-06-22;28359;49559;110;0;0;3046045;1550187;6417;2;0
FR;2;2021-06-23;21788;49580;107;1;1;3067833;1599767;6524;3;1
FR;2;2021-06-24;28376;50280;133;0;0;3096209;1650047;6657;3;1
FR;2;2021-06-25;33398;60407;127;0;0;3129607;1710454;6784;3;1
FR;2;2021-06-26;16384;59273;54;1;0;3145991;1769727;6838;4;1
FR;2;2021-06-27;2566;29312;22;1;0;3148557;1799039;6860;5;1
FR;2;2021-06-28;12638;54326;83;0;0;3161195;1853365;6943;5;1
FR;2;2021-06-29;19846;59911;178;0;0;3181041;1913276;7121;5;1
FR;2;2021-06-30;16325;57934;252;17;0;3197366;1971210;7373;22;1
FR;2;2021-07-01;20490;59888;228;0;0;3217856;2031098;7601;22;1
FR;2;2021-07-02;24071;62141;184;0;0;3241927;2093239;7785;22;1
FR;2;2021-07-03;12113;57093;153;0;0;3254040;2150332;7938;22;1
FR;2;2021-07-04;1958;23306;18;0;0;3255998;2173638;7956;22;1
FR;2;2021-07-05;9172;29365;106;0;0;3265170;2203003;8062;22;1
FR;2;2021-07-06;14577;36217;135;0;0;3279747;2239220;8197;22;1
FR;2;2021-07-07;14408;33659;139;0;0;3294155;2272879;8336;22;1
FR;2;2021-07-08;19716;40305;162;0;0;3313871;2313184;8498;22;1
FR;2;2021-07-09;27098;54284;202;1;0;3340969;2367468;8700;23;1
FR;2;2021-07-10;13386;33673;107;0;0;3354355;2401141;8807;23;1
FR;2;2021-07-11;1807;4362;16;0;0;3356162;2405503;8823;23;1
FR;2;2021-07-12;12965;37294;119;0;0;3369127;2442797;8942;23;1
FR;2;2021-07-13;37112;53186;150;0;0;3406239;2495983;9092;23;1
FR;2;2021-07-14;6614;3565;15;0;0;3412853;2499548;9107;23;1
FR;2;2021-07-15;47239;47031;156;0;0;3460092;2546579;9263;23;1
FR;2;2021-07-16;64308;55796;187;0;0;3524400;2602375;9450;23;1
FR;2;2021-07-17;31597;23929;96;0;0;3555997;2626304;9546;23;1
FR;2;2021-07-18;6086;4856;19;0;0;3562083;2631160;9565;23;1
FR;2;2021-07-19;32996;28659;94;0;0;3595079;2659819;9659;23;1
FR;2;2021-07-20;51991;44538;155;0;0;3647070;2704357;9814;23;1
FR;2;2021-07-21;45246;34713;93;0;0;3692316;2739070;9907;23;1
FR;2;2021-07-22;56278;41093;128;1;0;3748594;2780163;10035;24;1
FR;2;2021-07-23;68284;49033;170;0;0;3816878;2829196;10205;24;1
FR;2;2021-07-24;36170;21600;82;0;0;3853048;2850796;10287;24;1
FR;2;2021-07-25;6744;2635;10;0;0;3859792;2853431;10297;24;1
FR;2;2021-07-26;36309;22429;91;1;0;3896101;2875860;10388;25;1
FR;2;2021-07-27;62373;34601;180;0;0;3958474;2910461;10568;25;1
FR;2;2021-07-28;55312;26429;132;0;0;4013786;2936890;10700;25;1
FR;2;2021-07-29;68463;32787;189;0;0;4082249;2969677;10889;25;1
FR;2;2021-07-30;74449;37784;222;1;0;4156698;3007461;11111;26;1
FR;2;2021-07-31;34762;16201;104;0;0;4191460;3023662;11215;26;1
FR;2;2021-08-01;5409;2272;19;0;0;4196869;3025934;11234;26;1
FR;2;2021-08-02;35872;16199;101;0;0;4232741;3042133;11335;26;1
FR;2;2021-08-03;55973;28285;142;0;0;4288714;3070418;11477;26;1
FR;2;2021-08-04;46626;20853;128;1;0;4335340;3091271;11605;27;1
FR;2;2021-08-05;54626;31583;215;0;0;4389966;3122854;11820;27;1
FR;2;2021-08-06;58089;42390;242;1;0;4448055;3165244;12062;28;1
FR;2;2021-08-07;25144;17609;89;0;0;4473199;3182853;12151;28;1
FR;2;2021-08-08;3833;3663;21;0;0;4477032;3186516;12172;28;1
FR;2;2021-08-09;29304;21108;92;0;0;4506336;3207624;12264;28;1
FR;2;2021-08-10;44997;33492;155;0;0;4551333;3241116;12419;28;1
FR;2;2021-08-11;35268;25171;151;0;0;4586601;3266287;12570;28;1
FR;2;2021-08-12;41899;35719;162;0;0;4628500;3302006;12732;28;1
FR;2;2021-08-13;42594;37152;218;0;0;4671094;3339158;12950;28;1
FR;2;2021-08-14;18512;22217;93;0;0;4689606;3361375;13043;28;1
FR;2;2021-08-15;3839;3806;17;0;0;4693445;3365181;13060;28;1
FR;2;2021-08-16;25083;27183;110;0;0;4718528;3392364;13170;28;1
FR;2;2021-08-17;38255;43451;205;2;0;4756783;3435815;13375;30;1
FR;2;2021-08-18;32250;36371;195;1;1;4789033;3472186;13570;31;2
FR;2;2021-08-19;37433;46576;224;0;0;4826466;3518762;13794;31;2
FR;2;2021-08-20;40560;55615;269;1;0;4867026;3574377;14063;32;2
FR;2;2021-08-21;18121;24301;115;0;0;4885147;3598678;14178;32;2
FR;2;2021-08-22;2905;4323;22;1;1;4888052;3603001;14200;33;3
FR;2;2021-08-23;19246;35156;131;1;0;4907298;3638157;14331;34;3
FR;2;2021-08-24;31944;56045;236;0;0;4939242;3694202;14567;34;3
FR;2;2021-08-25;25928;43447;250;0;0;4965170;3737649;14817;34;3
FR;2;2021-08-26;32356;55810;387;0;0;4997526;3793459;15204;34;3
FR;2;2021-08-27;36999;65618;479;2;0;5034525;3859077;15683;36;3
FR;2;2021-08-28;17817;28503;300;0;0;5052342;3887580;15983;36;3
FR;2;2021-08-29;2654;5034;47;0;0;5054996;3892614;16030;36;3
FR;2;2021-08-30;18414;37739;400;0;756;5073410;3930353;16430;36;759
FR;2;2021-08-31;28074;57498;887;4;1543;5101484;3987851;17317;40;2302
FR;2;2021-09-01;21592;39861;1309;0;2107;5123076;4027712;18626;40;4409
FR;2;2021-09-02;25482;48640;1962;2;3316;5148558;4076352;20588;42;7725
FR;2;2021-09-03;33408;64497;2988;3;4843;5181966;4140849;23576;45;12568
FR;2;2021-09-04;16829;27714;1442;1;2364;5198795;4168563;25018;46;14932
FR;2;2021-09-05;2262;3607;266;0;413;5201057;4172170;25284;46;15345
FR;2;2021-09-06;14040;28716;1769;1;2938;5215097;4200886;27053;47;18283
FR;2;2021-09-07;21106;41072;3020;13;4882;5236203;4241958;30073;60;23165
FR;2;2021-09-08;17244;31931;2732;6;4481;5253447;4273889;32805;66;27646
FR;2;2021-09-09;20975;40461;4432;3;6782;5274422;4314350;37237;69;34428
FR;2;2021-09-10;28200;51191;5284;4;8855;5302622;4365541;42521;73;43283
FR;2;2021-09-11;13654;22404;2404;5;3959;5316276;4387945;44925;78;47242
FR;2;2021-09-12;1822;2777;289;0;510;5318098;4390722;45214;78;47752
FR;2;2021-09-13;11657;21435;2471;4;4016;5329755;4412157;47685;82;51768
FR;2;2021-09-14;18571;32773;5085;13;9067;5348326;4444930;52770;95;60835
FR;2;2021-09-15;14911;28270;5167;3;7777;5363237;4473200;57937;98;68612
FR;2;2021-09-16;16075;32765;6736;13;10522;5379312;4505965;64673;111;79134
FR;2;2021-09-17;20912;47108;8780;10;14595;5400224;4553073;73453;121;93729
FR;2;2021-09-18;9856;20937;3803;6;6027;5410080;4574010;77256;127;99756
FR;2;2021-09-19;1165;2625;396;0;639;5411245;4576635;77652;127;100395
FR;2;2021-09-20;7493;18766;3852;7;6149;5418738;4595401;81504;134;106544
FR;2;2021-09-21;11212;30003;6495;5;10743;5429950;4625404;87999;139;117287
FR;2;2021-09-22;9407;23528;5491;6;8512;5439357;4648932;93490;145;125799
FR;2;2021-09-23;10725;28890;7880;9;12635;5450082;4677822;101370;154;138434
FR;2;2021-09-24;15070;42902;10875;18;17214;5465152;4720724;112245;172;155648
FR;2;2021-09-25;7258;18769;3963;9;6101;5472410;4739493;116208;181;161749
FR;2;2021-09-26;1079;2561;495;0;636;5473489;4742054;116703;181;162385
FR;2;2021-09-27;6313;16425;4285;8;6539;5479802;4758479;120988;189;168924
FR;2;2021-09-28;9238;25550;7768;14;12072;5489040;4784029;128756;203;180996
FR;2;2021-09-29;8081;20204;6067;25;9260;5497121;4804233;134823;228;190256
FR;2;2021-09-30;9864;25813;9506;16;14088;5506985;4830046;144329;244;204344
FR;2;2021-10-01;13972;35679;12916;25;19276;5520957;4865725;157245;269;223620
FR;2;2021-10-02;6874;15900;4847;7;7017;5527831;4881625;162092;276;230637
FR;2;2021-10-03;841;1923;492;1;507;5528672;4883548;162584;277;231144
FR;2;2021-10-04;5821;13905;5518;5;7858;5534493;4897453;168102;282;239002
FR;2;2021-10-05;9052;22545;11119;19;15719;5543545;4919998;179221;301;254721
FR;2;2021-10-06;7782;17745;8241;11;11077;5551327;4937743;187462;312;265798
FR;2;2021-10-07;9197;22188;12381;15;16847;5560524;4959931;199843;327;282645
FR;2;2021-10-08;13428;32065;17348;27;23552;5573952;4991996;217191;354;306197
FR;2;2021-10-09;5999;12844;6042;6;7891;5579951;5004840;223233;360;314088
FR;2;2021-10-10;884;1620;436;2;625;5580835;5006460;223669;362;314713
FR;2;2021-10-11;5604;11579;6454;17;8829;5586439;5018039;230123;379;323542
FR;2;2021-10-12;8032;17773;12542;13;16750;5594471;5035812;242665;392;340292
FR;2;2021-10-13;6943;14836;10248;12;13615;5601414;5050648;252913;404;353907
FR;2;2021-10-14;8310;17929;14992;13;19451;5609724;5068577;267905;417;373358
FR;2;2021-10-15;11851;26302;20903;26;27961;5621575;5094879;288808;443;401319
FR;2;2021-10-16;5140;8737;1818;0;3211;5626715;5103616;290626;443;404530
FR;2;2021-10-17;651;1173;184;0;371;5627366;5104789;290810;443;404901
FR;2;2021-10-18;4560;7395;661;2;1656;5631926;5112184;291471;445;406557
FR;2;2021-10-19;6236;9886;730;5;2047;5638162;5122070;292201;450;408604
FR;2;2021-10-20;5163;8076;757;3;1682;5643325;5130146;292958;453;410286
FR;2;2021-10-21;6090;9970;778;5;2105;5649415;5140116;293736;458;412391
FR;2;2021-10-22;8448;14587;1148;4;2885;5657863;5154703;294884;462;415276
FR;2;2021-10-23;3841;5999;586;0;1230;5661704;5160702;295470;462;416506
FR;2;2021-10-24;494;889;100;0;205;5662198;5161591;295570;462;416711
FR;2;2021-10-25;3357;5361;305;1;828;5665555;5166952;295875;463;417539
FR;2;2021-10-26;4176;7258;1130;4;2012;5669731;5174210;297005;467;419551
FR;2;2021-10-27;3675;6613;1193;5;1996;5673406;5180823;298198;472;421547
FR;2;2021-10-28;4597;7697;1729;3;2745;5678003;5188520;299927;475;424292
FR;2;2021-10-29;5407;11078;2435;4;3674;5683410;5199598;302362;479;427966
FR;2;2021-10-30;2748;4439;973;1;1430;5686158;5204037;303335;480;429396
FR;2;2021-10-31;364;535;139;1;190;5686522;5204572;303474;481;429586
FR;2;2021-11-01;427;550;177;0;265;5686949;5205122;303651;481;429851
FR;2;2021-11-02;3291;6758;1182;0;1762;5690240;5211880;304833;481;431613
FR;2;2021-11-03;3339;6238;1386;2;1968;5693579;5218118;306219;483;433581
FR;2;2021-11-04;3986;7085;1764;4;2491;5697565;5225203;307983;487;436072
FR;2;2021-11-05;5229;10507;2866;5;3947;5702794;5235710;310849;492;440019
FR;2;2021-11-06;2594;4681;1401;0;1816;5705388;5240391;312250;492;441835
FR;2;2021-11-07;506;867;220;0;289;5705894;5241258;312470;492;442124
FR;2;2021-11-08;2578;5357;1201;3;1672;5708472;5246615;313671;495;443796
FR;2;2021-11-09;2750;6940;2397;6;3182;5711222;5253555;316068;501;446978
FR;2;2021-11-10;2587;5694;5103;6;6281;5713809;5259249;321171;507;453259
FR;2;2021-11-11;443;749;738;2;918;5714252;5259998;321909;509;454177
FR;2;2021-11-12;2951;8111;8968;8;10909;5717203;5268109;330877;517;465086
FR;2;2021-11-13;1537;3378;3867;7;4529;5718740;5271487;334744;524;469615
FR;2;2021-11-14;257;597;349;1;485;5718997;5272084;335093;525;470100
FR;2;2021-11-15;1622;3679;4442;9;5331;5720619;5275763;339535;534;475431
FR;2;2021-11-16;2184;5924;8302;14;10078;5722803;5281687;347837;548;485509
FR;2;2021-11-17;1739;4545;6624;8;7840;5724542;5286232;354461;556;493349
FR;2;2021-11-18;2191;5940;9177;11;11010;5726733;5292172;363638;567;504359
FR;2;2021-11-19;2698;7796;12968;19;15469;5729431;5299968;376606;586;519828
FR;2;2021-11-20;1564;3330;5173;5;6077;5730995;5303298;381779;591;525905
FR;2;2021-11-21;246;516;540;0;662;5731241;5303814;382319;591;526567
FR;2;2021-11-22;1276;2610;4478;5;5407;5732517;5306424;386797;596;531974
FR;2;2021-11-23;1615;4301;8194;9;9900;5734132;5310725;394991;605;541874
FR;2;2021-11-24;1417;3776;7472;14;8733;5735549;5314501;402463;619;550607
FR;2;2021-11-25;1812;4888;11457;21;13655;5737361;5319389;413920;640;564262
FR;2;2021-11-26;2540;7768;22662;31;26074;5739901;5327157;436582;671;590336
FR;2;2021-11-27;1496;4150;12263;18;14014;5741397;5331307;448845;689;604350
FR;2;2021-11-28;292;843;1970;3;2295;5741689;5332150;450815;692;606645
FR;2;2021-11-29;1443;4370;15080;23;17249;5743132;5336520;465895;715;623894
FR;2;2021-11-30;1911;6731;26228;36;29983;5745043;5343251;492123;751;653877
FR;2;2021-12-01;1908;6073;26194;29;29520;5746951;5349324;518317;780;683397
FR;2;2021-12-02;1909;6823;37698;52;41947;5748860;5356147;556015;832;725344
FR;2;2021-12-03;2552;10097;53603;111;59334;5751412;5366244;609618;943;784678
FR;2;2021-12-04;1848;6304;37105;38;40790;5753260;5372548;646723;981;825468
FR;2;2021-12-05;458;2256;14255;14;15988;5753718;5374804;660978;995;841456
FR;2;2021-12-06;2483;9891;77697;109;84747;5756201;5384695;738675;1104;926203
FR;2;2021-12-07;3456;15333;122419;238;133722;5759657;5400028;861094;1342;1059925
FR;2;2021-12-08;3722;16032;133184;330;145372;5763379;5416060;994278;1672;1205297
FR;2;2021-12-09;4547;19637;170178;554;185554;5767926;5435697;1164456;2226;1390851
FR;2;2021-12-10;4671;22839;188631;490;206092;5772597;5458536;1353087;2716;1596943
FR;2;2021-12-11;3683;16627;132433;239;144868;5776280;5475163;1485520;2955;1741811
FR;2;2021-12-12;1256;7125;59085;83;65132;5777536;5482288;1544605;3038;1806943
FR;2;2021-12-13;5526;26857;220672;605;242962;5783062;5509145;1765277;3643;2049905
FR;2;2021-12-14;7017;37505;300741;909;332200;5790079;5546650;2066018;4552;2382105
FR;2;2021-12-15;6558;36244;285197;956;315805;5796637;5582894;2351215;5508;2697910
FR;2;2021-12-16;7761;37924;312121;981;343717;5804398;5620818;2663336;6489;3041627
FR;2;2021-12-17;8678;41248;327854;976;360944;5813076;5662066;2991190;7465;3402571
FR;2;2021-12-18;6513;26566;212332;448;233643;5819589;5688632;3203522;7913;3636214
FR;2;2021-12-19;2602;11467;90208;182;100364;5822191;5700099;3293730;8095;3736578
FR;2;2021-12-20;9550;33591;275191;706;303353;5831741;5733690;3568921;8801;4039931
FR;2;2021-12-21;11559;38340;309609;968;341407;5843300;5772030;3878530;9769;4381338
FR;2;2021-12-22;10457;32837;265094;952;292471;5853757;5804867;4143624;10721;4673809
FR;2;2021-12-23;9430;26698;199481;700;221271;5863187;5831565;4343105;11421;4895080
FR;2;2021-12-24;2782;7500;43852;140;49564;5865969;5839065;4386957;11561;4944644
FR;2;2021-12-25;201;691;2002;10;2494;5866170;5839756;4388959;11571;4947138
FR;2;2021-12-26;1321;4207;25152;71;28677;5867491;5843963;4414111;11642;4975815
FR;2;2021-12-27;8074;29936;218402;659;243328;5875565;5873899;4632513;12301;5219143
FR;2;2021-12-28;9839;36322;272076;742;301961;5885404;5910221;4904589;13043;5521104
FR;2;2021-12-29;9497;32270;246118;766;272681;5894901;5942491;5150707;13809;5793785
FR;2;2021-12-30;9461;28133;208819;662;231470;5904362;5970624;5359526;14471;6025255
FR;2;2021-12-31;3009;8365;54983;177;61233;5907371;5978989;5414509;14648;6086488
FR;2;2022-01-01;227;690;2851;7;3346;5907598;5979679;5417360;14655;6089834
FR;2;2022-01-02;1504;4853;29510;75;33396;5909102;5984532;5446870;14730;6123230
FR;2;2022-01-03;9588;35398;266515;806;293878;5918690;6019930;5713385;15536;6417108
FR;2;2022-01-04;12847;45396;342075;1068;376972;5931537;6065326;6055460;16604;6794080
FR;2;2022-01-05;11269;38652;294162;886;323803;5942806;6103978;6349622;17490;7117883
FR;2;2022-01-06;13652;43521;331933;1298;364729;5956458;6147499;6681555;18788;7482612
FR;2;2022-01-07;14222;47631;361087;1270;396417;5970680;6195130;7042642;20058;7879029
FR;2;2022-01-08;7948;28150;201259;515;221700;5978628;6223280;7243901;20573;8100729
FR;2;2022-01-09;2749;8993;62522;137;69524;5981377;6232273;7306423;20710;8170253
FR;2;2022-01-10;10094;31931;232459;857;255046;5991471;6264204;7538882;21567;8425299
FR;2;2022-01-11;11469;36243;265898;1029;290585;6002940;6300447;7804780;22596;8715884
FR;2;2022-01-12;8761;29823;206314;862;226172;6011701;6330270;8011094;23458;8942056
FR;2;2022-01-13;9386;31347;224477;832;244822;6021087;6361617;8235571;24290;9186878
FR;2;2022-01-14;9743;35647;254526;920;277669;6030830;6397264;8490097;25210;9464547
FR;2;2022-01-15;5358;19452;140777;363;153633;6036188;6416716;8630874;25573;9618180
FR;2;2022-01-16;1511;5503;35879;81;39840;6037699;6422219;8666753;25654;9658020
FR;2;2022-01-17;5546;19293;135400;601;147252;6043245;6441512;8802153;26255;9805272
FR;2;2022-01-18;6419;21527;148615;648;160471;6049664;6463039;8950768;26903;9965743
FR;2;2022-01-19;4389;16346;105089;552;113705;6054053;6479385;9055857;27455;10079448
FR;2;2022-01-20;4867;17601;115285;603;123683;6058920;6496986;9171142;28058;10203131
FR;2;2022-01-21;5196;20067;137329;679;147751;6064116;6517053;9308471;28737;10350882
FR;2;2022-01-22;3030;10957;74258;260;80324;6067146;6528010;9382729;28997;10431206
FR;2;2022-01-23;724;2730;15238;41;16833;6067870;6530740;9397967;29038;10448039
FR;2;2022-01-24;3291;12824;75065;430;81026;6071161;6543564;9473032;29468;10529065
FR;2;2022-01-25;3572;14433;79619;496;85450;6074733;6557997;9552651;29964;10614515
FR;2;2022-01-26;2514;10680;58964;363;62995;6077247;6568677;9611615;30327;10677510
FR;2;2022-01-27;2680;11305;64173;388;67913;6079927;6579982;9675788;30715;10745423
FR;2;2022-01-28;3548;18359;91714;429;98952;6083475;6598341;9767502;31144;10844375
FR;2;2022-01-29;1894;9240;48844;164;52926;6085369;6607581;9816346;31308;10897301
FR;2;2022-01-30;464;2235;9452;38;10602;6085833;6609816;9825798;31346;10907903
FR;2;2022-01-31;1889;9578;43825;208;47339;6087722;6619394;9869623;31554;10955242
FR;2;2022-02-01;1913;10054;47026;279;50108;6089635;6629448;9916649;31833;11005350
FR;2;2022-02-02;1608;9015;41106;251;44168;6091243;6638463;9957755;32084;11049518
FR;2;2022-02-03;1723;8950;40513;205;42916;6092966;6647413;9998268;32289;11092434
FR;2;2022-02-04;2152;15214;66636;299;71346;6095118;6662627;10064904;32588;11163780
FR;2;2022-02-05;1361;8530;35943;132;39232;6096479;6671157;10100847;32720;11203012
FR;2;2022-02-06;274;1769;6124;16;6897;6096753;6672926;10106971;32736;11209909
FR;2;2022-02-07;1350;9585;37748;134;41300;6098103;6682511;10144719;32870;11251209
FR;2;2022-02-08;1300;9825;40930;173;43722;6099403;6692336;10185649;33043;11294931
FR;2;2022-02-09;1160;8827;37039;174;40459;6100563;6701163;10222688;33217;11335390
FR;2;2022-02-10;1025;7990;33835;204;36506;6101588;6709153;10256523;33421;11371896
FR;2;2022-02-11;1390;12083;53340;223;57692;6102978;6721236;10309863;33644;11429588
FR;2;2022-02-12;751;6533;27986;83;30805;6103729;6727769;10337849;33727;11460393
FR;2;2022-02-13;200;1339;4833;20;5574;6103929;6729108;10342682;33747;11465967
FR;2;2022-02-14;834;6727;30270;90;33230;6104763;6735835;10372952;33837;11499197
FR;2;2022-02-15;773;6460;28045;141;29988;6105536;6742295;10400997;33978;11529185
FR;2;2022-02-16;655;5358;22058;123;23623;6106191;6747653;10423055;34101;11552808
FR;2;2022-02-17;518;3778;14146;98;14612;6106709;6751431;10437201;34199;11567420
FR;2;2022-02-18;722;5364;20435;134;21127;6107431;6756795;10457636;34333;11588547
FR;2;2022-02-19;430;3053;10529;66;11243;6107861;6759848;10468165;34399;11599790
FR;2;2022-02-20;102;515;1458;3;1605;6107963;6760363;10469623;34402;11601395
FR;2;2022-02-21;422;2684;9119;65;9496;6108385;6763047;10478742;34467;11610891
FR;2;2022-02-22;390;2564;8890;76;8793;6108775;6765611;10487632;34543;11619684
FR;2;2022-02-23;431;2602;8988;82;9266;6109206;6768213;10496620;34625;11628950
FR;2;2022-02-24;314;2031;6798;81;6827;6109520;6770244;10503418;34706;11635777
FR;2;2022-02-25;457;3200;11415;108;11279;6109977;6773444;10514833;34814;11647056
FR;2;2022-02-26;296;1892;6035;49;6340;6110273;6775336;10520868;34863;11653396
FR;2;2022-02-27;76;313;905;5;948;6110349;6775649;10521773;34868;11654344
FR;2;2022-02-28;330;1685;5523;53;5531;6110679;6777334;10527296;34921;11659875
FR;2;2022-03-01;277;1561;5477;45;5194;6110956;6778895;10532773;34966;11665069
FR;2;2022-03-02;298;1435;5245;45;5089;6111254;6780330;10538018;35011;11670158
FR;2;2022-03-03;225;1109;3706;42;3483;6111479;6781439;10541724;35053;11673641
FR;2;2022-03-04;242;1467;4856;73;4502;6111721;6782906;10546580;35126;11678143
FR;2;2022-03-05;173;904;2979;32;2723;6111894;6783810;10549559;35158;11680866
FR;2;2022-03-06;42;182;279;5;319;6111936;6783992;10549838;35163;11681185
FR;2;2022-03-07;155;655;1985;70;1774;6112091;6784647;10551823;35233;11682959
FR;2;2022-03-08;144;658;2270;51;1902;6112235;6785305;10554093;35284;11684861
FR;2;2022-03-09;154;705;2345;37;2045;6112389;6786010;10556438;35321;11686906
FR;2;2022-03-10;121;602;1691;35;1466;6112510;6786612;10558129;35356;11688372
FR;2;2022-03-11;171;755;2767;57;2366;6112681;6787367;10560896;35413;11690738
FR;2;2022-03-12;145;484;1784;27;1553;6112826;6787851;10562680;35440;11692291
FR;2;2022-03-13;25;75;201;29;202;6112851;6787926;10562881;35469;11692493
FR;2;2022-03-14;127;468;1565;529;1294;6112978;6788394;10564446;35998;11693787
FR;2;2022-03-15;138;428;1708;689;1326;6113116;6788822;10566154;36687;11695113
FR;2;2022-03-16;141;474;2012;1611;1592;6113257;6789296;10568166;38298;11696705
FR;2;2022-03-17;93;413;1408;1193;1144;6113350;6789709;10569574;39491;11697849
FR;2;2022-03-18;145;492;2018;1792;1660;6113495;6790201;10571592;41283;11699509
FR;2;2022-03-19;108;319;1210;940;1015;6113603;6790520;10572802;42223;11700524
FR;2;2022-03-20;13;77;191;59;168;6113616;6790597;10572993;42282;11700692
FR;2;2022-03-21;96;305;1213;1483;1076;6113712;6790902;10574206;43765;11701768
FR;2;2022-03-22;117;386;1528;1829;1290;6113829;6791288;10575734;45594;11703058
FR;2;2022-03-23;139;359;1669;3032;1465;6113968;6791647;10577403;48626;11704523
FR;2;2022-03-24;116;292;1182;1546;998;6114084;6791939;10578585;50172;11705521
FR;2;2022-03-25;119;361;1803;2449;1473;6114203;6792300;10580388;52621;11706994
FR;2;2022-03-26;77;247;1203;1222;952;6114280;6792547;10581591;53843;11707946
FR;2;2022-03-27;19;36;153;100;132;6114299;6792583;10581744;53943;11708078
FR;2;2022-03-28;94;286;1135;1601;994;6114393;6792869;10582879;55544;11709072
FR;2;2022-03-29;108;257;1324;2464;1104;6114501;6793126;10584203;58008;11710176
FR;2;2022-03-30;91;312;1487;3183;1319;6114592;6793438;10585690;61191;11711495
FR;2;2022-03-31;104;283;1273;2330;1087;6114696;6793721;10586963;63521;11712582
FR;2;2022-04-01;121;321;1566;2343;1320;6114817;6794042;10588529;65864;11713902
FR;2;2022-04-02;72;161;845;891;737;6114889;6794203;10589374;66755;11714639
FR;2;2022-04-03;16;53;128;112;142;6114905;6794256;10589502;66867;11714781
FR;2;2022-04-04;109;232;986;1436;794;6115014;6794488;10590488;68303;11715575
FR;2;2022-04-05;143;289;1314;2886;1141;6115157;6794777;10591802;71189;11716716
FR;2;2022-04-06;88;249;1305;2519;1128;6115245;6795026;10593107;73708;11717844
FR;2;2022-04-07;120;215;1299;2681;1038;6115365;6795241;10594406;76389;11718882
FR;2;2022-04-08;125;333;1624;3230;1322;6115490;6795574;10596030;79619;11720204
FR;2;2022-04-09;90;219;899;1045;731;6115580;6795793;10596929;80664;11720935
FR;2;2022-04-10;37;47;143;162;119;6115617;6795840;10597072;80826;11721054
FR;2;2022-04-11;86;188;884;1531;773;6115703;6796028;10597956;82357;11721827
FR;2;2022-04-12;176;266;1179;2737;1058;6115879;6796294;10599135;85094;11722885
FR;2;2022-04-13;144;228;1124;2451;983;6116023;6796522;10600259;87545;11723868
FR;2;2022-04-14;114;220;1084;2673;916;6116137;6796742;10601343;90218;11724784
FR;2;2022-04-15;112;245;1196;2275;1065;6116249;6796987;10602539;92493;11725849
FR;2;2022-04-16;65;108;541;545;452;6116314;6797095;10603080;93038;11726301
FR;2;2022-04-17;15;26;57;53;53;6116329;6797121;10603137;93091;11726354
FR;2;2022-04-18;12;35;119;70;114;6116341;6797156;10603256;93161;11726468
FR;2;2022-04-19;112;237;1115;1707;947;6116453;6797393;10604371;94868;11727415
FR;2;2022-04-20;95;238;1099;2145;930;6116548;6797631;10605470;97013;11728345
FR;2;2022-04-21;111;230;980;1905;836;6116659;6797861;10606450;98918;11729181
FR;2;2022-04-22;97;270;1241;2085;1023;6116756;6798131;10607691;101003;11730204
FR;2;2022-04-23;66;154;644;762;573;6116822;6798285;10608335;101765;11730777
FR;2;2022-04-24;12;29;101;68;79;6116834;6798314;10608436;101833;11730856
FR;2;2022-04-25;103;203;820;1314;709;6116937;6798517;10609256;103147;11731565
FR;2;2022-04-26;109;183;1039;1997;877;6117046;6798700;10610295;105144;11732442
FR;2;2022-04-27;96;177;857;1757;760;6117142;6798877;10611152;106901;11733202
FR;2;2022-04-28;91;214;948;1904;842;6117233;6799091;10612100;108805;11734044
FR;2;2022-04-29;81;279;1129;1691;1037;6117314;6799370;10613229;110496;11735081
FR;2;2022-04-30;65;126;470;538;429;6117379;6799496;10613699;111034;11735510
FR;2;2022-05-01;20;24;83;48;84;6117399;6799520;10613782;111082;11735594
FR;2;2022-05-02;114;222;760;1206;655;6117513;6799742;10614542;112288;11736249
FR;2;2022-05-03;149;228;996;1767;935;6117662;6799970;10615538;114055;11737184
FR;2;2022-05-04;88;221;922;1808;865;6117750;6800191;10616460;115863;11738049
FR;2;2022-05-05;126;195;850;1697;767;6117876;6800386;10617310;117560;11738816
FR;2;2022-05-06;133;242;1098;1848;1012;6118009;6800628;10618408;119408;11739828
FR;2;2022-05-07;40;97;470;504;406;6118049;6800725;10618878;119912;11740234
FR;2;2022-05-08;45;53;106;70;100;6118094;6800778;10618984;119982;11740334
FR;2;2022-05-09;101;173;651;984;603;6118195;6800951;10619635;120966;11740937
FR;2;2022-05-10;119;241;936;1829;892;6118314;6801192;10620571;122795;11741829
FR;2;2022-05-11;100;169;810;1871;788;6118414;6801361;10621381;124666;11742617
FR;2;2022-05-12;110;166;838;2093;799;6118524;6801527;10622219;126759;11743416
FR;2;2022-05-13;99;230;967;2090;895;6118623;6801757;10623186;128849;11744311
FR;2;2022-05-14;76;116;450;554;408;6118699;6801873;10623636;129403;11744719
FR;2;2022-05-15;24;37;93;87;107;6118723;6801910;10623729;129490;11744826
FR;2;2022-05-16;103;169;599;921;536;6118826;6802079;10624328;130411;11745362
FR;2;2022-05-17;95;183;688;1685;656;6118921;6802262;10625016;132096;11746018
FR;2;2022-05-18;80;180;639;1421;644;6119001;6802442;10625655;133517;11746662
FR;2;2022-05-19;69;159;707;1822;750;6119070;6802601;10626362;135339;11747412
FR;2;2022-05-20;107;176;869;1700;776;6119177;6802777;10627231;137039;11748188
FR;2;2022-05-21;47;96;396;517;338;6119224;6802873;10627627;137556;11748526
FR;2;2022-05-22;8;23;69;37;57;6119232;6802896;10627696;137593;11748583
FR;2;2022-05-23;85;131;498;929;469;6119317;6803027;10628194;138522;11749052
FR;2;2022-05-24;86;161;625;1610;613;6119403;6803188;10628819;140132;11749665
FR;2;2022-05-25;71;141;538;1142;491;6119474;6803329;10629357;141274;11750156
FR;2;2022-05-26;8;29;77;41;84;6119482;6803358;10629434;141315;11750240
FR;2;2022-05-27;44;121;456;817;438;6119526;6803479;10629890;142132;11750678
FR;2;2022-05-28;28;60;220;243;220;6119554;6803539;10630110;142375;11750898
FR;2;2022-05-29;13;34;43;25;51;6119567;6803573;10630153;142400;11750949
FR;2;2022-05-30;65;108;418;720;404;6119632;6803681;10630571;143120;11751353
FR;2;2022-05-31;76;133;556;1276;506;6119708;6803814;10631127;144396;11751859
FR;2;2022-06-01;57;152;554;1074;534;6119765;6803966;10631681;145470;11752393
FR;2;2022-06-02;92;169;624;1399;588;6119857;6804135;10632305;146869;11752981
FR;2;2022-06-03;70;155;663;1603;590;6119927;6804290;10632968;148472;11753571
FR;2;2022-06-04;66;92;279;432;265;6119993;6804382;10633247;148904;11753836
FR;2;2022-06-05;11;17;62;57;47;6120004;6804399;10633309;148961;11753883
FR;2;2022-06-06;11;23;91;74;89;6120015;6804422;10633400;149035;11753972
FR;2;2022-06-07;98;217;660;1528;572;6120113;6804639;10634060;150563;11754544
FR;2;2022-06-08;69;116;474;1164;407;6120182;6804755;10634534;151727;11754951
FR;2;2022-06-09;91;164;607;1907;565;6120273;6804919;10635141;153634;11755516
FR;2;2022-06-10;86;165;645;1681;617;6120359;6805084;10635786;155315;11756133
FR;2;2022-06-11;42;81;286;527;257;6120401;6805165;10636072;155842;11756390
FR;2;2022-06-12;18;38;58;78;60;6120419;6805203;10636130;155920;11756450
FR;2;2022-06-13;35;117;386;948;371;6120454;6805320;10636516;156868;11756821
FR;2;2022-06-14;65;153;595;2084;533;6120519;6805473;10637111;158952;11757354
FR;2;2022-06-15;73;101;512;1495;436;6120592;6805574;10637623;160447;11757790
FR;2;2022-06-16;128;124;490;1410;415;6120720;6805698;10638113;161857;11758205
FR;2;2022-06-17;68;131;579;1815;506;6120788;6805829;10638692;163672;11758711
FR;2;2022-06-18;75;92;224;578;196;6120863;6805921;10638916;164250;11758907
FR;2;2022-06-19;11;14;52;71;41;6120874;6805935;10638968;164321;11758948
FR;2;2022-06-20;59;124;396;1027;387;6120933;6806059;10639364;165348;11759335
FR;2;2022-06-21;104;114;521;2112;451;6121037;6806173;10639885;167460;11759786
FR;2;2022-06-22;39;105;456;1885;408;6121076;6806278;10640341;169345;11760194
FR;2;2022-06-23;56;107;534;2280;450;6121132;6806385;10640875;171625;11760644
FR;2;2022-06-24;65;119;704;3175;567;6121197;6806504;10641579;174800;11761211
FR;2;2022-06-25;29;89;293;986;250;6121226;6806593;10641872;175786;11761461
FR;2;2022-06-26;30;27;131;194;96;6121256;6806620;10642003;175980;11761557
FR;2;2022-06-27;78;136;574;2471;477;6121334;6806756;10642577;178451;11762034
FR;2;2022-06-28;110;138;801;4802;643;6121444;6806894;10643378;183253;11762677
FR;2;2022-06-29;71;147;765;4340;625;6121515;6807041;10644143;187593;11763302
FR;2;2022-06-30;70;133;823;5171;613;6121585;6807174;10644966;192764;11763915
FR;2;2022-07-01;106;151;1037;6661;759;6121691;6807325;10646003;199425;11764674
FR;2;2022-07-02;65;128;448;1972;369;6121756;6807453;10646451;201397;11765043
FR;2;2022-07-03;23;28;143;333;127;6121779;6807481;10646594;201730;11765170
FR;2;2022-07-04;116;167;737;3769;573;6121895;6807648;10647331;205499;11765743
FR;2;2022-07-05;113;184;1096;6800;806;6122008;6807832;10648427;212299;11766549
FR;2;2022-07-06;92;146;928;5785;680;6122100;6807978;10649355;218084;11767229
FR;2;2022-07-07;80;183;1000;6476;731;6122180;6808161;10650355;224560;11767960
FR;2;2022-07-08;60;118;1061;7011;722;6122240;6808279;10651416;231571;11768682
FR;2;2022-07-09;33;61;415;1866;298;6122273;6808340;10651831;233437;11768980
FR;2;2022-07-10;6;17;95;311;81;6122279;6808357;10651926;233748;11769061
FR;2;2022-07-11;66;112;638;3782;503;6122345;6808469;10652564;237530;11769564
FR;2;2022-07-12;96;173;1029;6442;787;6122441;6808642;10653593;243972;11770351
FR;2;2022-07-13;56;119;850;4611;559;6122497;6808761;10654443;248583;11770910
FR;2;2022-07-14;6;11;60;243;35;6122503;6808772;10654503;248826;11770945
FR;2;2022-07-15;53;117;695;3734;520;6122556;6808889;10655198;252560;11771465
FR;2;2022-07-16;27;43;269;1021;221;6122583;6808932;10655467;253581;11771686
FR;2;2022-07-17;6;11;73;197;63;6122589;6808943;10655540;253778;11771749
FR;2;2022-07-18;49;100;472;2468;349;6122638;6809043;10656012;256246;11772098
FR;3;2020-12-27;0;0;0;0;0;0;0;0;0;0
FR;3;2020-12-28;0;0;0;0;0;0;0;0;0;0
FR;3;2020-12-29;0;0;0;0;0;0;0;0;0;0
FR;3;2020-12-30;0;0;0;0;0;0;0;0;0;0
FR;3;2020-12-31;0;0;0;0;0;0;0;0;0;0
FR;3;2021-01-01;0;0;0;0;0;0;0;0;0;0
FR;3;2021-01-02;0;0;0;0;0;0;0;0;0;0
FR;3;2021-01-03;0;0;0;0;0;0;0;0;0;0
FR;3;2021-01-04;0;0;0;0;0;0;0;0;0;0
FR;3;2021-01-05;0;0;0;0;0;0;0;0;0;0
FR;3;2021-01-06;0;0;0;0;0;0;0;0;0;0
FR;3;2021-01-07;0;0;0;0;0;0;0;0;0;0
FR;3;2021-01-08;0;0;0;0;0;0;0;0;0;0
FR;3;2021-01-09;0;0;0;0;0;0;0;0;0;0
FR;3;2021-01-10;0;0;0;0;0;0;0;0;0;0
FR;3;2021-01-11;0;0;0;0;0;0;0;0;0;0
FR;3;2021-01-12;0;0;0;0;0;0;0;0;0;0
FR;3;2021-01-13;0;0;0;0;0;0;0;0;0;0
FR;3;2021-01-14;0;0;0;0;0;0;0;0;0;0
FR;3;2021-01-15;0;0;0;0;0;0;0;0;0;0
FR;3;2021-01-16;0;0;0;0;0;0;0;0;0;0
FR;3;2021-01-17;0;0;0;0;0;0;0;0;0;0
FR;3;2021-01-18;0;0;0;0;0;0;0;0;0;0
FR;3;2021-01-19;0;0;0;0;0;0;0;0;0;0
FR;3;2021-01-20;0;0;0;0;0;0;0;0;0;0
FR;3;2021-01-21;0;0;0;0;0;0;0;0;0;0
FR;3;2021-01-22;0;0;0;0;0;0;0;0;0;0
FR;3;2021-01-23;0;0;0;0;0;0;0;0;0;0
FR;3;2021-01-24;0;0;0;0;0;0;0;0;0;0
FR;3;2021-01-25;0;0;0;0;0;0;0;0;0;0
FR;3;2021-01-26;0;0;0;0;0;0;0;0;0;0
FR;3;2021-01-27;0;0;0;0;0;0;0;0;0;0
FR;3;2021-01-28;0;0;0;0;0;0;0;0;0;0
FR;3;2021-01-29;0;0;0;0;0;0;0;0;0;0
FR;3;2021-01-30;0;0;0;0;0;0;0;0;0;0
FR;3;2021-01-31;0;0;0;0;0;0;0;0;0;0
FR;3;2021-02-01;0;0;0;0;0;0;0;0;0;0
FR;3;2021-02-02;0;0;0;0;0;0;0;0;0;0
FR;3;2021-02-03;0;0;0;0;0;0;0;0;0;0
FR;3;2021-02-04;0;0;0;0;0;0;0;0;0;0
FR;3;2021-02-05;0;0;0;0;0;0;0;0;0;0
FR;3;2021-02-06;1610;0;0;0;0;1610;0;0;0;0
FR;3;2021-02-07;1423;1;0;0;0;3033;1;0;0;0
FR;3;2021-02-08;2786;1;0;0;0;5819;2;0;0;0
FR;3;2021-02-09;6782;0;0;0;0;12601;2;0;0;0
FR;3;2021-02-10;9607;0;0;0;0;22208;2;0;0;0
FR;3;2021-02-11;13618;1;0;0;0;35826;3;0;0;0
FR;3;2021-02-12;13404;0;0;0;0;49230;3;0;0;0
FR;3;2021-02-13;3793;1;0;0;0;53023;4;0;0;0
FR;3;2021-02-14;973;0;0;0;0;53996;4;0;0;0
FR;3;2021-02-15;10490;1;0;0;0;64486;5;0;0;0
FR;3;2021-02-16;12549;4;0;0;0;77035;9;0;0;0
FR;3;2021-02-17;11154;0;0;0;0;88189;9;0;0;0
FR;3;2021-02-18;14942;2;0;0;0;103131;11;0;0;0
FR;3;2021-02-19;14359;1;0;0;0;117490;12;0;0;0
FR;3;2021-02-20;3330;0;0;0;0;120820;12;0;0;0
FR;3;2021-02-21;618;0;0;0;0;121438;12;0;0;0
FR;3;2021-02-22;9165;0;0;0;0;130603;12;0;0;0
FR;3;2021-02-23;11395;2;0;0;0;141998;14;0;0;0
FR;3;2021-02-24;14302;1;0;0;0;156300;15;0;0;0
FR;3;2021-02-25;44931;1;0;0;0;201231;16;0;0;0
FR;3;2021-02-26;61886;4;0;0;0;263117;20;0;0;0
FR;3;2021-02-27;34801;10;0;0;0;297918;30;0;0;0
FR;3;2021-02-28;2463;0;0;0;0;300381;30;0;0;0
FR;3;2021-03-01;20516;14;0;0;0;320897;44;0;0;0
FR;3;2021-03-02;38867;20;0;0;0;359764;64;0;0;0
FR;3;2021-03-03;48735;15;0;0;0;408499;79;0;0;0
FR;3;2021-03-04;82221;20;0;0;0;490720;99;0;0;0
FR;3;2021-03-05;118129;38;0;0;0;608849;137;0;0;0
FR;3;2021-03-06;120715;61;1;0;0;729564;198;1;0;0
FR;3;2021-03-07;55179;25;0;0;0;784743;223;1;0;0
FR;3;2021-03-08;42811;28;0;0;0;827554;251;1;0;0
FR;3;2021-03-09;78968;49;0;0;0;906522;300;1;0;0
FR;3;2021-03-10;80976;46;0;0;0;987498;346;1;0;0
FR;3;2021-03-11;128432;60;0;0;0;1115930;406;1;0;0
FR;3;2021-03-12;182720;100;0;0;0;1298650;506;1;0;0
FR;3;2021-03-13;132150;73;0;0;0;1430800;579;1;0;0
FR;3;2021-03-14;14056;5;0;0;0;1444856;584;1;0;0
FR;3;2021-03-15;52230;55;0;0;0;1497086;639;1;0;0
FR;3;2021-03-16;1214;36;0;0;0;1498300;675;1;0;0
FR;3;2021-03-17;944;40;0;0;0;1499244;715;1;0;0
FR;3;2021-03-18;1568;25;0;0;0;1500812;740;1;0;0
FR;3;2021-03-19;70453;49;0;0;0;1571265;789;1;0;0
FR;3;2021-03-20;65231;44;0;0;0;1636496;833;1;0;0
FR;3;2021-03-21;5758;7;0;0;0;1642254;840;1;0;0
FR;3;2021-03-22;37500;43;0;0;0;1679754;883;1;0;0
FR;3;2021-03-23;84657;70;0;0;0;1764411;953;1;0;0
FR;3;2021-03-24;90939;93;0;0;0;1855350;1046;1;0;0
FR;3;2021-03-25;150051;133;0;0;0;2005401;1179;1;0;0
FR;3;2021-03-26;165421;154;0;0;0;2170822;1333;1;0;0
FR;3;2021-03-27;68458;101;0;0;0;2239280;1434;1;0;0
FR;3;2021-03-28;6473;21;0;0;0;2245753;1455;1;0;0
FR;3;2021-03-29;54163;73;0;0;0;2299916;1528;1;0;0
FR;3;2021-03-30;93170;101;0;0;0;2393086;1629;1;0;0
FR;3;2021-03-31;63532;98;0;0;0;2456618;1727;1;0;0
FR;3;2021-04-01;86128;106;0;0;0;2542746;1833;1;0;0
FR;3;2021-04-02;86900;166;0;0;0;2629646;1999;1;0;0
FR;3;2021-04-03;35873;123;0;0;0;2665519;2122;1;0;0
FR;3;2021-04-04;3572;18;0;0;0;2669091;2140;1;0;0
FR;3;2021-04-05;4489;28;0;0;0;2673580;2168;1;0;0
FR;3;2021-04-06;29750;94;0;0;0;2703330;2262;1;0;0
FR;3;2021-04-07;32340;88;0;0;0;2735670;2350;1;0;0
FR;3;2021-04-08;78816;248;0;0;0;2814486;2598;1;0;0
FR;3;2021-04-09;161749;423;0;0;0;2976235;3021;1;0;0
FR;3;2021-04-10;75759;338;0;0;0;3051994;3359;1;0;0
FR;3;2021-04-11;7310;46;0;0;0;3059304;3405;1;0;0
FR;3;2021-04-12;51473;210;0;0;0;3110777;3615;1;0;0
FR;3;2021-04-13;86226;328;0;0;0;3197003;3943;1;0;0
FR;3;2021-04-14;67836;356;0;0;0;3264839;4299;1;0;0
FR;3;2021-04-15;93226;378;0;0;0;3358065;4677;1;0;0
FR;3;2021-04-16;112518;594;0;0;0;3470583;5271;1;0;0
FR;3;2021-04-17;53315;335;1;0;0;3523898;5606;2;0;0
FR;3;2021-04-18;9745;38;0;0;0;3533643;5644;2;0;0
FR;3;2021-04-19;25104;253;0;0;0;3558747;5897;2;0;0
FR;3;2021-04-20;45673;407;0;0;0;3604420;6304;2;0;0
FR;3;2021-04-21;38973;485;0;0;0;3643393;6789;2;0;0
FR;3;2021-04-22;54707;813;0;0;0;3698100;7602;2;0;0
FR;3;2021-04-23;70488;1032;0;0;0;3768588;8634;2;0;0
FR;3;2021-04-24;37242;1034;0;0;0;3805830;9668;2;0;0
FR;3;2021-04-25;6207;149;0;0;0;3812037;9817;2;0;0
FR;3;2021-04-26;19786;665;0;0;0;3831823;10482;2;0;0
FR;3;2021-04-27;34473;1274;0;0;0;3866296;11756;2;0;0
FR;3;2021-04-28;28967;1972;0;0;0;3895263;13728;2;0;0
FR;3;2021-04-29;45382;6011;0;0;0;3940645;19739;2;0;0
FR;3;2021-04-30;55460;8983;1;0;0;3996105;28722;3;0;0
FR;3;2021-05-01;9511;2013;0;0;0;4005616;30735;3;0;0
FR;3;2021-05-02;3074;484;0;0;0;4008690;31219;3;0;0
FR;3;2021-05-03;13061;3887;0;0;0;4021751;35106;3;0;0
FR;3;2021-05-04;23114;8450;0;0;0;4044865;43556;3;0;0
FR;3;2021-05-05;18758;10677;0;0;0;4063623;54233;3;0;0
FR;3;2021-05-06;34627;21015;0;0;0;4098250;75248;3;0;0
FR;3;2021-05-07;44201;28602;0;0;0;4142451;103850;3;0;0
FR;3;2021-05-08;6786;9113;0;0;0;4149237;112963;3;0;0
FR;3;2021-05-09;1794;2659;0;0;0;4151031;115622;3;0;0
FR;3;2021-05-10;14991;12746;0;0;0;4166022;128368;3;0;0
FR;3;2021-05-11;27092;25982;0;0;0;4193114;154350;3;0;0
FR;3;2021-05-12;17267;27744;0;0;0;4210381;182094;3;0;0
FR;3;2021-05-13;2281;3490;0;0;0;4212662;185584;3;0;0
FR;3;2021-05-14;14515;25911;0;0;0;4227177;211495;3;0;0
FR;3;2021-05-15;7233;20897;0;0;0;4234410;232392;3;0;0
FR;3;2021-05-16;976;2654;0;0;0;4235386;235046;3;0;0
FR;3;2021-05-17;7962;20033;0;0;0;4243348;255079;3;0;0
FR;3;2021-05-18;13411;29845;0;0;0;4256759;284924;3;0;0
FR;3;2021-05-19;9268;31139;0;0;0;4266027;316063;3;0;0
FR;3;2021-05-20;12803;53474;3;0;0;4278830;369537;6;0;0
FR;3;2021-05-21;12760;65791;2;0;0;4291590;435328;8;0;0
FR;3;2021-05-22;4963;33472;1;0;0;4296553;468800;9;0;0
FR;3;2021-05-23;650;2653;0;0;0;4297203;471453;9;0;0
FR;3;2021-05-24;882;4897;0;0;0;4298085;476350;9;0;0
FR;3;2021-05-25;5305;45912;1;0;0;4303390;522262;10;0;0
FR;3;2021-05-26;4975;51527;1;0;0;4308365;573789;11;0;0
FR;3;2021-05-27;6326;78430;3;0;0;4314691;652219;14;0;0
FR;3;2021-05-28;7541;99538;2;0;0;4322232;751757;16;0;0
FR;3;2021-05-29;3348;60643;1;0;0;4325580;812400;17;0;0
FR;3;2021-05-30;548;8180;0;0;0;4326128;820580;17;0;0
FR;3;2021-05-31;2439;35702;3;0;0;4328567;856282;20;0;0
FR;3;2021-06-01;3402;64816;10;0;0;4331969;921098;30;0;0
FR;3;2021-06-02;2729;58499;6;0;0;4334698;979597;36;0;0
FR;3;2021-06-03;3493;87404;10;0;0;4338191;1067001;46;0;0
FR;3;2021-06-04;4114;105398;22;0;0;4342305;1172399;68;0;0
FR;3;2021-06-05;1980;52378;4;0;0;4344285;1224777;72;0;0
FR;3;2021-06-06;506;5331;1;0;0;4344791;1230108;73;0;0
FR;3;2021-06-07;1475;30944;11;0;0;4346266;1261052;84;0;0
FR;3;2021-06-08;2054;47279;18;0;0;4348320;1308331;102;0;0
FR;3;2021-06-09;1792;42054;13;0;0;4350112;1350385;115;0;0
FR;3;2021-06-10;2247;67707;17;0;0;4352359;1418092;132;0;0
FR;3;2021-06-11;2479;96659;34;0;0;4354838;1514751;166;0;0
FR;3;2021-06-12;1175;40702;6;0;0;4356013;1555453;172;0;0
FR;3;2021-06-13;280;3724;3;0;0;4356293;1559177;175;0;0
FR;3;2021-06-14;1043;42484;17;0;0;4357336;1601661;192;0;0
FR;3;2021-06-15;1365;80515;20;0;0;4358701;1682176;212;0;0
FR;3;2021-06-16;1257;65549;20;0;0;4359958;1747725;232;0;0
FR;3;2021-06-17;1661;101990;41;0;0;4361619;1849715;273;0;0
FR;3;2021-06-18;1870;118150;62;0;0;4363489;1967865;335;0;0
FR;3;2021-06-19;802;39403;22;0;0;4364291;2007268;357;0;0
FR;3;2021-06-20;159;3291;0;0;0;4364450;2010559;357;0;0
FR;3;2021-06-21;771;39161;16;0;0;4365221;2049720;373;0;0
FR;3;2021-06-22;1063;69969;52;0;0;4366284;2119689;425;0;0
FR;3;2021-06-23;941;50802;39;0;0;4367225;2170491;464;0;0
FR;3;2021-06-24;1311;77176;48;0;0;4368536;2247667;512;0;0
FR;3;2021-06-25;1404;90277;73;0;0;4369940;2337944;585;0;0
FR;3;2021-06-26;629;33109;29;0;0;4370569;2371053;614;0;0
FR;3;2021-06-27;166;3922;1;0;0;4370735;2374975;615;0;0
FR;3;2021-06-28;649;30244;27;0;0;4371384;2405219;642;0;0
FR;3;2021-06-29;854;56296;95;0;0;4372238;2461515;737;0;0
FR;3;2021-06-30;904;45111;93;0;0;4373142;2506626;830;0;0
FR;3;2021-07-01;1162;65817;108;0;0;4374304;2572443;938;0;0
FR;3;2021-07-02;1303;90398;170;0;0;4375607;2662841;1108;0;0
FR;3;2021-07-03;602;31176;51;0;0;4376209;2694017;1159;0;0
FR;3;2021-07-04;143;4165;3;0;0;4376352;2698182;1162;0;0
FR;3;2021-07-05;610;33781;60;0;0;4376962;2731963;1222;0;0
FR;3;2021-07-06;959;55998;88;0;0;4377921;2787961;1310;0;0
FR;3;2021-07-07;870;43008;80;0;0;4378791;2830969;1390;0;0
FR;3;2021-07-08;1123;60715;99;0;0;4379914;2891684;1489;0;0
FR;3;2021-07-09;1259;68833;128;0;0;4381173;2960517;1617;0;0
FR;3;2021-07-10;642;25045;59;0;0;4381815;2985562;1676;0;0
FR;3;2021-07-11;129;3240;4;0;0;4381944;2988802;1680;0;0
FR;3;2021-07-12;661;23796;59;0;0;4382605;3012598;1739;0;0
FR;3;2021-07-13;1645;34646;90;0;0;4384250;3047244;1829;0;0
FR;3;2021-07-14;265;2552;2;0;0;4384515;3049796;1831;0;0
FR;3;2021-07-15;1935;30576;85;0;0;4386450;3080372;1916;0;0
FR;3;2021-07-16;2520;38773;122;0;0;4388970;3119145;2038;0;0
FR;3;2021-07-17;1046;13721;26;0;0;4390016;3132866;2064;0;0
FR;3;2021-07-18;263;2577;3;0;0;4390279;3135443;2067;0;0
FR;3;2021-07-19;1275;17073;37;0;0;4391554;3152516;2104;0;0
FR;3;2021-07-20;1823;27048;98;0;0;4393377;3179564;2202;0;0
FR;3;2021-07-21;1649;19639;44;0;0;4395026;3199203;2246;0;0
FR;3;2021-07-22;1851;27687;83;0;0;4396877;3226890;2329;0;0
FR;3;2021-07-23;2215;30378;117;0;0;4399092;3257268;2446;0;0
FR;3;2021-07-24;823;6978;25;0;0;4399915;3264246;2471;0;0
FR;3;2021-07-25;210;1324;1;0;0;4400125;3265570;2472;0;0
FR;3;2021-07-26;927;10629;28;0;0;4401052;3276199;2500;0;0
FR;3;2021-07-27;1167;16906;56;0;0;4402219;3293105;2556;0;0
FR;3;2021-07-28;988;12046;40;0;0;4403207;3305151;2596;0;0
FR;3;2021-07-29;1127;15780;63;0;0;4404334;3320931;2659;0;0
FR;3;2021-07-30;1127;18033;79;0;0;4405461;3338964;2738;0;0
FR;3;2021-07-31;406;3745;15;0;0;4405867;3342709;2753;0;0
FR;3;2021-08-01;114;470;1;0;0;4405981;3343179;2754;0;0
FR;3;2021-08-02;420;5113;22;0;0;4406401;3348292;2776;0;0
FR;3;2021-08-03;492;7541;27;0;0;4406893;3355833;2803;0;0
FR;3;2021-08-04;435;4858;26;0;0;4407328;3360691;2829;0;0
FR;3;2021-08-05;429;3698;12;0;0;4407757;3364389;2841;0;0
FR;3;2021-08-06;454;4754;30;0;0;4408211;3369143;2871;0;0
FR;3;2021-08-07;214;1916;11;0;0;4408425;3371059;2882;0;0
FR;3;2021-08-08;249;430;2;0;0;4408674;3371489;2884;0;0
FR;3;2021-08-09;315;2458;11;0;0;4408989;3373947;2895;0;0
FR;3;2021-08-10;368;3830;15;0;0;4409357;3377777;2910;0;0
FR;3;2021-08-11;288;2696;15;0;0;4409645;3380473;2925;0;0
FR;3;2021-08-12;277;2614;12;0;0;4409922;3383087;2937;0;0
FR;3;2021-08-13;277;2262;16;0;0;4410199;3385349;2953;0;0
FR;3;2021-08-14;171;908;1;0;0;4410370;3386257;2954;0;0
FR;3;2021-08-15;55;174;0;0;0;4410425;3386431;2954;0;0
FR;3;2021-08-16;123;1060;8;0;0;4410548;3387491;2962;0;0
FR;3;2021-08-17;186;1475;8;0;0;4410734;3388966;2970;0;0
FR;3;2021-08-18;201;1339;10;0;0;4410935;3390305;2980;0;0
FR;3;2021-08-19;165;1401;10;0;0;4411100;3391706;2990;0;0
FR;3;2021-08-20;167;1624;16;0;0;4411267;3393330;3006;0;0
FR;3;2021-08-21;93;586;2;0;0;4411360;3393916;3008;0;0
FR;3;2021-08-22;42;186;1;0;0;4411402;3394102;3009;0;0
FR;3;2021-08-23;140;920;7;0;0;4411542;3395022;3016;0;0
FR;3;2021-08-24;124;956;10;0;0;4411666;3395978;3026;0;0
FR;3;2021-08-25;137;832;3;0;0;4411803;3396810;3029;0;0
FR;3;2021-08-26;172;857;9;0;0;4411975;3397667;3038;0;0
FR;3;2021-08-27;175;954;9;0;0;4412150;3398621;3047;0;0
FR;3;2021-08-28;99;369;4;0;0;4412249;3398990;3051;0;0
FR;3;2021-08-29;128;135;1;0;0;4412377;3399125;3052;0;0
FR;3;2021-08-30;99;589;0;0;128;4412476;3399714;3052;0;128
FR;3;2021-08-31;130;701;7;0;148;4412606;3400415;3059;0;276
FR;3;2021-09-01;117;471;5;0;116;4412723;3400886;3064;0;392
FR;3;2021-09-02;100;627;22;0;116;4412823;3401513;3086;0;508
FR;3;2021-09-03;115;580;17;0;126;4412938;3402093;3103;0;634
FR;3;2021-09-04;54;301;3;0;56;4412992;3402394;3106;0;690
FR;3;2021-09-05;51;67;5;0;28;4413043;3402461;3111;0;718
FR;3;2021-09-06;116;385;4;0;143;4413159;3402846;3115;0;861
FR;3;2021-09-07;123;460;14;0;125;4413282;3403306;3129;0;986
FR;3;2021-09-08;119;360;2;0;97;4413401;3403666;3131;0;1083
FR;3;2021-09-09;93;387;8;0;110;4413494;3404053;3139;0;1193
FR;3;2021-09-10;100;411;3;0;99;4413594;3404464;3142;0;1292
FR;3;2021-09-11;76;235;4;0;66;4413670;3404699;3146;0;1358
FR;3;2021-09-12;37;47;1;0;18;4413707;3404746;3147;0;1376
FR;3;2021-09-13;72;312;7;0;105;4413779;3405058;3154;0;1481
FR;3;2021-09-14;72;284;6;0;101;4413851;3405342;3160;0;1582
FR;3;2021-09-15;60;259;3;0;6;4413911;3405601;3163;0;1588
FR;3;2021-09-16;60;332;5;0;5;4413971;3405933;3168;0;1593
FR;3;2021-09-17;51;340;3;0;7;4414022;3406273;3171;0;1600
FR;3;2021-09-18;36;176;1;0;1;4414058;3406449;3172;0;1601
FR;3;2021-09-19;27;31;2;0;1;4414085;3406480;3174;0;1602
FR;3;2021-09-20;79;200;0;0;1;4414164;3406680;3174;0;1603
FR;3;2021-09-21;59;286;6;0;7;4414223;3406966;3180;0;1610
FR;3;2021-09-22;64;228;6;0;7;4414287;3407194;3186;0;1617
FR;3;2021-09-23;36;270;11;0;7;4414323;3407464;3197;0;1624
FR;3;2021-09-24;27;322;12;0;19;4414350;3407786;3209;0;1643
FR;3;2021-09-25;30;147;3;0;3;4414380;3407933;3212;0;1646
FR;3;2021-09-26;15;57;1;0;1;4414395;3407990;3213;0;1647
FR;3;2021-09-27;41;293;3;0;5;4414436;3408283;3216;0;1652
FR;3;2021-09-28;49;252;6;0;10;4414485;3408535;3222;0;1662
FR;3;2021-09-29;35;225;10;0;14;4414520;3408760;3232;0;1676
FR;3;2021-09-30;39;199;8;0;10;4414559;3408959;3240;0;1686
FR;3;2021-10-01;19;165;6;0;6;4414578;3409124;3246;0;1692
FR;3;2021-10-02;16;87;0;0;0;4414594;3409211;3246;0;1692
FR;3;2021-10-03;19;18;1;0;2;4414613;3409229;3247;0;1694
FR;3;2021-10-04;30;158;4;0;4;4414643;3409387;3251;0;1698
FR;3;2021-10-05;16;151;10;0;13;4414659;3409538;3261;0;1711
FR;3;2021-10-06;31;152;8;0;9;4414690;3409690;3269;0;1720
FR;3;2021-10-07;19;137;6;0;6;4414709;3409827;3275;0;1726
FR;3;2021-10-08;22;143;10;0;9;4414731;3409970;3285;0;1735
FR;3;2021-10-09;14;71;1;0;1;4414745;3410041;3286;0;1736
FR;3;2021-10-10;13;17;2;0;2;4414758;3410058;3288;0;1738
FR;3;2021-10-11;15;121;4;0;5;4414773;3410179;3292;0;1743
FR;3;2021-10-12;18;109;5;0;5;4414791;3410288;3297;0;1748
FR;3;2021-10-13;23;115;8;0;6;4414814;3410403;3305;0;1754
FR;3;2021-10-14;16;157;3;0;4;4414830;3410560;3308;0;1758
FR;3;2021-10-15;23;151;8;0;11;4414853;3410711;3316;0;1769
FR;3;2021-10-16;11;77;6;0;8;4414864;3410788;3322;0;1777
FR;3;2021-10-17;12;24;0;0;0;4414876;3410812;3322;0;1777
FR;3;2021-10-18;18;122;2;0;2;4414894;3410934;3324;0;1779
FR;3;2021-10-19;16;119;19;0;21;4414910;3411053;3343;0;1800
FR;3;2021-10-20;22;129;6;0;7;4414932;3411182;3349;0;1807
FR;3;2021-10-21;26;131;17;0;13;4414958;3411313;3366;0;1820
FR;3;2021-10-22;21;125;16;0;20;4414979;3411438;3382;0;1840
FR;3;2021-10-23;12;59;2;0;1;4414991;3411497;3384;0;1841
FR;3;2021-10-24;7;32;0;0;0;4414998;3411529;3384;0;1841
FR;3;2021-10-25;22;149;7;0;7;4415020;3411678;3391;0;1848
FR;3;2021-10-26;19;111;22;0;19;4415039;3411789;3413;0;1867
FR;3;2021-10-27;17;110;9;0;9;4415056;3411899;3422;0;1876
FR;3;2021-10-28;20;119;33;0;36;4415076;3412018;3455;0;1912
FR;3;2021-10-29;11;114;64;0;54;4415087;3412132;3519;0;1966
FR;3;2021-10-30;9;65;11;1;10;4415096;3412197;3530;1;1976
FR;3;2021-10-31;7;23;1;0;1;4415103;3412220;3531;1;1977
FR;3;2021-11-01;8;22;2;0;1;4415111;3412242;3533;1;1978
FR;3;2021-11-02;9;103;8;0;10;4415120;3412345;3541;1;1988
FR;3;2021-11-03;19;112;10;0;10;4415139;3412457;3551;1;1998
FR;3;2021-11-04;18;93;4;0;3;4415157;3412550;3555;1;2001
FR;3;2021-11-05;17;134;8;1;5;4415174;3412684;3563;2;2006
FR;3;2021-11-06;7;63;3;0;3;4415181;3412747;3566;2;2009
FR;3;2021-11-07;6;21;1;0;1;4415187;3412768;3567;2;2010
FR;3;2021-11-08;11;136;7;0;5;4415198;3412904;3574;2;2015
FR;3;2021-11-09;12;142;5;0;5;4415210;3413046;3579;2;2020
FR;3;2021-11-10;13;167;14;0;15;4415223;3413213;3593;2;2035
FR;3;2021-11-11;10;48;3;0;3;4415233;3413261;3596;2;2038
FR;3;2021-11-12;12;148;6;0;4;4415245;3413409;3602;2;2042
FR;3;2021-11-13;7;74;9;0;10;4415252;3413483;3611;2;2052
FR;3;2021-11-14;3;24;0;0;0;4415255;3413507;3611;2;2052
FR;3;2021-11-15;5;186;10;0;11;4415260;3413693;3621;2;2063
FR;3;2021-11-16;4;149;11;0;10;4415264;3413842;3632;2;2073
FR;3;2021-11-17;6;165;10;0;7;4415270;3414007;3642;2;2080
FR;3;2021-11-18;13;164;10;0;11;4415283;3414171;3652;2;2091
FR;3;2021-11-19;10;210;22;0;27;4415293;3414381;3674;2;2118
FR;3;2021-11-20;6;107;5;0;5;4415299;3414488;3679;2;2123
FR;3;2021-11-21;3;25;3;0;3;4415302;3414513;3682;2;2126
FR;3;2021-11-22;11;215;11;0;11;4415313;3414728;3693;2;2137
FR;3;2021-11-23;8;211;15;0;14;4415321;3414939;3708;2;2151
FR;3;2021-11-24;5;218;9;0;17;4415326;3415157;3717;2;2168
FR;3;2021-11-25;9;251;11;0;10;4415335;3415408;3728;2;2178
FR;3;2021-11-26;7;320;35;0;32;4415342;3415728;3763;2;2210
FR;3;2021-11-27;8;155;20;0;21;4415350;3415883;3783;2;2231
FR;3;2021-11-28;3;62;7;0;7;4415353;3415945;3790;2;2238
FR;3;2021-11-29;5;284;20;0;21;4415358;3416229;3810;2;2259
FR;3;2021-11-30;5;366;26;0;29;4415363;3416595;3836;2;2288
FR;3;2021-12-01;22;405;35;0;37;4415385;3417000;3871;2;2325
FR;3;2021-12-02;9;430;33;0;36;4415394;3417430;3904;2;2361
FR;3;2021-12-03;3;492;37;0;38;4415397;3417922;3941;2;2399
FR;3;2021-12-04;3;252;26;0;28;4415400;3418174;3967;2;2427
FR;3;2021-12-05;1;71;5;0;5;4415401;3418245;3972;2;2432
FR;3;2021-12-06;5;456;14;0;15;4415406;3418701;3986;2;2447
FR;3;2021-12-07;4;533;20;0;24;4415410;3419234;4006;2;2471
FR;3;2021-12-08;6;482;29;0;30;4415416;3419716;4035;2;2501
FR;3;2021-12-09;3;546;17;0;22;4415419;3420262;4052;2;2523
FR;3;2021-12-10;9;556;29;0;25;4415428;3420818;4081;2;2548
FR;3;2021-12-11;4;353;10;0;9;4415432;3421171;4091;2;2557
FR;3;2021-12-12;1;113;3;0;3;4415433;3421284;4094;2;2560
FR;3;2021-12-13;2;535;19;0;21;4415435;3421819;4113;2;2581
FR;3;2021-12-14;7;686;18;0;21;4415442;3422505;4131;2;2602
FR;3;2021-12-15;9;652;17;0;21;4415451;3423157;4148;2;2623
FR;3;2021-12-16;10;664;19;0;18;4415461;3423821;4167;2;2641
FR;3;2021-12-17;5;739;18;0;19;4415466;3424560;4185;2;2660
FR;3;2021-12-18;4;391;4;0;5;4415470;3424951;4189;2;2665
FR;3;2021-12-19;3;198;2;0;2;4415473;3425149;4191;2;2667
FR;3;2021-12-20;8;676;23;0;28;4415481;3425825;4214;2;2695
FR;3;2021-12-21;3;767;10;0;13;4415484;3426592;4224;2;2708
FR;3;2021-12-22;8;717;9;0;10;4415492;3427309;4233;2;2718
FR;3;2021-12-23;2;618;8;0;8;4415494;3427927;4241;2;2726
FR;3;2021-12-24;2;257;3;0;6;4415496;3428184;4244;2;2732
FR;3;2021-12-25;0;25;0;0;0;4415496;3428209;4244;2;2732
FR;3;2021-12-26;0;92;1;0;1;4415496;3428301;4245;2;2733
FR;3;2021-12-27;7;518;17;0;20;4415503;3428819;4262;2;2753
FR;3;2021-12-28;1;664;6;0;5;4415504;3429483;4268;2;2758
FR;3;2021-12-29;4;551;14;0;16;4415508;3430034;4282;2;2774
FR;3;2021-12-30;2;577;7;0;10;4415510;3430611;4289;2;2784
FR;3;2021-12-31;0;200;5;0;7;4415510;3430811;4294;2;2791
FR;3;2022-01-01;0;26;0;0;2;4415510;3430837;4294;2;2793
FR;3;2022-01-02;0;81;0;0;0;4415510;3430918;4294;2;2793
FR;3;2022-01-03;4;549;17;0;21;4415514;3431467;4311;2;2814
FR;3;2022-01-04;6;604;9;0;8;4415520;3432071;4320;2;2822
FR;3;2022-01-05;4;539;10;0;14;4415524;3432610;4330;2;2836
FR;3;2022-01-06;5;526;9;0;11;4415529;3433136;4339;2;2847
FR;3;2022-01-07;2;559;11;0;13;4415531;3433695;4350;2;2860
FR;3;2022-01-08;2;271;4;0;5;4415533;3433966;4354;2;2865
FR;3;2022-01-09;0;118;0;0;0;4415533;3434084;4354;2;2865
FR;3;2022-01-10;2;468;12;0;12;4415535;3434552;4366;2;2877
FR;3;2022-01-11;2;517;1;0;1;4415537;3435069;4367;2;2878
FR;3;2022-01-12;2;437;9;0;10;4415539;3435506;4376;2;2888
FR;3;2022-01-13;3;414;11;0;12;4415542;3435920;4387;2;2900
FR;3;2022-01-14;3;465;10;0;13;4415545;3436385;4397;2;2913
FR;3;2022-01-15;0;295;2;0;3;4415545;3436680;4399;2;2916
FR;3;2022-01-16;1;115;1;0;1;4415546;3436795;4400;2;2917
FR;3;2022-01-17;2;341;8;0;9;4415548;3437136;4408;2;2926
FR;3;2022-01-18;2;400;1;0;2;4415550;3437536;4409;2;2928
FR;3;2022-01-19;2;342;5;0;10;4415552;3437878;4414;2;2938
FR;3;2022-01-20;1;374;5;0;3;4415553;3438252;4419;2;2941
FR;3;2022-01-21;4;364;5;0;7;4415557;3438616;4424;2;2948
FR;3;2022-01-22;2;230;1;0;2;4415559;3438846;4425;2;2950
FR;3;2022-01-23;0;81;0;0;1;4415559;3438927;4425;2;2951
FR;3;2022-01-24;2;341;1;0;6;4415561;3439268;4426;2;2957
FR;3;2022-01-25;0;188;0;0;0;4415561;3439456;4426;2;2957
FR;3;2022-01-26;0;83;0;0;0;4415561;3439539;4426;2;2957
FR;3;2022-01-27;0;55;0;0;0;4415561;3439594;4426;2;2957
FR;3;2022-01-28;0;129;0;0;0;4415561;3439723;4426;2;2957
FR;3;2022-01-29;0;109;0;0;0;4415561;3439832;4426;2;2957
FR;3;2022-01-30;0;51;0;0;0;4415561;3439883;4426;2;2957
FR;3;2022-01-31;0;96;0;0;0;4415561;3439979;4426;2;2957
FR;3;2022-02-01;0;106;0;0;1;4415561;3440085;4426;2;2958
FR;3;2022-02-02;0;94;0;0;0;4415561;3440179;4426;2;2958
FR;3;2022-02-03;0;101;0;0;0;4415561;3440280;4426;2;2958
FR;3;2022-02-04;0;122;0;0;0;4415561;3440402;4426;2;2958
FR;3;2022-02-05;0;73;0;0;0;4415561;3440475;4426;2;2958
FR;3;2022-02-06;0;11;0;0;0;4415561;3440486;4426;2;2958
FR;3;2022-02-07;0;89;0;0;1;4415561;3440575;4426;2;2959
FR;3;2022-02-08;0;0;0;0;0;4415561;3440575;4426;2;2959
FR;3;2022-02-09;0;0;0;0;0;4415561;3440575;4426;2;2959
FR;3;2022-02-10;0;0;0;0;0;4415561;3440575;4426;2;2959
FR;3;2022-02-11;0;0;0;0;0;4415561;3440575;4426;2;2959
FR;3;2022-02-12;0;0;0;0;0;4415561;3440575;4426;2;2959
FR;3;2022-02-13;0;0;0;0;0;4415561;3440575;4426;2;2959
FR;3;2022-02-14;0;0;0;0;0;4415561;3440575;4426;2;2959
FR;3;2022-02-15;0;0;0;0;0;4415561;3440575;4426;2;2959
FR;3;2022-02-16;0;0;0;0;0;4415561;3440575;4426;2;2959
FR;3;2022-02-17;0;0;0;0;0;4415561;3440575;4426;2;2959
FR;3;2022-02-18;0;0;0;0;0;4415561;3440575;4426;2;2959
FR;3;2022-02-19;0;0;0;0;0;4415561;3440575;4426;2;2959
FR;3;2022-02-20;0;0;0;0;0;4415561;3440575;4426;2;2959
FR;3;2022-02-21;2;0;0;0;0;4415563;3440575;4426;2;2959
FR;3;2022-02-22;0;0;0;0;0;4415563;3440575;4426;2;2959
FR;3;2022-02-23;0;0;0;0;0;4415563;3440575;4426;2;2959
FR;3;2022-02-24;0;0;0;0;0;4415563;3440575;4426;2;2959
FR;3;2022-02-25;0;0;0;0;0;4415563;3440575;4426;2;2959
FR;3;2022-02-26;0;0;0;0;0;4415563;3440575;4426;2;2959
FR;3;2022-02-27;0;0;0;0;0;4415563;3440575;4426;2;2959
FR;3;2022-02-28;1;0;0;0;0;4415564;3440575;4426;2;2959
FR;3;2022-03-01;1;0;0;0;0;4415565;3440575;4426;2;2959
FR;3;2022-03-02;0;0;0;0;0;4415565;3440575;4426;2;2959
FR;3;2022-03-03;0;0;0;0;0;4415565;3440575;4426;2;2959
FR;3;2022-03-04;0;0;0;0;0;4415565;3440575;4426;2;2959
FR;3;2022-03-05;0;0;0;0;0;4415565;3440575;4426;2;2959
FR;3;2022-03-06;1;0;0;0;0;4415566;3440575;4426;2;2959
FR;3;2022-03-07;0;0;0;0;0;4415566;3440575;4426;2;2959
FR;3;2022-03-08;1;0;0;0;0;4415567;3440575;4426;2;2959
FR;3;2022-03-09;0;0;0;0;0;4415567;3440575;4426;2;2959
FR;3;2022-03-10;0;0;0;0;0;4415567;3440575;4426;2;2959
FR;3;2022-03-11;0;0;0;0;0;4415567;3440575;4426;2;2959
FR;3;2022-03-12;0;0;0;0;0;4415567;3440575;4426;2;2959
FR;3;2022-03-13;0;0;0;0;0;4415567;3440575;4426;2;2959
FR;3;2022-03-14;0;0;0;0;0;4415567;3440575;4426;2;2959
FR;3;2022-03-15;0;0;0;0;0;4415567;3440575;4426;2;2959
FR;3;2022-03-16;0;0;0;0;0;4415567;3440575;4426;2;2959
FR;3;2022-03-17;0;0;0;0;0;4415567;3440575;4426;2;2959
FR;3;2022-03-18;0;0;0;0;0;4415567;3440575;4426;2;2959
FR;3;2022-03-19;0;0;0;0;0;4415567;3440575;4426;2;2959
FR;3;2022-03-20;1;0;0;0;0;4415568;3440575;4426;2;2959
FR;3;2022-03-21;0;0;0;0;0;4415568;3440575;4426;2;2959
FR;3;2022-03-22;0;0;0;0;0;4415568;3440575;4426;2;2959
FR;3;2022-03-23;1;0;0;0;0;4415569;3440575;4426;2;2959
FR;3;2022-03-24;0;0;0;0;0;4415569;3440575;4426;2;2959
FR;3;2022-03-25;1;0;0;0;0;4415570;3440575;4426;2;2959
FR;3;2022-03-26;0;0;0;0;0;4415570;3440575;4426;2;2959
FR;3;2022-03-27;0;0;0;0;0;4415570;3440575;4426;2;2959
FR;3;2022-03-28;0;0;0;0;0;4415570;3440575;4426;2;2959
FR;3;2022-03-29;0;0;0;0;0;4415570;3440575;4426;2;2959
FR;3;2022-03-30;0;0;0;0;0;4415570;3440575;4426;2;2959
FR;3;2022-03-31;0;0;0;0;0;4415570;3440575;4426;2;2959
FR;3;2022-04-01;0;0;0;0;0;4415570;3440575;4426;2;2959
FR;3;2022-04-02;0;0;0;0;0;4415570;3440575;4426;2;2959
FR;3;2022-04-03;0;0;0;0;0;4415570;3440575;4426;2;2959
FR;3;2022-04-04;0;0;0;0;0;4415570;3440575;4426;2;2959
FR;3;2022-04-05;0;0;0;0;0;4415570;3440575;4426;2;2959
FR;3;2022-04-06;0;0;0;0;0;4415570;3440575;4426;2;2959
FR;3;2022-04-07;0;0;0;0;0;4415570;3440575;4426;2;2959
FR;3;2022-04-08;0;0;0;0;0;4415570;3440575;4426;2;2959
FR;3;2022-04-09;0;0;0;0;0;4415570;3440575;4426;2;2959
FR;3;2022-04-10;0;0;0;0;0;4415570;3440575;4426;2;2959
FR;3;2022-04-11;0;0;0;0;0;4415570;3440575;4426;2;2959
FR;3;2022-04-12;0;0;0;0;0;4415570;3440575;4426;2;2959
FR;3;2022-04-13;0;0;0;0;0;4415570;3440575;4426;2;2959
FR;3;2022-04-14;0;0;0;0;0;4415570;3440575;4426;2;2959
FR;3;2022-04-15;1;0;0;0;0;4415571;3440575;4426;2;2959
FR;3;2022-04-16;0;0;0;0;0;4415571;3440575;4426;2;2959
FR;3;2022-04-17;0;0;0;0;0;4415571;3440575;4426;2;2959
FR;3;2022-04-18;0;0;0;0;0;4415571;3440575;4426;2;2959
FR;3;2022-04-19;0;0;0;0;0;4415571;3440575;4426;2;2959
FR;3;2022-04-20;0;0;0;0;0;4415571;3440575;4426;2;2959
FR;3;2022-04-21;0;0;0;0;0;4415571;3440575;4426;2;2959
FR;3;2022-04-22;0;0;0;0;0;4415571;3440575;4426;2;2959
FR;3;2022-04-23;0;0;0;0;0;4415571;3440575;4426;2;2959
FR;3;2022-04-24;0;0;0;0;0;4415571;3440575;4426;2;2959
FR;3;2022-04-25;0;0;0;0;0;4415571;3440575;4426;2;2959
FR;3;2022-04-26;0;0;0;0;0;4415571;3440575;4426;2;2959
FR;3;2022-04-27;0;0;0;0;0;4415571;3440575;4426;2;2959
FR;3;2022-04-28;0;0;0;0;0;4415571;3440575;4426;2;2959
FR;3;2022-04-29;0;0;0;0;0;4415571;3440575;4426;2;2959
FR;3;2022-04-30;0;0;0;0;0;4415571;3440575;4426;2;2959
FR;3;2022-05-01;0;0;0;0;0;4415571;3440575;4426;2;2959
FR;3;2022-05-02;0;0;0;0;0;4415571;3440575;4426;2;2959
FR;3;2022-05-03;0;0;0;0;0;4415571;3440575;4426;2;2959
FR;3;2022-05-04;0;0;0;0;0;4415571;3440575;4426;2;2959
FR;3;2022-05-05;0;0;0;0;0;4415571;3440575;4426;2;2959
FR;3;2022-05-06;0;0;0;0;0;4415571;3440575;4426;2;2959
FR;3;2022-05-07;0;0;0;0;0;4415571;3440575;4426;2;2959
FR;3;2022-05-08;0;0;0;0;0;4415571;3440575;4426;2;2959
FR;3;2022-05-09;0;0;0;0;0;4415571;3440575;4426;2;2959
FR;3;2022-05-10;0;0;0;0;0;4415571;3440575;4426;2;2959
FR;3;2022-05-11;0;0;0;0;0;4415571;3440575;4426;2;2959
FR;3;2022-05-12;0;0;0;0;0;4415571;3440575;4426;2;2959
FR;3;2022-05-13;0;0;0;0;0;4415571;3440575;4426;2;2959
FR;3;2022-05-14;1;0;0;0;0;4415572;3440575;4426;2;2959
FR;3;2022-05-15;0;0;0;0;0;4415572;3440575;4426;2;2959
FR;3;2022-05-16;0;0;0;0;0;4415572;3440575;4426;2;2959
FR;3;2022-05-17;0;0;0;0;0;4415572;3440575;4426;2;2959
FR;3;2022-05-18;0;0;0;0;0;4415572;3440575;4426;2;2959
FR;3;2022-05-19;0;0;0;0;0;4415572;3440575;4426;2;2959
FR;3;2022-05-20;0;0;0;0;0;4415572;3440575;4426;2;2959
FR;3;2022-05-21;0;0;0;0;0;4415572;3440575;4426;2;2959
FR;3;2022-05-22;0;0;0;0;0;4415572;3440575;4426;2;2959
FR;3;2022-05-23;0;0;0;0;0;4415572;3440575;4426;2;2959
FR;3;2022-05-24;0;0;0;0;0;4415572;3440575;4426;2;2959
FR;3;2022-05-25;0;0;0;0;0;4415572;3440575;4426;2;2959
FR;3;2022-05-26;0;0;0;0;0;4415572;3440575;4426;2;2959
FR;3;2022-05-27;0;0;0;0;0;4415572;3440575;4426;2;2959
FR;3;2022-05-28;0;0;0;0;0;4415572;3440575;4426;2;2959
FR;3;2022-05-29;0;0;0;0;0;4415572;3440575;4426;2;2959
FR;3;2022-05-30;0;0;0;0;0;4415572;3440575;4426;2;2959
FR;3;2022-05-31;0;0;0;0;0;4415572;3440575;4426;2;2959
FR;3;2022-06-01;0;0;0;0;0;4415572;3440575;4426;2;2959
FR;3;2022-06-02;0;0;0;0;0;4415572;3440575;4426;2;2959
FR;3;2022-06-03;0;0;0;0;0;4415572;3440575;4426;2;2959
FR;3;2022-06-04;0;0;0;0;0;4415572;3440575;4426;2;2959
FR;3;2022-06-05;0;0;0;0;0;4415572;3440575;4426;2;2959
FR;3;2022-06-06;0;0;0;0;0;4415572;3440575;4426;2;2959
FR;3;2022-06-07;0;0;0;0;0;4415572;3440575;4426;2;2959
FR;3;2022-06-08;0;0;0;0;0;4415572;3440575;4426;2;2959
FR;3;2022-06-09;0;0;0;0;0;4415572;3440575;4426;2;2959
FR;3;2022-06-10;0;0;0;0;0;4415572;3440575;4426;2;2959
FR;3;2022-06-11;0;0;0;0;0;4415572;3440575;4426;2;2959
FR;3;2022-06-12;0;0;0;0;0;4415572;3440575;4426;2;2959
FR;3;2022-06-13;1;0;0;0;0;4415573;3440575;4426;2;2959
FR;3;2022-06-14;0;0;0;0;0;4415573;3440575;4426;2;2959
FR;3;2022-06-15;0;0;0;0;0;4415573;3440575;4426;2;2959
FR;3;2022-06-16;0;0;0;0;0;4415573;3440575;4426;2;2959
FR;3;2022-06-17;0;0;0;0;0;4415573;3440575;4426;2;2959
FR;3;2022-06-18;0;0;0;0;0;4415573;3440575;4426;2;2959
FR;3;2022-06-19;0;0;0;0;0;4415573;3440575;4426;2;2959
FR;3;2022-06-20;0;0;0;0;0;4415573;3440575;4426;2;2959
FR;3;2022-06-21;0;0;0;0;0;4415573;3440575;4426;2;2959
FR;3;2022-06-22;0;0;0;0;0;4415573;3440575;4426;2;2959
FR;3;2022-06-23;0;0;0;0;0;4415573;3440575;4426;2;2959
FR;3;2022-06-24;0;0;0;0;0;4415573;3440575;4426;2;2959
FR;3;2022-06-25;0;0;0;0;0;4415573;3440575;4426;2;2959
FR;3;2022-06-26;0;0;0;0;0;4415573;3440575;4426;2;2959
FR;3;2022-06-27;0;0;0;0;0;4415573;3440575;4426;2;2959
FR;3;2022-06-28;0;0;0;0;0;4415573;3440575;4426;2;2959
FR;3;2022-06-29;1;0;0;0;0;4415574;3440575;4426;2;2959
FR;3;2022-06-30;0;0;0;0;0;4415574;3440575;4426;2;2959
FR;3;2022-07-01;0;0;0;0;0;4415574;3440575;4426;2;2959
FR;3;2022-07-02;0;0;0;0;0;4415574;3440575;4426;2;2959
FR;3;2022-07-03;0;0;0;0;0;4415574;3440575;4426;2;2959
FR;3;2022-07-04;0;0;0;0;0;4415574;3440575;4426;2;2959
FR;3;2022-07-05;0;0;0;0;0;4415574;3440575;4426;2;2959
FR;3;2022-07-06;0;0;0;0;0;4415574;3440575;4426;2;2959
FR;3;2022-07-07;0;0;0;0;0;4415574;3440575;4426;2;2959
FR;3;2022-07-08;0;0;0;0;0;4415574;3440575;4426;2;2959
FR;3;2022-07-09;0;0;0;0;0;4415574;3440575;4426;2;2959
FR;3;2022-07-10;0;0;0;0;0;4415574;3440575;4426;2;2959
FR;3;2022-07-11;0;0;0;0;0;4415574;3440575;4426;2;2959
FR;3;2022-07-12;0;0;0;0;0;4415574;3440575;4426;2;2959
FR;3;2022-07-13;0;0;0;0;0;4415574;3440575;4426;2;2959
FR;3;2022-07-14;0;0;0;0;0;4415574;3440575;4426;2;2959
FR;3;2022-07-15;0;0;0;0;0;4415574;3440575;4426;2;2959
FR;3;2022-07-16;0;0;0;0;0;4415574;3440575;4426;2;2959
FR;3;2022-07-17;0;0;0;0;0;4415574;3440575;4426;2;2959
FR;3;2022-07-18;0;0;0;0;0;4415574;3440575;4426;2;2959
FR;4;2020-12-27;0;0;0;0;0;0;0;0;0;0
FR;4;2020-12-28;0;0;0;0;0;0;0;0;0;0
FR;4;2020-12-29;0;0;0;0;0;0;0;0;0;0
FR;4;2020-12-30;0;0;0;0;0;0;0;0;0;0
FR;4;2020-12-31;0;0;0;0;0;0;0;0;0;0
FR;4;2021-01-01;0;0;0;0;0;0;0;0;0;0
FR;4;2021-01-02;0;0;0;0;0;0;0;0;0;0
FR;4;2021-01-03;0;0;0;0;0;0;0;0;0;0
FR;4;2021-01-04;0;0;0;0;0;0;0;0;0;0
FR;4;2021-01-05;0;0;0;0;0;0;0;0;0;0
FR;4;2021-01-06;0;0;0;0;0;0;0;0;0;0
FR;4;2021-01-07;0;0;0;0;0;0;0;0;0;0
FR;4;2021-01-08;0;0;0;0;0;0;0;0;0;0
FR;4;2021-01-09;0;0;0;0;0;0;0;0;0;0
FR;4;2021-01-10;0;0;0;0;0;0;0;0;0;0
FR;4;2021-01-11;0;0;0;0;0;0;0;0;0;0
FR;4;2021-01-12;0;0;0;0;0;0;0;0;0;0
FR;4;2021-01-13;0;0;0;0;0;0;0;0;0;0
FR;4;2021-01-14;0;0;0;0;0;0;0;0;0;0
FR;4;2021-01-15;0;0;0;0;0;0;0;0;0;0
FR;4;2021-01-16;0;0;0;0;0;0;0;0;0;0
FR;4;2021-01-17;0;0;0;0;0;0;0;0;0;0
FR;4;2021-01-18;0;0;0;0;0;0;0;0;0;0
FR;4;2021-01-19;0;0;0;0;0;0;0;0;0;0
FR;4;2021-01-20;0;0;0;0;0;0;0;0;0;0
FR;4;2021-01-21;0;0;0;0;0;0;0;0;0;0
FR;4;2021-01-22;0;0;0;0;0;0;0;0;0;0
FR;4;2021-01-23;0;0;0;0;0;0;0;0;0;0
FR;4;2021-01-24;0;0;0;0;0;0;0;0;0;0
FR;4;2021-01-25;0;0;0;0;0;0;0;0;0;0
FR;4;2021-01-26;0;0;0;0;0;0;0;0;0;0
FR;4;2021-01-27;0;0;0;0;0;0;0;0;0;0
FR;4;2021-01-28;0;0;0;0;0;0;0;0;0;0
FR;4;2021-01-29;0;0;0;0;0;0;0;0;0;0
FR;4;2021-01-30;0;0;0;0;0;0;0;0;0;0
FR;4;2021-01-31;0;0;0;0;0;0;0;0;0;0
FR;4;2021-02-01;0;0;0;0;0;0;0;0;0;0
FR;4;2021-02-02;0;0;0;0;0;0;0;0;0;0
FR;4;2021-02-03;0;0;0;0;0;0;0;0;0;0
FR;4;2021-02-04;0;0;0;0;0;0;0;0;0;0
FR;4;2021-02-05;0;0;0;0;0;0;0;0;0;0
FR;4;2021-02-06;0;0;0;0;0;0;0;0;0;0
FR;4;2021-02-07;0;0;0;0;0;0;0;0;0;0
FR;4;2021-02-08;0;0;0;0;0;0;0;0;0;0
FR;4;2021-02-09;0;0;0;0;0;0;0;0;0;0
FR;4;2021-02-10;0;0;0;0;0;0;0;0;0;0
FR;4;2021-02-11;0;0;0;0;0;0;0;0;0;0
FR;4;2021-02-12;0;0;0;0;0;0;0;0;0;0
FR;4;2021-02-13;0;0;0;0;0;0;0;0;0;0
FR;4;2021-02-14;0;0;0;0;0;0;0;0;0;0
FR;4;2021-02-15;0;0;0;0;0;0;0;0;0;0
FR;4;2021-02-16;0;0;0;0;0;0;0;0;0;0
FR;4;2021-02-17;0;0;0;0;0;0;0;0;0;0
FR;4;2021-02-18;0;0;0;0;0;0;0;0;0;0
FR;4;2021-02-19;0;0;0;0;0;0;0;0;0;0
FR;4;2021-02-20;0;0;0;0;0;0;0;0;0;0
FR;4;2021-02-21;0;0;0;0;0;0;0;0;0;0
FR;4;2021-02-22;0;0;0;0;0;0;0;0;0;0
FR;4;2021-02-23;0;0;0;0;0;0;0;0;0;0
FR;4;2021-02-24;0;0;0;0;0;0;0;0;0;0
FR;4;2021-02-25;0;0;0;0;0;0;0;0;0;0
FR;4;2021-02-26;0;0;0;0;0;0;0;0;0;0
FR;4;2021-02-27;0;0;0;0;0;0;0;0;0;0
FR;4;2021-02-28;0;0;0;0;0;0;0;0;0;0
FR;4;2021-03-01;0;0;0;0;0;0;0;0;0;0
FR;4;2021-03-02;0;0;0;0;0;0;0;0;0;0
FR;4;2021-03-03;0;0;0;0;0;0;0;0;0;0
FR;4;2021-03-04;0;0;0;0;0;0;0;0;0;0
FR;4;2021-03-05;0;0;0;0;0;0;0;0;0;0
FR;4;2021-03-06;0;0;0;0;0;0;0;0;0;0
FR;4;2021-03-07;0;0;0;0;0;0;0;0;0;0
FR;4;2021-03-08;0;0;0;0;0;0;0;0;0;0
FR;4;2021-03-09;0;0;0;0;0;0;0;0;0;0
FR;4;2021-03-10;0;0;0;0;0;0;0;0;0;0
FR;4;2021-03-11;0;0;0;0;0;0;0;0;0;0
FR;4;2021-03-12;0;0;0;0;0;0;0;0;0;0
FR;4;2021-03-13;0;0;0;0;0;0;0;0;0;0
FR;4;2021-03-14;0;0;0;0;0;0;0;0;0;0
FR;4;2021-03-15;0;0;0;0;0;0;0;0;0;0
FR;4;2021-03-16;0;0;0;0;0;0;0;0;0;0
FR;4;2021-03-17;0;0;0;0;0;0;0;0;0;0
FR;4;2021-03-18;0;0;0;0;0;0;0;0;0;0
FR;4;2021-03-19;0;0;0;0;0;0;0;0;0;0
FR;4;2021-03-20;0;0;0;0;0;0;0;0;0;0
FR;4;2021-03-21;0;0;0;0;0;0;0;0;0;0
FR;4;2021-03-22;0;0;0;0;0;0;0;0;0;0
FR;4;2021-03-23;0;0;0;0;0;0;0;0;0;0
FR;4;2021-03-24;0;0;0;0;0;0;0;0;0;0
FR;4;2021-03-25;0;0;0;0;0;0;0;0;0;0
FR;4;2021-03-26;0;0;0;0;0;0;0;0;0;0
FR;4;2021-03-27;0;0;0;0;0;0;0;0;0;0
FR;4;2021-03-28;0;0;0;0;0;0;0;0;0;0
FR;4;2021-03-29;0;0;0;0;0;0;0;0;0;0
FR;4;2021-03-30;0;0;0;0;0;0;0;0;0;0
FR;4;2021-03-31;0;0;0;0;0;0;0;0;0;0
FR;4;2021-04-01;0;0;0;0;0;0;0;0;0;0
FR;4;2021-04-02;0;0;0;0;0;0;0;0;0;0
FR;4;2021-04-03;0;0;0;0;0;0;0;0;0;0
FR;4;2021-04-04;0;0;0;0;0;0;0;0;0;0
FR;4;2021-04-05;0;0;0;0;0;0;0;0;0;0
FR;4;2021-04-06;0;0;0;0;0;0;0;0;0;0
FR;4;2021-04-07;0;0;0;0;0;0;0;0;0;0
FR;4;2021-04-08;0;0;0;0;0;0;0;0;0;0
FR;4;2021-04-09;0;0;0;0;0;0;0;0;0;0
FR;4;2021-04-10;0;0;0;0;0;0;0;0;0;0
FR;4;2021-04-11;0;0;0;0;0;0;0;0;0;0
FR;4;2021-04-12;0;0;0;0;0;0;0;0;0;0
FR;4;2021-04-13;0;0;0;0;0;0;0;0;0;0
FR;4;2021-04-14;0;0;0;0;0;0;0;0;0;0
FR;4;2021-04-15;0;0;0;0;0;0;0;0;0;0
FR;4;2021-04-16;0;0;0;0;0;0;0;0;0;0
FR;4;2021-04-17;0;0;0;0;0;0;0;0;0;0
FR;4;2021-04-18;0;0;0;0;0;0;0;0;0;0
FR;4;2021-04-19;0;0;0;0;0;0;0;0;0;0
FR;4;2021-04-20;0;0;0;0;0;0;0;0;0;0
FR;4;2021-04-21;0;0;0;0;0;0;0;0;0;0
FR;4;2021-04-22;0;0;0;0;0;0;0;0;0;0
FR;4;2021-04-23;3908;0;0;0;0;3908;0;0;0;0
FR;4;2021-04-24;1569;0;0;0;0;5477;0;0;0;0
FR;4;2021-04-25;125;0;0;0;0;5602;0;0;0;0
FR;4;2021-04-26;2869;1;0;0;0;8471;1;0;0;0
FR;4;2021-04-27;9520;3;0;0;0;17991;4;0;0;0
FR;4;2021-04-28;9904;6;0;0;0;27895;10;0;0;0
FR;4;2021-04-29;15992;8;0;0;0;43887;18;0;0;0
FR;4;2021-04-30;19232;10;0;0;0;63119;28;0;0;0
FR;4;2021-05-01;1994;6;0;0;0;65113;34;0;0;0
FR;4;2021-05-02;482;0;0;0;0;65595;34;0;0;0
FR;4;2021-05-03;5061;2;0;0;0;70656;36;0;0;0
FR;4;2021-05-04;8399;11;0;0;0;79055;47;0;0;0
FR;4;2021-05-05;6184;7;0;0;0;85239;54;0;0;0
FR;4;2021-05-06;11381;11;0;0;0;96620;65;0;0;0
FR;4;2021-05-07;19124;9;0;0;0;115744;74;0;0;0
FR;4;2021-05-08;2377;6;0;0;0;118121;80;0;0;0
FR;4;2021-05-09;686;3;0;0;0;118807;83;0;0;0
FR;4;2021-05-10;7241;5;1;0;0;126048;88;1;0;0
FR;4;2021-05-11;14317;12;0;0;0;140365;100;1;0;0
FR;4;2021-05-12;10168;15;0;0;0;150533;115;1;0;0
FR;4;2021-05-13;1580;3;0;0;0;152113;118;1;0;0
FR;4;2021-05-14;7765;7;0;0;0;159878;125;1;0;0
FR;4;2021-05-15;3718;8;1;0;0;163596;133;2;0;0
FR;4;2021-05-16;417;1;0;0;0;164013;134;2;0;0
FR;4;2021-05-17;4477;6;0;0;0;168490;140;2;0;0
FR;4;2021-05-18;8757;10;0;0;0;177247;150;2;0;0
FR;4;2021-05-19;5691;7;0;0;0;182938;157;2;0;0
FR;4;2021-05-20;9483;7;0;0;0;192421;164;2;0;0
FR;4;2021-05-21;12796;30;0;0;0;205217;194;2;0;0
FR;4;2021-05-22;5056;15;0;0;0;210273;209;2;0;0
FR;4;2021-05-23;494;4;0;0;0;210767;213;2;0;0
FR;4;2021-05-24;1057;7;0;0;0;211824;220;2;0;0
FR;4;2021-05-25;7625;16;0;0;0;219449;236;2;0;0
FR;4;2021-05-26;7726;16;0;0;0;227175;252;2;0;0
FR;4;2021-05-27;14331;35;0;0;0;241506;287;2;0;0
FR;4;2021-05-28;26586;82;1;0;0;268092;369;3;0;0
FR;4;2021-05-29;11382;18;0;0;0;279474;387;3;0;0
FR;4;2021-05-30;972;6;0;0;0;280446;393;3;0;0
FR;4;2021-05-31;12690;21;0;0;0;293136;414;3;0;0
FR;4;2021-06-01;20256;47;1;0;0;313392;461;4;0;0
FR;4;2021-06-02;14520;33;0;0;0;327912;494;4;0;0
FR;4;2021-06-03;19420;24;1;0;0;347332;518;5;0;0
FR;4;2021-06-04;22515;47;0;0;0;369847;565;5;0;0
FR;4;2021-06-05;9713;32;0;0;0;379560;597;5;0;0
FR;4;2021-06-06;1039;1;0;0;0;380599;598;5;0;0
FR;4;2021-06-07;9226;19;0;0;0;389825;617;5;0;0
FR;4;2021-06-08;14612;31;0;0;0;404437;648;5;0;0
FR;4;2021-06-09;12204;25;0;0;0;416641;673;5;0;0
FR;4;2021-06-10;15400;30;0;0;0;432041;703;5;0;0
FR;4;2021-06-11;16982;56;0;0;0;449023;759;5;0;0
FR;4;2021-06-12;7447;27;0;0;0;456470;786;5;0;0
FR;4;2021-06-13;907;3;0;0;0;457377;789;5;0;0
FR;4;2021-06-14;6646;26;0;0;0;464023;815;5;0;0
FR;4;2021-06-15;10885;37;0;0;0;474908;852;5;0;0
FR;4;2021-06-16;8908;15;0;0;0;483816;867;5;0;0
FR;4;2021-06-17;10896;37;0;0;0;494712;904;5;0;0
FR;4;2021-06-18;12421;45;0;0;0;507133;949;5;0;0
FR;4;2021-06-19;5568;25;0;0;0;512701;974;5;0;0
FR;4;2021-06-20;822;5;0;0;0;513523;979;5;0;0
FR;4;2021-06-21;5096;20;0;0;0;518619;999;5;0;0
FR;4;2021-06-22;7906;28;2;0;0;526525;1027;7;0;0
FR;4;2021-06-23;7096;40;2;0;0;533621;1067;9;0;0
FR;4;2021-06-24;8648;46;1;0;0;542269;1113;10;0;0
FR;4;2021-06-25;10171;39;2;0;0;552440;1152;12;0;0
FR;4;2021-06-26;4842;21;0;0;0;557282;1173;12;0;0
FR;4;2021-06-27;763;4;0;0;0;558045;1177;12;0;0
FR;4;2021-06-28;4824;16;1;0;0;562869;1193;13;0;0
FR;4;2021-06-29;7102;27;2;0;0;569971;1220;15;0;0
FR;4;2021-06-30;6715;39;2;0;0;576686;1259;17;0;0
FR;4;2021-07-01;8195;41;0;0;0;584881;1300;17;0;0
FR;4;2021-07-02;9419;52;1;0;0;594300;1352;18;0;0
FR;4;2021-07-03;4846;19;0;0;0;599146;1371;18;0;0
FR;4;2021-07-04;687;5;0;0;0;599833;1376;18;0;0
FR;4;2021-07-05;4770;19;2;0;0;604603;1395;20;0;0
FR;4;2021-07-06;7722;28;4;0;0;612325;1423;24;0;0
FR;4;2021-07-07;7073;34;2;0;0;619398;1457;26;0;0
FR;4;2021-07-08;9226;40;2;0;0;628624;1497;28;0;0
FR;4;2021-07-09;10277;34;1;0;0;638901;1531;29;0;0
FR;4;2021-07-10;4635;14;2;0;0;643536;1545;31;0;0
FR;4;2021-07-11;582;4;1;0;0;644118;1549;32;0;0
FR;4;2021-07-12;5871;29;0;0;0;649989;1578;32;0;0
FR;4;2021-07-13;14233;29;0;0;0;664222;1607;32;0;0
FR;4;2021-07-14;2286;15;0;0;0;666508;1622;32;0;0
FR;4;2021-07-15;18234;36;0;0;0;684742;1658;32;0;0
FR;4;2021-07-16;22828;71;2;0;0;707570;1729;34;0;0
FR;4;2021-07-17;9736;20;0;0;0;717306;1749;34;0;0
FR;4;2021-07-18;1355;4;0;0;0;718661;1753;34;0;0
FR;4;2021-07-19;12987;30;1;0;0;731648;1783;35;0;0
FR;4;2021-07-20;17340;26;1;0;0;748988;1809;36;0;0
FR;4;2021-07-21;15611;33;0;0;0;764599;1842;36;0;0
FR;4;2021-07-22;18240;44;2;0;0;782839;1886;38;0;0
FR;4;2021-07-23;20409;57;7;0;0;803248;1943;45;0;0
FR;4;2021-07-24;9287;32;0;0;0;812535;1975;45;0;0
FR;4;2021-07-25;1351;8;0;0;0;813886;1983;45;0;0
FR;4;2021-07-26;11033;22;0;0;0;824919;2005;45;0;0
FR;4;2021-07-27;14674;35;3;0;0;839593;2040;48;0;0
FR;4;2021-07-28;12930;26;2;0;0;852523;2066;50;0;0
FR;4;2021-07-29;14084;54;4;0;0;866607;2120;54;0;0
FR;4;2021-07-30;15490;46;2;0;0;882097;2166;56;0;0
FR;4;2021-07-31;6834;14;2;0;0;888931;2180;58;0;0
FR;4;2021-08-01;904;1;0;0;0;889835;2181;58;0;0
FR;4;2021-08-02;7912;30;0;0;0;897747;2211;58;0;0
FR;4;2021-08-03;10792;32;2;0;0;908539;2243;60;0;0
FR;4;2021-08-04;9737;29;0;0;0;918276;2272;60;0;0
FR;4;2021-08-05;9817;41;0;0;0;928093;2313;60;0;0
FR;4;2021-08-06;10191;31;3;0;0;938284;2344;63;0;0
FR;4;2021-08-07;5093;30;1;0;0;943377;2374;64;0;0
FR;4;2021-08-08;1219;13;0;0;0;944596;2387;64;0;0
FR;4;2021-08-09;6336;31;0;0;0;950932;2418;64;0;0
FR;4;2021-08-10;8745;18;0;0;0;959677;2436;64;0;0
FR;4;2021-08-11;7938;33;4;0;0;967615;2469;68;0;0
FR;4;2021-08-12;8584;30;1;0;0;976199;2499;69;0;0
FR;4;2021-08-13;7553;24;0;1;0;983752;2523;69;1;0
FR;4;2021-08-14;3789;20;0;0;0;987541;2543;69;1;0
FR;4;2021-08-15;770;5;0;0;0;988311;2548;69;1;0
FR;4;2021-08-16;4005;17;0;0;0;992316;2565;69;1;0
FR;4;2021-08-17;5623;17;1;0;0;997939;2582;70;1;0
FR;4;2021-08-18;5166;37;0;0;0;1003105;2619;70;1;0
FR;4;2021-08-19;5482;33;3;0;0;1008587;2652;73;1;0
FR;4;2021-08-20;5213;25;1;0;0;1013800;2677;74;1;0
FR;4;2021-08-21;2310;21;1;0;0;1016110;2698;75;1;0
FR;4;2021-08-22;404;2;0;0;0;1016514;2700;75;1;0
FR;4;2021-08-23;2927;19;1;0;0;1019441;2719;76;1;0
FR;4;2021-08-24;3751;15;0;0;0;1023192;2734;76;1;0
FR;4;2021-08-25;3539;25;1;0;0;1026731;2759;77;1;0
FR;4;2021-08-26;3708;20;2;0;0;1030439;2779;79;1;0
FR;4;2021-08-27;3609;31;2;0;0;1034048;2810;81;1;0
FR;4;2021-08-28;1725;9;1;0;0;1035773;2819;82;1;0
FR;4;2021-08-29;387;7;1;0;0;1036160;2826;83;1;0
FR;4;2021-08-30;2009;25;0;0;15;1038169;2851;83;1;15
FR;4;2021-08-31;2484;20;0;0;13;1040653;2871;83;1;28
FR;4;2021-09-01;2081;38;1;0;21;1042734;2909;84;1;49
FR;4;2021-09-02;2302;31;4;0;18;1045036;2940;88;1;67
FR;4;2021-09-03;2359;44;5;0;35;1047395;2984;93;1;102
FR;4;2021-09-04;1374;17;0;0;8;1048769;3001;93;1;110
FR;4;2021-09-05;432;2;0;0;2;1049201;3003;93;1;112
FR;4;2021-09-06;1711;61;0;0;22;1050912;3064;93;1;134
FR;4;2021-09-07;1676;18;1;0;9;1052588;3082;94;1;143
FR;4;2021-09-08;1281;26;3;0;19;1053869;3108;97;1;162
FR;4;2021-09-09;1386;23;2;0;9;1055255;3131;99;1;171
FR;4;2021-09-10;1521;31;2;0;23;1056776;3162;101;1;194
FR;4;2021-09-11;742;11;0;0;3;1057518;3173;101;1;197
FR;4;2021-09-12;168;4;0;0;3;1057686;3177;101;1;200
FR;4;2021-09-13;1320;22;1;0;16;1059006;3199;102;1;216
FR;4;2021-09-14;1498;9;2;0;6;1060504;3208;104;1;222
FR;4;2021-09-15;1094;27;1;0;24;1061598;3235;105;1;246
FR;4;2021-09-16;1100;22;2;0;15;1062698;3257;107;1;261
FR;4;2021-09-17;894;21;1;0;12;1063592;3278;108;1;273
FR;4;2021-09-18;462;6;1;0;5;1064054;3284;109;1;278
FR;4;2021-09-19;181;3;0;0;2;1064235;3287;109;1;280
FR;4;2021-09-20;452;19;0;0;13;1064687;3306;109;1;293
FR;4;2021-09-21;425;11;0;0;7;1065112;3317;109;1;300
FR;4;2021-09-22;372;19;2;0;13;1065484;3336;111;1;313
FR;4;2021-09-23;480;16;1;0;15;1065964;3352;112;1;328
FR;4;2021-09-24;411;13;2;0;9;1066375;3365;114;1;337
FR;4;2021-09-25;280;9;1;0;4;1066655;3374;115;1;341
FR;4;2021-09-26;73;2;0;0;1;1066728;3376;115;1;342
FR;4;2021-09-27;262;10;1;0;8;1066990;3386;116;1;350
FR;4;2021-09-28;317;8;0;0;8;1067307;3394;116;1;358
FR;4;2021-09-29;373;18;1;0;12;1067680;3412;117;1;370
FR;4;2021-09-30;363;40;0;0;21;1068043;3452;117;1;391
FR;4;2021-10-01;411;50;0;0;44;1068454;3502;117;1;435
FR;4;2021-10-02;196;22;1;0;13;1068650;3524;118;1;448
FR;4;2021-10-03;85;1;0;0;0;1068735;3525;118;1;448
FR;4;2021-10-04;361;20;1;0;16;1069096;3545;119;1;464
FR;4;2021-10-05;278;19;2;0;15;1069374;3564;121;1;479
FR;4;2021-10-06;246;22;1;0;18;1069620;3586;122;1;497
FR;4;2021-10-07;258;25;2;0;13;1069878;3611;124;1;510
FR;4;2021-10-08;354;23;2;0;19;1070232;3634;126;1;529
FR;4;2021-10-09;193;6;6;0;7;1070425;3640;132;1;536
FR;4;2021-10-10;95;3;2;0;3;1070520;3643;134;1;539
FR;4;2021-10-11;247;15;1;0;14;1070767;3658;135;1;553
FR;4;2021-10-12;207;14;0;0;13;1070974;3672;135;1;566
FR;4;2021-10-13;219;28;1;0;25;1071193;3700;136;1;591
FR;4;2021-10-14;310;21;4;0;15;1071503;3721;140;1;606
FR;4;2021-10-15;321;24;5;0;25;1071824;3745;145;1;631
FR;4;2021-10-16;166;6;2;0;6;1071990;3751;147;1;637
FR;4;2021-10-17;70;2;0;0;1;1072060;3753;147;1;638
FR;4;2021-10-18;279;15;1;0;12;1072339;3768;148;1;650
FR;4;2021-10-19;213;14;2;0;15;1072552;3782;150;1;665
FR;4;2021-10-20;227;27;4;0;15;1072779;3809;154;1;680
FR;4;2021-10-21;239;17;0;0;13;1073018;3826;154;1;693
FR;4;2021-10-22;212;25;2;0;20;1073230;3851;156;1;713
FR;4;2021-10-23;115;16;1;0;15;1073345;3867;157;1;728
FR;4;2021-10-24;38;4;0;0;1;1073383;3871;157;1;729
FR;4;2021-10-25;213;7;2;0;9;1073596;3878;159;1;738
FR;4;2021-10-26;196;14;0;0;12;1073792;3892;159;1;750
FR;4;2021-10-27;194;11;4;0;11;1073986;3903;163;1;761
FR;4;2021-10-28;184;18;4;0;21;1074170;3921;167;1;782
FR;4;2021-10-29;221;15;2;0;13;1074391;3936;169;1;795
FR;4;2021-10-30;102;2;1;0;2;1074493;3938;170;1;797
FR;4;2021-10-31;56;3;2;0;3;1074549;3941;172;1;800
FR;4;2021-11-01;75;27;4;0;24;1074624;3968;176;1;824
FR;4;2021-11-02;156;20;2;0;21;1074780;3988;178;1;845
FR;4;2021-11-03;129;20;8;1;18;1074909;4008;186;2;863
FR;4;2021-11-04;180;15;1;0;12;1075089;4023;187;2;875
FR;4;2021-11-05;129;17;1;0;16;1075218;4040;188;2;891
FR;4;2021-11-06;79;6;1;0;6;1075297;4046;189;2;897
FR;4;2021-11-07;78;2;2;0;4;1075375;4048;191;2;901
FR;4;2021-11-08;158;20;1;0;20;1075533;4068;192;2;921
FR;4;2021-11-09;155;14;3;0;16;1075688;4082;195;2;937
FR;4;2021-11-10;115;29;6;0;31;1075803;4111;201;2;968
FR;4;2021-11-11;91;10;0;0;10;1075894;4121;201;2;978
FR;4;2021-11-12;103;19;2;0;18;1075997;4140;203;2;996
FR;4;2021-11-13;74;15;2;0;14;1076071;4155;205;2;1010
FR;4;2021-11-14;54;5;3;0;7;1076125;4160;208;2;1017
FR;4;2021-11-15;98;26;2;0;24;1076223;4186;210;2;1041
FR;4;2021-11-16;104;13;2;0;15;1076327;4199;212;2;1056
FR;4;2021-11-17;119;29;4;0;29;1076446;4228;216;2;1085
FR;4;2021-11-18;100;34;13;0;42;1076546;4262;229;2;1127
FR;4;2021-11-19;84;19;3;0;20;1076630;4281;232;2;1147
FR;4;2021-11-20;75;8;1;0;8;1076705;4289;233;2;1155
FR;4;2021-11-21;63;7;2;0;9;1076768;4296;235;2;1164
FR;4;2021-11-22;104;27;7;0;30;1076872;4323;242;2;1194
FR;4;2021-11-23;75;29;5;0;26;1076947;4352;247;2;1220
FR;4;2021-11-24;85;23;10;0;23;1077032;4375;257;2;1243
FR;4;2021-11-25;87;28;14;0;30;1077119;4403;271;2;1273
FR;4;2021-11-26;82;43;12;0;45;1077201;4446;283;2;1318
FR;4;2021-11-27;39;22;15;0;25;1077240;4468;298;2;1343
FR;4;2021-11-28;48;8;0;0;7;1077288;4476;298;2;1350
FR;4;2021-11-29;87;31;15;0;39;1077375;4507;313;2;1389
FR;4;2021-11-30;72;36;12;0;40;1077447;4543;325;2;1429
FR;4;2021-12-01;87;60;19;0;67;1077534;4603;344;2;1496
FR;4;2021-12-02;101;48;19;0;53;1077635;4651;363;2;1549
FR;4;2021-12-03;98;36;15;0;44;1077733;4687;378;2;1593
FR;4;2021-12-04;70;31;18;0;44;1077803;4718;396;2;1637
FR;4;2021-12-05;61;6;1;0;7;1077864;4724;397;2;1644
FR;4;2021-12-06;103;46;20;0;60;1077967;4770;417;2;1704
FR;4;2021-12-07;80;35;9;0;34;1078047;4805;426;2;1738
FR;4;2021-12-08;68;29;16;0;35;1078115;4834;442;2;1773
FR;4;2021-12-09;61;32;10;0;38;1078176;4866;452;2;1811
FR;4;2021-12-10;63;64;20;0;68;1078239;4930;472;2;1879
FR;4;2021-12-11;28;34;7;0;34;1078267;4964;479;2;1913
FR;4;2021-12-12;24;10;3;0;13;1078291;4974;482;2;1926
FR;4;2021-12-13;70;40;13;0;48;1078361;5014;495;2;1974
FR;4;2021-12-14;59;43;17;0;54;1078420;5057;512;2;2028
FR;4;2021-12-15;62;64;28;0;84;1078482;5121;540;2;2112
FR;4;2021-12-16;32;44;19;0;57;1078514;5165;559;2;2169
FR;4;2021-12-17;39;55;12;0;60;1078553;5220;571;2;2229
FR;4;2021-12-18;48;29;2;0;30;1078601;5249;573;2;2259
FR;4;2021-12-19;15;4;1;0;4;1078616;5253;574;2;2263
FR;4;2021-12-20;38;38;10;0;41;1078654;5291;584;2;2304
FR;4;2021-12-21;27;30;15;0;36;1078681;5321;599;2;2340
FR;4;2021-12-22;36;37;10;0;38;1078717;5358;609;2;2378
FR;4;2021-12-23;39;45;8;0;49;1078756;5403;617;2;2427
FR;4;2021-12-24;23;26;10;0;30;1078779;5429;627;2;2457
FR;4;2021-12-25;6;3;3;0;4;1078785;5432;630;2;2461
FR;4;2021-12-26;4;3;1;0;2;1078789;5435;631;2;2463
FR;4;2021-12-27;28;41;9;0;43;1078817;5476;640;2;2506
FR;4;2021-12-28;24;28;7;0;29;1078841;5504;647;2;2535
FR;4;2021-12-29;49;25;10;0;29;1078890;5529;657;2;2564
FR;4;2021-12-30;42;18;12;0;21;1078932;5547;669;2;2585
FR;4;2021-12-31;18;6;8;0;11;1078950;5553;677;2;2596
FR;4;2022-01-01;5;4;4;0;6;1078955;5557;681;2;2602
FR;4;2022-01-02;40;5;16;0;20;1078995;5562;697;2;2622
FR;4;2022-01-03;40;54;21;1;60;1079035;5616;718;3;2682
FR;4;2022-01-04;32;27;13;0;30;1079067;5643;731;3;2712
FR;4;2022-01-05;47;21;18;0;23;1079114;5664;749;3;2735
FR;4;2022-01-06;48;20;23;0;35;1079162;5684;772;3;2770
FR;4;2022-01-07;28;20;15;0;20;1079190;5704;787;3;2790
FR;4;2022-01-08;8;6;10;0;12;1079198;5710;797;3;2802
FR;4;2022-01-09;18;2;3;0;4;1079216;5712;800;3;2806
FR;4;2022-01-10;41;22;17;0;34;1079257;5734;817;3;2840
FR;4;2022-01-11;26;30;12;0;34;1079283;5764;829;3;2874
FR;4;2022-01-12;32;21;13;0;23;1079315;5785;842;3;2897
FR;4;2022-01-13;51;19;27;0;37;1079366;5804;869;3;2934
FR;4;2022-01-14;23;28;13;0;31;1079389;5832;882;3;2965
FR;4;2022-01-15;11;6;8;0;12;1079400;5838;890;3;2977
FR;4;2022-01-16;11;9;11;0;19;1079411;5847;901;3;2996
FR;4;2022-01-17;24;18;12;0;24;1079435;5865;913;3;3020
FR;4;2022-01-18;16;13;8;0;18;1079451;5878;921;3;3038
FR;4;2022-01-19;30;23;10;0;31;1079481;5901;931;3;3069
FR;4;2022-01-20;31;34;11;0;37;1079512;5935;942;3;3106
FR;4;2022-01-21;9;12;19;1;16;1079521;5947;961;4;3122
FR;4;2022-01-22;30;9;2;0;9;1079551;5956;963;4;3131
FR;4;2022-01-23;7;2;4;0;6;1079558;5958;967;4;3137
FR;4;2022-01-24;14;21;8;0;27;1079572;5979;975;4;3164
FR;4;2022-01-25;20;31;8;1;35;1079592;6010;983;5;3199
FR;4;2022-01-26;19;14;7;1;16;1079611;6024;990;6;3215
FR;4;2022-01-27;20;18;6;0;22;1079631;6042;996;6;3237
FR;4;2022-01-28;13;23;8;0;26;1079644;6065;1004;6;3263
FR;4;2022-01-29;16;6;5;0;10;1079660;6071;1009;6;3273
FR;4;2022-01-30;16;3;1;0;4;1079676;6074;1010;6;3277
FR;4;2022-01-31;19;27;8;0;31;1079695;6101;1018;6;3308
FR;4;2022-02-01;9;19;11;0;19;1079704;6120;1029;6;3327
FR;4;2022-02-02;17;11;10;2;16;1079721;6131;1039;8;3343
FR;4;2022-02-03;13;23;9;0;26;1079734;6154;1048;8;3369
FR;4;2022-02-04;7;5;7;0;9;1079741;6159;1055;8;3378
FR;4;2022-02-05;7;14;1;0;13;1079748;6173;1056;8;3391
FR;4;2022-02-06;6;3;2;0;4;1079754;6176;1058;8;3395
FR;4;2022-02-07;14;19;7;0;19;1079768;6195;1065;8;3414
FR;4;2022-02-08;16;20;13;1;21;1079784;6215;1078;9;3435
FR;4;2022-02-09;16;11;7;0;14;1079800;6226;1085;9;3449
FR;4;2022-02-10;17;23;9;0;24;1079817;6249;1094;9;3473
FR;4;2022-02-11;18;14;8;0;19;1079835;6263;1102;9;3492
FR;4;2022-02-12;23;6;2;0;6;1079858;6269;1104;9;3498
FR;4;2022-02-13;7;3;3;0;6;1079865;6272;1107;9;3504
FR;4;2022-02-14;18;10;7;0;13;1079883;6282;1114;9;3517
FR;4;2022-02-15;17;7;1;0;7;1079900;6289;1115;9;3524
FR;4;2022-02-16;14;9;10;0;15;1079914;6298;1125;9;3539
FR;4;2022-02-17;10;4;4;0;6;1079924;6302;1129;9;3545
FR;4;2022-02-18;17;15;7;0;20;1079941;6317;1136;9;3565
FR;4;2022-02-19;16;3;2;0;4;1079957;6320;1138;9;3569
FR;4;2022-02-20;7;3;0;0;2;1079964;6323;1138;9;3571
FR;4;2022-02-21;22;3;3;0;4;1079986;6326;1141;9;3575
FR;4;2022-02-22;8;4;9;0;9;1079994;6330;1150;9;3584
FR;4;2022-02-23;16;6;9;0;9;1080010;6336;1159;9;3593
FR;4;2022-02-24;10;5;3;0;6;1080020;6341;1162;9;3599
FR;4;2022-02-25;15;5;7;0;6;1080035;6346;1169;9;3605
FR;4;2022-02-26;26;3;0;0;3;1080061;6349;1169;9;3608
FR;4;2022-02-27;9;0;1;0;1;1080070;6349;1170;9;3609
FR;4;2022-02-28;15;3;2;0;3;1080085;6352;1172;9;3612
FR;4;2022-03-01;6;2;7;0;3;1080091;6354;1179;9;3615
FR;4;2022-03-02;12;2;3;0;4;1080103;6356;1182;9;3619
FR;4;2022-03-03;16;5;1;0;4;1080119;6361;1183;9;3623
FR;4;2022-03-04;7;7;2;1;5;1080126;6368;1185;10;3628
FR;4;2022-03-05;9;2;0;0;2;1080135;6370;1185;10;3630
FR;4;2022-03-06;4;0;1;0;1;1080139;6370;1186;10;3631
FR;4;2022-03-07;10;4;1;0;3;1080149;6374;1187;10;3634
FR;4;2022-03-08;13;3;0;0;3;1080162;6377;1187;10;3637
FR;4;2022-03-09;8;6;2;0;7;1080170;6383;1189;10;3644
FR;4;2022-03-10;5;1;5;0;2;1080175;6384;1194;10;3646
FR;4;2022-03-11;8;4;5;0;2;1080183;6388;1199;10;3648
FR;4;2022-03-12;9;2;0;0;0;1080192;6390;1199;10;3648
FR;4;2022-03-13;5;1;1;0;2;1080197;6391;1200;10;3650
FR;4;2022-03-14;4;1;1;0;2;1080201;6392;1201;10;3652
FR;4;2022-03-15;6;3;2;0;2;1080207;6395;1203;10;3654
FR;4;2022-03-16;7;3;3;0;3;1080214;6398;1206;10;3657
FR;4;2022-03-17;3;4;1;0;5;1080217;6402;1207;10;3662
FR;4;2022-03-18;9;3;0;0;3;1080226;6405;1207;10;3665
FR;4;2022-03-19;1;1;0;0;1;1080227;6406;1207;10;3666
FR;4;2022-03-20;2;0;2;0;1;1080229;6406;1209;10;3667
FR;4;2022-03-21;5;3;0;0;3;1080234;6409;1209;10;3670
FR;4;2022-03-22;3;2;2;0;3;1080237;6411;1211;10;3673
FR;4;2022-03-23;6;4;4;0;7;1080243;6415;1215;10;3680
FR;4;2022-03-24;2;4;3;1;5;1080245;6419;1218;11;3685
FR;4;2022-03-25;3;1;2;0;1;1080248;6420;1220;11;3686
FR;4;2022-03-26;5;5;0;0;5;1080253;6425;1220;11;3691
FR;4;2022-03-27;1;0;1;0;0;1080254;6425;1221;11;3691
FR;4;2022-03-28;5;1;3;0;3;1080259;6426;1224;11;3694
FR;4;2022-03-29;8;0;4;1;0;1080267;6426;1228;12;3694
FR;4;2022-03-30;2;4;0;0;4;1080269;6430;1228;12;3698
FR;4;2022-03-31;2;3;1;1;3;1080271;6433;1229;13;3701
FR;4;2022-04-01;13;2;5;0;5;1080284;6435;1234;13;3706
FR;4;2022-04-02;4;4;0;0;3;1080288;6439;1234;13;3709
FR;4;2022-04-03;0;0;0;0;0;1080288;6439;1234;13;3709
FR;4;2022-04-04;4;4;3;0;4;1080292;6443;1237;13;3713
FR;4;2022-04-05;3;3;1;1;2;1080295;6446;1238;14;3715
FR;4;2022-04-06;4;0;0;0;0;1080299;6446;1238;14;3715
FR;4;2022-04-07;3;2;3;2;5;1080302;6448;1241;16;3720
FR;4;2022-04-08;4;1;1;0;1;1080306;6449;1242;16;3721
FR;4;2022-04-09;0;0;1;1;1;1080306;6449;1243;17;3722
FR;4;2022-04-10;1;2;0;0;2;1080307;6451;1243;17;3724
FR;4;2022-04-11;3;2;4;0;4;1080310;6453;1247;17;3728
FR;4;2022-04-12;3;1;4;0;2;1080313;6454;1251;17;3730
FR;4;2022-04-13;4;7;2;0;9;1080317;6461;1253;17;3739
FR;4;2022-04-14;6;4;1;1;4;1080323;6465;1254;18;3743
FR;4;2022-04-15;5;8;1;0;9;1080328;6473;1255;18;3752
FR;4;2022-04-16;1;0;0;0;0;1080329;6473;1255;18;3752
FR;4;2022-04-17;2;1;0;0;1;1080331;6474;1255;18;3753
FR;4;2022-04-18;2;2;5;0;3;1080333;6476;1260;18;3756
FR;4;2022-04-19;2;0;1;0;0;1080335;6476;1261;18;3756
FR;4;2022-04-20;13;4;1;0;3;1080348;6480;1262;18;3759
FR;4;2022-04-21;5;1;0;0;1;1080353;6481;1262;18;3760
FR;4;2022-04-22;1;0;2;0;1;1080354;6481;1264;18;3761
FR;4;2022-04-23;2;3;3;0;6;1080356;6484;1267;18;3767
FR;4;2022-04-24;0;2;0;0;2;1080356;6486;1267;18;3769
FR;4;2022-04-25;3;4;3;0;7;1080359;6490;1270;18;3776
FR;4;2022-04-26;4;4;1;0;4;1080363;6494;1271;18;3780
FR;4;2022-04-27;4;1;0;1;0;1080367;6495;1271;19;3780
FR;4;2022-04-28;2;5;5;0;6;1080369;6500;1276;19;3786
FR;4;2022-04-29;4;3;0;0;2;1080373;6503;1276;19;3788
FR;4;2022-04-30;0;1;1;0;2;1080373;6504;1277;19;3790
FR;4;2022-05-01;0;0;0;0;0;1080373;6504;1277;19;3790
FR;4;2022-05-02;4;16;6;0;19;1080377;6520;1283;19;3809
FR;4;2022-05-03;2;5;2;0;6;1080379;6525;1285;19;3815
FR;4;2022-05-04;7;4;1;0;4;1080386;6529;1286;19;3819
FR;4;2022-05-05;2;2;1;1;1;1080388;6531;1287;20;3820
FR;4;2022-05-06;2;1;1;0;1;1080390;6532;1288;20;3821
FR;4;2022-05-07;0;0;0;0;0;1080390;6532;1288;20;3821
FR;4;2022-05-08;1;1;0;0;1;1080391;6533;1288;20;3822
FR;4;2022-05-09;5;0;0;0;0;1080396;6533;1288;20;3822
FR;4;2022-05-10;1;1;0;2;3;1080397;6534;1288;22;3825
FR;4;2022-05-11;2;2;1;0;3;1080399;6536;1289;22;3828
FR;4;2022-05-12;5;3;1;1;4;1080404;6539;1290;23;3832
FR;4;2022-05-13;0;0;2;0;2;1080404;6539;1292;23;3834
FR;4;2022-05-14;0;2;0;0;2;1080404;6541;1292;23;3836
FR;4;2022-05-15;1;2;0;0;0;1080405;6543;1292;23;3836
FR;4;2022-05-16;5;2;2;0;2;1080410;6545;1294;23;3838
FR;4;2022-05-17;3;1;2;0;3;1080413;6546;1296;23;3841
FR;4;2022-05-18;0;5;0;0;5;1080413;6551;1296;23;3846
FR;4;2022-05-19;2;2;3;0;4;1080415;6553;1299;23;3850
FR;4;2022-05-20;2;1;3;0;1;1080417;6554;1302;23;3851
FR;4;2022-05-21;2;0;1;0;1;1080419;6554;1303;23;3852
FR;4;2022-05-22;0;0;1;0;1;1080419;6554;1304;23;3853
FR;4;2022-05-23;0;0;2;0;0;1080419;6554;1306;23;3853
FR;4;2022-05-24;1;4;0;0;4;1080420;6558;1306;23;3857
FR;4;2022-05-25;1;3;0;0;1;1080421;6561;1306;23;3858
FR;4;2022-05-26;2;0;0;0;0;1080423;6561;1306;23;3858
FR;4;2022-05-27;0;1;0;0;1;1080423;6562;1306;23;3859
FR;4;2022-05-28;1;0;0;0;0;1080424;6562;1306;23;3859
FR;4;2022-05-29;0;0;0;0;0;1080424;6562;1306;23;3859
FR;4;2022-05-30;2;4;2;0;5;1080426;6566;1308;23;3864
FR;4;2022-05-31;2;1;0;0;1;1080428;6567;1308;23;3865
FR;4;2022-06-01;1;11;7;0;15;1080429;6578;1315;23;3880
FR;4;2022-06-02;1;5;2;0;5;1080430;6583;1317;23;3885
FR;4;2022-06-03;1;5;4;1;6;1080431;6588;1321;24;3891
FR;4;2022-06-04;0;1;1;0;1;1080431;6589;1322;24;3892
FR;4;2022-06-05;0;0;0;0;0;1080431;6589;1322;24;3892
FR;4;2022-06-06;5;0;2;0;1;1080436;6589;1324;24;3893
FR;4;2022-06-07;3;1;0;1;1;1080439;6590;1324;25;3894
FR;4;2022-06-08;0;3;3;0;6;1080439;6593;1327;25;3900
FR;4;2022-06-09;1;2;0;0;1;1080440;6595;1327;25;3901
FR;4;2022-06-10;2;0;3;0;1;1080442;6595;1330;25;3902
FR;4;2022-06-11;0;0;0;0;0;1080442;6595;1330;25;3902
FR;4;2022-06-12;4;0;0;0;0;1080446;6595;1330;25;3902
FR;4;2022-06-13;3;1;2;0;1;1080449;6596;1332;25;3903
FR;4;2022-06-14;3;2;0;0;2;1080452;6598;1332;25;3905
FR;4;2022-06-15;6;0;4;0;0;1080458;6598;1336;25;3905
FR;4;2022-06-16;0;2;1;1;1;1080458;6600;1337;26;3906
FR;4;2022-06-17;2;1;0;0;1;1080460;6601;1337;26;3907
FR;4;2022-06-18;0;0;0;0;0;1080460;6601;1337;26;3907
FR;4;2022-06-19;0;0;0;0;0;1080460;6601;1337;26;3907
FR;4;2022-06-20;4;2;1;0;3;1080464;6603;1338;26;3910
FR;4;2022-06-21;2;2;3;1;3;1080466;6605;1341;27;3913
FR;4;2022-06-22;2;2;0;0;2;1080468;6607;1341;27;3915
FR;4;2022-06-23;3;3;3;0;5;1080471;6610;1344;27;3920
FR;4;2022-06-24;1;0;2;0;0;1080472;6610;1346;27;3920
FR;4;2022-06-25;1;0;0;0;0;1080473;6610;1346;27;3920
FR;4;2022-06-26;0;0;1;0;1;1080473;6610;1347;27;3921
FR;4;2022-06-27;1;2;0;3;2;1080474;6612;1347;30;3923
FR;4;2022-06-28;0;3;2;1;4;1080474;6615;1349;31;3927
FR;4;2022-06-29;0;0;1;0;0;1080474;6615;1350;31;3927
FR;4;2022-06-30;1;0;0;0;0;1080475;6615;1350;31;3927
FR;4;2022-07-01;2;0;2;0;0;1080477;6615;1352;31;3927
FR;4;2022-07-02;0;1;0;0;0;1080477;6616;1352;31;3927
FR;4;2022-07-03;0;0;0;0;0;1080477;6616;1352;31;3927
FR;4;2022-07-04;2;0;0;0;0;1080479;6616;1352;31;3927
FR;4;2022-07-05;1;0;0;0;0;1080480;6616;1352;31;3927
FR;4;2022-07-06;5;0;0;0;0;1080485;6616;1352;31;3927
FR;4;2022-07-07;1;0;2;1;0;1080486;6616;1354;32;3927
FR;4;2022-07-08;2;0;0;0;0;1080488;6616;1354;32;3927
FR;4;2022-07-09;2;0;1;0;1;1080490;6616;1355;32;3928
FR;4;2022-07-10;1;0;0;0;0;1080491;6616;1355;32;3928
FR;4;2022-07-11;2;0;1;0;0;1080493;6616;1356;32;3928
FR;4;2022-07-12;0;0;1;0;1;1080493;6616;1357;32;3929
FR;4;2022-07-13;1;1;2;0;1;1080494;6617;1359;32;3930
FR;4;2022-07-14;0;0;0;0;0;1080494;6617;1359;32;3930
FR;4;2022-07-15;5;0;0;0;0;1080499;6617;1359;32;3930
FR;4;2022-07-16;1;0;0;0;0;1080500;6617;1359;32;3930
FR;4;2022-07-17;0;0;0;0;0;1080500;6617;1359;32;3930
FR;4;2022-07-18;0;0;0;0;0;1080500;6617;1359;32;3930
FR;5;2020-12-27;0;0;0;0;0;0;0;0;0;0
FR;5;2020-12-28;0;0;0;0;0;0;0;0;0;0
FR;5;2020-12-29;0;0;0;0;0;0;0;0;0;0
FR;5;2020-12-30;0;0;0;0;0;0;0;0;0;0
FR;5;2020-12-31;0;0;0;0;0;0;0;0;0;0
FR;5;2021-01-01;0;0;0;0;0;0;0;0;0;0
FR;5;2021-01-02;0;0;0;0;0;0;0;0;0;0
FR;5;2021-01-03;0;0;0;0;0;0;0;0;0;0
FR;5;2021-01-04;0;0;0;0;0;0;0;0;0;0
FR;5;2021-01-05;0;0;0;0;0;0;0;0;0;0
FR;5;2021-01-06;0;0;0;0;0;0;0;0;0;0
FR;5;2021-01-07;0;0;0;0;0;0;0;0;0;0
FR;5;2021-01-08;0;0;0;0;0;0;0;0;0;0
FR;5;2021-01-09;0;0;0;0;0;0;0;0;0;0
FR;5;2021-01-10;0;0;0;0;0;0;0;0;0;0
FR;5;2021-01-11;0;0;0;0;0;0;0;0;0;0
FR;5;2021-01-12;0;0;0;0;0;0;0;0;0;0
FR;5;2021-01-13;0;0;0;0;0;0;0;0;0;0
FR;5;2021-01-14;0;0;0;0;0;0;0;0;0;0
FR;5;2021-01-15;0;0;0;0;0;0;0;0;0;0
FR;5;2021-01-16;0;0;0;0;0;0;0;0;0;0
FR;5;2021-01-17;0;0;0;0;0;0;0;0;0;0
FR;5;2021-01-18;0;0;0;0;0;0;0;0;0;0
FR;5;2021-01-19;0;0;0;0;0;0;0;0;0;0
FR;5;2021-01-20;0;0;0;0;0;0;0;0;0;0
FR;5;2021-01-21;0;0;0;0;0;0;0;0;0;0
FR;5;2021-01-22;0;0;0;0;0;0;0;0;0;0
FR;5;2021-01-23;0;0;0;0;0;0;0;0;0;0
FR;5;2021-01-24;0;0;0;0;0;0;0;0;0;0
FR;5;2021-01-25;0;0;0;0;0;0;0;0;0;0
FR;5;2021-01-26;0;0;0;0;0;0;0;0;0;0
FR;5;2021-01-27;0;0;0;0;0;0;0;0;0;0
FR;5;2021-01-28;0;0;0;0;0;0;0;0;0;0
FR;5;2021-01-29;0;0;0;0;0;0;0;0;0;0
FR;5;2021-01-30;0;0;0;0;0;0;0;0;0;0
FR;5;2021-01-31;0;0;0;0;0;0;0;0;0;0
FR;5;2021-02-01;0;0;0;0;0;0;0;0;0;0
FR;5;2021-02-02;0;0;0;0;0;0;0;0;0;0
FR;5;2021-02-03;0;0;0;0;0;0;0;0;0;0
FR;5;2021-02-04;0;0;0;0;0;0;0;0;0;0
FR;5;2021-02-05;0;0;0;0;0;0;0;0;0;0
FR;5;2021-02-06;0;0;0;0;0;0;0;0;0;0
FR;5;2021-02-07;0;0;0;0;0;0;0;0;0;0
FR;5;2021-02-08;0;0;0;0;0;0;0;0;0;0
FR;5;2021-02-09;0;0;0;0;0;0;0;0;0;0
FR;5;2021-02-10;0;0;0;0;0;0;0;0;0;0
FR;5;2021-02-11;0;0;0;0;0;0;0;0;0;0
FR;5;2021-02-12;0;0;0;0;0;0;0;0;0;0
FR;5;2021-02-13;0;0;0;0;0;0;0;0;0;0
FR;5;2021-02-14;0;0;0;0;0;0;0;0;0;0
FR;5;2021-02-15;0;0;0;0;0;0;0;0;0;0
FR;5;2021-02-16;0;0;0;0;0;0;0;0;0;0
FR;5;2021-02-17;0;0;0;0;0;0;0;0;0;0
FR;5;2021-02-18;0;0;0;0;0;0;0;0;0;0
FR;5;2021-02-19;0;0;0;0;0;0;0;0;0;0
FR;5;2021-02-20;0;0;0;0;0;0;0;0;0;0
FR;5;2021-02-21;0;0;0;0;0;0;0;0;0;0
FR;5;2021-02-22;0;0;0;0;0;0;0;0;0;0
FR;5;2021-02-23;0;0;0;0;0;0;0;0;0;0
FR;5;2021-02-24;0;0;0;0;0;0;0;0;0;0
FR;5;2021-02-25;0;0;0;0;0;0;0;0;0;0
FR;5;2021-02-26;0;0;0;0;0;0;0;0;0;0
FR;5;2021-02-27;0;0;0;0;0;0;0;0;0;0
FR;5;2021-02-28;0;0;0;0;0;0;0;0;0;0
FR;5;2021-03-01;0;0;0;0;0;0;0;0;0;0
FR;5;2021-03-02;0;0;0;0;0;0;0;0;0;0
FR;5;2021-03-03;0;0;0;0;0;0;0;0;0;0
FR;5;2021-03-04;0;0;0;0;0;0;0;0;0;0
FR;5;2021-03-05;0;0;0;0;0;0;0;0;0;0
FR;5;2021-03-06;0;0;0;0;0;0;0;0;0;0
FR;5;2021-03-07;0;0;0;0;0;0;0;0;0;0
FR;5;2021-03-08;0;0;0;0;0;0;0;0;0;0
FR;5;2021-03-09;0;0;0;0;0;0;0;0;0;0
FR;5;2021-03-10;0;0;0;0;0;0;0;0;0;0
FR;5;2021-03-11;0;0;0;0;0;0;0;0;0;0
FR;5;2021-03-12;0;0;0;0;0;0;0;0;0;0
FR;5;2021-03-13;0;0;0;0;0;0;0;0;0;0
FR;5;2021-03-14;0;0;0;0;0;0;0;0;0;0
FR;5;2021-03-15;0;0;0;0;0;0;0;0;0;0
FR;5;2021-03-16;0;0;0;0;0;0;0;0;0;0
FR;5;2021-03-17;0;0;0;0;0;0;0;0;0;0
FR;5;2021-03-18;0;0;0;0;0;0;0;0;0;0
FR;5;2021-03-19;0;0;0;0;0;0;0;0;0;0
FR;5;2021-03-20;0;0;0;0;0;0;0;0;0;0
FR;5;2021-03-21;0;0;0;0;0;0;0;0;0;0
FR;5;2021-03-22;0;0;0;0;0;0;0;0;0;0
FR;5;2021-03-23;0;0;0;0;0;0;0;0;0;0
FR;5;2021-03-24;0;0;0;0;0;0;0;0;0;0
FR;5;2021-03-25;0;0;0;0;0;0;0;0;0;0
FR;5;2021-03-26;0;0;0;0;0;0;0;0;0;0
FR;5;2021-03-27;0;0;0;0;0;0;0;0;0;0
FR;5;2021-03-28;0;0;0;0;0;0;0;0;0;0
FR;5;2021-03-29;0;0;0;0;0;0;0;0;0;0
FR;5;2021-03-30;0;0;0;0;0;0;0;0;0;0
FR;5;2021-03-31;0;0;0;0;0;0;0;0;0;0
FR;5;2021-04-01;0;0;0;0;0;0;0;0;0;0
FR;5;2021-04-02;0;0;0;0;0;0;0;0;0;0
FR;5;2021-04-03;0;0;0;0;0;0;0;0;0;0
FR;5;2021-04-04;0;0;0;0;0;0;0;0;0;0
FR;5;2021-04-05;0;0;0;0;0;0;0;0;0;0
FR;5;2021-04-06;0;0;0;0;0;0;0;0;0;0
FR;5;2021-04-07;0;0;0;0;0;0;0;0;0;0
FR;5;2021-04-08;0;0;0;0;0;0;0;0;0;0
FR;5;2021-04-09;0;0;0;0;0;0;0;0;0;0
FR;5;2021-04-10;0;0;0;0;0;0;0;0;0;0
FR;5;2021-04-11;0;0;0;0;0;0;0;0;0;0
FR;5;2021-04-12;0;0;0;0;0;0;0;0;0;0
FR;5;2021-04-13;0;0;0;0;0;0;0;0;0;0
FR;5;2021-04-14;0;0;0;0;0;0;0;0;0;0
FR;5;2021-04-15;0;0;0;0;0;0;0;0;0;0
FR;5;2021-04-16;0;0;0;0;0;0;0;0;0;0
FR;5;2021-04-17;0;0;0;0;0;0;0;0;0;0
FR;5;2021-04-18;0;0;0;0;0;0;0;0;0;0
FR;5;2021-04-19;0;0;0;0;0;0;0;0;0;0
FR;5;2021-04-20;0;0;0;0;0;0;0;0;0;0
FR;5;2021-04-21;0;0;0;0;0;0;0;0;0;0
FR;5;2021-04-22;0;0;0;0;0;0;0;0;0;0
FR;5;2021-04-23;0;0;0;0;0;0;0;0;0;0
FR;5;2021-04-24;0;0;0;0;0;0;0;0;0;0
FR;5;2021-04-25;0;0;0;0;0;0;0;0;0;0
FR;5;2021-04-26;0;0;0;0;0;0;0;0;0;0
FR;5;2021-04-27;0;0;0;0;0;0;0;0;0;0
FR;5;2021-04-28;0;0;0;0;0;0;0;0;0;0
FR;5;2021-04-29;0;0;0;0;0;0;0;0;0;0
FR;5;2021-04-30;0;0;0;0;0;0;0;0;0;0
FR;5;2021-05-01;0;0;0;0;0;0;0;0;0;0
FR;5;2021-05-02;0;0;0;0;0;0;0;0;0;0
FR;5;2021-05-03;0;0;0;0;0;0;0;0;0;0
FR;5;2021-05-04;0;0;0;0;0;0;0;0;0;0
FR;5;2021-05-05;0;0;0;0;0;0;0;0;0;0
FR;5;2021-05-06;0;0;0;0;0;0;0;0;0;0
FR;5;2021-05-07;0;0;0;0;0;0;0;0;0;0
FR;5;2021-05-08;0;0;0;0;0;0;0;0;0;0
FR;5;2021-05-09;0;0;0;0;0;0;0;0;0;0
FR;5;2021-05-10;0;0;0;0;0;0;0;0;0;0
FR;5;2021-05-11;0;0;0;0;0;0;0;0;0;0
FR;5;2021-05-12;0;0;0;0;0;0;0;0;0;0
FR;5;2021-05-13;0;0;0;0;0;0;0;0;0;0
FR;5;2021-05-14;0;0;0;0;0;0;0;0;0;0
FR;5;2021-05-15;0;0;0;0;0;0;0;0;0;0
FR;5;2021-05-16;0;0;0;0;0;0;0;0;0;0
FR;5;2021-05-17;0;0;0;0;0;0;0;0;0;0
FR;5;2021-05-18;0;0;0;0;0;0;0;0;0;0
FR;5;2021-05-19;0;0;0;0;0;0;0;0;0;0
FR;5;2021-05-20;0;0;0;0;0;0;0;0;0;0
FR;5;2021-05-21;0;0;0;0;0;0;0;0;0;0
FR;5;2021-05-22;0;0;0;0;0;0;0;0;0;0
FR;5;2021-05-23;0;0;0;0;0;0;0;0;0;0
FR;5;2021-05-24;0;0;0;0;0;0;0;0;0;0
FR;5;2021-05-25;0;0;0;0;0;0;0;0;0;0
FR;5;2021-05-26;0;0;0;0;0;0;0;0;0;0
FR;5;2021-05-27;0;0;0;0;0;0;0;0;0;0
FR;5;2021-05-28;0;0;0;0;0;0;0;0;0;0
FR;5;2021-05-29;0;0;0;0;0;0;0;0;0;0
FR;5;2021-05-30;0;0;0;0;0;0;0;0;0;0
FR;5;2021-05-31;0;0;0;0;0;0;0;0;0;0
FR;5;2021-06-01;0;0;0;0;0;0;0;0;0;0
FR;5;2021-06-02;0;0;0;0;0;0;0;0;0;0
FR;5;2021-06-03;0;0;0;0;0;0;0;0;0;0
FR;5;2021-06-04;0;0;0;0;0;0;0;0;0;0
FR;5;2021-06-05;0;0;0;0;0;0;0;0;0;0
FR;5;2021-06-06;0;0;0;0;0;0;0;0;0;0
FR;5;2021-06-07;0;0;0;0;0;0;0;0;0;0
FR;5;2021-06-08;0;0;0;0;0;0;0;0;0;0
FR;5;2021-06-09;0;0;0;0;0;0;0;0;0;0
FR;5;2021-06-10;0;0;0;0;0;0;0;0;0;0
FR;5;2021-06-11;0;0;0;0;0;0;0;0;0;0
FR;5;2021-06-12;0;0;0;0;0;0;0;0;0;0
FR;5;2021-06-13;0;0;0;0;0;0;0;0;0;0
FR;5;2021-06-14;0;0;0;0;0;0;0;0;0;0
FR;5;2021-06-15;0;0;0;0;0;0;0;0;0;0
FR;5;2021-06-16;0;0;0;0;0;0;0;0;0;0
FR;5;2021-06-17;0;0;0;0;0;0;0;0;0;0
FR;5;2021-06-18;0;0;0;0;0;0;0;0;0;0
FR;5;2021-06-19;0;0;0;0;0;0;0;0;0;0
FR;5;2021-06-20;0;0;0;0;0;0;0;0;0;0
FR;5;2021-06-21;0;0;0;0;0;0;0;0;0;0
FR;5;2021-06-22;0;0;0;0;0;0;0;0;0;0
FR;5;2021-06-23;0;0;0;0;0;0;0;0;0;0
FR;5;2021-06-24;0;0;0;0;0;0;0;0;0;0
FR;5;2021-06-25;0;0;0;0;0;0;0;0;0;0
FR;5;2021-06-26;0;0;0;0;0;0;0;0;0;0
FR;5;2021-06-27;0;0;0;0;0;0;0;0;0;0
FR;5;2021-06-28;0;0;0;0;0;0;0;0;0;0
FR;5;2021-06-29;0;0;0;0;0;0;0;0;0;0
FR;5;2021-06-30;0;0;0;0;0;0;0;0;0;0
FR;5;2021-07-01;0;0;0;0;0;0;0;0;0;0
FR;5;2021-07-02;0;0;0;0;0;0;0;0;0;0
FR;5;2021-07-03;0;0;0;0;0;0;0;0;0;0
FR;5;2021-07-04;0;0;0;0;0;0;0;0;0;0
FR;5;2021-07-05;0;0;0;0;0;0;0;0;0;0
FR;5;2021-07-06;0;0;0;0;0;0;0;0;0;0
FR;5;2021-07-07;0;0;0;0;0;0;0;0;0;0
FR;5;2021-07-08;0;0;0;0;0;0;0;0;0;0
FR;5;2021-07-09;0;0;0;0;0;0;0;0;0;0
FR;5;2021-07-10;0;0;0;0;0;0;0;0;0;0
FR;5;2021-07-11;0;0;0;0;0;0;0;0;0;0
FR;5;2021-07-12;0;0;0;0;0;0;0;0;0;0
FR;5;2021-07-13;0;0;0;0;0;0;0;0;0;0
FR;5;2021-07-14;0;0;0;0;0;0;0;0;0;0
FR;5;2021-07-15;0;0;0;0;0;0;0;0;0;0
FR;5;2021-07-16;0;0;0;0;0;0;0;0;0;0
FR;5;2021-07-17;0;0;0;0;0;0;0;0;0;0
FR;5;2021-07-18;0;0;0;0;0;0;0;0;0;0
FR;5;2021-07-19;0;0;0;0;0;0;0;0;0;0
FR;5;2021-07-20;0;0;0;0;0;0;0;0;0;0
FR;5;2021-07-21;0;0;0;0;0;0;0;0;0;0
FR;5;2021-07-22;0;0;0;0;0;0;0;0;0;0
FR;5;2021-07-23;0;0;0;0;0;0;0;0;0;0
FR;5;2021-07-24;0;0;0;0;0;0;0;0;0;0
FR;5;2021-07-25;0;0;0;0;0;0;0;0;0;0
FR;5;2021-07-26;0;0;0;0;0;0;0;0;0;0
FR;5;2021-07-27;0;0;0;0;0;0;0;0;0;0
FR;5;2021-07-28;0;0;0;0;0;0;0;0;0;0
FR;5;2021-07-29;0;0;0;0;0;0;0;0;0;0
FR;5;2021-07-30;0;0;0;0;0;0;0;0;0;0
FR;5;2021-07-31;0;0;0;0;0;0;0;0;0;0
FR;5;2021-08-01;0;0;0;0;0;0;0;0;0;0
FR;5;2021-08-02;0;0;0;0;0;0;0;0;0;0
FR;5;2021-08-03;0;0;0;0;0;0;0;0;0;0
FR;5;2021-08-04;0;0;0;0;0;0;0;0;0;0
FR;5;2021-08-05;0;0;0;0;0;0;0;0;0;0
FR;5;2021-08-06;0;0;0;0;0;0;0;0;0;0
FR;5;2021-08-07;0;0;0;0;0;0;0;0;0;0
FR;5;2021-08-08;0;0;0;0;0;0;0;0;0;0
FR;5;2021-08-09;0;0;0;0;0;0;0;0;0;0
FR;5;2021-08-10;0;0;0;0;0;0;0;0;0;0
FR;5;2021-08-11;0;0;0;0;0;0;0;0;0;0
FR;5;2021-08-12;0;0;0;0;0;0;0;0;0;0
FR;5;2021-08-13;0;0;0;0;0;0;0;0;0;0
FR;5;2021-08-14;0;0;0;0;0;0;0;0;0;0
FR;5;2021-08-15;0;0;0;0;0;0;0;0;0;0
FR;5;2021-08-16;0;0;0;0;0;0;0;0;0;0
FR;5;2021-08-17;0;0;0;0;0;0;0;0;0;0
FR;5;2021-08-18;0;0;0;0;0;0;0;0;0;0
FR;5;2021-08-19;0;0;0;0;0;0;0;0;0;0
FR;5;2021-08-20;0;0;0;0;0;0;0;0;0;0
FR;5;2021-08-21;0;0;0;0;0;0;0;0;0;0
FR;5;2021-08-22;0;0;0;0;0;0;0;0;0;0
FR;5;2021-08-23;0;0;0;0;0;0;0;0;0;0
FR;5;2021-08-24;0;0;0;0;0;0;0;0;0;0
FR;5;2021-08-25;0;0;0;0;0;0;0;0;0;0
FR;5;2021-08-26;0;0;0;0;0;0;0;0;0;0
FR;5;2021-08-27;0;0;0;0;0;0;0;0;0;0
FR;5;2021-08-28;0;0;0;0;0;0;0;0;0;0
FR;5;2021-08-29;0;0;0;0;0;0;0;0;0;0
FR;5;2021-08-30;0;0;0;0;0;0;0;0;0;0
FR;5;2021-08-31;0;0;0;0;0;0;0;0;0;0
FR;5;2021-09-01;0;0;0;0;0;0;0;0;0;0
FR;5;2021-09-02;0;0;0;0;0;0;0;0;0;0
FR;5;2021-09-03;0;0;0;0;0;0;0;0;0;0
FR;5;2021-09-04;0;0;0;0;0;0;0;0;0;0
FR;5;2021-09-05;0;0;0;0;0;0;0;0;0;0
FR;5;2021-09-06;0;0;0;0;0;0;0;0;0;0
FR;5;2021-09-07;0;0;0;0;0;0;0;0;0;0
FR;5;2021-09-08;0;0;0;0;0;0;0;0;0;0
FR;5;2021-09-09;0;0;0;0;0;0;0;0;0;0
FR;5;2021-09-10;0;0;0;0;0;0;0;0;0;0
FR;5;2021-09-11;0;0;0;0;0;0;0;0;0;0
FR;5;2021-09-12;0;0;0;0;0;0;0;0;0;0
FR;5;2021-09-13;0;0;0;0;0;0;0;0;0;0
FR;5;2021-09-14;0;0;0;0;0;0;0;0;0;0
FR;5;2021-09-15;0;0;0;0;0;0;0;0;0;0
FR;5;2021-09-16;0;0;0;0;0;0;0;0;0;0
FR;5;2021-09-17;0;0;0;0;0;0;0;0;0;0
FR;5;2021-09-18;0;0;0;0;0;0;0;0;0;0
FR;5;2021-09-19;0;0;0;0;0;0;0;0;0;0
FR;5;2021-09-20;0;0;0;0;0;0;0;0;0;0
FR;5;2021-09-21;0;0;0;0;0;0;0;0;0;0
FR;5;2021-09-22;0;0;0;0;0;0;0;0;0;0
FR;5;2021-09-23;0;0;0;0;0;0;0;0;0;0
FR;5;2021-09-24;0;0;0;0;0;0;0;0;0;0
FR;5;2021-09-25;0;0;0;0;0;0;0;0;0;0
FR;5;2021-09-26;0;0;0;0;0;0;0;0;0;0
FR;5;2021-09-27;0;0;0;0;0;0;0;0;0;0
FR;5;2021-09-28;0;0;0;0;0;0;0;0;0;0
FR;5;2021-09-29;0;0;0;0;0;0;0;0;0;0
FR;5;2021-09-30;0;0;0;0;0;0;0;0;0;0
FR;5;2021-10-01;0;0;0;0;0;0;0;0;0;0
FR;5;2021-10-02;0;0;0;0;0;0;0;0;0;0
FR;5;2021-10-03;0;0;0;0;0;0;0;0;0;0
FR;5;2021-10-04;0;0;0;0;0;0;0;0;0;0
FR;5;2021-10-05;0;0;0;0;0;0;0;0;0;0
FR;5;2021-10-06;0;0;0;0;0;0;0;0;0;0
FR;5;2021-10-07;0;0;0;0;0;0;0;0;0;0
FR;5;2021-10-08;0;0;0;0;0;0;0;0;0;0
FR;5;2021-10-09;0;0;0;0;0;0;0;0;0;0
FR;5;2021-10-10;0;0;0;0;0;0;0;0;0;0
FR;5;2021-10-11;0;0;0;0;0;0;0;0;0;0
FR;5;2021-10-12;0;0;0;0;0;0;0;0;0;0
FR;5;2021-10-13;0;0;0;0;0;0;0;0;0;0
FR;5;2021-10-14;0;0;0;0;0;0;0;0;0;0
FR;5;2021-10-15;0;0;0;0;0;0;0;0;0;0
FR;5;2021-10-16;0;0;0;0;0;0;0;0;0;0
FR;5;2021-10-17;0;0;0;0;0;0;0;0;0;0
FR;5;2021-10-18;0;0;0;0;0;0;0;0;0;0
FR;5;2021-10-19;0;0;0;0;0;0;0;0;0;0
FR;5;2021-10-20;0;0;0;0;0;0;0;0;0;0
FR;5;2021-10-21;0;0;0;0;0;0;0;0;0;0
FR;5;2021-10-22;0;0;0;0;0;0;0;0;0;0
FR;5;2021-10-23;0;0;0;0;0;0;0;0;0;0
FR;5;2021-10-24;0;0;0;0;0;0;0;0;0;0
FR;5;2021-10-25;0;0;0;0;0;0;0;0;0;0
FR;5;2021-10-26;0;0;0;0;0;0;0;0;0;0
FR;5;2021-10-27;0;0;0;0;0;0;0;0;0;0
FR;5;2021-10-28;0;0;0;0;0;0;0;0;0;0
FR;5;2021-10-29;0;0;0;0;0;0;0;0;0;0
FR;5;2021-10-30;0;0;0;0;0;0;0;0;0;0
FR;5;2021-10-31;0;0;0;0;0;0;0;0;0;0
FR;5;2021-11-01;0;0;0;0;0;0;0;0;0;0
FR;5;2021-11-02;0;0;0;0;0;0;0;0;0;0
FR;5;2021-11-03;0;0;0;0;0;0;0;0;0;0
FR;5;2021-11-04;0;0;0;0;0;0;0;0;0;0
FR;5;2021-11-05;0;0;0;0;0;0;0;0;0;0
FR;5;2021-11-06;0;0;0;0;0;0;0;0;0;0
FR;5;2021-11-07;0;0;0;0;0;0;0;0;0;0
FR;5;2021-11-08;0;0;0;0;0;0;0;0;0;0
FR;5;2021-11-09;0;0;0;0;0;0;0;0;0;0
FR;5;2021-11-10;0;0;0;0;0;0;0;0;0;0
FR;5;2021-11-11;0;0;0;0;0;0;0;0;0;0
FR;5;2021-11-12;0;0;0;0;0;0;0;0;0;0
FR;5;2021-11-13;0;0;0;0;0;0;0;0;0;0
FR;5;2021-11-14;0;0;0;0;0;0;0;0;0;0
FR;5;2021-11-15;0;0;0;0;0;0;0;0;0;0
FR;5;2021-11-16;0;0;0;0;0;0;0;0;0;0
FR;5;2021-11-17;0;0;0;0;0;0;0;0;0;0
FR;5;2021-11-18;0;0;0;0;0;0;0;0;0;0
FR;5;2021-11-19;0;0;0;0;0;0;0;0;0;0
FR;5;2021-11-20;0;0;0;0;0;0;0;0;0;0
FR;5;2021-11-21;0;0;0;0;0;0;0;0;0;0
FR;5;2021-11-22;0;0;0;0;0;0;0;0;0;0
FR;5;2021-11-23;0;0;0;0;0;0;0;0;0;0
FR;5;2021-11-24;0;0;0;0;0;0;0;0;0;0
FR;5;2021-11-25;0;0;0;0;0;0;0;0;0;0
FR;5;2021-11-26;0;0;0;0;0;0;0;0;0;0
FR;5;2021-11-27;0;0;0;0;0;0;0;0;0;0
FR;5;2021-11-28;0;0;0;0;0;0;0;0;0;0
FR;5;2021-11-29;0;0;0;0;0;0;0;0;0;0
FR;5;2021-11-30;0;0;0;0;0;0;0;0;0;0
FR;5;2021-12-01;0;0;0;0;0;0;0;0;0;0
FR;5;2021-12-02;0;0;0;0;0;0;0;0;0;0
FR;5;2021-12-03;0;0;0;0;0;0;0;0;0;0
FR;5;2021-12-04;0;0;0;0;0;0;0;0;0;0
FR;5;2021-12-05;0;0;0;0;0;0;0;0;0;0
FR;5;2021-12-06;0;0;0;0;0;0;0;0;0;0
FR;5;2021-12-07;0;0;0;0;0;0;0;0;0;0
FR;5;2021-12-08;0;0;0;0;0;0;0;0;0;0
FR;5;2021-12-09;0;0;0;0;0;0;0;0;0;0
FR;5;2021-12-10;0;0;0;0;0;0;0;0;0;0
FR;5;2021-12-11;0;0;0;0;0;0;0;0;0;0
FR;5;2021-12-12;0;0;0;0;0;0;0;0;0;0
FR;5;2021-12-13;0;0;0;0;0;0;0;0;0;0
FR;5;2021-12-14;29;45;77;0;88;29;45;77;0;88
FR;5;2021-12-15;196;44;37;0;49;225;89;114;0;137
FR;5;2021-12-16;181;21;44;0;48;406;110;158;0;185
FR;5;2021-12-17;311;16;72;0;74;717;126;230;0;259
FR;5;2021-12-18;765;24;22;0;29;1482;150;252;0;288
FR;5;2021-12-19;586;15;15;0;17;2068;165;267;0;305
FR;5;2021-12-20;1223;31;35;0;38;3291;196;302;0;343
FR;5;2021-12-21;1536;22;54;1;60;4827;218;356;1;403
FR;5;2021-12-22;4069;40;37;0;46;8896;258;393;1;449
FR;5;2021-12-23;3042;16;21;0;25;11938;274;414;1;474
FR;5;2021-12-24;760;19;9;0;15;12698;293;423;1;489
FR;5;2021-12-25;61;5;2;0;3;12759;298;425;1;492
FR;5;2021-12-26;623;6;3;0;4;13382;304;428;1;496
FR;5;2021-12-27;4080;25;21;0;23;17462;329;449;1;519
FR;5;2021-12-28;5204;23;41;1;43;22666;352;490;2;562
FR;5;2021-12-29;8107;34;66;2;69;30773;386;556;4;631
FR;5;2021-12-30;5173;18;33;0;39;35946;404;589;4;670
FR;5;2021-12-31;1553;8;10;0;11;37499;412;599;4;681
FR;5;2022-01-01;185;2;2;0;3;37684;414;601;4;684
FR;5;2022-01-02;1489;1;1;0;1;39173;415;602;4;685
FR;5;2022-01-03;3061;36;33;0;32;42234;451;635;4;717
FR;5;2022-01-04;3033;39;33;0;42;45267;490;668;4;759
FR;5;2022-01-05;19322;203;97;1;108;64589;693;765;5;867
FR;5;2022-01-06;3746;133;122;0;142;68335;826;887;5;1009
FR;5;2022-01-07;5007;200;48;2;56;73342;1026;935;7;1065
FR;5;2022-01-08;13658;514;45;0;52;87000;1540;980;7;1117
FR;5;2022-01-09;5754;399;15;0;20;92754;1939;995;7;1137
FR;5;2022-01-10;3455;326;25;0;29;96209;2265;1020;7;1166
FR;5;2022-01-11;3672;284;38;0;41;99881;2549;1058;7;1207
FR;5;2022-01-12;22652;3005;90;0;113;122533;5554;1148;7;1320
FR;5;2022-01-13;4036;622;30;0;32;126569;6176;1178;7;1352
FR;5;2022-01-14;4844;581;44;0;51;131413;6757;1222;7;1403
FR;5;2022-01-15;14684;1746;38;3;49;146097;8503;1260;10;1452
FR;5;2022-01-16;4727;666;3;0;5;150824;9169;1263;10;1457
FR;5;2022-01-17;2298;715;26;0;29;153122;9884;1289;10;1486
FR;5;2022-01-18;2430;870;30;0;40;155552;10754;1319;10;1526
FR;5;2022-01-19;18482;6423;74;2;142;174034;17177;1393;12;1668
FR;5;2022-01-20;1920;1067;25;0;34;175954;18244;1418;12;1702
FR;5;2022-01-21;3076;1371;47;1;59;179030;19615;1465;13;1761
FR;5;2022-01-22;10721;3454;33;1;43;189751;23069;1498;14;1804
FR;5;2022-01-23;2629;1415;5;0;9;192380;24484;1503;14;1813
FR;5;2022-01-24;1160;1340;19;0;23;193540;25824;1522;14;1836
FR;5;2022-01-25;1220;1548;19;2;29;194760;27372;1541;16;1865
FR;5;2022-01-26;10752;12027;50;1;89;205512;39399;1591;17;1954
FR;5;2022-01-27;1292;1693;10;0;17;206804;41092;1601;17;1971
FR;5;2022-01-28;1699;3347;16;0;19;208503;44439;1617;17;1990
FR;5;2022-01-29;6238;8040;68;0;96;214741;52479;1685;17;2086
FR;5;2022-01-30;1509;2950;5;0;18;216250;55429;1690;17;2104
FR;5;2022-01-31;589;1773;23;0;24;216839;57202;1713;17;2128
FR;5;2022-02-01;712;1706;10;0;15;217551;58908;1723;17;2143
FR;5;2022-02-02;6957;15655;52;0;94;224508;74563;1775;17;2237
FR;5;2022-02-03;491;1690;14;0;13;224999;76253;1789;17;2250
FR;5;2022-02-04;945;3002;19;0;31;225944;79255;1808;17;2281
FR;5;2022-02-05;3535;8917;23;0;37;229479;88172;1831;17;2318
FR;5;2022-02-06;737;2397;10;0;19;230216;90569;1841;17;2337
FR;5;2022-02-07;884;1596;22;0;24;231100;92165;1863;17;2361
FR;5;2022-02-08;722;1287;18;0;20;231822;93452;1881;17;2381
FR;5;2022-02-09;4541;12877;44;0;76;236363;106329;1925;17;2457
FR;5;2022-02-10;646;1059;14;0;15;237009;107388;1939;17;2472
FR;5;2022-02-11;793;2031;16;0;21;237802;109419;1955;17;2493
FR;5;2022-02-12;2286;6811;33;0;53;240088;116230;1988;17;2546
FR;5;2022-02-13;464;1540;8;0;8;240552;117770;1996;17;2554
FR;5;2022-02-14;678;1288;10;0;13;241230;119058;2006;17;2567
FR;5;2022-02-15;482;886;9;0;14;241712;119944;2015;17;2581
FR;5;2022-02-16;2980;9123;41;1;58;244692;129067;2056;18;2639
FR;5;2022-02-17;436;809;6;0;7;245128;129876;2062;18;2646
FR;5;2022-02-18;649;1407;13;0;17;245777;131283;2075;18;2663
FR;5;2022-02-19;1373;4315;16;0;28;247150;135598;2091;18;2691
FR;5;2022-02-20;247;879;6;0;8;247397;136477;2097;18;2699
FR;5;2022-02-21;221;607;2;0;4;247618;137084;2099;18;2703
FR;5;2022-02-22;262;545;17;0;17;247880;137629;2116;18;2720
FR;5;2022-02-23;1909;6926;22;1;42;249789;144555;2138;19;2762
FR;5;2022-02-24;182;374;6;1;7;249971;144929;2144;20;2769
FR;5;2022-02-25;336;949;13;0;12;250307;145878;2157;20;2781
FR;5;2022-02-26;972;3070;10;0;14;251279;148948;2167;20;2795
FR;5;2022-02-27;149;506;0;0;3;251428;149454;2167;20;2798
FR;5;2022-02-28;162;369;1;0;1;251590;149823;2168;20;2799
FR;5;2022-03-01;130;280;6;0;7;251720;150103;2174;20;2806
FR;5;2022-03-02;1240;4156;28;3;40;252960;154259;2202;23;2846
FR;5;2022-03-03;121;251;5;0;10;253081;154510;2207;23;2856
FR;5;2022-03-04;194;488;13;0;14;253275;154998;2220;23;2870
FR;5;2022-03-05;677;1990;8;0;16;253952;156988;2228;23;2886
FR;5;2022-03-06;108;260;0;0;0;254060;157248;2228;23;2886
FR;5;2022-03-07;71;228;5;0;3;254131;157476;2233;23;2889
FR;5;2022-03-08;46;130;7;1;7;254177;157606;2240;24;2896
FR;5;2022-03-09;909;3078;24;0;36;255086;160684;2264;24;2932
FR;5;2022-03-10;82;201;8;0;12;255168;160885;2272;24;2944
FR;5;2022-03-11;148;369;13;1;15;255316;161254;2285;25;2959
FR;5;2022-03-12;758;1613;13;1;30;256074;162867;2298;26;2989
FR;5;2022-03-13;78;100;0;0;0;256152;162967;2298;26;2989
FR;5;2022-03-14;67;119;7;1;7;256219;163086;2305;27;2996
FR;5;2022-03-15;83;99;4;0;7;256302;163185;2309;27;3003
FR;5;2022-03-16;883;1827;15;3;36;257185;165012;2324;30;3039
FR;5;2022-03-17;66;123;8;4;10;257251;165135;2332;34;3049
FR;5;2022-03-18;172;318;13;4;18;257423;165453;2345;38;3067
FR;5;2022-03-19;751;1163;12;5;33;258174;166616;2357;43;3100
FR;5;2022-03-20;45;93;1;0;1;258219;166709;2358;43;3101
FR;5;2022-03-21;71;120;10;6;15;258290;166829;2368;49;3116
FR;5;2022-03-22;56;119;8;8;9;258346;166948;2376;57;3125
FR;5;2022-03-23;804;1461;14;8;36;259150;168409;2390;65;3161
FR;5;2022-03-24;70;93;8;7;7;259220;168502;2398;72;3168
FR;5;2022-03-25;222;291;14;8;18;259442;168793;2412;80;3186
FR;5;2022-03-26;707;853;12;5;26;260149;169646;2424;85;3212
FR;5;2022-03-27;75;80;0;0;3;260224;169726;2424;85;3215
FR;5;2022-03-28;81;91;1;2;3;260305;169817;2425;87;3218
FR;5;2022-03-29;71;82;10;4;12;260376;169899;2435;91;3230
FR;5;2022-03-30;823;1116;16;13;29;261199;171015;2451;104;3259
FR;5;2022-03-31;102;125;1;4;6;261301;171140;2452;108;3265
FR;5;2022-04-01;110;86;7;12;11;261411;171226;2459;120;3276
FR;5;2022-04-02;330;349;3;3;15;261741;171575;2462;123;3291
FR;5;2022-04-03;54;59;1;0;1;261795;171634;2463;123;3292
FR;5;2022-04-04;40;57;4;1;8;261835;171691;2467;124;3300
FR;5;2022-04-05;52;60;6;7;9;261887;171751;2473;131;3309
FR;5;2022-04-06;421;439;7;15;16;262308;172190;2480;146;3325
FR;5;2022-04-07;45;68;5;7;7;262353;172258;2485;153;3332
FR;5;2022-04-08;133;112;12;14;15;262486;172370;2497;167;3347
FR;5;2022-04-09;311;323;2;5;17;262797;172693;2499;172;3364
FR;5;2022-04-10;43;31;2;0;2;262840;172724;2501;172;3366
FR;5;2022-04-11;50;60;3;2;4;262890;172784;2504;174;3370
FR;5;2022-04-12;59;54;3;3;5;262949;172838;2507;177;3375
FR;5;2022-04-13;382;413;3;8;16;263331;173251;2510;185;3391
FR;5;2022-04-14;48;48;5;5;9;263379;173299;2515;190;3400
FR;5;2022-04-15;91;109;4;5;5;263470;173408;2519;195;3405
FR;5;2022-04-16;188;184;2;1;13;263658;173592;2521;196;3418
FR;5;2022-04-17;12;11;1;0;1;263670;173603;2522;196;3419
FR;5;2022-04-18;8;10;2;0;3;263678;173613;2524;196;3422
FR;5;2022-04-19;74;71;6;1;6;263752;173684;2530;197;3428
FR;5;2022-04-20;361;349;9;6;12;264113;174033;2539;203;3440
FR;5;2022-04-21;42;64;9;10;12;264155;174097;2548;213;3452
FR;5;2022-04-22;113;96;5;4;5;264268;174193;2553;217;3457
FR;5;2022-04-23;209;193;3;2;10;264477;174386;2556;219;3467
FR;5;2022-04-24;37;35;0;0;3;264514;174421;2556;219;3470
FR;5;2022-04-25;69;65;1;1;4;264583;174486;2557;220;3474
FR;5;2022-04-26;60;62;2;1;5;264643;174548;2559;221;3479
FR;5;2022-04-27;335;316;2;7;14;264978;174864;2561;228;3493
FR;5;2022-04-28;80;54;4;5;8;265058;174918;2565;233;3501
FR;5;2022-04-29;117;84;5;18;12;265175;175002;2570;251;3513
FR;5;2022-04-30;183;114;2;3;10;265358;175116;2572;254;3523
FR;5;2022-05-01;11;7;0;0;0;265369;175123;2572;254;3523
FR;5;2022-05-02;51;29;4;5;2;265420;175152;2576;259;3525
FR;5;2022-05-03;84;57;2;5;11;265504;175209;2578;264;3536
FR;5;2022-05-04;278;205;1;2;7;265782;175414;2579;266;3543
FR;5;2022-05-05;62;32;3;4;5;265844;175446;2582;270;3548
FR;5;2022-05-06;105;64;2;3;5;265949;175510;2584;273;3553
FR;5;2022-05-07;171;117;3;10;13;266120;175627;2587;283;3566
FR;5;2022-05-08;8;8;0;0;2;266128;175635;2587;283;3568
FR;5;2022-05-09;44;34;15;3;16;266172;175669;2602;286;3584
FR;5;2022-05-10;54;49;3;4;5;266226;175718;2605;290;3589
FR;5;2022-05-11;327;237;12;7;21;266553;175955;2617;297;3610
FR;5;2022-05-12;46;34;1;3;2;266599;175989;2618;300;3612
FR;5;2022-05-13;109;83;3;8;9;266708;176072;2621;308;3621
FR;5;2022-05-14;209;131;0;1;8;266917;176203;2621;309;3629
FR;5;2022-05-15;22;9;2;0;1;266939;176212;2623;309;3630
FR;5;2022-05-16;52;34;4;5;4;266991;176246;2627;314;3634
FR;5;2022-05-17;72;40;5;0;2;267063;176286;2632;314;3636
FR;5;2022-05-18;289;214;4;4;8;267352;176500;2636;318;3644
FR;5;2022-05-19;44;35;5;3;3;267396;176535;2641;321;3647
FR;5;2022-05-20;76;63;3;10;1;267472;176598;2644;331;3648
FR;5;2022-05-21;242;166;2;3;17;267714;176764;2646;334;3665
FR;5;2022-05-22;20;14;2;5;2;267734;176778;2648;339;3667
FR;5;2022-05-23;42;30;4;3;6;267776;176808;2652;342;3673
FR;5;2022-05-24;47;45;3;2;5;267823;176853;2655;344;3678
FR;5;2022-05-25;329;256;4;1;16;268152;177109;2659;345;3694
FR;5;2022-05-26;17;5;0;1;2;268169;177114;2659;346;3696
FR;5;2022-05-27;99;54;4;4;9;268268;177168;2663;350;3705
FR;5;2022-05-28;99;78;5;3;10;268367;177246;2668;353;3715
FR;5;2022-05-29;14;14;1;0;2;268381;177260;2669;353;3717
FR;5;2022-05-30;56;41;2;1;2;268437;177301;2671;354;3719
FR;5;2022-05-31;57;43;1;8;1;268494;177344;2672;362;3720
FR;5;2022-06-01;256;241;9;2;25;268750;177585;2681;364;3745
FR;5;2022-06-02;62;61;5;0;9;268812;177646;2686;364;3754
FR;5;2022-06-03;81;71;4;5;10;268893;177717;2690;369;3764
FR;5;2022-06-04;156;109;2;1;9;269049;177826;2692;370;3773
FR;5;2022-06-05;17;11;0;0;1;269066;177837;2692;370;3774
FR;5;2022-06-06;15;9;0;0;0;269081;177846;2692;370;3774
FR;5;2022-06-07;49;56;1;1;2;269130;177902;2693;371;3776
FR;5;2022-06-08;282;224;3;4;17;269412;178126;2696;375;3793
FR;5;2022-06-09;52;41;6;3;7;269464;178167;2702;378;3800
FR;5;2022-06-10;80;72;1;1;6;269544;178239;2703;379;3806
FR;5;2022-06-11;169;141;3;3;10;269713;178380;2706;382;3816
FR;5;2022-06-12;17;16;0;0;2;269730;178396;2706;382;3818
FR;5;2022-06-13;56;46;9;3;9;269786;178442;2715;385;3827
FR;5;2022-06-14;59;56;1;3;6;269845;178498;2716;388;3833
FR;5;2022-06-15;265;260;5;2;27;270110;178758;2721;390;3860
FR;5;2022-06-16;46;29;4;2;4;270156;178787;2725;392;3864
FR;5;2022-06-17;98;66;5;5;10;270254;178853;2730;397;3874
FR;5;2022-06-18;141;95;10;2;26;270395;178948;2740;399;3900
FR;5;2022-06-19;26;15;0;1;4;270421;178963;2740;400;3904
FR;5;2022-06-20;55;49;8;0;11;270476;179012;2748;400;3915
FR;5;2022-06-21;48;73;5;3;7;270524;179085;2753;403;3922
FR;5;2022-06-22;221;246;7;8;33;270745;179331;2760;411;3955
FR;5;2022-06-23;50;36;2;5;6;270795;179367;2762;416;3961
FR;5;2022-06-24;88;70;14;5;16;270883;179437;2776;421;3977
FR;5;2022-06-25;154;124;3;7;14;271037;179561;2779;428;3991
FR;5;2022-06-26;26;19;2;0;5;271063;179580;2781;428;3996
FR;5;2022-06-27;57;60;5;7;11;271120;179640;2786;435;4007
FR;5;2022-06-28;70;49;8;2;14;271190;179689;2794;437;4021
FR;5;2022-06-29;296;267;9;20;34;271486;179956;2803;457;4055
FR;5;2022-06-30;85;56;9;12;16;271571;180012;2812;469;4071
FR;5;2022-07-01;120;63;7;11;10;271691;180075;2819;480;4081
FR;5;2022-07-02;189;126;4;0;22;271880;180201;2823;480;4103
FR;5;2022-07-03;31;22;1;0;4;271911;180223;2824;480;4107
FR;5;2022-07-04;100;63;2;5;6;272011;180286;2826;485;4113
FR;5;2022-07-05;103;72;3;8;13;272114;180358;2829;493;4126
FR;5;2022-07-06;276;168;9;36;27;272390;180526;2838;529;4153
FR;5;2022-07-07;86;68;6;9;13;272476;180594;2844;538;4166
FR;5;2022-07-08;150;118;7;14;25;272626;180712;2851;552;4191
FR;5;2022-07-09;115;67;1;8;10;272741;180779;2852;560;4201
FR;5;2022-07-10;15;6;0;0;1;272756;180785;2852;560;4202
FR;5;2022-07-11;91;70;10;2;19;272847;180855;2862;562;4221
FR;5;2022-07-12;65;60;4;9;7;272912;180915;2866;571;4228
FR;5;2022-07-13;161;116;8;19;15;273073;181031;2874;590;4243
FR;5;2022-07-14;8;4;0;0;0;273081;181035;2874;590;4243
FR;5;2022-07-15;73;65;5;12;15;273154;181100;2879;602;4258
FR;5;2022-07-16;54;41;3;0;3;273208;181141;2882;602;4261
FR;5;2022-07-17;10;7;0;0;1;273218;181148;2882;602;4262
FR;5;2022-07-18;59;44;0;5;3;273277;181192;2882;607;4265
FR;6;2020-12-27;0;0;0;0;0;0;0;0;0;0
FR;6;2020-12-28;0;0;0;0;0;0;0;0;0;0
FR;6;2020-12-29;0;0;0;0;0;0;0;0;0;0
FR;6;2020-12-30;0;0;0;0;0;0;0;0;0;0
FR;6;2020-12-31;0;0;0;0;0;0;0;0;0;0
FR;6;2021-01-01;0;0;0;0;0;0;0;0;0;0
FR;6;2021-01-02;0;0;0;0;0;0;0;0;0;0
FR;6;2021-01-03;0;0;0;0;0;0;0;0;0;0
FR;6;2021-01-04;0;0;0;0;0;0;0;0;0;0
FR;6;2021-01-05;0;0;0;0;0;0;0;0;0;0
FR;6;2021-01-06;0;0;0;0;0;0;0;0;0;0
FR;6;2021-01-07;0;0;0;0;0;0;0;0;0;0
FR;6;2021-01-08;0;0;0;0;0;0;0;0;0;0
FR;6;2021-01-09;0;0;0;0;0;0;0;0;0;0
FR;6;2021-01-10;0;0;0;0;0;0;0;0;0;0
FR;6;2021-01-11;0;0;0;0;0;0;0;0;0;0
FR;6;2021-01-12;0;0;0;0;0;0;0;0;0;0
FR;6;2021-01-13;0;0;0;0;0;0;0;0;0;0
FR;6;2021-01-14;0;0;0;0;0;0;0;0;0;0
FR;6;2021-01-15;0;0;0;0;0;0;0;0;0;0
FR;6;2021-01-16;0;0;0;0;0;0;0;0;0;0
FR;6;2021-01-17;0;0;0;0;0;0;0;0;0;0
FR;6;2021-01-18;0;0;0;0;0;0;0;0;0;0
FR;6;2021-01-19;0;0;0;0;0;0;0;0;0;0
FR;6;2021-01-20;0;0;0;0;0;0;0;0;0;0
FR;6;2021-01-21;0;0;0;0;0;0;0;0;0;0
FR;6;2021-01-22;0;0;0;0;0;0;0;0;0;0
FR;6;2021-01-23;0;0;0;0;0;0;0;0;0;0
FR;6;2021-01-24;0;0;0;0;0;0;0;0;0;0
FR;6;2021-01-25;0;0;0;0;0;0;0;0;0;0
FR;6;2021-01-26;0;0;0;0;0;0;0;0;0;0
FR;6;2021-01-27;0;0;0;0;0;0;0;0;0;0
FR;6;2021-01-28;0;0;0;0;0;0;0;0;0;0
FR;6;2021-01-29;0;0;0;0;0;0;0;0;0;0
FR;6;2021-01-30;0;0;0;0;0;0;0;0;0;0
FR;6;2021-01-31;0;0;0;0;0;0;0;0;0;0
FR;6;2021-02-01;0;0;0;0;0;0;0;0;0;0
FR;6;2021-02-02;0;0;0;0;0;0;0;0;0;0
FR;6;2021-02-03;0;0;0;0;0;0;0;0;0;0
FR;6;2021-02-04;0;0;0;0;0;0;0;0;0;0
FR;6;2021-02-05;0;0;0;0;0;0;0;0;0;0
FR;6;2021-02-06;0;0;0;0;0;0;0;0;0;0
FR;6;2021-02-07;0;0;0;0;0;0;0;0;0;0
FR;6;2021-02-08;0;0;0;0;0;0;0;0;0;0
FR;6;2021-02-09;0;0;0;0;0;0;0;0;0;0
FR;6;2021-02-10;0;0;0;0;0;0;0;0;0;0
FR;6;2021-02-11;0;0;0;0;0;0;0;0;0;0
FR;6;2021-02-12;0;0;0;0;0;0;0;0;0;0
FR;6;2021-02-13;0;0;0;0;0;0;0;0;0;0
FR;6;2021-02-14;0;0;0;0;0;0;0;0;0;0
FR;6;2021-02-15;0;0;0;0;0;0;0;0;0;0
FR;6;2021-02-16;0;0;0;0;0;0;0;0;0;0
FR;6;2021-02-17;0;0;0;0;0;0;0;0;0;0
FR;6;2021-02-18;0;0;0;0;0;0;0;0;0;0
FR;6;2021-02-19;0;0;0;0;0;0;0;0;0;0
FR;6;2021-02-20;0;0;0;0;0;0;0;0;0;0
FR;6;2021-02-21;0;0;0;0;0;0;0;0;0;0
FR;6;2021-02-22;0;0;0;0;0;0;0;0;0;0
FR;6;2021-02-23;0;0;0;0;0;0;0;0;0;0
FR;6;2021-02-24;0;0;0;0;0;0;0;0;0;0
FR;6;2021-02-25;0;0;0;0;0;0;0;0;0;0
FR;6;2021-02-26;0;0;0;0;0;0;0;0;0;0
FR;6;2021-02-27;0;0;0;0;0;0;0;0;0;0
FR;6;2021-02-28;0;0;0;0;0;0;0;0;0;0
FR;6;2021-03-01;0;0;0;0;0;0;0;0;0;0
FR;6;2021-03-02;0;0;0;0;0;0;0;0;0;0
FR;6;2021-03-03;0;0;0;0;0;0;0;0;0;0
FR;6;2021-03-04;0;0;0;0;0;0;0;0;0;0
FR;6;2021-03-05;0;0;0;0;0;0;0;0;0;0
FR;6;2021-03-06;0;0;0;0;0;0;0;0;0;0
FR;6;2021-03-07;0;0;0;0;0;0;0;0;0;0
FR;6;2021-03-08;0;0;0;0;0;0;0;0;0;0
FR;6;2021-03-09;0;0;0;0;0;0;0;0;0;0
FR;6;2021-03-10;0;0;0;0;0;0;0;0;0;0
FR;6;2021-03-11;0;0;0;0;0;0;0;0;0;0
FR;6;2021-03-12;0;0;0;0;0;0;0;0;0;0
FR;6;2021-03-13;0;0;0;0;0;0;0;0;0;0
FR;6;2021-03-14;0;0;0;0;0;0;0;0;0;0
FR;6;2021-03-15;0;0;0;0;0;0;0;0;0;0
FR;6;2021-03-16;0;0;0;0;0;0;0;0;0;0
FR;6;2021-03-17;0;0;0;0;0;0;0;0;0;0
FR;6;2021-03-18;0;0;0;0;0;0;0;0;0;0
FR;6;2021-03-19;0;0;0;0;0;0;0;0;0;0
FR;6;2021-03-20;0;0;0;0;0;0;0;0;0;0
FR;6;2021-03-21;0;0;0;0;0;0;0;0;0;0
FR;6;2021-03-22;0;0;0;0;0;0;0;0;0;0
FR;6;2021-03-23;0;0;0;0;0;0;0;0;0;0
FR;6;2021-03-24;0;0;0;0;0;0;0;0;0;0
FR;6;2021-03-25;0;0;0;0;0;0;0;0;0;0
FR;6;2021-03-26;0;0;0;0;0;0;0;0;0;0
FR;6;2021-03-27;0;0;0;0;0;0;0;0;0;0
FR;6;2021-03-28;0;0;0;0;0;0;0;0;0;0
FR;6;2021-03-29;0;0;0;0;0;0;0;0;0;0
FR;6;2021-03-30;0;0;0;0;0;0;0;0;0;0
FR;6;2021-03-31;0;0;0;0;0;0;0;0;0;0
FR;6;2021-04-01;0;0;0;0;0;0;0;0;0;0
FR;6;2021-04-02;0;0;0;0;0;0;0;0;0;0
FR;6;2021-04-03;0;0;0;0;0;0;0;0;0;0
FR;6;2021-04-04;0;0;0;0;0;0;0;0;0;0
FR;6;2021-04-05;0;0;0;0;0;0;0;0;0;0
FR;6;2021-04-06;0;0;0;0;0;0;0;0;0;0
FR;6;2021-04-07;0;0;0;0;0;0;0;0;0;0
FR;6;2021-04-08;0;0;0;0;0;0;0;0;0;0
FR;6;2021-04-09;0;0;0;0;0;0;0;0;0;0
FR;6;2021-04-10;0;0;0;0;0;0;0;0;0;0
FR;6;2021-04-11;0;0;0;0;0;0;0;0;0;0
FR;6;2021-04-12;0;0;0;0;0;0;0;0;0;0
FR;6;2021-04-13;0;0;0;0;0;0;0;0;0;0
FR;6;2021-04-14;0;0;0;0;0;0;0;0;0;0
FR;6;2021-04-15;0;0;0;0;0;0;0;0;0;0
FR;6;2021-04-16;0;0;0;0;0;0;0;0;0;0
FR;6;2021-04-17;0;0;0;0;0;0;0;0;0;0
FR;6;2021-04-18;0;0;0;0;0;0;0;0;0;0
FR;6;2021-04-19;0;0;0;0;0;0;0;0;0;0
FR;6;2021-04-20;0;0;0;0;0;0;0;0;0;0
FR;6;2021-04-21;0;0;0;0;0;0;0;0;0;0
FR;6;2021-04-22;0;0;0;0;0;0;0;0;0;0
FR;6;2021-04-23;0;0;0;0;0;0;0;0;0;0
FR;6;2021-04-24;0;0;0;0;0;0;0;0;0;0
FR;6;2021-04-25;0;0;0;0;0;0;0;0;0;0
FR;6;2021-04-26;0;0;0;0;0;0;0;0;0;0
FR;6;2021-04-27;0;0;0;0;0;0;0;0;0;0
FR;6;2021-04-28;0;0;0;0;0;0;0;0;0;0
FR;6;2021-04-29;0;0;0;0;0;0;0;0;0;0
FR;6;2021-04-30;0;0;0;0;0;0;0;0;0;0
FR;6;2021-05-01;0;0;0;0;0;0;0;0;0;0
FR;6;2021-05-02;0;0;0;0;0;0;0;0;0;0
FR;6;2021-05-03;0;0;0;0;0;0;0;0;0;0
FR;6;2021-05-04;0;0;0;0;0;0;0;0;0;0
FR;6;2021-05-05;0;0;0;0;0;0;0;0;0;0
FR;6;2021-05-06;0;0;0;0;0;0;0;0;0;0
FR;6;2021-05-07;0;0;0;0;0;0;0;0;0;0
FR;6;2021-05-08;0;0;0;0;0;0;0;0;0;0
FR;6;2021-05-09;0;0;0;0;0;0;0;0;0;0
FR;6;2021-05-10;0;0;0;0;0;0;0;0;0;0
FR;6;2021-05-11;0;0;0;0;0;0;0;0;0;0
FR;6;2021-05-12;0;0;0;0;0;0;0;0;0;0
FR;6;2021-05-13;0;0;0;0;0;0;0;0;0;0
FR;6;2021-05-14;0;0;0;0;0;0;0;0;0;0
FR;6;2021-05-15;0;0;0;0;0;0;0;0;0;0
FR;6;2021-05-16;0;0;0;0;0;0;0;0;0;0
FR;6;2021-05-17;0;0;0;0;0;0;0;0;0;0
FR;6;2021-05-18;0;0;0;0;0;0;0;0;0;0
FR;6;2021-05-19;0;0;0;0;0;0;0;0;0;0
FR;6;2021-05-20;0;0;0;0;0;0;0;0;0;0
FR;6;2021-05-21;0;0;0;0;0;0;0;0;0;0
FR;6;2021-05-22;0;0;0;0;0;0;0;0;0;0
FR;6;2021-05-23;0;0;0;0;0;0;0;0;0;0
FR;6;2021-05-24;0;0;0;0;0;0;0;0;0;0
FR;6;2021-05-25;0;0;0;0;0;0;0;0;0;0
FR;6;2021-05-26;0;0;0;0;0;0;0;0;0;0
FR;6;2021-05-27;0;0;0;0;0;0;0;0;0;0
FR;6;2021-05-28;0;0;0;0;0;0;0;0;0;0
FR;6;2021-05-29;0;0;0;0;0;0;0;0;0;0
FR;6;2021-05-30;0;0;0;0;0;0;0;0;0;0
FR;6;2021-05-31;0;0;0;0;0;0;0;0;0;0
FR;6;2021-06-01;0;0;0;0;0;0;0;0;0;0
FR;6;2021-06-02;0;0;0;0;0;0;0;0;0;0
FR;6;2021-06-03;0;0;0;0;0;0;0;0;0;0
FR;6;2021-06-04;0;0;0;0;0;0;0;0;0;0
FR;6;2021-06-05;0;0;0;0;0;0;0;0;0;0
FR;6;2021-06-06;0;0;0;0;0;0;0;0;0;0
FR;6;2021-06-07;0;0;0;0;0;0;0;0;0;0
FR;6;2021-06-08;0;0;0;0;0;0;0;0;0;0
FR;6;2021-06-09;0;0;0;0;0;0;0;0;0;0
FR;6;2021-06-10;0;0;0;0;0;0;0;0;0;0
FR;6;2021-06-11;0;0;0;0;0;0;0;0;0;0
FR;6;2021-06-12;0;0;0;0;0;0;0;0;0;0
FR;6;2021-06-13;0;0;0;0;0;0;0;0;0;0
FR;6;2021-06-14;0;0;0;0;0;0;0;0;0;0
FR;6;2021-06-15;0;0;0;0;0;0;0;0;0;0
FR;6;2021-06-16;0;0;0;0;0;0;0;0;0;0
FR;6;2021-06-17;0;0;0;0;0;0;0;0;0;0
FR;6;2021-06-18;0;0;0;0;0;0;0;0;0;0
FR;6;2021-06-19;0;0;0;0;0;0;0;0;0;0
FR;6;2021-06-20;0;0;0;0;0;0;0;0;0;0
FR;6;2021-06-21;0;0;0;0;0;0;0;0;0;0
FR;6;2021-06-22;0;0;0;0;0;0;0;0;0;0
FR;6;2021-06-23;0;0;0;0;0;0;0;0;0;0
FR;6;2021-06-24;0;0;0;0;0;0;0;0;0;0
FR;6;2021-06-25;0;0;0;0;0;0;0;0;0;0
FR;6;2021-06-26;0;0;0;0;0;0;0;0;0;0
FR;6;2021-06-27;0;0;0;0;0;0;0;0;0;0
FR;6;2021-06-28;0;0;0;0;0;0;0;0;0;0
FR;6;2021-06-29;0;0;0;0;0;0;0;0;0;0
FR;6;2021-06-30;0;0;0;0;0;0;0;0;0;0
FR;6;2021-07-01;0;0;0;0;0;0;0;0;0;0
FR;6;2021-07-02;0;0;0;0;0;0;0;0;0;0
FR;6;2021-07-03;0;0;0;0;0;0;0;0;0;0
FR;6;2021-07-04;0;0;0;0;0;0;0;0;0;0
FR;6;2021-07-05;0;0;0;0;0;0;0;0;0;0
FR;6;2021-07-06;0;0;0;0;0;0;0;0;0;0
FR;6;2021-07-07;0;0;0;0;0;0;0;0;0;0
FR;6;2021-07-08;0;0;0;0;0;0;0;0;0;0
FR;6;2021-07-09;0;0;0;0;0;0;0;0;0;0
FR;6;2021-07-10;0;0;0;0;0;0;0;0;0;0
FR;6;2021-07-11;0;0;0;0;0;0;0;0;0;0
FR;6;2021-07-12;0;0;0;0;0;0;0;0;0;0
FR;6;2021-07-13;0;0;0;0;0;0;0;0;0;0
FR;6;2021-07-14;0;0;0;0;0;0;0;0;0;0
FR;6;2021-07-15;0;0;0;0;0;0;0;0;0;0
FR;6;2021-07-16;0;0;0;0;0;0;0;0;0;0
FR;6;2021-07-17;0;0;0;0;0;0;0;0;0;0
FR;6;2021-07-18;0;0;0;0;0;0;0;0;0;0
FR;6;2021-07-19;0;0;0;0;0;0;0;0;0;0
FR;6;2021-07-20;0;0;0;0;0;0;0;0;0;0
FR;6;2021-07-21;0;0;0;0;0;0;0;0;0;0
FR;6;2021-07-22;0;0;0;0;0;0;0;0;0;0
FR;6;2021-07-23;0;0;0;0;0;0;0;0;0;0
FR;6;2021-07-24;0;0;0;0;0;0;0;0;0;0
FR;6;2021-07-25;0;0;0;0;0;0;0;0;0;0
FR;6;2021-07-26;0;0;0;0;0;0;0;0;0;0
FR;6;2021-07-27;0;0;0;0;0;0;0;0;0;0
FR;6;2021-07-28;0;0;0;0;0;0;0;0;0;0
FR;6;2021-07-29;0;0;0;0;0;0;0;0;0;0
FR;6;2021-07-30;0;0;0;0;0;0;0;0;0;0
FR;6;2021-07-31;0;0;0;0;0;0;0;0;0;0
FR;6;2021-08-01;0;0;0;0;0;0;0;0;0;0
FR;6;2021-08-02;0;0;0;0;0;0;0;0;0;0
FR;6;2021-08-03;0;0;0;0;0;0;0;0;0;0
FR;6;2021-08-04;0;0;0;0;0;0;0;0;0;0
FR;6;2021-08-05;0;0;0;0;0;0;0;0;0;0
FR;6;2021-08-06;0;0;0;0;0;0;0;0;0;0
FR;6;2021-08-07;0;0;0;0;0;0;0;0;0;0
FR;6;2021-08-08;0;0;0;0;0;0;0;0;0;0
FR;6;2021-08-09;0;0;0;0;0;0;0;0;0;0
FR;6;2021-08-10;0;0;0;0;0;0;0;0;0;0
FR;6;2021-08-11;0;0;0;0;0;0;0;0;0;0
FR;6;2021-08-12;0;0;0;0;0;0;0;0;0;0
FR;6;2021-08-13;0;0;0;0;0;0;0;0;0;0
FR;6;2021-08-14;0;0;0;0;0;0;0;0;0;0
FR;6;2021-08-15;0;0;0;0;0;0;0;0;0;0
FR;6;2021-08-16;0;0;0;0;0;0;0;0;0;0
FR;6;2021-08-17;0;0;0;0;0;0;0;0;0;0
FR;6;2021-08-18;0;0;0;0;0;0;0;0;0;0
FR;6;2021-08-19;0;0;0;0;0;0;0;0;0;0
FR;6;2021-08-20;0;0;0;0;0;0;0;0;0;0
FR;6;2021-08-21;0;0;0;0;0;0;0;0;0;0
FR;6;2021-08-22;0;0;0;0;0;0;0;0;0;0
FR;6;2021-08-23;0;0;0;0;0;0;0;0;0;0
FR;6;2021-08-24;0;0;0;0;0;0;0;0;0;0
FR;6;2021-08-25;0;0;0;0;0;0;0;0;0;0
FR;6;2021-08-26;0;0;0;0;0;0;0;0;0;0
FR;6;2021-08-27;0;0;0;0;0;0;0;0;0;0
FR;6;2021-08-28;0;0;0;0;0;0;0;0;0;0
FR;6;2021-08-29;0;0;0;0;0;0;0;0;0;0
FR;6;2021-08-30;0;0;0;0;0;0;0;0;0;0
FR;6;2021-08-31;0;0;0;0;0;0;0;0;0;0
FR;6;2021-09-01;0;0;0;0;0;0;0;0;0;0
FR;6;2021-09-02;0;0;0;0;0;0;0;0;0;0
FR;6;2021-09-03;0;0;0;0;0;0;0;0;0;0
FR;6;2021-09-04;0;0;0;0;0;0;0;0;0;0
FR;6;2021-09-05;0;0;0;0;0;0;0;0;0;0
FR;6;2021-09-06;0;0;0;0;0;0;0;0;0;0
FR;6;2021-09-07;0;0;0;0;0;0;0;0;0;0
FR;6;2021-09-08;0;0;0;0;0;0;0;0;0;0
FR;6;2021-09-09;0;0;0;0;0;0;0;0;0;0
FR;6;2021-09-10;0;0;0;0;0;0;0;0;0;0
FR;6;2021-09-11;0;0;0;0;0;0;0;0;0;0
FR;6;2021-09-12;0;0;0;0;0;0;0;0;0;0
FR;6;2021-09-13;0;0;0;0;0;0;0;0;0;0
FR;6;2021-09-14;0;0;0;0;0;0;0;0;0;0
FR;6;2021-09-15;0;0;0;0;0;0;0;0;0;0
FR;6;2021-09-16;0;0;0;0;0;0;0;0;0;0
FR;6;2021-09-17;0;0;0;0;0;0;0;0;0;0
FR;6;2021-09-18;0;0;0;0;0;0;0;0;0;0
FR;6;2021-09-19;0;0;0;0;0;0;0;0;0;0
FR;6;2021-09-20;0;0;0;0;0;0;0;0;0;0
FR;6;2021-09-21;0;0;0;0;0;0;0;0;0;0
FR;6;2021-09-22;0;0;0;0;0;0;0;0;0;0
FR;6;2021-09-23;0;0;0;0;0;0;0;0;0;0
FR;6;2021-09-24;0;0;0;0;0;0;0;0;0;0
FR;6;2021-09-25;0;0;0;0;0;0;0;0;0;0
FR;6;2021-09-26;0;0;0;0;0;0;0;0;0;0
FR;6;2021-09-27;0;0;0;0;0;0;0;0;0;0
FR;6;2021-09-28;0;0;0;0;0;0;0;0;0;0
FR;6;2021-09-29;0;0;0;0;0;0;0;0;0;0
FR;6;2021-09-30;0;0;0;0;0;0;0;0;0;0
FR;6;2021-10-01;0;0;0;0;0;0;0;0;0;0
FR;6;2021-10-02;0;0;0;0;0;0;0;0;0;0
FR;6;2021-10-03;0;0;0;0;0;0;0;0;0;0
FR;6;2021-10-04;0;0;0;0;0;0;0;0;0;0
FR;6;2021-10-05;0;0;0;0;0;0;0;0;0;0
FR;6;2021-10-06;0;0;0;0;0;0;0;0;0;0
FR;6;2021-10-07;0;0;0;0;0;0;0;0;0;0
FR;6;2021-10-08;0;0;0;0;0;0;0;0;0;0
FR;6;2021-10-09;0;0;0;0;0;0;0;0;0;0
FR;6;2021-10-10;0;0;0;0;0;0;0;0;0;0
FR;6;2021-10-11;0;0;0;0;0;0;0;0;0;0
FR;6;2021-10-12;0;0;0;0;0;0;0;0;0;0
FR;6;2021-10-13;0;0;0;0;0;0;0;0;0;0
FR;6;2021-10-14;0;0;0;0;0;0;0;0;0;0
FR;6;2021-10-15;0;0;0;0;0;0;0;0;0;0
FR;6;2021-10-16;0;0;0;0;0;0;0;0;0;0
FR;6;2021-10-17;0;0;0;0;0;0;0;0;0;0
FR;6;2021-10-18;0;0;0;0;0;0;0;0;0;0
FR;6;2021-10-19;0;0;0;0;0;0;0;0;0;0
FR;6;2021-10-20;0;0;0;0;0;0;0;0;0;0
FR;6;2021-10-21;0;0;0;0;0;0;0;0;0;0
FR;6;2021-10-22;0;0;0;0;0;0;0;0;0;0
FR;6;2021-10-23;0;0;0;0;0;0;0;0;0;0
FR;6;2021-10-24;0;0;0;0;0;0;0;0;0;0
FR;6;2021-10-25;0;0;0;0;0;0;0;0;0;0
FR;6;2021-10-26;0;0;0;0;0;0;0;0;0;0
FR;6;2021-10-27;0;0;0;0;0;0;0;0;0;0
FR;6;2021-10-28;0;0;0;0;0;0;0;0;0;0
FR;6;2021-10-29;0;0;0;0;0;0;0;0;0;0
FR;6;2021-10-30;0;0;0;0;0;0;0;0;0;0
FR;6;2021-10-31;0;0;0;0;0;0;0;0;0;0
FR;6;2021-11-01;0;0;0;0;0;0;0;0;0;0
FR;6;2021-11-02;0;0;0;0;0;0;0;0;0;0
FR;6;2021-11-03;0;0;0;0;0;0;0;0;0;0
FR;6;2021-11-04;0;0;0;0;0;0;0;0;0;0
FR;6;2021-11-05;0;0;0;0;0;0;0;0;0;0
FR;6;2021-11-06;0;0;0;0;0;0;0;0;0;0
FR;6;2021-11-07;0;0;0;0;0;0;0;0;0;0
FR;6;2021-11-08;0;0;0;0;0;0;0;0;0;0
FR;6;2021-11-09;0;0;0;0;0;0;0;0;0;0
FR;6;2021-11-10;0;0;0;0;0;0;0;0;0;0
FR;6;2021-11-11;0;0;0;0;0;0;0;0;0;0
FR;6;2021-11-12;0;0;0;0;0;0;0;0;0;0
FR;6;2021-11-13;0;0;0;0;0;0;0;0;0;0
FR;6;2021-11-14;0;0;0;0;0;0;0;0;0;0
FR;6;2021-11-15;0;0;0;0;0;0;0;0;0;0
FR;6;2021-11-16;0;0;0;0;0;0;0;0;0;0
FR;6;2021-11-17;0;0;0;0;0;0;0;0;0;0
FR;6;2021-11-18;0;0;0;0;0;0;0;0;0;0
FR;6;2021-11-19;0;0;0;0;0;0;0;0;0;0
FR;6;2021-11-20;0;0;0;0;0;0;0;0;0;0
FR;6;2021-11-21;0;0;0;0;0;0;0;0;0;0
FR;6;2021-11-22;0;0;0;0;0;0;0;0;0;0
FR;6;2021-11-23;0;0;0;0;0;0;0;0;0;0
FR;6;2021-11-24;0;0;0;0;0;0;0;0;0;0
FR;6;2021-11-25;0;0;0;0;0;0;0;0;0;0
FR;6;2021-11-26;0;0;0;0;0;0;0;0;0;0
FR;6;2021-11-27;0;0;0;0;0;0;0;0;0;0
FR;6;2021-11-28;0;0;0;0;0;0;0;0;0;0
FR;6;2021-11-29;0;0;0;0;0;0;0;0;0;0
FR;6;2021-11-30;0;0;0;0;0;0;0;0;0;0
FR;6;2021-12-01;0;0;0;0;0;0;0;0;0;0
FR;6;2021-12-02;0;0;0;0;0;0;0;0;0;0
FR;6;2021-12-03;0;0;0;0;0;0;0;0;0;0
FR;6;2021-12-04;0;0;0;0;0;0;0;0;0;0
FR;6;2021-12-05;0;0;0;0;0;0;0;0;0;0
FR;6;2021-12-06;0;0;0;0;0;0;0;0;0;0
FR;6;2021-12-07;0;0;0;0;0;0;0;0;0;0
FR;6;2021-12-08;0;0;0;0;0;0;0;0;0;0
FR;6;2021-12-09;0;0;0;0;0;0;0;0;0;0
FR;6;2021-12-10;0;0;0;0;0;0;0;0;0;0
FR;6;2021-12-11;0;0;0;0;0;0;0;0;0;0
FR;6;2021-12-12;0;0;0;0;0;0;0;0;0;0
FR;6;2021-12-13;0;0;0;0;0;0;0;0;0;0
FR;6;2021-12-14;0;0;0;0;0;0;0;0;0;0
FR;6;2021-12-15;0;0;0;0;0;0;0;0;0;0
FR;6;2021-12-16;0;0;0;0;0;0;0;0;0;0
FR;6;2021-12-17;0;0;0;0;0;0;0;0;0;0
FR;6;2021-12-18;0;0;0;0;0;0;0;0;0;0
FR;6;2021-12-19;0;0;0;0;0;0;0;0;0;0
FR;6;2021-12-20;0;0;0;0;0;0;0;0;0;0
FR;6;2021-12-21;0;0;0;0;0;0;0;0;0;0
FR;6;2021-12-22;0;0;0;0;0;0;0;0;0;0
FR;6;2021-12-23;0;0;0;0;0;0;0;0;0;0
FR;6;2021-12-24;0;0;0;0;0;0;0;0;0;0
FR;6;2021-12-25;0;0;0;0;0;0;0;0;0;0
FR;6;2021-12-26;0;0;0;0;0;0;0;0;0;0
FR;6;2021-12-27;0;0;0;0;0;0;0;0;0;0
FR;6;2021-12-28;0;0;0;0;0;0;0;0;0;0
FR;6;2021-12-29;0;0;0;0;0;0;0;0;0;0
FR;6;2021-12-30;0;0;0;0;0;0;0;0;0;0
FR;6;2021-12-31;0;0;0;0;0;0;0;0;0;0
FR;6;2022-01-01;0;0;0;0;0;0;0;0;0;0
FR;6;2022-01-02;0;0;0;0;0;0;0;0;0;0
FR;6;2022-01-03;0;0;0;0;0;0;0;0;0;0
FR;6;2022-01-04;0;0;0;0;0;0;0;0;0;0
FR;6;2022-01-05;0;0;0;0;0;0;0;0;0;0
FR;6;2022-01-06;0;0;0;0;0;0;0;0;0;0
FR;6;2022-01-07;0;0;0;0;0;0;0;0;0;0
FR;6;2022-01-08;0;0;0;0;0;0;0;0;0;0
FR;6;2022-01-09;0;0;0;0;0;0;0;0;0;0
FR;6;2022-01-10;0;0;0;0;0;0;0;0;0;0
FR;6;2022-01-11;0;0;0;0;0;0;0;0;0;0
FR;6;2022-01-12;0;0;0;0;0;0;0;0;0;0
FR;6;2022-01-13;0;0;0;0;0;0;0;0;0;0
FR;6;2022-01-14;0;0;0;0;0;0;0;0;0;0
FR;6;2022-01-15;0;0;0;0;0;0;0;0;0;0
FR;6;2022-01-16;0;0;0;0;0;0;0;0;0;0
FR;6;2022-01-17;0;0;0;0;0;0;0;0;0;0
FR;6;2022-01-18;0;0;0;0;0;0;0;0;0;0
FR;6;2022-01-19;0;0;0;0;0;0;0;0;0;0
FR;6;2022-01-20;0;0;0;0;0;0;0;0;0;0
FR;6;2022-01-21;0;0;0;0;0;0;0;0;0;0
FR;6;2022-01-22;0;0;0;0;0;0;0;0;0;0
FR;6;2022-01-23;0;0;0;0;0;0;0;0;0;0
FR;6;2022-01-24;0;0;0;0;0;0;0;0;0;0
FR;6;2022-01-25;0;0;0;0;0;0;0;0;0;0
FR;6;2022-01-26;0;0;0;0;0;0;0;0;0;0
FR;6;2022-01-27;0;0;0;0;0;0;0;0;0;0
FR;6;2022-01-28;0;0;0;0;0;0;0;0;0;0
FR;6;2022-01-29;0;0;0;0;0;0;0;0;0;0
FR;6;2022-01-30;0;0;0;0;0;0;0;0;0;0
FR;6;2022-01-31;0;0;0;0;0;0;0;0;0;0
FR;6;2022-02-01;0;0;0;0;0;0;0;0;0;0
FR;6;2022-02-02;0;0;0;0;0;0;0;0;0;0
FR;6;2022-02-03;0;0;0;0;0;0;0;0;0;0
FR;6;2022-02-04;0;0;0;0;0;0;0;0;0;0
FR;6;2022-02-05;0;0;0;0;0;0;0;0;0;0
FR;6;2022-02-06;0;0;0;0;0;0;0;0;0;0
FR;6;2022-02-07;0;0;0;0;0;0;0;0;0;0
FR;6;2022-02-08;0;0;0;0;0;0;0;0;0;0
FR;6;2022-02-09;0;0;0;0;0;0;0;0;0;0
FR;6;2022-02-10;0;0;0;0;0;0;0;0;0;0
FR;6;2022-02-11;0;0;0;0;0;0;0;0;0;0
FR;6;2022-02-12;0;0;0;0;0;0;0;0;0;0
FR;6;2022-02-13;0;0;0;0;0;0;0;0;0;0
FR;6;2022-02-14;0;0;0;0;0;0;0;0;0;0
FR;6;2022-02-15;0;0;0;0;0;0;0;0;0;0
FR;6;2022-02-16;0;0;0;0;0;0;0;0;0;0
FR;6;2022-02-17;0;0;0;0;0;0;0;0;0;0
FR;6;2022-02-18;0;0;0;0;0;0;0;0;0;0
FR;6;2022-02-19;0;0;0;0;0;0;0;0;0;0
FR;6;2022-02-20;0;0;0;0;0;0;0;0;0;0
FR;6;2022-02-21;0;0;0;0;0;0;0;0;0;0
FR;6;2022-02-22;0;0;0;0;0;0;0;0;0;0
FR;6;2022-02-23;0;0;0;0;0;0;0;0;0;0
FR;6;2022-02-24;0;0;0;0;0;0;0;0;0;0
FR;6;2022-02-25;0;0;0;0;0;0;0;0;0;0
FR;6;2022-02-26;1;0;0;0;0;1;0;0;0;0
FR;6;2022-02-27;0;0;0;0;0;1;0;0;0;0
FR;6;2022-02-28;0;0;0;0;0;1;0;0;0;0
FR;6;2022-03-01;3;0;0;0;0;4;0;0;0;0
FR;6;2022-03-02;97;9;2;0;7;101;9;2;0;7
FR;6;2022-03-03;0;0;0;0;0;101;9;2;0;7
FR;6;2022-03-04;91;4;0;0;4;192;13;2;0;11
FR;6;2022-03-05;391;23;2;0;14;583;36;4;0;25
FR;6;2022-03-06;7;1;0;0;0;590;37;4;0;25
FR;6;2022-03-07;337;19;0;0;13;927;56;4;0;38
FR;6;2022-03-08;230;14;0;0;5;1157;70;4;0;43
FR;6;2022-03-09;519;29;2;0;21;1676;99;6;0;64
FR;6;2022-03-10;206;19;0;1;12;1882;118;6;1;76
FR;6;2022-03-11;328;21;6;0;21;2210;139;12;1;97
FR;6;2022-03-12;518;25;1;0;20;2728;164;13;1;117
FR;6;2022-03-13;40;2;0;0;1;2768;166;13;1;118
FR;6;2022-03-14;201;4;2;0;3;2969;170;15;1;121
FR;6;2022-03-15;112;11;2;0;9;3081;181;17;1;130
FR;6;2022-03-16;310;17;1;1;14;3391;198;18;2;144
FR;6;2022-03-17;117;6;1;2;4;3508;204;19;4;148
FR;6;2022-03-18;215;10;0;0;6;3723;214;19;4;154
FR;6;2022-03-19;307;19;2;0;9;4030;233;21;4;163
FR;6;2022-03-20;15;5;0;0;1;4045;238;21;4;164
FR;6;2022-03-21;132;23;1;0;4;4177;261;22;4;168
FR;6;2022-03-22;97;15;0;0;4;4274;276;22;4;172
FR;6;2022-03-23;226;108;3;0;14;4500;384;25;4;186
FR;6;2022-03-24;100;15;1;3;4;4600;399;26;7;190
FR;6;2022-03-25;203;141;2;1;15;4803;540;28;8;205
FR;6;2022-03-26;331;295;7;1;19;5134;835;35;9;224
FR;6;2022-03-27;32;30;1;0;1;5166;865;36;9;225
FR;6;2022-03-28;200;208;8;1;17;5366;1073;44;10;242
FR;6;2022-03-29;124;189;12;2;12;5490;1262;56;12;254
FR;6;2022-03-30;305;476;10;2;22;5795;1738;66;14;276
FR;6;2022-03-31;124;140;10;0;14;5919;1878;76;14;290
FR;6;2022-04-01;195;150;11;2;23;6114;2028;87;16;313
FR;6;2022-04-02;205;241;9;1;13;6319;2269;96;17;326
FR;6;2022-04-03;17;21;0;0;1;6336;2290;96;17;327
FR;6;2022-04-04;132;114;6;1;9;6468;2404;102;18;336
FR;6;2022-04-05;145;88;15;1;11;6613;2492;117;19;347
FR;6;2022-04-06;204;245;22;26;27;6817;2737;139;45;374
FR;6;2022-04-07;127;96;15;9;17;6944;2833;154;54;391
FR;6;2022-04-08;199;170;16;3;17;7143;3003;170;57;408
FR;6;2022-04-09;145;139;6;12;13;7288;3142;176;69;421
FR;6;2022-04-10;10;20;3;0;1;7298;3162;179;69;422
FR;6;2022-04-11;101;106;4;0;5;7399;3268;183;69;427
FR;6;2022-04-12;136;75;5;8;10;7535;3343;188;77;437
FR;6;2022-04-13;161;175;7;5;13;7696;3518;195;82;450
FR;6;2022-04-14;100;103;5;10;8;7796;3621;200;92;458
FR;6;2022-04-15;160;148;11;7;19;7956;3769;211;99;477
FR;6;2022-04-16;127;132;5;0;14;8083;3901;216;99;491
FR;6;2022-04-17;8;9;4;0;4;8091;3910;220;99;495
FR;6;2022-04-18;8;15;3;0;4;8099;3925;223;99;499
FR;6;2022-04-19;97;112;4;3;3;8196;4037;227;102;502
FR;6;2022-04-20;177;227;8;7;15;8373;4264;235;109;517
FR;6;2022-04-21;111;93;8;4;11;8484;4357;243;113;528
FR;6;2022-04-22;138;160;13;12;13;8622;4517;256;125;541
FR;6;2022-04-23;106;129;1;1;7;8728;4646;257;126;548
FR;6;2022-04-24;5;21;1;0;0;8733;4667;258;126;548
FR;6;2022-04-25;91;128;3;8;11;8824;4795;261;134;559
FR;6;2022-04-26;101;128;18;2;16;8925;4923;279;136;575
FR;6;2022-04-27;197;159;21;1;27;9122;5082;300;137;602
FR;6;2022-04-28;109;87;7;1;8;9231;5169;307;138;610
FR;6;2022-04-29;191;168;16;2;20;9422;5337;323;140;630
FR;6;2022-04-30;133;125;7;1;24;9555;5462;330;141;654
FR;6;2022-05-01;7;6;0;0;0;9562;5468;330;141;654
FR;6;2022-05-02;94;65;3;4;3;9656;5533;333;145;657
FR;6;2022-05-03;136;92;11;2;7;9792;5625;344;147;664
FR;6;2022-05-04;167;118;25;12;29;9959;5743;369;159;693
FR;6;2022-05-05;101;70;8;3;12;10060;5813;377;162;705
FR;6;2022-05-06;152;110;10;9;16;10212;5923;387;171;721
FR;6;2022-05-07;138;93;13;3;23;10350;6016;400;174;744
FR;6;2022-05-08;20;8;6;5;7;10370;6024;406;179;751
FR;6;2022-05-09;86;73;9;7;13;10456;6097;415;186;764
FR;6;2022-05-10;111;80;15;7;12;10567;6177;430;193;776
FR;6;2022-05-11;130;124;11;14;20;10697;6301;441;207;796
FR;6;2022-05-12;105;76;7;5;15;10802;6377;448;212;811
FR;6;2022-05-13;154;95;17;21;20;10956;6472;465;233;831
FR;6;2022-05-14;81;60;6;7;15;11037;6532;471;240;846
FR;6;2022-05-15;12;7;0;0;0;11049;6539;471;240;846
FR;6;2022-05-16;64;54;6;2;12;11113;6593;477;242;858
FR;6;2022-05-17;123;77;5;7;11;11236;6670;482;249;869
FR;6;2022-05-18;131;116;5;1;13;11367;6786;487;250;882
FR;6;2022-05-19;124;57;6;8;9;11491;6843;493;258;891
FR;6;2022-05-20;127;115;13;3;18;11618;6958;506;261;909
FR;6;2022-05-21;92;69;14;3;12;11710;7027;520;264;921
FR;6;2022-05-22;19;12;5;0;4;11729;7039;525;264;925
FR;6;2022-05-23;77;72;4;2;7;11806;7111;529;266;932
FR;6;2022-05-24;116;98;8;2;16;11922;7209;537;268;948
FR;6;2022-05-25;139;129;6;3;11;12061;7338;543;271;959
FR;6;2022-05-26;7;9;3;0;9;12068;7347;546;271;968
FR;6;2022-05-27;127;105;15;11;18;12195;7452;561;282;986
FR;6;2022-05-28;52;75;1;5;8;12247;7527;562;287;994
FR;6;2022-05-29;8;10;0;0;1;12255;7537;562;287;995
FR;6;2022-05-30;70;70;7;4;4;12325;7607;569;291;999
FR;6;2022-05-31;87;102;10;2;14;12412;7709;579;293;1013
FR;6;2022-06-01;97;89;10;1;11;12509;7798;589;294;1024
FR;6;2022-06-02;88;60;6;3;9;12597;7858;595;297;1033
FR;6;2022-06-03;126;102;13;7;21;12723;7960;608;304;1054
FR;6;2022-06-04;62;51;10;0;12;12785;8011;618;304;1066
FR;6;2022-06-05;16;15;2;1;4;12801;8026;620;305;1070
FR;6;2022-06-06;9;6;0;0;0;12810;8032;620;305;1070
FR;6;2022-06-07;79;90;3;4;8;12889;8122;623;309;1078
FR;6;2022-06-08;92;110;13;5;20;12981;8232;636;314;1098
FR;6;2022-06-09;75;81;15;3;15;13056;8313;651;317;1113
FR;6;2022-06-10;116;93;26;9;22;13172;8406;677;326;1135
FR;6;2022-06-11;83;62;6;10;12;13255;8468;683;336;1147
FR;6;2022-06-12;6;14;1;0;2;13261;8482;684;336;1149
FR;6;2022-06-13;74;59;18;1;7;13335;8541;702;337;1156
FR;6;2022-06-14;98;100;8;5;16;13433;8641;710;342;1172
FR;6;2022-06-15;80;85;7;8;15;13513;8726;717;350;1187
FR;6;2022-06-16;53;40;11;7;14;13566;8766;728;357;1201
FR;6;2022-06-17;85;81;3;13;11;13651;8847;731;370;1212
FR;6;2022-06-18;72;60;12;0;20;13723;8907;743;370;1232
FR;6;2022-06-19;6;6;3;0;4;13729;8913;746;370;1236
FR;6;2022-06-20;42;41;4;1;6;13771;8954;750;371;1242
FR;6;2022-06-21;59;73;7;7;15;13830;9027;757;378;1257
FR;6;2022-06-22;85;85;8;2;17;13915;9112;765;380;1274
FR;6;2022-06-23;64;39;13;7;15;13979;9151;778;387;1289
FR;6;2022-06-24;73;83;7;14;18;14052;9234;785;401;1307
FR;6;2022-06-25;67;61;4;3;8;14119;9295;789;404;1315
FR;6;2022-06-26;6;7;1;0;1;14125;9302;790;404;1316
FR;6;2022-06-27;53;50;4;9;12;14178;9352;794;413;1328
FR;6;2022-06-28;68;47;5;3;15;14246;9399;799;416;1343
FR;6;2022-06-29;97;117;26;37;19;14343;9516;825;453;1362
FR;6;2022-06-30;84;59;33;10;12;14427;9575;858;463;1374
FR;6;2022-07-01;113;94;24;33;17;14540;9669;882;496;1391
FR;6;2022-07-02;56;66;23;2;34;14596;9735;905;498;1425
FR;6;2022-07-03;11;4;4;3;4;14607;9739;909;501;1429
FR;6;2022-07-04;61;43;3;23;13;14668;9782;912;524;1442
FR;6;2022-07-05;65;52;18;67;25;14733;9834;930;591;1467
FR;6;2022-07-06;93;64;7;11;12;14826;9898;937;602;1479
FR;6;2022-07-07;93;79;42;37;14;14919;9977;979;639;1493
FR;6;2022-07-08;136;87;42;27;10;15055;10064;1021;666;1503
FR;6;2022-07-09;53;50;16;29;26;15108;10114;1037;695;1529
FR;6;2022-07-10;3;6;8;0;9;15111;10120;1045;695;1538
FR;6;2022-07-11;54;44;5;4;12;15165;10164;1050;699;1550
FR;6;2022-07-12;69;70;12;22;12;15234;10234;1062;721;1562
FR;6;2022-07-13;81;64;14;21;25;15315;10298;1076;742;1587
FR;6;2022-07-14;4;3;1;0;1;15319;10301;1077;742;1588
FR;6;2022-07-15;73;59;9;57;16;15392;10360;1086;799;1604
FR;6;2022-07-16;26;31;17;0;17;15418;10391;1103;799;1621
FR;6;2022-07-17;3;6;0;0;0;15421;10397;1103;799;1621
FR;6;2022-07-18;33;57;8;11;14;15454;10454;1111;810;1635
FR;0;2020-12-27;609;0;0;0;0;609;0;0;0;0
FR;0;2020-12-28;678;1;0;0;0;1287;1;0;0;0
FR;0;2020-12-29;380;0;0;0;0;1667;1;0;0;0
FR;0;2020-12-30;442;0;0;0;0;2109;1;0;0;0
FR;0;2020-12-31;439;1;0;0;0;2548;2;0;0;0
FR;0;2021-01-01;1149;2;0;0;0;3697;4;0;0;0
FR;0;2021-01-02;362;3;0;0;0;4059;7;0;0;0
FR;0;2021-01-03;402;0;0;0;0;4461;7;0;0;0
FR;0;2021-01-04;2103;3;0;0;0;6564;10;0;0;0
FR;0;2021-01-05;7745;3;0;0;0;14309;13;0;0;0
FR;0;2021-01-06;12454;16;0;0;0;26763;29;0;0;0
FR;0;2021-01-07;29457;13;0;0;0;56220;42;0;0;0
FR;0;2021-01-08;37140;14;0;0;0;93360;56;0;0;0
FR;0;2021-01-09;11212;7;0;0;0;104572;63;0;0;0
FR;0;2021-01-10;6003;5;0;0;0;110575;68;0;0;0
FR;0;2021-01-11;39929;19;0;0;0;150504;87;0;0;0
FR;0;2021-01-12;62132;18;0;0;0;212636;105;0;0;0
FR;0;2021-01-13;65114;38;0;0;0;277750;143;0;0;0
FR;0;2021-01-14;83114;127;0;0;0;360864;270;0;0;0
FR;0;2021-01-15;69004;44;0;0;0;429868;314;0;0;0
FR;0;2021-01-16;20212;72;0;0;0;450080;386;0;0;0
FR;0;2021-01-17;10982;49;0;0;0;461062;435;0;0;0
FR;0;2021-01-18;85894;169;0;0;0;546956;604;0;0;0
FR;0;2021-01-19;130594;181;0;0;0;677550;785;0;0;0
FR;0;2021-01-20;137540;187;0;0;0;815090;972;0;0;0
FR;0;2021-01-21;158395;173;0;0;0;973485;1145;0;0;0
FR;0;2021-01-22;121056;225;0;0;0;1094541;1370;0;0;0
FR;0;2021-01-23;38476;68;0;0;0;1133017;1438;0;0;0
FR;0;2021-01-24;9741;95;0;0;0;1142758;1533;0;0;0
FR;0;2021-01-25;78230;1318;0;0;0;1220988;2851;0;0;0
FR;0;2021-01-26;100373;3414;1;0;0;1321361;6265;1;0;0
FR;0;2021-01-27;107237;6054;0;0;0;1428598;12319;1;0;0
FR;0;2021-01-28;124343;15314;0;0;0;1552941;27633;1;0;0
FR;0;2021-01-29;92180;17990;0;0;0;1645121;45623;1;0;0
FR;0;2021-01-30;29121;4383;0;0;0;1674242;50006;1;0;0
FR;0;2021-01-31;5231;1793;0;0;0;1679473;51799;1;0;0
FR;0;2021-02-01;53115;21797;0;0;0;1732588;73596;1;0;0
FR;0;2021-02-02;72296;36408;0;0;0;1804884;110004;1;0;0
FR;0;2021-02-03;72300;38678;0;0;0;1877184;148682;1;0;0
FR;0;2021-02-04;82066;52491;0;0;0;1959250;201173;1;0;0
FR;0;2021-02-05;68225;46563;0;0;0;2027475;247736;1;0;0
FR;0;2021-02-06;23065;10950;0;0;0;2050540;258686;1;0;0
FR;0;2021-02-07;5185;5520;0;0;0;2055725;264206;1;0;0
FR;0;2021-02-08;46832;47448;0;0;0;2102557;311654;1;0;0
FR;0;2021-02-09;66001;75590;0;0;0;2168558;387244;1;0;0
FR;0;2021-02-10;71003;80389;0;0;0;2239561;467633;1;0;0
FR;0;2021-02-11;87269;102302;0;0;0;2326830;569935;1;0;0
FR;0;2021-02-12;79307;75312;0;0;0;2406137;645247;1;0;0
FR;0;2021-02-13;22375;19572;0;0;0;2428512;664819;1;0;0
FR;0;2021-02-14;5074;7349;0;0;0;2433586;672168;1;0;0
FR;0;2021-02-15;38082;76748;0;0;0;2471668;748916;1;0;0
FR;0;2021-02-16;50387;100627;0;0;0;2522055;849543;1;0;0
FR;0;2021-02-17;50521;105395;20;0;0;2572576;954938;21;0;0
FR;0;2021-02-18;69782;121461;0;0;0;2642358;1076399;21;0;0
FR;0;2021-02-19;65059;91467;1;0;0;2707417;1167866;22;0;0
FR;0;2021-02-20;18584;28689;0;0;0;2726001;1196555;22;0;0
FR;0;2021-02-21;3316;6266;0;0;0;2729317;1202821;22;0;0
FR;0;2021-02-22;37494;73346;2;0;0;2766811;1276167;24;0;0
FR;0;2021-02-23;53772;84836;1;0;0;2820583;1361003;25;0;0
FR;0;2021-02-24;60003;82156;1;0;0;2880586;1443159;26;0;0
FR;0;2021-02-25;100562;91344;1;0;0;2981148;1534503;27;0;0
FR;0;2021-02-26;113454;70804;1;0;0;3094602;1605307;28;0;0
FR;0;2021-02-27;52096;22282;1;0;0;3146698;1627589;29;0;0
FR;0;2021-02-28;6193;4242;2;0;0;3152891;1631831;31;0;0
FR;0;2021-03-01;65870;53574;1;0;0;3218761;1685405;32;0;0
FR;0;2021-03-02;101369;66865;3;0;0;3320130;1752270;35;0;0
FR;0;2021-03-03;116502;65484;0;0;0;3436632;1817754;35;0;0
FR;0;2021-03-04;163612;71069;3;0;0;3600244;1888823;38;0;0
FR;0;2021-03-05;200911;62930;3;0;0;3801155;1951753;41;0;0
FR;0;2021-03-06;207950;17662;3;0;0;4009105;1969415;44;0;0
FR;0;2021-03-07;121270;4702;1;0;0;4130375;1974117;45;0;0
FR;0;2021-03-08;107133;50097;2;0;0;4237508;2024214;47;0;0
FR;0;2021-03-09;172440;56386;2;0;0;4409948;2080600;49;0;0
FR;0;2021-03-10;178978;57113;5;0;0;4588926;2137713;54;0;0
FR;0;2021-03-11;242867;63687;2;0;0;4831793;2201400;56;0;0
FR;0;2021-03-12;294799;53442;1;0;0;5126592;2254842;57;0;0
FR;0;2021-03-13;231388;15322;1;0;0;5357980;2270164;58;0;0
FR;0;2021-03-14;63346;3225;1;0;0;5421326;2273389;59;0;0
FR;0;2021-03-15;158637;32020;3;0;0;5579963;2305409;62;0;0
FR;0;2021-03-16;141562;39055;6;0;0;5721525;2344464;68;0;0
FR;0;2021-03-17;150471;38029;4;0;0;5871996;2382493;72;0;0
FR;0;2021-03-18;167812;44450;5;0;0;6039808;2426943;77;0;0
FR;0;2021-03-19;229988;37086;2;0;0;6269796;2464029;79;0;0
FR;0;2021-03-20;166665;11513;1;0;0;6436461;2475542;80;0;0
FR;0;2021-03-21;49930;2354;1;0;0;6486391;2477896;81;0;0
FR;0;2021-03-22;170029;33922;2;0;0;6656420;2511818;83;0;0
FR;0;2021-03-23;250365;42368;1;0;0;6906785;2554186;84;0;0
FR;0;2021-03-24;256879;43611;0;0;0;7163664;2597797;84;0;0
FR;0;2021-03-25;341792;44947;5;0;0;7505456;2642744;89;0;0
FR;0;2021-03-26;358787;41905;5;1;0;7864243;2684649;94;1;0
FR;0;2021-03-27;195249;16815;1;0;0;8059492;2701464;95;1;0
FR;0;2021-03-28;59334;4243;3;0;0;8118826;2705707;98;1;0
FR;0;2021-03-29;202957;53783;4;0;0;8321783;2759490;102;1;0
FR;0;2021-03-30;285460;69814;5;0;0;8607243;2829304;107;1;0
FR;0;2021-03-31;263006;73523;4;0;0;8870249;2902827;111;1;0
FR;0;2021-04-01;315444;90612;11;0;0;9185693;2993439;122;1;0
FR;0;2021-04-02;281311;93550;7;0;0;9467004;3086989;129;1;0
FR;0;2021-04-03;141065;62164;5;0;0;9608069;3149153;134;1;0
FR;0;2021-04-04;46525;18834;2;0;0;9654594;3167987;136;1;0
FR;0;2021-04-05;63327;10665;11;0;0;9717921;3178652;147;1;0
FR;0;2021-04-06;217188;110552;17;0;0;9935109;3289204;164;1;0
FR;0;2021-04-07;260234;115253;17;0;0;10195343;3404457;181;1;0
FR;0;2021-04-08;337799;122183;14;0;0;10533142;3526640;195;1;0
FR;0;2021-04-09;410127;116592;49;0;0;10943269;3643232;244;1;0
FR;0;2021-04-10;212609;82716;15;0;0;11155878;3725948;259;1;0
FR;0;2021-04-11;56137;34329;7;0;0;11212015;3760277;266;1;0
FR;0;2021-04-12;237049;115484;46;0;0;11449064;3875761;312;1;0
FR;0;2021-04-13;309459;144319;98;1;0;11758523;4020080;410;2;0
FR;0;2021-04-14;294496;139364;214;0;0;12053019;4159444;624;2;0
FR;0;2021-04-15;337068;149187;338;0;0;12390087;4308631;962;2;0
FR;0;2021-04-16;339261;146248;353;0;0;12729348;4454879;1315;2;0
FR;0;2021-04-17;188645;89960;109;0;0;12917993;4544839;1424;2;0
FR;0;2021-04-18;51611;35382;47;0;0;12969604;4580221;1471;2;0
FR;0;2021-04-19;205668;138175;456;0;0;13175272;4718396;1927;2;0
FR;0;2021-04-20;254391;171189;569;0;0;13429663;4889585;2496;2;0
FR;0;2021-04-21;253229;169377;834;0;0;13682892;5058962;3330;2;0
FR;0;2021-04-22;287528;189224;817;0;0;13970420;5248186;4147;2;0
FR;0;2021-04-23;297855;183738;747;0;0;14268275;5431924;4894;2;0
FR;0;2021-04-24;190438;111698;252;0;0;14458713;5543622;5146;2;0
FR;0;2021-04-25;69550;38767;51;0;0;14528263;5582389;5197;2;0
FR;0;2021-04-26;220933;157020;561;0;0;14749196;5739409;5758;2;0
FR;0;2021-04-27;284579;187539;940;0;0;15033775;5926948;6698;2;0
FR;0;2021-04-28;299476;183678;1423;1;1;15333251;6110626;8121;3;1
FR;0;2021-04-29;357101;197018;1277;0;0;15690352;6307644;9398;3;1
FR;0;2021-04-30;372180;185191;1121;1;0;16062532;6492835;10519;4;1
FR;0;2021-05-01;167627;52492;178;0;0;16230159;6545327;10697;4;1
FR;0;2021-05-02;91728;37777;83;0;0;16321887;6583104;10780;4;1
FR;0;2021-05-03;288898;167443;842;0;0;16610785;6750547;11622;4;1
FR;0;2021-05-04;315644;224756;1232;0;0;16926429;6975303;12854;4;1
FR;0;2021-05-05;327167;225316;1313;0;0;17253596;7200619;14167;4;1
FR;0;2021-05-06;379488;239922;1632;0;0;17633084;7440541;15799;4;1
FR;0;2021-05-07;372725;257745;1222;0;0;18005809;7698286;17021;4;1
FR;0;2021-05-08;222149;68807;299;0;0;18227958;7767093;17320;4;1
FR;0;2021-05-09;129691;45845;243;0;0;18357649;7812938;17563;4;1
FR;0;2021-05-10;313356;229001;1234;0;0;18671005;8041939;18797;4;1
FR;0;2021-05-11;403870;257911;1564;0;0;19074875;8299850;20361;4;1
FR;0;2021-05-12;434082;233319;1542;0;0;19508957;8533169;21903;4;1
FR;0;2021-05-13;338579;56780;430;0;0;19847536;8589949;22333;4;1
FR;0;2021-05-14;454094;167356;1125;0;0;20301630;8757305;23458;4;1
FR;0;2021-05-15;374953;94162;443;0;0;20676583;8851467;23901;4;1
FR;0;2021-05-16;202740;20720;168;0;0;20879323;8872187;24069;4;1
FR;0;2021-05-17;376095;148804;1553;0;0;21255418;9020991;25622;4;1
FR;0;2021-05-18;460111;153430;1988;0;0;21715529;9174421;27610;4;1
FR;0;2021-05-19;467372;143925;2459;0;0;22182901;9318346;30069;4;1
FR;0;2021-05-20;507491;160285;2334;0;0;22690392;9478631;32403;4;1
FR;0;2021-05-21;489635;174678;1992;0;0;23180027;9653309;34395;4;1
FR;0;2021-05-22;347169;79959;668;0;0;23527196;9733268;35063;4;1
FR;0;2021-05-23;161682;14304;246;0;0;23688878;9747572;35309;4;1
FR;0;2021-05-24;263171;33199;603;0;0;23952049;9780771;35912;4;1
FR;0;2021-05-25;400252;189745;2351;1;0;24352301;9970516;38263;5;1
FR;0;2021-05-26;413426;189281;2221;0;0;24765727;10159797;40484;5;1
FR;0;2021-05-27;449770;219161;2160;0;0;25215497;10378958;42644;5;1
FR;0;2021-05-28;429524;259949;1891;0;0;25645021;10638907;44535;5;1
FR;0;2021-05-29;298965;149745;584;0;0;25943986;10788652;45119;5;1
FR;0;2021-05-30;107135;32569;163;0;0;26051121;10821221;45282;5;1
FR;0;2021-05-31;358009;203332;1468;1;1;26409130;11024553;46750;6;2
FR;0;2021-06-01;430961;251339;1961;1;1;26840091;11275892;48711;7;3
FR;0;2021-06-02;420069;231272;1982;0;0;27260160;11507164;50693;7;3
FR;0;2021-06-03;465551;258197;1823;0;0;27725711;11765361;52516;7;3
FR;0;2021-06-04;456113;305092;1730;1;1;28181824;12070453;54246;8;4
FR;0;2021-06-05;304780;189147;652;0;0;28486604;12259600;54898;8;4
FR;0;2021-06-06;133290;49080;226;0;0;28619894;12308680;55124;8;4
FR;0;2021-06-07;339670;261826;1523;0;0;28959564;12570506;56647;8;4
FR;0;2021-06-08;393729;290915;1803;0;0;29353293;12861421;58450;8;4
FR;0;2021-06-09;384784;274888;1729;0;0;29738077;13136309;60179;8;4
FR;0;2021-06-10;404121;288332;1722;1;0;30142198;13424641;61901;9;4
FR;0;2021-06-11;386609;356940;1466;0;0;30528807;13781581;63367;9;4
FR;0;2021-06-12;283235;211124;492;0;0;30812042;13992705;63859;9;4
FR;0;2021-06-13;104876;73914;204;0;0;30916918;14066619;64063;9;4
FR;0;2021-06-14;240803;354960;1426;1;0;31157721;14421579;65489;10;4
FR;0;2021-06-15;308098;385193;1566;1;0;31465819;14806772;67055;11;4
FR;0;2021-06-16;313952;357556;1417;1;0;31779771;15164328;68472;12;4
FR;0;2021-06-17;317637;372646;1426;1;0;32097408;15536974;69898;13;4
FR;0;2021-06-18;321715;442563;1336;1;0;32419123;15979537;71234;14;4
FR;0;2021-06-19;224332;273813;448;0;0;32643455;16253350;71682;14;4
FR;0;2021-06-20;74416;102479;126;0;0;32717871;16355829;71808;14;4
FR;0;2021-06-21;195726;401796;1034;1;1;32913597;16757625;72842;15;5
FR;0;2021-06-22;223161;467409;1264;10;2;33136758;17225034;74106;25;7
FR;0;2021-06-23;234001;439913;1197;1;1;33370759;17664947;75303;26;8
FR;0;2021-06-24;241833;409557;1353;0;0;33612592;18074504;76656;26;8
FR;0;2021-06-25;227612;522502;1398;0;0;33840204;18597006;78054;26;8
FR;0;2021-06-26;153227;370772;586;1;0;33993431;18967778;78640;27;8
FR;0;2021-06-27;55893;156140;168;1;0;34049324;19123918;78808;28;8
FR;0;2021-06-28;154737;452764;1173;0;0;34204061;19576682;79981;28;8
FR;0;2021-06-29;182658;507096;2124;0;0;34386719;20083778;82105;28;8
FR;0;2021-06-30;203969;484488;2011;21;2;34590688;20568266;84116;49;10
FR;0;2021-07-01;231290;457990;2222;5;1;34821978;21026256;86338;54;11
FR;0;2021-07-02;228548;520148;2120;5;2;35050526;21546404;88458;59;13
FR;0;2021-07-03;142029;368726;908;3;1;35192555;21915130;89366;62;14
FR;0;2021-07-04;56717;141166;265;0;0;35249272;22056296;89631;62;14
FR;0;2021-07-05;168459;419135;1668;8;2;35417731;22475431;91299;70;16
FR;0;2021-07-06;196713;474682;1828;45;8;35614444;22950113;93127;115;24
FR;0;2021-07-07;213102;439181;1878;25;5;35827546;23389294;95005;140;29
FR;0;2021-07-08;231594;424143;2089;20;6;36059140;23813437;97094;160;35
FR;0;2021-07-09;228528;511001;2184;4;2;36287668;24324438;99278;164;37
FR;0;2021-07-10;148590;339899;982;1;1;36436258;24664337;100260;165;38
FR;0;2021-07-11;60181;110120;283;0;0;36496439;24774457;100543;165;38
FR;0;2021-07-12;169131;478094;1759;4;0;36665570;25252551;102302;169;38
FR;0;2021-07-13;287215;527209;2045;8;1;36952785;25779760;104347;177;39
FR;0;2021-07-14;181029;157597;434;0;0;37133814;25937357;104781;177;39
FR;0;2021-07-15;347038;502235;2099;1;0;37480852;26439592;106880;178;39
FR;0;2021-07-16;380044;495627;2022;3;1;37860896;26935219;108902;181;40
FR;0;2021-07-17;259704;319724;876;1;0;38120600;27254943;109778;182;40
FR;0;2021-07-18;109689;114696;310;0;0;38230289;27369639;110088;182;40
FR;0;2021-07-19;285367;424669;1628;3;0;38515656;27794308;111716;185;40
FR;0;2021-07-20;376793;452086;1723;0;0;38892449;28246394;113439;185;40
FR;0;2021-07-21;395676;407577;1549;4;2;39288125;28653971;114988;189;42
FR;0;2021-07-22;440956;387863;1715;4;2;39729081;29041834;116703;193;44
FR;0;2021-07-23;440200;422866;1881;4;1;40169281;29464700;118584;197;45
FR;0;2021-07-24;285208;269504;804;1;0;40454489;29734204;119388;198;45
FR;0;2021-07-25;121072;79998;232;0;0;40575561;29814202;119620;198;45
FR;0;2021-07-26;347317;322879;1615;3;2;40922878;30137081;121235;201;47
FR;0;2021-07-27;463971;320005;1696;4;2;41386849;30457086;122931;205;49
FR;0;2021-07-28;459363;289742;1634;4;2;41846212;30746828;124565;209;51
FR;0;2021-07-29;489728;276670;1794;2;1;42335940;31023498;126359;211;52
FR;0;2021-07-30;461706;302717;1940;5;1;42797646;31326215;128299;216;53
FR;0;2021-07-31;285365;185092;914;1;0;43083011;31511307;129213;217;53
FR;0;2021-08-01;111972;49971;252;0;0;43194983;31561278;129465;217;53
FR;0;2021-08-02;341307;234459;1602;2;0;43536290;31795737;131067;219;53
FR;0;2021-08-03;398499;244822;1720;2;1;43934789;32040559;132787;221;54
FR;0;2021-08-04;384735;209944;1592;6;3;44319524;32250503;134379;227;57
FR;0;2021-08-05;366068;228739;1709;0;0;44685592;32479242;136088;227;57
FR;0;2021-08-06;359630;271592;1835;4;1;45045222;32750834;137923;231;58
FR;0;2021-08-07;213075;178371;755;4;3;45258297;32929205;138678;235;61
FR;0;2021-08-08;74155;63233;274;0;0;45332452;32992438;138952;235;61
FR;0;2021-08-09;258651;259241;1546;4;3;45591103;33251679;140498;239;64
FR;0;2021-08-10;306755;277706;1659;2;1;45897858;33529385;142157;241;65
FR;0;2021-08-11;279638;259990;1441;5;1;46177496;33789375;143598;246;66
FR;0;2021-08-12;271469;278470;1662;3;1;46448965;34067845;145260;249;67
FR;0;2021-08-13;252089;278032;1591;3;2;46701054;34345877;146851;252;69
FR;0;2021-08-14;145306;197244;739;0;0;46846360;34543121;147590;252;69
FR;0;2021-08-15;39337;50113;216;1;0;46885697;34593234;147806;253;69
FR;0;2021-08-16;186107;317983;1539;0;0;47071804;34911217;149345;253;69
FR;0;2021-08-17;215611;336331;1636;7;1;47287415;35247548;150981;260;70
FR;0;2021-08-18;198987;324673;1597;7;4;47486402;35572221;152578;267;74
FR;0;2021-08-19;191956;325678;1637;1;0;47678358;35897899;154215;268;74
FR;0;2021-08-20;186397;366422;1817;3;2;47864755;36264321;156032;271;76
FR;0;2021-08-21;104775;238122;704;0;0;47969530;36502443;156736;271;76
FR;0;2021-08-22;31900;87207;255;1;1;48001430;36589650;156991;272;77
FR;0;2021-08-23;140925;357170;1561;3;1;48142355;36946820;158552;275;78
FR;0;2021-08-24;162439;376848;1848;5;1;48304794;37323668;160400;280;79
FR;0;2021-08-25;151092;350858;2033;8;3;48455886;37674526;162433;288;82
FR;0;2021-08-26;142804;342867;2557;10;0;48598690;38017393;164990;298;82
FR;0;2021-08-27;148399;388291;2791;11;3;48747089;38405684;167781;309;85
FR;0;2021-08-28;90636;249595;1404;0;0;48837725;38655279;169185;309;85
FR;0;2021-08-29;27308;83357;518;1;0;48865033;38738636;169703;310;85
FR;0;2021-08-30;117352;324839;4709;6;5990;48982385;39063475;174412;316;6075
FR;0;2021-08-31;128731;334574;10184;19;11840;49111116;39398049;184596;335;17915
FR;0;2021-09-01;135929;285725;22425;7;24365;49247045;39683774;207021;342;42280
FR;0;2021-09-02;113700;247295;26512;20;28925;49360745;39931069;233533;362;71205
FR;0;2021-09-03;118248;292724;29962;24;33015;49478993;40223793;263495;386;104220
FR;0;2021-09-04;89867;217760;12584;12;14103;49568860;40441553;276079;398;118323
FR;0;2021-09-05;21352;44835;4394;2;4724;49590212;40486388;280473;400;123047
FR;0;2021-09-06;75386;180709;31949;16;34273;49665598;40667097;312422;416;157320
FR;0;2021-09-07;80240;181268;33240;43;36211;49745838;40848365;345662;459;193531
FR;0;2021-09-08;90735;206162;29659;28;32513;49836573;41054527;375321;487;226044
FR;0;2021-09-09;76831;165391;33051;27;36563;49913404;41219918;408372;514;262607
FR;0;2021-09-10;95889;203741;35731;27;40580;50009293;41423659;444103;541;303187
FR;0;2021-09-11;67059;169268;12137;20;14361;50076352;41592927;456240;561;317548
FR;0;2021-09-12;12818;32090;2774;1;3173;50089170;41625017;459014;562;320721
FR;0;2021-09-13;64492;126284;41220;34;44125;50153662;41751301;500234;596;364846
FR;0;2021-09-14;73408;129116;56355;79;62180;50227070;41880417;556589;675;427026
FR;0;2021-09-15;76545;167849;55645;58;54814;50303615;42048266;612234;733;481840
FR;0;2021-09-16;63805;114560;60051;84;60056;50367420;42162826;672285;817;541896
FR;0;2021-09-17;75018;156845;53838;71;57273;50442438;42319671;726123;888;599169
FR;0;2021-09-18;48209;139612;15600;25;17297;50490647;42459283;741723;913;616466
FR;0;2021-09-19;7873;23695;2436;1;2618;50498520;42482978;744159;914;619084
FR;0;2021-09-20;44499;93892;50067;72;50314;50543019;42576870;794226;986;669398
FR;0;2021-09-21;45851;98457;62746;76;63416;50588870;42675327;856972;1062;732814
FR;0;2021-09-22;48645;142361;55357;82;55386;50637515;42817688;912329;1144;788200
FR;0;2021-09-23;43222;92057;62375;94;63517;50680737;42909745;974704;1238;851717
FR;0;2021-09-24;52266;133351;54539;107;59145;50733003;43043096;1029243;1345;910862
FR;0;2021-09-25;35203;115603;16268;36;18280;50768206;43158699;1045511;1381;929142
FR;0;2021-09-26;5533;17807;2268;5;2333;50773739;43176506;1047779;1386;931475
FR;0;2021-09-27;33940;76957;47187;97;48150;50807679;43253463;1094966;1483;979625
FR;0;2021-09-28;36483;75276;54949;89;56512;50844162;43328739;1149915;1572;1036137
FR;0;2021-09-29;44363;100811;53336;112;54837;50888525;43429550;1203251;1684;1090974
FR;0;2021-09-30;36298;72915;57031;96;59533;50924823;43502465;1260282;1780;1150507
FR;0;2021-10-01;61666;101820;57794;108;63822;50986489;43604285;1318076;1888;1214329
FR;0;2021-10-02;39448;78413;20956;39;23338;51025937;43682698;1339032;1927;1237667
FR;0;2021-10-03;5282;10507;2528;4;2539;51031219;43693205;1341560;1931;1240206
FR;0;2021-10-04;35116;58537;52614;84;54810;51066335;43751742;1394174;2015;1295016
FR;0;2021-10-05;33822;64358;60991;135;64978;51100157;43816100;1455165;2150;1359994
FR;0;2021-10-06;42668;79323;65728;113;68298;51142825;43895423;1520893;2263;1428292
FR;0;2021-10-07;30499;62216;65409;90;68762;51173324;43957639;1586302;2353;1497054
FR;0;2021-10-08;49289;91869;77740;110;84685;51222613;44049508;1664042;2463;1581739
FR;0;2021-10-09;33644;60937;31534;35;33895;51256257;44110445;1695576;2498;1615634
FR;0;2021-10-10;4694;7445;3190;9;3487;51260951;44117890;1698766;2507;1619121
FR;0;2021-10-11;30680;49906;61035;105;64068;51291631;44167796;1759801;2612;1683189
FR;0;2021-10-12;31566;54444;70592;140;75891;51323197;44222240;1830393;2752;1759080
FR;0;2021-10-13;40081;62830;74413;136;79296;51363278;44285070;1904806;2888;1838376
FR;0;2021-10-14;30292;52888;68740;116;73786;51393570;44337958;1973546;3004;1912162
FR;0;2021-10-15;44833;75288;93231;191;102955;51438403;44413246;2066777;3195;2015117
FR;0;2021-10-16;31297;44112;36688;44;39625;51469700;44457358;2103465;3239;2054742
FR;0;2021-10-17;3836;5254;3592;2;3686;51473536;44462612;2107057;3241;2058428
FR;0;2021-10-18;28698;42452;67481;133;71354;51502234;44505064;2174538;3374;2129782
FR;0;2021-10-19;27139;45447;76394;140;81640;51529373;44550511;2250932;3514;2211422
FR;0;2021-10-20;35269;52477;96930;181;101506;51564642;44602988;2347862;3695;2312928
FR;0;2021-10-21;26047;45201;83945;112;89139;51590689;44648189;2431807;3807;2402067
FR;0;2021-10-22;38333;62464;104882;200;112552;51629022;44710653;2536689;4007;2514619
FR;0;2021-10-23;26992;41231;45448;57;48613;51656014;44751884;2582137;4064;2563232
FR;0;2021-10-24;2915;4793;3680;6;3936;51658929;44756677;2585817;4070;2567168
FR;0;2021-10-25;25999;36296;82319;144;86635;51684928;44792973;2668136;4214;2653803
FR;0;2021-10-26;23708;35059;87231;166;92333;51708636;44828032;2755367;4380;2746136
FR;0;2021-10-27;30062;46404;108989;257;114672;51738698;44874436;2864356;4637;2860808
FR;0;2021-10-28;23574;34976;88684;153;94444;51762272;44909412;2953040;4790;2955252
FR;0;2021-10-29;31557;51492;117303;204;125322;51793829;44960904;3070343;4994;3080574
FR;0;2021-10-30;20546;33225;50338;76;53371;51814375;44994129;3120681;5070;3133945
FR;0;2021-10-31;2485;3741;3587;3;3874;51816860;44997870;3124268;5073;3137819
FR;0;2021-11-01;8369;4853;3210;3;3569;51825229;45002723;3127478;5076;3141388
FR;0;2021-11-02;25635;40120;93560;156;99535;51850864;45042843;3221038;5232;3240923
FR;0;2021-11-03;30033;47977;118870;218;125835;51880897;45090820;3339908;5450;3366758
FR;0;2021-11-04;23758;37541;107541;217;114387;51904655;45128361;3447449;5667;3481145
FR;0;2021-11-05;32336;52990;141622;235;151326;51936991;45181351;3589071;5902;3632471
FR;0;2021-11-06;21510;34586;64864;123;68275;51958501;45215937;3653935;6025;3700746
FR;0;2021-11-07;2390;4201;5187;6;5590;51960891;45220138;3659122;6031;3706336
FR;0;2021-11-08;20571;37812;127177;227;134269;51981462;45257950;3786299;6258;3840605
FR;0;2021-11-09;22377;44810;161666;340;172224;52003839;45302760;3947965;6598;4012829
FR;0;2021-11-10;31545;55091;186984;446;198755;52035384;45357851;4134949;7044;4211584
FR;0;2021-11-11;4560;6752;12952;28;13944;52039944;45364603;4147901;7072;4225528
FR;0;2021-11-12;29058;55157;183757;252;197344;52069002;45419760;4331658;7324;4422872
FR;0;2021-11-13;20336;32694;80688;118;86306;52089338;45452454;4412346;7442;4509178
FR;0;2021-11-14;2351;3909;7167;6;7857;52091689;45456363;4419513;7448;4517035
FR;0;2021-11-15;20459;38727;160826;313;171530;52112148;45495090;4580339;7761;4688565
FR;0;2021-11-16;23585;44013;200378;391;214980;52135733;45539103;4780717;8152;4903545
FR;0;2021-11-17;30477;50426;199828;407;212850;52166210;45589529;4980545;8559;5116395
FR;0;2021-11-18;23414;45309;191642;469;205510;52189624;45634838;5172187;9028;5321905
FR;0;2021-11-19;33640;61411;243185;549;262140;52223264;45696249;5415372;9577;5584045
FR;0;2021-11-20;25394;36728;102141;206;109694;52248658;45732977;5517513;9783;5693739
FR;0;2021-11-21;2632;4534;9647;19;10638;52251290;45737511;5527160;9802;5704377
FR;0;2021-11-22;22769;33336;180347;470;194830;52274059;45770847;5707507;10272;5899207
FR;0;2021-11-23;25634;45645;229345;548;247779;52299693;45816492;5936852;10820;6146986
FR;0;2021-11-24;31787;53807;224774;717;243193;52331480;45870299;6161626;11537;6390179
FR;0;2021-11-25;25475;49195;255896;739;277705;52356955;45919494;6417522;12276;6667884
FR;0;2021-11-26;33225;74943;379446;864;414588;52390180;45994437;6796968;13140;7082472
FR;0;2021-11-27;23417;49719;214886;389;236642;52413597;46044156;7011854;13529;7319114
FR;0;2021-11-28;3501;10550;56746;66;63328;52417098;46054706;7068600;13595;7382442
FR;0;2021-11-29;19402;54210;341434;863;371660;52436500;46108916;7410034;14458;7754102
FR;0;2021-11-30;24739;72133;457347;988;500734;52461239;46181049;7867381;15446;8254836
FR;0;2021-12-01;27253;75923;469063;1158;511306;52488492;46256972;8336444;16604;8766142
FR;0;2021-12-02;22066;71908;527070;1279;574832;52510558;46328880;8863514;17883;9340974
FR;0;2021-12-03;25525;92722;596333;1419;651116;52536083;46421602;9459847;19302;9992090
FR;0;2021-12-04;18308;60557;336201;690;369756;52554391;46482159;9796048;19992;10361846
FR;0;2021-12-05;4149;16226;95768;157;107056;52558540;46498385;9891816;20149;10468902
FR;0;2021-12-06;27118;73073;493100;1174;539888;52585658;46571458;10384916;21323;11008790
FR;0;2021-12-07;23509;91680;645328;1772;706282;52609167;46663138;11030244;23095;11715072
FR;0;2021-12-08;25467;92390;591526;1873;647447;52634634;46755528;11621770;24968;12362519
FR;0;2021-12-09;24038;94316;663053;2180;726334;52658672;46849844;12284823;27148;13088853
FR;0;2021-12-10;28027;111279;736013;2075;806137;52686699;46961123;13020836;29223;13894990
FR;0;2021-12-11;20243;76158;435159;987;480366;52706942;47037281;13455995;30210;14375356
FR;0;2021-12-12;5628;23266;142285;262;159217;52712570;47060547;13598280;30472;14534573
FR;0;2021-12-13;21328;91218;587592;1698;649228;52733898;47151765;14185872;32170;15183801
FR;0;2021-12-14;27862;118741;765477;2652;847474;52761760;47270506;14951349;34822;16031275
FR;0;2021-12-15;28390;114574;694271;2265;769036;52790150;47385080;15645620;37087;16800311
FR;0;2021-12-16;28006;116092;763976;2558;844383;52818156;47501172;16409596;39645;17644694
FR;0;2021-12-17;31614;128841;807818;2709;892034;52849770;47630013;17217414;42354;18536728
FR;0;2021-12-18;24925;81752;469939;1178;522199;52874695;47711765;17687353;43532;19058927
FR;0;2021-12-19;8754;28783;169374;376;191109;52883449;47740548;17856727;43908;19250036
FR;0;2021-12-20;31713;97566;591423;1786;658708;52915162;47838114;18448150;45694;19908744
FR;0;2021-12-21;39377;112388;682359;2389;759540;52954539;47950502;19130509;48083;20668284
FR;0;2021-12-22;39508;99671;575712;2167;642124;52994047;48050173;19706221;50250;21310408
FR;0;2021-12-23;33771;79788;440951;1653;494369;53027818;48129961;20147172;51903;21804777
FR;0;2021-12-24;10679;26162;111004;398;126661;53038497;48156123;20258176;52301;21931438
FR;0;2021-12-25;771;3543;7584;25;9033;53039268;48159666;20265760;52326;21940471
FR;0;2021-12-26;4699;11897;52086;141;60132;53043967;48171563;20317846;52467;22000603
FR;0;2021-12-27;30439;84128;453510;1365;509137;53074406;48255691;20771356;53832;22509740
FR;0;2021-12-28;38344;99114;564122;1769;632216;53112750;48354805;21335478;55601;23141956
FR;0;2021-12-29;39862;88483;501159;1686;560964;53152612;48443288;21836637;57287;23702920
FR;0;2021-12-30;35910;75339;420992;1519;471132;53188522;48518627;22257629;58806;24174052
FR;0;2021-12-31;12043;25191;116852;406;131650;53200565;48543818;22374481;59212;24305702
FR;0;2022-01-01;1461;3217;8509;37;9940;53202026;48547035;22382990;59249;24315642
FR;0;2022-01-02;6091;12991;58410;125;66937;53208117;48560026;22441400;59374;24382579
FR;0;2022-01-03;35354;90257;494780;1593;551632;53243471;48650283;22936180;60967;24934211
FR;0;2022-01-04;41540;111069;641329;2305;714298;53285011;48761352;23577509;63272;25648509
FR;0;2022-01-05;60695;103579;569100;1984;634112;53345706;48864931;24146609;65256;26282621
FR;0;2022-01-06;44201;110390;638931;2695;711411;53389907;48975321;24785540;67951;26994032
FR;0;2022-01-07;50777;123373;710951;2807;790431;53440684;49098694;25496491;70758;27784463
FR;0;2022-01-08;44993;80348;423796;1211;472871;53485677;49179042;25920287;71969;28257334
FR;0;2022-01-09;15597;26664;128554;300;145685;53501274;49205706;26048841;72269;28403019
FR;0;2022-01-10;35299;93186;469248;1810;522713;53536573;49298892;26518089;74079;28925732
FR;0;2022-01-11;41786;100566;548189;2306;608452;53578359;49399458;27066278;76385;29534184
FR;0;2022-01-12;60310;95758;452620;1966;504303;53638669;49495216;27518898;78351;30038487
FR;0;2022-01-13;38170;92559;487309;2084;540996;53676839;49587775;28006207;80435;30579483
FR;0;2022-01-14;42544;103413;568529;2286;628964;53719383;49691188;28574736;82721;31208447
FR;0;2022-01-15;39373;65905;340114;985;377559;53758756;49757093;28914850;83706;31586006
FR;0;2022-01-16;11392;19262;87408;216;99438;53770148;49776355;29002258;83922;31685444
FR;0;2022-01-17;24702;60144;320248;1381;354167;53794850;49836499;29322506;85303;32039611
FR;0;2022-01-18;28243;68754;361034;1799;397529;53823093;49905253;29683540;87102;32437140
FR;0;2022-01-19;43179;67109;281246;1451;311065;53866272;49972362;29964786;88553;32748205
FR;0;2022-01-20;23579;59622;298954;1740;328473;53889851;50031984;30263740;90293;33076678
FR;0;2022-01-21;28173;68827;366326;2087;401162;53918024;50100811;30630066;92380;33477840
FR;0;2022-01-22;27617;47985;218774;839;241753;53945641;50148796;30848840;93219;33719593
FR;0;2022-01-23;6709;13014;48662;172;55176;53952350;50161810;30897502;93391;33774769
FR;0;2022-01-24;16257;47495;217269;1138;239321;53968607;50209305;31114771;94529;34014090
FR;0;2022-01-25;18995;54428;243005;1547;267053;53987602;50263733;31357776;96076;34281143
FR;0;2022-01-26;28139;60377;209246;1297;229411;54015741;50324110;31567022;97373;34510554
FR;0;2022-01-27;16314;46204;207614;1273;225884;54032055;50370314;31774636;98646;34736438
FR;0;2022-01-28;21560;77476;290019;1573;321434;54053615;50447790;32064655;100219;35057872
FR;0;2022-01-29;18410;52832;184107;688;204577;54072025;50500622;32248762;100907;35262449
FR;0;2022-01-30;4468;14514;39133;124;45090;54076493;50515136;32287895;101031;35307539
FR;0;2022-01-31;11245;43851;148176;739;164785;54087738;50558987;32436071;101770;35472324
FR;0;2022-02-01;13339;48319;174092;1142;191386;54101077;50607306;32610163;102912;35663710
FR;0;2022-02-02;20361;66286;171500;1033;190144;54121438;50673592;32781663;103945;35853854
FR;0;2022-02-03;11365;44483;157525;987;173322;54132803;50718075;32939188;104932;36027176
FR;0;2022-02-04;14603;66528;239216;1265;264176;54147406;50784603;33178404;106197;36291352
FR;0;2022-02-05;12887;51497;153532;523;172341;54160293;50836100;33331936;106720;36463693
FR;0;2022-02-06;2712;12204;28877;101;33826;54163005;50848304;33360813;106821;36497519
FR;0;2022-02-07;9508;46747;156843;586;176322;54172513;50895051;33517656;107407;36673841
FR;0;2022-02-08;9686;42960;166579;867;184364;54182199;50938011;33684235;108274;36858205
FR;0;2022-02-09;14280;58142;172319;870;193016;54196479;50996153;33856554;109144;37051221
FR;0;2022-02-10;8513;38761;150196;877;166665;54204992;51034914;34006750;110021;37217886
FR;0;2022-02-11;10842;55606;218459;1100;243047;54215834;51090520;34225209;111121;37460933
FR;0;2022-02-12;8369;40919;134705;461;151726;54224203;51131439;34359914;111582;37612659
FR;0;2022-02-13;1897;8592;26557;85;30915;54226100;51140031;34386471;111667;37643574
FR;0;2022-02-14;6959;35195;148346;482;166341;54233059;51175226;34534817;112149;37809915
FR;0;2022-02-15;6947;35928;146943;751;162520;54240006;51211154;34681760;112900;37972435
FR;0;2022-02-16;9357;42883;132507;719;146722;54249363;51254037;34814267;113619;38119157
FR;0;2022-02-17;5482;24228;87272;585;94837;54254845;51278265;34901539;114204;38213994
FR;0;2022-02-18;6971;33515;119627;804;129291;54261816;51311780;35021166;115008;38343285
FR;0;2022-02-19;5363;24529;70017;370;77323;54267179;51336309;35091183;115378;38420608
FR;0;2022-02-20;1143;4644;12159;39;13934;54268322;51340953;35103342;115417;38434542
FR;0;2022-02-21;4077;17865;61933;351;67161;54272399;51358818;35165275;115768;38501703
FR;0;2022-02-22;4427;18602;60802;575;64435;54276826;51377420;35226077;116343;38566138
FR;0;2022-02-23;6534;27303;66478;591;71878;54283360;51404723;35292555;116934;38638016
FR;0;2022-02-24;3779;15429;50402;517;53224;54287139;51420152;35342957;117451;38691240
FR;0;2022-02-25;5239;23903;76317;803;80043;54292378;51444055;35419274;118254;38771283
FR;0;2022-02-26;3982;17758;47398;358;51463;54296360;51461813;35466672;118612;38822746
FR;0;2022-02-27;876;3000;8025;47;8936;54297236;51464813;35474697;118659;38831682
FR;0;2022-02-28;3089;12492;40464;357;42898;54300325;51477305;35515161;119016;38874580
FR;0;2022-03-01;3660;12473;44167;435;44824;54303985;51489778;35559328;119451;38919404
FR;0;2022-03-02;5218;17686;47111;442;49039;54309203;51507464;35606439;119893;38968443
FR;0;2022-03-03;2738;9254;29863;366;29980;54311941;51516718;35636302;120259;38998423
FR;0;2022-03-04;3201;12341;40280;663;39427;54315142;51529059;35676582;120922;39037850
FR;0;2022-03-05;3063;9247;24942;310;25099;54318205;51538306;35701524;121232;39062949
FR;0;2022-03-06;515;1393;3194;43;3437;54318720;51539699;35704718;121275;39066386
FR;0;2022-03-07;2205;5565;18416;315;17682;54320925;51545264;35723134;121590;39084068
FR;0;2022-03-08;2036;6002;19421;359;17886;54322961;51551266;35742555;121949;39101954
FR;0;2022-03-09;3503;10425;22167;405;21257;54326464;51561691;35764722;122354;39123211
FR;0;2022-03-10;1735;5532;16964;342;15787;54328199;51567223;35781686;122696;39138998
FR;0;2022-03-11;2358;7516;24484;539;22247;54330557;51574739;35806170;123235;39161245
FR;0;2022-03-12;2658;6766;17157;306;16511;54333215;51581505;35823327;123541;39177756
FR;0;2022-03-13;390;785;2318;146;2268;54333605;51582290;35825645;123687;39180024
FR;0;2022-03-14;1490;4229;14958;4407;13812;54335095;51586519;35840603;128094;39193836
FR;0;2022-03-15;1633;4792;16336;7550;14468;54336728;51591311;35856939;135644;39208304
FR;0;2022-03-16;2976;7239;19400;13129;18069;54339704;51598550;35876339;148773;39226373
FR;0;2022-03-17;1399;3877;13119;10841;11964;54341103;51602427;35889458;159614;39238337
FR;0;2022-03-18;2224;5681;19970;18285;18060;54343327;51608108;35909428;177899;39256397
FR;0;2022-03-19;2287;4785;13109;9397;12411;54345614;51612893;35922537;187296;39268808
FR;0;2022-03-20;296;726;1915;1072;1926;54345910;51613619;35924452;188368;39270734
FR;0;2022-03-21;1352;3193;12709;14933;11929;54347262;51616812;35937161;203301;39282663
FR;0;2022-03-22;1470;3693;13780;20522;12537;54348732;51620505;35950941;223823;39295200
FR;0;2022-03-23;2652;6173;17692;23141;17204;54351384;51626678;35968633;246964;39312404
FR;0;2022-03-24;1367;3027;11570;17580;10641;54352751;51629705;35980203;264544;39323045
FR;0;2022-03-25;2054;4942;18528;27751;16859;54354805;51634647;35998731;292295;39339904
FR;0;2022-03-26;2220;4386;12068;12677;11510;54357025;51639033;36010799;304972;39351414
FR;0;2022-03-27;356;686;1893;1480;1926;54357381;51639719;36012692;306452;39353340
FR;0;2022-03-28;1426;3036;11105;17481;10598;54358807;51642755;36023797;323933;39363938
FR;0;2022-03-29;1430;3250;12893;27550;12034;54360237;51646005;36036690;351483;39375972
FR;0;2022-03-30;2830;5412;15655;27365;15051;54363067;51651417;36052345;378848;39391023
FR;0;2022-03-31;1607;3319;12958;24954;12290;54364674;51654736;36065303;403802;39403313
FR;0;2022-04-01;2481;4540;20027;30844;18659;54367155;51659276;36085330;434646;39421972
FR;0;2022-04-02;1513;2621;9043;10106;8701;54368668;51661897;36094373;444752;39430673
FR;0;2022-04-03;284;502;1561;1166;1576;54368952;51662399;36095934;445918;39432249
FR;0;2022-04-04;1655;2717;12321;19077;11513;54370607;51665116;36108255;464995;39443762
FR;0;2022-04-05;1686;3029;14307;34036;13157;54372293;51668145;36122562;499031;39456919
FR;0;2022-04-06;2069;3759;13506;26388;12767;54374362;51671904;36136068;525419;39469686
FR;0;2022-04-07;1453;2989;13638;33704;12846;54375815;51674893;36149706;559123;39482532
FR;0;2022-04-08;2030;4150;19179;43788;17786;54377845;51679043;36168885;602911;39500318
FR;0;2022-04-09;1358;2661;9301;13548;8852;54379203;51681704;36178186;616459;39509170
FR;0;2022-04-10;284;587;1977;1995;1995;54379487;51682291;36180163;618454;39511165
FR;0;2022-04-11;1208;2513;11843;23739;11443;54380695;51684804;36192006;642193;39522608
FR;0;2022-04-12;1603;2838;13965;40715;13338;54382298;51687642;36205971;682908;39535946
FR;0;2022-04-13;1880;3516;13372;33003;12985;54384178;51691158;36219343;715911;39548931
FR;0;2022-04-14;1448;2762;13143;36163;12992;54385626;51693920;36232486;752074;39561923
FR;0;2022-04-15;1814;3391;15580;35454;14841;54387440;51697311;36248066;787528;39576764
FR;0;2022-04-16;1034;1812;6379;8521;6230;54388474;51699123;36254445;796049;39582994
FR;0;2022-04-17;190;320;991;1169;1030;54388664;51699443;36255436;797218;39584024
FR;0;2022-04-18;162;478;2760;1067;2779;54388826;51699921;36258196;798285;39586803
FR;0;2022-04-19;1492;2965;12880;29487;12405;54390318;51702886;36271076;827772;39599208
FR;0;2022-04-20;1944;3391;13265;28951;12941;54392262;51706277;36284341;856723;39612149
FR;0;2022-04-21;1484;2776;12494;34994;12511;54393746;51709053;36296835;891717;39624660
FR;0;2022-04-22;1836;3546;16440;37503;15808;54395582;51712599;36313275;929220;39640468
FR;0;2022-04-23;1136;2042;7376;10649;7227;54396718;51714641;36320651;939869;39647695
FR;0;2022-04-24;248;446;1474;1586;1408;54396966;51715087;36322125;941455;39649103
FR;0;2022-04-25;1269;2471;10670;20939;10472;54398235;51717558;36332795;962394;39659575
FR;0;2022-04-26;1578;2965;13641;38521;13086;54399813;51720523;36346436;1000915;39672661
FR;0;2022-04-27;1927;3028;11500;30891;11561;54401740;51723551;36357936;1031806;39684222
FR;0;2022-04-28;1539;2675;12498;35992;12225;54403279;51726226;36370434;1067798;39696447
FR;0;2022-04-29;1978;3748;15526;37122;14878;54405257;51729974;36385960;1104920;39711325
FR;0;2022-04-30;1200;1808;6912;9691;6741;54406457;51731782;36392872;1114611;39718066
FR;0;2022-05-01;207;314;901;994;897;54406664;51732096;36393773;1115605;39718963
FR;0;2022-05-02;1249;2584;11090;18057;10880;54407913;51734680;36404863;1133662;39729843
FR;0;2022-05-03;1799;3135;13663;34478;13504;54409712;51737815;36418526;1168140;39743347
FR;0;2022-05-04;1838;3128;12124;25505;12237;54411550;51740943;36430650;1193645;39755584
FR;0;2022-05-05;1644;2750;12987;33259;12806;54413194;51743693;36443637;1226904;39768390
FR;0;2022-05-06;2084;3574;15294;36621;14778;54415278;51747267;36458931;1263525;39783168
FR;0;2022-05-07;1189;1763;6446;9593;6433;54416467;51749030;36465377;1273118;39789601
FR;0;2022-05-08;259;393;1169;1532;1228;54416726;51749423;36466546;1274650;39790829
FR;0;2022-05-09;1270;2192;9891;20128;9758;54417996;51751615;36476437;1294778;39800587
FR;0;2022-05-10;1681;2935;13459;38724;13003;54419677;51754550;36489896;1333502;39813590
FR;0;2022-05-11;1944;2787;10685;27783;10592;54421621;51757337;36500581;1361285;39824182
FR;0;2022-05-12;1534;2565;11274;35466;10947;54423155;51759902;36511855;1396751;39835129
FR;0;2022-05-13;1950;3137;13722;37700;13300;54425105;51763039;36525577;1434451;39848429
FR;0;2022-05-14;1135;1604;5930;10764;5788;54426240;51764643;36531507;1445215;39854217
FR;0;2022-05-15;275;441;1271;1431;1347;54426515;51765084;36532778;1446646;39855564
FR;0;2022-05-16;1170;1952;8643;20896;8625;54427685;51767036;36541421;1467542;39864189
FR;0;2022-05-17;1549;2509;11782;37666;11353;54429234;51769545;36553203;1505208;39875542
FR;0;2022-05-18;1771;2553;9636;27002;9616;54431005;51772098;36562839;1532210;39885158
FR;0;2022-05-19;1404;2557;10523;35603;10631;54432409;51774655;36573362;1567813;39895789
FR;0;2022-05-20;1851;3029;13277;39266;12770;54434260;51777684;36586639;1607079;39908559
FR;0;2022-05-21;1152;1685;5648;9891;5520;54435412;51779369;36592287;1616970;39914079
FR;0;2022-05-22;236;330;1019;1427;1007;54435648;51779699;36593306;1618397;39915086
FR;0;2022-05-23;1146;2018;8858;20291;8784;54436794;51781717;36602164;1638688;39923870
FR;0;2022-05-24;1512;2704;11304;38614;11158;54438306;51784421;36613468;1677302;39935028
FR;0;2022-05-25;1791;2753;9312;24725;9431;54440097;51787174;36622780;1702027;39944459
FR;0;2022-05-26;190;345;1646;1151;1654;54440287;51787519;36624426;1703178;39946113
FR;0;2022-05-27;1358;2383;9217;21231;8960;54441645;51789902;36633643;1724409;39955073
FR;0;2022-05-28;661;1243;3903;6776;3954;54442306;51791145;36637546;1731185;39959027
FR;0;2022-05-29;149;310;745;913;764;54442455;51791455;36638291;1732098;39959791
FR;0;2022-05-30;996;1915;6968;19209;6978;54443451;51793370;36645259;1751307;39966769
FR;0;2022-05-31;1470;2413;9771;35498;9603;54444921;51795783;36655030;1786805;39976372
FR;0;2022-06-01;1610;2775;10945;24339;10790;54446531;51798558;36665975;1811144;39987162
FR;0;2022-06-02;1422;2502;11247;35395;10777;54447953;51801060;36677222;1846539;39997939
FR;0;2022-06-03;1622;2994;13322;38659;12691;54449575;51804054;36690544;1885198;40010630
FR;0;2022-06-04;945;1502;5005;9062;5074;54450520;51805556;36695549;1894260;40015704
FR;0;2022-06-05;167;322;870;1101;880;54450687;51805878;36696419;1895361;40016584
FR;0;2022-06-06;185;385;2060;1241;2033;54450872;51806263;36698479;1896602;40018617
FR;0;2022-06-07;1337;2572;9790;35514;9373;54452209;51808835;36708269;1932116;40027990
FR;0;2022-06-08;1516;2604;9110;28651;8941;54453725;51811439;36717379;1960767;40036931
FR;0;2022-06-09;1253;2370;10540;39292;10157;54454978;51813809;36727919;2000059;40047088
FR;0;2022-06-10;1577;2842;12999;44650;12549;54456555;51816651;36740918;2044709;40059637
FR;0;2022-06-11;937;1712;5418;11603;5443;54457492;51818363;36746336;2056312;40065080
FR;0;2022-06-12;188;425;1065;1753;1128;54457680;51818788;36747401;2058065;40066208
FR;0;2022-06-13;1039;1936;7383;23111;7209;54458719;51820724;36754784;2081176;40073417
FR;0;2022-06-14;1276;2410;10379;44780;9734;54459995;51823134;36765163;2125956;40083151
FR;0;2022-06-15;1442;2306;9175;30766;8800;54461437;51825440;36774338;2156722;40091951
FR;0;2022-06-16;1138;1953;9791;39706;9186;54462575;51827393;36784129;2196428;40101137
FR;0;2022-06-17;1439;2775;12396;46498;11815;54464014;51830168;36796525;2242926;40112952
FR;0;2022-06-18;832;1494;4545;11109;4478;54464846;51831662;36801070;2254035;40117430
FR;0;2022-06-19;174;347;1052;1611;1124;54465020;51832009;36802122;2255646;40118554
FR;0;2022-06-20;982;1857;8747;25955;8439;54466002;51833866;36810869;2281601;40126993
FR;0;2022-06-21;1280;2337;10239;49760;9276;54467282;51836203;36821108;2331361;40136269
FR;0;2022-06-22;1350;2407;8811;38847;8278;54468632;51838610;36829919;2370208;40144547
FR;0;2022-06-23;1188;2267;10536;54936;9734;54469820;51840877;36840455;2425144;40154281
FR;0;2022-06-24;1444;2919;13515;68930;12178;54471264;51843796;36853970;2494074;40166459
FR;0;2022-06-25;916;1754;6173;19880;5933;54472180;51845550;36860143;2513954;40172392
FR;0;2022-06-26;223;442;1901;3679;1760;54472403;51845992;36862044;2517633;40174152
FR;0;2022-06-27;1096;1984;10378;48298;9530;54473499;51847976;36872422;2565931;40183682
FR;0;2022-06-28;1431;2766;14551;91088;12980;54474930;51850742;36886973;2657019;40196662
FR;0;2022-06-29;1663;2785;12162;71560;11109;54476593;51853527;36899135;2728579;40207771
FR;0;2022-06-30;1479;2555;14180;94891;12306;54478072;51856082;36913315;2823470;40220077
FR;0;2022-07-01;1852;3277;18447;115459;15945;54479924;51859359;36931762;2938929;40236022
FR;0;2022-07-02;1035;1810;7978;35621;7175;54480959;51861169;36939740;2974550;40243197
FR;0;2022-07-03;287;512;2057;6382;1849;54481246;51861681;36941797;2980932;40245046
FR;0;2022-07-04;1448;2487;13467;78942;11747;54482694;51864168;36955264;3059874;40256793
FR;0;2022-07-05;1643;2937;17957;132415;15159;54484337;51867105;36973221;3192289;40271952
FR;0;2022-07-06;1757;2615;14950;98806;12755;54486094;51869720;36988171;3291095;40284707
FR;0;2022-07-07;1638;2747;17188;125163;14012;54487732;51872467;37005359;3416258;40298719
FR;0;2022-07-08;1815;3061;19864;136131;15899;54489547;51875528;37025223;3552389;40314618
FR;0;2022-07-09;844;1407;7519;37582;6459;54490391;51876935;37032742;3589971;40321077
FR;0;2022-07-10;243;472;2282;6932;2063;54490634;51877407;37035024;3596903;40323140
FR;0;2022-07-11;1346;2290;14187;87473;11822;54491980;51879697;37049211;3684376;40334962
FR;0;2022-07-12;1691;2937;19713;142343;15919;54493671;51882634;37068924;3826719;40350881
FR;0;2022-07-13;1634;2520;14804;93034;12455;54495305;51885154;37083728;3919753;40363336
FR;0;2022-07-14;160;276;1419;5277;1315;54495465;51885430;37085147;3925030;40364651
FR;0;2022-07-15;1384;2367;13797;83006;11373;54496849;51887797;37098944;4008036;40376024
FR;0;2022-07-16;594;1063;5440;24450;4696;54497443;51888860;37104384;4032486;40380720
FR;0;2022-07-17;162;329;1607;4455;1449;54497605;51889189;37105991;4036941;40382169
FR;0;2022-07-18;992;1941;10396;59428;8610;54498597;51891130;37116387;4096369;40390779
