fra;vaccin;jour;n_dose1;n_dose2;n_dose3;n_dose4;n_rappel;n_cum_dose1;n_cum_dose2;n_cum_dose3;n_cum_dose4;n_cum_rappel
FR;1;2020-12-27;609;0;0;0;0;609;0;0;0;0
FR;1;2020-12-28;683;1;0;0;0;1292;1;0;0;0
FR;1;2020-12-29;384;0;0;0;0;1676;1;0;0;0
FR;1;2020-12-30;443;0;0;0;0;2119;1;0;0;0
FR;1;2020-12-31;440;1;0;0;0;2559;2;0;0;0
FR;1;2021-01-01;1156;2;0;0;0;3715;4;0;0;0
FR;1;2021-01-02;362;3;0;0;0;4077;7;0;0;0
FR;1;2021-01-03;404;0;0;0;0;4481;7;0;0;0
FR;1;2021-01-04;2109;4;0;0;0;6590;11;0;0;0
FR;1;2021-01-05;7751;3;0;0;0;14341;14;0;0;0
FR;1;2021-01-06;12454;16;0;0;0;26795;30;0;0;0
FR;1;2021-01-07;29461;17;0;0;0;56256;47;0;0;0
FR;1;2021-01-08;37143;17;0;0;0;93399;64;0;0;0
FR;1;2021-01-09;11212;7;0;0;0;104611;71;0;0;0
FR;1;2021-01-10;6006;7;0;0;0;110617;78;0;0;0
FR;1;2021-01-11;39934;22;0;0;0;150551;100;0;0;0
FR;1;2021-01-12;62142;19;0;0;0;212693;119;0;0;0
FR;1;2021-01-13;65119;42;0;0;0;277812;161;0;0;0
FR;1;2021-01-14;81452;149;0;0;0;359264;310;0;0;0
FR;1;2021-01-15;68611;63;0;0;0;427875;373;0;0;0
FR;1;2021-01-16;19901;72;0;0;0;447776;445;0;0;0
FR;1;2021-01-17;10903;51;0;0;0;458679;496;0;0;0
FR;1;2021-01-18;82828;167;0;0;0;541507;663;0;0;0
FR;1;2021-01-19;125919;189;0;0;0;667426;852;0;0;0
FR;1;2021-01-20;132413;182;0;0;0;799839;1034;0;0;0
FR;1;2021-01-21;153058;174;0;0;0;952897;1208;0;0;0
FR;1;2021-01-22;115944;219;0;0;0;1068841;1427;0;0;0
FR;1;2021-01-23;36608;68;0;0;0;1105449;1495;0;0;0
FR;1;2021-01-24;9583;97;0;0;0;1115032;1592;0;0;0
FR;1;2021-01-25;74423;1337;0;0;0;1189455;2929;0;0;0
FR;1;2021-01-26;96454;3489;1;0;0;1285909;6418;1;0;0
FR;1;2021-01-27;103645;6116;0;0;0;1389554;12534;1;0;0
FR;1;2021-01-28;120603;15577;0;0;0;1510157;28111;1;0;0
FR;1;2021-01-29;88889;18175;0;0;0;1599046;46286;1;0;0
FR;1;2021-01-30;27992;4401;0;0;0;1627038;50687;1;0;0
FR;1;2021-01-31;5189;1813;0;0;0;1632227;52500;1;0;0
FR;1;2021-02-01;49725;22048;0;0;0;1681952;74548;1;0;0
FR;1;2021-02-02;67817;36811;0;0;0;1749769;111359;1;0;0
FR;1;2021-02-03;67085;38972;0;0;0;1816854;150331;1;0;0
FR;1;2021-02-04;77140;53179;0;0;0;1893994;203510;1;0;0
FR;1;2021-02-05;63420;46793;0;0;0;1957414;250303;1;0;0
FR;1;2021-02-06;19424;11069;0;0;0;1976838;261372;1;0;0
FR;1;2021-02-07;3664;5595;0;0;0;1980502;266967;1;0;0
FR;1;2021-02-08;36498;47697;0;0;0;2017000;314664;1;0;0
FR;1;2021-02-09;50799;76159;0;0;0;2067799;390823;1;0;0
FR;1;2021-02-10;52066;80871;0;0;0;2119865;471694;1;0;0
FR;1;2021-02-11;63375;103281;0;0;0;2183240;574975;1;0;0
FR;1;2021-02-12;55864;75146;0;0;0;2239104;650121;1;0;0
FR;1;2021-02-13;15463;19348;0;0;0;2254567;669469;1;0;0
FR;1;2021-02-14;3747;7347;0;0;0;2258314;676816;1;0;0
FR;1;2021-02-15;24147;73619;0;0;0;2282461;750435;1;0;0
FR;1;2021-02-16;32775;96435;0;0;0;2315236;846870;1;0;0
FR;1;2021-02-17;35122;101218;20;0;0;2350358;948088;21;0;0
FR;1;2021-02-18;49443;116883;0;0;0;2399801;1064971;21;0;0
FR;1;2021-02-19;45379;87210;1;0;0;2445180;1152181;22;0;0
FR;1;2021-02-20;13389;27170;0;0;0;2458569;1179351;22;0;0
FR;1;2021-02-21;2458;6099;0;0;0;2461027;1185450;22;0;0
FR;1;2021-02-22;24717;69588;2;0;0;2485744;1255038;24;0;0
FR;1;2021-02-23;37428;81338;1;0;0;2523172;1336376;25;0;0
FR;1;2021-02-24;40698;78867;1;0;0;2563870;1415243;26;0;0
FR;1;2021-02-25;50157;87976;1;0;0;2614027;1503219;27;0;0
FR;1;2021-02-26;47217;67600;1;0;0;2661244;1570819;28;0;0
FR;1;2021-02-27;15674;21244;1;0;0;2676918;1592063;29;0;0
FR;1;2021-02-28;3558;4175;2;0;0;2680476;1596238;31;0;0
FR;1;2021-03-01;40191;50009;1;0;0;2720667;1646247;32;0;0
FR;1;2021-03-02;55977;62257;3;0;0;2776644;1708504;35;0;0
FR;1;2021-03-03;61242;60490;0;0;0;2837886;1768994;35;0;0
FR;1;2021-03-04;72998;67367;3;0;0;2910884;1836361;38;0;0
FR;1;2021-03-05;74767;58828;3;0;0;2985651;1895189;41;0;0
FR;1;2021-03-06;82456;15878;2;0;0;3068107;1911067;43;0;0
FR;1;2021-03-07;63724;4491;1;0;0;3131831;1915558;44;0;0
FR;1;2021-03-08;60170;41559;2;0;0;3192001;1957117;46;0;0
FR;1;2021-03-09;85991;47703;1;0;0;3277992;2004820;47;0;0
FR;1;2021-03-10;90916;47958;5;0;0;3368908;2052778;52;0;0
FR;1;2021-03-11;105082;54525;1;0;0;3473990;2107303;53;0;0
FR;1;2021-03-12;104119;45033;1;0;0;3578109;2152336;54;0;0
FR;1;2021-03-13;89201;12624;1;0;0;3667310;2164960;55;0;0
FR;1;2021-03-14;44456;2792;1;0;0;3711766;2167752;56;0;0
FR;1;2021-03-15;95515;28369;3;0;0;3807281;2196121;59;0;0
FR;1;2021-03-16;123588;34331;5;0;0;3930869;2230452;64;0;0
FR;1;2021-03-17;129305;33830;4;0;0;4060174;2264282;68;0;0
FR;1;2021-03-18;142895;39383;5;0;0;4203069;2303665;73;0;0
FR;1;2021-03-19;136247;32303;2;0;0;4339316;2335968;75;0;0
FR;1;2021-03-20;76001;9861;1;0;0;4415317;2345829;76;0;0
FR;1;2021-03-21;26512;2135;1;0;0;4441829;2347964;77;0;0
FR;1;2021-03-22;114758;30610;2;0;0;4556587;2378574;79;0;0
FR;1;2021-03-23;143033;38070;1;0;0;4699620;2416644;80;0;0
FR;1;2021-03-24;142001;38485;0;0;0;4841621;2455129;80;0;0
FR;1;2021-03-25;164998;39700;4;0;0;5006619;2494829;84;0;0
FR;1;2021-03-26;166394;37502;5;1;0;5173013;2532331;89;1;0
FR;1;2021-03-27;110881;15408;1;0;0;5283894;2547739;90;1;0
FR;1;2021-03-28;42305;4212;3;0;0;5326199;2551951;93;1;0
FR;1;2021-03-29;129819;49286;4;0;0;5456018;2601237;97;1;0
FR;1;2021-03-30;167717;63737;5;0;0;5623735;2664974;102;1;0
FR;1;2021-03-31;170937;67642;4;0;0;5794672;2732616;106;1;0
FR;1;2021-04-01;194808;82617;10;0;0;5989480;2815233;116;1;0
FR;1;2021-04-02;164452;86061;7;0;0;6153932;2901294;123;1;0
FR;1;2021-04-03;88246;58089;6;0;0;6242178;2959383;129;1;0
FR;1;2021-04-04;33650;17733;0;0;0;6275828;2977116;129;1;0
FR;1;2021-04-05;46404;9800;11;0;0;6322232;2986916;140;1;0
FR;1;2021-04-06;160314;104043;17;0;0;6482546;3090959;157;1;0
FR;1;2021-04-07;196981;108077;16;0;0;6679527;3199036;173;1;0
FR;1;2021-04-08;222125;113523;13;0;0;6901652;3312559;186;1;0
FR;1;2021-04-09;214556;107824;21;0;0;7116208;3420383;207;1;0
FR;1;2021-04-10;117178;73211;14;0;0;7233386;3493594;221;1;0
FR;1;2021-04-11;40890;29987;6;0;0;7274276;3523581;227;1;0
FR;1;2021-04-12;168465;104347;46;0;0;7442741;3627928;273;1;0
FR;1;2021-04-13;203802;127927;97;1;0;7646543;3755855;370;2;0
FR;1;2021-04-14;208617;122745;207;0;0;7855160;3878600;577;2;0
FR;1;2021-04-15;221676;127699;311;0;0;8076836;4006299;888;2;0
FR;1;2021-04-16;206056;125375;308;0;0;8282892;4131674;1196;2;0
FR;1;2021-04-17;122084;67161;103;0;0;8404976;4198835;1299;2;0
FR;1;2021-04-18;35963;20960;41;0;0;8440939;4219795;1340;2;0
FR;1;2021-04-19;163746;121592;432;0;0;8604685;4341387;1772;2;0
FR;1;2021-04-20;189421;149299;531;0;0;8794106;4490686;2303;2;0
FR;1;2021-04-21;193997;147224;759;0;0;8988103;4637910;3062;2;0
FR;1;2021-04-22;209032;163788;777;0;0;9197135;4801698;3839;2;0
FR;1;2021-04-23;198953;157469;671;0;0;9396088;4959167;4510;2;0
FR;1;2021-04-24;126329;95644;148;0;0;9522417;5054811;4658;2;0
FR;1;2021-04-25;53629;30039;46;0;0;9576046;5084850;4704;2;0
FR;1;2021-04-26;181138;139281;542;0;0;9757184;5224131;5246;2;0
FR;1;2021-04-27;221361;162211;900;0;0;9978545;5386342;6146;2;0
FR;1;2021-04-28;238293;155593;1314;1;1;10216838;5541935;7460;3;1
FR;1;2021-04-29;270282;160974;1208;0;0;10487120;5702909;8668;3;1
FR;1;2021-04-30;271986;148509;1071;0;0;10759106;5851418;9739;3;1
FR;1;2021-05-01;141146;40612;173;0;0;10900252;5892030;9912;3;1
FR;1;2021-05-02;81546;28141;81;0;0;10981798;5920171;9993;3;1
FR;1;2021-05-03;250773;144021;803;0;0;11232571;6064192;10796;3;1
FR;1;2021-05-04;265870;187393;1200;0;0;11498441;6251585;11996;3;1
FR;1;2021-05-05;283870;185485;1267;0;0;11782311;6437070;13263;3;1
FR;1;2021-05-06;309957;183855;1501;0;0;12092268;6620925;14764;3;1
FR;1;2021-05-07;284088;196056;1125;0;0;12376356;6816981;15889;3;1
FR;1;2021-05-08;191658;50122;285;0;0;12568014;6867103;16174;3;1
FR;1;2021-05-09;114054;35109;236;0;0;12682068;6902212;16410;3;1
FR;1;2021-05-10;258205;194456;1186;0;0;12940273;7096668;17596;3;1
FR;1;2021-05-11;318878;210968;1465;0;0;13259151;7307636;19061;3;1
FR;1;2021-05-12;356622;185848;1399;0;0;13615773;7493484;20460;3;1
FR;1;2021-05-13;283442;47504;401;0;0;13899215;7540988;20861;3;1
FR;1;2021-05-14;370491;128513;994;0;0;14269706;7669501;21855;3;1
FR;1;2021-05-15;298086;66125;403;0;0;14567792;7735626;22258;3;1
FR;1;2021-05-16;157773;15485;158;0;0;14725565;7751111;22416;3;1
FR;1;2021-05-17;318925;116198;1439;0;0;15044490;7867309;23855;3;1
FR;1;2021-05-18;383321;111397;1798;0;0;15427811;7978706;25653;3;1
FR;1;2021-05-19;395255;102110;2181;0;0;15823066;8080816;27834;3;1
FR;1;2021-05-20;421799;95902;2047;0;0;16244865;8176718;29881;3;1
FR;1;2021-05-21;399802;97252;1764;0;0;16644667;8273970;31645;3;1
FR;1;2021-05-22;275686;41922;602;0;0;16920353;8315892;32247;3;1
FR;1;2021-05-23;123012;11041;224;0;0;17043365;8326933;32471;3;1
FR;1;2021-05-24;244008;26258;569;0;0;17287373;8353191;33040;3;1
FR;1;2021-05-25;366220;131561;2110;1;0;17653593;8484752;35150;4;1
FR;1;2021-05-26;380811;126536;1993;0;0;18034404;8611288;37143;4;1
FR;1;2021-05-27;406138;128099;1976;0;0;18440542;8739387;39119;4;1
FR;1;2021-05-28;366024;145403;1700;0;0;18806566;8884790;40819;4;1
FR;1;2021-05-29;253823;80939;527;0;0;19060389;8965729;41346;4;1
FR;1;2021-05-30;100974;22571;157;0;0;19161363;8988300;41503;4;1
FR;1;2021-05-31;314309;148928;1282;1;1;19475672;9137228;42785;5;2
FR;1;2021-06-01;361616;166517;1727;1;1;19837288;9303745;44512;6;3
FR;1;2021-06-02;365378;153732;1796;0;0;20202666;9457477;46308;6;3
FR;1;2021-06-03;391407;147517;1651;0;0;20594073;9604994;47959;6;3
FR;1;2021-06-04;364108;175631;1495;1;1;20958181;9780625;49454;7;4
FR;1;2021-06-05;258507;112684;596;0;0;21216688;9893309;50050;7;4
FR;1;2021-06-06;126801;37541;215;0;0;21343489;9930850;50265;7;4
FR;1;2021-06-07;301114;207809;1365;0;0;21644603;10138659;51630;7;4
FR;1;2021-06-08;330829;220793;1642;0;0;21975432;10359452;53272;7;4
FR;1;2021-06-09;336572;211734;1609;0;0;22312004;10571186;54881;7;4
FR;1;2021-06-10;343879;201300;1612;0;0;22655883;10772486;56493;7;4
FR;1;2021-06-11;311888;234913;1299;0;0;22967771;11007399;57792;7;4
FR;1;2021-06-12;244075;150621;435;0;0;23211846;11158020;58227;7;4
FR;1;2021-06-13;100365;60995;188;0;0;23312211;11219015;58415;7;4
FR;1;2021-06-14;207833;288107;1317;1;0;23520044;11507122;59732;8;4
FR;1;2021-06-15;256843;281688;1394;1;0;23776887;11788810;61126;9;4
FR;1;2021-06-16;273641;270564;1263;1;0;24050528;12059374;62389;10;4
FR;1;2021-06-17;268207;244834;1235;1;0;24318735;12304208;63624;11;4
FR;1;2021-06-18;260595;295458;1152;1;0;24579330;12599666;64776;12;4
FR;1;2021-06-19;193447;209500;388;0;0;24772777;12809166;65164;12;4
FR;1;2021-06-20;69703;89109;120;0;0;24842480;12898275;65284;12;4
FR;1;2021-06-21;172361;319752;933;1;1;25014841;13218027;66217;13;5
FR;1;2021-06-22;185859;347854;1100;10;1;25200700;13565881;67317;23;6
FR;1;2021-06-23;204190;339535;1049;0;0;25404890;13905416;68366;23;6
FR;1;2021-06-24;203520;282045;1173;0;0;25608410;14187461;69539;23;6
FR;1;2021-06-25;182653;371774;1197;0;0;25791063;14559235;70736;23;6
FR;1;2021-06-26;131383;278390;504;0;0;25922446;14837625;71240;23;6
FR;1;2021-06-27;52402;122899;145;0;0;25974848;14960524;71385;23;6
FR;1;2021-06-28;136651;368205;1064;0;0;26111499;15328729;72449;23;6
FR;1;2021-06-29;154880;390907;1848;0;0;26266379;15719636;74297;23;6
FR;1;2021-06-30;180046;381955;1666;4;2;26446425;16101591;75963;27;8
FR;1;2021-07-01;201466;332309;1887;5;1;26647891;16433900;77850;32;9
FR;1;2021-07-02;193885;367485;1765;5;2;26841776;16801385;79615;37;11
FR;1;2021-07-03;124471;280434;704;3;1;26966247;17081819;80319;40;12
FR;1;2021-07-04;53953;113690;244;0;0;27020200;17195509;80563;40;12
FR;1;2021-07-05;153950;355932;1500;8;2;27174150;17551441;82063;48;14
FR;1;2021-07-06;173494;382396;1602;45;8;27347644;17933837;83665;93;22
FR;1;2021-07-07;190811;362487;1657;25;4;27538455;18296324;85322;118;26
FR;1;2021-07-08;201561;323085;1826;20;6;27740016;18619409;87148;138;32
FR;1;2021-07-09;189966;387806;1853;3;2;27929982;19007215;89001;141;34
FR;1;2021-07-10;129944;281161;815;1;1;28059926;19288376;89816;142;35
FR;1;2021-07-11;57674;102532;262;0;0;28117600;19390908;90078;142;35
FR;1;2021-07-12;149878;416951;1583;4;0;28267478;19807859;91661;146;35
FR;1;2021-07-13;234261;439276;1805;8;1;28501739;20247135;93466;154;36
FR;1;2021-07-14;171904;151431;418;0;0;28673643;20398566;93884;154;36
FR;1;2021-07-15;279676;424527;1858;1;0;28953319;20823093;95742;155;36
FR;1;2021-07-16;290422;400902;1711;3;1;29243741;21223995;97453;158;37
FR;1;2021-07-17;217336;282050;754;1;0;29461077;21506045;98207;159;37
FR;1;2021-07-18;101998;107234;288;0;0;29563075;21613279;98495;159;37
FR;1;2021-07-19;238198;378775;1497;3;0;29801273;21992054;99992;162;37
FR;1;2021-07-20;305743;380292;1469;0;0;30107016;22372346;101461;162;37
FR;1;2021-07-21;333260;353057;1412;4;2;30440276;22725403;102873;166;39
FR;1;2021-07-22;364660;318920;1502;3;2;30804936;23044323;104375;169;41
FR;1;2021-07-23;349394;343226;1588;4;1;31154330;23387549;105963;173;42
FR;1;2021-07-24;238955;240835;697;1;0;31393285;23628384;106660;174;42
FR;1;2021-07-25;112799;76028;223;0;0;31506084;23704412;106883;174;42
FR;1;2021-07-26;299136;289654;1495;2;2;31805220;23994066;108378;176;44
FR;1;2021-07-27;385826;268223;1458;4;2;32191046;24262289;109836;180;46
FR;1;2021-07-28;390198;251147;1461;4;2;32581244;24513436;111297;184;48
FR;1;2021-07-29;406126;227933;1540;2;0;32987370;24741369;112837;186;48
FR;1;2021-07-30;370731;246741;1638;4;1;33358101;24988110;114475;190;49
FR;1;2021-07-31;243378;165117;793;1;0;33601479;25153227;115268;191;49
FR;1;2021-08-01;105577;47212;233;0;0;33707056;25200439;115501;191;49
FR;1;2021-08-02;297379;213020;1479;2;0;34004435;25413459;116980;193;49
FR;1;2021-08-03;331325;208896;1557;2;1;34335760;25622355;118537;195;50
FR;1;2021-08-04;328024;184093;1439;5;3;34663784;25806448;119976;200;53
FR;1;2021-08-05;301274;193313;1482;0;0;34965058;25999761;121458;200;53
FR;1;2021-08-06;290974;224302;1560;3;1;35256032;26224063;123018;203;54
FR;1;2021-08-07;182652;158807;654;4;3;35438684;26382870;123672;207;57
FR;1;2021-08-08;68886;59115;252;0;0;35507570;26441985;123924;207;57
FR;1;2021-08-09;222776;235515;1444;4;3;35730346;26677500;125368;211;60
FR;1;2021-08-10;252722;240186;1491;2;1;35983068;26917686;126859;213;61
FR;1;2021-08-11;236226;232000;1271;5;1;36219294;27149686;128130;218;62
FR;1;2021-08-12;220775;239978;1487;3;0;36440069;27389664;129617;221;62
FR;1;2021-08-13;201714;238598;1358;2;2;36641783;27628262;130975;223;64
FR;1;2021-08-14;122855;174072;646;0;0;36764638;27802334;131621;223;64
FR;1;2021-08-15;34698;46132;200;1;0;36799336;27848466;131821;224;64
FR;1;2021-08-16;156951;289588;1423;0;0;36956287;28138054;133244;224;64
FR;1;2021-08-17;171602;291230;1422;5;0;37127889;28429284;134666;229;64
FR;1;2021-08-18;161423;286838;1392;6;3;37289312;28716122;136058;235;67
FR;1;2021-08-19;148943;277572;1403;1;0;37438255;28993694;137461;236;67
FR;1;2021-08-20;140500;309085;1532;2;2;37578755;29302779;138993;238;69
FR;1;2021-08-21;84269;213210;586;0;0;37663024;29515989;139579;238;69
FR;1;2021-08-22;28572;82698;232;0;0;37691596;29598687;139811;238;69
FR;1;2021-08-23;118662;321054;1422;2;1;37810258;29919741;141233;240;70
FR;1;2021-08-24;126648;319800;1602;5;1;37936906;30239541;142835;245;71
FR;1;2021-08-25;121517;306516;1779;8;2;38058423;30546057;144614;253;73
FR;1;2021-08-26;106626;286126;2161;10;0;38165049;30832183;146775;263;73
FR;1;2021-08-27;107652;321669;2301;9;3;38272701;31153852;149076;272;76
FR;1;2021-08-28;71016;220697;1100;0;0;38343717;31374549;150176;272;76
FR;1;2021-08-29;24149;78186;469;1;0;38367866;31452735;150645;273;76
FR;1;2021-08-30;96876;286444;4312;6;5069;38464742;31739179;154957;279;5145
FR;1;2021-08-31;98100;276317;9293;15;10118;38562842;32015496;164250;294;15263
FR;1;2021-09-01;112306;245342;21113;7;22132;38675148;32260838;185363;301;37395
FR;1;2021-09-02;86749;197959;24528;18;25482;38761897;32458797;209891;319;62877
FR;1;2021-09-03;82412;227556;26953;21;28020;38844309;32686353;236844;340;90897
FR;1;2021-09-04;71626;189737;11140;11;11683;38915935;32876090;247984;351;102580
FR;1;2021-09-05;18608;41158;4124;2;4280;38934543;32917248;252108;353;106860
FR;1;2021-09-06;59560;151502;30179;15;31194;38994103;33068750;282287;368;138054
FR;1;2021-09-07;57375;139694;30208;30;31211;39051478;33208444;312495;398;169265
FR;1;2021-09-08;72318;173817;26922;22;27912;39123796;33382261;339417;420;197177
FR;1;2021-09-09;54460;124496;28619;24;29697;39178256;33506757;368036;444;226874
FR;1;2021-09-10;66167;152114;30446;24;31644;39244423;33658871;398482;468;258518
FR;1;2021-09-11;52682;146630;9730;14;10337;39297105;33805501;408212;482;268855
FR;1;2021-09-12;10793;29274;2484;1;2645;39307898;33834775;410696;483;271500
FR;1;2021-09-13;51475;104486;38744;31;40015;39359373;33939261;449440;514;311515
FR;1;2021-09-14;53301;96034;51268;66;53094;39412674;34035295;500708;580;364609
FR;1;2021-09-15;60512;139289;50484;55;47036;39473186;34174584;551192;635;411645
FR;1;2021-09-16;46598;81422;53333;70;49539;39519784;34256006;604525;705;461184
FR;1;2021-09-17;53190;109364;45066;61;42672;39572974;34365370;649591;766;503856
FR;1;2021-09-18;37859;118497;11796;19;11270;39610833;34483867;661387;785;515126
FR;1;2021-09-19;6506;21042;2038;1;1980;39617339;34504909;663425;786;517106
FR;1;2021-09-20;36489;74887;46223;65;44168;39653828;34579796;709648;851;561274
FR;1;2021-09-21;34169;68145;56257;70;52681;39687997;34647941;765905;921;613955
FR;1;2021-09-22;38811;118610;49869;76;46880;39726808;34766551;815774;997;660835
FR;1;2021-09-23;32002;62910;54495;85;50886;39758810;34829461;870269;1082;711721
FR;1;2021-09-24;36766;90081;43658;89;41917;39795576;34919542;913927;1171;753638
FR;1;2021-09-25;27644;96702;12303;27;12177;39823220;35016244;926230;1198;765815
FR;1;2021-09-26;4377;15194;1773;5;1696;39827597;35031438;928003;1203;767511
FR;1;2021-09-27;27336;60236;42905;89;41615;39854933;35091674;970908;1292;809126
FR;1;2021-09-28;26882;49469;47190;75;44445;39881815;35141143;1018098;1367;853571
FR;1;2021-09-29;35890;80362;47267;87;45571;39917705;35221505;1065365;1454;899142
FR;1;2021-09-30;26048;46888;47521;80;45435;39943753;35268393;1112886;1534;944577
FR;1;2021-10-01;47285;66946;44882;83;44581;39991038;35335339;1157768;1617;989158
FR;1;2021-10-02;32369;62417;16112;32;16316;40023407;35397756;1173880;1649;1005474
FR;1;2021-10-03;4338;8563;2038;3;2032;40027745;35406319;1175918;1652;1007506
FR;1;2021-10-04;28923;44449;47098;79;46950;40056668;35450768;1223016;1731;1054456
FR;1;2021-10-05;24517;41662;49877;116;49298;40081185;35492430;1272893;1847;1103754
FR;1;2021-10-06;34623;61398;57491;102;57207;40115808;35553828;1330384;1949;1160961
FR;1;2021-10-07;21038;39897;53034;75;51950;40136846;35593725;1383418;2024;1212911
FR;1;2021-10-08;35638;59650;60387;83;61120;40172484;35653375;1443805;2107;1274031
FR;1;2021-10-09;27444;48016;25493;29;26010;40199928;35701391;1469298;2136;1300041
FR;1;2021-10-10;3711;5811;2753;7;2860;40203639;35707202;1472051;2143;1302901
FR;1;2021-10-11;24822;38245;54579;88;55244;40228461;35745447;1526630;2231;1358145
FR;1;2021-10-12;23333;36583;58062;127;59174;40251794;35782030;1584692;2358;1417319
FR;1;2021-10-13;32913;47841;64165;124;65669;40284707;35829871;1648857;2482;1482988
FR;1;2021-10-14;21669;34798;53756;103;54341;40306376;35864669;1702613;2585;1537329
FR;1;2021-10-15;32696;48815;72320;165;74981;40339072;35913484;1774933;2750;1612310
FR;1;2021-10-16;25984;35307;34865;44;36407;40365056;35948791;1809798;2794;1648717
FR;1;2021-10-17;3108;4053;3410;2;3313;40368164;35952844;1813208;2796;1652030
FR;1;2021-10-18;24116;34894;66828;131;69698;40392280;35987738;1880036;2927;1721728
FR;1;2021-10-19;20685;35600;75650;135;79544;40412965;36023338;1955686;3062;1801272
FR;1;2021-10-20;29872;44243;96170;178;99822;40442837;36067581;2051856;3240;1901094
FR;1;2021-10-21;19768;35089;83169;107;87019;40462605;36102670;2135025;3347;1988113
FR;1;2021-10-22;29721;47780;103729;196;109665;40492326;36150450;2238754;3543;2097778
FR;1;2021-10-23;23026;35153;44866;57;47376;40515352;36185603;2283620;3600;2145154
FR;1;2021-10-24;2380;3849;3582;6;3724;40517732;36189452;2287202;3606;2148878
FR;1;2021-10-25;22413;30773;82014;143;85796;40540145;36220225;2369216;3749;2234674
FR;1;2021-10-26;19328;27674;86093;162;90307;40559473;36247899;2455309;3911;2324981
FR;1;2021-10-27;26189;39656;107796;252;112680;40585662;36287555;2563105;4163;2437661
FR;1;2021-10-28;18780;27140;86937;150;91670;40604442;36314695;2650042;4313;2529331
FR;1;2021-10-29;25924;40279;114818;201;121610;40630366;36354974;2764860;4514;2650941
FR;1;2021-10-30;17693;28727;49360;74;51944;40648059;36383701;2814220;4588;2702885
FR;1;2021-10-31;2059;3177;3447;2;3684;40650118;36386878;2817667;4590;2706569
FR;1;2021-11-01;7923;4270;3027;3;3285;40658041;36391148;2820694;4593;2709854
FR;1;2021-11-02;22817;33244;92386;156;97792;40680858;36424392;2913080;4749;2807646
FR;1;2021-11-03;26587;41607;117484;215;123851;40707445;36465999;3030564;4964;2931497
FR;1;2021-11-04;19592;30344;105796;213;111917;40727037;36496343;3136360;5177;3043414
FR;1;2021-11-05;27002;42351;138765;229;147410;40754039;36538694;3275125;5406;3190824
FR;1;2021-11-06;18840;29829;63477;123;66476;40772879;36568523;3338602;5529;3257300
FR;1;2021-11-07;1808;3292;4972;6;5301;40774687;36571815;3343574;5535;3262601
FR;1;2021-11-08;17842;32293;125987;224;132607;40792529;36604108;3469561;5759;3395208
FR;1;2021-11-09;19484;37668;159280;334;169049;40812013;36641776;3628841;6093;3564257
FR;1;2021-11-10;28856;49192;181885;440;192487;40840869;36690968;3810726;6533;3756744
FR;1;2021-11-11;4151;5952;12222;26;13021;40845020;36696920;3822948;6559;3769765
FR;1;2021-11-12;26000;46901;174798;244;186450;40871020;36743821;3997746;6803;3956215
FR;1;2021-11-13;18727;29192;76819;111;81759;40889747;36773013;4074565;6914;4037974
FR;1;2021-11-14;2041;3266;6817;5;7359;40891788;36776279;4081382;6919;4045333
FR;1;2021-11-15;18754;34824;156399;304;166212;40910542;36811103;4237781;7223;4211545
FR;1;2021-11-16;21344;37925;192099;378;204934;40931886;36849028;4429880;7601;4416479
FR;1;2021-11-17;28638;45653;193207;398;205005;40960524;36894681;4623087;7999;4621484
FR;1;2021-11-18;21124;39430;182473;458;194511;40981648;36934111;4805560;8457;4815995
FR;1;2021-11-19;30870;53443;230222;530;246689;41012518;36987554;5035782;8987;5062684
FR;1;2021-11-20;23751;33251;96975;201;103604;41036269;37020805;5132757;9188;5166288
FR;1;2021-11-21;2327;3948;9107;19;9944;41038596;37024753;5141864;9207;5176232
FR;1;2021-11-22;21405;30434;175881;465;189414;41060001;37055187;5317745;9672;5365646
FR;1;2021-11-23;24010;41101;221163;540;237895;41084011;37096288;5538908;10212;5603541
FR;1;2021-11-24;30282;49771;217321;701;234469;41114293;37146059;5756229;10913;5838010
FR;1;2021-11-25;23708;44069;244449;718;264090;41138001;37190128;6000678;11631;6102100
FR;1;2021-11-26;30616;66765;356783;834;388489;41168617;37256893;6357461;12465;6490589
FR;1;2021-11-27;21942;45387;202604;371;222612;41190559;37302280;6560065;12836;6713201
FR;1;2021-11-28;3164;9623;54779;63;61017;41193723;37311903;6614844;12899;6774218
FR;1;2021-11-29;17875;49533;326349;839;354398;41211598;37361436;6941193;13738;7128616
FR;1;2021-11-30;22783;64953;431114;952;470725;41234381;37426389;7372307;14690;7599341
FR;1;2021-12-01;25319;69352;442847;1129;481722;41259700;37495741;7815154;15819;8081063
FR;1;2021-12-02;20061;64587;489348;1228;532836;41279761;37560328;8304502;17047;8613899
FR;1;2021-12-03;22889;82572;542726;1309;591758;41302650;37642900;8847228;18356;9205657
FR;1;2021-12-04;16391;53968;299071;652;328918;41319041;37696868;9146299;19008;9534575
FR;1;2021-12-05;3632;13875;81520;143;91054;41322673;37710743;9227819;19151;9625629
FR;1;2021-12-06;25797;62694;415410;1064;455141;41348470;37773437;9643229;20215;10080770
FR;1;2021-12-07;19989;75675;522932;1535;572518;41368459;37849112;10166161;21750;10653288
FR;1;2021-12-08;21684;75788;458349;1544;502060;41390143;37924900;10624510;23294;11155348
FR;1;2021-12-09;19438;74072;492876;1625;540773;41409581;37998972;11117386;24919;11696121
FR;1;2021-12-10;23298;87757;547360;1585;599964;41432879;38086729;11664746;26504;12296085
FR;1;2021-12-11;16533;59245;302723;748;335472;41449412;38145974;11967469;27252;12631557
FR;1;2021-12-12;4361;15980;83206;179;94059;41453773;38161954;12050675;27431;12725616
FR;1;2021-12-13;15747;63750;366930;1094;406259;41469520;38225704;12417605;28525;13131875
FR;1;2021-12-14;20832;80394;464669;1745;515126;41490352;38306098;12882274;30270;13647001
FR;1;2021-12-15;21590;77559;409039;1309;453120;41511942;38383657;13291313;31579;14100121
FR;1;2021-12-16;20034;77382;451811;1578;500573;41531976;38461039;13743124;33157;14600694
FR;1;2021-12-17;22606;86728;479892;1733;530970;41554582;38547767;14223016;34890;15131664
FR;1;2021-12-18;17598;54707;257599;730;288493;41572180;38602474;14480615;35620;15420157
FR;1;2021-12-19;5550;17053;79165;194;90718;41577730;38619527;14559780;35814;15510875
FR;1;2021-12-20;20928;63192;316206;1080;355283;41598658;38682719;14875986;36894;15866158
FR;1;2021-12-21;26323;73164;372706;1422;418051;41624981;38755883;15248692;38316;16284209
FR;1;2021-12-22;24975;65971;310596;1216;349580;41649956;38821854;15559288;39532;16633789
FR;1;2021-12-23;21265;52346;241466;955;273028;41671221;38874200;15800754;40487;16906817
FR;1;2021-12-24;7121;18366;67146;258;77066;41678342;38892566;15867900;40745;16983883
FR;1;2021-12-25;506;2858;5582;15;6536;41678848;38895424;15873482;40760;16990419
FR;1;2021-12-26;2748;7588;26934;71;31458;41681596;38903012;15900416;40831;17021877
FR;1;2021-12-27;18303;53600;235096;705;265748;41699899;38956612;16135512;41536;17287625
FR;1;2021-12-28;23292;62067;292017;1026;330209;41723191;39018679;16427529;42562;17617834
FR;1;2021-12-29;22209;55573;254973;920;288192;41745400;39074252;16682502;43482;17906026
FR;1;2021-12-30;21236;46583;212147;858;239624;41766636;39120835;16894649;44340;18145650
FR;1;2021-12-31;7463;16603;61859;229;70399;41774099;39137438;16956508;44569;18216049
FR;1;2022-01-01;1074;2486;5655;30;6582;41775173;39139924;16962163;44599;18222631
FR;1;2022-01-02;3060;8056;28887;50;33525;41778233;39147980;16991050;44649;18256156
FR;1;2022-01-03;23579;54288;228218;786;257680;41801812;39202268;17219268;45435;18513836
FR;1;2022-01-04;25929;65070;299231;1239;337274;41827741;39267338;17518499;46674;18851110
FR;1;2022-01-05;30265;64314;274851;1096;310215;41858006;39331652;17793350;47770;19161325
FR;1;2022-01-06;26778;66281;306865;1398;346523;41884784;39397933;18100215;49168;19507848
FR;1;2022-01-07;31546;75046;349822;1537;393965;41916330;39472979;18450037;50705;19901813
FR;1;2022-01-08;23382;51392;222482;698;251105;41939712;39524371;18672519;51403;20152918
FR;1;2022-01-09;7077;17142;66021;163;76140;41946789;39541513;18738540;51566;20229058
FR;1;2022-01-10;21730;60746;236771;954;267613;41968519;39602259;18975311;52520;20496671
FR;1;2022-01-11;26733;63530;282264;1277;317806;41995252;39665789;19257575;53797;20814477
FR;1;2022-01-12;28891;62528;246232;1104;278020;42024143;39728317;19503807;54901;21092497
FR;1;2022-01-13;24723;60204;262778;1253;296116;42048866;39788521;19766585;56154;21388613
FR;1;2022-01-14;27946;66740;313982;1366;351249;42076812;39855261;20080567;57520;21739862
FR;1;2022-01-15;19330;44379;199300;619;223858;42096142;39899640;20279867;58139;21963720
FR;1;2022-01-16;5148;12949;51520;135;59567;42101290;39912589;20331387;58274;22023287
FR;1;2022-01-17;16843;39755;184815;780;206852;42118133;39952344;20516202;59054;22230139
FR;1;2022-01-18;19431;45982;212397;1154;237016;42137564;39998326;20728599;60208;22467155
FR;1;2022-01-19;20291;43999;176088;897;197193;42157855;40042325;20904687;61105;22664348
FR;1;2022-01-20;16773;40589;183655;1136;204728;42174628;40082914;21088342;62241;22869076
FR;1;2022-01-21;19895;47093;228939;1405;253333;42194523;40130007;21317281;63646;23122409
FR;1;2022-01-22;13836;33354;144487;578;161384;42208359;40163361;21461768;64224;23283793
FR;1;2022-01-23;3349;8766;33421;132;38320;42211708;40172127;21495189;64356;23322113
FR;1;2022-01-24;11794;33000;142193;709;158247;42223502;40205127;21637382;65065;23480360
FR;1;2022-01-25;14199;38235;163372;1048;181536;42237701;40243362;21800754;66113;23661896
FR;1;2022-01-26;14858;37663;150237;932;166328;42252559;40281025;21950991;67045;23828224
FR;1;2022-01-27;12332;33234;143442;886;157967;42264891;40314259;22094433;67931;23986191
FR;1;2022-01-28;16311;56161;198304;1145;222431;42281202;40370420;22292737;69076;24208622
FR;1;2022-01-29;10264;35435;135197;524;151539;42291466;40405855;22427934;69600;24360161
FR;1;2022-01-30;2479;9268;29680;86;34469;42293945;40415123;22457614;69686;24394630
FR;1;2022-01-31;8755;32510;104336;532;117398;42302700;40447633;22561950;70218;24512028
FR;1;2022-02-01;10812;36511;127063;863;141267;42313512;40484144;22689013;71081;24653295
FR;1;2022-02-02;11838;41597;130339;782;145858;42325350;40525741;22819352;71863;24799153
FR;1;2022-02-03;9212;34002;116999;784;130358;42334562;40559743;22936351;72647;24929511
FR;1;2022-02-04;11512;48196;172572;967;192786;42346074;40607939;23108923;73614;25122297
FR;1;2022-02-05;7989;33950;117575;391;133055;42354063;40641889;23226498;74005;25255352
FR;1;2022-02-06;1702;8013;22750;85;26914;42355765;40649902;23249248;74090;25282266
FR;1;2022-02-07;7286;35444;119077;456;134973;42363051;40685346;23368325;74546;25417239
FR;1;2022-02-08;7723;31918;125636;693;140623;42370774;40717264;23493961;75239;25557862
FR;1;2022-02-09;8603;36498;135242;696;152486;42379377;40753762;23629203;75935;25710348
FR;1;2022-02-10;6980;29917;116358;674;130141;42386357;40783679;23745561;76609;25840489
FR;1;2022-02-11;8652;41513;165127;877;185350;42395009;40825192;23910688;77486;26025839
FR;1;2022-02-12;5316;27585;106696;378;120878;42400325;40852777;24017384;77864;26146717
FR;1;2022-02-13;1227;5713;21714;65;25329;42401552;40858490;24039098;77929;26172046
FR;1;2022-02-14;5446;27200;118069;392;133096;42406998;40885690;24157167;78321;26305142
FR;1;2022-02-15;5762;28822;118905;610;132535;42412760;40914512;24276072;78931;26437677
FR;1;2022-02-16;5735;28455;110413;596;123046;42418495;40942967;24386485;79527;26560723
FR;1;2022-02-17;4605;19693;73130;487;80229;42423100;40962660;24459615;80014;26640952
FR;1;2022-02-18;5600;26752;99185;670;108142;42428700;40989412;24558800;80684;26749094
FR;1;2022-02-19;3547;17169;59473;304;66054;42432247;41006581;24618273;80988;26815148
FR;1;2022-02-20;787;3252;10701;36;12328;42433034;41009833;24628974;81024;26827476
FR;1;2022-02-21;3420;14585;52814;286;57663;42436454;41024418;24681788;81310;26885139
FR;1;2022-02-22;3784;15519;51899;500;55634;42440238;41039937;24733687;81810;26940773
FR;1;2022-02-23;4219;17790;57467;508;62568;42444457;41057727;24791154;82318;27003341
FR;1;2022-02-24;3338;13041;43609;435;46399;42447795;41070768;24834763;82753;27049740
FR;1;2022-02-25;4470;19795;64903;695;68775;42452265;41090563;24899666;83448;27118515
FR;1;2022-02-26;2692;12796;41362;310;45115;42454957;41103359;24941028;83758;27163630
FR;1;2022-02-27;644;2183;7125;42;7990;42455601;41105542;24948153;83800;27171620
FR;1;2022-02-28;2612;10455;34945;305;37371;42458213;41115997;24983098;84105;27208991
FR;1;2022-03-01;3417;10707;38691;390;39643;42461630;41126704;25021789;84495;27248634
FR;1;2022-03-02;3629;12148;41844;397;43912;42465259;41138852;25063633;84892;27292546
FR;1;2022-03-03;2435;7935;26170;326;26504;42467694;41146787;25089803;85218;27319050
FR;1;2022-03-04;2681;10402;35420;590;34913;42470375;41157189;25125223;85808;27353963
FR;1;2022-03-05;1816;6344;21961;278;22357;42472191;41163533;25147184;86086;27376320
FR;1;2022-03-06;354;951;2915;38;3118;42472545;41164484;25150099;86124;27379438
FR;1;2022-03-07;1702;4696;16427;246;15893;42474247;41169180;25166526;86370;27395331
FR;1;2022-03-08;1651;5243;17161;307;15988;42475898;41174423;25183687;86677;27411319
FR;1;2022-03-09;1952;6667;19805;368;19163;42477850;41181090;25203492;87045;27430482
FR;1;2022-03-10;1367;4763;15270;306;14309;42479217;41185853;25218762;87351;27444791
FR;1;2022-03-11;1748;6382;21699;481;19850;42480965;41192235;25240461;87832;27464641
FR;1;2022-03-12;1228;4647;15359;280;14908;42482193;41196882;25255820;88112;27479549
FR;1;2022-03-13;242;608;2117;118;2064;42482435;41197490;25257937;88230;27481613
FR;1;2022-03-14;1137;3666;13396;3878;12518;42483572;41201156;25271333;92108;27494131
FR;1;2022-03-15;1373;5692;14643;6862;13239;42484945;41206848;25285976;98970;27507370
FR;1;2022-03-16;1669;4996;17384;11517;16444;42486614;41211844;25303360;110487;27523814
FR;1;2022-03-17;1160;3423;11712;9643;10813;42487774;41215267;25315072;120130;27534627
FR;1;2022-03-18;1721;4913;17954;16490;16391;42489495;41220180;25333026;136620;27551018
FR;1;2022-03-19;1121;3296;11887;8455;11355;42490616;41223476;25344913;145075;27562373
FR;1;2022-03-20;222;556;1723;1014;1757;42490838;41224032;25346636;146089;27564130
FR;1;2022-03-21;1081;2752;11488;13448;10836;42491919;41226784;25358124;159537;27574966
FR;1;2022-03-22;1222;3204;12249;18691;11240;42493141;41229988;25370373;178228;27586206
FR;1;2022-03-23;1490;4302;16013;20109;15695;42494631;41234290;25386386;198337;27601901
FR;1;2022-03-24;1105;2736;10388;16046;9649;42495736;41237026;25396774;214383;27611550
FR;1;2022-03-25;1528;4333;16723;25294;15372;42497264;41241359;25413497;239677;27626922
FR;1;2022-03-26;1103;3009;10851;11449;10512;42498367;41244368;25424348;251126;27637434
FR;1;2022-03-27;232;542;1748;1380;1800;42498599;41244910;25426096;252506;27639234
FR;1;2022-03-28;1077;2475;9967;15882;9591;42499676;41247385;25436063;268388;27648825
FR;1;2022-03-29;1138;2734;11547;25082;10910;42500814;41250119;25447610;293470;27659735
FR;1;2022-03-30;1619;3541;14158;24167;13692;42502433;41253660;25461768;317637;27673427
FR;1;2022-03-31;1276;2991;11683;22630;11191;42503709;41256651;25473451;340267;27684618
FR;1;2022-04-01;2210;4008;18452;28500;17321;42505919;41260659;25491903;368767;27701939
FR;1;2022-04-02;907;1869;8189;9215;7935;42506826;41262528;25500092;377982;27709874
FR;1;2022-04-03;200;371;1432;1054;1433;42507026;41262899;25501524;379036;27711307
FR;1;2022-04-04;1519;2429;11357;17656;10741;42508545;41265328;25512881;396692;27722048
FR;1;2022-04-05;1391;2648;12991;31169;12014;42509936;41267976;25525872;427861;27734062
FR;1;2022-04-06;1417;2911;12186;23911;11618;42511353;41270887;25538058;451772;27745680
FR;1;2022-04-07;1228;2675;12330;31044;11795;42512581;41273562;25550388;482816;27757475
FR;1;2022-04-08;1597;3591;17542;40568;16450;42514178;41277153;25567930;523384;27773925
FR;1;2022-04-09;815;1983;8401;12492;8099;42514993;41279136;25576331;535876;27782024
FR;1;2022-04-10;193;491;1833;1849;1876;42515186;41279627;25578164;537725;27783900
FR;1;2022-04-11;1014;2222;10956;22305;10665;42516200;41281849;25589120;560030;27794565
FR;1;2022-04-12;1282;2606;12807;38090;12293;42517482;41284455;25601927;598120;27806858
FR;1;2022-04-13;1234;2815;12262;30584;11992;42518716;41287270;25614189;628704;27818850
FR;1;2022-04-14;1209;2496;12079;33553;12083;42519925;41289766;25626268;662257;27830933
FR;1;2022-04-15;1474;2920;14386;33188;13760;42521399;41292686;25640654;695445;27844693
FR;1;2022-04-16;657;1391;5839;7983;5763;42522056;41294077;25646493;703428;27850456
FR;1;2022-04-17;153;274;929;1119;971;42522209;41294351;25647422;704547;27851427
FR;1;2022-04-18;148;460;2633;998;2656;42522357;41294811;25650055;705545;27854083
FR;1;2022-04-19;1228;2576;11772;27887;11504;42523585;41297387;25661827;733432;27865587
FR;1;2022-04-20;1322;2619;12161;26811;12001;42524907;41300006;25673988;760243;27877588
FR;1;2022-04-21;1222;2442;11524;33123;11690;42526129;41302448;25685512;793366;27889278
FR;1;2022-04-22;1502;3058;15191;35463;14773;42527631;41305506;25700703;828829;27904051
FR;1;2022-04-23;756;1566;6729;9888;6635;42528387;41307072;25707432;838717;27910686
FR;1;2022-04-24;195;361;1373;1520;1326;42528582;41307433;25708805;840237;27912012
FR;1;2022-04-25;1019;2116;9849;19685;9747;42529601;41309549;25718654;859922;27921759
FR;1;2022-04-26;1334;2597;12587;36534;12194;42530935;41312146;25731241;896456;27933953
FR;1;2022-04-27;1315;2393;10639;29150;10775;42532250;41314539;25741880;925606;27944728
FR;1;2022-04-28;1263;2368;11551;34159;11389;42533513;41316907;25753431;959765;27956117
FR;1;2022-04-29;1595;3498;14389;35488;13827;42535108;41320405;25767820;995253;27969944
FR;1;2022-04-30;822;1460;6443;9162;6285;42535930;41321865;25774263;1004415;27976229
FR;1;2022-05-01;175;281;824;947;818;42536105;41322146;25775087;1005362;27977047
FR;1;2022-05-02;1182;2456;10352;16859;10246;42537287;41324602;25785439;1022221;27987293
FR;1;2022-05-03;1467;2801;12687;32818;12580;42538754;41327403;25798126;1055039;27999873
FR;1;2022-05-04;1323;2686;11210;23777;11362;42540077;41330089;25809336;1078816;28011235
FR;1;2022-05-05;1433;2520;12158;31712;12084;42541510;41332609;25821494;1110528;28023319
FR;1;2022-05-06;1750;3207;14205;34844;13772;42543260;41335816;25835699;1145372;28037091
FR;1;2022-05-07;841;1456;5972;9084;6003;42544101;41337272;25841671;1154456;28043094
FR;1;2022-05-08;186;325;1059;1469;1121;42544287;41337597;25842730;1155925;28044215
FR;1;2022-05-09;1059;1981;9232;19243;9144;42545346;41339578;25851962;1175168;28053359
FR;1;2022-05-10;1426;2719;12582;36964;12176;42546772;41342297;25864544;1212132;28065535
FR;1;2022-05-11;1413;2404;9890;25956;9817;42548185;41344701;25874434;1238088;28075352
FR;1;2022-05-12;1287;2360;10482;33484;10171;42549472;41347061;25884916;1271572;28085523
FR;1;2022-05-13;1593;2766;12744;35679;12388;42551065;41349827;25897660;1307251;28097911
FR;1;2022-05-14;775;1298;5477;10206;5359;42551840;41351125;25903137;1317457;28103270
FR;1;2022-05-15;220;392;1180;1345;1244;42552060;41351517;25904317;1318802;28104514
FR;1;2022-05-16;951;1737;8056;20058;8108;42553011;41353254;25912373;1338860;28112622
FR;1;2022-05-17;1273;2248;11110;36116;10715;42554284;41355502;25923483;1374976;28123337
FR;1;2022-05-18;1282;2092;9023;25668;8973;42555566;41357594;25932506;1400644;28132310
FR;1;2022-05-19;1176;2366;9823;33884;9918;42556742;41359960;25942329;1434528;28142228
FR;1;2022-05-20;1551;2729;12503;37620;12087;42558293;41362689;25954832;1472148;28154315
FR;1;2022-05-21;773;1360;5241;9372;5160;42559066;41364049;25960073;1481520;28159475
FR;1;2022-05-22;190;284;947;1392;947;42559256;41364333;25961020;1482912;28160422
FR;1;2022-05-23;950;1809;8362;19395;8320;42560206;41366142;25969382;1502307;28168742
FR;1;2022-05-24;1274;2423;10708;37175;10551;42561480;41368565;25980090;1539482;28179293
FR;1;2022-05-25;1260;2261;8785;23652;8943;42562740;41370826;25988875;1563134;28188236
FR;1;2022-05-26;161;348;1573;1146;1566;42562901;41371174;25990448;1564280;28189802
FR;1;2022-05-27;1100;2156;8773;20427;8523;42564001;41373330;25999221;1584707;28198325
FR;1;2022-05-28;481;1033;3684;6529;3722;42564482;41374363;26002905;1591236;28202047
FR;1;2022-05-29;118;256;706;890;716;42564600;41374619;26003611;1592126;28202763
FR;1;2022-05-30;809;1709;6555;18529;6582;42565409;41376328;26010166;1610655;28209345
FR;1;2022-05-31;1260;2184;9238;34335;9106;42566669;41378512;26019404;1644990;28218451
FR;1;2022-06-01;1278;2564;10432;23372;10295;42567947;41381076;26029836;1668362;28228746
FR;1;2022-06-02;1207;2259;10666;34053;10223;42569154;41383335;26040502;1702415;28238969
FR;1;2022-06-03;1421;2699;12690;37077;12112;42570575;41386034;26053192;1739492;28251081
FR;1;2022-06-04;680;1255;4745;8670;4821;42571255;41387289;26057937;1748162;28255902
FR;1;2022-06-05;127;283;808;1046;830;42571382;41387572;26058745;1749208;28256732
FR;1;2022-06-06;199;711;2003;1175;1996;42571581;41388283;26060748;1750383;28258728
FR;1;2022-06-07;1129;2270;9165;34011;8824;42572710;41390553;26069913;1784394;28267552
FR;1;2022-06-08;1083;2192;8660;27520;8537;42573793;41392745;26078573;1811914;28276089
FR;1;2022-06-09;1043;2113;9966;37502;9646;42574836;41394858;26088539;1849416;28285735
FR;1;2022-06-10;1316;2536;12377;43044;11950;42576152;41397394;26100916;1892460;28297685
FR;1;2022-06-11;654;1438;5138;11073;5185;42576806;41398832;26106054;1903533;28302870
FR;1;2022-06-12;150;361;1012;1680;1068;42576956;41399193;26107066;1905213;28303938
FR;1;2022-06-13;887;1764;6997;22193;6854;42577843;41400957;26114063;1927406;28310792
FR;1;2022-06-14;1076;2140;9826;42742;9228;42578919;41403097;26123889;1970148;28320020
FR;1;2022-06-15;1050;1910;8758;29357;8442;42579969;41405007;26132647;1999505;28328462
FR;1;2022-06-16;926;1786;9373;38410;8851;42580895;41406793;26142020;2037915;28337313
FR;1;2022-06-17;1203;2518;11863;44754;11350;42582098;41409311;26153883;2082669;28348663
FR;1;2022-06-18;557;1256;4311;10538;4247;42582655;41410567;26158194;2093207;28352910
FR;1;2022-06-19;137;317;1001;1541;1080;42582792;41410884;26159195;2094748;28353990
FR;1;2022-06-20;851;1671;8479;25027;8143;42583643;41412555;26167674;2119775;28362133
FR;1;2022-06-21;1091;2107;9751;47714;8840;42584734;41414662;26177425;2167489;28370973
FR;1;2022-06-22;1015;2006;8422;37079;7923;42585749;41416668;26185847;2204568;28378896
FR;1;2022-06-23;1043;2119;10114;52756;9384;42586792;41418787;26195961;2257324;28388280
FR;1;2022-06-24;1238;2683;12894;65856;11669;42588030;41421470;26208855;2323180;28399949
FR;1;2022-06-25;679;1497;5918;18912;5700;42588709;41422967;26214773;2342092;28405649
FR;1;2022-06-26;166;401;1816;3491;1707;42588875;41423368;26216589;2345583;28407356
FR;1;2022-06-27;929;1758;9892;45933;9117;42589804;41425126;26226481;2391516;28416473
FR;1;2022-06-28;1196;2553;13820;86444;12379;42591000;41427679;26240301;2477960;28428852
FR;1;2022-06-29;1223;2276;11468;67302;10536;42592223;41429955;26251769;2545262;28439388
FR;1;2022-06-30;1270;2379;13492;89917;11802;42593493;41432334;26265261;2635179;28451190
FR;1;2022-07-01;1594;3379;20098;109138;17743;42595087;41435713;26285359;2744317;28468933
FR;1;2022-07-02;754;1520;8006;33757;7243;42595841;41437233;26293365;2778074;28476176
FR;1;2022-07-03;225;478;1935;6110;1750;42596066;41437711;26295300;2784184;28477926
FR;1;2022-07-04;1215;2396;13864;75366;12255;42597281;41440107;26309164;2859550;28490181
FR;1;2022-07-05;1402;2731;17641;126188;15099;42598683;41442838;26326805;2985738;28505280
FR;1;2022-07-06;1329;2307;14850;93580;12873;42600012;41445145;26341655;3079318;28518153
FR;1;2022-07-07;1415;2489;16888;119297;13949;42601427;41447634;26358543;3198615;28532102
FR;1;2022-07-08;1512;2790;19567;129833;15940;42602939;41450424;26378110;3328448;28548042
FR;1;2022-07-09;657;1264;7294;35993;6338;42603596;41451688;26385404;3364441;28554380
FR;1;2022-07-10;233;475;2239;6681;2033;42603829;41452163;26387643;3371122;28556413
FR;1;2022-07-11;1176;2170;14296;84359;11904;42605005;41454333;26401939;3455481;28568317
FR;1;2022-07-12;1533;2737;19415;137217;15850;42606538;41457070;26421354;3592698;28584167
FR;1;2022-07-13;1381;2319;14745;89686;12589;42607919;41459389;26436099;3682384;28596756
FR;1;2022-07-14;156;298;1858;5274;1765;42608075;41459687;26437957;3687658;28598521
FR;1;2022-07-15;1247;2265;14317;80511;11970;42609322;41461952;26452274;3768169;28610491
FR;1;2022-07-16;503;1028;5624;23911;4874;42609825;41462980;26457898;3792080;28615365
FR;1;2022-07-17;155;359;1653;4449;1497;42609980;41463339;26459551;3796529;28616862
FR;1;2022-07-18;959;1971;11272;59207;9539;42610939;41465310;26470823;3855736;28626401
FR;1;2022-07-19;1216;2097;14650;99302;11684;42612155;41467407;26485473;3955038;28638085
FR;1;2022-07-20;1157;1952;12298;74275;10210;42613312;41469359;26497771;4029313;28648295
FR;1;2022-07-21;1104;1904;12366;84352;9944;42614416;41471263;26510137;4113665;28658239
FR;1;2022-07-22;1224;2170;14042;85744;11372;42615640;41473433;26524179;4199409;28669611
FR;1;2022-07-23;526;1070;5216;21271;4597;42616166;41474503;26529395;4220680;28674208
FR;1;2022-07-24;139;300;1318;3676;1161;42616305;41474803;26530713;4224356;28675369
FR;1;2022-07-25;857;1592;9057;46050;7500;42617162;41476395;26539770;4270406;28682869
FR;1;2022-07-26;1121;1938;12658;81866;10302;42618283;41478333;26552428;4352272;28693171
FR;1;2022-07-27;1010;1697;9711;58311;8092;42619293;41480030;26562139;4410583;28701263
FR;1;2022-07-28;963;1652;9813;61691;7808;42620256;41481682;26571952;4472274;28709071
FR;1;2022-07-29;1103;1759;10382;62801;8317;42621359;41483441;26582334;4535075;28717388
FR;1;2022-07-30;386;699;3331;14441;2837;42621745;41484140;26585665;4549516;28720225
FR;1;2022-07-31;135;254;894;2312;763;42621880;41484394;26586559;4551828;28720988
FR;1;2022-08-01;664;1159;7181;28884;6037;42622544;41485553;26593740;4580712;28727025
FR;1;2022-08-02;863;1433;8165;53826;6547;42623407;41486986;26601905;4634538;28733572
FR;1;2022-08-03;693;1059;6094;36969;4881;42624100;41488045;26607999;4671507;28738453
FR;1;2022-08-04;622;1045;6154;41299;4970;42624722;41489090;26614153;4712806;28743423
FR;1;2022-08-05;723;1171;6605;42911;5271;42625445;41490261;26620758;4755717;28748694
FR;1;2022-08-06;268;456;1913;8956;1589;42625713;41490717;26622671;4764673;28750283
FR;1;2022-08-07;82;139;507;1536;423;42625795;41490856;26623178;4766209;28750706
FR;1;2022-08-08;457;795;3736;21135;3063;42626252;41491651;26626914;4787344;28753769
FR;1;2022-08-09;598;995;5642;38343;4505;42626850;41492646;26632556;4825687;28758274
FR;1;2022-08-10;504;943;4350;26787;3547;42627354;41493589;26636906;4852474;28761821
FR;1;2022-08-11;529;871;4240;27994;3504;42627883;41494460;26641146;4880468;28765325
FR;1;2022-08-12;579;995;4464;27063;3653;42628462;41495455;26645610;4907531;28768978
FR;1;2022-08-13;163;332;1212;5056;1022;42628625;41495787;26646822;4912587;28770000
FR;1;2022-08-14;58;110;264;831;225;42628683;41495897;26647086;4913418;28770225
FR;1;2022-08-15;50;136;475;515;441;42628733;41496033;26647561;4913933;28770666
FR;1;2022-08-16;506;897;3719;21421;3152;42629239;41496930;26651280;4935354;28773818
FR;1;2022-08-17;505;843;3685;22013;3113;42629744;41497773;26654965;4957367;28776931
FR;1;2022-08-18;515;831;3827;25275;3027;42630259;41498604;26658792;4982642;28779958
FR;1;2022-08-19;504;998;4123;26405;3374;42630763;41499602;26662915;5009047;28783332
FR;1;2022-08-20;219;383;1244;5336;1055;42630982;41499985;26664159;5014383;28784387
FR;1;2022-08-21;77;108;269;953;241;42631059;41500093;26664428;5015336;28784628
FR;1;2022-08-22;454;835;2847;14824;2440;42631513;41500928;26667275;5030160;28787068
FR;1;2022-08-23;615;1027;4051;28135;3379;42632128;41501955;26671326;5058295;28790447
FR;1;2022-08-24;530;799;3263;18877;2624;42632658;41502754;26674589;5077172;28793071
FR;1;2022-08-25;539;869;3693;22710;3089;42633197;41503623;26678282;5099882;28796160
FR;1;2022-08-26;725;1072;4155;24883;3387;42633922;41504695;26682437;5124765;28799547
FR;1;2022-08-27;209;401;1281;5234;1136;42634131;41505096;26683718;5129999;28800683
FR;1;2022-08-28;98;132;285;859;260;42634229;41505228;26684003;5130858;28800943
FR;1;2022-08-29;478;808;2747;14026;2298;42634707;41506036;26686750;5144884;28803241
FR;1;2022-08-30;712;1053;4290;27270;3478;42635419;41507089;26691040;5172154;28806719
FR;1;2022-08-31;546;770;2866;16825;2390;42635965;41507859;26693906;5188979;28809109
FR;1;2022-09-01;591;783;3268;21138;2678;42636556;41508642;26697174;5210117;28811787
FR;1;2022-09-02;717;960;4274;27007;3476;42637273;41509602;26701448;5237124;28815263
FR;1;2022-09-03;280;443;1505;5671;1276;42637553;41510045;26702953;5242795;28816539
FR;1;2022-09-04;80;103;277;732;275;42637633;41510148;26703230;5243527;28816814
FR;2;2020-12-27;0;0;0;0;0;0;0;0;0;0
FR;2;2020-12-28;0;0;0;0;0;0;0;0;0;0
FR;2;2020-12-29;0;0;0;0;0;0;0;0;0;0
FR;2;2020-12-30;0;0;0;0;0;0;0;0;0;0
FR;2;2020-12-31;0;0;0;0;0;0;0;0;0;0
FR;2;2021-01-01;0;0;0;0;0;0;0;0;0;0
FR;2;2021-01-02;0;0;0;0;0;0;0;0;0;0
FR;2;2021-01-03;0;0;0;0;0;0;0;0;0;0
FR;2;2021-01-04;0;0;0;0;0;0;0;0;0;0
FR;2;2021-01-05;0;0;0;0;0;0;0;0;0;0
FR;2;2021-01-06;0;0;0;0;0;0;0;0;0;0
FR;2;2021-01-07;0;0;0;0;0;0;0;0;0;0
FR;2;2021-01-08;0;0;0;0;0;0;0;0;0;0
FR;2;2021-01-09;0;0;0;0;0;0;0;0;0;0
FR;2;2021-01-10;0;0;0;0;0;0;0;0;0;0
FR;2;2021-01-11;0;0;0;0;0;0;0;0;0;0
FR;2;2021-01-12;0;0;0;0;0;0;0;0;0;0
FR;2;2021-01-13;0;0;0;0;0;0;0;0;0;0
FR;2;2021-01-14;1665;0;0;0;0;1665;0;0;0;0
FR;2;2021-01-15;398;0;0;0;0;2063;0;0;0;0
FR;2;2021-01-16;316;0;0;0;0;2379;0;0;0;0
FR;2;2021-01-17;83;0;0;0;0;2462;0;0;0;0
FR;2;2021-01-18;3074;2;0;0;0;5536;2;0;0;0
FR;2;2021-01-19;4680;0;0;0;0;10216;2;0;0;0
FR;2;2021-01-20;5135;6;0;0;0;15351;8;0;0;0
FR;2;2021-01-21;5344;9;0;0;0;20695;17;0;0;0
FR;2;2021-01-22;5119;14;0;0;0;25814;31;0;0;0
FR;2;2021-01-23;1872;1;0;0;0;27686;32;0;0;0
FR;2;2021-01-24;162;2;0;0;0;27848;34;0;0;0
FR;2;2021-01-25;3814;3;0;0;0;31662;37;0;0;0
FR;2;2021-01-26;3923;5;0;0;0;35585;42;0;0;0
FR;2;2021-01-27;3601;4;0;0;0;39186;46;0;0;0
FR;2;2021-01-28;3752;8;0;0;0;42938;54;0;0;0
FR;2;2021-01-29;3295;3;0;0;0;46233;57;0;0;0
FR;2;2021-01-30;1130;3;0;0;0;47363;60;0;0;0
FR;2;2021-01-31;45;2;0;0;0;47408;62;0;0;0
FR;2;2021-02-01;3404;9;0;0;0;50812;71;0;0;0
FR;2;2021-02-02;4492;14;0;0;0;55304;85;0;0;0
FR;2;2021-02-03;5220;7;0;0;0;60524;92;0;0;0
FR;2;2021-02-04;4936;11;0;0;0;65460;103;0;0;0
FR;2;2021-02-05;4812;14;0;0;0;70272;117;0;0;0
FR;2;2021-02-06;2042;14;0;0;0;72314;131;0;0;0
FR;2;2021-02-07;102;4;0;0;0;72416;135;0;0;0
FR;2;2021-02-08;7555;23;0;0;0;79971;158;0;0;0
FR;2;2021-02-09;8425;27;0;0;0;88396;185;0;0;0
FR;2;2021-02-10;9342;58;0;0;0;97738;243;0;0;0
FR;2;2021-02-11;10287;117;0;0;0;108025;360;0;0;0
FR;2;2021-02-12;10055;267;0;0;0;118080;627;0;0;0
FR;2;2021-02-13;3120;225;0;0;0;121200;852;0;0;0
FR;2;2021-02-14;355;9;0;0;0;121555;861;0;0;0
FR;2;2021-02-15;3458;3111;0;0;0;125013;3972;0;0;0
FR;2;2021-02-16;5073;4108;0;0;0;130086;8080;0;0;0
FR;2;2021-02-17;4256;4522;0;0;0;134342;12602;0;0;0
FR;2;2021-02-18;5402;5150;0;0;0;139744;17752;0;0;0
FR;2;2021-02-19;5327;4450;0;0;0;145071;22202;0;0;0
FR;2;2021-02-20;1869;1515;0;0;0;146940;23717;0;0;0
FR;2;2021-02-21;244;95;0;0;0;147184;23812;0;0;0
FR;2;2021-02-22;3613;3766;0;0;0;150797;27578;0;0;0
FR;2;2021-02-23;4954;3720;0;0;0;155751;31298;0;0;0
FR;2;2021-02-24;5015;3522;0;0;0;160766;34820;0;0;0
FR;2;2021-02-25;5491;3470;0;0;0;166257;38290;0;0;0
FR;2;2021-02-26;4363;3167;0;0;0;170620;41457;0;0;0
FR;2;2021-02-27;1624;1058;0;0;0;172244;42515;0;0;0
FR;2;2021-02-28;178;22;0;0;0;172422;42537;0;0;0
FR;2;2021-03-01;5184;3751;0;0;0;177606;46288;0;0;0
FR;2;2021-03-02;6532;4721;0;0;0;184138;51009;0;0;0
FR;2;2021-03-03;6539;4935;0;0;0;190677;55944;0;0;0
FR;2;2021-03-04;8408;4137;0;0;0;199085;60081;0;0;0
FR;2;2021-03-05;8035;4057;0;0;0;207120;64138;0;0;0
FR;2;2021-03-06;4786;1681;0;0;0;211906;65819;0;0;0
FR;2;2021-03-07;2372;30;0;0;0;214278;65849;0;0;0
FR;2;2021-03-08;4166;8377;0;0;0;218444;74226;0;0;0
FR;2;2021-03-09;7491;8559;1;0;0;225935;82785;1;0;0
FR;2;2021-03-10;7102;9186;0;0;0;233037;91971;1;0;0
FR;2;2021-03-11;9377;9307;1;0;0;242414;101278;2;0;0
FR;2;2021-03-12;7978;8315;0;0;0;250392;109593;2;0;0
FR;2;2021-03-13;10053;2576;0;0;0;260445;112169;2;0;0
FR;2;2021-03-14;4840;385;0;0;0;265285;112554;2;0;0
FR;2;2021-03-15;10910;3472;0;0;0;276195;116026;2;0;0
FR;2;2021-03-16;16764;4670;1;0;0;292959;120696;3;0;0
FR;2;2021-03-17;20237;3990;0;0;0;313196;124686;3;0;0
FR;2;2021-03-18;23372;5049;0;0;0;336568;129735;3;0;0
FR;2;2021-03-19;23307;4630;0;0;0;359875;134365;3;0;0
FR;2;2021-03-20;25449;1585;0;0;0;385324;135950;3;0;0
FR;2;2021-03-21;17671;153;0;0;0;402995;136103;3;0;0
FR;2;2021-03-22;17786;3199;0;0;0;420781;139302;3;0;0
FR;2;2021-03-23;22694;4232;0;0;0;443475;143534;3;0;0
FR;2;2021-03-24;23958;5044;0;0;0;467433;148578;3;0;0
FR;2;2021-03-25;26750;5184;1;0;0;494183;153762;4;0;0
FR;2;2021-03-26;26982;4222;0;0;0;521165;157984;4;0;0
FR;2;2021-03-27;15920;1350;0;0;0;537085;159334;4;0;0
FR;2;2021-03-28;10561;138;0;0;0;547646;159472;4;0;0
FR;2;2021-03-29;18994;4317;0;0;0;566640;163789;4;0;0
FR;2;2021-03-30;24586;6074;0;0;0;591226;169863;4;0;0
FR;2;2021-03-31;28561;5915;0;0;0;619787;175778;4;0;0
FR;2;2021-04-01;34549;8546;1;0;0;654336;184324;5;0;0
FR;2;2021-04-02;29981;7695;0;0;0;684317;192019;5;0;0
FR;2;2021-04-03;16955;4051;0;0;0;701272;196070;5;0;0
FR;2;2021-04-04;9306;1157;2;0;0;710578;197227;7;0;0
FR;2;2021-04-05;12445;800;0;0;0;723023;198027;7;0;0
FR;2;2021-04-06;27151;7182;0;0;0;750174;205209;7;0;0
FR;2;2021-04-07;30929;7141;1;0;0;781103;212350;8;0;0
FR;2;2021-04-08;36891;8644;1;0;0;817994;220994;9;0;0
FR;2;2021-04-09;33845;8442;28;0;0;851839;229436;37;0;0
FR;2;2021-04-10;19682;9189;1;0;0;871521;238625;38;0;0
FR;2;2021-04-11;7942;4250;1;0;0;879463;242875;39;0;0
FR;2;2021-04-12;17126;11044;0;0;0;896589;253919;39;0;0
FR;2;2021-04-13;19453;16071;1;0;0;916042;269990;40;0;0
FR;2;2021-04-14;18065;16389;7;0;0;934107;286379;47;0;0
FR;2;2021-04-15;22196;21460;27;0;0;956303;307839;74;0;0
FR;2;2021-04-16;20708;20409;45;0;0;977011;328248;119;0;0
FR;2;2021-04-17;13255;22487;5;0;0;990266;350735;124;0;0
FR;2;2021-04-18;5909;14396;6;0;0;996175;365131;130;0;0
FR;2;2021-04-19;16838;16330;24;0;0;1013013;381461;154;0;0
FR;2;2021-04-20;19325;21657;38;0;0;1032338;403118;192;0;0
FR;2;2021-04-21;20290;21769;76;0;0;1052628;424887;268;0;0
FR;2;2021-04-22;23819;24904;41;0;0;1076447;449791;309;0;0
FR;2;2021-04-23;24526;25392;76;0;0;1100973;475183;385;0;0
FR;2;2021-04-24;25304;15060;104;0;0;1126277;490243;489;0;0
FR;2;2021-04-25;9595;8606;5;0;0;1135872;498849;494;0;0
FR;2;2021-04-26;17162;17437;21;0;0;1153034;516286;515;0;0
FR;2;2021-04-27;19243;24125;40;0;0;1172277;540411;555;0;0
FR;2;2021-04-28;22337;26318;112;0;0;1194614;566729;667;0;0
FR;2;2021-04-29;25471;30297;69;0;0;1220085;597026;736;0;0
FR;2;2021-04-30;25531;27874;49;1;0;1245616;624900;785;1;0
FR;2;2021-05-01;14986;9863;6;0;0;1260602;634763;791;1;0
FR;2;2021-05-02;6639;9173;2;0;0;1267241;643936;793;1;0
FR;2;2021-05-03;20016;19194;40;0;0;1287257;663130;833;1;0
FR;2;2021-05-04;18282;29109;33;0;0;1305539;692239;866;1;0
FR;2;2021-05-05;18374;29426;48;0;0;1323913;721665;914;1;0
FR;2;2021-05-06;23544;35312;131;0;0;1347457;756977;1045;1;0
FR;2;2021-05-07;25330;33220;97;0;0;1372787;790197;1142;1;0
FR;2;2021-05-08;21341;10254;14;0;0;1394128;800451;1156;1;0
FR;2;2021-05-09;13166;7744;7;0;0;1407294;808195;1163;1;0
FR;2;2021-05-10;32939;21920;49;0;0;1440233;830115;1212;1;0
FR;2;2021-05-11;43603;20976;101;0;0;1483836;851091;1313;1;0
FR;2;2021-05-12;50049;19724;143;0;0;1533885;870815;1456;1;0
FR;2;2021-05-13;51293;5676;31;0;0;1585178;876491;1487;1;0
FR;2;2021-05-14;61351;12888;132;0;0;1646529;889379;1619;1;0
FR;2;2021-05-15;65932;7125;39;0;0;1712461;896504;1658;1;0
FR;2;2021-05-16;43586;2572;10;0;0;1756047;899076;1668;1;0
FR;2;2021-05-17;44747;12507;114;0;0;1800794;911583;1782;1;0
FR;2;2021-05-18;54641;12258;191;0;0;1855435;923841;1973;1;0
FR;2;2021-05-19;57176;10554;281;0;0;1912611;934395;2254;1;0
FR;2;2021-05-20;63436;10820;288;0;0;1976047;945215;2542;1;0
FR;2;2021-05-21;64296;11631;230;0;0;2040343;956846;2772;1;0
FR;2;2021-05-22;61482;4515;65;0;0;2101825;961361;2837;1;0
FR;2;2021-05-23;37533;574;22;0;0;2139358;961935;2859;1;0
FR;2;2021-05-24;17242;2039;35;0;0;2156600;963974;2894;1;0
FR;2;2021-05-25;21110;12216;240;0;0;2177710;976190;3134;1;0
FR;2;2021-05-26;19939;11476;229;0;0;2197649;987666;3363;1;0
FR;2;2021-05-27;22997;12651;182;0;0;2220646;1000317;3545;1;0
FR;2;2021-05-28;29391;14992;190;0;0;2250037;1015309;3735;1;0
FR;2;2021-05-29;30420;8189;57;0;0;2280457;1023498;3792;1;0
FR;2;2021-05-30;4647;1815;6;0;0;2285104;1025313;3798;1;0
FR;2;2021-05-31;28590;18733;184;0;0;2313694;1044046;3982;1;0
FR;2;2021-06-01;45727;19945;224;0;0;2359421;1063991;4206;1;0
FR;2;2021-06-02;37474;19246;182;0;0;2396895;1083237;4388;1;0
FR;2;2021-06-03;51278;23209;161;0;0;2448173;1106446;4549;1;0
FR;2;2021-06-04;65512;24059;217;0;0;2513685;1130505;4766;1;0
FR;2;2021-06-05;34599;24063;52;0;0;2548284;1154568;4818;1;0
FR;2;2021-06-06;4956;6193;10;0;0;2553240;1160761;4828;1;0
FR;2;2021-06-07;28174;23023;150;0;0;2581414;1183784;4978;1;0
FR;2;2021-06-08;46375;22914;143;0;0;2627789;1206698;5121;1;0
FR;2;2021-06-09;34291;20949;107;0;0;2662080;1227647;5228;1;0
FR;2;2021-06-10;42639;19122;95;1;0;2704719;1246769;5323;2;0
FR;2;2021-06-11;55299;25173;134;0;0;2760018;1271942;5457;2;0
FR;2;2021-06-12;30561;19777;53;0;0;2790579;1291719;5510;2;0
FR;2;2021-06-13;3330;9189;13;0;0;2793909;1300908;5523;2;0
FR;2;2021-06-14;25300;24133;92;0;0;2819209;1325041;5615;2;0
FR;2;2021-06-15;39044;22838;154;0;0;2858253;1347879;5769;2;0
FR;2;2021-06-16;30162;21395;135;0;0;2888415;1369274;5904;2;0
FR;2;2021-06-17;36910;25820;150;0;0;2925325;1395094;6054;2;0
FR;2;2021-06-18;46858;28847;123;0;0;2972183;1423941;6177;2;0
FR;2;2021-06-19;24525;24898;39;0;0;2996708;1448839;6216;2;0
FR;2;2021-06-20;3741;10066;9;0;0;3000449;1458905;6225;2;0
FR;2;2021-06-21;17528;42841;88;0;0;3017977;1501746;6313;2;0
FR;2;2021-06-22;28360;49570;110;0;0;3046337;1551316;6423;2;0
FR;2;2021-06-23;21789;49585;107;1;1;3068126;1600901;6530;3;1
FR;2;2021-06-24;28376;50281;134;0;0;3096502;1651182;6664;3;1
FR;2;2021-06-25;33399;60424;128;0;0;3129901;1711606;6792;3;1
FR;2;2021-06-26;16386;59297;54;1;0;3146287;1770903;6846;4;1
FR;2;2021-06-27;2566;29313;22;1;0;3148853;1800216;6868;5;1
FR;2;2021-06-28;12640;54328;83;0;0;3161493;1854544;6951;5;1
FR;2;2021-06-29;19850;59937;178;0;0;3181343;1914481;7129;5;1
FR;2;2021-06-30;16329;57974;253;17;0;3197672;1972455;7382;22;1
FR;2;2021-07-01;20492;59875;228;0;0;3218164;2032330;7610;22;1
FR;2;2021-07-02;24074;62145;184;0;0;3242238;2094475;7794;22;1
FR;2;2021-07-03;12117;57105;153;0;0;3254355;2151580;7947;22;1
FR;2;2021-07-04;1959;23305;18;0;0;3256314;2174885;7965;22;1
FR;2;2021-07-05;9177;29347;106;0;0;3265491;2204232;8071;22;1
FR;2;2021-07-06;14580;36229;135;0;0;3280071;2240461;8206;22;1
FR;2;2021-07-07;14413;33664;139;0;0;3294484;2274125;8345;22;1
FR;2;2021-07-08;19719;40314;162;0;0;3314203;2314439;8507;22;1
FR;2;2021-07-09;27101;54299;202;1;0;3341304;2368738;8709;23;1
FR;2;2021-07-10;13386;33692;107;0;0;3354690;2402430;8816;23;1
FR;2;2021-07-11;1808;4357;16;0;0;3356498;2406787;8832;23;1
FR;2;2021-07-12;12968;37296;119;0;0;3369466;2444083;8951;23;1
FR;2;2021-07-13;37115;53176;150;0;0;3406581;2497259;9101;23;1
FR;2;2021-07-14;6623;3548;15;0;0;3413204;2500807;9116;23;1
FR;2;2021-07-15;47240;47024;156;0;0;3460444;2547831;9272;23;1
FR;2;2021-07-16;64312;55797;188;0;0;3524756;2603628;9460;23;1
FR;2;2021-07-17;31598;23924;96;0;0;3556354;2627552;9556;23;1
FR;2;2021-07-18;6088;4844;19;0;0;3562442;2632396;9575;23;1
FR;2;2021-07-19;33000;28642;94;0;0;3595442;2661038;9669;23;1
FR;2;2021-07-20;51997;44535;155;0;0;3647439;2705573;9824;23;1
FR;2;2021-07-21;45251;34705;93;0;0;3692690;2740278;9917;23;1
FR;2;2021-07-22;56279;41089;128;1;0;3748969;2781367;10045;24;1
FR;2;2021-07-23;68291;49002;170;0;0;3817260;2830369;10215;24;1
FR;2;2021-07-24;36175;21595;82;0;0;3853435;2851964;10297;24;1
FR;2;2021-07-25;6749;2626;10;0;0;3860184;2854590;10307;24;1
FR;2;2021-07-26;36312;22407;91;1;0;3896496;2876997;10398;25;1
FR;2;2021-07-27;62385;34593;180;0;0;3958881;2911590;10578;25;1
FR;2;2021-07-28;55315;26430;132;0;0;4014196;2938020;10710;25;1
FR;2;2021-07-29;68472;32802;189;0;0;4082668;2970822;10899;25;1
FR;2;2021-07-30;74459;37797;222;1;0;4157127;3008619;11121;26;1
FR;2;2021-07-31;34769;16201;104;0;0;4191896;3024820;11225;26;1
FR;2;2021-08-01;5412;2269;19;0;0;4197308;3027089;11244;26;1
FR;2;2021-08-02;35880;16191;101;0;0;4233188;3043280;11345;26;1
FR;2;2021-08-03;55982;28282;142;0;0;4289170;3071562;11487;26;1
FR;2;2021-08-04;46632;20848;128;1;0;4335802;3092410;11615;27;1
FR;2;2021-08-05;54633;31579;215;0;0;4390435;3123989;11830;27;1
FR;2;2021-08-06;58094;42396;242;1;0;4448529;3166385;12072;28;1
FR;2;2021-08-07;25145;17618;89;0;0;4473674;3184003;12161;28;1
FR;2;2021-08-08;3837;3655;21;0;0;4477511;3187658;12182;28;1
FR;2;2021-08-09;29307;21078;92;0;0;4506818;3208736;12274;28;1
FR;2;2021-08-10;45002;33488;155;0;0;4551820;3242224;12429;28;1
FR;2;2021-08-11;35273;25167;151;0;0;4587093;3267391;12580;28;1
FR;2;2021-08-12;41902;35711;162;0;0;4628995;3303102;12742;28;1
FR;2;2021-08-13;42598;37214;218;0;0;4671593;3340316;12960;28;1
FR;2;2021-08-14;18515;22193;93;0;0;4690108;3362509;13053;28;1
FR;2;2021-08-15;3851;3804;17;0;0;4693959;3366313;13070;28;1
FR;2;2021-08-16;25091;27155;111;0;0;4719050;3393468;13181;28;1
FR;2;2021-08-17;38256;43430;205;2;0;4757306;3436898;13386;30;1
FR;2;2021-08-18;32250;36369;195;1;1;4789556;3473267;13581;31;2
FR;2;2021-08-19;37434;46566;224;0;0;4826990;3519833;13805;31;2
FR;2;2021-08-20;40565;55617;269;1;0;4867555;3575450;14074;32;2
FR;2;2021-08-21;18120;24318;116;0;0;4885675;3599768;14190;32;2
FR;2;2021-08-22;2906;4325;22;1;1;4888581;3604093;14212;33;3
FR;2;2021-08-23;19248;35156;131;1;0;4907829;3639249;14343;34;3
FR;2;2021-08-24;31947;56048;236;0;0;4939776;3695297;14579;34;3
FR;2;2021-08-25;25934;43460;250;0;0;4965710;3738757;14829;34;3
FR;2;2021-08-26;32360;55817;387;0;0;4998070;3794574;15216;34;3
FR;2;2021-08-27;37001;65647;478;2;0;5035071;3860221;15694;36;3
FR;2;2021-08-28;17821;28517;300;0;0;5052892;3888738;15994;36;3
FR;2;2021-08-29;2655;5023;47;0;0;5055547;3893761;16041;36;3
FR;2;2021-08-30;18415;37743;400;0;759;5073962;3931504;16441;36;762
FR;2;2021-08-31;28076;57504;887;4;1546;5102038;3989008;17328;40;2308
FR;2;2021-09-01;21592;39863;1309;0;2114;5123630;4028871;18637;40;4422
FR;2;2021-09-02;25484;48652;1962;2;3333;5149114;4077523;20599;42;7755
FR;2;2021-09-03;33409;64530;2988;3;4861;5182523;4142053;23587;45;12616
FR;2;2021-09-04;16832;27728;1442;1;2369;5199355;4169781;25029;46;14985
FR;2;2021-09-05;2262;3608;266;0;413;5201617;4173389;25295;46;15398
FR;2;2021-09-06;14041;28713;1769;1;2942;5215658;4202102;27064;47;18340
FR;2;2021-09-07;21106;41090;3020;13;4892;5236764;4243192;30084;60;23232
FR;2;2021-09-08;17245;31934;2734;6;4494;5254009;4275126;32818;66;27726
FR;2;2021-09-09;20977;40474;4433;3;6801;5274986;4315600;37251;69;34527
FR;2;2021-09-10;28203;51237;5285;4;8896;5303189;4366837;42536;73;43423
FR;2;2021-09-11;13655;22423;2404;5;3968;5316844;4389260;44940;78;47391
FR;2;2021-09-12;1824;2781;291;0;512;5318668;4392041;45231;78;47903
FR;2;2021-09-13;11658;21435;2472;4;4025;5330326;4413476;47703;82;51928
FR;2;2021-09-14;18573;32756;5086;13;9055;5348899;4446232;52789;95;60983
FR;2;2021-09-15;14913;28263;5169;3;7767;5363812;4474495;57958;98;68750
FR;2;2021-09-16;16077;32775;6736;12;10522;5379889;4507270;64694;110;79272
FR;2;2021-09-17;20911;47119;8779;10;14592;5400800;4554389;73473;120;93864
FR;2;2021-09-18;9857;20948;3803;6;6035;5410657;4575337;77276;126;99899
FR;2;2021-09-19;1166;2611;396;0;632;5411823;4577948;77672;126;100531
FR;2;2021-09-20;7498;18743;3855;7;6147;5419321;4596691;81527;133;106678
FR;2;2021-09-21;11214;30002;6495;5;10743;5430535;4626693;88022;138;117421
FR;2;2021-09-22;9407;23540;5491;6;8522;5439942;4650233;93513;144;125943
FR;2;2021-09-23;10727;28902;7881;9;12644;5450669;4679135;101394;153;138587
FR;2;2021-09-24;15072;42922;10876;18;17228;5465741;4722057;112270;171;155815
FR;2;2021-09-25;7259;18772;3965;9;6109;5473000;4740829;116235;180;161924
FR;2;2021-09-26;1079;2549;495;0;630;5474079;4743378;116730;180;162554
FR;2;2021-09-27;6313;16420;4285;8;6532;5480392;4759798;121015;188;169086
FR;2;2021-09-28;9239;25546;7768;14;12071;5489631;4785344;128783;202;181157
FR;2;2021-09-29;8080;20202;6067;25;9257;5497711;4805546;134850;227;190414
FR;2;2021-09-30;9865;25822;9506;16;14097;5507576;4831368;144356;243;204511
FR;2;2021-10-01;13974;35718;12916;25;19299;5521550;4867086;157272;268;223810
FR;2;2021-10-02;6874;15906;4847;7;7020;5528424;4882992;162119;275;230830
FR;2;2021-10-03;841;1921;492;1;506;5529265;4884913;162611;276;231336
FR;2;2021-10-04;5824;13900;5515;5;7857;5535089;4898813;168126;281;239193
FR;2;2021-10-05;9053;22547;11121;19;15729;5544142;4921360;179247;300;254922
FR;2;2021-10-06;7783;17748;8241;11;11077;5551925;4939108;187488;311;265999
FR;2;2021-10-07;9201;22201;12381;15;16857;5561126;4961309;199869;326;282856
FR;2;2021-10-08;13429;32085;17348;27;23560;5574555;4993394;217217;353;306416
FR;2;2021-10-09;5999;12853;6042;6;7900;5580554;5006247;223259;359;314316
FR;2;2021-10-10;885;1608;436;2;615;5581439;5007855;223695;361;314931
FR;2;2021-10-11;5606;11572;6455;17;8833;5587045;5019427;230150;378;323764
FR;2;2021-10-12;8033;17781;12545;13;16766;5595078;5037208;242695;391;340530
FR;2;2021-10-13;6942;14853;10255;12;13633;5602020;5052061;252950;403;354163
FR;2;2021-10-14;8311;17934;14994;13;19457;5610331;5069995;267944;416;373620
FR;2;2021-10-15;11852;26309;20903;26;27973;5622183;5096304;288847;442;401593
FR;2;2021-10-16;5138;8738;1819;0;3214;5627321;5105042;290666;442;404807
FR;2;2021-10-17;651;1165;184;0;368;5627972;5106207;290850;442;405175
FR;2;2021-10-18;4562;7373;664;2;1646;5632534;5113580;291514;444;406821
FR;2;2021-10-19;6237;9872;730;5;2044;5638771;5123452;292244;449;408865
FR;2;2021-10-20;5169;8071;758;3;1681;5643940;5131523;293002;452;410546
FR;2;2021-10-21;6090;9966;778;5;2098;5650030;5141489;293780;457;412644
FR;2;2021-10-22;8450;14594;1148;4;2882;5658480;5156083;294928;461;415526
FR;2;2021-10-23;3845;5999;586;0;1232;5662325;5162082;295514;461;416758
FR;2;2021-10-24;494;886;100;0;204;5662819;5162968;295614;461;416962
FR;2;2021-10-25;3357;5353;306;1;828;5666176;5168321;295920;462;417790
FR;2;2021-10-26;4176;7260;1130;4;2020;5670352;5175581;297050;466;419810
FR;2;2021-10-27;3676;6609;1193;5;1995;5674028;5182190;298243;471;421805
FR;2;2021-10-28;4597;7700;1731;3;2750;5678625;5189890;299974;474;424555
FR;2;2021-10-29;5411;11085;2435;4;3673;5684036;5200975;302409;478;428228
FR;2;2021-10-30;2749;4441;975;1;1437;5686785;5205416;303384;479;429665
FR;2;2021-10-31;364;533;139;1;190;5687149;5205949;303523;480;429855
FR;2;2021-11-01;428;550;177;0;264;5687577;5206499;303700;480;430119
FR;2;2021-11-02;3293;6760;1183;0;1761;5690870;5213259;304883;480;431880
FR;2;2021-11-03;3340;6239;1386;2;1968;5694210;5219498;306269;482;433848
FR;2;2021-11-04;3986;7082;1765;4;2491;5698196;5226580;308034;486;436339
FR;2;2021-11-05;5232;10499;2867;5;3953;5703428;5237079;310901;491;440292
FR;2;2021-11-06;2594;4681;1403;0;1814;5706022;5241760;312304;491;442106
FR;2;2021-11-07;505;864;220;0;286;5706527;5242624;312524;491;442392
FR;2;2021-11-08;2578;5360;1202;3;1678;5709105;5247984;313726;494;444070
FR;2;2021-11-09;2750;6926;2399;5;3181;5711855;5254910;316125;499;447251
FR;2;2021-11-10;2588;5689;5109;6;6286;5714443;5260599;321234;505;453537
FR;2;2021-11-11;444;750;743;2;924;5714887;5261349;321977;507;454461
FR;2;2021-11-12;2953;8099;8972;8;10913;5717840;5269448;330949;515;465374
FR;2;2021-11-13;1538;3380;3868;7;4537;5719378;5272828;334817;522;469911
FR;2;2021-11-14;257;595;351;1;487;5719635;5273423;335168;523;470398
FR;2;2021-11-15;1622;3668;4445;9;5329;5721257;5277091;339613;532;475727
FR;2;2021-11-16;2184;5903;8305;14;10071;5723441;5282994;347918;546;485798
FR;2;2021-11-17;1741;4545;6627;8;7850;5725182;5287539;354545;554;493648
FR;2;2021-11-18;2192;5932;9179;10;11009;5727374;5293471;363724;564;504657
FR;2;2021-11-19;2698;7788;12971;19;15473;5730072;5301259;376695;583;520130
FR;2;2021-11-20;1565;3342;5173;5;6083;5731637;5304601;381868;588;526213
FR;2;2021-11-21;247;515;541;0;663;5731884;5305116;382409;588;526876
FR;2;2021-11-22;1278;2598;4479;5;5403;5733162;5307714;386888;593;532279
FR;2;2021-11-23;1617;4298;8197;9;9911;5734779;5312012;395085;602;542190
FR;2;2021-11-24;1418;3765;7473;14;8728;5736197;5315777;402558;616;550918
FR;2;2021-11-25;1812;4885;11467;21;13666;5738009;5320662;414025;637;564584
FR;2;2021-11-26;2540;7760;22668;31;26076;5740549;5328422;436693;668;590660
FR;2;2021-11-27;1497;4159;12270;18;14031;5742046;5332581;448963;686;604691
FR;2;2021-11-28;293;845;1970;3;2297;5742339;5333426;450933;689;606988
FR;2;2021-11-29;1446;4356;15089;23;17255;5743785;5337782;466022;712;624243
FR;2;2021-11-30;1912;6710;26237;36;29987;5745697;5344492;492259;748;654230
FR;2;2021-12-01;1912;6063;26201;31;29527;5747609;5350555;518460;779;683757
FR;2;2021-12-02;1912;6819;37709;52;41955;5749521;5357374;556169;831;725712
FR;2;2021-12-03;2552;10095;53614;111;59357;5752073;5367469;609783;942;785069
FR;2;2021-12-04;1848;6302;37114;38;40806;5753921;5373771;646897;980;825875
FR;2;2021-12-05;458;2254;14259;14;15990;5754379;5376025;661156;994;841865
FR;2;2021-12-06;2485;9887;77710;109;84767;5756864;5385912;738866;1103;926632
FR;2;2021-12-07;3455;15317;122437;238;133744;5760319;5401229;861303;1341;1060376
FR;2;2021-12-08;3724;16020;133191;330;145373;5764043;5417249;994494;1671;1205749
FR;2;2021-12-09;4548;19636;170197;554;185581;5768591;5436885;1164691;2225;1391330
FR;2;2021-12-10;4672;22844;188652;490;206127;5773263;5459729;1353343;2715;1597457
FR;2;2021-12-11;3685;16642;132440;239;144888;5776948;5476371;1485783;2954;1742345
FR;2;2021-12-12;1257;7128;59093;83;65146;5778205;5483499;1544876;3037;1807491
FR;2;2021-12-13;5526;26855;220688;605;242985;5783731;5510354;1765564;3642;2050476
FR;2;2021-12-14;7014;37488;300765;909;332217;5790745;5547842;2066329;4551;2382693
FR;2;2021-12-15;6557;36240;285218;956;315832;5797302;5584082;2351547;5507;2698525
FR;2;2021-12-16;7761;37930;312133;979;343743;5805063;5622012;2663680;6486;3042268
FR;2;2021-12-17;8680;41233;327874;976;360958;5813743;5663245;2991554;7462;3403226
FR;2;2021-12-18;6514;26561;212337;448;233647;5820257;5689806;3203891;7910;3636873
FR;2;2021-12-19;2603;11459;90209;182;100360;5822860;5701265;3294100;8092;3737233
FR;2;2021-12-20;9546;33576;275216;706;303370;5832406;5734841;3569316;8798;4040603
FR;2;2021-12-21;11564;38323;309625;968;341421;5843970;5773164;3878941;9766;4382024
FR;2;2021-12-22;10458;32820;265110;952;292475;5854428;5805984;4144051;10718;4674499
FR;2;2021-12-23;9426;26698;199499;700;221297;5863854;5832682;4343550;11418;4895796
FR;2;2021-12-24;2783;7489;43855;140;49559;5866637;5840171;4387405;11558;4945355
FR;2;2021-12-25;201;687;2002;10;2490;5866838;5840858;4389407;11568;4947845
FR;2;2021-12-26;1319;4210;25156;71;28683;5868157;5845068;4414563;11639;4976528
FR;2;2021-12-27;8077;29926;218407;659;243334;5876234;5874994;4632970;12298;5219862
FR;2;2021-12-28;9838;36324;272086;742;301981;5886072;5911318;4905056;13040;5521843
FR;2;2021-12-29;9497;32269;246131;766;272697;5895569;5943587;5151187;13806;5794540
FR;2;2021-12-30;9462;28104;208825;662;231455;5905031;5971691;5360012;14468;6025995
FR;2;2021-12-31;3010;8352;54989;176;61234;5908041;5980043;5415001;14644;6087229
FR;2;2022-01-01;227;691;2853;7;3349;5908268;5980734;5417854;14651;6090578
FR;2;2022-01-02;1504;4855;29511;75;33399;5909772;5985589;5447365;14726;6123977
FR;2;2022-01-03;9591;35408;266527;806;293897;5919363;6020997;5713892;15532;6417874
FR;2;2022-01-04;12850;45423;342084;1068;377016;5932213;6066420;6055976;16600;6794890
FR;2;2022-01-05;11272;38654;294181;884;323822;5943485;6105074;6350157;17484;7118712
FR;2;2022-01-06;13653;43507;331941;1298;364731;5957138;6148581;6682098;18782;7483443
FR;2;2022-01-07;14224;47631;361090;1270;396432;5971362;6196212;7043188;20052;7879875
FR;2;2022-01-08;7948;28152;201261;515;221707;5979310;6224364;7244449;20567;8101582
FR;2;2022-01-09;2749;8980;62524;137;69513;5982059;6233344;7306973;20704;8171095
FR;2;2022-01-10;10097;31922;232468;857;255045;5992156;6265266;7539441;21561;8426140
FR;2;2022-01-11;11469;36247;265907;1029;290595;6003625;6301513;7805348;22590;8716735
FR;2;2022-01-12;8765;29812;206319;863;226169;6012390;6331325;8011667;23453;8942904
FR;2;2022-01-13;9387;31348;224484;832;244833;6021777;6362673;8236151;24285;9187737
FR;2;2022-01-14;9742;35621;254536;920;277659;6031519;6398294;8490687;25205;9465396
FR;2;2022-01-15;5357;19448;140779;363;153635;6036876;6417742;8631466;25568;9619031
FR;2;2022-01-16;1512;5490;35883;81;39832;6038388;6423232;8667349;25649;9658863
FR;2;2022-01-17;5547;19278;135411;601;147253;6043935;6442510;8802760;26250;9806116
FR;2;2022-01-18;6421;21514;148628;648;160472;6050356;6464024;8951388;26898;9966588
FR;2;2022-01-19;4393;16330;105097;551;113701;6054749;6480354;9056485;27449;10080289
FR;2;2022-01-20;4870;17594;115292;603;123691;6059619;6497948;9171777;28052;10203980
FR;2;2022-01-21;5197;20063;137343;679;147761;6064816;6518011;9309120;28731;10351741
FR;2;2022-01-22;3030;10955;74261;260;80327;6067846;6528966;9383381;28991;10432068
FR;2;2022-01-23;724;2719;15241;41;16831;6068570;6531685;9398622;29032;10448899
FR;2;2022-01-24;3289;12824;75078;430;81038;6071859;6544509;9473700;29462;10529937
FR;2;2022-01-25;3574;14426;79624;496;85455;6075433;6558935;9553324;29958;10615392
FR;2;2022-01-26;2515;10693;58973;363;63017;6077948;6569628;9612297;30321;10678409
FR;2;2022-01-27;2680;11337;64177;388;67926;6080628;6580965;9676474;30709;10746335
FR;2;2022-01-28;3551;18314;91715;429;98927;6084179;6599279;9768189;31138;10845262
FR;2;2022-01-29;1895;9243;48850;164;52932;6086074;6608522;9817039;31302;10898194
FR;2;2022-01-30;464;2230;9454;38;10604;6086538;6610752;9826493;31340;10908798
FR;2;2022-01-31;1888;9577;43830;208;47340;6088426;6620329;9870323;31548;10956138
FR;2;2022-02-01;1916;10045;47029;279;50106;6090342;6630374;9917352;31827;11006244
FR;2;2022-02-02;1613;9008;41114;250;44165;6091955;6639382;9958466;32077;11050409
FR;2;2022-02-03;1724;8948;40521;205;42923;6093679;6648330;9998987;32282;11093332
FR;2;2022-02-04;2152;15199;66641;299;71341;6095831;6663529;10065628;32581;11164673
FR;2;2022-02-05;1360;8523;35943;132;39227;6097191;6672052;10101571;32713;11203900
FR;2;2022-02-06;275;1767;6125;16;6899;6097466;6673819;10107696;32729;11210799
FR;2;2022-02-07;1351;9576;37753;134;41300;6098817;6683395;10145449;32863;11252099
FR;2;2022-02-08;1299;9832;40952;173;43746;6100116;6693227;10186401;33036;11295845
FR;2;2022-02-09;1160;8834;37039;174;40461;6101276;6702061;10223440;33210;11336306
FR;2;2022-02-10;1027;7995;33835;204;36507;6102303;6710056;10257275;33414;11372813
FR;2;2022-02-11;1391;12083;53342;223;57693;6103694;6722139;10310617;33637;11430506
FR;2;2022-02-12;752;6533;27985;83;30804;6104446;6728672;10338602;33720;11461310
FR;2;2022-02-13;200;1340;4833;20;5574;6104646;6730012;10343435;33740;11466884
FR;2;2022-02-14;834;6728;30271;90;33230;6105480;6736740;10373706;33830;11500114
FR;2;2022-02-15;773;6471;28047;141;29991;6106253;6743211;10401753;33971;11530105
FR;2;2022-02-16;657;5361;22062;123;23627;6106910;6748572;10423815;34094;11553732
FR;2;2022-02-17;518;3780;14148;98;14615;6107428;6752352;10437963;34192;11568347
FR;2;2022-02-18;723;5367;20439;134;21128;6108151;6757719;10458402;34326;11589475
FR;2;2022-02-19;430;3054;10530;66;11244;6108581;6760773;10468932;34392;11600719
FR;2;2022-02-20;102;515;1459;3;1606;6108683;6761288;10470391;34395;11602325
FR;2;2022-02-21;422;2685;9122;65;9499;6109105;6763973;10479513;34460;11611824
FR;2;2022-02-22;390;2567;8892;76;8794;6109495;6766540;10488405;34536;11620618
FR;2;2022-02-23;431;2603;8990;82;9267;6109926;6769143;10497395;34618;11629885
FR;2;2022-02-24;314;2035;6800;81;6828;6110240;6771178;10504195;34699;11636713
FR;2;2022-02-25;457;3205;11417;108;11282;6110697;6774383;10515612;34807;11647995
FR;2;2022-02-26;296;1892;6034;49;6341;6110993;6776275;10521646;34856;11654336
FR;2;2022-02-27;76;313;907;5;950;6111069;6776588;10522553;34861;11655286
FR;2;2022-02-28;330;1688;5523;53;5531;6111399;6778276;10528076;34914;11660817
FR;2;2022-03-01;277;1564;5479;45;5196;6111676;6779840;10533555;34959;11666013
FR;2;2022-03-02;298;1442;5245;45;5089;6111974;6781282;10538800;35004;11671102
FR;2;2022-03-03;225;1111;3708;42;3485;6112199;6782393;10542508;35046;11674587
FR;2;2022-03-04;243;1468;4857;74;4505;6112442;6783861;10547365;35120;11679092
FR;2;2022-03-05;174;905;2979;32;2723;6112616;6784766;10550344;35152;11681815
FR;2;2022-03-06;42;182;279;5;319;6112658;6784948;10550623;35157;11682134
FR;2;2022-03-07;156;658;1986;70;1776;6112814;6785606;10552609;35227;11683910
FR;2;2022-03-08;144;666;2272;51;1905;6112958;6786272;10554881;35278;11685815
FR;2;2022-03-09;154;707;2346;37;2047;6113112;6786979;10557227;35315;11687862
FR;2;2022-03-10;123;603;1692;35;1467;6113235;6787582;10558919;35350;11689329
FR;2;2022-03-11;172;756;2767;57;2366;6113407;6788338;10561686;35407;11691695
FR;2;2022-03-12;149;484;1785;27;1554;6113556;6788822;10563471;35434;11693249
FR;2;2022-03-13;25;75;202;29;203;6113581;6788897;10563673;35463;11693452
FR;2;2022-03-14;128;470;1566;529;1296;6113709;6789367;10565239;35992;11694748
FR;2;2022-03-15;138;438;1711;689;1330;6113847;6789805;10566950;36681;11696078
FR;2;2022-03-16;142;475;2013;1615;1593;6113989;6790280;10568963;38296;11697671
FR;2;2022-03-17;93;413;1408;1193;1144;6114082;6790693;10570371;39489;11698815
FR;2;2022-03-18;145;494;2019;1792;1662;6114227;6791187;10572390;41281;11700477
FR;2;2022-03-19;108;321;1210;940;1015;6114335;6791508;10573600;42221;11701492
FR;2;2022-03-20;13;77;191;59;168;6114348;6791585;10573791;42280;11701660
FR;2;2022-03-21;96;306;1213;1483;1076;6114444;6791891;10575004;43763;11702736
FR;2;2022-03-22;117;388;1530;1829;1291;6114561;6792279;10576534;45592;11704027
FR;2;2022-03-23;139;361;1670;3031;1466;6114700;6792640;10578204;48623;11705493
FR;2;2022-03-24;116;293;1183;1547;1000;6114816;6792933;10579387;50170;11706493
FR;2;2022-03-25;119;361;1804;2449;1474;6114935;6793294;10581191;52619;11707967
FR;2;2022-03-26;77;247;1203;1222;952;6115012;6793541;10582394;53841;11708919
FR;2;2022-03-27;19;36;153;100;132;6115031;6793577;10582547;53941;11709051
FR;2;2022-03-28;94;287;1136;1601;995;6115125;6793864;10583683;55542;11710046
FR;2;2022-03-29;108;258;1324;2466;1104;6115233;6794122;10585007;58008;11711150
FR;2;2022-03-30;91;312;1487;3183;1319;6115324;6794434;10586494;61191;11712469
FR;2;2022-03-31;104;284;1275;2329;1089;6115428;6794718;10587769;63520;11713558
FR;2;2022-04-01;122;323;1567;2347;1322;6115550;6795041;10589336;65867;11714880
FR;2;2022-04-02;72;161;845;891;737;6115622;6795202;10590181;66758;11715617
FR;2;2022-04-03;16;53;128;113;142;6115638;6795255;10590309;66871;11715759
FR;2;2022-04-04;110;237;986;1438;795;6115748;6795492;10591295;68309;11716554
FR;2;2022-04-05;143;292;1314;2886;1141;6115891;6795784;10592609;71195;11717695
FR;2;2022-04-06;89;254;1304;2520;1127;6115980;6796038;10593913;73715;11718822
FR;2;2022-04-07;120;218;1300;2682;1040;6116100;6796256;10595213;76397;11719862
FR;2;2022-04-08;125;336;1629;3267;1323;6116225;6796592;10596842;79664;11721185
FR;2;2022-04-09;90;219;899;1045;731;6116315;6796811;10597741;80709;11721916
FR;2;2022-04-10;37;48;143;162;119;6116352;6796859;10597884;80871;11722035
FR;2;2022-04-11;88;193;886;1531;776;6116440;6797052;10598770;82402;11722811
FR;2;2022-04-12;176;268;1179;2738;1058;6116616;6797320;10599949;85140;11723869
FR;2;2022-04-13;146;230;1124;2453;986;6116762;6797550;10601073;87593;11724855
FR;2;2022-04-14;115;222;1085;2674;917;6116877;6797772;10602158;90267;11725772
FR;2;2022-04-15;114;247;1213;2285;1067;6116991;6798019;10603371;92552;11726839
FR;2;2022-04-16;67;108;548;549;459;6117058;6798127;10603919;93101;11727298
FR;2;2022-04-17;15;26;57;53;53;6117073;6798153;10603976;93154;11727351
FR;2;2022-04-18;12;35;120;70;115;6117085;6798188;10604096;93224;11727466
FR;2;2022-04-19;112;237;1117;1707;949;6117197;6798425;10605213;94931;11728415
FR;2;2022-04-20;95;240;1105;2156;931;6117292;6798665;10606318;97087;11729346
FR;2;2022-04-21;111;231;981;1910;837;6117403;6798896;10607299;98997;11730183
FR;2;2022-04-22;98;272;1242;2086;1023;6117501;6799168;10608541;101083;11731206
FR;2;2022-04-23;67;156;644;762;573;6117568;6799324;10609185;101845;11731779
FR;2;2022-04-24;12;29;101;68;79;6117580;6799353;10609286;101913;11731858
FR;2;2022-04-25;103;203;820;1314;710;6117683;6799556;10610106;103227;11732568
FR;2;2022-04-26;108;183;1041;1999;878;6117791;6799739;10611147;105226;11733446
FR;2;2022-04-27;97;177;860;1783;763;6117888;6799916;10612007;107009;11734209
FR;2;2022-04-28;92;214;948;1913;842;6117980;6800130;10612955;108922;11735051
FR;2;2022-04-29;81;280;1129;1691;1039;6118061;6800410;10614084;110613;11736090
FR;2;2022-04-30;65;126;470;538;429;6118126;6800536;10614554;111151;11736519
FR;2;2022-05-01;22;24;84;48;85;6118148;6800560;10614638;111199;11736604
FR;2;2022-05-02;116;226;762;1206;660;6118264;6800786;10615400;112405;11737264
FR;2;2022-05-03;148;228;998;1767;937;6118412;6801014;10616398;114172;11738201
FR;2;2022-05-04;90;222;923;1809;866;6118502;6801236;10617321;115981;11739067
FR;2;2022-05-05;127;196;851;1697;768;6118629;6801432;10618172;117678;11739835
FR;2;2022-05-06;133;245;1098;1848;1012;6118762;6801677;10619270;119526;11740847
FR;2;2022-05-07;40;98;470;504;406;6118802;6801775;10619740;120030;11741253
FR;2;2022-05-08;45;53;106;70;100;6118847;6801828;10619846;120100;11741353
FR;2;2022-05-09;101;174;654;984;604;6118948;6802002;10620500;121084;11741957
FR;2;2022-05-10;120;247;938;1830;893;6119068;6802249;10621438;122914;11742850
FR;2;2022-05-11;100;172;811;1871;791;6119168;6802421;10622249;124785;11743641
FR;2;2022-05-12;111;171;843;2093;801;6119279;6802592;10623092;126878;11744442
FR;2;2022-05-13;100;232;967;2090;896;6119379;6802824;10624059;128968;11745338
FR;2;2022-05-14;76;117;451;554;409;6119455;6802941;10624510;129522;11745747
FR;2;2022-05-15;24;39;94;87;108;6119479;6802980;10624604;129609;11745855
FR;2;2022-05-16;103;170;599;923;537;6119582;6803150;10625203;130532;11746392
FR;2;2022-05-17;95;184;689;1685;657;6119677;6803334;10625892;132217;11747049
FR;2;2022-05-18;80;180;640;1431;645;6119757;6803514;10626532;133648;11747694
FR;2;2022-05-19;70;160;708;1831;750;6119827;6803674;10627240;135479;11748444
FR;2;2022-05-20;107;178;872;1699;777;6119934;6803852;10628112;137178;11749221
FR;2;2022-05-21;48;96;397;517;338;6119982;6803948;10628509;137695;11749559
FR;2;2022-05-22;8;23;69;37;57;6119990;6803971;10628578;137732;11749616
FR;2;2022-05-23;85;132;498;930;469;6120075;6804103;10629076;138662;11750085
FR;2;2022-05-24;87;161;625;1611;613;6120162;6804264;10629701;140273;11750698
FR;2;2022-05-25;71;145;538;1145;492;6120233;6804409;10630239;141418;11751190
FR;2;2022-05-26;10;31;77;42;85;6120243;6804440;10630316;141460;11751275
FR;2;2022-05-27;44;122;456;817;438;6120287;6804562;10630772;142277;11751713
FR;2;2022-05-28;28;60;221;244;221;6120315;6804622;10630993;142521;11751934
FR;2;2022-05-29;13;34;43;25;51;6120328;6804656;10631036;142546;11751985
FR;2;2022-05-30;65;108;418;721;404;6120393;6804764;10631454;143267;11752389
FR;2;2022-05-31;76;135;563;1276;510;6120469;6804899;10632017;144543;11752899
FR;2;2022-06-01;59;154;559;1074;538;6120528;6805053;10632576;145617;11753437
FR;2;2022-06-02;92;172;624;1400;589;6120620;6805225;10633200;147017;11754026
FR;2;2022-06-03;71;155;666;1604;593;6120691;6805380;10633866;148621;11754619
FR;2;2022-06-04;68;93;281;433;268;6120759;6805473;10634147;149054;11754887
FR;2;2022-06-05;12;17;62;57;47;6120771;6805490;10634209;149111;11754934
FR;2;2022-06-06;11;31;92;75;92;6120782;6805521;10634301;149186;11755026
FR;2;2022-06-07;98;218;664;1531;576;6120880;6805739;10634965;150717;11755602
FR;2;2022-06-08;70;118;475;1165;411;6120950;6805857;10635440;151882;11756013
FR;2;2022-06-09;93;164;611;1921;568;6121043;6806021;10636051;153803;11756581
FR;2;2022-06-10;88;166;650;1682;621;6121131;6806187;10636701;155485;11757202
FR;2;2022-06-11;42;83;286;528;258;6121173;6806270;10636987;156013;11757460
FR;2;2022-06-12;18;38;58;78;60;6121191;6806308;10637045;156091;11757520
FR;2;2022-06-13;39;118;390;948;375;6121230;6806426;10637435;157039;11757895
FR;2;2022-06-14;65;154;599;2087;536;6121295;6806580;10638034;159126;11758431
FR;2;2022-06-15;76;104;520;1500;444;6121371;6806684;10638554;160626;11758875
FR;2;2022-06-16;127;127;495;1411;422;6121498;6806811;10639049;162037;11759297
FR;2;2022-06-17;72;134;586;1815;513;6121570;6806945;10639635;163852;11759810
FR;2;2022-06-18;75;92;224;578;196;6121645;6807037;10639859;164430;11760006
FR;2;2022-06-19;11;14;53;71;41;6121656;6807051;10639912;164501;11760047
FR;2;2022-06-20;62;124;400;1027;391;6121718;6807175;10640312;165528;11760438
FR;2;2022-06-21;107;115;524;2122;453;6121825;6807290;10640836;167650;11760891
FR;2;2022-06-22;39;106;461;1889;414;6121864;6807396;10641297;169539;11761305
FR;2;2022-06-23;56;108;536;2281;451;6121920;6807504;10641833;171820;11761756
FR;2;2022-06-24;66;122;708;3198;570;6121986;6807626;10642541;175018;11762326
FR;2;2022-06-25;30;90;295;986;251;6122016;6807716;10642836;176004;11762577
FR;2;2022-06-26;30;27;131;194;97;6122046;6807743;10642967;176198;11762674
FR;2;2022-06-27;79;136;580;2472;481;6122125;6807879;10643547;178670;11763155
FR;2;2022-06-28;110;140;812;4814;650;6122235;6808019;10644359;183484;11763805
FR;2;2022-06-29;71;149;775;4387;636;6122306;6808168;10645134;187871;11764441
FR;2;2022-06-30;72;133;832;5176;618;6122378;6808301;10645966;193047;11765059
FR;2;2022-07-01;112;157;1148;6691;846;6122490;6808458;10647114;199738;11765905
FR;2;2022-07-02;67;131;473;1973;391;6122557;6808589;10647587;201711;11766296
FR;2;2022-07-03;23;30;144;334;128;6122580;6808619;10647731;202045;11766424
FR;2;2022-07-04;119;176;776;3773;610;6122699;6808795;10648507;205818;11767034
FR;2;2022-07-05;117;184;1119;6810;825;6122816;6808979;10649626;212628;11767859
FR;2;2022-07-06;92;148;947;5800;693;6122908;6809127;10650573;218428;11768552
FR;2;2022-07-07;81;184;1020;6495;748;6122989;6809311;10651593;224923;11769300
FR;2;2022-07-08;64;122;1092;7031;754;6123053;6809433;10652685;231954;11770054
FR;2;2022-07-09;34;61;417;1869;298;6123087;6809494;10653102;233823;11770352
FR;2;2022-07-10;6;17;96;313;82;6123093;6809511;10653198;234136;11770434
FR;2;2022-07-11;68;119;681;3814;539;6123161;6809630;10653879;237950;11770973
FR;2;2022-07-12;99;178;1051;6505;807;6123260;6809808;10654930;244455;11771780
FR;2;2022-07-13;63;125;879;4651;585;6123323;6809933;10655809;249106;11772365
FR;2;2022-07-14;6;12;87;248;58;6123329;6809945;10655896;249354;11772423
FR;2;2022-07-15;60;126;739;3787;559;6123389;6810071;10656635;253141;11772982
FR;2;2022-07-16;27;54;287;1029;240;6123416;6810125;10656922;254170;11773222
FR;2;2022-07-17;5;12;77;201;66;6123421;6810137;10656999;254371;11773288
FR;2;2022-07-18;56;103;514;2507;384;6123477;6810240;10657513;256878;11773672
FR;2;2022-07-19;66;132;768;4247;554;6123543;6810372;10658281;261125;11774226
FR;2;2022-07-20;57;118;579;3177;429;6123600;6810490;10658860;264302;11774655
FR;2;2022-07-21;60;109;671;3677;485;6123660;6810599;10659531;267979;11775140
FR;2;2022-07-22;51;97;696;3518;503;6123711;6810696;10660227;271497;11775643
FR;2;2022-07-23;39;95;290;1169;229;6123750;6810791;10660517;272666;11775872
FR;2;2022-07-24;14;23;68;201;67;6123764;6810814;10660585;272867;11775939
FR;2;2022-07-25;49;69;401;1923;296;6123813;6810883;10660986;274790;11776235
FR;2;2022-07-26;59;133;602;3421;474;6123872;6811016;10661588;278211;11776709
FR;2;2022-07-27;42;81;454;2777;358;6123914;6811097;10662042;280988;11777067
FR;2;2022-07-28;29;75;447;2438;355;6123943;6811172;10662489;283426;11777422
FR;2;2022-07-29;67;87;531;2854;344;6124010;6811259;10663020;286280;11777766
FR;2;2022-07-30;21;37;162;774;110;6124031;6811296;10663182;287054;11777876
FR;2;2022-07-31;6;13;27;104;21;6124037;6811309;10663209;287158;11777897
FR;2;2022-08-01;35;101;320;1260;256;6124072;6811410;10663529;288418;11778153
FR;2;2022-08-02;49;73;324;2053;246;6124121;6811483;10663853;290471;11778399
FR;2;2022-08-03;28;52;253;1610;185;6124149;6811535;10664106;292081;11778584
FR;2;2022-08-04;39;63;301;1685;237;6124188;6811598;10664407;293766;11778821
FR;2;2022-08-05;32;93;323;1878;233;6124220;6811691;10664730;295644;11779054
FR;2;2022-08-06;21;40;105;365;81;6124241;6811731;10664835;296009;11779135
FR;2;2022-08-07;7;8;14;69;16;6124248;6811739;10664849;296078;11779151
FR;2;2022-08-08;16;34;213;874;141;6124264;6811773;10665062;296952;11779292
FR;2;2022-08-09;27;51;278;1471;238;6124291;6811824;10665340;298423;11779530
FR;2;2022-08-10;15;21;210;1123;147;6124306;6811845;10665550;299546;11779677
FR;2;2022-08-11;20;41;171;1022;114;6124326;6811886;10665721;300568;11779791
FR;2;2022-08-12;36;45;179;1028;136;6124362;6811931;10665900;301596;11779927
FR;2;2022-08-13;8;17;40;149;46;6124370;6811948;10665940;301745;11779973
FR;2;2022-08-14;1;2;12;52;11;6124371;6811950;10665952;301797;11779984
FR;2;2022-08-15;0;3;24;22;14;6124371;6811953;10665976;301819;11779998
FR;2;2022-08-16;24;31;142;672;118;6124395;6811984;10666118;302491;11780116
FR;2;2022-08-17;16;26;107;738;87;6124411;6812010;10666225;303229;11780203
FR;2;2022-08-18;14;28;153;835;103;6124425;6812038;10666378;304064;11780306
FR;2;2022-08-19;8;38;112;694;82;6124433;6812076;10666490;304758;11780388
FR;2;2022-08-20;6;25;52;192;43;6124439;6812101;10666542;304950;11780431
FR;2;2022-08-21;4;14;15;19;13;6124443;6812115;10666557;304969;11780444
FR;2;2022-08-22;10;23;111;395;69;6124453;6812138;10666668;305364;11780513
FR;2;2022-08-23;11;40;134;664;112;6124464;6812178;10666802;306028;11780625
FR;2;2022-08-24;9;22;78;445;68;6124473;6812200;10666880;306473;11780693
FR;2;2022-08-25;5;29;103;475;62;6124478;6812229;10666983;306948;11780755
FR;2;2022-08-26;14;42;114;718;87;6124492;6812271;10667097;307666;11780842
FR;2;2022-08-27;10;17;45;156;40;6124502;6812288;10667142;307822;11780882
FR;2;2022-08-28;1;4;5;15;6;6124503;6812292;10667147;307837;11780888
FR;2;2022-08-29;24;41;85;399;79;6124527;6812333;10667232;308236;11780967
FR;2;2022-08-30;29;51;141;759;109;6124556;6812384;10667373;308995;11781076
FR;2;2022-08-31;18;34;81;390;75;6124574;6812418;10667454;309385;11781151
FR;2;2022-09-01;19;37;102;564;74;6124593;6812455;10667556;309949;11781225
FR;2;2022-09-02;28;50;129;684;97;6124621;6812505;10667685;310633;11781322
FR;2;2022-09-03;9;20;74;203;58;6124630;6812525;10667759;310836;11781380
FR;2;2022-09-04;4;5;9;31;10;6124634;6812530;10667768;310867;11781390
FR;3;2020-12-27;0;0;0;0;0;0;0;0;0;0
FR;3;2020-12-28;0;0;0;0;0;0;0;0;0;0
FR;3;2020-12-29;0;0;0;0;0;0;0;0;0;0
FR;3;2020-12-30;0;0;0;0;0;0;0;0;0;0
FR;3;2020-12-31;0;0;0;0;0;0;0;0;0;0
FR;3;2021-01-01;0;0;0;0;0;0;0;0;0;0
FR;3;2021-01-02;0;0;0;0;0;0;0;0;0;0
FR;3;2021-01-03;0;0;0;0;0;0;0;0;0;0
FR;3;2021-01-04;0;0;0;0;0;0;0;0;0;0
FR;3;2021-01-05;0;0;0;0;0;0;0;0;0;0
FR;3;2021-01-06;0;0;0;0;0;0;0;0;0;0
FR;3;2021-01-07;0;0;0;0;0;0;0;0;0;0
FR;3;2021-01-08;0;0;0;0;0;0;0;0;0;0
FR;3;2021-01-09;0;0;0;0;0;0;0;0;0;0
FR;3;2021-01-10;0;0;0;0;0;0;0;0;0;0
FR;3;2021-01-11;0;0;0;0;0;0;0;0;0;0
FR;3;2021-01-12;0;0;0;0;0;0;0;0;0;0
FR;3;2021-01-13;0;0;0;0;0;0;0;0;0;0
FR;3;2021-01-14;0;0;0;0;0;0;0;0;0;0
FR;3;2021-01-15;0;0;0;0;0;0;0;0;0;0
FR;3;2021-01-16;0;0;0;0;0;0;0;0;0;0
FR;3;2021-01-17;0;0;0;0;0;0;0;0;0;0
FR;3;2021-01-18;0;0;0;0;0;0;0;0;0;0
FR;3;2021-01-19;0;0;0;0;0;0;0;0;0;0
FR;3;2021-01-20;0;0;0;0;0;0;0;0;0;0
FR;3;2021-01-21;0;0;0;0;0;0;0;0;0;0
FR;3;2021-01-22;0;0;0;0;0;0;0;0;0;0
FR;3;2021-01-23;0;0;0;0;0;0;0;0;0;0
FR;3;2021-01-24;0;0;0;0;0;0;0;0;0;0
FR;3;2021-01-25;0;0;0;0;0;0;0;0;0;0
FR;3;2021-01-26;0;0;0;0;0;0;0;0;0;0
FR;3;2021-01-27;0;0;0;0;0;0;0;0;0;0
FR;3;2021-01-28;0;0;0;0;0;0;0;0;0;0
FR;3;2021-01-29;0;0;0;0;0;0;0;0;0;0
FR;3;2021-01-30;0;0;0;0;0;0;0;0;0;0
FR;3;2021-01-31;0;0;0;0;0;0;0;0;0;0
FR;3;2021-02-01;0;0;0;0;0;0;0;0;0;0
FR;3;2021-02-02;0;0;0;0;0;0;0;0;0;0
FR;3;2021-02-03;0;0;0;0;0;0;0;0;0;0
FR;3;2021-02-04;0;0;0;0;0;0;0;0;0;0
FR;3;2021-02-05;0;0;0;0;0;0;0;0;0;0
FR;3;2021-02-06;1569;0;0;0;0;1569;0;0;0;0
FR;3;2021-02-07;1423;1;0;0;0;2992;1;0;0;0
FR;3;2021-02-08;2786;1;0;0;0;5778;2;0;0;0
FR;3;2021-02-09;6782;0;0;0;0;12560;2;0;0;0
FR;3;2021-02-10;9609;0;0;0;0;22169;2;0;0;0
FR;3;2021-02-11;13618;1;0;0;0;35787;3;0;0;0
FR;3;2021-02-12;13404;0;0;0;0;49191;3;0;0;0
FR;3;2021-02-13;3797;1;0;0;0;52988;4;0;0;0
FR;3;2021-02-14;974;0;0;0;0;53962;4;0;0;0
FR;3;2021-02-15;10491;1;0;0;0;64453;5;0;0;0
FR;3;2021-02-16;12550;4;0;0;0;77003;9;0;0;0
FR;3;2021-02-17;11156;1;0;0;0;88159;10;0;0;0
FR;3;2021-02-18;14942;2;0;0;0;103101;12;0;0;0
FR;3;2021-02-19;14362;1;0;0;0;117463;13;0;0;0
FR;3;2021-02-20;3330;0;0;0;0;120793;13;0;0;0
FR;3;2021-02-21;618;0;0;0;0;121411;13;0;0;0
FR;3;2021-02-22;9166;0;0;0;0;130577;13;0;0;0
FR;3;2021-02-23;11398;3;0;0;0;141975;16;0;0;0
FR;3;2021-02-24;14305;1;0;0;0;156280;17;0;0;0
FR;3;2021-02-25;44931;3;0;0;0;201211;20;0;0;0
FR;3;2021-02-26;61888;7;0;0;0;263099;27;0;0;0
FR;3;2021-02-27;34805;11;0;0;0;297904;38;0;0;0
FR;3;2021-02-28;2463;0;0;0;0;300367;38;0;0;0
FR;3;2021-03-01;20518;14;0;0;0;320885;52;0;0;0
FR;3;2021-03-02;38869;21;0;0;0;359754;73;0;0;0
FR;3;2021-03-03;48743;16;0;0;0;408497;89;0;0;0
FR;3;2021-03-04;82222;22;0;0;0;490719;111;0;0;0
FR;3;2021-03-05;118128;43;0;0;0;608847;154;0;0;0
FR;3;2021-03-06;120716;63;1;0;0;729563;217;1;0;0
FR;3;2021-03-07;55180;25;0;0;0;784743;242;1;0;0
FR;3;2021-03-08;42812;25;0;0;0;827555;267;1;0;0
FR;3;2021-03-09;78973;50;0;0;0;906528;317;1;0;0
FR;3;2021-03-10;80978;57;0;0;0;987506;374;1;0;0
FR;3;2021-03-11;128439;60;0;0;0;1115945;434;1;0;0
FR;3;2021-03-12;182723;106;0;0;0;1298668;540;1;0;0
FR;3;2021-03-13;132154;77;0;0;0;1430822;617;1;0;0
FR;3;2021-03-14;14056;5;0;0;0;1444878;622;1;0;0
FR;3;2021-03-15;52236;65;0;0;0;1497114;687;1;0;0
FR;3;2021-03-16;1215;43;0;0;0;1498329;730;1;0;0
FR;3;2021-03-17;946;45;0;0;0;1499275;775;1;0;0
FR;3;2021-03-18;1571;29;0;0;0;1500846;804;1;0;0
FR;3;2021-03-19;70455;50;0;0;0;1571301;854;1;0;0
FR;3;2021-03-20;65235;45;0;0;0;1636536;899;1;0;0
FR;3;2021-03-21;5759;8;0;0;0;1642295;907;1;0;0
FR;3;2021-03-22;37505;44;0;0;0;1679800;951;1;0;0
FR;3;2021-03-23;84659;76;0;0;0;1764459;1027;1;0;0
FR;3;2021-03-24;90946;97;0;0;0;1855405;1124;1;0;0
FR;3;2021-03-25;150061;136;0;0;0;2005466;1260;1;0;0
FR;3;2021-03-26;165428;155;0;0;0;2170894;1415;1;0;0
FR;3;2021-03-27;68458;100;0;0;0;2239352;1515;1;0;0
FR;3;2021-03-28;6475;21;0;0;0;2245827;1536;1;0;0
FR;3;2021-03-29;54164;74;0;0;0;2299991;1610;1;0;0
FR;3;2021-03-30;93173;101;0;0;0;2393164;1711;1;0;0
FR;3;2021-03-31;63539;104;0;0;0;2456703;1815;1;0;0
FR;3;2021-04-01;86131;112;0;0;0;2542834;1927;1;0;0
FR;3;2021-04-02;86907;176;0;0;0;2629741;2103;1;0;0
FR;3;2021-04-03;35875;128;0;0;0;2665616;2231;1;0;0
FR;3;2021-04-04;3573;19;0;0;0;2669189;2250;1;0;0
FR;3;2021-04-05;4491;36;0;0;0;2673680;2286;1;0;0
FR;3;2021-04-06;29754;95;0;0;0;2703434;2381;1;0;0
FR;3;2021-04-07;32343;93;0;0;0;2735777;2474;1;0;0
FR;3;2021-04-08;78819;251;0;0;0;2814596;2725;1;0;0
FR;3;2021-04-09;161754;431;0;0;0;2976350;3156;1;0;0
FR;3;2021-04-10;75760;353;0;0;0;3052110;3509;1;0;0
FR;3;2021-04-11;7311;46;0;0;0;3059421;3555;1;0;0
FR;3;2021-04-12;51478;216;0;0;0;3110899;3771;1;0;0
FR;3;2021-04-13;86231;344;0;0;0;3197130;4115;1;0;0
FR;3;2021-04-14;67841;357;0;0;0;3264971;4472;1;0;0
FR;3;2021-04-15;93232;387;0;0;0;3358203;4859;1;0;0
FR;3;2021-04-16;112520;601;0;0;0;3470723;5460;1;0;0
FR;3;2021-04-17;53317;338;1;0;0;3524040;5798;2;0;0
FR;3;2021-04-18;9747;43;0;0;0;3533787;5841;2;0;0
FR;3;2021-04-19;25111;261;0;0;0;3558898;6102;2;0;0
FR;3;2021-04-20;45673;415;0;0;0;3604571;6517;2;0;0
FR;3;2021-04-21;38979;496;0;0;0;3643550;7013;2;0;0
FR;3;2021-04-22;54712;822;0;0;0;3698262;7835;2;0;0
FR;3;2021-04-23;70489;1048;0;0;0;3768751;8883;2;0;0
FR;3;2021-04-24;37245;1055;0;0;0;3805996;9938;2;0;0
FR;3;2021-04-25;6211;151;0;0;0;3812207;10089;2;0;0
FR;3;2021-04-26;19787;679;0;0;0;3831994;10768;2;0;0
FR;3;2021-04-27;34481;1290;0;0;0;3866475;12058;2;0;0
FR;3;2021-04-28;28968;1986;0;0;0;3895443;14044;2;0;0
FR;3;2021-04-29;45382;6038;0;0;0;3940825;20082;2;0;0
FR;3;2021-04-30;55463;9010;1;0;0;3996288;29092;3;0;0
FR;3;2021-05-01;9515;2025;0;0;0;4005803;31117;3;0;0
FR;3;2021-05-02;3075;477;0;0;0;4008878;31594;3;0;0
FR;3;2021-05-03;13062;3897;0;0;0;4021940;35491;3;0;0
FR;3;2021-05-04;23113;8450;0;0;0;4045053;43941;3;0;0
FR;3;2021-05-05;18759;10718;0;0;0;4063812;54659;3;0;0
FR;3;2021-05-06;34628;21077;0;0;0;4098440;75736;3;0;0
FR;3;2021-05-07;44202;28663;0;0;0;4142642;104399;3;0;0
FR;3;2021-05-08;6785;9172;0;0;0;4149427;113571;3;0;0
FR;3;2021-05-09;1795;2654;0;0;0;4151222;116225;3;0;0
FR;3;2021-05-10;14996;12795;0;0;0;4166218;129020;3;0;0
FR;3;2021-05-11;27096;26054;0;0;0;4193314;155074;3;0;0
FR;3;2021-05-12;17269;27851;0;0;0;4210583;182925;3;0;0
FR;3;2021-05-13;2282;3493;0;0;0;4212865;186418;3;0;0
FR;3;2021-05-14;14518;25971;0;0;0;4227383;212389;3;0;0
FR;3;2021-05-15;7234;20950;0;0;0;4234617;233339;3;0;0
FR;3;2021-05-16;976;2647;0;0;0;4235593;235986;3;0;0
FR;3;2021-05-17;7964;20066;0;0;0;4243557;256052;3;0;0
FR;3;2021-05-18;13413;29957;0;0;0;4256970;286009;3;0;0
FR;3;2021-05-19;9272;31012;0;0;0;4266242;317021;3;0;0
FR;3;2021-05-20;12805;53588;3;0;0;4279047;370609;6;0;0
FR;3;2021-05-21;12764;65914;2;0;0;4291811;436523;8;0;0
FR;3;2021-05-22;4963;33580;1;0;0;4296774;470103;9;0;0
FR;3;2021-05-23;651;2653;0;0;0;4297425;472756;9;0;0
FR;3;2021-05-24;883;4850;0;0;0;4298308;477606;9;0;0
FR;3;2021-05-25;5309;46141;1;0;0;4303617;523747;10;0;0
FR;3;2021-05-26;4976;51729;1;0;0;4308593;575476;11;0;0
FR;3;2021-05-27;6332;78588;3;0;0;4314925;654064;14;0;0
FR;3;2021-05-28;7542;99788;2;0;0;4322467;753852;16;0;0
FR;3;2021-05-29;3349;60783;1;0;0;4325816;814635;17;0;0
FR;3;2021-05-30;548;8171;0;0;0;4326364;822806;17;0;0
FR;3;2021-05-31;2441;35655;3;0;0;4328805;858461;20;0;0
FR;3;2021-06-01;3407;64846;10;0;0;4332212;923307;30;0;0
FR;3;2021-06-02;2732;58605;6;0;0;4334944;981912;36;0;0
FR;3;2021-06-03;3495;87321;10;0;0;4338439;1069233;46;0;0
FR;3;2021-06-04;4114;105561;22;0;0;4342553;1174794;68;0;0
FR;3;2021-06-05;1982;52458;4;0;0;4344535;1227252;72;0;0
FR;3;2021-06-06;508;5318;1;0;0;4345043;1232570;73;0;0
FR;3;2021-06-07;1478;30853;11;0;0;4346521;1263423;84;0;0
FR;3;2021-06-08;2059;47330;18;0;0;4348580;1310753;102;0;0
FR;3;2021-06-09;1794;41995;13;0;0;4350374;1352748;115;0;0
FR;3;2021-06-10;2252;67751;17;0;0;4352626;1420499;132;0;0
FR;3;2021-06-11;2480;96660;34;0;0;4355106;1517159;166;0;0
FR;3;2021-06-12;1176;40666;6;0;0;4356282;1557825;172;0;0
FR;3;2021-06-13;282;3680;3;0;0;4356564;1561505;175;0;0
FR;3;2021-06-14;1045;42439;17;0;0;4357609;1603944;192;0;0
FR;3;2021-06-15;1371;80474;20;0;0;4358980;1684418;212;0;0
FR;3;2021-06-16;1260;65537;20;0;0;4360240;1749955;232;0;0
FR;3;2021-06-17;1666;102095;41;0;0;4361906;1852050;273;0;0
FR;3;2021-06-18;1870;118223;62;0;0;4363776;1970273;335;0;0
FR;3;2021-06-19;802;39449;22;0;0;4364578;2009722;357;0;0
FR;3;2021-06-20;160;3247;0;0;0;4364738;2012969;357;0;0
FR;3;2021-06-21;772;39110;16;0;0;4365510;2052079;373;0;0
FR;3;2021-06-22;1065;70005;52;0;0;4366575;2122084;425;0;0
FR;3;2021-06-23;942;50837;39;0;0;4367517;2172921;464;0;0
FR;3;2021-06-24;1310;77203;48;0;0;4368827;2250124;512;0;0
FR;3;2021-06-25;1405;90451;73;0;0;4370232;2340575;585;0;0
FR;3;2021-06-26;631;33110;29;0;0;4370863;2373685;614;0;0
FR;3;2021-06-27;166;3870;1;0;0;4371029;2377555;615;0;0
FR;3;2021-06-28;654;30181;27;0;0;4371683;2407736;642;0;0
FR;3;2021-06-29;857;56396;95;0;0;4372540;2464132;737;0;0
FR;3;2021-06-30;905;45131;93;0;0;4373445;2509263;830;0;0
FR;3;2021-07-01;1163;65932;108;0;0;4374608;2575195;938;0;0
FR;3;2021-07-02;1306;90467;170;0;0;4375914;2665662;1108;0;0
FR;3;2021-07-03;602;31176;51;0;0;4376516;2696838;1159;0;0
FR;3;2021-07-04;144;4091;3;0;0;4376660;2700929;1162;0;0
FR;3;2021-07-05;610;33705;60;0;0;4377270;2734634;1222;0;0
FR;3;2021-07-06;963;55996;88;0;0;4378233;2790630;1310;0;0
FR;3;2021-07-07;871;42973;80;0;0;4379104;2833603;1390;0;0
FR;3;2021-07-08;1125;60754;99;0;0;4380229;2894357;1489;0;0
FR;3;2021-07-09;1260;68857;128;0;0;4381489;2963214;1617;0;0
FR;3;2021-07-10;643;25044;59;0;0;4382132;2988258;1676;0;0
FR;3;2021-07-11;129;3223;4;0;0;4382261;2991481;1680;0;0
FR;3;2021-07-12;662;23745;59;0;0;4382923;3015226;1739;0;0
FR;3;2021-07-13;1647;34576;90;0;0;4384570;3049802;1829;0;0
FR;3;2021-07-14;267;2523;2;0;0;4384837;3052325;1831;0;0
FR;3;2021-07-15;1940;30522;85;0;0;4386777;3082847;1916;0;0
FR;3;2021-07-16;2520;38733;122;0;0;4389297;3121580;2038;0;0
FR;3;2021-07-17;1049;13732;26;0;0;4390346;3135312;2064;0;0
FR;3;2021-07-18;265;2560;3;0;0;4390611;3137872;2067;0;0
FR;3;2021-07-19;1276;17017;37;0;0;4391887;3154889;2104;0;0
FR;3;2021-07-20;1823;27014;98;0;0;4393710;3181903;2202;0;0
FR;3;2021-07-21;1651;19590;44;0;0;4395361;3201493;2246;0;0
FR;3;2021-07-22;1854;27673;83;0;0;4397215;3229166;2329;0;0
FR;3;2021-07-23;2215;30328;117;0;0;4399430;3259494;2446;0;0
FR;3;2021-07-24;826;6962;25;0;0;4400256;3266456;2471;0;0
FR;3;2021-07-25;210;1303;1;0;0;4400466;3267759;2472;0;0
FR;3;2021-07-26;929;10581;28;0;0;4401395;3278340;2500;0;0
FR;3;2021-07-27;1169;16875;56;0;0;4402564;3295215;2556;0;0
FR;3;2021-07-28;989;12026;40;0;0;4403553;3307241;2596;0;0
FR;3;2021-07-29;1127;15740;63;0;0;4404680;3322981;2659;0;0
FR;3;2021-07-30;1128;18022;79;0;0;4405808;3341003;2738;0;0
FR;3;2021-07-31;406;3735;15;0;0;4406214;3344738;2753;0;0
FR;3;2021-08-01;114;460;1;0;0;4406328;3345198;2754;0;0
FR;3;2021-08-02;421;5073;22;0;0;4406749;3350271;2776;0;0
FR;3;2021-08-03;495;7516;27;0;0;4407244;3357787;2803;0;0
FR;3;2021-08-04;437;4851;26;0;0;4407681;3362638;2829;0;0
FR;3;2021-08-05;430;3679;13;0;0;4408111;3366317;2842;0;0
FR;3;2021-08-06;456;4734;30;0;0;4408567;3371051;2872;0;0
FR;3;2021-08-07;214;1906;11;0;0;4408781;3372957;2883;0;0
FR;3;2021-08-08;249;428;2;0;0;4409030;3373385;2885;0;0
FR;3;2021-08-09;317;2425;11;0;0;4409347;3375810;2896;0;0
FR;3;2021-08-10;368;3803;15;0;0;4409715;3379613;2911;0;0
FR;3;2021-08-11;291;2689;15;0;0;4410006;3382302;2926;0;0
FR;3;2021-08-12;277;2605;12;0;0;4410283;3384907;2938;0;0
FR;3;2021-08-13;277;2261;16;0;0;4410560;3387168;2954;0;0
FR;3;2021-08-14;172;905;1;0;0;4410732;3388073;2955;0;0
FR;3;2021-08-15;56;174;0;0;0;4410788;3388247;2955;0;0
FR;3;2021-08-16;124;1038;8;0;0;4410912;3389285;2963;0;0
FR;3;2021-08-17;188;1458;8;0;0;4411100;3390743;2971;0;0
FR;3;2021-08-18;203;1326;10;0;0;4411303;3392069;2981;0;0
FR;3;2021-08-19;165;1393;10;0;0;4411468;3393462;2991;0;0
FR;3;2021-08-20;167;1610;16;0;0;4411635;3395072;3007;0;0
FR;3;2021-08-21;93;586;2;0;0;4411728;3395658;3009;0;0
FR;3;2021-08-22;42;188;1;0;0;4411770;3395846;3010;0;0
FR;3;2021-08-23;141;912;7;0;0;4411911;3396758;3017;0;0
FR;3;2021-08-24;124;944;10;0;0;4412035;3397702;3027;0;0
FR;3;2021-08-25;137;829;3;0;0;4412172;3398531;3030;0;0
FR;3;2021-08-26;172;846;9;0;0;4412344;3399377;3039;0;0
FR;3;2021-08-27;178;944;9;0;0;4412522;3400321;3048;0;0
FR;3;2021-08-28;100;370;4;0;0;4412622;3400691;3052;0;0
FR;3;2021-08-29;128;133;1;0;0;4412750;3400824;3053;0;0
FR;3;2021-08-30;100;580;0;0;121;4412850;3401404;3053;0;121
FR;3;2021-08-31;132;697;7;0;143;4412982;3402101;3060;0;264
FR;3;2021-09-01;121;466;5;0;115;4413103;3402567;3065;0;379
FR;3;2021-09-02;100;617;22;0;112;4413203;3403184;3087;0;491
FR;3;2021-09-03;115;572;17;0;120;4413318;3403756;3104;0;611
FR;3;2021-09-04;54;300;3;0;55;4413372;3404056;3107;0;666
FR;3;2021-09-05;51;66;5;0;27;4413423;3404122;3112;0;693
FR;3;2021-09-06;117;380;4;0;138;4413540;3404502;3116;0;831
FR;3;2021-09-07;124;449;14;0;121;4413664;3404951;3130;0;952
FR;3;2021-09-08;120;351;2;0;94;4413784;3405302;3132;0;1046
FR;3;2021-09-09;93;387;8;0;108;4413877;3405689;3140;0;1154
FR;3;2021-09-10;100;408;3;0;96;4413977;3406097;3143;0;1250
FR;3;2021-09-11;76;233;4;0;66;4414053;3406330;3147;0;1316
FR;3;2021-09-12;37;47;1;0;17;4414090;3406377;3148;0;1333
FR;3;2021-09-13;73;307;7;0;102;4414163;3406684;3155;0;1435
FR;3;2021-09-14;72;281;6;0;99;4414235;3406965;3161;0;1534
FR;3;2021-09-15;61;257;3;0;6;4414296;3407222;3164;0;1540
FR;3;2021-09-16;62;326;6;0;6;4414358;3407548;3170;0;1546
FR;3;2021-09-17;52;334;3;0;7;4414410;3407882;3173;0;1553
FR;3;2021-09-18;36;178;1;0;1;4414446;3408060;3174;0;1554
FR;3;2021-09-19;28;31;2;0;1;4414474;3408091;3176;0;1555
FR;3;2021-09-20;81;197;0;0;1;4414555;3408288;3176;0;1556
FR;3;2021-09-21;60;285;6;0;7;4414615;3408573;3182;0;1563
FR;3;2021-09-22;64;233;6;0;7;4414679;3408806;3188;0;1570
FR;3;2021-09-23;37;265;11;0;7;4414716;3409071;3199;0;1577
FR;3;2021-09-24;28;322;12;0;19;4414744;3409393;3211;0;1596
FR;3;2021-09-25;31;142;3;0;3;4414775;3409535;3214;0;1599
FR;3;2021-09-26;16;58;1;0;1;4414791;3409593;3215;0;1600
FR;3;2021-09-27;46;292;3;0;5;4414837;3409885;3218;0;1605
FR;3;2021-09-28;49;249;6;0;8;4414886;3410134;3224;0;1613
FR;3;2021-09-29;37;224;10;0;14;4414923;3410358;3234;0;1627
FR;3;2021-09-30;39;202;8;0;10;4414962;3410560;3242;0;1637
FR;3;2021-10-01;22;163;6;0;7;4414984;3410723;3248;0;1644
FR;3;2021-10-02;17;85;0;0;0;4415001;3410808;3248;0;1644
FR;3;2021-10-03;19;18;1;0;2;4415020;3410826;3249;0;1646
FR;3;2021-10-04;33;158;4;0;4;4415053;3410984;3253;0;1650
FR;3;2021-10-05;17;151;10;0;13;4415070;3411135;3263;0;1663
FR;3;2021-10-06;32;147;8;0;9;4415102;3411282;3271;0;1672
FR;3;2021-10-07;19;133;6;0;6;4415121;3411415;3277;0;1678
FR;3;2021-10-08;24;140;10;0;9;4415145;3411555;3287;0;1687
FR;3;2021-10-09;15;72;1;0;1;4415160;3411627;3288;0;1688
FR;3;2021-10-10;13;18;2;0;3;4415173;3411645;3290;0;1691
FR;3;2021-10-11;16;119;4;0;5;4415189;3411764;3294;0;1696
FR;3;2021-10-12;20;104;5;0;5;4415209;3411868;3299;0;1701
FR;3;2021-10-13;25;116;9;0;7;4415234;3411984;3308;0;1708
FR;3;2021-10-14;18;153;3;0;4;4415252;3412137;3311;0;1712
FR;3;2021-10-15;23;151;8;0;12;4415275;3412288;3319;0;1724
FR;3;2021-10-16;11;77;6;0;8;4415286;3412365;3325;0;1732
FR;3;2021-10-17;12;25;0;0;0;4415298;3412390;3325;0;1732
FR;3;2021-10-18;18;117;2;0;2;4415316;3412507;3327;0;1734
FR;3;2021-10-19;16;114;19;0;21;4415332;3412621;3346;0;1755
FR;3;2021-10-20;25;128;6;0;7;4415357;3412749;3352;0;1762
FR;3;2021-10-21;28;131;17;0;13;4415385;3412880;3369;0;1775
FR;3;2021-10-22;23;112;16;0;19;4415408;3412992;3385;0;1794
FR;3;2021-10-23;15;58;2;0;1;4415423;3413050;3387;0;1795
FR;3;2021-10-24;7;35;0;0;0;4415430;3413085;3387;0;1795
FR;3;2021-10-25;23;149;7;0;7;4415453;3413234;3394;0;1802
FR;3;2021-10-26;25;103;22;0;19;4415478;3413337;3416;0;1821
FR;3;2021-10-27;18;103;9;0;9;4415496;3413440;3425;0;1830
FR;3;2021-10-28;22;119;33;0;36;4415518;3413559;3458;0;1866
FR;3;2021-10-29;12;109;64;0;54;4415530;3413668;3522;0;1920
FR;3;2021-10-30;11;63;11;1;10;4415541;3413731;3533;1;1930
FR;3;2021-10-31;8;23;1;0;1;4415549;3413754;3534;1;1931
FR;3;2021-11-01;10;22;2;0;1;4415559;3413776;3536;1;1932
FR;3;2021-11-02;9;103;10;0;12;4415568;3413879;3546;1;1944
FR;3;2021-11-03;19;112;10;0;10;4415587;3413991;3556;1;1954
FR;3;2021-11-04;18;91;4;0;3;4415605;3414082;3560;1;1957
FR;3;2021-11-05;19;127;8;1;5;4415624;3414209;3568;2;1962
FR;3;2021-11-06;10;61;3;0;3;4415634;3414270;3571;2;1965
FR;3;2021-11-07;6;21;1;0;1;4415640;3414291;3572;2;1966
FR;3;2021-11-08;11;134;7;0;5;4415651;3414425;3579;2;1971
FR;3;2021-11-09;13;135;5;0;5;4415664;3414560;3584;2;1976
FR;3;2021-11-10;14;164;14;0;15;4415678;3414724;3598;2;1991
FR;3;2021-11-11;11;49;3;0;3;4415689;3414773;3601;2;1994
FR;3;2021-11-12;14;141;6;0;4;4415703;3414914;3607;2;1998
FR;3;2021-11-13;7;68;9;0;10;4415710;3414982;3616;2;2008
FR;3;2021-11-14;3;24;1;0;1;4415713;3415006;3617;2;2009
FR;3;2021-11-15;5;175;10;0;11;4415718;3415181;3627;2;2020
FR;3;2021-11-16;6;145;11;0;10;4415724;3415326;3638;2;2030
FR;3;2021-11-17;7;156;11;0;8;4415731;3415482;3649;2;2038
FR;3;2021-11-18;14;151;10;0;11;4415745;3415633;3659;2;2049
FR;3;2021-11-19;10;202;22;0;27;4415755;3415835;3681;2;2076
FR;3;2021-11-20;6;107;6;0;6;4415761;3415942;3687;2;2082
FR;3;2021-11-21;3;26;3;0;3;4415764;3415968;3690;2;2085
FR;3;2021-11-22;11;205;11;0;11;4415775;3416173;3701;2;2096
FR;3;2021-11-23;8;204;15;0;14;4415783;3416377;3716;2;2110
FR;3;2021-11-24;9;208;9;0;17;4415792;3416585;3725;2;2127
FR;3;2021-11-25;12;238;11;0;11;4415804;3416823;3736;2;2138
FR;3;2021-11-26;8;306;35;0;33;4415812;3417129;3771;2;2171
FR;3;2021-11-27;8;143;20;0;21;4415820;3417272;3791;2;2192
FR;3;2021-11-28;3;63;7;0;7;4415823;3417335;3798;2;2199
FR;3;2021-11-29;5;262;20;0;21;4415828;3417597;3818;2;2220
FR;3;2021-11-30;7;354;28;0;31;4415835;3417951;3846;2;2251
FR;3;2021-12-01;30;383;36;0;38;4415865;3418334;3882;2;2289
FR;3;2021-12-02;9;400;33;0;36;4415874;3418734;3915;2;2325
FR;3;2021-12-03;4;455;37;0;38;4415878;3419189;3952;2;2363
FR;3;2021-12-04;3;243;26;0;28;4415881;3419432;3978;2;2391
FR;3;2021-12-05;1;66;5;0;5;4415882;3419498;3983;2;2396
FR;3;2021-12-06;6;419;14;0;15;4415888;3419917;3997;2;2411
FR;3;2021-12-07;4;496;20;0;24;4415892;3420413;4017;2;2435
FR;3;2021-12-08;7;453;29;0;30;4415899;3420866;4046;2;2465
FR;3;2021-12-09;3;513;17;0;22;4415902;3421379;4063;2;2487
FR;3;2021-12-10;10;526;29;0;25;4415912;3421905;4092;2;2512
FR;3;2021-12-11;4;337;10;0;9;4415916;3422242;4102;2;2521
FR;3;2021-12-12;1;109;3;0;3;4415917;3422351;4105;2;2524
FR;3;2021-12-13;2;508;19;0;21;4415919;3422859;4124;2;2545
FR;3;2021-12-14;8;645;18;0;21;4415927;3423504;4142;2;2566
FR;3;2021-12-15;9;616;17;0;21;4415936;3424120;4159;2;2587
FR;3;2021-12-16;10;628;19;0;18;4415946;3424748;4178;2;2605
FR;3;2021-12-17;5;711;18;0;19;4415951;3425459;4196;2;2624
FR;3;2021-12-18;4;378;4;0;5;4415955;3425837;4200;2;2629
FR;3;2021-12-19;3;194;2;0;2;4415958;3426031;4202;2;2631
FR;3;2021-12-20;8;645;23;0;28;4415966;3426676;4225;2;2659
FR;3;2021-12-21;3;734;10;0;13;4415969;3427410;4235;2;2672
FR;3;2021-12-22;10;685;9;0;10;4415979;3428095;4244;2;2682
FR;3;2021-12-23;2;591;8;0;8;4415981;3428686;4252;2;2690
FR;3;2021-12-24;2;251;3;0;6;4415983;3428937;4255;2;2696
FR;3;2021-12-25;0;25;0;0;0;4415983;3428962;4255;2;2696
FR;3;2021-12-26;0;92;1;0;1;4415983;3429054;4256;2;2697
FR;3;2021-12-27;7;498;17;0;20;4415990;3429552;4273;2;2717
FR;3;2021-12-28;3;646;6;0;5;4415993;3430198;4279;2;2722
FR;3;2021-12-29;4;537;14;0;16;4415997;3430735;4293;2;2738
FR;3;2021-12-30;3;556;7;0;10;4416000;3431291;4300;2;2748
FR;3;2021-12-31;0;196;5;0;7;4416000;3431487;4305;2;2755
FR;3;2022-01-01;0;26;0;0;2;4416000;3431513;4305;2;2757
FR;3;2022-01-02;0;80;0;0;0;4416000;3431593;4305;2;2757
FR;3;2022-01-03;4;535;17;0;21;4416004;3432128;4322;2;2778
FR;3;2022-01-04;6;583;9;0;8;4416010;3432711;4331;2;2786
FR;3;2022-01-05;5;528;10;0;14;4416015;3433239;4341;2;2800
FR;3;2022-01-06;6;506;9;0;10;4416021;3433745;4350;2;2810
FR;3;2022-01-07;2;534;11;0;13;4416023;3434279;4361;2;2823
FR;3;2022-01-08;4;263;4;0;5;4416027;3434542;4365;2;2828
FR;3;2022-01-09;0;117;0;0;0;4416027;3434659;4365;2;2828
FR;3;2022-01-10;2;457;12;0;12;4416029;3435116;4377;2;2840
FR;3;2022-01-11;2;497;1;0;1;4416031;3435613;4378;2;2841
FR;3;2022-01-12;2;421;9;0;10;4416033;3436034;4387;2;2851
FR;3;2022-01-13;3;406;11;0;12;4416036;3436440;4398;2;2863
FR;3;2022-01-14;3;451;10;0;13;4416039;3436891;4408;2;2876
FR;3;2022-01-15;0;289;2;0;3;4416039;3437180;4410;2;2879
FR;3;2022-01-16;1;110;1;0;1;4416040;3437290;4411;2;2880
FR;3;2022-01-17;2;335;8;0;9;4416042;3437625;4419;2;2889
FR;3;2022-01-18;2;387;1;0;2;4416044;3438012;4420;2;2891
FR;3;2022-01-19;2;338;5;0;10;4416046;3438350;4425;2;2901
FR;3;2022-01-20;1;368;5;0;3;4416047;3438718;4430;2;2904
FR;3;2022-01-21;4;357;5;0;7;4416051;3439075;4435;2;2911
FR;3;2022-01-22;2;230;1;0;2;4416053;3439305;4436;2;2913
FR;3;2022-01-23;0;81;0;0;1;4416053;3439386;4436;2;2914
FR;3;2022-01-24;2;336;1;0;6;4416055;3439722;4437;2;2920
FR;3;2022-01-25;0;184;0;0;0;4416055;3439906;4437;2;2920
FR;3;2022-01-26;0;80;0;0;0;4416055;3439986;4437;2;2920
FR;3;2022-01-27;0;54;0;0;0;4416055;3440040;4437;2;2920
FR;3;2022-01-28;0;123;0;0;0;4416055;3440163;4437;2;2920
FR;3;2022-01-29;0;103;0;0;0;4416055;3440266;4437;2;2920
FR;3;2022-01-30;0;51;0;0;0;4416055;3440317;4437;2;2920
FR;3;2022-01-31;0;96;0;0;0;4416055;3440413;4437;2;2920
FR;3;2022-02-01;0;101;0;0;1;4416055;3440514;4437;2;2921
FR;3;2022-02-02;0;90;0;0;0;4416055;3440604;4437;2;2921
FR;3;2022-02-03;0;96;0;0;0;4416055;3440700;4437;2;2921
FR;3;2022-02-04;0;121;0;0;0;4416055;3440821;4437;2;2921
FR;3;2022-02-05;0;72;0;0;0;4416055;3440893;4437;2;2921
FR;3;2022-02-06;0;11;0;0;0;4416055;3440904;4437;2;2921
FR;3;2022-02-07;0;85;0;0;0;4416055;3440989;4437;2;2921
FR;3;2022-02-08;0;0;0;0;0;4416055;3440989;4437;2;2921
FR;3;2022-02-09;0;0;0;0;0;4416055;3440989;4437;2;2921
FR;3;2022-02-10;0;0;0;0;0;4416055;3440989;4437;2;2921
FR;3;2022-02-11;0;0;0;0;0;4416055;3440989;4437;2;2921
FR;3;2022-02-12;0;0;0;0;0;4416055;3440989;4437;2;2921
FR;3;2022-02-13;0;0;0;0;0;4416055;3440989;4437;2;2921
FR;3;2022-02-14;0;0;0;0;0;4416055;3440989;4437;2;2921
FR;3;2022-02-15;0;0;0;0;0;4416055;3440989;4437;2;2921
FR;3;2022-02-16;0;0;0;0;0;4416055;3440989;4437;2;2921
FR;3;2022-02-17;0;0;0;0;0;4416055;3440989;4437;2;2921
FR;3;2022-02-18;0;0;0;0;0;4416055;3440989;4437;2;2921
FR;3;2022-02-19;0;0;0;0;0;4416055;3440989;4437;2;2921
FR;3;2022-02-20;0;0;0;0;0;4416055;3440989;4437;2;2921
FR;3;2022-02-21;2;0;0;0;0;4416057;3440989;4437;2;2921
FR;3;2022-02-22;0;0;0;0;0;4416057;3440989;4437;2;2921
FR;3;2022-02-23;0;0;0;0;0;4416057;3440989;4437;2;2921
FR;3;2022-02-24;0;0;0;0;0;4416057;3440989;4437;2;2921
FR;3;2022-02-25;0;0;0;0;0;4416057;3440989;4437;2;2921
FR;3;2022-02-26;0;0;0;0;0;4416057;3440989;4437;2;2921
FR;3;2022-02-27;0;0;0;0;0;4416057;3440989;4437;2;2921
FR;3;2022-02-28;1;0;0;0;0;4416058;3440989;4437;2;2921
FR;3;2022-03-01;1;0;0;0;0;4416059;3440989;4437;2;2921
FR;3;2022-03-02;0;0;0;0;0;4416059;3440989;4437;2;2921
FR;3;2022-03-03;0;0;0;0;0;4416059;3440989;4437;2;2921
FR;3;2022-03-04;0;0;0;0;0;4416059;3440989;4437;2;2921
FR;3;2022-03-05;0;0;0;0;0;4416059;3440989;4437;2;2921
FR;3;2022-03-06;1;0;0;0;0;4416060;3440989;4437;2;2921
FR;3;2022-03-07;0;0;0;0;0;4416060;3440989;4437;2;2921
FR;3;2022-03-08;1;0;0;0;0;4416061;3440989;4437;2;2921
FR;3;2022-03-09;0;0;0;0;0;4416061;3440989;4437;2;2921
FR;3;2022-03-10;0;0;0;0;0;4416061;3440989;4437;2;2921
FR;3;2022-03-11;0;0;0;0;0;4416061;3440989;4437;2;2921
FR;3;2022-03-12;0;0;0;0;0;4416061;3440989;4437;2;2921
FR;3;2022-03-13;0;0;0;0;0;4416061;3440989;4437;2;2921
FR;3;2022-03-14;0;0;0;0;0;4416061;3440989;4437;2;2921
FR;3;2022-03-15;0;0;0;0;0;4416061;3440989;4437;2;2921
FR;3;2022-03-16;0;0;0;0;0;4416061;3440989;4437;2;2921
FR;3;2022-03-17;0;0;0;0;0;4416061;3440989;4437;2;2921
FR;3;2022-03-18;0;0;0;0;0;4416061;3440989;4437;2;2921
FR;3;2022-03-19;0;0;0;0;0;4416061;3440989;4437;2;2921
FR;3;2022-03-20;1;0;0;0;0;4416062;3440989;4437;2;2921
FR;3;2022-03-21;0;0;0;0;0;4416062;3440989;4437;2;2921
FR;3;2022-03-22;0;0;0;0;0;4416062;3440989;4437;2;2921
FR;3;2022-03-23;1;0;0;0;0;4416063;3440989;4437;2;2921
FR;3;2022-03-24;0;0;0;0;0;4416063;3440989;4437;2;2921
FR;3;2022-03-25;1;0;0;0;0;4416064;3440989;4437;2;2921
FR;3;2022-03-26;0;0;0;0;0;4416064;3440989;4437;2;2921
FR;3;2022-03-27;0;0;0;0;0;4416064;3440989;4437;2;2921
FR;3;2022-03-28;0;0;0;0;0;4416064;3440989;4437;2;2921
FR;3;2022-03-29;0;0;0;0;0;4416064;3440989;4437;2;2921
FR;3;2022-03-30;0;0;0;0;0;4416064;3440989;4437;2;2921
FR;3;2022-03-31;0;0;0;0;0;4416064;3440989;4437;2;2921
FR;3;2022-04-01;0;0;0;0;0;4416064;3440989;4437;2;2921
FR;3;2022-04-02;0;0;0;0;0;4416064;3440989;4437;2;2921
FR;3;2022-04-03;0;0;0;0;0;4416064;3440989;4437;2;2921
FR;3;2022-04-04;0;0;0;0;0;4416064;3440989;4437;2;2921
FR;3;2022-04-05;0;0;0;0;0;4416064;3440989;4437;2;2921
FR;3;2022-04-06;0;0;0;0;0;4416064;3440989;4437;2;2921
FR;3;2022-04-07;0;0;0;0;0;4416064;3440989;4437;2;2921
FR;3;2022-04-08;0;0;0;0;0;4416064;3440989;4437;2;2921
FR;3;2022-04-09;0;0;0;0;0;4416064;3440989;4437;2;2921
FR;3;2022-04-10;0;0;0;0;0;4416064;3440989;4437;2;2921
FR;3;2022-04-11;0;0;0;0;0;4416064;3440989;4437;2;2921
FR;3;2022-04-12;0;0;0;0;0;4416064;3440989;4437;2;2921
FR;3;2022-04-13;0;0;0;0;0;4416064;3440989;4437;2;2921
FR;3;2022-04-14;0;0;0;0;0;4416064;3440989;4437;2;2921
FR;3;2022-04-15;1;0;0;0;0;4416065;3440989;4437;2;2921
FR;3;2022-04-16;0;0;0;0;0;4416065;3440989;4437;2;2921
FR;3;2022-04-17;0;0;0;0;0;4416065;3440989;4437;2;2921
FR;3;2022-04-18;0;0;0;0;0;4416065;3440989;4437;2;2921
FR;3;2022-04-19;0;0;0;0;0;4416065;3440989;4437;2;2921
FR;3;2022-04-20;0;0;0;0;0;4416065;3440989;4437;2;2921
FR;3;2022-04-21;0;0;0;0;0;4416065;3440989;4437;2;2921
FR;3;2022-04-22;0;0;0;0;0;4416065;3440989;4437;2;2921
FR;3;2022-04-23;0;0;0;0;0;4416065;3440989;4437;2;2921
FR;3;2022-04-24;0;0;0;0;0;4416065;3440989;4437;2;2921
FR;3;2022-04-25;0;0;0;0;0;4416065;3440989;4437;2;2921
FR;3;2022-04-26;0;0;0;0;0;4416065;3440989;4437;2;2921
FR;3;2022-04-27;0;0;0;0;0;4416065;3440989;4437;2;2921
FR;3;2022-04-28;0;0;0;0;0;4416065;3440989;4437;2;2921
FR;3;2022-04-29;0;0;0;0;0;4416065;3440989;4437;2;2921
FR;3;2022-04-30;0;0;0;0;0;4416065;3440989;4437;2;2921
FR;3;2022-05-01;0;0;0;0;0;4416065;3440989;4437;2;2921
FR;3;2022-05-02;0;0;0;0;0;4416065;3440989;4437;2;2921
FR;3;2022-05-03;0;0;0;0;0;4416065;3440989;4437;2;2921
FR;3;2022-05-04;0;0;0;0;0;4416065;3440989;4437;2;2921
FR;3;2022-05-05;0;0;0;0;0;4416065;3440989;4437;2;2921
FR;3;2022-05-06;0;0;0;0;0;4416065;3440989;4437;2;2921
FR;3;2022-05-07;0;0;0;0;0;4416065;3440989;4437;2;2921
FR;3;2022-05-08;0;0;0;0;0;4416065;3440989;4437;2;2921
FR;3;2022-05-09;0;0;0;0;0;4416065;3440989;4437;2;2921
FR;3;2022-05-10;0;0;0;0;0;4416065;3440989;4437;2;2921
FR;3;2022-05-11;0;0;0;0;0;4416065;3440989;4437;2;2921
FR;3;2022-05-12;0;0;0;0;0;4416065;3440989;4437;2;2921
FR;3;2022-05-13;0;0;0;0;0;4416065;3440989;4437;2;2921
FR;3;2022-05-14;1;0;0;0;0;4416066;3440989;4437;2;2921
FR;3;2022-05-15;0;0;0;0;0;4416066;3440989;4437;2;2921
FR;3;2022-05-16;0;0;0;0;0;4416066;3440989;4437;2;2921
FR;3;2022-05-17;0;0;0;0;0;4416066;3440989;4437;2;2921
FR;3;2022-05-18;0;0;0;0;0;4416066;3440989;4437;2;2921
FR;3;2022-05-19;0;0;0;0;0;4416066;3440989;4437;2;2921
FR;3;2022-05-20;0;0;0;0;0;4416066;3440989;4437;2;2921
FR;3;2022-05-21;0;0;0;0;0;4416066;3440989;4437;2;2921
FR;3;2022-05-22;0;0;0;0;0;4416066;3440989;4437;2;2921
FR;3;2022-05-23;0;0;0;0;0;4416066;3440989;4437;2;2921
FR;3;2022-05-24;0;0;0;0;0;4416066;3440989;4437;2;2921
FR;3;2022-05-25;0;0;0;0;0;4416066;3440989;4437;2;2921
FR;3;2022-05-26;0;0;0;0;0;4416066;3440989;4437;2;2921
FR;3;2022-05-27;0;0;0;0;0;4416066;3440989;4437;2;2921
FR;3;2022-05-28;0;0;0;0;0;4416066;3440989;4437;2;2921
FR;3;2022-05-29;0;0;0;0;0;4416066;3440989;4437;2;2921
FR;3;2022-05-30;0;0;0;0;0;4416066;3440989;4437;2;2921
FR;3;2022-05-31;0;0;0;0;0;4416066;3440989;4437;2;2921
FR;3;2022-06-01;0;0;0;0;0;4416066;3440989;4437;2;2921
FR;3;2022-06-02;0;0;0;0;0;4416066;3440989;4437;2;2921
FR;3;2022-06-03;0;0;0;0;0;4416066;3440989;4437;2;2921
FR;3;2022-06-04;0;0;0;0;0;4416066;3440989;4437;2;2921
FR;3;2022-06-05;0;0;0;0;0;4416066;3440989;4437;2;2921
FR;3;2022-06-06;0;0;0;0;0;4416066;3440989;4437;2;2921
FR;3;2022-06-07;0;0;0;0;0;4416066;3440989;4437;2;2921
FR;3;2022-06-08;0;0;0;0;0;4416066;3440989;4437;2;2921
FR;3;2022-06-09;0;0;0;0;0;4416066;3440989;4437;2;2921
FR;3;2022-06-10;0;0;0;0;0;4416066;3440989;4437;2;2921
FR;3;2022-06-11;0;0;0;0;0;4416066;3440989;4437;2;2921
FR;3;2022-06-12;0;0;0;0;0;4416066;3440989;4437;2;2921
FR;3;2022-06-13;1;0;0;0;0;4416067;3440989;4437;2;2921
FR;3;2022-06-14;0;0;0;0;0;4416067;3440989;4437;2;2921
FR;3;2022-06-15;0;0;0;0;0;4416067;3440989;4437;2;2921
FR;3;2022-06-16;0;0;0;0;0;4416067;3440989;4437;2;2921
FR;3;2022-06-17;0;0;0;0;0;4416067;3440989;4437;2;2921
FR;3;2022-06-18;0;0;0;0;0;4416067;3440989;4437;2;2921
FR;3;2022-06-19;0;0;0;0;0;4416067;3440989;4437;2;2921
FR;3;2022-06-20;0;0;0;0;0;4416067;3440989;4437;2;2921
FR;3;2022-06-21;0;0;0;0;0;4416067;3440989;4437;2;2921
FR;3;2022-06-22;0;0;0;0;0;4416067;3440989;4437;2;2921
FR;3;2022-06-23;0;0;0;0;0;4416067;3440989;4437;2;2921
FR;3;2022-06-24;0;0;0;0;0;4416067;3440989;4437;2;2921
FR;3;2022-06-25;0;0;0;0;0;4416067;3440989;4437;2;2921
FR;3;2022-06-26;0;0;0;0;0;4416067;3440989;4437;2;2921
FR;3;2022-06-27;0;0;0;0;0;4416067;3440989;4437;2;2921
FR;3;2022-06-28;0;0;0;0;0;4416067;3440989;4437;2;2921
FR;3;2022-06-29;1;0;0;0;0;4416068;3440989;4437;2;2921
FR;3;2022-06-30;0;0;0;0;0;4416068;3440989;4437;2;2921
FR;3;2022-07-01;0;0;0;0;0;4416068;3440989;4437;2;2921
FR;3;2022-07-02;0;0;0;0;0;4416068;3440989;4437;2;2921
FR;3;2022-07-03;0;0;0;0;0;4416068;3440989;4437;2;2921
FR;3;2022-07-04;0;0;0;0;0;4416068;3440989;4437;2;2921
FR;3;2022-07-05;0;0;0;0;0;4416068;3440989;4437;2;2921
FR;3;2022-07-06;0;0;0;0;0;4416068;3440989;4437;2;2921
FR;3;2022-07-07;0;0;0;0;0;4416068;3440989;4437;2;2921
FR;3;2022-07-08;0;0;0;0;0;4416068;3440989;4437;2;2921
FR;3;2022-07-09;0;0;0;0;0;4416068;3440989;4437;2;2921
FR;3;2022-07-10;0;0;0;0;0;4416068;3440989;4437;2;2921
FR;3;2022-07-11;0;0;0;0;0;4416068;3440989;4437;2;2921
FR;3;2022-07-12;0;0;0;0;0;4416068;3440989;4437;2;2921
FR;3;2022-07-13;0;0;0;0;0;4416068;3440989;4437;2;2921
FR;3;2022-07-14;0;0;0;0;0;4416068;3440989;4437;2;2921
FR;3;2022-07-15;0;0;0;0;0;4416068;3440989;4437;2;2921
FR;3;2022-07-16;0;0;0;0;0;4416068;3440989;4437;2;2921
FR;3;2022-07-17;0;0;0;0;0;4416068;3440989;4437;2;2921
FR;3;2022-07-18;0;0;0;0;0;4416068;3440989;4437;2;2921
FR;3;2022-07-19;0;0;0;0;0;4416068;3440989;4437;2;2921
FR;3;2022-07-20;0;0;0;0;0;4416068;3440989;4437;2;2921
FR;3;2022-07-21;0;0;0;0;0;4416068;3440989;4437;2;2921
FR;3;2022-07-22;0;0;0;0;0;4416068;3440989;4437;2;2921
FR;3;2022-07-23;0;0;0;0;0;4416068;3440989;4437;2;2921
FR;3;2022-07-24;0;0;0;0;0;4416068;3440989;4437;2;2921
FR;3;2022-07-25;0;0;0;0;0;4416068;3440989;4437;2;2921
FR;3;2022-07-26;0;0;0;0;0;4416068;3440989;4437;2;2921
FR;3;2022-07-27;0;0;0;0;0;4416068;3440989;4437;2;2921
FR;3;2022-07-28;0;0;0;0;0;4416068;3440989;4437;2;2921
FR;3;2022-07-29;0;0;0;0;0;4416068;3440989;4437;2;2921
FR;3;2022-07-30;0;0;0;0;0;4416068;3440989;4437;2;2921
FR;3;2022-07-31;0;0;0;0;0;4416068;3440989;4437;2;2921
FR;3;2022-08-01;0;0;0;0;0;4416068;3440989;4437;2;2921
FR;3;2022-08-02;0;0;0;0;0;4416068;3440989;4437;2;2921
FR;3;2022-08-03;0;0;0;0;0;4416068;3440989;4437;2;2921
FR;3;2022-08-04;0;0;0;0;0;4416068;3440989;4437;2;2921
FR;3;2022-08-05;0;0;0;0;0;4416068;3440989;4437;2;2921
FR;3;2022-08-06;0;0;0;0;0;4416068;3440989;4437;2;2921
FR;3;2022-08-07;0;0;0;0;0;4416068;3440989;4437;2;2921
FR;3;2022-08-08;0;0;0;0;0;4416068;3440989;4437;2;2921
FR;3;2022-08-09;0;0;0;0;0;4416068;3440989;4437;2;2921
FR;3;2022-08-10;0;0;0;0;0;4416068;3440989;4437;2;2921
FR;3;2022-08-11;0;0;0;0;0;4416068;3440989;4437;2;2921
FR;3;2022-08-12;0;0;0;0;0;4416068;3440989;4437;2;2921
FR;3;2022-08-13;0;0;0;0;0;4416068;3440989;4437;2;2921
FR;3;2022-08-14;0;0;0;0;0;4416068;3440989;4437;2;2921
FR;3;2022-08-15;0;0;0;0;0;4416068;3440989;4437;2;2921
FR;3;2022-08-16;0;0;0;0;0;4416068;3440989;4437;2;2921
FR;3;2022-08-17;0;0;0;0;0;4416068;3440989;4437;2;2921
FR;3;2022-08-18;0;0;0;0;0;4416068;3440989;4437;2;2921
FR;3;2022-08-19;0;0;0;0;0;4416068;3440989;4437;2;2921
FR;3;2022-08-20;0;0;0;0;0;4416068;3440989;4437;2;2921
FR;3;2022-08-21;0;0;0;0;0;4416068;3440989;4437;2;2921
FR;3;2022-08-22;0;0;0;0;0;4416068;3440989;4437;2;2921
FR;3;2022-08-23;0;0;0;0;0;4416068;3440989;4437;2;2921
FR;3;2022-08-24;0;0;0;0;0;4416068;3440989;4437;2;2921
FR;3;2022-08-25;0;0;0;0;0;4416068;3440989;4437;2;2921
FR;3;2022-08-26;0;0;0;0;0;4416068;3440989;4437;2;2921
FR;3;2022-08-27;0;0;0;0;0;4416068;3440989;4437;2;2921
FR;3;2022-08-28;0;0;0;0;0;4416068;3440989;4437;2;2921
FR;3;2022-08-29;0;0;0;0;0;4416068;3440989;4437;2;2921
FR;3;2022-08-30;0;0;0;0;0;4416068;3440989;4437;2;2921
FR;3;2022-08-31;0;0;0;0;0;4416068;3440989;4437;2;2921
FR;3;2022-09-01;0;0;0;0;0;4416068;3440989;4437;2;2921
FR;3;2022-09-02;0;0;0;0;0;4416068;3440989;4437;2;2921
FR;3;2022-09-03;0;0;0;0;0;4416068;3440989;4437;2;2921
FR;3;2022-09-04;0;0;0;0;0;4416068;3440989;4437;2;2921
FR;4;2020-12-27;0;0;0;0;0;0;0;0;0;0
FR;4;2020-12-28;0;0;0;0;0;0;0;0;0;0
FR;4;2020-12-29;0;0;0;0;0;0;0;0;0;0
FR;4;2020-12-30;0;0;0;0;0;0;0;0;0;0
FR;4;2020-12-31;0;0;0;0;0;0;0;0;0;0
FR;4;2021-01-01;0;0;0;0;0;0;0;0;0;0
FR;4;2021-01-02;0;0;0;0;0;0;0;0;0;0
FR;4;2021-01-03;0;0;0;0;0;0;0;0;0;0
FR;4;2021-01-04;0;0;0;0;0;0;0;0;0;0
FR;4;2021-01-05;0;0;0;0;0;0;0;0;0;0
FR;4;2021-01-06;0;0;0;0;0;0;0;0;0;0
FR;4;2021-01-07;0;0;0;0;0;0;0;0;0;0
FR;4;2021-01-08;0;0;0;0;0;0;0;0;0;0
FR;4;2021-01-09;0;0;0;0;0;0;0;0;0;0
FR;4;2021-01-10;0;0;0;0;0;0;0;0;0;0
FR;4;2021-01-11;0;0;0;0;0;0;0;0;0;0
FR;4;2021-01-12;0;0;0;0;0;0;0;0;0;0
FR;4;2021-01-13;0;0;0;0;0;0;0;0;0;0
FR;4;2021-01-14;0;0;0;0;0;0;0;0;0;0
FR;4;2021-01-15;0;0;0;0;0;0;0;0;0;0
FR;4;2021-01-16;0;0;0;0;0;0;0;0;0;0
FR;4;2021-01-17;0;0;0;0;0;0;0;0;0;0
FR;4;2021-01-18;0;0;0;0;0;0;0;0;0;0
FR;4;2021-01-19;0;0;0;0;0;0;0;0;0;0
FR;4;2021-01-20;0;0;0;0;0;0;0;0;0;0
FR;4;2021-01-21;0;0;0;0;0;0;0;0;0;0
FR;4;2021-01-22;0;0;0;0;0;0;0;0;0;0
FR;4;2021-01-23;0;0;0;0;0;0;0;0;0;0
FR;4;2021-01-24;0;0;0;0;0;0;0;0;0;0
FR;4;2021-01-25;0;0;0;0;0;0;0;0;0;0
FR;4;2021-01-26;0;0;0;0;0;0;0;0;0;0
FR;4;2021-01-27;0;0;0;0;0;0;0;0;0;0
FR;4;2021-01-28;0;0;0;0;0;0;0;0;0;0
FR;4;2021-01-29;0;0;0;0;0;0;0;0;0;0
FR;4;2021-01-30;0;0;0;0;0;0;0;0;0;0
FR;4;2021-01-31;0;0;0;0;0;0;0;0;0;0
FR;4;2021-02-01;0;0;0;0;0;0;0;0;0;0
FR;4;2021-02-02;0;0;0;0;0;0;0;0;0;0
FR;4;2021-02-03;0;0;0;0;0;0;0;0;0;0
FR;4;2021-02-04;0;0;0;0;0;0;0;0;0;0
FR;4;2021-02-05;0;0;0;0;0;0;0;0;0;0
FR;4;2021-02-06;0;0;0;0;0;0;0;0;0;0
FR;4;2021-02-07;0;0;0;0;0;0;0;0;0;0
FR;4;2021-02-08;0;0;0;0;0;0;0;0;0;0
FR;4;2021-02-09;0;0;0;0;0;0;0;0;0;0
FR;4;2021-02-10;0;0;0;0;0;0;0;0;0;0
FR;4;2021-02-11;0;0;0;0;0;0;0;0;0;0
FR;4;2021-02-12;0;0;0;0;0;0;0;0;0;0
FR;4;2021-02-13;0;0;0;0;0;0;0;0;0;0
FR;4;2021-02-14;0;0;0;0;0;0;0;0;0;0
FR;4;2021-02-15;0;0;0;0;0;0;0;0;0;0
FR;4;2021-02-16;0;0;0;0;0;0;0;0;0;0
FR;4;2021-02-17;0;0;0;0;0;0;0;0;0;0
FR;4;2021-02-18;0;0;0;0;0;0;0;0;0;0
FR;4;2021-02-19;0;0;0;0;0;0;0;0;0;0
FR;4;2021-02-20;0;0;0;0;0;0;0;0;0;0
FR;4;2021-02-21;0;0;0;0;0;0;0;0;0;0
FR;4;2021-02-22;0;0;0;0;0;0;0;0;0;0
FR;4;2021-02-23;0;0;0;0;0;0;0;0;0;0
FR;4;2021-02-24;0;0;0;0;0;0;0;0;0;0
FR;4;2021-02-25;0;0;0;0;0;0;0;0;0;0
FR;4;2021-02-26;0;0;0;0;0;0;0;0;0;0
FR;4;2021-02-27;0;0;0;0;0;0;0;0;0;0
FR;4;2021-02-28;0;0;0;0;0;0;0;0;0;0
FR;4;2021-03-01;0;0;0;0;0;0;0;0;0;0
FR;4;2021-03-02;0;0;0;0;0;0;0;0;0;0
FR;4;2021-03-03;0;0;0;0;0;0;0;0;0;0
FR;4;2021-03-04;0;0;0;0;0;0;0;0;0;0
FR;4;2021-03-05;0;0;0;0;0;0;0;0;0;0
FR;4;2021-03-06;0;0;0;0;0;0;0;0;0;0
FR;4;2021-03-07;0;0;0;0;0;0;0;0;0;0
FR;4;2021-03-08;0;0;0;0;0;0;0;0;0;0
FR;4;2021-03-09;0;0;0;0;0;0;0;0;0;0
FR;4;2021-03-10;0;0;0;0;0;0;0;0;0;0
FR;4;2021-03-11;0;0;0;0;0;0;0;0;0;0
FR;4;2021-03-12;0;0;0;0;0;0;0;0;0;0
FR;4;2021-03-13;0;0;0;0;0;0;0;0;0;0
FR;4;2021-03-14;0;0;0;0;0;0;0;0;0;0
FR;4;2021-03-15;0;0;0;0;0;0;0;0;0;0
FR;4;2021-03-16;0;0;0;0;0;0;0;0;0;0
FR;4;2021-03-17;0;0;0;0;0;0;0;0;0;0
FR;4;2021-03-18;0;0;0;0;0;0;0;0;0;0
FR;4;2021-03-19;0;0;0;0;0;0;0;0;0;0
FR;4;2021-03-20;0;0;0;0;0;0;0;0;0;0
FR;4;2021-03-21;0;0;0;0;0;0;0;0;0;0
FR;4;2021-03-22;0;0;0;0;0;0;0;0;0;0
FR;4;2021-03-23;0;0;0;0;0;0;0;0;0;0
FR;4;2021-03-24;0;0;0;0;0;0;0;0;0;0
FR;4;2021-03-25;0;0;0;0;0;0;0;0;0;0
FR;4;2021-03-26;0;0;0;0;0;0;0;0;0;0
FR;4;2021-03-27;0;0;0;0;0;0;0;0;0;0
FR;4;2021-03-28;0;0;0;0;0;0;0;0;0;0
FR;4;2021-03-29;0;0;0;0;0;0;0;0;0;0
FR;4;2021-03-30;0;0;0;0;0;0;0;0;0;0
FR;4;2021-03-31;0;0;0;0;0;0;0;0;0;0
FR;4;2021-04-01;0;0;0;0;0;0;0;0;0;0
FR;4;2021-04-02;0;0;0;0;0;0;0;0;0;0
FR;4;2021-04-03;0;0;0;0;0;0;0;0;0;0
FR;4;2021-04-04;0;0;0;0;0;0;0;0;0;0
FR;4;2021-04-05;0;0;0;0;0;0;0;0;0;0
FR;4;2021-04-06;0;0;0;0;0;0;0;0;0;0
FR;4;2021-04-07;0;0;0;0;0;0;0;0;0;0
FR;4;2021-04-08;0;0;0;0;0;0;0;0;0;0
FR;4;2021-04-09;0;0;0;0;0;0;0;0;0;0
FR;4;2021-04-10;0;0;0;0;0;0;0;0;0;0
FR;4;2021-04-11;0;0;0;0;0;0;0;0;0;0
FR;4;2021-04-12;0;0;0;0;0;0;0;0;0;0
FR;4;2021-04-13;0;0;0;0;0;0;0;0;0;0
FR;4;2021-04-14;0;0;0;0;0;0;0;0;0;0
FR;4;2021-04-15;0;0;0;0;0;0;0;0;0;0
FR;4;2021-04-16;0;0;0;0;0;0;0;0;0;0
FR;4;2021-04-17;0;0;0;0;0;0;0;0;0;0
FR;4;2021-04-18;0;0;0;0;0;0;0;0;0;0
FR;4;2021-04-19;0;0;0;0;0;0;0;0;0;0
FR;4;2021-04-20;0;0;0;0;0;0;0;0;0;0
FR;4;2021-04-21;0;0;0;0;0;0;0;0;0;0
FR;4;2021-04-22;0;0;0;0;0;0;0;0;0;0
FR;4;2021-04-23;3847;0;0;0;0;3847;0;0;0;0
FR;4;2021-04-24;1569;0;0;0;0;5416;0;0;0;0
FR;4;2021-04-25;125;0;0;0;0;5541;0;0;0;0
FR;4;2021-04-26;2869;1;0;0;0;8410;1;0;0;0
FR;4;2021-04-27;9520;3;0;0;0;17930;4;0;0;0
FR;4;2021-04-28;9906;6;0;0;0;27836;10;0;0;0
FR;4;2021-04-29;15992;8;0;0;0;43828;18;0;0;0
FR;4;2021-04-30;19233;10;0;0;0;63061;28;0;0;0
FR;4;2021-05-01;1994;6;0;0;0;65055;34;0;0;0
FR;4;2021-05-02;483;0;0;0;0;65538;34;0;0;0
FR;4;2021-05-03;5064;2;0;0;0;70602;36;0;0;0
FR;4;2021-05-04;8401;11;0;0;0;79003;47;0;0;0
FR;4;2021-05-05;6189;7;0;0;0;85192;54;0;0;0
FR;4;2021-05-06;11383;11;0;0;0;96575;65;0;0;0
FR;4;2021-05-07;19125;9;0;0;0;115700;74;0;0;0
FR;4;2021-05-08;2378;6;0;0;0;118078;80;0;0;0
FR;4;2021-05-09;686;3;0;0;0;118764;83;0;0;0
FR;4;2021-05-10;7242;5;1;0;0;126006;88;1;0;0
FR;4;2021-05-11;14320;12;0;0;0;140326;100;1;0;0
FR;4;2021-05-12;10171;15;0;0;0;150497;115;1;0;0
FR;4;2021-05-13;1583;4;0;0;0;152080;119;1;0;0
FR;4;2021-05-14;7767;7;0;0;0;159847;126;1;0;0
FR;4;2021-05-15;3720;8;1;0;0;163567;134;2;0;0
FR;4;2021-05-16;417;1;0;0;0;163984;135;2;0;0
FR;4;2021-05-17;4477;6;0;0;0;168461;141;2;0;0
FR;4;2021-05-18;8761;10;0;0;0;177222;151;2;0;0
FR;4;2021-05-19;5693;7;0;0;0;182915;158;2;0;0
FR;4;2021-05-20;9483;7;0;0;0;192398;165;2;0;0
FR;4;2021-05-21;12803;30;0;0;0;205201;195;2;0;0
FR;4;2021-05-22;5058;15;0;0;0;210259;210;2;0;0
FR;4;2021-05-23;494;4;0;0;0;210753;214;2;0;0
FR;4;2021-05-24;1058;7;0;0;0;211811;221;2;0;0
FR;4;2021-05-25;7631;16;0;0;0;219442;237;2;0;0
FR;4;2021-05-26;7728;16;0;0;0;227170;253;2;0;0
FR;4;2021-05-27;14333;35;0;0;0;241503;288;2;0;0
FR;4;2021-05-28;26589;82;1;0;0;268092;370;3;0;0
FR;4;2021-05-29;11385;18;0;0;0;279477;388;3;0;0
FR;4;2021-05-30;973;6;0;0;0;280450;394;3;0;0
FR;4;2021-05-31;12692;21;0;0;0;293142;415;3;0;0
FR;4;2021-06-01;20262;47;1;0;0;313404;462;4;0;0
FR;4;2021-06-02;14521;33;0;0;0;327925;495;4;0;0
FR;4;2021-06-03;19427;24;1;0;0;347352;519;5;0;0
FR;4;2021-06-04;22515;47;0;0;0;369867;566;5;0;0
FR;4;2021-06-05;9715;32;0;0;0;379582;598;5;0;0
FR;4;2021-06-06;1039;1;0;0;0;380621;599;5;0;0
FR;4;2021-06-07;9226;19;0;0;0;389847;618;5;0;0
FR;4;2021-06-08;14612;31;0;0;0;404459;649;5;0;0
FR;4;2021-06-09;12205;25;0;0;0;416664;674;5;0;0
FR;4;2021-06-10;15404;30;0;0;0;432068;704;5;0;0
FR;4;2021-06-11;16983;56;0;0;0;449051;760;5;0;0
FR;4;2021-06-12;7448;27;0;0;0;456499;787;5;0;0
FR;4;2021-06-13;907;3;0;0;0;457406;790;5;0;0
FR;4;2021-06-14;6649;26;0;0;0;464055;816;5;0;0
FR;4;2021-06-15;10887;37;0;0;0;474942;853;5;0;0
FR;4;2021-06-16;8908;16;0;0;0;483850;869;5;0;0
FR;4;2021-06-17;10897;37;0;0;0;494747;906;5;0;0
FR;4;2021-06-18;12422;45;0;0;0;507169;951;5;0;0
FR;4;2021-06-19;5567;25;0;0;0;512736;976;5;0;0
FR;4;2021-06-20;823;5;0;0;0;513559;981;5;0;0
FR;4;2021-06-21;5097;20;0;0;0;518656;1001;5;0;0
FR;4;2021-06-22;7911;28;2;0;0;526567;1029;7;0;0
FR;4;2021-06-23;7098;41;2;0;0;533665;1070;9;0;0
FR;4;2021-06-24;8652;46;1;0;0;542317;1116;10;0;0
FR;4;2021-06-25;10171;40;2;0;0;552488;1156;12;0;0
FR;4;2021-06-26;4846;21;0;0;0;557334;1177;12;0;0
FR;4;2021-06-27;764;4;0;0;0;558098;1181;12;0;0
FR;4;2021-06-28;4827;16;1;0;0;562925;1197;13;0;0
FR;4;2021-06-29;7104;28;2;0;0;570029;1225;15;0;0
FR;4;2021-06-30;6721;39;2;0;0;576750;1264;17;0;0
FR;4;2021-07-01;8205;42;0;0;0;584955;1306;17;0;0
FR;4;2021-07-02;9426;53;1;0;0;594381;1359;18;0;0
FR;4;2021-07-03;4846;20;0;0;0;599227;1379;18;0;0
FR;4;2021-07-04;687;5;0;0;0;599914;1384;18;0;0
FR;4;2021-07-05;4772;19;2;0;0;604686;1403;20;0;0
FR;4;2021-07-06;7725;28;4;0;0;612411;1431;24;0;0
FR;4;2021-07-07;7081;34;2;0;0;619492;1465;26;0;0
FR;4;2021-07-08;9230;39;2;0;0;628722;1504;28;0;0
FR;4;2021-07-09;10278;34;1;0;0;639000;1538;29;0;0
FR;4;2021-07-10;4638;14;2;0;0;643638;1552;31;0;0
FR;4;2021-07-11;583;4;1;0;0;644221;1556;32;0;0
FR;4;2021-07-12;5872;29;0;0;0;650093;1585;32;0;0
FR;4;2021-07-13;14232;29;0;0;0;664325;1614;32;0;0
FR;4;2021-07-14;2288;15;0;0;0;666613;1629;32;0;0
FR;4;2021-07-15;18235;36;0;0;0;684848;1665;32;0;0
FR;4;2021-07-16;22835;71;2;0;0;707683;1736;34;0;0
FR;4;2021-07-17;9736;20;0;0;0;717419;1756;34;0;0
FR;4;2021-07-18;1356;4;0;0;0;718775;1760;34;0;0
FR;4;2021-07-19;12989;30;1;0;0;731764;1790;35;0;0
FR;4;2021-07-20;17342;26;1;0;0;749106;1816;36;0;0
FR;4;2021-07-21;15615;33;0;0;0;764721;1849;36;0;0
FR;4;2021-07-22;18244;44;2;0;0;782965;1893;38;0;0
FR;4;2021-07-23;20414;57;7;0;0;803379;1950;45;0;0
FR;4;2021-07-24;9290;32;0;0;0;812669;1982;45;0;0
FR;4;2021-07-25;1353;8;0;0;0;814022;1990;45;0;0
FR;4;2021-07-26;11041;22;0;0;0;825063;2012;45;0;0
FR;4;2021-07-27;14677;35;3;0;0;839740;2047;48;0;0
FR;4;2021-07-28;12930;26;2;0;0;852670;2073;50;0;0
FR;4;2021-07-29;14087;54;4;0;0;866757;2127;54;0;0
FR;4;2021-07-30;15497;46;2;0;0;882254;2173;56;0;0
FR;4;2021-07-31;6840;14;2;0;0;889094;2187;58;0;0
FR;4;2021-08-01;905;1;0;0;0;889999;2188;58;0;0
FR;4;2021-08-02;7915;31;0;0;0;897914;2219;58;0;0
FR;4;2021-08-03;10797;31;2;0;0;908711;2250;60;0;0
FR;4;2021-08-04;9745;29;0;0;0;918456;2279;60;0;0
FR;4;2021-08-05;9821;41;0;0;0;928277;2320;60;0;0
FR;4;2021-08-06;10196;31;3;0;0;938473;2351;63;0;0
FR;4;2021-08-07;5098;30;1;0;0;943571;2381;64;0;0
FR;4;2021-08-08;1219;13;0;0;0;944790;2394;64;0;0
FR;4;2021-08-09;6343;31;0;0;0;951133;2425;64;0;0
FR;4;2021-08-10;8748;18;0;0;0;959881;2443;64;0;0
FR;4;2021-08-11;7941;34;4;0;0;967822;2477;68;0;0
FR;4;2021-08-12;8585;30;1;0;0;976407;2507;69;0;0
FR;4;2021-08-13;7557;25;0;1;0;983964;2532;69;1;0
FR;4;2021-08-14;3791;20;0;0;0;987755;2552;69;1;0
FR;4;2021-08-15;771;5;0;0;0;988526;2557;69;1;0
FR;4;2021-08-16;4007;17;0;0;0;992533;2574;69;1;0
FR;4;2021-08-17;5628;17;1;0;0;998161;2591;70;1;0
FR;4;2021-08-18;5167;37;0;0;0;1003328;2628;70;1;0
FR;4;2021-08-19;5485;33;3;0;0;1008813;2661;73;1;0
FR;4;2021-08-20;5221;25;1;0;0;1014034;2686;74;1;0
FR;4;2021-08-21;2310;21;1;0;0;1016344;2707;75;1;0
FR;4;2021-08-22;406;2;0;0;0;1016750;2709;75;1;0
FR;4;2021-08-23;2932;19;1;0;0;1019682;2728;76;1;0
FR;4;2021-08-24;3756;15;0;0;0;1023438;2743;76;1;0
FR;4;2021-08-25;3542;25;1;0;0;1026980;2768;77;1;0
FR;4;2021-08-26;3713;21;2;0;0;1030693;2789;79;1;0
FR;4;2021-08-27;3617;31;2;0;0;1034310;2820;81;1;0
FR;4;2021-08-28;1725;10;1;0;0;1036035;2830;82;1;0
FR;4;2021-08-29;387;7;1;0;0;1036422;2837;83;1;0
FR;4;2021-08-30;2009;25;0;0;15;1038431;2862;83;1;15
FR;4;2021-08-31;2485;21;0;0;14;1040916;2883;83;1;29
FR;4;2021-09-01;2083;38;1;0;21;1042999;2921;84;1;50
FR;4;2021-09-02;2304;31;4;0;18;1045303;2952;88;1;68
FR;4;2021-09-03;2362;44;5;0;36;1047665;2996;93;1;104
FR;4;2021-09-04;1374;17;0;0;8;1049039;3013;93;1;112
FR;4;2021-09-05;433;2;0;0;2;1049472;3015;93;1;114
FR;4;2021-09-06;1711;61;0;0;22;1051183;3076;93;1;136
FR;4;2021-09-07;1678;18;0;0;8;1052861;3094;93;1;144
FR;4;2021-09-08;1285;26;3;0;19;1054146;3120;96;1;163
FR;4;2021-09-09;1388;23;2;0;9;1055534;3143;98;1;172
FR;4;2021-09-10;1521;31;2;0;23;1057055;3174;100;1;195
FR;4;2021-09-11;744;11;0;0;3;1057799;3185;100;1;198
FR;4;2021-09-12;169;4;0;0;3;1057968;3189;100;1;201
FR;4;2021-09-13;1321;22;1;0;16;1059289;3211;101;1;217
FR;4;2021-09-14;1502;9;2;0;6;1060791;3220;103;1;223
FR;4;2021-09-15;1095;27;1;0;24;1061886;3247;104;1;247
FR;4;2021-09-16;1102;22;2;0;15;1062988;3269;106;1;262
FR;4;2021-09-17;895;21;1;0;12;1063883;3290;107;1;274
FR;4;2021-09-18;464;6;1;0;5;1064347;3296;108;1;279
FR;4;2021-09-19;182;3;0;0;2;1064529;3299;108;1;281
FR;4;2021-09-20;453;19;0;0;13;1064982;3318;108;1;294
FR;4;2021-09-21;431;11;0;0;7;1065413;3329;108;1;301
FR;4;2021-09-22;374;19;2;0;13;1065787;3348;110;1;314
FR;4;2021-09-23;482;16;1;0;15;1066269;3364;111;1;329
FR;4;2021-09-24;412;13;2;0;9;1066681;3377;113;1;338
FR;4;2021-09-25;280;10;1;0;5;1066961;3387;114;1;343
FR;4;2021-09-26;74;2;0;0;1;1067035;3389;114;1;344
FR;4;2021-09-27;262;10;1;0;8;1067297;3399;115;1;352
FR;4;2021-09-28;317;8;0;0;8;1067614;3407;115;1;360
FR;4;2021-09-29;375;19;1;0;13;1067989;3426;116;1;373
FR;4;2021-09-30;364;40;0;0;21;1068353;3466;116;1;394
FR;4;2021-10-01;411;55;0;0;49;1068764;3521;116;1;443
FR;4;2021-10-02;196;22;1;0;13;1068960;3543;117;1;456
FR;4;2021-10-03;86;1;0;0;0;1069046;3544;117;1;456
FR;4;2021-10-04;359;20;1;0;16;1069405;3564;118;1;472
FR;4;2021-10-05;285;19;2;0;15;1069690;3583;120;1;487
FR;4;2021-10-06;246;23;1;0;18;1069936;3606;121;1;505
FR;4;2021-10-07;264;25;2;0;13;1070200;3631;123;1;518
FR;4;2021-10-08;356;24;2;0;20;1070556;3655;125;1;538
FR;4;2021-10-09;193;6;6;0;7;1070749;3661;131;1;545
FR;4;2021-10-10;96;3;2;0;3;1070845;3664;133;1;548
FR;4;2021-10-11;248;15;1;0;14;1071093;3679;134;1;562
FR;4;2021-10-12;208;14;0;0;13;1071301;3693;134;1;575
FR;4;2021-10-13;219;28;1;0;25;1071520;3721;135;1;600
FR;4;2021-10-14;311;21;4;0;15;1071831;3742;139;1;615
FR;4;2021-10-15;322;24;5;0;25;1072153;3766;144;1;640
FR;4;2021-10-16;166;6;2;0;6;1072319;3772;146;1;646
FR;4;2021-10-17;70;2;0;0;1;1072389;3774;146;1;647
FR;4;2021-10-18;281;15;1;0;12;1072670;3789;147;1;659
FR;4;2021-10-19;214;14;2;0;15;1072884;3803;149;1;674
FR;4;2021-10-20;229;27;4;0;15;1073113;3830;153;1;689
FR;4;2021-10-21;242;17;0;0;13;1073355;3847;153;1;702
FR;4;2021-10-22;216;25;2;0;20;1073571;3872;155;1;722
FR;4;2021-10-23;116;16;1;0;15;1073687;3888;156;1;737
FR;4;2021-10-24;38;4;0;0;1;1073725;3892;156;1;738
FR;4;2021-10-25;214;7;2;0;9;1073939;3899;158;1;747
FR;4;2021-10-26;199;14;0;0;12;1074138;3913;158;1;759
FR;4;2021-10-27;196;11;4;0;11;1074334;3924;162;1;770
FR;4;2021-10-28;183;18;4;0;21;1074517;3942;166;1;791
FR;4;2021-10-29;223;15;2;0;13;1074740;3957;168;1;804
FR;4;2021-10-30;102;2;1;0;2;1074842;3959;169;1;806
FR;4;2021-10-31;57;3;2;0;3;1074899;3962;171;1;809
FR;4;2021-11-01;75;27;4;0;24;1074974;3989;175;1;833
FR;4;2021-11-02;160;20;2;0;21;1075134;4009;177;1;854
FR;4;2021-11-03;129;20;8;1;18;1075263;4029;185;2;872
FR;4;2021-11-04;183;15;1;0;12;1075446;4044;186;2;884
FR;4;2021-11-05;130;17;1;0;16;1075576;4061;187;2;900
FR;4;2021-11-06;80;6;1;0;6;1075656;4067;188;2;906
FR;4;2021-11-07;80;2;2;0;4;1075736;4069;190;2;910
FR;4;2021-11-08;159;20;1;0;20;1075895;4089;191;2;930
FR;4;2021-11-09;156;14;3;0;16;1076051;4103;194;2;946
FR;4;2021-11-10;117;29;6;0;31;1076168;4132;200;2;977
FR;4;2021-11-11;97;10;0;0;10;1076265;4142;200;2;987
FR;4;2021-11-12;104;19;2;0;18;1076369;4161;202;2;1005
FR;4;2021-11-13;74;15;2;0;14;1076443;4176;204;2;1019
FR;4;2021-11-14;54;5;4;0;8;1076497;4181;208;2;1027
FR;4;2021-11-15;98;26;2;0;24;1076595;4207;210;2;1051
FR;4;2021-11-16;105;13;2;0;15;1076700;4220;212;2;1066
FR;4;2021-11-17;119;30;4;0;30;1076819;4250;216;2;1096
FR;4;2021-11-18;100;34;13;0;42;1076919;4284;229;2;1138
FR;4;2021-11-19;87;19;3;0;20;1077006;4303;232;2;1158
FR;4;2021-11-20;77;8;1;0;8;1077083;4311;233;2;1166
FR;4;2021-11-21;66;7;2;0;9;1077149;4318;235;2;1175
FR;4;2021-11-22;106;28;9;0;33;1077255;4346;244;2;1208
FR;4;2021-11-23;76;31;5;0;28;1077331;4377;249;2;1236
FR;4;2021-11-24;87;23;11;0;24;1077418;4400;260;2;1260
FR;4;2021-11-25;93;28;14;0;30;1077511;4428;274;2;1290
FR;4;2021-11-26;83;43;12;0;45;1077594;4471;286;2;1335
FR;4;2021-11-27;41;22;15;0;25;1077635;4493;301;2;1360
FR;4;2021-11-28;50;8;0;0;7;1077685;4501;301;2;1367
FR;4;2021-11-29;87;31;16;0;40;1077772;4532;317;2;1407
FR;4;2021-11-30;73;37;12;0;41;1077845;4569;329;2;1448
FR;4;2021-12-01;87;60;19;0;67;1077932;4629;348;2;1515
FR;4;2021-12-02;103;48;19;0;53;1078035;4677;367;2;1568
FR;4;2021-12-03;100;36;15;0;44;1078135;4713;382;2;1612
FR;4;2021-12-04;71;31;18;0;44;1078206;4744;400;2;1656
FR;4;2021-12-05;62;6;1;0;7;1078268;4750;401;2;1663
FR;4;2021-12-06;107;46;19;0;59;1078375;4796;420;2;1722
FR;4;2021-12-07;81;37;9;0;36;1078456;4833;429;2;1758
FR;4;2021-12-08;70;31;16;0;37;1078526;4864;445;2;1795
FR;4;2021-12-09;61;32;10;0;38;1078587;4896;455;2;1833
FR;4;2021-12-10;63;64;20;0;68;1078650;4960;475;2;1901
FR;4;2021-12-11;28;34;7;0;34;1078678;4994;482;2;1935
FR;4;2021-12-12;24;10;3;0;13;1078702;5004;485;2;1948
FR;4;2021-12-13;72;40;14;0;49;1078774;5044;499;2;1997
FR;4;2021-12-14;59;43;17;0;54;1078833;5087;516;2;2051
FR;4;2021-12-15;65;64;28;0;84;1078898;5151;544;2;2135
FR;4;2021-12-16;33;44;19;0;57;1078931;5195;563;2;2192
FR;4;2021-12-17;40;55;12;0;60;1078971;5250;575;2;2252
FR;4;2021-12-18;48;30;2;0;31;1079019;5280;577;2;2283
FR;4;2021-12-19;15;4;1;0;4;1079034;5284;578;2;2287
FR;4;2021-12-20;42;38;10;0;41;1079076;5322;588;2;2328
FR;4;2021-12-21;29;30;15;0;36;1079105;5352;603;2;2364
FR;4;2021-12-22;37;37;10;0;38;1079142;5389;613;2;2402
FR;4;2021-12-23;39;45;8;0;49;1079181;5434;621;2;2451
FR;4;2021-12-24;23;26;10;0;30;1079204;5460;631;2;2481
FR;4;2021-12-25;6;3;3;0;4;1079210;5463;634;2;2485
FR;4;2021-12-26;5;3;1;0;2;1079215;5466;635;2;2487
FR;4;2021-12-27;28;41;9;0;43;1079243;5507;644;2;2530
FR;4;2021-12-28;24;28;7;0;29;1079267;5535;651;2;2559
FR;4;2021-12-29;50;25;11;0;30;1079317;5560;662;2;2589
FR;4;2021-12-30;43;18;12;0;21;1079360;5578;674;2;2610
FR;4;2021-12-31;18;6;8;0;11;1079378;5584;682;2;2621
FR;4;2022-01-01;5;4;4;0;6;1079383;5588;686;2;2627
FR;4;2022-01-02;40;5;16;0;20;1079423;5593;702;2;2647
FR;4;2022-01-03;41;55;21;1;61;1079464;5648;723;3;2708
FR;4;2022-01-04;34;27;13;0;30;1079498;5675;736;3;2738
FR;4;2022-01-05;48;22;19;0;25;1079546;5697;755;3;2763
FR;4;2022-01-06;48;22;23;0;37;1079594;5719;778;3;2800
FR;4;2022-01-07;29;20;15;0;20;1079623;5739;793;3;2820
FR;4;2022-01-08;9;6;10;0;12;1079632;5745;803;3;2832
FR;4;2022-01-09;18;2;3;0;4;1079650;5747;806;3;2836
FR;4;2022-01-10;42;22;19;0;36;1079692;5769;825;3;2872
FR;4;2022-01-11;26;31;12;0;35;1079718;5800;837;3;2907
FR;4;2022-01-12;33;21;13;0;23;1079751;5821;850;3;2930
FR;4;2022-01-13;52;20;27;0;38;1079803;5841;877;3;2968
FR;4;2022-01-14;23;29;13;0;32;1079826;5870;890;3;3000
FR;4;2022-01-15;13;6;8;0;12;1079839;5876;898;3;3012
FR;4;2022-01-16;11;9;12;0;20;1079850;5885;910;3;3032
FR;4;2022-01-17;24;19;12;0;25;1079874;5904;922;3;3057
FR;4;2022-01-18;16;13;8;0;18;1079890;5917;930;3;3075
FR;4;2022-01-19;30;23;11;0;32;1079920;5940;941;3;3107
FR;4;2022-01-20;31;34;12;0;38;1079951;5974;953;3;3145
FR;4;2022-01-21;10;12;19;1;16;1079961;5986;972;4;3161
FR;4;2022-01-22;30;13;2;0;13;1079991;5999;974;4;3174
FR;4;2022-01-23;7;2;4;0;6;1079998;6001;978;4;3180
FR;4;2022-01-24;14;21;8;0;27;1080012;6022;986;4;3207
FR;4;2022-01-25;20;32;9;1;37;1080032;6054;995;5;3244
FR;4;2022-01-26;19;16;8;1;19;1080051;6070;1003;6;3263
FR;4;2022-01-27;20;18;8;0;24;1080071;6088;1011;6;3287
FR;4;2022-01-28;13;23;8;0;26;1080084;6111;1019;6;3313
FR;4;2022-01-29;17;6;5;0;10;1080101;6117;1024;6;3323
FR;4;2022-01-30;18;3;1;0;4;1080119;6120;1025;6;3327
FR;4;2022-01-31;22;27;8;0;31;1080141;6147;1033;6;3358
FR;4;2022-02-01;11;22;11;0;22;1080152;6169;1044;6;3380
FR;4;2022-02-02;17;11;12;2;18;1080169;6180;1056;8;3398
FR;4;2022-02-03;13;23;10;0;27;1080182;6203;1066;8;3425
FR;4;2022-02-04;7;5;7;0;9;1080189;6208;1073;8;3434
FR;4;2022-02-05;7;14;1;0;13;1080196;6222;1074;8;3447
FR;4;2022-02-06;6;3;2;0;4;1080202;6225;1076;8;3451
FR;4;2022-02-07;15;19;7;0;19;1080217;6244;1083;8;3470
FR;4;2022-02-08;17;21;13;1;22;1080234;6265;1096;9;3492
FR;4;2022-02-09;16;11;8;0;15;1080250;6276;1104;9;3507
FR;4;2022-02-10;19;23;9;0;24;1080269;6299;1113;9;3531
FR;4;2022-02-11;18;14;8;0;19;1080287;6313;1121;9;3550
FR;4;2022-02-12;24;6;2;0;6;1080311;6319;1123;9;3556
FR;4;2022-02-13;7;3;3;0;6;1080318;6322;1126;9;3562
FR;4;2022-02-14;20;10;9;0;15;1080338;6332;1135;9;3577
FR;4;2022-02-15;17;7;1;0;7;1080355;6339;1136;9;3584
FR;4;2022-02-16;16;9;10;0;15;1080371;6348;1146;9;3599
FR;4;2022-02-17;11;4;4;0;6;1080382;6352;1150;9;3605
FR;4;2022-02-18;16;15;7;0;20;1080398;6367;1157;9;3625
FR;4;2022-02-19;16;4;2;0;5;1080414;6371;1159;9;3630
FR;4;2022-02-20;7;3;0;0;2;1080421;6374;1159;9;3632
FR;4;2022-02-21;23;3;4;0;5;1080444;6377;1163;9;3637
FR;4;2022-02-22;8;5;10;0;10;1080452;6382;1173;9;3647
FR;4;2022-02-23;16;6;9;0;9;1080468;6388;1182;9;3656
FR;4;2022-02-24;11;5;3;0;6;1080479;6393;1185;9;3662
FR;4;2022-02-25;15;5;7;0;6;1080494;6398;1192;9;3668
FR;4;2022-02-26;26;3;0;0;3;1080520;6401;1192;9;3671
FR;4;2022-02-27;9;0;1;0;1;1080529;6401;1193;9;3672
FR;4;2022-02-28;17;3;2;0;3;1080546;6404;1195;9;3675
FR;4;2022-03-01;7;4;7;0;5;1080553;6408;1202;9;3680
FR;4;2022-03-02;13;3;4;0;6;1080566;6411;1206;9;3686
FR;4;2022-03-03;17;5;1;0;4;1080583;6416;1207;9;3690
FR;4;2022-03-04;7;7;2;1;5;1080590;6423;1209;10;3695
FR;4;2022-03-05;9;2;0;0;2;1080599;6425;1209;10;3697
FR;4;2022-03-06;4;0;1;0;1;1080603;6425;1210;10;3698
FR;4;2022-03-07;10;4;1;0;3;1080613;6429;1211;10;3701
FR;4;2022-03-08;13;3;0;0;3;1080626;6432;1211;10;3704
FR;4;2022-03-09;8;7;2;0;7;1080634;6439;1213;10;3711
FR;4;2022-03-10;5;1;5;0;2;1080639;6440;1218;10;3713
FR;4;2022-03-11;8;4;5;0;2;1080647;6444;1223;10;3715
FR;4;2022-03-12;9;2;0;0;0;1080656;6446;1223;10;3715
FR;4;2022-03-13;5;1;1;0;2;1080661;6447;1224;10;3717
FR;4;2022-03-14;4;1;1;0;2;1080665;6448;1225;10;3719
FR;4;2022-03-15;7;6;3;0;5;1080672;6454;1228;10;3724
FR;4;2022-03-16;7;3;3;0;3;1080679;6457;1231;10;3727
FR;4;2022-03-17;3;4;1;0;5;1080682;6461;1232;10;3732
FR;4;2022-03-18;9;3;0;0;3;1080691;6464;1232;10;3735
FR;4;2022-03-19;1;1;0;0;1;1080692;6465;1232;10;3736
FR;4;2022-03-20;2;0;2;0;1;1080694;6465;1234;10;3737
FR;4;2022-03-21;5;3;1;0;4;1080699;6468;1235;10;3741
FR;4;2022-03-22;3;2;2;0;3;1080702;6470;1237;10;3744
FR;4;2022-03-23;6;4;4;0;7;1080708;6474;1241;10;3751
FR;4;2022-03-24;2;6;3;1;7;1080710;6480;1244;11;3758
FR;4;2022-03-25;3;1;2;0;1;1080713;6481;1246;11;3759
FR;4;2022-03-26;5;5;0;0;5;1080718;6486;1246;11;3764
FR;4;2022-03-27;1;0;2;0;1;1080719;6486;1248;11;3765
FR;4;2022-03-28;5;1;3;0;3;1080724;6487;1251;11;3768
FR;4;2022-03-29;8;0;4;1;0;1080732;6487;1255;12;3768
FR;4;2022-03-30;3;4;0;0;4;1080735;6491;1255;12;3772
FR;4;2022-03-31;2;3;1;1;3;1080737;6494;1256;13;3775
FR;4;2022-04-01;14;2;5;0;5;1080751;6496;1261;13;3780
FR;4;2022-04-02;4;4;0;0;3;1080755;6500;1261;13;3783
FR;4;2022-04-03;0;0;0;0;0;1080755;6500;1261;13;3783
FR;4;2022-04-04;4;4;4;0;5;1080759;6504;1265;13;3788
FR;4;2022-04-05;3;3;1;1;2;1080762;6507;1266;14;3790
FR;4;2022-04-06;6;0;0;0;0;1080768;6507;1266;14;3790
FR;4;2022-04-07;3;2;3;2;5;1080771;6509;1269;16;3795
FR;4;2022-04-08;4;1;1;0;1;1080775;6510;1270;16;3796
FR;4;2022-04-09;0;0;1;1;1;1080775;6510;1271;17;3797
FR;4;2022-04-10;1;2;0;0;2;1080776;6512;1271;17;3799
FR;4;2022-04-11;4;3;4;0;5;1080780;6515;1275;17;3804
FR;4;2022-04-12;3;1;4;0;2;1080783;6516;1279;17;3806
FR;4;2022-04-13;5;7;2;0;9;1080788;6523;1281;17;3815
FR;4;2022-04-14;6;4;2;1;5;1080794;6527;1283;18;3820
FR;4;2022-04-15;5;8;1;0;9;1080799;6535;1284;18;3829
FR;4;2022-04-16;1;0;0;0;0;1080800;6535;1284;18;3829
FR;4;2022-04-17;2;1;0;0;1;1080802;6536;1284;18;3830
FR;4;2022-04-18;2;2;5;0;3;1080804;6538;1289;18;3833
FR;4;2022-04-19;2;0;1;0;0;1080806;6538;1290;18;3833
FR;4;2022-04-20;14;4;1;0;3;1080820;6542;1291;18;3836
FR;4;2022-04-21;7;1;0;0;1;1080827;6543;1291;18;3837
FR;4;2022-04-22;1;1;2;0;2;1080828;6544;1293;18;3839
FR;4;2022-04-23;2;3;3;0;6;1080830;6547;1296;18;3845
FR;4;2022-04-24;0;2;0;0;2;1080830;6549;1296;18;3847
FR;4;2022-04-25;3;4;3;0;7;1080833;6553;1299;18;3854
FR;4;2022-04-26;5;6;1;0;6;1080838;6559;1300;18;3860
FR;4;2022-04-27;4;1;1;1;1;1080842;6560;1301;19;3861
FR;4;2022-04-28;3;5;5;0;6;1080845;6565;1306;19;3867
FR;4;2022-04-29;6;3;0;0;2;1080851;6568;1306;19;3869
FR;4;2022-04-30;0;1;1;0;2;1080851;6569;1307;19;3871
FR;4;2022-05-01;0;0;0;0;0;1080851;6569;1307;19;3871
FR;4;2022-05-02;5;16;6;0;19;1080856;6585;1313;19;3890
FR;4;2022-05-03;2;6;2;0;7;1080858;6591;1315;19;3897
FR;4;2022-05-04;7;4;1;0;4;1080865;6595;1316;19;3901
FR;4;2022-05-05;2;2;1;1;1;1080867;6597;1317;20;3902
FR;4;2022-05-06;3;3;1;0;2;1080870;6600;1318;20;3904
FR;4;2022-05-07;0;0;0;0;0;1080870;6600;1318;20;3904
FR;4;2022-05-08;1;1;0;0;1;1080871;6601;1318;20;3905
FR;4;2022-05-09;5;1;0;0;1;1080876;6602;1318;20;3906
FR;4;2022-05-10;1;1;0;2;3;1080877;6603;1318;22;3909
FR;4;2022-05-11;3;2;3;0;5;1080880;6605;1321;22;3914
FR;4;2022-05-12;6;3;1;1;4;1080886;6608;1322;23;3918
FR;4;2022-05-13;1;0;2;0;2;1080887;6608;1324;23;3920
FR;4;2022-05-14;0;2;0;0;2;1080887;6610;1324;23;3922
FR;4;2022-05-15;2;2;0;0;0;1080889;6612;1324;23;3922
FR;4;2022-05-16;5;2;2;0;2;1080894;6614;1326;23;3924
FR;4;2022-05-17;5;1;2;0;3;1080899;6615;1328;23;3927
FR;4;2022-05-18;2;5;0;0;5;1080901;6620;1328;23;3932
FR;4;2022-05-19;2;2;3;0;4;1080903;6622;1331;23;3936
FR;4;2022-05-20;3;2;3;0;2;1080906;6624;1334;23;3938
FR;4;2022-05-21;2;0;1;0;1;1080908;6624;1335;23;3939
FR;4;2022-05-22;0;0;1;0;1;1080908;6624;1336;23;3940
FR;4;2022-05-23;0;0;2;0;0;1080908;6624;1338;23;3940
FR;4;2022-05-24;1;4;0;0;4;1080909;6628;1338;23;3944
FR;4;2022-05-25;1;3;0;0;1;1080910;6631;1338;23;3945
FR;4;2022-05-26;4;0;1;0;1;1080914;6631;1339;23;3946
FR;4;2022-05-27;0;1;0;1;1;1080914;6632;1339;24;3947
FR;4;2022-05-28;1;0;0;0;0;1080915;6632;1339;24;3947
FR;4;2022-05-29;1;0;1;0;1;1080916;6632;1340;24;3948
FR;4;2022-05-30;2;4;2;0;5;1080918;6636;1342;24;3953
FR;4;2022-05-31;2;1;0;0;1;1080920;6637;1342;24;3954
FR;4;2022-06-01;1;11;7;0;15;1080921;6648;1349;24;3969
FR;4;2022-06-02;3;5;2;0;5;1080924;6653;1351;24;3974
FR;4;2022-06-03;2;5;4;1;6;1080926;6658;1355;25;3980
FR;4;2022-06-04;0;1;1;0;1;1080926;6659;1356;25;3981
FR;4;2022-06-05;0;0;0;0;0;1080926;6659;1356;25;3981
FR;4;2022-06-06;5;0;3;0;2;1080931;6659;1359;25;3983
FR;4;2022-06-07;5;1;0;1;1;1080936;6660;1359;26;3984
FR;4;2022-06-08;0;3;3;0;6;1080936;6663;1362;26;3990
FR;4;2022-06-09;1;2;0;0;1;1080937;6665;1362;26;3991
FR;4;2022-06-10;3;0;3;0;1;1080940;6665;1365;26;3992
FR;4;2022-06-11;1;0;0;0;0;1080941;6665;1365;26;3992
FR;4;2022-06-12;4;0;0;0;0;1080945;6665;1365;26;3992
FR;4;2022-06-13;4;2;3;0;2;1080949;6667;1368;26;3994
FR;4;2022-06-14;4;2;0;0;2;1080953;6669;1368;26;3996
FR;4;2022-06-15;6;0;4;0;0;1080959;6669;1372;26;3996
FR;4;2022-06-16;1;2;1;1;1;1080960;6671;1373;27;3997
FR;4;2022-06-17;6;1;0;0;1;1080966;6672;1373;27;3998
FR;4;2022-06-18;0;0;0;0;0;1080966;6672;1373;27;3998
FR;4;2022-06-19;0;0;0;0;0;1080966;6672;1373;27;3998
FR;4;2022-06-20;4;2;2;1;3;1080970;6674;1375;28;4001
FR;4;2022-06-21;4;2;3;1;3;1080974;6676;1378;29;4004
FR;4;2022-06-22;3;1;0;0;1;1080977;6677;1378;29;4005
FR;4;2022-06-23;3;3;3;0;5;1080980;6680;1381;29;4010
FR;4;2022-06-24;3;0;2;0;0;1080983;6680;1383;29;4010
FR;4;2022-06-25;1;0;1;1;1;1080984;6680;1384;30;4011
FR;4;2022-06-26;0;0;1;0;1;1080984;6680;1385;30;4012
FR;4;2022-06-27;1;2;0;3;2;1080985;6682;1385;33;4014
FR;4;2022-06-28;0;4;2;1;5;1080985;6686;1387;34;4019
FR;4;2022-06-29;1;2;0;0;2;1080986;6688;1387;34;4021
FR;4;2022-06-30;1;0;0;0;0;1080987;6688;1387;34;4021
FR;4;2022-07-01;2;4;8;0;4;1080989;6692;1395;34;4025
FR;4;2022-07-02;0;1;0;0;0;1080989;6693;1395;34;4025
FR;4;2022-07-03;0;0;0;0;0;1080989;6693;1395;34;4025
FR;4;2022-07-04;3;0;0;0;0;1080992;6693;1395;34;4025
FR;4;2022-07-05;1;0;0;0;0;1080993;6693;1395;34;4025
FR;4;2022-07-06;5;0;1;1;0;1080998;6693;1396;35;4025
FR;4;2022-07-07;1;0;2;1;0;1080999;6693;1398;36;4025
FR;4;2022-07-08;2;1;0;0;1;1081001;6694;1398;36;4026
FR;4;2022-07-09;2;2;1;0;3;1081003;6696;1399;36;4029
FR;4;2022-07-10;2;0;0;0;0;1081005;6696;1399;36;4029
FR;4;2022-07-11;2;0;2;0;0;1081007;6696;1401;36;4029
FR;4;2022-07-12;0;0;1;0;1;1081007;6696;1402;36;4030
FR;4;2022-07-13;2;2;3;0;2;1081009;6698;1405;36;4032
FR;4;2022-07-14;3;0;1;0;0;1081012;6698;1406;36;4032
FR;4;2022-07-15;8;2;0;0;2;1081020;6700;1406;36;4034
FR;4;2022-07-16;3;0;0;2;0;1081023;6700;1406;38;4034
FR;4;2022-07-17;0;0;0;0;0;1081023;6700;1406;38;4034
FR;4;2022-07-18;2;2;2;0;2;1081025;6702;1408;38;4036
FR;4;2022-07-19;3;0;1;0;1;1081028;6702;1409;38;4037
FR;4;2022-07-20;10;0;0;0;0;1081038;6702;1409;38;4037
FR;4;2022-07-21;2;1;1;0;1;1081040;6703;1410;38;4038
FR;4;2022-07-22;3;0;3;0;1;1081043;6703;1413;38;4039
FR;4;2022-07-23;1;2;0;0;1;1081044;6705;1413;38;4040
FR;4;2022-07-24;0;0;0;0;0;1081044;6705;1413;38;4040
FR;4;2022-07-25;4;0;0;0;0;1081048;6705;1413;38;4040
FR;4;2022-07-26;2;0;0;0;0;1081050;6705;1413;38;4040
FR;4;2022-07-27;2;1;0;0;0;1081052;6706;1413;38;4040
FR;4;2022-07-28;3;0;0;0;0;1081055;6706;1413;38;4040
FR;4;2022-07-29;2;0;1;0;0;1081057;6706;1414;38;4040
FR;4;2022-07-30;3;0;2;0;0;1081060;6706;1416;38;4040
FR;4;2022-07-31;0;0;0;0;0;1081060;6706;1416;38;4040
FR;4;2022-08-01;0;0;2;0;1;1081060;6706;1418;38;4041
FR;4;2022-08-02;5;0;0;0;0;1081065;6706;1418;38;4041
FR;4;2022-08-03;0;2;1;0;2;1081065;6708;1419;38;4043
FR;4;2022-08-04;3;1;0;0;1;1081068;6709;1419;38;4044
FR;4;2022-08-05;2;0;1;0;0;1081070;6709;1420;38;4044
FR;4;2022-08-06;2;0;0;0;0;1081072;6709;1420;38;4044
FR;4;2022-08-07;3;0;0;0;0;1081075;6709;1420;38;4044
FR;4;2022-08-08;1;0;1;1;1;1081076;6709;1421;39;4045
FR;4;2022-08-09;1;0;1;2;1;1081077;6709;1422;41;4046
FR;4;2022-08-10;4;1;1;0;1;1081081;6710;1423;41;4047
FR;4;2022-08-11;1;0;0;0;0;1081082;6710;1423;41;4047
FR;4;2022-08-12;4;0;1;0;0;1081086;6710;1424;41;4047
FR;4;2022-08-13;0;0;0;0;0;1081086;6710;1424;41;4047
FR;4;2022-08-14;0;0;0;0;0;1081086;6710;1424;41;4047
FR;4;2022-08-15;0;0;2;0;0;1081086;6710;1426;41;4047
FR;4;2022-08-16;0;0;1;0;1;1081086;6710;1427;41;4048
FR;4;2022-08-17;1;0;0;0;0;1081087;6710;1427;41;4048
FR;4;2022-08-18;0;0;0;0;0;1081087;6710;1427;41;4048
FR;4;2022-08-19;3;0;0;0;0;1081090;6710;1427;41;4048
FR;4;2022-08-20;1;0;0;0;0;1081091;6710;1427;41;4048
FR;4;2022-08-21;1;0;0;0;0;1081092;6710;1427;41;4048
FR;4;2022-08-22;3;0;0;0;0;1081095;6710;1427;41;4048
FR;4;2022-08-23;1;0;0;0;0;1081096;6710;1427;41;4048
FR;4;2022-08-24;1;0;0;0;0;1081097;6710;1427;41;4048
FR;4;2022-08-25;0;0;1;0;0;1081097;6710;1428;41;4048
FR;4;2022-08-26;1;0;0;1;0;1081098;6710;1428;42;4048
FR;4;2022-08-27;1;0;0;0;0;1081099;6710;1428;42;4048
FR;4;2022-08-28;0;0;0;0;0;1081099;6710;1428;42;4048
FR;4;2022-08-29;1;0;0;0;0;1081100;6710;1428;42;4048
FR;4;2022-08-30;1;0;0;0;0;1081101;6710;1428;42;4048
FR;4;2022-08-31;0;1;0;0;1;1081101;6711;1428;42;4049
FR;4;2022-09-01;1;0;0;0;0;1081102;6711;1428;42;4049
FR;4;2022-09-02;1;0;0;0;0;1081103;6711;1428;42;4049
FR;4;2022-09-03;0;0;0;0;0;1081103;6711;1428;42;4049
FR;4;2022-09-04;0;0;0;0;0;1081103;6711;1428;42;4049
FR;5;2020-12-27;0;0;0;0;0;0;0;0;0;0
FR;5;2020-12-28;0;0;0;0;0;0;0;0;0;0
FR;5;2020-12-29;0;0;0;0;0;0;0;0;0;0
FR;5;2020-12-30;0;0;0;0;0;0;0;0;0;0
FR;5;2020-12-31;0;0;0;0;0;0;0;0;0;0
FR;5;2021-01-01;0;0;0;0;0;0;0;0;0;0
FR;5;2021-01-02;0;0;0;0;0;0;0;0;0;0
FR;5;2021-01-03;0;0;0;0;0;0;0;0;0;0
FR;5;2021-01-04;0;0;0;0;0;0;0;0;0;0
FR;5;2021-01-05;0;0;0;0;0;0;0;0;0;0
FR;5;2021-01-06;0;0;0;0;0;0;0;0;0;0
FR;5;2021-01-07;0;0;0;0;0;0;0;0;0;0
FR;5;2021-01-08;0;0;0;0;0;0;0;0;0;0
FR;5;2021-01-09;0;0;0;0;0;0;0;0;0;0
FR;5;2021-01-10;0;0;0;0;0;0;0;0;0;0
FR;5;2021-01-11;0;0;0;0;0;0;0;0;0;0
FR;5;2021-01-12;0;0;0;0;0;0;0;0;0;0
FR;5;2021-01-13;0;0;0;0;0;0;0;0;0;0
FR;5;2021-01-14;0;0;0;0;0;0;0;0;0;0
FR;5;2021-01-15;0;0;0;0;0;0;0;0;0;0
FR;5;2021-01-16;0;0;0;0;0;0;0;0;0;0
FR;5;2021-01-17;0;0;0;0;0;0;0;0;0;0
FR;5;2021-01-18;0;0;0;0;0;0;0;0;0;0
FR;5;2021-01-19;0;0;0;0;0;0;0;0;0;0
FR;5;2021-01-20;0;0;0;0;0;0;0;0;0;0
FR;5;2021-01-21;0;0;0;0;0;0;0;0;0;0
FR;5;2021-01-22;0;0;0;0;0;0;0;0;0;0
FR;5;2021-01-23;0;0;0;0;0;0;0;0;0;0
FR;5;2021-01-24;0;0;0;0;0;0;0;0;0;0
FR;5;2021-01-25;0;0;0;0;0;0;0;0;0;0
FR;5;2021-01-26;0;0;0;0;0;0;0;0;0;0
FR;5;2021-01-27;0;0;0;0;0;0;0;0;0;0
FR;5;2021-01-28;0;0;0;0;0;0;0;0;0;0
FR;5;2021-01-29;0;0;0;0;0;0;0;0;0;0
FR;5;2021-01-30;0;0;0;0;0;0;0;0;0;0
FR;5;2021-01-31;0;0;0;0;0;0;0;0;0;0
FR;5;2021-02-01;0;0;0;0;0;0;0;0;0;0
FR;5;2021-02-02;0;0;0;0;0;0;0;0;0;0
FR;5;2021-02-03;0;0;0;0;0;0;0;0;0;0
FR;5;2021-02-04;0;0;0;0;0;0;0;0;0;0
FR;5;2021-02-05;0;0;0;0;0;0;0;0;0;0
FR;5;2021-02-06;0;0;0;0;0;0;0;0;0;0
FR;5;2021-02-07;0;0;0;0;0;0;0;0;0;0
FR;5;2021-02-08;0;0;0;0;0;0;0;0;0;0
FR;5;2021-02-09;0;0;0;0;0;0;0;0;0;0
FR;5;2021-02-10;0;0;0;0;0;0;0;0;0;0
FR;5;2021-02-11;0;0;0;0;0;0;0;0;0;0
FR;5;2021-02-12;0;0;0;0;0;0;0;0;0;0
FR;5;2021-02-13;0;0;0;0;0;0;0;0;0;0
FR;5;2021-02-14;0;0;0;0;0;0;0;0;0;0
FR;5;2021-02-15;0;0;0;0;0;0;0;0;0;0
FR;5;2021-02-16;0;0;0;0;0;0;0;0;0;0
FR;5;2021-02-17;0;0;0;0;0;0;0;0;0;0
FR;5;2021-02-18;0;0;0;0;0;0;0;0;0;0
FR;5;2021-02-19;0;0;0;0;0;0;0;0;0;0
FR;5;2021-02-20;0;0;0;0;0;0;0;0;0;0
FR;5;2021-02-21;0;0;0;0;0;0;0;0;0;0
FR;5;2021-02-22;0;0;0;0;0;0;0;0;0;0
FR;5;2021-02-23;0;0;0;0;0;0;0;0;0;0
FR;5;2021-02-24;0;0;0;0;0;0;0;0;0;0
FR;5;2021-02-25;0;0;0;0;0;0;0;0;0;0
FR;5;2021-02-26;0;0;0;0;0;0;0;0;0;0
FR;5;2021-02-27;0;0;0;0;0;0;0;0;0;0
FR;5;2021-02-28;0;0;0;0;0;0;0;0;0;0
FR;5;2021-03-01;0;0;0;0;0;0;0;0;0;0
FR;5;2021-03-02;0;0;0;0;0;0;0;0;0;0
FR;5;2021-03-03;0;0;0;0;0;0;0;0;0;0
FR;5;2021-03-04;0;0;0;0;0;0;0;0;0;0
FR;5;2021-03-05;0;0;0;0;0;0;0;0;0;0
FR;5;2021-03-06;0;0;0;0;0;0;0;0;0;0
FR;5;2021-03-07;0;0;0;0;0;0;0;0;0;0
FR;5;2021-03-08;0;0;0;0;0;0;0;0;0;0
FR;5;2021-03-09;0;0;0;0;0;0;0;0;0;0
FR;5;2021-03-10;0;0;0;0;0;0;0;0;0;0
FR;5;2021-03-11;0;0;0;0;0;0;0;0;0;0
FR;5;2021-03-12;0;0;0;0;0;0;0;0;0;0
FR;5;2021-03-13;0;0;0;0;0;0;0;0;0;0
FR;5;2021-03-14;0;0;0;0;0;0;0;0;0;0
FR;5;2021-03-15;0;0;0;0;0;0;0;0;0;0
FR;5;2021-03-16;0;0;0;0;0;0;0;0;0;0
FR;5;2021-03-17;0;0;0;0;0;0;0;0;0;0
FR;5;2021-03-18;0;0;0;0;0;0;0;0;0;0
FR;5;2021-03-19;0;0;0;0;0;0;0;0;0;0
FR;5;2021-03-20;0;0;0;0;0;0;0;0;0;0
FR;5;2021-03-21;0;0;0;0;0;0;0;0;0;0
FR;5;2021-03-22;0;0;0;0;0;0;0;0;0;0
FR;5;2021-03-23;0;0;0;0;0;0;0;0;0;0
FR;5;2021-03-24;0;0;0;0;0;0;0;0;0;0
FR;5;2021-03-25;0;0;0;0;0;0;0;0;0;0
FR;5;2021-03-26;0;0;0;0;0;0;0;0;0;0
FR;5;2021-03-27;0;0;0;0;0;0;0;0;0;0
FR;5;2021-03-28;0;0;0;0;0;0;0;0;0;0
FR;5;2021-03-29;0;0;0;0;0;0;0;0;0;0
FR;5;2021-03-30;0;0;0;0;0;0;0;0;0;0
FR;5;2021-03-31;0;0;0;0;0;0;0;0;0;0
FR;5;2021-04-01;0;0;0;0;0;0;0;0;0;0
FR;5;2021-04-02;0;0;0;0;0;0;0;0;0;0
FR;5;2021-04-03;0;0;0;0;0;0;0;0;0;0
FR;5;2021-04-04;0;0;0;0;0;0;0;0;0;0
FR;5;2021-04-05;0;0;0;0;0;0;0;0;0;0
FR;5;2021-04-06;0;0;0;0;0;0;0;0;0;0
FR;5;2021-04-07;0;0;0;0;0;0;0;0;0;0
FR;5;2021-04-08;0;0;0;0;0;0;0;0;0;0
FR;5;2021-04-09;0;0;0;0;0;0;0;0;0;0
FR;5;2021-04-10;0;0;0;0;0;0;0;0;0;0
FR;5;2021-04-11;0;0;0;0;0;0;0;0;0;0
FR;5;2021-04-12;0;0;0;0;0;0;0;0;0;0
FR;5;2021-04-13;0;0;0;0;0;0;0;0;0;0
FR;5;2021-04-14;0;0;0;0;0;0;0;0;0;0
FR;5;2021-04-15;0;0;0;0;0;0;0;0;0;0
FR;5;2021-04-16;0;0;0;0;0;0;0;0;0;0
FR;5;2021-04-17;0;0;0;0;0;0;0;0;0;0
FR;5;2021-04-18;0;0;0;0;0;0;0;0;0;0
FR;5;2021-04-19;0;0;0;0;0;0;0;0;0;0
FR;5;2021-04-20;0;0;0;0;0;0;0;0;0;0
FR;5;2021-04-21;0;0;0;0;0;0;0;0;0;0
FR;5;2021-04-22;0;0;0;0;0;0;0;0;0;0
FR;5;2021-04-23;0;0;0;0;0;0;0;0;0;0
FR;5;2021-04-24;0;0;0;0;0;0;0;0;0;0
FR;5;2021-04-25;0;0;0;0;0;0;0;0;0;0
FR;5;2021-04-26;0;0;0;0;0;0;0;0;0;0
FR;5;2021-04-27;0;0;0;0;0;0;0;0;0;0
FR;5;2021-04-28;0;0;0;0;0;0;0;0;0;0
FR;5;2021-04-29;0;0;0;0;0;0;0;0;0;0
FR;5;2021-04-30;0;0;0;0;0;0;0;0;0;0
FR;5;2021-05-01;0;0;0;0;0;0;0;0;0;0
FR;5;2021-05-02;0;0;0;0;0;0;0;0;0;0
FR;5;2021-05-03;0;0;0;0;0;0;0;0;0;0
FR;5;2021-05-04;0;0;0;0;0;0;0;0;0;0
FR;5;2021-05-05;0;0;0;0;0;0;0;0;0;0
FR;5;2021-05-06;0;0;0;0;0;0;0;0;0;0
FR;5;2021-05-07;0;0;0;0;0;0;0;0;0;0
FR;5;2021-05-08;0;0;0;0;0;0;0;0;0;0
FR;5;2021-05-09;0;0;0;0;0;0;0;0;0;0
FR;5;2021-05-10;0;0;0;0;0;0;0;0;0;0
FR;5;2021-05-11;0;0;0;0;0;0;0;0;0;0
FR;5;2021-05-12;0;0;0;0;0;0;0;0;0;0
FR;5;2021-05-13;0;0;0;0;0;0;0;0;0;0
FR;5;2021-05-14;0;0;0;0;0;0;0;0;0;0
FR;5;2021-05-15;0;0;0;0;0;0;0;0;0;0
FR;5;2021-05-16;0;0;0;0;0;0;0;0;0;0
FR;5;2021-05-17;0;0;0;0;0;0;0;0;0;0
FR;5;2021-05-18;0;0;0;0;0;0;0;0;0;0
FR;5;2021-05-19;0;0;0;0;0;0;0;0;0;0
FR;5;2021-05-20;0;0;0;0;0;0;0;0;0;0
FR;5;2021-05-21;0;0;0;0;0;0;0;0;0;0
FR;5;2021-05-22;0;0;0;0;0;0;0;0;0;0
FR;5;2021-05-23;0;0;0;0;0;0;0;0;0;0
FR;5;2021-05-24;0;0;0;0;0;0;0;0;0;0
FR;5;2021-05-25;0;0;0;0;0;0;0;0;0;0
FR;5;2021-05-26;0;0;0;0;0;0;0;0;0;0
FR;5;2021-05-27;0;0;0;0;0;0;0;0;0;0
FR;5;2021-05-28;0;0;0;0;0;0;0;0;0;0
FR;5;2021-05-29;0;0;0;0;0;0;0;0;0;0
FR;5;2021-05-30;0;0;0;0;0;0;0;0;0;0
FR;5;2021-05-31;0;0;0;0;0;0;0;0;0;0
FR;5;2021-06-01;0;0;0;0;0;0;0;0;0;0
FR;5;2021-06-02;0;0;0;0;0;0;0;0;0;0
FR;5;2021-06-03;0;0;0;0;0;0;0;0;0;0
FR;5;2021-06-04;0;0;0;0;0;0;0;0;0;0
FR;5;2021-06-05;0;0;0;0;0;0;0;0;0;0
FR;5;2021-06-06;0;0;0;0;0;0;0;0;0;0
FR;5;2021-06-07;0;0;0;0;0;0;0;0;0;0
FR;5;2021-06-08;0;0;0;0;0;0;0;0;0;0
FR;5;2021-06-09;0;0;0;0;0;0;0;0;0;0
FR;5;2021-06-10;0;0;0;0;0;0;0;0;0;0
FR;5;2021-06-11;0;0;0;0;0;0;0;0;0;0
FR;5;2021-06-12;0;0;0;0;0;0;0;0;0;0
FR;5;2021-06-13;0;0;0;0;0;0;0;0;0;0
FR;5;2021-06-14;0;0;0;0;0;0;0;0;0;0
FR;5;2021-06-15;0;0;0;0;0;0;0;0;0;0
FR;5;2021-06-16;0;0;0;0;0;0;0;0;0;0
FR;5;2021-06-17;0;0;0;0;0;0;0;0;0;0
FR;5;2021-06-18;0;0;0;0;0;0;0;0;0;0
FR;5;2021-06-19;0;0;0;0;0;0;0;0;0;0
FR;5;2021-06-20;0;0;0;0;0;0;0;0;0;0
FR;5;2021-06-21;0;0;0;0;0;0;0;0;0;0
FR;5;2021-06-22;0;0;0;0;0;0;0;0;0;0
FR;5;2021-06-23;0;0;0;0;0;0;0;0;0;0
FR;5;2021-06-24;0;0;0;0;0;0;0;0;0;0
FR;5;2021-06-25;0;0;0;0;0;0;0;0;0;0
FR;5;2021-06-26;0;0;0;0;0;0;0;0;0;0
FR;5;2021-06-27;0;0;0;0;0;0;0;0;0;0
FR;5;2021-06-28;0;0;0;0;0;0;0;0;0;0
FR;5;2021-06-29;0;0;0;0;0;0;0;0;0;0
FR;5;2021-06-30;0;0;0;0;0;0;0;0;0;0
FR;5;2021-07-01;0;0;0;0;0;0;0;0;0;0
FR;5;2021-07-02;0;0;0;0;0;0;0;0;0;0
FR;5;2021-07-03;0;0;0;0;0;0;0;0;0;0
FR;5;2021-07-04;0;0;0;0;0;0;0;0;0;0
FR;5;2021-07-05;0;0;0;0;0;0;0;0;0;0
FR;5;2021-07-06;0;0;0;0;0;0;0;0;0;0
FR;5;2021-07-07;0;0;0;0;0;0;0;0;0;0
FR;5;2021-07-08;0;0;0;0;0;0;0;0;0;0
FR;5;2021-07-09;0;0;0;0;0;0;0;0;0;0
FR;5;2021-07-10;0;0;0;0;0;0;0;0;0;0
FR;5;2021-07-11;0;0;0;0;0;0;0;0;0;0
FR;5;2021-07-12;0;0;0;0;0;0;0;0;0;0
FR;5;2021-07-13;0;0;0;0;0;0;0;0;0;0
FR;5;2021-07-14;0;0;0;0;0;0;0;0;0;0
FR;5;2021-07-15;0;0;0;0;0;0;0;0;0;0
FR;5;2021-07-16;0;0;0;0;0;0;0;0;0;0
FR;5;2021-07-17;0;0;0;0;0;0;0;0;0;0
FR;5;2021-07-18;0;0;0;0;0;0;0;0;0;0
FR;5;2021-07-19;0;0;0;0;0;0;0;0;0;0
FR;5;2021-07-20;0;0;0;0;0;0;0;0;0;0
FR;5;2021-07-21;0;0;0;0;0;0;0;0;0;0
FR;5;2021-07-22;0;0;0;0;0;0;0;0;0;0
FR;5;2021-07-23;0;0;0;0;0;0;0;0;0;0
FR;5;2021-07-24;0;0;0;0;0;0;0;0;0;0
FR;5;2021-07-25;0;0;0;0;0;0;0;0;0;0
FR;5;2021-07-26;0;0;0;0;0;0;0;0;0;0
FR;5;2021-07-27;0;0;0;0;0;0;0;0;0;0
FR;5;2021-07-28;0;0;0;0;0;0;0;0;0;0
FR;5;2021-07-29;0;0;0;0;0;0;0;0;0;0
FR;5;2021-07-30;0;0;0;0;0;0;0;0;0;0
FR;5;2021-07-31;0;0;0;0;0;0;0;0;0;0
FR;5;2021-08-01;0;0;0;0;0;0;0;0;0;0
FR;5;2021-08-02;0;0;0;0;0;0;0;0;0;0
FR;5;2021-08-03;0;0;0;0;0;0;0;0;0;0
FR;5;2021-08-04;0;0;0;0;0;0;0;0;0;0
FR;5;2021-08-05;0;0;0;0;0;0;0;0;0;0
FR;5;2021-08-06;0;0;0;0;0;0;0;0;0;0
FR;5;2021-08-07;0;0;0;0;0;0;0;0;0;0
FR;5;2021-08-08;0;0;0;0;0;0;0;0;0;0
FR;5;2021-08-09;0;0;0;0;0;0;0;0;0;0
FR;5;2021-08-10;0;0;0;0;0;0;0;0;0;0
FR;5;2021-08-11;0;0;0;0;0;0;0;0;0;0
FR;5;2021-08-12;0;0;0;0;0;0;0;0;0;0
FR;5;2021-08-13;0;0;0;0;0;0;0;0;0;0
FR;5;2021-08-14;0;0;0;0;0;0;0;0;0;0
FR;5;2021-08-15;0;0;0;0;0;0;0;0;0;0
FR;5;2021-08-16;0;0;0;0;0;0;0;0;0;0
FR;5;2021-08-17;0;0;0;0;0;0;0;0;0;0
FR;5;2021-08-18;0;0;0;0;0;0;0;0;0;0
FR;5;2021-08-19;0;0;0;0;0;0;0;0;0;0
FR;5;2021-08-20;0;0;0;0;0;0;0;0;0;0
FR;5;2021-08-21;0;0;0;0;0;0;0;0;0;0
FR;5;2021-08-22;0;0;0;0;0;0;0;0;0;0
FR;5;2021-08-23;0;0;0;0;0;0;0;0;0;0
FR;5;2021-08-24;0;0;0;0;0;0;0;0;0;0
FR;5;2021-08-25;0;0;0;0;0;0;0;0;0;0
FR;5;2021-08-26;0;0;0;0;0;0;0;0;0;0
FR;5;2021-08-27;0;0;0;0;0;0;0;0;0;0
FR;5;2021-08-28;0;0;0;0;0;0;0;0;0;0
FR;5;2021-08-29;0;0;0;0;0;0;0;0;0;0
FR;5;2021-08-30;0;0;0;0;0;0;0;0;0;0
FR;5;2021-08-31;0;0;0;0;0;0;0;0;0;0
FR;5;2021-09-01;0;0;0;0;0;0;0;0;0;0
FR;5;2021-09-02;0;0;0;0;0;0;0;0;0;0
FR;5;2021-09-03;0;0;0;0;0;0;0;0;0;0
FR;5;2021-09-04;0;0;0;0;0;0;0;0;0;0
FR;5;2021-09-05;0;0;0;0;0;0;0;0;0;0
FR;5;2021-09-06;0;0;0;0;0;0;0;0;0;0
FR;5;2021-09-07;0;0;0;0;0;0;0;0;0;0
FR;5;2021-09-08;0;0;0;0;0;0;0;0;0;0
FR;5;2021-09-09;0;0;0;0;0;0;0;0;0;0
FR;5;2021-09-10;0;0;0;0;0;0;0;0;0;0
FR;5;2021-09-11;0;0;0;0;0;0;0;0;0;0
FR;5;2021-09-12;0;0;0;0;0;0;0;0;0;0
FR;5;2021-09-13;0;0;0;0;0;0;0;0;0;0
FR;5;2021-09-14;0;0;0;0;0;0;0;0;0;0
FR;5;2021-09-15;0;0;0;0;0;0;0;0;0;0
FR;5;2021-09-16;0;0;0;0;0;0;0;0;0;0
FR;5;2021-09-17;0;0;0;0;0;0;0;0;0;0
FR;5;2021-09-18;0;0;0;0;0;0;0;0;0;0
FR;5;2021-09-19;0;0;0;0;0;0;0;0;0;0
FR;5;2021-09-20;0;0;0;0;0;0;0;0;0;0
FR;5;2021-09-21;0;0;0;0;0;0;0;0;0;0
FR;5;2021-09-22;0;0;0;0;0;0;0;0;0;0
FR;5;2021-09-23;0;0;0;0;0;0;0;0;0;0
FR;5;2021-09-24;0;0;0;0;0;0;0;0;0;0
FR;5;2021-09-25;0;0;0;0;0;0;0;0;0;0
FR;5;2021-09-26;0;0;0;0;0;0;0;0;0;0
FR;5;2021-09-27;0;0;0;0;0;0;0;0;0;0
FR;5;2021-09-28;0;0;0;0;0;0;0;0;0;0
FR;5;2021-09-29;0;0;0;0;0;0;0;0;0;0
FR;5;2021-09-30;0;0;0;0;0;0;0;0;0;0
FR;5;2021-10-01;0;0;0;0;0;0;0;0;0;0
FR;5;2021-10-02;0;0;0;0;0;0;0;0;0;0
FR;5;2021-10-03;0;0;0;0;0;0;0;0;0;0
FR;5;2021-10-04;0;0;0;0;0;0;0;0;0;0
FR;5;2021-10-05;0;0;0;0;0;0;0;0;0;0
FR;5;2021-10-06;0;0;0;0;0;0;0;0;0;0
FR;5;2021-10-07;0;0;0;0;0;0;0;0;0;0
FR;5;2021-10-08;0;0;0;0;0;0;0;0;0;0
FR;5;2021-10-09;0;0;0;0;0;0;0;0;0;0
FR;5;2021-10-10;0;0;0;0;0;0;0;0;0;0
FR;5;2021-10-11;0;0;0;0;0;0;0;0;0;0
FR;5;2021-10-12;0;0;0;0;0;0;0;0;0;0
FR;5;2021-10-13;0;0;0;0;0;0;0;0;0;0
FR;5;2021-10-14;0;0;0;0;0;0;0;0;0;0
FR;5;2021-10-15;0;0;0;0;0;0;0;0;0;0
FR;5;2021-10-16;0;0;0;0;0;0;0;0;0;0
FR;5;2021-10-17;0;0;0;0;0;0;0;0;0;0
FR;5;2021-10-18;0;0;0;0;0;0;0;0;0;0
FR;5;2021-10-19;0;0;0;0;0;0;0;0;0;0
FR;5;2021-10-20;0;0;0;0;0;0;0;0;0;0
FR;5;2021-10-21;0;0;0;0;0;0;0;0;0;0
FR;5;2021-10-22;0;0;0;0;0;0;0;0;0;0
FR;5;2021-10-23;0;0;0;0;0;0;0;0;0;0
FR;5;2021-10-24;0;0;0;0;0;0;0;0;0;0
FR;5;2021-10-25;0;0;0;0;0;0;0;0;0;0
FR;5;2021-10-26;0;0;0;0;0;0;0;0;0;0
FR;5;2021-10-27;0;0;0;0;0;0;0;0;0;0
FR;5;2021-10-28;0;0;0;0;0;0;0;0;0;0
FR;5;2021-10-29;0;0;0;0;0;0;0;0;0;0
FR;5;2021-10-30;0;0;0;0;0;0;0;0;0;0
FR;5;2021-10-31;0;0;0;0;0;0;0;0;0;0
FR;5;2021-11-01;0;0;0;0;0;0;0;0;0;0
FR;5;2021-11-02;0;0;0;0;0;0;0;0;0;0
FR;5;2021-11-03;0;0;0;0;0;0;0;0;0;0
FR;5;2021-11-04;0;0;0;0;0;0;0;0;0;0
FR;5;2021-11-05;0;0;0;0;0;0;0;0;0;0
FR;5;2021-11-06;0;0;0;0;0;0;0;0;0;0
FR;5;2021-11-07;0;0;0;0;0;0;0;0;0;0
FR;5;2021-11-08;0;0;0;0;0;0;0;0;0;0
FR;5;2021-11-09;0;0;0;0;0;0;0;0;0;0
FR;5;2021-11-10;0;0;0;0;0;0;0;0;0;0
FR;5;2021-11-11;0;0;0;0;0;0;0;0;0;0
FR;5;2021-11-12;0;0;0;0;0;0;0;0;0;0
FR;5;2021-11-13;0;0;0;0;0;0;0;0;0;0
FR;5;2021-11-14;0;0;0;0;0;0;0;0;0;0
FR;5;2021-11-15;0;0;0;0;0;0;0;0;0;0
FR;5;2021-11-16;0;0;0;0;0;0;0;0;0;0
FR;5;2021-11-17;0;0;0;0;0;0;0;0;0;0
FR;5;2021-11-18;0;0;0;0;0;0;0;0;0;0
FR;5;2021-11-19;0;0;0;0;0;0;0;0;0;0
FR;5;2021-11-20;0;0;0;0;0;0;0;0;0;0
FR;5;2021-11-21;0;0;0;0;0;0;0;0;0;0
FR;5;2021-11-22;0;0;0;0;0;0;0;0;0;0
FR;5;2021-11-23;0;0;0;0;0;0;0;0;0;0
FR;5;2021-11-24;0;0;0;0;0;0;0;0;0;0
FR;5;2021-11-25;0;0;0;0;0;0;0;0;0;0
FR;5;2021-11-26;0;0;0;0;0;0;0;0;0;0
FR;5;2021-11-27;0;0;0;0;0;0;0;0;0;0
FR;5;2021-11-28;0;0;0;0;0;0;0;0;0;0
FR;5;2021-11-29;0;0;0;0;0;0;0;0;0;0
FR;5;2021-11-30;0;0;0;0;0;0;0;0;0;0
FR;5;2021-12-01;0;0;0;0;0;0;0;0;0;0
FR;5;2021-12-02;0;0;0;0;0;0;0;0;0;0
FR;5;2021-12-03;0;0;0;0;0;0;0;0;0;0
FR;5;2021-12-04;0;0;0;0;0;0;0;0;0;0
FR;5;2021-12-05;0;0;0;0;0;0;0;0;0;0
FR;5;2021-12-06;0;0;0;0;0;0;0;0;0;0
FR;5;2021-12-07;0;0;0;0;0;0;0;0;0;0
FR;5;2021-12-08;0;0;0;0;0;0;0;0;0;0
FR;5;2021-12-09;0;0;0;0;0;0;0;0;0;0
FR;5;2021-12-10;0;0;0;0;0;0;0;0;0;0
FR;5;2021-12-11;0;0;0;0;0;0;0;0;0;0
FR;5;2021-12-12;0;0;0;0;0;0;0;0;0;0
FR;5;2021-12-13;0;0;0;0;0;0;0;0;0;0
FR;5;2021-12-14;33;45;77;0;88;33;45;77;0;88
FR;5;2021-12-15;196;44;37;0;49;229;89;114;0;137
FR;5;2021-12-16;181;21;44;0;48;410;110;158;0;185
FR;5;2021-12-17;311;16;72;0;74;721;126;230;0;259
FR;5;2021-12-18;766;24;22;0;29;1487;150;252;0;288
FR;5;2021-12-19;586;15;15;0;17;2073;165;267;0;305
FR;5;2021-12-20;1223;31;35;0;38;3296;196;302;0;343
FR;5;2021-12-21;1535;22;54;1;60;4831;218;356;1;403
FR;5;2021-12-22;4069;40;37;0;46;8900;258;393;1;449
FR;5;2021-12-23;3042;16;21;0;25;11942;274;414;1;474
FR;5;2021-12-24;761;18;9;0;14;12703;292;423;1;488
FR;5;2021-12-25;61;5;2;0;3;12764;297;425;1;491
FR;5;2021-12-26;623;6;3;0;4;13387;303;428;1;495
FR;5;2021-12-27;4082;25;21;0;23;17469;328;449;1;518
FR;5;2021-12-28;5204;23;41;1;43;22673;351;490;2;561
FR;5;2021-12-29;8107;34;66;2;69;30780;385;556;4;630
FR;5;2021-12-30;5173;18;33;0;39;35953;403;589;4;669
FR;5;2021-12-31;1553;8;10;0;11;37506;411;599;4;680
FR;5;2022-01-01;185;2;2;0;3;37691;413;601;4;683
FR;5;2022-01-02;1489;1;1;0;1;39180;414;602;4;684
FR;5;2022-01-03;3066;36;33;0;32;42246;450;635;4;716
FR;5;2022-01-04;3034;39;33;0;42;45280;489;668;4;758
FR;5;2022-01-05;19323;203;97;1;108;64603;692;765;5;866
FR;5;2022-01-06;3746;133;122;0;142;68349;825;887;5;1008
FR;5;2022-01-07;5007;202;48;2;56;73356;1027;935;7;1064
FR;5;2022-01-08;13659;514;45;0;52;87015;1541;980;7;1116
FR;5;2022-01-09;5754;399;15;0;20;92769;1940;995;7;1136
FR;5;2022-01-10;3455;326;25;0;29;96224;2266;1020;7;1165
FR;5;2022-01-11;3671;284;38;0;41;99895;2550;1058;7;1206
FR;5;2022-01-12;22652;3005;90;0;113;122547;5555;1148;7;1319
FR;5;2022-01-13;4037;622;30;0;32;126584;6177;1178;7;1351
FR;5;2022-01-14;4843;582;44;0;51;131427;6759;1222;7;1402
FR;5;2022-01-15;14686;1746;38;3;49;146113;8505;1260;10;1451
FR;5;2022-01-16;4727;666;3;0;5;150840;9171;1263;10;1456
FR;5;2022-01-17;2297;716;26;0;29;153137;9887;1289;10;1485
FR;5;2022-01-18;2430;870;30;0;40;155567;10757;1319;10;1525
FR;5;2022-01-19;18483;6423;74;2;142;174050;17180;1393;12;1667
FR;5;2022-01-20;1920;1068;25;0;34;175970;18248;1418;12;1701
FR;5;2022-01-21;3077;1372;47;1;59;179047;19620;1465;13;1760
FR;5;2022-01-22;10721;3454;33;1;43;189768;23074;1498;14;1803
FR;5;2022-01-23;2629;1415;6;0;10;192397;24489;1504;14;1813
FR;5;2022-01-24;1160;1340;19;0;23;193557;25829;1523;14;1836
FR;5;2022-01-25;1220;1549;20;2;31;194777;27378;1543;16;1867
FR;5;2022-01-26;10752;12027;50;1;89;205529;39405;1593;17;1956
FR;5;2022-01-27;1291;1693;10;0;17;206820;41098;1603;17;1973
FR;5;2022-01-28;1699;3347;16;0;19;208519;44445;1619;17;1992
FR;5;2022-01-29;6240;8041;68;0;96;214759;52486;1687;17;2088
FR;5;2022-01-30;1509;2950;5;0;18;216268;55436;1692;17;2106
FR;5;2022-01-31;589;1773;23;0;24;216857;57209;1715;17;2130
FR;5;2022-02-01;712;1706;10;0;15;217569;58915;1725;17;2145
FR;5;2022-02-02;6958;15656;52;0;94;224527;74571;1777;17;2239
FR;5;2022-02-03;491;1690;14;0;13;225018;76261;1791;17;2252
FR;5;2022-02-04;945;3002;19;0;31;225963;79263;1810;17;2283
FR;5;2022-02-05;3535;8917;23;0;37;229498;88180;1833;17;2320
FR;5;2022-02-06;737;2397;10;0;19;230235;90577;1843;17;2339
FR;5;2022-02-07;884;1596;23;0;25;231119;92173;1866;17;2364
FR;5;2022-02-08;722;1287;18;0;20;231841;93460;1884;17;2384
FR;5;2022-02-09;4544;12878;44;0;76;236385;106338;1928;17;2460
FR;5;2022-02-10;646;1059;14;0;15;237031;107397;1942;17;2475
FR;5;2022-02-11;793;2032;16;0;21;237824;109429;1958;17;2496
FR;5;2022-02-12;2286;6813;33;0;53;240110;116242;1991;17;2549
FR;5;2022-02-13;464;1540;8;0;8;240574;117782;1999;17;2557
FR;5;2022-02-14;678;1288;10;0;13;241252;119070;2009;17;2570
FR;5;2022-02-15;482;886;9;0;14;241734;119956;2018;17;2584
FR;5;2022-02-16;2980;9123;41;1;58;244714;129079;2059;18;2642
FR;5;2022-02-17;436;809;6;0;7;245150;129888;2065;18;2649
FR;5;2022-02-18;649;1408;13;0;17;245799;131296;2078;18;2666
FR;5;2022-02-19;1373;4315;16;0;28;247172;135611;2094;18;2694
FR;5;2022-02-20;247;879;6;0;8;247419;136490;2100;18;2702
FR;5;2022-02-21;221;607;2;0;4;247640;137097;2102;18;2706
FR;5;2022-02-22;262;545;17;0;17;247902;137642;2119;18;2723
FR;5;2022-02-23;1909;6926;23;1;43;249811;144568;2142;19;2766
FR;5;2022-02-24;182;374;6;1;7;249993;144942;2148;20;2773
FR;5;2022-02-25;336;950;13;0;12;250329;145892;2161;20;2785
FR;5;2022-02-26;972;3070;11;0;15;251301;148962;2172;20;2800
FR;5;2022-02-27;150;506;0;0;3;251451;149468;2172;20;2803
FR;5;2022-02-28;162;369;1;0;1;251613;149837;2173;20;2804
FR;5;2022-03-01;130;280;6;0;7;251743;150117;2179;20;2811
FR;5;2022-03-02;1241;4156;28;3;40;252984;154273;2207;23;2851
FR;5;2022-03-03;121;251;5;0;10;253105;154524;2212;23;2861
FR;5;2022-03-04;196;488;13;0;14;253301;155012;2225;23;2875
FR;5;2022-03-05;677;1990;8;0;16;253978;157002;2233;23;2891
FR;5;2022-03-06;108;260;0;0;0;254086;157262;2233;23;2891
FR;5;2022-03-07;71;228;5;0;3;254157;157490;2238;23;2894
FR;5;2022-03-08;46;134;7;1;8;254203;157624;2245;24;2902
FR;5;2022-03-09;910;3078;24;0;36;255113;160702;2269;24;2938
FR;5;2022-03-10;82;202;8;0;12;255195;160904;2277;24;2950
FR;5;2022-03-11;148;369;13;1;15;255343;161273;2290;25;2965
FR;5;2022-03-12;758;1613;13;1;30;256101;162886;2303;26;2995
FR;5;2022-03-13;78;100;0;0;0;256179;162986;2303;26;2995
FR;5;2022-03-14;67;119;7;1;7;256246;163105;2310;27;3002
FR;5;2022-03-15;83;99;4;0;7;256329;163204;2314;27;3009
FR;5;2022-03-16;883;1827;15;3;36;257212;165031;2329;30;3045
FR;5;2022-03-17;68;123;8;4;10;257280;165154;2337;34;3055
FR;5;2022-03-18;172;318;13;4;18;257452;165472;2350;38;3073
FR;5;2022-03-19;751;1163;12;5;33;258203;166635;2362;43;3106
FR;5;2022-03-20;45;93;1;0;1;258248;166728;2363;43;3107
FR;5;2022-03-21;71;120;10;6;15;258319;166848;2373;49;3122
FR;5;2022-03-22;56;119;8;7;9;258375;166967;2381;56;3131
FR;5;2022-03-23;805;1461;14;8;36;259180;168428;2395;64;3167
FR;5;2022-03-24;70;93;8;7;7;259250;168521;2403;71;3174
FR;5;2022-03-25;222;293;14;8;18;259472;168814;2417;79;3192
FR;5;2022-03-26;707;853;12;5;26;260179;169667;2429;84;3218
FR;5;2022-03-27;75;80;0;0;3;260254;169747;2429;84;3221
FR;5;2022-03-28;81;93;1;2;3;260335;169840;2430;86;3224
FR;5;2022-03-29;71;82;10;4;12;260406;169922;2440;90;3236
FR;5;2022-03-30;823;1116;16;13;29;261229;171038;2456;103;3265
FR;5;2022-03-31;102;125;1;4;6;261331;171163;2457;107;3271
FR;5;2022-04-01;114;86;7;12;11;261445;171249;2464;119;3282
FR;5;2022-04-02;330;349;3;3;15;261775;171598;2467;122;3297
FR;5;2022-04-03;54;59;1;0;1;261829;171657;2468;122;3298
FR;5;2022-04-04;40;57;4;1;8;261869;171714;2472;123;3306
FR;5;2022-04-05;52;60;6;7;9;261921;171774;2478;130;3315
FR;5;2022-04-06;421;439;7;15;16;262342;172213;2485;145;3331
FR;5;2022-04-07;45;69;5;7;7;262387;172282;2490;152;3338
FR;5;2022-04-08;134;112;12;13;14;262521;172394;2502;165;3352
FR;5;2022-04-09;311;324;2;5;17;262832;172718;2504;170;3369
FR;5;2022-04-10;43;31;2;0;2;262875;172749;2506;170;3371
FR;5;2022-04-11;50;60;3;2;4;262925;172809;2509;172;3375
FR;5;2022-04-12;59;54;3;3;5;262984;172863;2512;175;3380
FR;5;2022-04-13;382;413;3;8;16;263366;173276;2515;183;3396
FR;5;2022-04-14;48;48;5;5;9;263414;173324;2520;188;3405
FR;5;2022-04-15;91;109;4;4;5;263505;173433;2524;192;3410
FR;5;2022-04-16;188;184;2;1;13;263693;173617;2526;193;3423
FR;5;2022-04-17;12;11;1;0;1;263705;173628;2527;193;3424
FR;5;2022-04-18;9;10;2;0;3;263714;173638;2529;193;3427
FR;5;2022-04-19;75;71;6;1;6;263789;173709;2535;194;3433
FR;5;2022-04-20;361;349;9;6;12;264150;174058;2544;200;3445
FR;5;2022-04-21;42;64;9;10;12;264192;174122;2553;210;3457
FR;5;2022-04-22;113;96;5;4;5;264305;174218;2558;214;3462
FR;5;2022-04-23;209;193;3;2;10;264514;174411;2561;216;3472
FR;5;2022-04-24;37;35;0;0;3;264551;174446;2561;216;3475
FR;5;2022-04-25;69;65;1;1;4;264620;174511;2562;217;3479
FR;5;2022-04-26;60;63;2;1;5;264680;174574;2564;218;3484
FR;5;2022-04-27;335;316;2;7;14;265015;174890;2566;225;3498
FR;5;2022-04-28;81;54;4;5;8;265096;174944;2570;230;3506
FR;5;2022-04-29;117;84;5;19;12;265213;175028;2575;249;3518
FR;5;2022-04-30;183;114;2;3;10;265396;175142;2577;252;3528
FR;5;2022-05-01;11;7;0;0;0;265407;175149;2577;252;3528
FR;5;2022-05-02;52;28;4;5;2;265459;175177;2581;257;3530
FR;5;2022-05-03;84;57;2;5;11;265543;175234;2583;262;3541
FR;5;2022-05-04;278;205;1;2;7;265821;175439;2584;264;3548
FR;5;2022-05-05;62;32;3;4;5;265883;175471;2587;268;3553
FR;5;2022-05-06;105;65;2;3;5;265988;175536;2589;271;3558
FR;5;2022-05-07;171;117;3;10;13;266159;175653;2592;281;3571
FR;5;2022-05-08;8;8;0;0;2;266167;175661;2592;281;3573
FR;5;2022-05-09;44;34;15;3;16;266211;175695;2607;284;3589
FR;5;2022-05-10;54;49;3;4;5;266265;175744;2610;288;3594
FR;5;2022-05-11;326;237;12;7;21;266591;175981;2622;295;3615
FR;5;2022-05-12;46;34;2;2;2;266637;176015;2624;297;3617
FR;5;2022-05-13;109;83;3;8;8;266746;176098;2627;305;3625
FR;5;2022-05-14;209;131;0;1;8;266955;176229;2627;306;3633
FR;5;2022-05-15;22;9;2;0;1;266977;176238;2629;306;3634
FR;5;2022-05-16;52;34;4;5;4;267029;176272;2633;311;3638
FR;5;2022-05-17;72;40;5;0;2;267101;176312;2638;311;3640
FR;5;2022-05-18;289;215;4;4;8;267390;176527;2642;315;3648
FR;5;2022-05-19;45;35;5;3;3;267435;176562;2647;318;3651
FR;5;2022-05-20;76;63;3;10;1;267511;176625;2650;328;3652
FR;5;2022-05-21;242;166;2;3;17;267753;176791;2652;331;3669
FR;5;2022-05-22;20;14;2;5;2;267773;176805;2654;336;3671
FR;5;2022-05-23;42;31;4;3;6;267815;176836;2658;339;3677
FR;5;2022-05-24;47;45;3;2;5;267862;176881;2661;341;3682
FR;5;2022-05-25;329;257;4;1;16;268191;177138;2665;342;3698
FR;5;2022-05-26;17;5;0;1;2;268208;177143;2665;343;3700
FR;5;2022-05-27;99;54;4;4;9;268307;177197;2669;347;3709
FR;5;2022-05-28;100;78;5;3;10;268407;177275;2674;350;3719
FR;5;2022-05-29;14;14;1;0;2;268421;177289;2675;350;3721
FR;5;2022-05-30;56;41;2;1;2;268477;177330;2677;351;3723
FR;5;2022-05-31;57;43;1;8;1;268534;177373;2678;359;3724
FR;5;2022-06-01;257;241;9;2;25;268791;177614;2687;361;3749
FR;5;2022-06-02;63;61;5;0;9;268854;177675;2692;361;3758
FR;5;2022-06-03;81;71;4;5;10;268935;177746;2696;366;3768
FR;5;2022-06-04;156;109;2;1;9;269091;177855;2698;367;3777
FR;5;2022-06-05;18;11;0;0;1;269109;177866;2698;367;3778
FR;5;2022-06-06;16;9;0;1;0;269125;177875;2698;368;3778
FR;5;2022-06-07;50;56;1;1;2;269175;177931;2699;369;3780
FR;5;2022-06-08;283;225;3;4;17;269458;178156;2702;373;3797
FR;5;2022-06-09;52;41;6;3;7;269510;178197;2708;376;3804
FR;5;2022-06-10;80;72;1;1;6;269590;178269;2709;377;3810
FR;5;2022-06-11;173;141;3;3;10;269763;178410;2712;380;3820
FR;5;2022-06-12;17;16;0;0;2;269780;178426;2712;380;3822
FR;5;2022-06-13;56;47;9;3;10;269836;178473;2721;383;3832
FR;5;2022-06-14;59;56;1;3;6;269895;178529;2722;386;3838
FR;5;2022-06-15;266;260;5;2;27;270161;178789;2727;388;3865
FR;5;2022-06-16;47;30;5;2;5;270208;178819;2732;390;3870
FR;5;2022-06-17;98;67;5;5;10;270306;178886;2737;395;3880
FR;5;2022-06-18;146;95;10;2;26;270452;178981;2747;397;3906
FR;5;2022-06-19;26;15;0;1;4;270478;178996;2747;398;3910
FR;5;2022-06-20;56;49;8;0;11;270534;179045;2755;398;3921
FR;5;2022-06-21;52;73;5;3;7;270586;179118;2760;401;3928
FR;5;2022-06-22;224;247;7;9;33;270810;179365;2767;410;3961
FR;5;2022-06-23;50;38;2;5;6;270860;179403;2769;415;3967
FR;5;2022-06-24;91;69;12;5;16;270951;179472;2781;420;3983
FR;5;2022-06-25;154;124;3;7;14;271105;179596;2784;427;3997
FR;5;2022-06-26;26;19;2;0;5;271131;179615;2786;427;4002
FR;5;2022-06-27;57;60;5;7;11;271188;179675;2791;434;4013
FR;5;2022-06-28;70;49;8;2;14;271258;179724;2799;436;4027
FR;5;2022-06-29;297;268;9;21;34;271555;179992;2808;457;4061
FR;5;2022-06-30;88;57;10;12;17;271643;180049;2818;469;4078
FR;5;2022-07-01;124;65;7;11;12;271767;180114;2825;480;4090
FR;5;2022-07-02;191;132;4;0;22;271958;180246;2829;480;4112
FR;5;2022-07-03;30;25;1;0;4;271988;180271;2830;480;4116
FR;5;2022-07-04;103;64;2;5;6;272091;180335;2832;485;4122
FR;5;2022-07-05;104;72;3;8;13;272195;180407;2835;493;4135
FR;5;2022-07-06;277;168;9;36;27;272472;180575;2844;529;4162
FR;5;2022-07-07;87;68;6;9;13;272559;180643;2850;538;4175
FR;5;2022-07-08;152;120;7;14;25;272711;180763;2857;552;4200
FR;5;2022-07-09;116;68;1;8;10;272827;180831;2858;560;4210
FR;5;2022-07-10;15;6;0;0;1;272842;180837;2858;560;4211
FR;5;2022-07-11;92;72;10;2;19;272934;180909;2868;562;4230
FR;5;2022-07-12;67;63;5;10;7;273001;180972;2873;572;4237
FR;5;2022-07-13;167;117;10;19;16;273168;181089;2883;591;4253
FR;5;2022-07-14;8;4;0;0;0;273176;181093;2883;591;4253
FR;5;2022-07-15;74;66;5;14;15;273250;181159;2888;605;4268
FR;5;2022-07-16;54;44;3;0;3;273304;181203;2891;605;4271
FR;5;2022-07-17;10;7;3;0;2;273314;181210;2894;605;4273
FR;5;2022-07-18;60;46;0;5;3;273374;181256;2894;610;4276
FR;5;2022-07-19;63;42;5;3;7;273437;181298;2899;613;4283
FR;5;2022-07-20;119;106;4;11;14;273556;181404;2903;624;4297
FR;5;2022-07-21;38;43;2;10;5;273594;181447;2905;634;4302
FR;5;2022-07-22;45;69;11;14;23;273639;181516;2916;648;4325
FR;5;2022-07-23;59;78;2;1;11;273698;181594;2918;649;4336
FR;5;2022-07-24;11;9;3;1;3;273709;181603;2921;650;4339
FR;5;2022-07-25;53;48;2;7;8;273762;181651;2923;657;4347
FR;5;2022-07-26;57;53;5;41;6;273819;181704;2928;698;4353
FR;5;2022-07-27;106;118;4;4;13;273925;181822;2932;702;4366
FR;5;2022-07-28;39;35;2;2;6;273964;181857;2934;704;4372
FR;5;2022-07-29;56;72;3;13;8;274020;181929;2937;717;4380
FR;5;2022-07-30;53;53;5;1;7;274073;181982;2942;718;4387
FR;5;2022-07-31;7;11;1;0;1;274080;181993;2943;718;4388
FR;5;2022-08-01;38;52;1;2;6;274118;182045;2944;720;4394
FR;5;2022-08-02;31;43;8;7;8;274149;182088;2952;727;4402
FR;5;2022-08-03;54;51;4;10;9;274203;182139;2956;737;4411
FR;5;2022-08-04;20;18;1;6;1;274223;182157;2957;743;4412
FR;5;2022-08-05;34;24;3;3;3;274257;182181;2960;746;4415
FR;5;2022-08-06;23;26;1;0;1;274280;182207;2961;746;4416
FR;5;2022-08-07;2;2;1;0;1;274282;182209;2962;746;4417
FR;5;2022-08-08;25;19;1;2;2;274307;182228;2963;748;4419
FR;5;2022-08-09;26;28;3;3;3;274333;182256;2966;751;4422
FR;5;2022-08-10;47;47;2;0;5;274380;182303;2968;751;4427
FR;5;2022-08-11;19;34;2;2;5;274399;182337;2970;753;4432
FR;5;2022-08-12;27;28;2;0;2;274426;182365;2972;753;4434
FR;5;2022-08-13;15;18;0;0;0;274441;182383;2972;753;4434
FR;5;2022-08-14;2;3;0;0;0;274443;182386;2972;753;4434
FR;5;2022-08-15;2;4;0;0;0;274445;182390;2972;753;4434
FR;5;2022-08-16;33;26;2;0;5;274478;182416;2974;753;4439
FR;5;2022-08-17;49;55;2;1;1;274527;182471;2976;754;4440
FR;5;2022-08-18;26;18;4;17;6;274553;182489;2980;771;4446
FR;5;2022-08-19;25;32;1;2;2;274578;182521;2981;773;4448
FR;5;2022-08-20;25;27;2;1;4;274603;182548;2983;774;4452
FR;5;2022-08-21;7;4;1;0;1;274610;182552;2984;774;4453
FR;5;2022-08-22;38;24;1;6;2;274648;182576;2985;780;4455
FR;5;2022-08-23;26;25;1;1;2;274674;182601;2986;781;4457
FR;5;2022-08-24;47;43;0;0;0;274721;182644;2986;781;4457
FR;5;2022-08-25;27;26;3;1;2;274748;182670;2989;782;4459
FR;5;2022-08-26;48;38;7;2;5;274796;182708;2996;784;4464
FR;5;2022-08-27;46;28;1;0;3;274842;182736;2997;784;4467
FR;5;2022-08-28;5;6;0;0;0;274847;182742;2997;784;4467
FR;5;2022-08-29;58;44;0;1;3;274905;182786;2997;785;4470
FR;5;2022-08-30;42;23;12;29;10;274947;182809;3009;814;4480
FR;5;2022-08-31;51;47;6;1;11;274998;182856;3015;815;4491
FR;5;2022-09-01;14;6;1;3;1;275012;182862;3016;818;4492
FR;5;2022-09-02;40;19;8;2;8;275052;182881;3024;820;4500
FR;5;2022-09-03;66;36;1;0;1;275118;182917;3025;820;4501
FR;5;2022-09-04;12;7;1;0;3;275130;182924;3026;820;4504
FR;6;2020-12-27;0;0;0;0;0;0;0;0;0;0
FR;6;2020-12-28;0;0;0;0;0;0;0;0;0;0
FR;6;2020-12-29;0;0;0;0;0;0;0;0;0;0
FR;6;2020-12-30;0;0;0;0;0;0;0;0;0;0
FR;6;2020-12-31;0;0;0;0;0;0;0;0;0;0
FR;6;2021-01-01;0;0;0;0;0;0;0;0;0;0
FR;6;2021-01-02;0;0;0;0;0;0;0;0;0;0
FR;6;2021-01-03;0;0;0;0;0;0;0;0;0;0
FR;6;2021-01-04;0;0;0;0;0;0;0;0;0;0
FR;6;2021-01-05;0;0;0;0;0;0;0;0;0;0
FR;6;2021-01-06;0;0;0;0;0;0;0;0;0;0
FR;6;2021-01-07;0;0;0;0;0;0;0;0;0;0
FR;6;2021-01-08;0;0;0;0;0;0;0;0;0;0
FR;6;2021-01-09;0;0;0;0;0;0;0;0;0;0
FR;6;2021-01-10;0;0;0;0;0;0;0;0;0;0
FR;6;2021-01-11;0;0;0;0;0;0;0;0;0;0
FR;6;2021-01-12;0;0;0;0;0;0;0;0;0;0
FR;6;2021-01-13;0;0;0;0;0;0;0;0;0;0
FR;6;2021-01-14;0;0;0;0;0;0;0;0;0;0
FR;6;2021-01-15;0;0;0;0;0;0;0;0;0;0
FR;6;2021-01-16;0;0;0;0;0;0;0;0;0;0
FR;6;2021-01-17;0;0;0;0;0;0;0;0;0;0
FR;6;2021-01-18;0;0;0;0;0;0;0;0;0;0
FR;6;2021-01-19;0;0;0;0;0;0;0;0;0;0
FR;6;2021-01-20;0;0;0;0;0;0;0;0;0;0
FR;6;2021-01-21;0;0;0;0;0;0;0;0;0;0
FR;6;2021-01-22;0;0;0;0;0;0;0;0;0;0
FR;6;2021-01-23;0;0;0;0;0;0;0;0;0;0
FR;6;2021-01-24;0;0;0;0;0;0;0;0;0;0
FR;6;2021-01-25;0;0;0;0;0;0;0;0;0;0
FR;6;2021-01-26;0;0;0;0;0;0;0;0;0;0
FR;6;2021-01-27;0;0;0;0;0;0;0;0;0;0
FR;6;2021-01-28;0;0;0;0;0;0;0;0;0;0
FR;6;2021-01-29;0;0;0;0;0;0;0;0;0;0
FR;6;2021-01-30;0;0;0;0;0;0;0;0;0;0
FR;6;2021-01-31;0;0;0;0;0;0;0;0;0;0
FR;6;2021-02-01;0;0;0;0;0;0;0;0;0;0
FR;6;2021-02-02;0;0;0;0;0;0;0;0;0;0
FR;6;2021-02-03;0;0;0;0;0;0;0;0;0;0
FR;6;2021-02-04;0;0;0;0;0;0;0;0;0;0
FR;6;2021-02-05;0;0;0;0;0;0;0;0;0;0
FR;6;2021-02-06;0;0;0;0;0;0;0;0;0;0
FR;6;2021-02-07;0;0;0;0;0;0;0;0;0;0
FR;6;2021-02-08;0;0;0;0;0;0;0;0;0;0
FR;6;2021-02-09;0;0;0;0;0;0;0;0;0;0
FR;6;2021-02-10;0;0;0;0;0;0;0;0;0;0
FR;6;2021-02-11;0;0;0;0;0;0;0;0;0;0
FR;6;2021-02-12;0;0;0;0;0;0;0;0;0;0
FR;6;2021-02-13;0;0;0;0;0;0;0;0;0;0
FR;6;2021-02-14;0;0;0;0;0;0;0;0;0;0
FR;6;2021-02-15;0;0;0;0;0;0;0;0;0;0
FR;6;2021-02-16;0;0;0;0;0;0;0;0;0;0
FR;6;2021-02-17;0;0;0;0;0;0;0;0;0;0
FR;6;2021-02-18;0;0;0;0;0;0;0;0;0;0
FR;6;2021-02-19;0;0;0;0;0;0;0;0;0;0
FR;6;2021-02-20;0;0;0;0;0;0;0;0;0;0
FR;6;2021-02-21;0;0;0;0;0;0;0;0;0;0
FR;6;2021-02-22;0;0;0;0;0;0;0;0;0;0
FR;6;2021-02-23;0;0;0;0;0;0;0;0;0;0
FR;6;2021-02-24;0;0;0;0;0;0;0;0;0;0
FR;6;2021-02-25;0;0;0;0;0;0;0;0;0;0
FR;6;2021-02-26;0;0;0;0;0;0;0;0;0;0
FR;6;2021-02-27;0;0;0;0;0;0;0;0;0;0
FR;6;2021-02-28;0;0;0;0;0;0;0;0;0;0
FR;6;2021-03-01;0;0;0;0;0;0;0;0;0;0
FR;6;2021-03-02;0;0;0;0;0;0;0;0;0;0
FR;6;2021-03-03;0;0;0;0;0;0;0;0;0;0
FR;6;2021-03-04;0;0;0;0;0;0;0;0;0;0
FR;6;2021-03-05;0;0;0;0;0;0;0;0;0;0
FR;6;2021-03-06;0;0;0;0;0;0;0;0;0;0
FR;6;2021-03-07;0;0;0;0;0;0;0;0;0;0
FR;6;2021-03-08;0;0;0;0;0;0;0;0;0;0
FR;6;2021-03-09;0;0;0;0;0;0;0;0;0;0
FR;6;2021-03-10;0;0;0;0;0;0;0;0;0;0
FR;6;2021-03-11;0;0;0;0;0;0;0;0;0;0
FR;6;2021-03-12;0;0;0;0;0;0;0;0;0;0
FR;6;2021-03-13;0;0;0;0;0;0;0;0;0;0
FR;6;2021-03-14;0;0;0;0;0;0;0;0;0;0
FR;6;2021-03-15;0;0;0;0;0;0;0;0;0;0
FR;6;2021-03-16;0;0;0;0;0;0;0;0;0;0
FR;6;2021-03-17;0;0;0;0;0;0;0;0;0;0
FR;6;2021-03-18;0;0;0;0;0;0;0;0;0;0
FR;6;2021-03-19;0;0;0;0;0;0;0;0;0;0
FR;6;2021-03-20;0;0;0;0;0;0;0;0;0;0
FR;6;2021-03-21;0;0;0;0;0;0;0;0;0;0
FR;6;2021-03-22;0;0;0;0;0;0;0;0;0;0
FR;6;2021-03-23;0;0;0;0;0;0;0;0;0;0
FR;6;2021-03-24;0;0;0;0;0;0;0;0;0;0
FR;6;2021-03-25;0;0;0;0;0;0;0;0;0;0
FR;6;2021-03-26;0;0;0;0;0;0;0;0;0;0
FR;6;2021-03-27;0;0;0;0;0;0;0;0;0;0
FR;6;2021-03-28;0;0;0;0;0;0;0;0;0;0
FR;6;2021-03-29;0;0;0;0;0;0;0;0;0;0
FR;6;2021-03-30;0;0;0;0;0;0;0;0;0;0
FR;6;2021-03-31;0;0;0;0;0;0;0;0;0;0
FR;6;2021-04-01;0;0;0;0;0;0;0;0;0;0
FR;6;2021-04-02;0;0;0;0;0;0;0;0;0;0
FR;6;2021-04-03;0;0;0;0;0;0;0;0;0;0
FR;6;2021-04-04;0;0;0;0;0;0;0;0;0;0
FR;6;2021-04-05;0;0;0;0;0;0;0;0;0;0
FR;6;2021-04-06;0;0;0;0;0;0;0;0;0;0
FR;6;2021-04-07;0;0;0;0;0;0;0;0;0;0
FR;6;2021-04-08;0;0;0;0;0;0;0;0;0;0
FR;6;2021-04-09;0;0;0;0;0;0;0;0;0;0
FR;6;2021-04-10;0;0;0;0;0;0;0;0;0;0
FR;6;2021-04-11;0;0;0;0;0;0;0;0;0;0
FR;6;2021-04-12;0;0;0;0;0;0;0;0;0;0
FR;6;2021-04-13;0;0;0;0;0;0;0;0;0;0
FR;6;2021-04-14;0;0;0;0;0;0;0;0;0;0
FR;6;2021-04-15;0;0;0;0;0;0;0;0;0;0
FR;6;2021-04-16;0;0;0;0;0;0;0;0;0;0
FR;6;2021-04-17;0;0;0;0;0;0;0;0;0;0
FR;6;2021-04-18;0;0;0;0;0;0;0;0;0;0
FR;6;2021-04-19;0;0;0;0;0;0;0;0;0;0
FR;6;2021-04-20;0;0;0;0;0;0;0;0;0;0
FR;6;2021-04-21;0;0;0;0;0;0;0;0;0;0
FR;6;2021-04-22;0;0;0;0;0;0;0;0;0;0
FR;6;2021-04-23;0;0;0;0;0;0;0;0;0;0
FR;6;2021-04-24;0;0;0;0;0;0;0;0;0;0
FR;6;2021-04-25;0;0;0;0;0;0;0;0;0;0
FR;6;2021-04-26;0;0;0;0;0;0;0;0;0;0
FR;6;2021-04-27;0;0;0;0;0;0;0;0;0;0
FR;6;2021-04-28;0;0;0;0;0;0;0;0;0;0
FR;6;2021-04-29;0;0;0;0;0;0;0;0;0;0
FR;6;2021-04-30;0;0;0;0;0;0;0;0;0;0
FR;6;2021-05-01;0;0;0;0;0;0;0;0;0;0
FR;6;2021-05-02;0;0;0;0;0;0;0;0;0;0
FR;6;2021-05-03;0;0;0;0;0;0;0;0;0;0
FR;6;2021-05-04;0;0;0;0;0;0;0;0;0;0
FR;6;2021-05-05;0;0;0;0;0;0;0;0;0;0
FR;6;2021-05-06;0;0;0;0;0;0;0;0;0;0
FR;6;2021-05-07;0;0;0;0;0;0;0;0;0;0
FR;6;2021-05-08;0;0;0;0;0;0;0;0;0;0
FR;6;2021-05-09;0;0;0;0;0;0;0;0;0;0
FR;6;2021-05-10;0;0;0;0;0;0;0;0;0;0
FR;6;2021-05-11;0;0;0;0;0;0;0;0;0;0
FR;6;2021-05-12;0;0;0;0;0;0;0;0;0;0
FR;6;2021-05-13;0;0;0;0;0;0;0;0;0;0
FR;6;2021-05-14;0;0;0;0;0;0;0;0;0;0
FR;6;2021-05-15;0;0;0;0;0;0;0;0;0;0
FR;6;2021-05-16;0;0;0;0;0;0;0;0;0;0
FR;6;2021-05-17;0;0;0;0;0;0;0;0;0;0
FR;6;2021-05-18;0;0;0;0;0;0;0;0;0;0
FR;6;2021-05-19;0;0;0;0;0;0;0;0;0;0
FR;6;2021-05-20;0;0;0;0;0;0;0;0;0;0
FR;6;2021-05-21;0;0;0;0;0;0;0;0;0;0
FR;6;2021-05-22;0;0;0;0;0;0;0;0;0;0
FR;6;2021-05-23;0;0;0;0;0;0;0;0;0;0
FR;6;2021-05-24;0;0;0;0;0;0;0;0;0;0
FR;6;2021-05-25;0;0;0;0;0;0;0;0;0;0
FR;6;2021-05-26;0;0;0;0;0;0;0;0;0;0
FR;6;2021-05-27;0;0;0;0;0;0;0;0;0;0
FR;6;2021-05-28;0;0;0;0;0;0;0;0;0;0
FR;6;2021-05-29;0;0;0;0;0;0;0;0;0;0
FR;6;2021-05-30;0;0;0;0;0;0;0;0;0;0
FR;6;2021-05-31;0;0;0;0;0;0;0;0;0;0
FR;6;2021-06-01;0;0;0;0;0;0;0;0;0;0
FR;6;2021-06-02;0;0;0;0;0;0;0;0;0;0
FR;6;2021-06-03;0;0;0;0;0;0;0;0;0;0
FR;6;2021-06-04;0;0;0;0;0;0;0;0;0;0
FR;6;2021-06-05;0;0;0;0;0;0;0;0;0;0
FR;6;2021-06-06;0;0;0;0;0;0;0;0;0;0
FR;6;2021-06-07;0;0;0;0;0;0;0;0;0;0
FR;6;2021-06-08;0;0;0;0;0;0;0;0;0;0
FR;6;2021-06-09;0;0;0;0;0;0;0;0;0;0
FR;6;2021-06-10;0;0;0;0;0;0;0;0;0;0
FR;6;2021-06-11;0;0;0;0;0;0;0;0;0;0
FR;6;2021-06-12;0;0;0;0;0;0;0;0;0;0
FR;6;2021-06-13;0;0;0;0;0;0;0;0;0;0
FR;6;2021-06-14;0;0;0;0;0;0;0;0;0;0
FR;6;2021-06-15;0;0;0;0;0;0;0;0;0;0
FR;6;2021-06-16;0;0;0;0;0;0;0;0;0;0
FR;6;2021-06-17;0;0;0;0;0;0;0;0;0;0
FR;6;2021-06-18;0;0;0;0;0;0;0;0;0;0
FR;6;2021-06-19;0;0;0;0;0;0;0;0;0;0
FR;6;2021-06-20;0;0;0;0;0;0;0;0;0;0
FR;6;2021-06-21;0;0;0;0;0;0;0;0;0;0
FR;6;2021-06-22;0;0;0;0;0;0;0;0;0;0
FR;6;2021-06-23;0;0;0;0;0;0;0;0;0;0
FR;6;2021-06-24;0;0;0;0;0;0;0;0;0;0
FR;6;2021-06-25;0;0;0;0;0;0;0;0;0;0
FR;6;2021-06-26;0;0;0;0;0;0;0;0;0;0
FR;6;2021-06-27;0;0;0;0;0;0;0;0;0;0
FR;6;2021-06-28;0;0;0;0;0;0;0;0;0;0
FR;6;2021-06-29;0;0;0;0;0;0;0;0;0;0
FR;6;2021-06-30;0;0;0;0;0;0;0;0;0;0
FR;6;2021-07-01;0;0;0;0;0;0;0;0;0;0
FR;6;2021-07-02;0;0;0;0;0;0;0;0;0;0
FR;6;2021-07-03;0;0;0;0;0;0;0;0;0;0
FR;6;2021-07-04;0;0;0;0;0;0;0;0;0;0
FR;6;2021-07-05;0;0;0;0;0;0;0;0;0;0
FR;6;2021-07-06;0;0;0;0;0;0;0;0;0;0
FR;6;2021-07-07;0;0;0;0;0;0;0;0;0;0
FR;6;2021-07-08;0;0;0;0;0;0;0;0;0;0
FR;6;2021-07-09;0;0;0;0;0;0;0;0;0;0
FR;6;2021-07-10;0;0;0;0;0;0;0;0;0;0
FR;6;2021-07-11;0;0;0;0;0;0;0;0;0;0
FR;6;2021-07-12;0;0;0;0;0;0;0;0;0;0
FR;6;2021-07-13;0;0;0;0;0;0;0;0;0;0
FR;6;2021-07-14;0;0;0;0;0;0;0;0;0;0
FR;6;2021-07-15;0;0;0;0;0;0;0;0;0;0
FR;6;2021-07-16;0;0;0;0;0;0;0;0;0;0
FR;6;2021-07-17;0;0;0;0;0;0;0;0;0;0
FR;6;2021-07-18;0;0;0;0;0;0;0;0;0;0
FR;6;2021-07-19;0;0;0;0;0;0;0;0;0;0
FR;6;2021-07-20;0;0;0;0;0;0;0;0;0;0
FR;6;2021-07-21;0;0;0;0;0;0;0;0;0;0
FR;6;2021-07-22;0;0;0;0;0;0;0;0;0;0
FR;6;2021-07-23;0;0;0;0;0;0;0;0;0;0
FR;6;2021-07-24;0;0;0;0;0;0;0;0;0;0
FR;6;2021-07-25;0;0;0;0;0;0;0;0;0;0
FR;6;2021-07-26;0;0;0;0;0;0;0;0;0;0
FR;6;2021-07-27;0;0;0;0;0;0;0;0;0;0
FR;6;2021-07-28;0;0;0;0;0;0;0;0;0;0
FR;6;2021-07-29;0;0;0;0;0;0;0;0;0;0
FR;6;2021-07-30;0;0;0;0;0;0;0;0;0;0
FR;6;2021-07-31;0;0;0;0;0;0;0;0;0;0
FR;6;2021-08-01;0;0;0;0;0;0;0;0;0;0
FR;6;2021-08-02;0;0;0;0;0;0;0;0;0;0
FR;6;2021-08-03;0;0;0;0;0;0;0;0;0;0
FR;6;2021-08-04;0;0;0;0;0;0;0;0;0;0
FR;6;2021-08-05;0;0;0;0;0;0;0;0;0;0
FR;6;2021-08-06;0;0;0;0;0;0;0;0;0;0
FR;6;2021-08-07;0;0;0;0;0;0;0;0;0;0
FR;6;2021-08-08;0;0;0;0;0;0;0;0;0;0
FR;6;2021-08-09;0;0;0;0;0;0;0;0;0;0
FR;6;2021-08-10;0;0;0;0;0;0;0;0;0;0
FR;6;2021-08-11;0;0;0;0;0;0;0;0;0;0
FR;6;2021-08-12;0;0;0;0;0;0;0;0;0;0
FR;6;2021-08-13;0;0;0;0;0;0;0;0;0;0
FR;6;2021-08-14;0;0;0;0;0;0;0;0;0;0
FR;6;2021-08-15;0;0;0;0;0;0;0;0;0;0
FR;6;2021-08-16;0;0;0;0;0;0;0;0;0;0
FR;6;2021-08-17;0;0;0;0;0;0;0;0;0;0
FR;6;2021-08-18;0;0;0;0;0;0;0;0;0;0
FR;6;2021-08-19;0;0;0;0;0;0;0;0;0;0
FR;6;2021-08-20;0;0;0;0;0;0;0;0;0;0
FR;6;2021-08-21;0;0;0;0;0;0;0;0;0;0
FR;6;2021-08-22;0;0;0;0;0;0;0;0;0;0
FR;6;2021-08-23;0;0;0;0;0;0;0;0;0;0
FR;6;2021-08-24;0;0;0;0;0;0;0;0;0;0
FR;6;2021-08-25;0;0;0;0;0;0;0;0;0;0
FR;6;2021-08-26;0;0;0;0;0;0;0;0;0;0
FR;6;2021-08-27;0;0;0;0;0;0;0;0;0;0
FR;6;2021-08-28;0;0;0;0;0;0;0;0;0;0
FR;6;2021-08-29;0;0;0;0;0;0;0;0;0;0
FR;6;2021-08-30;0;0;0;0;0;0;0;0;0;0
FR;6;2021-08-31;0;0;0;0;0;0;0;0;0;0
FR;6;2021-09-01;0;0;0;0;0;0;0;0;0;0
FR;6;2021-09-02;0;0;0;0;0;0;0;0;0;0
FR;6;2021-09-03;0;0;0;0;0;0;0;0;0;0
FR;6;2021-09-04;0;0;0;0;0;0;0;0;0;0
FR;6;2021-09-05;0;0;0;0;0;0;0;0;0;0
FR;6;2021-09-06;0;0;0;0;0;0;0;0;0;0
FR;6;2021-09-07;0;0;0;0;0;0;0;0;0;0
FR;6;2021-09-08;0;0;0;0;0;0;0;0;0;0
FR;6;2021-09-09;0;0;0;0;0;0;0;0;0;0
FR;6;2021-09-10;0;0;0;0;0;0;0;0;0;0
FR;6;2021-09-11;0;0;0;0;0;0;0;0;0;0
FR;6;2021-09-12;0;0;0;0;0;0;0;0;0;0
FR;6;2021-09-13;0;0;0;0;0;0;0;0;0;0
FR;6;2021-09-14;0;0;0;0;0;0;0;0;0;0
FR;6;2021-09-15;0;0;0;0;0;0;0;0;0;0
FR;6;2021-09-16;0;0;0;0;0;0;0;0;0;0
FR;6;2021-09-17;0;0;0;0;0;0;0;0;0;0
FR;6;2021-09-18;0;0;0;0;0;0;0;0;0;0
FR;6;2021-09-19;0;0;0;0;0;0;0;0;0;0
FR;6;2021-09-20;0;0;0;0;0;0;0;0;0;0
FR;6;2021-09-21;0;0;0;0;0;0;0;0;0;0
FR;6;2021-09-22;0;0;0;0;0;0;0;0;0;0
FR;6;2021-09-23;0;0;0;0;0;0;0;0;0;0
FR;6;2021-09-24;0;0;0;0;0;0;0;0;0;0
FR;6;2021-09-25;0;0;0;0;0;0;0;0;0;0
FR;6;2021-09-26;0;0;0;0;0;0;0;0;0;0
FR;6;2021-09-27;0;0;0;0;0;0;0;0;0;0
FR;6;2021-09-28;0;0;0;0;0;0;0;0;0;0
FR;6;2021-09-29;0;0;0;0;0;0;0;0;0;0
FR;6;2021-09-30;0;0;0;0;0;0;0;0;0;0
FR;6;2021-10-01;0;0;0;0;0;0;0;0;0;0
FR;6;2021-10-02;0;0;0;0;0;0;0;0;0;0
FR;6;2021-10-03;0;0;0;0;0;0;0;0;0;0
FR;6;2021-10-04;0;0;0;0;0;0;0;0;0;0
FR;6;2021-10-05;0;0;0;0;0;0;0;0;0;0
FR;6;2021-10-06;0;0;0;0;0;0;0;0;0;0
FR;6;2021-10-07;0;0;0;0;0;0;0;0;0;0
FR;6;2021-10-08;0;0;0;0;0;0;0;0;0;0
FR;6;2021-10-09;0;0;0;0;0;0;0;0;0;0
FR;6;2021-10-10;0;0;0;0;0;0;0;0;0;0
FR;6;2021-10-11;0;0;0;0;0;0;0;0;0;0
FR;6;2021-10-12;0;0;0;0;0;0;0;0;0;0
FR;6;2021-10-13;0;0;0;0;0;0;0;0;0;0
FR;6;2021-10-14;0;0;0;0;0;0;0;0;0;0
FR;6;2021-10-15;0;0;0;0;0;0;0;0;0;0
FR;6;2021-10-16;0;0;0;0;0;0;0;0;0;0
FR;6;2021-10-17;0;0;0;0;0;0;0;0;0;0
FR;6;2021-10-18;0;0;0;0;0;0;0;0;0;0
FR;6;2021-10-19;0;0;0;0;0;0;0;0;0;0
FR;6;2021-10-20;0;0;0;0;0;0;0;0;0;0
FR;6;2021-10-21;0;0;0;0;0;0;0;0;0;0
FR;6;2021-10-22;0;0;0;0;0;0;0;0;0;0
FR;6;2021-10-23;0;0;0;0;0;0;0;0;0;0
FR;6;2021-10-24;0;0;0;0;0;0;0;0;0;0
FR;6;2021-10-25;0;0;0;0;0;0;0;0;0;0
FR;6;2021-10-26;0;0;0;0;0;0;0;0;0;0
FR;6;2021-10-27;0;0;0;0;0;0;0;0;0;0
FR;6;2021-10-28;0;0;0;0;0;0;0;0;0;0
FR;6;2021-10-29;0;0;0;0;0;0;0;0;0;0
FR;6;2021-10-30;0;0;0;0;0;0;0;0;0;0
FR;6;2021-10-31;0;0;0;0;0;0;0;0;0;0
FR;6;2021-11-01;0;0;0;0;0;0;0;0;0;0
FR;6;2021-11-02;0;0;0;0;0;0;0;0;0;0
FR;6;2021-11-03;0;0;0;0;0;0;0;0;0;0
FR;6;2021-11-04;0;0;0;0;0;0;0;0;0;0
FR;6;2021-11-05;0;0;0;0;0;0;0;0;0;0
FR;6;2021-11-06;0;0;0;0;0;0;0;0;0;0
FR;6;2021-11-07;0;0;0;0;0;0;0;0;0;0
FR;6;2021-11-08;0;0;0;0;0;0;0;0;0;0
FR;6;2021-11-09;0;0;0;0;0;0;0;0;0;0
FR;6;2021-11-10;0;0;0;0;0;0;0;0;0;0
FR;6;2021-11-11;0;0;0;0;0;0;0;0;0;0
FR;6;2021-11-12;0;0;0;0;0;0;0;0;0;0
FR;6;2021-11-13;0;0;0;0;0;0;0;0;0;0
FR;6;2021-11-14;0;0;0;0;0;0;0;0;0;0
FR;6;2021-11-15;0;0;0;0;0;0;0;0;0;0
FR;6;2021-11-16;0;0;0;0;0;0;0;0;0;0
FR;6;2021-11-17;0;0;0;0;0;0;0;0;0;0
FR;6;2021-11-18;0;0;0;0;0;0;0;0;0;0
FR;6;2021-11-19;0;0;0;0;0;0;0;0;0;0
FR;6;2021-11-20;0;0;0;0;0;0;0;0;0;0
FR;6;2021-11-21;0;0;0;0;0;0;0;0;0;0
FR;6;2021-11-22;0;0;0;0;0;0;0;0;0;0
FR;6;2021-11-23;0;0;0;0;0;0;0;0;0;0
FR;6;2021-11-24;0;0;0;0;0;0;0;0;0;0
FR;6;2021-11-25;0;0;0;0;0;0;0;0;0;0
FR;6;2021-11-26;0;0;0;0;0;0;0;0;0;0
FR;6;2021-11-27;0;0;0;0;0;0;0;0;0;0
FR;6;2021-11-28;0;0;0;0;0;0;0;0;0;0
FR;6;2021-11-29;0;0;0;0;0;0;0;0;0;0
FR;6;2021-11-30;0;0;0;0;0;0;0;0;0;0
FR;6;2021-12-01;0;0;0;0;0;0;0;0;0;0
FR;6;2021-12-02;0;0;0;0;0;0;0;0;0;0
FR;6;2021-12-03;0;0;0;0;0;0;0;0;0;0
FR;6;2021-12-04;0;0;0;0;0;0;0;0;0;0
FR;6;2021-12-05;0;0;0;0;0;0;0;0;0;0
FR;6;2021-12-06;0;0;0;0;0;0;0;0;0;0
FR;6;2021-12-07;0;0;0;0;0;0;0;0;0;0
FR;6;2021-12-08;0;0;0;0;0;0;0;0;0;0
FR;6;2021-12-09;0;0;0;0;0;0;0;0;0;0
FR;6;2021-12-10;0;0;0;0;0;0;0;0;0;0
FR;6;2021-12-11;0;0;0;0;0;0;0;0;0;0
FR;6;2021-12-12;0;0;0;0;0;0;0;0;0;0
FR;6;2021-12-13;0;0;0;0;0;0;0;0;0;0
FR;6;2021-12-14;0;0;0;0;0;0;0;0;0;0
FR;6;2021-12-15;0;0;0;0;0;0;0;0;0;0
FR;6;2021-12-16;0;0;0;0;0;0;0;0;0;0
FR;6;2021-12-17;0;0;0;0;0;0;0;0;0;0
FR;6;2021-12-18;0;0;0;0;0;0;0;0;0;0
FR;6;2021-12-19;0;0;0;0;0;0;0;0;0;0
FR;6;2021-12-20;0;0;0;0;0;0;0;0;0;0
FR;6;2021-12-21;0;0;0;0;0;0;0;0;0;0
FR;6;2021-12-22;0;0;0;0;0;0;0;0;0;0
FR;6;2021-12-23;0;0;0;0;0;0;0;0;0;0
FR;6;2021-12-24;0;0;0;0;0;0;0;0;0;0
FR;6;2021-12-25;0;0;0;0;0;0;0;0;0;0
FR;6;2021-12-26;0;0;0;0;0;0;0;0;0;0
FR;6;2021-12-27;0;0;0;0;0;0;0;0;0;0
FR;6;2021-12-28;0;0;0;0;0;0;0;0;0;0
FR;6;2021-12-29;0;0;0;0;0;0;0;0;0;0
FR;6;2021-12-30;0;0;0;0;0;0;0;0;0;0
FR;6;2021-12-31;0;0;0;0;0;0;0;0;0;0
FR;6;2022-01-01;0;0;0;0;0;0;0;0;0;0
FR;6;2022-01-02;0;0;0;0;0;0;0;0;0;0
FR;6;2022-01-03;0;0;0;0;0;0;0;0;0;0
FR;6;2022-01-04;0;0;0;0;0;0;0;0;0;0
FR;6;2022-01-05;0;0;0;0;0;0;0;0;0;0
FR;6;2022-01-06;0;0;0;0;0;0;0;0;0;0
FR;6;2022-01-07;0;0;0;0;0;0;0;0;0;0
FR;6;2022-01-08;0;0;0;0;0;0;0;0;0;0
FR;6;2022-01-09;0;0;0;0;0;0;0;0;0;0
FR;6;2022-01-10;0;0;0;0;0;0;0;0;0;0
FR;6;2022-01-11;0;0;0;0;0;0;0;0;0;0
FR;6;2022-01-12;0;0;0;0;0;0;0;0;0;0
FR;6;2022-01-13;0;0;0;0;0;0;0;0;0;0
FR;6;2022-01-14;0;0;0;0;0;0;0;0;0;0
FR;6;2022-01-15;0;0;0;0;0;0;0;0;0;0
FR;6;2022-01-16;0;0;0;0;0;0;0;0;0;0
FR;6;2022-01-17;0;0;0;0;0;0;0;0;0;0
FR;6;2022-01-18;0;0;0;0;0;0;0;0;0;0
FR;6;2022-01-19;0;0;0;0;0;0;0;0;0;0
FR;6;2022-01-20;0;0;0;0;0;0;0;0;0;0
FR;6;2022-01-21;0;0;0;0;0;0;0;0;0;0
FR;6;2022-01-22;0;0;0;0;0;0;0;0;0;0
FR;6;2022-01-23;0;0;0;0;0;0;0;0;0;0
FR;6;2022-01-24;0;0;0;0;0;0;0;0;0;0
FR;6;2022-01-25;0;0;0;0;0;0;0;0;0;0
FR;6;2022-01-26;0;0;0;0;0;0;0;0;0;0
FR;6;2022-01-27;0;0;0;0;0;0;0;0;0;0
FR;6;2022-01-28;0;0;0;0;0;0;0;0;0;0
FR;6;2022-01-29;0;0;0;0;0;0;0;0;0;0
FR;6;2022-01-30;0;0;0;0;0;0;0;0;0;0
FR;6;2022-01-31;0;0;0;0;0;0;0;0;0;0
FR;6;2022-02-01;0;0;0;0;0;0;0;0;0;0
FR;6;2022-02-02;0;0;0;0;0;0;0;0;0;0
FR;6;2022-02-03;0;0;0;0;0;0;0;0;0;0
FR;6;2022-02-04;0;0;0;0;0;0;0;0;0;0
FR;6;2022-02-05;0;0;0;0;0;0;0;0;0;0
FR;6;2022-02-06;0;0;0;0;0;0;0;0;0;0
FR;6;2022-02-07;0;0;0;0;0;0;0;0;0;0
FR;6;2022-02-08;0;0;0;0;0;0;0;0;0;0
FR;6;2022-02-09;0;0;0;0;0;0;0;0;0;0
FR;6;2022-02-10;0;0;0;0;0;0;0;0;0;0
FR;6;2022-02-11;0;0;0;0;0;0;0;0;0;0
FR;6;2022-02-12;0;0;0;0;0;0;0;0;0;0
FR;6;2022-02-13;0;0;0;0;0;0;0;0;0;0
FR;6;2022-02-14;0;0;0;0;0;0;0;0;0;0
FR;6;2022-02-15;0;0;0;0;0;0;0;0;0;0
FR;6;2022-02-16;0;0;0;0;0;0;0;0;0;0
FR;6;2022-02-17;0;0;0;0;0;0;0;0;0;0
FR;6;2022-02-18;0;0;0;0;0;0;0;0;0;0
FR;6;2022-02-19;0;0;0;0;0;0;0;0;0;0
FR;6;2022-02-20;0;0;0;0;0;0;0;0;0;0
FR;6;2022-02-21;0;0;0;0;0;0;0;0;0;0
FR;6;2022-02-22;0;0;0;0;0;0;0;0;0;0
FR;6;2022-02-23;0;0;0;0;0;0;0;0;0;0
FR;6;2022-02-24;0;0;0;0;0;0;0;0;0;0
FR;6;2022-02-25;0;0;0;0;0;0;0;0;0;0
FR;6;2022-02-26;1;0;0;0;0;1;0;0;0;0
FR;6;2022-02-27;0;0;0;0;0;1;0;0;0;0
FR;6;2022-02-28;0;0;0;0;0;1;0;0;0;0
FR;6;2022-03-01;3;0;0;0;0;4;0;0;0;0
FR;6;2022-03-02;97;9;2;0;7;101;9;2;0;7
FR;6;2022-03-03;0;0;0;0;0;101;9;2;0;7
FR;6;2022-03-04;91;4;0;0;4;192;13;2;0;11
FR;6;2022-03-05;391;23;2;0;14;583;36;4;0;25
FR;6;2022-03-06;7;1;0;0;0;590;37;4;0;25
FR;6;2022-03-07;337;19;0;0;13;927;56;4;0;38
FR;6;2022-03-08;230;14;0;0;5;1157;70;4;0;43
FR;6;2022-03-09;519;29;2;0;21;1676;99;6;0;64
FR;6;2022-03-10;206;19;0;1;12;1882;118;6;1;76
FR;6;2022-03-11;328;21;6;0;21;2210;139;12;1;97
FR;6;2022-03-12;518;25;1;0;20;2728;164;13;1;117
FR;6;2022-03-13;40;2;0;0;1;2768;166;13;1;118
FR;6;2022-03-14;201;4;2;0;3;2969;170;15;1;121
FR;6;2022-03-15;112;11;2;0;9;3081;181;17;1;130
FR;6;2022-03-16;310;17;1;1;14;3391;198;18;2;144
FR;6;2022-03-17;117;6;1;2;4;3508;204;19;4;148
FR;6;2022-03-18;215;10;0;0;6;3723;214;19;4;154
FR;6;2022-03-19;307;19;2;0;9;4030;233;21;4;163
FR;6;2022-03-20;15;5;0;0;1;4045;238;21;4;164
FR;6;2022-03-21;132;23;1;0;4;4177;261;22;4;168
FR;6;2022-03-22;97;15;0;0;4;4274;276;22;4;172
FR;6;2022-03-23;226;108;3;0;14;4500;384;25;4;186
FR;6;2022-03-24;100;15;1;3;4;4600;399;26;7;190
FR;6;2022-03-25;203;141;2;1;15;4803;540;28;8;205
FR;6;2022-03-26;331;295;7;1;19;5134;835;35;9;224
FR;6;2022-03-27;32;30;1;0;1;5166;865;36;9;225
FR;6;2022-03-28;200;208;8;1;17;5366;1073;44;10;242
FR;6;2022-03-29;124;189;12;2;12;5490;1262;56;12;254
FR;6;2022-03-30;305;476;10;2;22;5795;1738;66;14;276
FR;6;2022-03-31;123;140;10;0;14;5918;1878;76;14;290
FR;6;2022-04-01;195;150;11;2;23;6113;2028;87;16;313
FR;6;2022-04-02;206;241;9;1;13;6319;2269;96;17;326
FR;6;2022-04-03;17;21;0;0;1;6336;2290;96;17;327
FR;6;2022-04-04;137;114;6;1;9;6473;2404;102;18;336
FR;6;2022-04-05;146;88;15;1;11;6619;2492;117;19;347
FR;6;2022-04-06;204;245;22;26;27;6823;2737;139;45;374
FR;6;2022-04-07;127;96;15;9;17;6950;2833;154;54;391
FR;6;2022-04-08;199;170;16;3;17;7149;3003;170;57;408
FR;6;2022-04-09;145;139;6;12;13;7294;3142;176;69;421
FR;6;2022-04-10;10;20;3;0;1;7304;3162;179;69;422
FR;6;2022-04-11;101;106;4;0;5;7405;3268;183;69;427
FR;6;2022-04-12;136;75;5;8;10;7541;3343;188;77;437
FR;6;2022-04-13;162;175;7;5;13;7703;3518;195;82;450
FR;6;2022-04-14;100;103;5;10;8;7803;3621;200;92;458
FR;6;2022-04-15;158;148;11;7;19;7961;3769;211;99;477
FR;6;2022-04-16;127;132;5;0;14;8088;3901;216;99;491
FR;6;2022-04-17;8;9;4;0;4;8096;3910;220;99;495
FR;6;2022-04-18;8;15;3;0;4;8104;3925;223;99;499
FR;6;2022-04-19;97;112;4;3;3;8201;4037;227;102;502
FR;6;2022-04-20;178;227;8;7;15;8379;4264;235;109;517
FR;6;2022-04-21;111;93;8;4;11;8490;4357;243;113;528
FR;6;2022-04-22;138;160;13;12;13;8628;4517;256;125;541
FR;6;2022-04-23;106;129;1;1;7;8734;4646;257;126;548
FR;6;2022-04-24;5;21;1;0;0;8739;4667;258;126;548
FR;6;2022-04-25;91;128;3;8;11;8830;4795;261;134;559
FR;6;2022-04-26;101;128;18;2;16;8931;4923;279;136;575
FR;6;2022-04-27;197;159;21;1;27;9128;5082;300;137;602
FR;6;2022-04-28;109;87;7;1;8;9237;5169;307;138;610
FR;6;2022-04-29;191;169;16;2;20;9428;5338;323;140;630
FR;6;2022-04-30;133;125;7;1;24;9561;5463;330;141;654
FR;6;2022-05-01;7;6;0;0;0;9568;5469;330;141;654
FR;6;2022-05-02;94;66;3;4;3;9662;5535;333;145;657
FR;6;2022-05-03;136;93;11;2;7;9798;5628;344;147;664
FR;6;2022-05-04;167;118;25;12;29;9965;5746;369;159;693
FR;6;2022-05-05;101;70;8;3;12;10066;5816;377;162;705
FR;6;2022-05-06;152;110;10;9;16;10218;5926;387;171;721
FR;6;2022-05-07;139;93;13;3;23;10357;6019;400;174;744
FR;6;2022-05-08;20;8;6;5;7;10377;6027;406;179;751
FR;6;2022-05-09;86;78;9;7;13;10463;6105;415;186;764
FR;6;2022-05-10;111;80;15;7;12;10574;6185;430;193;776
FR;6;2022-05-11;130;124;11;14;20;10704;6309;441;207;796
FR;6;2022-05-12;105;76;7;5;15;10809;6385;448;212;811
FR;6;2022-05-13;154;97;17;21;22;10963;6482;465;233;833
FR;6;2022-05-14;81;60;6;7;15;11044;6542;471;240;848
FR;6;2022-05-15;12;7;0;0;0;11056;6549;471;240;848
FR;6;2022-05-16;64;54;6;2;12;11120;6603;477;242;860
FR;6;2022-05-17;123;77;5;7;11;11243;6680;482;249;871
FR;6;2022-05-18;131;116;5;1;13;11374;6796;487;250;884
FR;6;2022-05-19;124;57;6;8;9;11498;6853;493;258;893
FR;6;2022-05-20;125;115;13;3;18;11623;6968;506;261;911
FR;6;2022-05-21;92;69;14;3;12;11715;7037;520;264;923
FR;6;2022-05-22;19;12;5;0;4;11734;7049;525;264;927
FR;6;2022-05-23;77;72;4;2;7;11811;7121;529;266;934
FR;6;2022-05-24;116;98;8;2;16;11927;7219;537;268;950
FR;6;2022-05-25;139;129;6;3;11;12066;7348;543;271;961
FR;6;2022-05-26;7;9;3;0;9;12073;7357;546;271;970
FR;6;2022-05-27;127;105;15;11;18;12200;7462;561;282;988
FR;6;2022-05-28;53;75;1;5;8;12253;7537;562;287;996
FR;6;2022-05-29;8;10;0;0;1;12261;7547;562;287;997
FR;6;2022-05-30;70;70;7;4;4;12331;7617;569;291;1001
FR;6;2022-05-31;87;102;10;2;14;12418;7719;579;293;1015
FR;6;2022-06-01;97;89;10;1;11;12515;7808;589;294;1026
FR;6;2022-06-02;91;60;6;3;9;12606;7868;595;297;1035
FR;6;2022-06-03;126;102;13;7;21;12732;7970;608;304;1056
FR;6;2022-06-04;63;51;10;0;12;12795;8021;618;304;1068
FR;6;2022-06-05;16;15;2;1;4;12811;8036;620;305;1072
FR;6;2022-06-06;9;6;0;0;0;12820;8042;620;305;1072
FR;6;2022-06-07;79;90;3;4;8;12899;8132;623;309;1080
FR;6;2022-06-08;92;110;13;5;20;12991;8242;636;314;1100
FR;6;2022-06-09;75;81;15;3;15;13066;8323;651;317;1115
FR;6;2022-06-10;116;93;26;10;22;13182;8416;677;327;1137
FR;6;2022-06-11;83;62;6;10;12;13265;8478;683;337;1149
FR;6;2022-06-12;6;14;1;0;2;13271;8492;684;337;1151
FR;6;2022-06-13;74;59;18;1;7;13345;8551;702;338;1158
FR;6;2022-06-14;98;100;8;5;16;13443;8651;710;343;1174
FR;6;2022-06-15;80;85;7;8;15;13523;8736;717;351;1189
FR;6;2022-06-16;53;40;11;7;14;13576;8776;728;358;1203
FR;6;2022-06-17;85;85;3;13;11;13661;8861;731;371;1214
FR;6;2022-06-18;71;61;13;0;21;13732;8922;744;371;1235
FR;6;2022-06-19;6;6;3;0;4;13738;8928;747;371;1239
FR;6;2022-06-20;42;41;4;1;6;13780;8969;751;372;1245
FR;6;2022-06-21;59;73;10;7;17;13839;9042;761;379;1262
FR;6;2022-06-22;86;85;8;2;17;13925;9127;769;381;1279
FR;6;2022-06-23;64;39;13;7;15;13989;9166;782;388;1294
FR;6;2022-06-24;77;85;7;14;20;14066;9251;789;402;1314
FR;6;2022-06-25;67;61;4;3;8;14133;9312;793;405;1322
FR;6;2022-06-26;6;7;1;0;1;14139;9319;794;405;1323
FR;6;2022-06-27;53;50;4;9;12;14192;9369;798;414;1335
FR;6;2022-06-28;68;47;6;3;15;14260;9416;804;417;1350
FR;6;2022-06-29;98;117;26;37;19;14358;9533;830;454;1369
FR;6;2022-06-30;84;59;33;10;12;14442;9592;863;464;1381
FR;6;2022-07-01;115;94;25;33;18;14557;9686;888;497;1399
FR;6;2022-07-02;58;67;26;2;37;14615;9753;914;499;1436
FR;6;2022-07-03;11;4;4;3;4;14626;9757;918;502;1440
FR;6;2022-07-04;61;43;3;23;13;14687;9800;921;525;1453
FR;6;2022-07-05;65;53;19;67;27;14752;9853;940;592;1480
FR;6;2022-07-06;94;64;7;11;12;14846;9917;947;603;1492
FR;6;2022-07-07;97;79;42;37;14;14943;9996;989;640;1506
FR;6;2022-07-08;139;87;42;27;10;15082;10083;1031;667;1516
FR;6;2022-07-09;53;50;16;29;26;15135;10133;1047;696;1542
FR;6;2022-07-10;3;7;8;0;9;15138;10140;1055;696;1551
FR;6;2022-07-11;54;44;5;4;12;15192;10184;1060;700;1563
FR;6;2022-07-12;70;72;12;22;12;15262;10256;1072;722;1575
FR;6;2022-07-13;84;65;14;21;25;15346;10321;1086;743;1600
FR;6;2022-07-14;4;3;1;0;1;15350;10324;1087;743;1601
FR;6;2022-07-15;74;59;9;57;16;15424;10383;1096;800;1617
FR;6;2022-07-16;27;31;17;0;17;15451;10414;1113;800;1634
FR;6;2022-07-17;3;7;0;0;0;15454;10421;1113;800;1634
FR;6;2022-07-18;37;62;11;14;15;15491;10483;1124;814;1649
FR;6;2022-07-19;54;48;4;19;6;15545;10531;1128;833;1655
FR;6;2022-07-20;53;70;7;22;11;15598;10601;1135;855;1666
FR;6;2022-07-21;50;60;4;7;11;15648;10661;1139;862;1677
FR;6;2022-07-22;55;73;7;26;8;15703;10734;1146;888;1685
FR;6;2022-07-23;38;40;6;10;6;15741;10774;1152;898;1691
FR;6;2022-07-24;11;14;1;3;3;15752;10788;1153;901;1694
FR;6;2022-07-25;60;44;8;12;9;15812;10832;1161;913;1703
FR;6;2022-07-26;47;64;14;6;10;15859;10896;1175;919;1713
FR;6;2022-07-27;54;78;15;11;17;15913;10974;1190;930;1730
FR;6;2022-07-28;30;48;4;6;8;15943;11022;1194;936;1738
FR;6;2022-07-29;43;71;10;38;24;15986;11093;1204;974;1762
FR;6;2022-07-30;26;48;4;15;7;16012;11141;1208;989;1769
FR;6;2022-07-31;0;1;1;0;0;16012;11142;1209;989;1769
FR;6;2022-08-01;39;36;14;8;10;16051;11178;1223;997;1779
FR;6;2022-08-02;37;46;10;14;6;16088;11224;1233;1011;1785
FR;6;2022-08-03;29;52;7;16;11;16117;11276;1240;1027;1796
FR;6;2022-08-04;25;21;4;9;6;16142;11297;1244;1036;1802
FR;6;2022-08-05;43;45;1;7;5;16185;11342;1245;1043;1807
FR;6;2022-08-06;17;27;1;3;2;16202;11369;1246;1046;1809
FR;6;2022-08-07;1;2;0;0;0;16203;11371;1246;1046;1809
FR;6;2022-08-08;24;33;1;0;1;16227;11404;1247;1046;1810
FR;6;2022-08-09;22;30;6;3;3;16249;11434;1253;1049;1813
FR;6;2022-08-10;30;37;5;9;6;16279;11471;1258;1058;1819
FR;6;2022-08-11;33;33;1;1;1;16312;11504;1259;1059;1820
FR;6;2022-08-12;50;44;6;2;15;16362;11548;1265;1061;1835
FR;6;2022-08-13;9;20;0;0;1;16371;11568;1265;1061;1836
FR;6;2022-08-14;3;1;0;0;0;16374;11569;1265;1061;1836
FR;6;2022-08-15;2;3;1;0;0;16376;11572;1266;1061;1836
FR;6;2022-08-16;35;66;21;7;7;16411;11638;1287;1068;1843
FR;6;2022-08-17;32;44;10;9;10;16443;11682;1297;1077;1853
FR;6;2022-08-18;29;55;14;4;4;16472;11737;1311;1081;1857
FR;6;2022-08-19;30;44;5;4;3;16502;11781;1316;1085;1860
FR;6;2022-08-20;26;28;3;0;8;16528;11809;1319;1085;1868
FR;6;2022-08-21;1;5;2;0;0;16529;11814;1321;1085;1868
FR;6;2022-08-22;19;42;15;1;0;16548;11856;1336;1086;1868
FR;6;2022-08-23;34;45;6;7;6;16582;11901;1342;1093;1874
FR;6;2022-08-24;34;29;6;3;6;16616;11930;1348;1096;1880
FR;6;2022-08-25;25;27;1;1;5;16641;11957;1349;1097;1885
FR;6;2022-08-26;39;44;4;4;7;16680;12001;1353;1101;1892
FR;6;2022-08-27;19;20;7;3;8;16699;12021;1360;1104;1900
FR;6;2022-08-28;6;3;0;0;0;16705;12024;1360;1104;1900
FR;6;2022-08-29;25;22;2;6;3;16730;12046;1362;1110;1903
FR;6;2022-08-30;27;32;3;12;6;16757;12078;1365;1122;1909
FR;6;2022-08-31;34;38;2;11;3;16791;12116;1367;1133;1912
FR;6;2022-09-01;15;11;5;1;4;16806;12127;1372;1134;1916
FR;6;2022-09-02;19;13;1;1;2;16825;12140;1373;1135;1918
FR;6;2022-09-03;9;3;1;5;2;16834;12143;1374;1140;1920
FR;6;2022-09-04;2;1;0;0;0;16836;12144;1374;1140;1920
FR;0;2020-12-27;609;0;0;0;0;609;0;0;0;0
FR;0;2020-12-28;683;1;0;0;0;1292;1;0;0;0
FR;0;2020-12-29;384;0;0;0;0;1676;1;0;0;0
FR;0;2020-12-30;443;0;0;0;0;2119;1;0;0;0
FR;0;2020-12-31;440;1;0;0;0;2559;2;0;0;0
FR;0;2021-01-01;1156;2;0;0;0;3715;4;0;0;0
FR;0;2021-01-02;362;3;0;0;0;4077;7;0;0;0
FR;0;2021-01-03;404;0;0;0;0;4481;7;0;0;0
FR;0;2021-01-04;2109;4;0;0;0;6590;11;0;0;0
FR;0;2021-01-05;7751;3;0;0;0;14341;14;0;0;0
FR;0;2021-01-06;12454;16;0;0;0;26795;30;0;0;0
FR;0;2021-01-07;29461;17;0;0;0;56256;47;0;0;0
FR;0;2021-01-08;37143;17;0;0;0;93399;64;0;0;0
FR;0;2021-01-09;11212;7;0;0;0;104611;71;0;0;0
FR;0;2021-01-10;6006;7;0;0;0;110617;78;0;0;0
FR;0;2021-01-11;39934;22;0;0;0;150551;100;0;0;0
FR;0;2021-01-12;62142;19;0;0;0;212693;119;0;0;0
FR;0;2021-01-13;65119;42;0;0;0;277812;161;0;0;0
FR;0;2021-01-14;83117;149;0;0;0;360929;310;0;0;0
FR;0;2021-01-15;69009;63;0;0;0;429938;373;0;0;0
FR;0;2021-01-16;20217;72;0;0;0;450155;445;0;0;0
FR;0;2021-01-17;10986;51;0;0;0;461141;496;0;0;0
FR;0;2021-01-18;85902;169;0;0;0;547043;665;0;0;0
FR;0;2021-01-19;130599;189;0;0;0;677642;854;0;0;0
FR;0;2021-01-20;137548;188;0;0;0;815190;1042;0;0;0
FR;0;2021-01-21;158402;183;0;0;0;973592;1225;0;0;0
FR;0;2021-01-22;121063;233;0;0;0;1094655;1458;0;0;0
FR;0;2021-01-23;38480;69;0;0;0;1133135;1527;0;0;0
FR;0;2021-01-24;9745;99;0;0;0;1142880;1626;0;0;0
FR;0;2021-01-25;78237;1340;0;0;0;1221117;2966;0;0;0
FR;0;2021-01-26;100377;3494;1;0;0;1321494;6460;1;0;0
FR;0;2021-01-27;107246;6120;0;0;0;1428740;12580;1;0;0
FR;0;2021-01-28;124355;15585;0;0;0;1553095;28165;1;0;0
FR;0;2021-01-29;92184;18178;0;0;0;1645279;46343;1;0;0
FR;0;2021-01-30;29122;4404;0;0;0;1674401;50747;1;0;0
FR;0;2021-01-31;5234;1815;0;0;0;1679635;52562;1;0;0
FR;0;2021-02-01;53129;22057;0;0;0;1732764;74619;1;0;0
FR;0;2021-02-02;72309;36825;0;0;0;1805073;111444;1;0;0
FR;0;2021-02-03;72305;38979;0;0;0;1877378;150423;1;0;0
FR;0;2021-02-04;82076;53190;0;0;0;1959454;203613;1;0;0
FR;0;2021-02-05;68232;46807;0;0;0;2027686;250420;1;0;0
FR;0;2021-02-06;23035;11083;0;0;0;2050721;261503;1;0;0
FR;0;2021-02-07;5189;5600;0;0;0;2055910;267103;1;0;0
FR;0;2021-02-08;46839;47721;0;0;0;2102749;314824;1;0;0
FR;0;2021-02-09;66006;76186;0;0;0;2168755;391010;1;0;0
FR;0;2021-02-10;71017;80929;0;0;0;2239772;471939;1;0;0
FR;0;2021-02-11;87280;103399;0;0;0;2327052;575338;1;0;0
FR;0;2021-02-12;79323;75413;0;0;0;2406375;650751;1;0;0
FR;0;2021-02-13;22380;19574;0;0;0;2428755;670325;1;0;0
FR;0;2021-02-14;5076;7356;0;0;0;2433831;677681;1;0;0
FR;0;2021-02-15;38096;76731;0;0;0;2471927;754412;1;0;0
FR;0;2021-02-16;50398;100547;0;0;0;2522325;854959;1;0;0
FR;0;2021-02-17;50534;105741;20;0;0;2572859;960700;21;0;0
FR;0;2021-02-18;69787;122035;0;0;0;2642646;1082735;21;0;0
FR;0;2021-02-19;65068;91661;1;0;0;2707714;1174396;22;0;0
FR;0;2021-02-20;18588;28685;0;0;0;2726302;1203081;22;0;0
FR;0;2021-02-21;3320;6194;0;0;0;2729622;1209275;22;0;0
FR;0;2021-02-22;37496;73354;2;0;0;2767118;1282629;24;0;0
FR;0;2021-02-23;53780;85061;1;0;0;2820898;1367690;25;0;0
FR;0;2021-02-24;60018;82390;1;0;0;2880916;1450080;26;0;0
FR;0;2021-02-25;100579;91449;1;0;0;2981495;1541529;27;0;0
FR;0;2021-02-26;113468;70774;1;0;0;3094963;1612303;28;0;0
FR;0;2021-02-27;52103;22313;1;0;0;3147066;1634616;29;0;0
FR;0;2021-02-28;6199;4197;2;0;0;3153265;1638813;31;0;0
FR;0;2021-03-01;65893;53774;1;0;0;3219158;1692587;32;0;0
FR;0;2021-03-02;101378;66999;3;0;0;3320536;1759586;35;0;0
FR;0;2021-03-03;116524;65441;0;0;0;3437060;1825027;35;0;0
FR;0;2021-03-04;163628;71526;3;0;0;3600688;1896553;38;0;0
FR;0;2021-03-05;200930;62928;3;0;0;3801618;1959481;41;0;0
FR;0;2021-03-06;207958;17622;3;0;0;4009576;1977103;44;0;0
FR;0;2021-03-07;121276;4546;1;0;0;4130852;1981649;45;0;0
FR;0;2021-03-08;107148;49961;2;0;0;4238000;2031610;47;0;0
FR;0;2021-03-09;172455;56312;2;0;0;4410455;2087922;49;0;0
FR;0;2021-03-10;178996;57201;5;0;0;4589451;2145123;54;0;0
FR;0;2021-03-11;242898;63892;2;0;0;4832349;2209015;56;0;0
FR;0;2021-03-12;294820;53454;1;0;0;5127169;2262469;57;0;0
FR;0;2021-03-13;231409;15277;1;0;0;5358578;2277746;58;0;0
FR;0;2021-03-14;63352;3182;1;0;0;5421930;2280928;59;0;0
FR;0;2021-03-15;158661;31906;3;0;0;5580591;2312834;62;0;0
FR;0;2021-03-16;141567;39044;6;0;0;5722158;2351878;68;0;0
FR;0;2021-03-17;150488;37865;4;0;0;5872646;2389743;72;0;0
FR;0;2021-03-18;167838;44461;5;0;0;6040484;2434204;77;0;0
FR;0;2021-03-19;230009;36983;2;0;0;6270493;2471187;79;0;0
FR;0;2021-03-20;166685;11491;1;0;0;6437178;2482678;80;0;0
FR;0;2021-03-21;49942;2296;1;0;0;6487120;2484974;81;0;0
FR;0;2021-03-22;170049;33853;2;0;0;6657169;2518827;83;0;0
FR;0;2021-03-23;250386;42378;1;0;0;6907555;2561205;84;0;0
FR;0;2021-03-24;256905;43626;0;0;0;7164460;2604831;84;0;0
FR;0;2021-03-25;341809;45020;5;0;0;7506269;2649851;89;0;0
FR;0;2021-03-26;358804;41879;5;1;0;7865073;2691730;94;1;0
FR;0;2021-03-27;195259;16858;1;0;0;8060332;2708588;95;1;0
FR;0;2021-03-28;59341;4371;3;0;0;8119673;2712959;98;1;0
FR;0;2021-03-29;202977;53677;4;0;0;8322650;2766636;102;1;0
FR;0;2021-03-30;285476;69912;5;0;0;8608126;2836548;107;1;0
FR;0;2021-03-31;263037;73661;4;0;0;8871163;2910209;111;1;0
FR;0;2021-04-01;315489;91275;11;0;0;9186652;3001484;122;1;0
FR;0;2021-04-02;281340;93932;7;0;0;9467992;3095416;129;1;0
FR;0;2021-04-03;141076;62268;6;0;0;9609068;3157684;135;1;0
FR;0;2021-04-04;46529;18909;2;0;0;9655597;3176593;137;1;0
FR;0;2021-04-05;63340;10636;11;0;0;9718937;3187229;148;1;0
FR;0;2021-04-06;217219;111320;17;0;0;9936156;3298549;165;1;0
FR;0;2021-04-07;260253;115311;17;0;0;10196409;3413860;182;1;0
FR;0;2021-04-08;337835;122418;14;0;0;10534244;3536278;196;1;0
FR;0;2021-04-09;410155;116698;49;0;0;10944399;3652976;245;1;0
FR;0;2021-04-10;212620;82753;15;0;0;11157019;3735729;260;1;0
FR;0;2021-04-11;56143;34283;7;0;0;11213162;3770012;267;1;0
FR;0;2021-04-12;237069;115607;46;0;0;11450231;3885619;313;1;0
FR;0;2021-04-13;309486;144342;98;1;0;11759717;4029961;411;2;0
FR;0;2021-04-14;294523;139491;214;0;0;12054240;4169452;625;2;0
FR;0;2021-04-15;337105;149546;338;0;0;12391345;4318998;963;2;0
FR;0;2021-04-16;339284;146385;353;0;0;12730629;4465383;1316;2;0
FR;0;2021-04-17;188656;89986;109;0;0;12919285;4555369;1425;2;0
FR;0;2021-04-18;51619;35399;47;0;0;12970904;4590768;1472;2;0
FR;0;2021-04-19;205695;138183;456;0;0;13176599;4728951;1928;2;0
FR;0;2021-04-20;254419;171371;569;0;0;13431018;4900322;2497;2;0
FR;0;2021-04-21;253266;169489;835;0;0;13684284;5069811;3332;2;0
FR;0;2021-04-22;287563;189514;818;0;0;13971847;5259325;4150;2;0
FR;0;2021-04-23;297815;183909;747;0;0;14269662;5443234;4897;2;0
FR;0;2021-04-24;190447;111759;252;0;0;14460109;5554993;5149;2;0
FR;0;2021-04-25;69560;38796;51;0;0;14529669;5593789;5200;2;0
FR;0;2021-04-26;220956;157398;563;0;0;14750625;5751187;5763;2;0
FR;0;2021-04-27;284605;187629;940;0;0;15035230;5938816;6703;2;0
FR;0;2021-04-28;299504;183903;1426;1;1;15334734;6122719;8129;3;1
FR;0;2021-04-29;357127;197317;1277;0;0;15691861;6320036;9406;3;1
FR;0;2021-04-30;372213;185403;1121;1;0;16064074;6505439;10527;4;1
FR;0;2021-05-01;167641;52506;179;0;0;16231715;6557945;10706;4;1
FR;0;2021-05-02;91743;37791;83;0;0;16323458;6595736;10789;4;1
FR;0;2021-05-03;288915;167114;843;0;0;16612373;6762850;11632;4;1
FR;0;2021-05-04;315666;224963;1233;0;0;16928039;6987813;12865;4;1
FR;0;2021-05-05;327192;225636;1315;0;0;17255231;7213449;14180;4;1
FR;0;2021-05-06;379512;240255;1632;0;0;17634743;7453704;15812;4;1
FR;0;2021-05-07;372745;257949;1222;0;0;18007488;7711653;17034;4;1
FR;0;2021-05-08;222162;69554;299;0;0;18229650;7781207;17333;4;1
FR;0;2021-05-09;129701;45510;243;0;0;18359351;7826717;17576;4;1
FR;0;2021-05-10;313382;229176;1236;0;0;18672733;8055893;18812;4;1
FR;0;2021-05-11;403897;258010;1566;0;0;19076630;8313903;20378;4;1
FR;0;2021-05-12;434111;233438;1542;0;0;19510741;8547341;21920;4;1
FR;0;2021-05-13;338600;56677;432;0;0;19849341;8604018;22352;4;1
FR;0;2021-05-14;454127;167379;1126;0;0;20303468;8771397;23478;4;1
FR;0;2021-05-15;374972;94208;443;0;0;20678440;8865605;23921;4;1
FR;0;2021-05-16;202752;20705;168;0;0;20881192;8886310;24089;4;1
FR;0;2021-05-17;376113;148777;1553;0;0;21257305;9035087;25642;4;1
FR;0;2021-05-18;460136;153622;1989;0;0;21717441;9188709;27631;4;1
FR;0;2021-05-19;467396;143683;2462;0;0;22184837;9332392;30093;4;1
FR;0;2021-05-20;507523;160317;2338;0;0;22692360;9492709;32431;4;1
FR;0;2021-05-21;489665;174827;1996;0;0;23182025;9667536;34427;4;1
FR;0;2021-05-22;347189;80032;668;0;0;23529214;9747568;35095;4;1
FR;0;2021-05-23;161690;14272;246;0;0;23690904;9761840;35341;4;1
FR;0;2021-05-24;263191;33154;604;0;0;23954095;9794994;35945;4;1
FR;0;2021-05-25;400270;189934;2351;1;0;24354365;9984928;38296;5;1
FR;0;2021-05-26;413454;189757;2223;0;0;24767819;10174685;40519;5;1
FR;0;2021-05-27;449800;219374;2161;0;0;25217619;10394059;42680;5;1
FR;0;2021-05-28;429546;260265;1893;0;0;25647165;10654324;44573;5;1
FR;0;2021-05-29;298977;149929;585;0;0;25946142;10804253;45158;5;1
FR;0;2021-05-30;107142;32563;163;0;0;26053284;10836816;45321;5;1
FR;0;2021-05-31;358032;203337;1469;1;1;26411316;11040153;46790;6;2
FR;0;2021-06-01;431012;251355;1962;1;1;26842328;11291508;48752;7;3
FR;0;2021-06-02;420105;231616;1984;0;0;27262433;11523124;50736;7;3
FR;0;2021-06-03;465607;258071;1823;0;0;27728040;11781195;52559;7;3
FR;0;2021-06-04;456249;305298;1734;1;1;28184289;12086493;54293;8;4
FR;0;2021-06-05;304803;189237;652;0;0;28489092;12275730;54945;8;4
FR;0;2021-06-06;133304;49053;226;0;0;28622396;12324783;55171;8;4
FR;0;2021-06-07;339992;261704;1526;0;0;28962388;12586487;56697;8;4
FR;0;2021-06-08;393875;291068;1803;0;0;29356263;12877555;58500;8;4
FR;0;2021-06-09;384862;274703;1729;0;0;29741125;13152258;60229;8;4
FR;0;2021-06-10;404174;288203;1724;1;0;30145299;13440461;61953;9;4
FR;0;2021-06-11;386650;356802;1467;0;0;30531949;13797263;63420;9;4
FR;0;2021-06-12;283260;211091;494;0;0;30815209;14008354;63914;9;4
FR;0;2021-06-13;104884;73867;204;0;0;30920093;14082221;64118;9;4
FR;0;2021-06-14;240827;354705;1426;1;0;31160920;14436926;65544;10;4
FR;0;2021-06-15;308145;385037;1568;1;0;31469065;14821963;67112;11;4
FR;0;2021-06-16;313971;357512;1418;1;0;31783036;15179475;68530;12;4
FR;0;2021-06-17;317680;372786;1426;1;0;32100716;15552261;69956;13;4
FR;0;2021-06-18;321745;442573;1337;1;0;32422461;15994834;71293;14;4
FR;0;2021-06-19;224341;273872;449;0;0;32646802;16268706;71742;14;4
FR;0;2021-06-20;74427;102427;129;0;0;32721229;16371133;71871;14;4
FR;0;2021-06-21;195758;401723;1037;1;1;32916987;16772856;72908;15;5
FR;0;2021-06-22;223195;467457;1264;10;1;33140182;17240313;74172;25;6
FR;0;2021-06-23;234019;439998;1197;1;1;33374201;17680311;75369;26;7
FR;0;2021-06-24;241858;409575;1356;0;0;33616059;18089886;76725;26;7
FR;0;2021-06-25;227628;522689;1400;0;0;33843687;18612575;78125;26;7
FR;0;2021-06-26;153246;370818;587;1;0;33996933;18983393;78712;27;7
FR;0;2021-06-27;55898;156086;168;1;0;34052831;19139479;78880;28;7
FR;0;2021-06-28;154772;452730;1175;0;0;34207603;19592209;80055;28;7
FR;0;2021-06-29;182691;507268;2123;0;0;34390294;20099477;82178;28;7
FR;0;2021-06-30;204001;485099;2014;21;2;34594295;20584576;84192;49;9
FR;0;2021-07-01;231326;458158;2223;5;1;34825621;21042734;86415;54;10
FR;0;2021-07-02;228691;520150;2120;5;2;35054312;21562884;88535;59;12
FR;0;2021-07-03;142036;368735;908;3;1;35196348;21931619;89443;62;13
FR;0;2021-07-04;56743;141091;265;0;0;35253091;22072710;89708;62;13
FR;0;2021-07-05;168509;419003;1668;8;2;35421600;22491713;91376;70;15
FR;0;2021-07-06;196762;474649;1829;45;8;35618362;22966362;93205;115;23
FR;0;2021-07-07;213176;439158;1878;25;4;35831538;23405520;95083;140;27
FR;0;2021-07-08;231635;424192;2089;20;6;36063173;23829712;97172;160;33
FR;0;2021-07-09;228605;510996;2184;4;2;36291778;24340708;99356;164;35
FR;0;2021-07-10;148611;339911;983;1;1;36440389;24680619;100339;165;36
FR;0;2021-07-11;60194;110116;283;0;0;36500583;24790735;100622;165;36
FR;0;2021-07-12;169380;478021;1761;4;0;36669963;25268756;102383;169;36
FR;0;2021-07-13;287255;527057;2045;8;1;36957218;25795813;104428;177;37
FR;0;2021-07-14;181082;157517;435;0;0;37138300;25953330;104863;177;37
FR;0;2021-07-15;347091;502109;2099;1;0;37485391;26455439;106962;178;37
FR;0;2021-07-16;380089;495503;2023;3;1;37865480;26950942;108985;181;38
FR;0;2021-07-17;259719;319726;876;1;0;38125199;27270668;109861;182;38
FR;0;2021-07-18;109707;114642;310;0;0;38234906;27385310;110171;182;38
FR;0;2021-07-19;285463;424464;1629;3;0;38520369;27809774;111800;185;38
FR;0;2021-07-20;376905;451867;1723;0;0;38897274;28261641;113523;185;38
FR;0;2021-07-21;395777;407385;1549;4;2;39293051;28669026;115072;189;40
FR;0;2021-07-22;441037;387726;1715;4;2;39734088;29056752;116787;193;42
FR;0;2021-07-23;440314;422613;1882;4;1;40174402;29479365;118669;197;43
FR;0;2021-07-24;285246;269424;804;1;0;40459648;29748789;119473;198;43
FR;0;2021-07-25;121111;79965;234;0;0;40580759;29828754;119707;198;43
FR;0;2021-07-26;347418;322664;1614;3;2;40928177;30151418;121321;201;45
FR;0;2021-07-27;464057;319726;1697;4;2;41392234;30471144;123018;205;47
FR;0;2021-07-28;459432;289629;1635;4;2;41851666;30760773;124653;209;49
FR;0;2021-07-29;489812;276529;1796;2;0;42341478;31037302;126449;211;49
FR;0;2021-07-30;461815;302606;1941;5;1;42803293;31339908;128390;216;50
FR;0;2021-07-31;285393;185067;914;1;0;43088686;31524975;129304;217;50
FR;0;2021-08-01;112008;49942;253;0;0;43200694;31574917;129557;217;50
FR;0;2021-08-02;341595;234315;1602;2;0;43542289;31809232;131159;219;50
FR;0;2021-08-03;398599;244725;1728;2;1;43940888;32053957;132887;221;51
FR;0;2021-08-04;384838;209821;1593;6;3;44325726;32263778;134480;227;54
FR;0;2021-08-05;366158;228612;1710;0;0;44691884;32492390;136190;227;54
FR;0;2021-08-06;359720;271463;1835;4;1;45051604;32763853;138025;231;55
FR;0;2021-08-07;213109;178361;755;4;3;45264713;32942214;138780;235;58
FR;0;2021-08-08;74191;63211;275;0;0;45338904;33005425;139055;235;58
FR;0;2021-08-09;258743;259049;1547;4;3;45597647;33264474;140602;239;61
FR;0;2021-08-10;306840;277495;1661;2;1;45904487;33541969;142263;241;62
FR;0;2021-08-11;279731;259890;1441;5;1;46184218;33801859;143704;246;63
FR;0;2021-08-12;271539;278324;1662;3;0;46455757;34080183;145366;249;63
FR;0;2021-08-13;252146;278098;1592;3;2;46707903;34358281;146958;252;65
FR;0;2021-08-14;145333;197190;740;0;0;46853236;34555471;147698;252;65
FR;0;2021-08-15;39376;50115;217;1;0;46892612;34605586;147915;253;65
FR;0;2021-08-16;186173;317798;1542;0;0;47078785;34923384;149457;253;65
FR;0;2021-08-17;215674;336135;1636;7;0;47294459;35259519;151093;260;65
FR;0;2021-08-18;199043;324570;1597;7;4;47493502;35584089;152690;267;69
FR;0;2021-08-19;192027;325564;1640;1;0;47685529;35909653;154330;268;69
FR;0;2021-08-20;186453;366337;1818;3;2;47871982;36275990;156148;271;71
FR;0;2021-08-21;104792;238135;705;0;0;47976774;36514125;156853;271;71
FR;0;2021-08-22;31926;87213;255;1;1;48008700;36601338;157108;272;72
FR;0;2021-08-23;140983;357141;1561;3;1;48149683;36958479;158669;275;73
FR;0;2021-08-24;162475;376807;1848;5;1;48312158;37335286;160517;280;74
FR;0;2021-08-25;151130;350830;2033;8;2;48463288;37686116;162550;288;76
FR;0;2021-08-26;142871;342810;2559;10;0;48606159;38028926;165109;298;76
FR;0;2021-08-27;148448;388291;2790;11;3;48754607;38417217;167899;309;79
FR;0;2021-08-28;90662;249594;1405;0;0;48845269;38666811;169304;309;79
FR;0;2021-08-29;27319;83349;518;1;0;48872588;38750160;169822;310;79
FR;0;2021-08-30;117400;324792;4712;6;5964;48989988;39074952;174534;316;6043
FR;0;2021-08-31;128793;334539;10187;19;11821;49118781;39409491;184721;335;17864
FR;0;2021-09-01;136102;285709;22428;7;24382;49254883;39695200;207149;342;42246
FR;0;2021-09-02;114637;247259;26516;20;28945;49369520;39942459;233665;362;71191
FR;0;2021-09-03;118298;292702;29963;24;33037;49487818;40235161;263628;386;104228
FR;0;2021-09-04;89886;217782;12585;12;14115;49577704;40452943;276213;398;118343
FR;0;2021-09-05;21354;44834;4395;2;4722;49599058;40497777;280608;400;123065
FR;0;2021-09-06;75429;180656;31952;16;34296;49674487;40678433;312560;416;157361
FR;0;2021-09-07;80283;181251;33242;43;36232;49754770;40859684;345802;459;193593
FR;0;2021-09-08;90968;206128;29661;28;32519;49845738;41065812;375463;487;226112
FR;0;2021-09-09;76918;165380;33062;27;36615;49922656;41231192;408525;514;262727
FR;0;2021-09-10;95991;203790;35736;28;40659;50018647;41434982;444261;542;303386
FR;0;2021-09-11;67157;169297;12138;19;14374;50085804;41604279;456399;561;317760
FR;0;2021-09-12;12823;32106;2776;1;3177;50098627;41636385;459175;562;320937
FR;0;2021-09-13;64527;126250;41224;35;44158;50163154;41762635;500399;597;365095
FR;0;2021-09-14;73448;129080;56362;79;62254;50236602;41891715;556761;676;427349
FR;0;2021-09-15;76581;167836;55657;58;54833;50313183;42059551;612418;734;482182
FR;0;2021-09-16;63839;114545;60077;82;60082;50377022;42174096;672495;816;542264
FR;0;2021-09-17;75048;156838;53849;71;57283;50452070;42330934;726344;887;599547
FR;0;2021-09-18;48216;139629;15601;25;17311;50500286;42470563;741945;912;616858
FR;0;2021-09-19;7882;23687;2436;1;2615;50508168;42494250;744381;913;619473
FR;0;2021-09-20;44521;93846;50078;72;50329;50552689;42588096;794459;985;669802
FR;0;2021-09-21;45874;98443;62758;75;63438;50598563;42686539;857217;1060;733240
FR;0;2021-09-22;48656;142402;55368;82;55422;50647219;42828941;912585;1142;788662
FR;0;2021-09-23;43248;92093;62388;94;63552;50690467;42921034;974973;1236;852214
FR;0;2021-09-24;52278;133338;54548;107;59173;50742745;43054372;1029521;1343;911387
FR;0;2021-09-25;35214;115626;16272;36;18294;50777959;43169998;1045793;1379;929681
FR;0;2021-09-26;5546;17803;2269;5;2328;50783505;43187801;1048062;1384;932009
FR;0;2021-09-27;33957;76958;47194;97;48160;50817462;43264759;1095256;1481;980169
FR;0;2021-09-28;36487;75272;54964;89;56532;50853949;43340031;1150220;1570;1036701
FR;0;2021-09-29;44382;100807;53345;112;54855;50898331;43440838;1203565;1682;1091556
FR;0;2021-09-30;36316;72952;57035;96;59563;50934647;43513790;1260600;1778;1151119
FR;0;2021-10-01;61692;102882;57804;108;63936;50996339;43616672;1318404;1886;1215055
FR;0;2021-10-02;39456;78430;20960;39;23349;51035795;43695102;1339364;1925;1238404
FR;0;2021-10-03;5284;10503;2531;4;2540;51041079;43705605;1341895;1929;1240944
FR;0;2021-10-04;35139;58527;52618;84;54827;51076218;43764132;1394513;2013;1295771
FR;0;2021-10-05;33872;64379;61010;135;65055;51110090;43828511;1455523;2148;1360826
FR;0;2021-10-06;42684;79316;65741;113;68311;51152774;43907827;1521264;2261;1429137
FR;0;2021-10-07;30522;62256;65423;90;68826;51183296;43970083;1586687;2351;1497963
FR;0;2021-10-08;49447;91899;77747;110;84709;51232743;44061982;1664434;2461;1582672
FR;0;2021-10-09;33651;60947;31542;35;33918;51266394;44122929;1695976;2496;1616590
FR;0;2021-10-10;4705;7440;3193;9;3481;51271099;44130369;1699169;2505;1620071
FR;0;2021-10-11;30692;49951;61039;105;64096;51301791;44180320;1760208;2610;1684167
FR;0;2021-10-12;31594;54482;70612;140;75958;51333385;44234802;1830820;2750;1760125
FR;0;2021-10-13;40099;62838;74430;136;79334;51373484;44297640;1905250;2886;1839459
FR;0;2021-10-14;30309;52906;68757;116;73817;51403793;44350546;1974007;3002;1913276
FR;0;2021-10-15;44893;75299;93236;191;102991;51448686;44425845;2067243;3193;2016267
FR;0;2021-10-16;31299;44128;36692;44;39635;51479985;44469973;2103935;3237;2055902
FR;0;2021-10-17;3841;5245;3594;2;3682;51483826;44475218;2107529;3239;2059584
FR;0;2021-10-18;28977;42399;67495;133;71358;51512803;44517617;2175024;3372;2130942
FR;0;2021-10-19;27152;45600;76401;140;81624;51539955;44563217;2251425;3512;2212566
FR;0;2021-10-20;35295;52469;96938;181;101525;51575250;44615686;2348363;3693;2314091
FR;0;2021-10-21;26128;45203;83964;112;89143;51601378;44660889;2432327;3805;2403234
FR;0;2021-10-22;38410;62511;104895;200;112586;51639788;44723400;2537222;4005;2515820
FR;0;2021-10-23;27002;41226;45455;57;48624;51666790;44764626;2582677;4062;2564444
FR;0;2021-10-24;2919;4774;3682;6;3929;51669709;44769400;2586359;4068;2568373
FR;0;2021-10-25;26007;36282;82329;144;86640;51695716;44805682;2668688;4212;2655013
FR;0;2021-10-26;23728;35051;87245;166;92358;51719444;44840733;2755933;4378;2747371
FR;0;2021-10-27;30079;46379;109002;257;114695;51749523;44887112;2864935;4635;2862066
FR;0;2021-10-28;23582;34977;88705;153;94477;51773105;44922089;2953640;4788;2956543
FR;0;2021-10-29;31570;51488;117319;205;125350;51804675;44973577;3070959;4993;3081893
FR;0;2021-10-30;20555;33233;50347;76;53393;51825230;45006810;3121306;5069;3135286
FR;0;2021-10-31;2488;3736;3589;3;3878;51827718;45010546;3124895;5072;3139164
FR;0;2021-11-01;8436;4869;3210;3;3574;51836154;45015415;3128105;5075;3142738
FR;0;2021-11-02;26279;40127;93581;156;99586;51862433;45055542;3221686;5231;3242324
FR;0;2021-11-03;30075;47978;118888;218;125847;51892508;45103520;3340574;5449;3368171
FR;0;2021-11-04;23779;37532;107566;217;114423;51916287;45141052;3448140;5666;3482594
FR;0;2021-11-05;32383;52994;141641;235;151384;51948670;45194046;3589781;5901;3633978
FR;0;2021-11-06;21524;34577;64884;123;68299;51970194;45228623;3654665;6024;3702277
FR;0;2021-11-07;2399;4179;5195;6;5592;51972593;45232802;3659860;6030;3707869
FR;0;2021-11-08;20590;37807;127197;227;134310;51993183;45270609;3787057;6257;3842179
FR;0;2021-11-09;22403;44743;161687;339;172251;52015586;45315352;3948744;6596;4014430
FR;0;2021-11-10;31575;55074;187014;446;198819;52047161;45370426;4135758;7042;4213249
FR;0;2021-11-11;4703;6761;12968;28;13958;52051864;45377187;4148726;7070;4227207
FR;0;2021-11-12;29071;55160;183778;252;197385;52080935;45432347;4332504;7322;4424592
FR;0;2021-11-13;20346;32655;80698;118;86320;52101281;45465002;4413202;7440;4510912
FR;0;2021-11-14;2355;3890;7173;6;7855;52103636;45468892;4420375;7446;4518767
FR;0;2021-11-15;20479;38693;160856;313;171576;52124115;45507585;4581231;7759;4690343
FR;0;2021-11-16;23639;43986;200417;392;215030;52147754;45551571;4781648;8151;4905373
FR;0;2021-11-17;30505;50384;199849;406;212893;52178259;45601955;4981497;8557;5118266
FR;0;2021-11-18;23430;45547;191675;468;205573;52201689;45647502;5173172;9025;5323839
FR;0;2021-11-19;33665;61452;243218;549;262209;52235354;45708954;5416390;9574;5586048
FR;0;2021-11-20;25399;36708;102155;206;109701;52260753;45745662;5518545;9780;5695749
FR;0;2021-11-21;2643;4496;9653;19;10619;52263396;45750158;5528198;9799;5706368
FR;0;2021-11-22;22800;33265;180380;470;194861;52286196;45783423;5708578;10269;5901229
FR;0;2021-11-23;25711;45634;229380;549;247848;52311907;45829057;5937958;10818;6149077
FR;0;2021-11-24;31796;53767;224814;715;243238;52343703;45882824;6162772;11533;6392315
FR;0;2021-11-25;25625;49220;255941;739;277797;52369328;45932044;6418713;12272;6670112
FR;0;2021-11-26;33247;74874;379498;865;414643;52402575;46006918;6798211;13137;7084755
FR;0;2021-11-27;23488;49711;214909;389;236689;52426063;46056629;7013120;13526;7321444
FR;0;2021-11-28;3510;10539;56756;66;63328;52429573;46067168;7069876;13592;7384772
FR;0;2021-11-29;19413;54182;341474;862;371714;52448986;46121350;7411350;14454;7756486
FR;0;2021-11-30;24775;72054;457391;988;500784;52473761;46193404;7868741;15442;8257270
FR;0;2021-12-01;27348;75858;469103;1160;511354;52501109;46269262;8337844;16602;8768624
FR;0;2021-12-02;22085;71854;527109;1280;574880;52523194;46341116;8864953;17882;9343504
FR;0;2021-12-03;25545;93158;596392;1420;651197;52548739;46434274;9461345;19302;9994701
FR;0;2021-12-04;18313;60544;336229;690;369796;52567052;46494818;9797574;19992;10364497
FR;0;2021-12-05;4153;16201;95785;157;107056;52571205;46511019;9893359;20149;10471553
FR;0;2021-12-06;28395;73046;493153;1173;539982;52599600;46584065;10386512;21322;11011535
FR;0;2021-12-07;23529;91525;645398;1773;706322;52623129;46675590;11031910;23095;11717857
FR;0;2021-12-08;25485;92292;591585;1874;647500;52648614;46767882;11623495;24969;12365357
FR;0;2021-12-09;24050;94253;663100;2179;726414;52672664;46862135;12286595;27148;13091771
FR;0;2021-12-10;28043;111191;736061;2075;806184;52700707;46973326;13022656;29223;13897955
FR;0;2021-12-11;20250;76258;435180;987;480403;52720957;47049584;13457836;30210;14378358
FR;0;2021-12-12;5643;23227;142305;262;159221;52726600;47072811;13600141;30472;14537579
FR;0;2021-12-13;21347;91153;587651;1699;649314;52747947;47163964;14187792;32171;15186893
FR;0;2021-12-14;27946;118615;765546;2654;847506;52775893;47282579;14953338;34825;16034399
FR;0;2021-12-15;28417;114523;694339;2265;769106;52804310;47397102;15647677;37090;16803505
FR;0;2021-12-16;28019;116005;764026;2557;844439;52832329;47513107;16411703;39647;17647944
FR;0;2021-12-17;31642;128743;807868;2709;892081;52863971;47641850;17219571;42356;18540025
FR;0;2021-12-18;24930;81700;469964;1178;522205;52888901;47723550;17689535;43534;19062230
FR;0;2021-12-19;8757;28725;169392;376;191101;52897658;47752275;17858927;43910;19253331
FR;0;2021-12-20;31747;97482;591490;1786;658760;52929405;47849757;18450417;45696;19912091
FR;0;2021-12-21;39454;112273;682410;2391;759581;52968859;47962030;19132827;48087;20671672
FR;0;2021-12-22;39549;99553;575762;2168;642149;53008408;48061583;19708589;50255;21313821
FR;0;2021-12-23;33774;79696;441002;1655;494407;53042182;48141279;20149591;51910;21808228
FR;0;2021-12-24;10690;26150;111023;398;126675;53052872;48167429;20260614;52308;21934903
FR;0;2021-12-25;774;3578;7589;25;9033;53053646;48171007;20268203;52333;21943936
FR;0;2021-12-26;4695;11899;52095;142;60148;53058341;48182906;20320298;52475;22004084
FR;0;2021-12-27;30497;84090;453550;1364;509168;53088838;48266996;20773848;53839;22513252
FR;0;2021-12-28;38361;99088;564157;1769;632267;53127199;48366084;21338005;55608;23145519
FR;0;2021-12-29;39867;88438;501195;1688;561004;53167066;48454522;21839200;57296;23706523
FR;0;2021-12-30;35917;75279;421024;1520;471149;53202983;48529801;22260224;58816;24177672
FR;0;2021-12-31;12044;25165;116871;405;131662;53215027;48554966;22377095;59221;24309334
FR;0;2022-01-01;1491;3209;8514;37;9942;53216518;48558175;22385609;59258;24319276
FR;0;2022-01-02;6093;12997;58415;125;66945;53222611;48571172;22444024;59383;24386221
FR;0;2022-01-03;36281;90322;494816;1593;551691;53258892;48661494;22938840;60976;24937912
FR;0;2022-01-04;41853;111142;641370;2307;714370;53300745;48772636;23580210;63283;25652282
FR;0;2022-01-05;60913;103721;569158;1981;634184;53361658;48876357;24149368;65264;26286466
FR;0;2022-01-06;44231;110449;638960;2696;711443;53405889;48986806;24788328;67960;26997909
FR;0;2022-01-07;50808;123433;710986;2809;790486;53456697;49110239;25499314;70769;27788395
FR;0;2022-01-08;45002;80327;423802;1213;472881;53501699;49190566;25923116;71982;28261276
FR;0;2022-01-09;15598;26640;128563;300;145677;53517297;49217206;26051679;72282;28406953
FR;0;2022-01-10;35326;93473;469295;1811;522735;53552623;49310679;26520974;74093;28929688
FR;0;2022-01-11;41901;100589;548222;2306;608478;53594524;49411268;27069196;76399;29538166
FR;0;2022-01-12;60343;95787;452663;1967;504335;53654867;49507055;27521859;78366;30042501
FR;0;2022-01-13;38202;92600;487330;2085;541031;53693069;49599655;28009189;80451;30583532
FR;0;2022-01-14;42557;103423;568585;2286;629004;53735626;49703078;28577774;82737;31212536
FR;0;2022-01-15;39386;65868;340127;985;377557;53775012;49768946;28917901;83722;31590093
FR;0;2022-01-16;11399;19224;87419;216;99425;53786411;49788170;29005320;83938;31689518
FR;0;2022-01-17;24713;60103;320272;1381;354168;53811124;49848273;29325592;85319;32043686
FR;0;2022-01-18;28300;68766;361064;1802;397548;53839424;49917039;29686656;87121;32441234
FR;0;2022-01-19;43199;67113;281275;1450;311078;53882623;49984152;29967931;88571;32752312
FR;0;2022-01-20;23595;59653;298989;1739;328494;53906218;50043805;30266920;90310;33080806
FR;0;2022-01-21;28183;68897;366353;2086;401176;53934401;50112702;30633273;92396;33481982
FR;0;2022-01-22;27619;48006;218784;839;241769;53962020;50160708;30852057;93235;33723751
FR;0;2022-01-23;6709;12983;48672;173;55168;53968729;50173691;30900729;93408;33778919
FR;0;2022-01-24;16259;47521;217299;1139;239341;53984988;50221212;31118028;94547;34018260
FR;0;2022-01-25;19013;54426;243025;1547;267059;54004001;50275638;31361053;96094;34285319
FR;0;2022-01-26;28144;60479;209268;1297;229453;54032145;50336117;31570321;97391;34514772
FR;0;2022-01-27;16323;46336;207637;1274;225934;54048468;50382453;31777958;98665;34740706
FR;0;2022-01-28;21574;77968;290043;1574;321403;54070042;50460421;32068001;100239;35062109
FR;0;2022-01-29;18416;52828;184120;688;204577;54088458;50513249;32252121;100927;35266686
FR;0;2022-01-30;4470;14502;39140;124;45095;54092928;50527751;32291261;101051;35311781
FR;0;2022-01-31;11254;43983;148197;740;164793;54104182;50571734;32439458;101791;35476574
FR;0;2022-02-01;13451;48385;174113;1142;191411;54117633;50620119;32613571;102933;35667985
FR;0;2022-02-02;20426;66362;171517;1034;190135;54138059;50686481;32785088;103967;35858120
FR;0;2022-02-03;11440;44759;157544;989;173321;54149499;50731240;32942632;104956;36031441
FR;0;2022-02-04;14616;66523;239239;1266;264167;54164115;50797763;33181871;106222;36295608
FR;0;2022-02-05;12891;51476;153542;523;172332;54177006;50849239;33335413;106745;36467940
FR;0;2022-02-06;2720;12191;28887;101;33836;54179726;50861430;33364300;106846;36501776
FR;0;2022-02-07;9536;46720;156860;590;176317;54189262;50908150;33521160;107436;36678093
FR;0;2022-02-08;9761;43058;166619;867;184411;54199023;50951208;33687779;108303;36862504
FR;0;2022-02-09;14323;58221;172333;870;193038;54213346;51009429;33860112;109173;37055542
FR;0;2022-02-10;8672;38994;150216;878;166687;54222018;51048423;34010328;110051;37222229
FR;0;2022-02-11;10854;55642;218493;1100;243083;54232872;51104065;34228821;111151;37465312
FR;0;2022-02-12;8378;40937;134716;461;151741;54241250;51145002;34363537;111612;37617053
FR;0;2022-02-13;1898;8596;26558;85;30917;54243148;51153598;34390095;111697;37647970
FR;0;2022-02-14;6978;35226;148359;482;166354;54250126;51188824;34538454;112179;37814324
FR;0;2022-02-15;7034;36186;146962;751;162547;54257160;51225010;34685416;112930;37976871
FR;0;2022-02-16;9388;42948;132526;720;146746;54266548;51267958;34817942;113650;38123617
FR;0;2022-02-17;5570;24286;87288;585;94857;54272118;51292244;34905230;114235;38218474
FR;0;2022-02-18;6988;33542;119644;804;129307;54279106;51325786;35024874;115039;38347781
FR;0;2022-02-19;5366;24542;70021;370;77331;54284472;51350328;35094895;115409;38425112
FR;0;2022-02-20;1143;4649;12166;39;13944;54285615;51354977;35107061;115448;38439056
FR;0;2022-02-21;4088;17880;61942;351;67171;54289703;51372857;35169003;115799;38506227
FR;0;2022-02-22;4444;18636;60818;576;64455;54294147;51391493;35229821;116375;38570682
FR;0;2022-02-23;6575;27325;66489;591;71887;54300722;51418818;35296310;116966;38642569
FR;0;2022-02-24;3845;15455;50418;517;53240;54304567;51434273;35346728;117483;38695809
FR;0;2022-02-25;5278;23955;76340;803;80075;54309845;51458228;35423068;118286;38775884
FR;0;2022-02-26;3987;17761;47407;359;51474;54313832;51475989;35470475;118645;38827358
FR;0;2022-02-27;879;3002;8033;47;8944;54314711;51478991;35478508;118692;38836302
FR;0;2022-02-28;3122;12515;40471;358;42906;54317833;51491506;35518979;119050;38879208
FR;0;2022-03-01;3835;12555;44183;435;44851;54321668;51504061;35563162;119485;38924059
FR;0;2022-03-02;5278;17758;47123;445;49054;54326946;51521819;35610285;119930;38973113
FR;0;2022-03-03;2798;9302;29884;368;30003;54329744;51531121;35640169;120298;39003116
FR;0;2022-03-04;3218;12369;40292;665;39441;54332962;51543490;35680461;120963;39042557
FR;0;2022-03-05;3067;9264;24950;310;25112;54336029;51552754;35705411;121273;39067669
FR;0;2022-03-06;516;1394;3195;43;3438;54336545;51554148;35708606;121316;39071107
FR;0;2022-03-07;2276;5605;18419;316;17688;54338821;51559753;35727025;121632;39088795
FR;0;2022-03-08;2085;6060;19440;359;17909;54340906;51565813;35746465;121991;39106704
FR;0;2022-03-09;3543;10488;22179;405;21274;54344449;51576301;35768644;122396;39127978
FR;0;2022-03-10;1783;5588;16975;342;15802;54346232;51581889;35785619;122738;39143780
FR;0;2022-03-11;2404;7532;24490;539;22254;54348636;51589421;35810109;123277;39166034
FR;0;2022-03-12;2662;6771;17158;308;16512;54351298;51596192;35827267;123585;39182546
FR;0;2022-03-13;390;786;2320;147;2270;54351688;51596978;35829587;123732;39184816
FR;0;2022-03-14;1537;4260;14972;4408;13826;54353225;51601238;35844559;128140;39198642
FR;0;2022-03-15;1713;6246;16363;7551;14590;54354938;51607484;35860922;135691;39213232
FR;0;2022-03-16;3011;7318;19416;13136;18090;54357949;51614802;35880338;148827;39231322
FR;0;2022-03-17;1441;3969;13130;10842;11976;54359390;51618771;35893468;159669;39243298
FR;0;2022-03-18;2262;5738;19986;18286;18080;54361652;51624509;35913454;177955;39261378
FR;0;2022-03-19;2288;4800;13111;9400;12413;54363940;51629309;35926565;187355;39273791
FR;0;2022-03-20;298;731;1917;1073;1928;54364238;51630040;35928482;188428;39275719
FR;0;2022-03-21;1385;3204;12713;14937;11935;54365623;51633244;35941195;203365;39287654
FR;0;2022-03-22;1495;3728;13789;20527;12547;54367118;51636972;35954984;223892;39300201
FR;0;2022-03-23;2667;6236;17704;23148;17218;54369785;51643208;35972688;247040;39317419
FR;0;2022-03-24;1393;3143;11583;17604;10667;54371178;51646351;35984271;264644;39328086
FR;0;2022-03-25;2076;5129;18545;27752;16880;54373254;51651480;36002816;292396;39344966
FR;0;2022-03-26;2223;4409;12073;12677;11514;54375477;51655889;36014889;305073;39356480
FR;0;2022-03-27;359;688;1904;1480;1937;54375836;51656577;36016793;306553;39358417
FR;0;2022-03-28;1457;3064;11115;17486;10609;54377293;51659641;36027908;324039;39369026
FR;0;2022-03-29;1449;3263;12897;27555;12038;54378742;51662904;36040805;351594;39381064
FR;0;2022-03-30;2841;5449;15671;27365;15066;54381583;51668353;36056476;378959;39396130
FR;0;2022-03-31;1607;3543;12970;24964;12303;54383190;51671896;36069446;403923;39408433
FR;0;2022-04-01;2655;4569;20042;30861;18682;54385845;51676465;36089488;434784;39427115
FR;0;2022-04-02;1519;2624;9046;10110;8703;54387364;51679089;36098534;444894;39435818
FR;0;2022-04-03;287;504;1561;1167;1577;54387651;51679593;36100095;446061;39437395
FR;0;2022-04-04;1810;2841;12357;19096;11558;54389461;51682434;36112452;465157;39448953
FR;0;2022-04-05;1735;3091;14327;34064;13177;54391196;51685525;36126779;499221;39462130
FR;0;2022-04-06;2137;3849;13519;26472;12788;54393333;51689374;36140298;525693;39474918
FR;0;2022-04-07;1523;3060;13653;33744;12864;54394856;51692434;36153951;559437;39487782
FR;0;2022-04-08;2059;4210;19200;43851;17805;54396915;51696644;36173151;603288;39505587
FR;0;2022-04-09;1361;2665;9309;13555;8861;54398276;51699309;36182460;616843;39514448
FR;0;2022-04-10;284;592;1981;2011;2000;54398560;51699901;36184441;618854;39516448
FR;0;2022-04-11;1257;2584;11853;23838;11455;54399817;51702485;36196294;642692;39527903
FR;0;2022-04-12;1656;3004;13998;40839;13368;54401473;51705489;36210292;683531;39541271
FR;0;2022-04-13;1929;3640;13398;33050;13016;54403402;51709129;36223690;716581;39554287
FR;0;2022-04-14;1478;2873;13176;36243;13022;54404880;51712002;36236866;752824;39567309
FR;0;2022-04-15;1843;3432;15615;35484;14860;54406723;51715434;36252481;788308;39582169
FR;0;2022-04-16;1040;1815;6394;8533;6249;54407763;51717249;36258875;796841;39588418
FR;0;2022-04-17;190;321;991;1172;1030;54407953;51717570;36259866;798013;39589448
FR;0;2022-04-18;179;522;2763;1068;2781;54408132;51718092;36262629;799081;39592229
FR;0;2022-04-19;1514;2996;12900;29598;12462;54409646;51721088;36275529;828679;39604691
FR;0;2022-04-20;1970;3439;13284;28980;12962;54411616;51724527;36288813;857659;39617653
FR;0;2022-04-21;1493;2831;12522;35047;12551;54413109;51727358;36301335;892706;39630204
FR;0;2022-04-22;1852;3587;16453;37565;15816;54414961;51730945;36317788;930271;39646020
FR;0;2022-04-23;1140;2047;7380;10653;7231;54416101;51732992;36325168;940924;39653251
FR;0;2022-04-24;249;448;1475;1588;1410;54416350;51733440;36326643;942512;39654661
FR;0;2022-04-25;1285;2516;10676;21008;10479;54417635;51735956;36337319;963520;39665140
FR;0;2022-04-26;1608;2977;13649;38536;13099;54419243;51738933;36350968;1002056;39678239
FR;0;2022-04-27;1948;3046;11523;30942;11580;54421191;51741979;36362491;1032998;39689819
FR;0;2022-04-28;1548;2728;12515;36078;12253;54422739;51744707;36375006;1069076;39702072
FR;0;2022-04-29;1990;4034;15539;37200;14900;54424729;51748741;36390545;1106276;39716972
FR;0;2022-04-30;1203;1826;6923;9704;6750;54425932;51750567;36397468;1115980;39723722
FR;0;2022-05-01;215;318;908;995;903;54426147;51750885;36398376;1116975;39724625
FR;0;2022-05-02;1449;2792;11127;18074;10930;54427596;51753677;36409503;1135049;39735555
FR;0;2022-05-03;1837;3185;13700;34592;13542;54429433;51756862;36423203;1169641;39749097
FR;0;2022-05-04;1865;3235;12160;25600;12268;54431298;51760097;36435363;1195241;39761365
FR;0;2022-05-05;1725;2820;13021;33417;12870;54433023;51762917;36448384;1228658;39774235
FR;0;2022-05-06;2143;3630;15316;36704;14807;54435166;51766547;36463700;1265362;39789042
FR;0;2022-05-07;1191;1764;6458;9601;6445;54436357;51768311;36470158;1274963;39795487
FR;0;2022-05-08;260;395;1171;1544;1231;54436617;51768706;36471329;1276507;39796718
FR;0;2022-05-09;1295;2268;9910;20237;9778;54437912;51770974;36481239;1296744;39806496
FR;0;2022-05-10;1712;3096;13538;38807;13089;54439624;51774070;36494777;1335551;39819585
FR;0;2022-05-11;1972;2939;10727;27848;10654;54441596;51777009;36505504;1363399;39830239
FR;0;2022-05-12;1555;2644;11335;35585;10993;54443151;51779653;36516839;1398984;39841232
FR;0;2022-05-13;1957;3178;13733;37798;13316;54445108;51782831;36530572;1436782;39854548
FR;0;2022-05-14;1142;1608;5934;10768;5793;54446250;51784439;36536506;1447550;39860341
FR;0;2022-05-15;280;449;1276;1432;1353;54446530;51784888;36537782;1448982;39861694
FR;0;2022-05-16;1175;1997;8667;20988;8663;54447705;51786885;36546449;1469970;39870357
FR;0;2022-05-17;1568;2550;11811;37808;11388;54449273;51789435;36558260;1507778;39881745
FR;0;2022-05-18;1784;2608;9672;27104;9644;54451057;51792043;36567932;1534882;39891389
FR;0;2022-05-19;1417;2620;10545;35726;10684;54452474;51794663;36578477;1570608;39902073
FR;0;2022-05-20;1862;3087;13394;39332;12885;54454336;51797750;36591871;1609940;39914958
FR;0;2022-05-21;1157;1691;5655;9895;5528;54455493;51799441;36597526;1619835;39920486
FR;0;2022-05-22;237;333;1024;1434;1011;54455730;51799774;36598550;1621269;39921497
FR;0;2022-05-23;1154;2044;8870;20330;8802;54456884;51801818;36607420;1641599;39930299
FR;0;2022-05-24;1525;2731;11344;38790;11189;54458409;51804549;36618764;1680389;39941488
FR;0;2022-05-25;1800;2795;9333;24801;9463;54460209;51807344;36628097;1705190;39950951
FR;0;2022-05-26;199;393;1654;1189;1663;54460408;51807737;36629751;1706379;39952614
FR;0;2022-05-27;1370;2438;9248;21260;8989;54461778;51810175;36638999;1727639;39961603
FR;0;2022-05-28;663;1246;3911;6781;3961;54462441;51811421;36642910;1734420;39965564
FR;0;2022-05-29;154;314;751;915;771;54462595;51811735;36643661;1735335;39966335
FR;0;2022-05-30;1002;1932;6984;19255;6997;54463597;51813667;36650645;1754590;39973332
FR;0;2022-05-31;1482;2465;9812;35621;9632;54465079;51816132;36660457;1790211;39982964
FR;0;2022-06-01;1692;3059;11017;24449;10884;54466771;51819191;36671474;1814660;39993848
FR;0;2022-06-02;1456;2557;11303;35456;10835;54468227;51821748;36682777;1850116;40004683
FR;0;2022-06-03;1701;3032;13377;38694;12742;54469928;51824780;36696154;1888810;40017425
FR;0;2022-06-04;967;1509;5039;9104;5111;54470895;51826289;36701193;1897914;40022536
FR;0;2022-06-05;173;326;872;1104;882;54471068;51826615;36702065;1899018;40023418
FR;0;2022-06-06;240;757;2098;1251;2090;54471308;51827372;36704163;1900269;40025508
FR;0;2022-06-07;1361;2635;9833;35548;9411;54472669;51830007;36713996;1935817;40034919
FR;0;2022-06-08;1528;2648;9154;28694;8991;54474197;51832655;36723150;1964511;40043910
FR;0;2022-06-09;1264;2401;10598;39429;10237;54475461;51835056;36733748;2003940;40054147
FR;0;2022-06-10;1603;2867;13057;44737;12600;54477064;51837923;36746805;2048677;40066747
FR;0;2022-06-11;953;1724;5433;11614;5465;54478017;51839647;36752238;2060291;40072212
FR;0;2022-06-12;195;429;1071;1758;1132;54478212;51840076;36753309;2062049;40073344
FR;0;2022-06-13;1061;1990;7417;23145;7248;54479273;51842066;36760726;2085194;40080592
FR;0;2022-06-14;1302;2452;10434;44837;9788;54480575;51844518;36771160;2130031;40090380
FR;0;2022-06-15;1478;2359;9294;30867;8928;54482053;51846877;36780454;2160898;40099308
FR;0;2022-06-16;1154;1985;9885;39831;9293;54483207;51848862;36790339;2200729;40108601
FR;0;2022-06-17;1464;2805;12457;46587;11885;54484671;51851667;36802796;2247316;40120486
FR;0;2022-06-18;849;1504;4558;11118;4490;54485520;51853171;36807354;2258434;40124976
FR;0;2022-06-19;180;352;1057;1613;1129;54485700;51853523;36808411;2260047;40126105
FR;0;2022-06-20;1015;1887;8893;26056;8554;54486715;51855410;36817304;2286103;40134659
FR;0;2022-06-21;1313;2370;10293;49847;9320;54488028;51857780;36827597;2335950;40143979
FR;0;2022-06-22;1367;2445;8898;38979;8388;54489395;51860225;36836495;2374929;40152367
FR;0;2022-06-23;1216;2307;10668;55049;9861;54490611;51862532;36847163;2429978;40162228
FR;0;2022-06-24;1475;2959;13623;69073;12275;54492086;51865491;36860786;2499051;40174503
FR;0;2022-06-25;931;1772;6221;19909;5974;54493017;51867263;36867007;2518960;40180477
FR;0;2022-06-26;228;454;1951;3685;1811;54493245;51867717;36868958;2522645;40182288
FR;0;2022-06-27;1119;2006;10481;48424;9623;54494364;51869723;36879439;2571069;40191911
FR;0;2022-06-28;1444;2793;14648;91264;13063;54495808;51872516;36894087;2662333;40204974
FR;0;2022-06-29;1691;2812;12278;71747;11227;54497499;51875328;36906365;2734080;40216201
FR;0;2022-06-30;1515;2628;14367;95115;12449;54499014;51877956;36920732;2829195;40228650
FR;0;2022-07-01;1947;3699;21286;115873;18623;54500961;51881655;36942018;2945068;40247273
FR;0;2022-07-02;1070;1851;8509;35732;7693;54502031;51883506;36950527;2980800;40254966
FR;0;2022-07-03;289;537;2084;6447;1886;54502320;51884043;36952611;2987247;40256852
FR;0;2022-07-04;1501;2679;14645;79167;12884;54503821;51886722;36967256;3066414;40269736
FR;0;2022-07-05;1689;3040;18782;133073;15964;54505510;51889762;36986038;3199487;40285700
FR;0;2022-07-06;1797;2687;15814;99428;13605;54507307;51892449;37001852;3298915;40299305
FR;0;2022-07-07;1681;2820;17958;125839;14724;54508988;51895269;37019810;3424754;40314029
FR;0;2022-07-08;1869;3120;20708;136905;16730;54510857;51898389;37040518;3561659;40330759
FR;0;2022-07-09;862;1445;7729;37899;6675;54511719;51899834;37048247;3599558;40337434
FR;0;2022-07-10;259;505;2343;6994;2125;54511978;51900339;37050590;3606552;40339559
FR;0;2022-07-11;1392;2405;14994;88179;12474;54513370;51902744;37065584;3694731;40352033
FR;0;2022-07-12;1769;3050;20484;143754;16677;54515139;51905794;37086068;3838485;40368710
FR;0;2022-07-13;1697;2628;15651;94377;13217;54516836;51908422;37101719;3932862;40381927
FR;0;2022-07-14;177;317;1947;5522;1824;54517013;51908739;37103666;3938384;40383751
FR;0;2022-07-15;1463;2518;15070;84369;12562;54518476;51911257;37118736;4022753;40396313
FR;0;2022-07-16;614;1157;5931;24942;5134;54519090;51912414;37124667;4047695;40401447
FR;0;2022-07-17;173;385;1733;4650;1565;54519263;51912799;37126400;4052345;40403012
FR;0;2022-07-18;1114;2184;11799;61733;9943;54520377;51914983;37138199;4114078;40412955
FR;0;2022-07-19;1402;2319;15428;103571;12252;54521779;51917302;37153627;4217649;40425207
FR;0;2022-07-20;1396;2246;12888;77485;10664;54523175;51919548;37166515;4295134;40435871
FR;0;2022-07-21;1254;2117;13044;88046;10446;54524429;51921665;37179559;4383180;40446317
FR;0;2022-07-22;1378;2409;14759;89302;11907;54525807;51924074;37194318;4472482;40458224
FR;0;2022-07-23;663;1285;5514;22451;4844;54526470;51925359;37199832;4494933;40463068
FR;0;2022-07-24;175;346;1390;3881;1234;54526645;51925705;37201222;4498814;40464302
FR;0;2022-07-25;1023;1753;9468;47992;7813;54527668;51927458;37210690;4546806;40472115
FR;0;2022-07-26;1286;2188;13279;85334;10792;54528954;51929646;37223969;4632140;40482907
FR;0;2022-07-27;1214;1975;10184;61103;8480;54530168;51931621;37234153;4693243;40491387
FR;0;2022-07-28;1064;1810;10266;64137;8177;54531232;51933431;37244419;4757380;40499564
FR;0;2022-07-29;1271;1989;10927;65706;8693;54532503;51935420;37255346;4823086;40508257
FR;0;2022-07-30;489;837;3504;15231;2961;54532992;51936257;37258850;4838317;40511218
FR;0;2022-07-31;148;279;923;2416;785;54533140;51936536;37259773;4840733;40512003
FR;0;2022-08-01;776;1348;7518;30154;6310;54533916;51937884;37267291;4870887;40518313
FR;0;2022-08-02;985;1595;8507;55900;6807;54534901;51939479;37275798;4926787;40525120
FR;0;2022-08-03;804;1216;6359;38605;5088;54535705;51940695;37282157;4965392;40530208
FR;0;2022-08-04;709;1148;6460;42999;5215;54536414;51941843;37288617;5008391;40535423
FR;0;2022-08-05;834;1333;6933;44799;5512;54537248;51943176;37295550;5053190;40540935
FR;0;2022-08-06;331;549;2020;9324;1673;54537579;51943725;37297570;5062514;40542608
FR;0;2022-08-07;95;151;522;1605;440;54537674;51943876;37298092;5064119;40543048
FR;0;2022-08-08;523;881;3952;22012;3208;54538197;51944757;37302044;5086131;40546256
FR;0;2022-08-09;674;1104;5930;39822;4750;54538871;51945861;37307974;5125953;40551006
FR;0;2022-08-10;600;1049;4568;27919;3706;54539471;51946910;37312542;5153872;40554712
FR;0;2022-08-11;602;979;4414;29019;3624;54540073;51947889;37316956;5182891;40558336
FR;0;2022-08-12;696;1112;4652;28093;3806;54540769;51949001;37321608;5210984;40562142
FR;0;2022-08-13;195;387;1252;5205;1069;54540964;51949388;37322860;5216189;40563211
FR;0;2022-08-14;64;116;276;883;236;54541028;51949504;37323136;5217072;40563447
FR;0;2022-08-15;54;146;502;537;455;54541082;51949650;37323638;5217609;40563902
FR;0;2022-08-16;598;1020;3885;22100;3283;54541680;51950670;37327523;5239709;40567185
FR;0;2022-08-17;603;968;3804;22761;3211;54542283;51951638;37331327;5262470;40570396
FR;0;2022-08-18;584;932;3998;26131;3140;54542867;51952570;37335325;5288601;40573536
FR;0;2022-08-19;570;1112;4241;27105;3461;54543437;51953682;37339566;5315706;40576997
FR;0;2022-08-20;277;463;1301;5529;1110;54543714;51954145;37340867;5321235;40578107
FR;0;2022-08-21;90;131;287;972;255;54543804;51954276;37341154;5322207;40578362
FR;0;2022-08-22;524;924;2974;15226;2511;54544328;51955200;37344128;5337433;40580873
FR;0;2022-08-23;687;1137;4192;28807;3499;54545015;51956337;37348320;5366240;40584372
FR;0;2022-08-24;621;893;3347;19325;2698;54545636;51957230;37351667;5385565;40587070
FR;0;2022-08-25;596;951;3801;23187;3158;54546232;51958181;37355468;5408752;40590228
FR;0;2022-08-26;827;1196;4280;25608;3486;54547059;51959377;37359748;5434360;40593714
FR;0;2022-08-27;285;466;1334;5393;1187;54547344;51959843;37361082;5439753;40594901
FR;0;2022-08-28;110;145;290;874;266;54547454;51959988;37361372;5440627;40595167
FR;0;2022-08-29;586;915;2834;14432;2383;54548040;51960903;37364206;5455059;40597550
FR;0;2022-08-30;811;1159;4446;28070;3603;54548851;51962062;37368652;5483129;40601153
FR;0;2022-08-31;649;890;2955;17227;2480;54549500;51962952;37371607;5500356;40603633
FR;0;2022-09-01;640;837;3376;21706;2757;54550140;51963789;37374983;5522062;40606390
FR;0;2022-09-02;805;1042;4412;27694;3583;54550945;51964831;37379395;5549756;40609973
FR;0;2022-09-03;364;502;1581;5879;1337;54551309;51965333;37380976;5555635;40611310
FR;0;2022-09-04;98;116;287;763;288;54551407;51965449;37381263;5556398;40611598
