fra;vaccin;jour;n_dose1;n_dose2;n_dose3;n_cum_dose1;n_cum_dose2;n_cum_dose3
FR;1;2020-12-27;321;0;0;321;0;0
FR;1;2020-12-28;333;0;0;654;0;0
FR;1;2020-12-29;232;0;0;886;0;0
FR;1;2020-12-30;277;0;0;1163;0;0
FR;1;2020-12-31;219;0;0;1382;0;0
FR;1;2021-01-01;256;0;0;1638;0;0
FR;1;2021-01-02;205;0;0;1843;0;0
FR;1;2021-01-03;240;0;0;2083;0;0
FR;1;2021-01-04;1714;0;0;3797;0;0
FR;1;2021-01-05;5655;0;0;9452;0;0
FR;1;2021-01-06;11572;0;0;21024;0;0
FR;1;2021-01-07;29019;0;0;50043;0;0
FR;1;2021-01-08;36685;0;0;86728;0;0
FR;1;2021-01-09;11061;0;0;97789;0;0
FR;1;2021-01-10;5750;0;0;103539;0;0
FR;1;2021-01-11;39593;0;0;143132;0;0
FR;1;2021-01-12;61602;0;0;204734;0;0
FR;1;2021-01-13;64551;0;0;269285;0;0
FR;1;2021-01-14;80782;0;0;350067;0;0
FR;1;2021-01-15;68128;0;0;418195;0;0
FR;1;2021-01-16;19754;77;0;437949;77;0
FR;1;2021-01-17;10698;42;0;448647;119;0
FR;1;2021-01-18;82309;161;0;530956;280;0
FR;1;2021-01-19;125339;125;0;656295;405;0
FR;1;2021-01-20;131758;155;0;788053;560;0
FR;1;2021-01-21;152170;131;0;940223;691;0
FR;1;2021-01-22;115259;160;0;1055482;851;0
FR;1;2021-01-23;36369;50;0;1091851;901;0
FR;1;2021-01-24;9417;27;0;1101268;928;0
FR;1;2021-01-25;73956;1215;0;1175224;2143;0
FR;1;2021-01-26;96004;3108;0;1271228;5251;0
FR;1;2021-01-27;103239;5592;0;1374467;10843;0
FR;1;2021-01-28;120079;14353;0;1494546;25196;0
FR;1;2021-01-29;88459;17277;0;1583005;42473;0
FR;1;2021-01-30;27818;4222;0;1610823;46695;0
FR;1;2021-01-31;5033;1678;0;1615856;48373;0
FR;1;2021-02-01;48852;21115;0;1664708;69488;0
FR;1;2021-02-02;67140;34552;0;1731848;104040;0
FR;1;2021-02-03;66597;36949;0;1798445;140989;0
FR;1;2021-02-04;76577;50036;0;1875022;191025;0
FR;1;2021-02-05;63005;45315;0;1938027;236340;0
FR;1;2021-02-06;19234;10390;0;1957261;246730;0
FR;1;2021-02-07;3554;5040;0;1960815;251770;0
FR;1;2021-02-08;36148;45958;0;1996963;297728;0
FR;1;2021-02-09;50441;72373;0;2047404;370101;0
FR;1;2021-02-10;51445;76663;0;2098849;446764;0
FR;1;2021-02-11;62906;99061;0;2161755;545825;0
FR;1;2021-02-12;55391;73966;0;2217146;619791;0
FR;1;2021-02-13;15298;19261;0;2232444;639052;0
FR;1;2021-02-14;3561;7188;0;2236005;646240;0
FR;1;2021-02-15;23836;73415;0;2259841;719655;0
FR;1;2021-02-16;32379;96824;0;2292220;816479;0
FR;1;2021-02-17;34706;98573;1;2326926;915052;1
FR;1;2021-02-18;48887;113412;0;2375813;1028464;1
FR;1;2021-02-19;44987;86407;0;2420800;1114871;1
FR;1;2021-02-20;13219;26906;0;2434019;1141777;1
FR;1;2021-02-21;2279;6286;0;2436298;1148063;1
FR;1;2021-02-22;24359;69403;1;2460657;1217466;2
FR;1;2021-02-23;37058;80344;1;2497715;1297810;3
FR;1;2021-02-24;40136;77637;1;2537851;1375447;4
FR;1;2021-02-25;49677;87938;1;2587528;1463385;5
FR;1;2021-02-26;46693;67874;0;2634221;1531259;5
FR;1;2021-02-27;15448;20929;0;2649669;1552188;5
FR;1;2021-02-28;3378;4385;1;2653047;1556573;6
FR;1;2021-03-01;39302;49003;0;2692349;1605576;6
FR;1;2021-03-02;55353;61496;1;2747702;1667072;7
FR;1;2021-03-03;60339;60643;0;2808041;1727715;7
FR;1;2021-03-04;72252;64890;2;2880293;1792605;9
FR;1;2021-03-05;73974;59250;2;2954267;1851855;11
FR;1;2021-03-06;81995;16081;0;3036262;1867936;11
FR;1;2021-03-07;63385;5411;0;3099647;1873347;11
FR;1;2021-03-08;59503;42458;0;3159150;1915805;11
FR;1;2021-03-09;85277;48311;0;3244427;1964116;11
FR;1;2021-03-10;89948;48059;2;3334375;2012175;13
FR;1;2021-03-11;104128;53848;0;3438503;2066023;13
FR;1;2021-03-12;103254;45286;1;3541757;2111309;14
FR;1;2021-03-13;88483;12742;0;3630240;2124051;14
FR;1;2021-03-14;44100;3028;0;3674340;2127079;14
FR;1;2021-03-15;94674;29116;0;3769014;2156195;14
FR;1;2021-03-16;122866;34888;1;3891880;2191083;15
FR;1;2021-03-17;128622;34823;2;4020502;2225906;17
FR;1;2021-03-18;142069;39706;1;4162571;2265612;18
FR;1;2021-03-19;135492;32897;0;4298063;2298509;18
FR;1;2021-03-20;75537;10206;0;4373600;2308715;18
FR;1;2021-03-21;26149;2475;0;4399749;2311190;18
FR;1;2021-03-22;113960;31171;2;4513709;2342361;20
FR;1;2021-03-23;142150;38168;0;4655859;2380529;20
FR;1;2021-03-24;141089;38769;0;4796948;2419298;20
FR;1;2021-03-25;164148;39617;1;4961096;2458915;21
FR;1;2021-03-26;165646;37485;1;5126742;2496400;22
FR;1;2021-03-27;110424;15253;0;5237166;2511653;22
FR;1;2021-03-28;42022;3620;2;5279188;2515273;24
FR;1;2021-03-29;129242;49949;1;5408430;2565222;25
FR;1;2021-03-30;166830;63576;3;5575260;2628798;28
FR;1;2021-03-31;170027;66896;2;5745287;2695694;30
FR;1;2021-04-01;193001;79236;4;5938288;2774930;34
FR;1;2021-04-02;163530;84309;5;6101818;2859239;39
FR;1;2021-04-03;87625;58165;2;6189443;2917404;41
FR;1;2021-04-04;32658;17731;0;6222101;2935135;41
FR;1;2021-04-05;43004;10174;3;6265105;2945309;44
FR;1;2021-04-06;159117;100864;6;6424222;3046173;50
FR;1;2021-04-07;195543;108243;5;6619765;3154416;55
FR;1;2021-04-08;220416;112374;5;6840181;3266790;60
FR;1;2021-04-09;213130;107495;6;7053311;3374285;66
FR;1;2021-04-10;116473;73454;1;7169784;3447739;67
FR;1;2021-04-11;40411;30281;2;7210195;3478020;69
FR;1;2021-04-12;167362;103777;21;7377557;3581797;90
FR;1;2021-04-13;202437;128237;47;7579994;3710034;137
FR;1;2021-04-14;206794;122798;97;7786788;3832832;234
FR;1;2021-04-15;219611;126752;128;8006399;3959584;362
FR;1;2021-04-16;204923;125135;154;8211322;4084719;516
FR;1;2021-04-17;121444;67478;38;8332766;4152197;554
FR;1;2021-04-18;35534;20992;15;8368300;4173189;569
FR;1;2021-04-19;162671;121901;283;8530971;4295090;852
FR;1;2021-04-20;187995;148764;291;8718966;4443854;1143
FR;1;2021-04-21;192612;146702;445;8911578;4590556;1588
FR;1;2021-04-22;207625;162623;464;9119203;4753179;2052
FR;1;2021-04-23;197780;156921;403;9316983;4910100;2455
FR;1;2021-04-24;125538;95502;61;9442521;5005602;2516
FR;1;2021-04-25;53165;30128;19;9495686;5035730;2535
FR;1;2021-04-26;180151;138263;300;9675837;5173993;2835
FR;1;2021-04-27;220031;161963;507;9895868;5335956;3342
FR;1;2021-04-28;237002;155096;908;10132870;5491052;4250
FR;1;2021-04-29;268703;160048;793;10401573;5651100;5043
FR;1;2021-04-30;270409;148136;596;10671982;5799236;5639
FR;1;2021-05-01;138952;40705;94;10810934;5839941;5733
FR;1;2021-05-02;80802;28150;46;10891736;5868091;5779
FR;1;2021-05-03;248264;146449;479;11140000;6014540;6258
FR;1;2021-05-04;263454;186827;698;11403454;6201367;6956
FR;1;2021-05-05;280508;184554;690;11683962;6385921;7646
FR;1;2021-05-06;307040;183013;910;11991002;6568934;8556
FR;1;2021-05-07;281990;195711;625;12272992;6764645;9181
FR;1;2021-05-08;190593;48332;125;12463585;6812977;9306
FR;1;2021-05-09;113469;36212;79;12577054;6849189;9385
FR;1;2021-05-10;254419;194244;659;12831473;7043433;10044
FR;1;2021-05-11;316455;211381;827;13147928;7254814;10871
FR;1;2021-05-12;353545;185888;710;13501473;7440702;11581
FR;1;2021-05-13;281043;47644;209;13782516;7488346;11790
FR;1;2021-05-14;367621;128842;555;14150137;7617188;12345
FR;1;2021-05-15;295294;66142;177;14445431;7683330;12522
FR;1;2021-05-16;156819;15578;69;14602250;7698908;12591
FR;1;2021-05-17;316698;116680;812;14918948;7815588;13403
FR;1;2021-05-18;379870;111313;1026;15298818;7926901;14429
FR;1;2021-05-19;392757;102905;1261;15691575;8029806;15690
FR;1;2021-05-20;418811;96306;1160;16110386;8126112;16850
FR;1;2021-05-21;397264;97369;957;16507650;8223481;17807
FR;1;2021-05-22;274210;42080;321;16781860;8265561;18128
FR;1;2021-05-23;122386;11208;125;16904246;8276769;18253
FR;1;2021-05-24;242717;26303;313;17146963;8303072;18566
FR;1;2021-05-25;363752;131927;1188;17510715;8434999;19754
FR;1;2021-05-26;378543;125687;1163;17889258;8560686;20917
FR;1;2021-05-27;403822;128214;1204;18293080;8688900;22121
FR;1;2021-05-28;363948;145538;947;18657028;8834438;23068
FR;1;2021-05-29;252844;80974;288;18909872;8915412;23356
FR;1;2021-05-30;100299;22568;84;19010171;8937980;23440
FR;1;2021-05-31;312574;148808;752;19322745;9086788;24192
FR;1;2021-06-01;353862;166784;989;19676607;9253572;25181
FR;1;2021-06-02;358339;153250;1035;20034946;9406822;26216
FR;1;2021-06-03;384710;147755;881;20419656;9554577;27097
FR;1;2021-06-04;359991;175667;845;20779647;9730244;27942
FR;1;2021-06-05;256478;112794;343;21036125;9843038;28285
FR;1;2021-06-06;125262;37534;124;21161387;9880572;28409
FR;1;2021-06-07;296258;208207;782;21457645;10088779;29191
FR;1;2021-06-08;327431;221087;889;21785076;10309866;30080
FR;1;2021-06-09;332736;212682;957;22117812;10522548;31037
FR;1;2021-06-10;338543;202291;988;22456355;10724839;32025
FR;1;2021-06-11;309456;235543;686;22765811;10960382;32711
FR;1;2021-06-12;242382;150856;227;23008193;11111238;32938
FR;1;2021-06-13;99530;61083;103;23107723;11172321;33041
FR;1;2021-06-14;205498;289171;749;23313221;11461492;33790
FR;1;2021-06-15;253734;282554;777;23566955;11744046;34567
FR;1;2021-06-16;270706;270590;752;23837661;12014636;35319
FR;1;2021-06-17;265423;244527;668;24103084;12259163;35987
FR;1;2021-06-18;258371;296141;612;24361455;12555304;36599
FR;1;2021-06-19;192384;209699;214;24553839;12765003;36813
FR;1;2021-06-20;68902;89193;57;24622741;12854196;36870
FR;1;2021-06-21;170273;320156;530;24793014;13174352;37400
FR;1;2021-06-22;183761;347840;622;24976775;13522192;38022
FR;1;2021-06-23;201806;339560;620;25178581;13861752;38642
FR;1;2021-06-24;201350;281906;653;25379931;14143658;39295
FR;1;2021-06-25;179990;372046;683;25559921;14515704;39978
FR;1;2021-06-26;130387;278505;260;25690308;14794209;40238
FR;1;2021-06-27;51860;123054;78;25742168;14917263;40316
FR;1;2021-06-28;135059;368545;641;25877227;15285808;40957
FR;1;2021-06-29;153436;389708;1694;26030663;15675516;42651
FR;1;2021-06-30;178222;378456;1550;26208885;16053972;44201
FR;1;2021-07-01;194947;332306;1807;26403832;16386278;46008
FR;1;2021-07-02;189390;367924;1691;26593222;16754202;47699
FR;1;2021-07-03;122793;280666;684;26716015;17034868;48383
FR;1;2021-07-04;53258;113778;241;26769273;17148646;48624
FR;1;2021-07-05;150406;356352;1426;26919679;17504998;50050
FR;1;2021-07-06;170844;382857;1520;27090523;17887855;51570
FR;1;2021-07-07;187090;362881;1531;27277613;18250736;53101
FR;1;2021-07-08;198749;323227;1751;27476362;18573963;54852
FR;1;2021-07-09;187979;386845;1774;27664341;18960808;56626
FR;1;2021-07-10;128465;281098;780;27792806;19241906;57406
FR;1;2021-07-11;57049;102513;247;27849855;19344419;57653
FR;1;2021-07-12;147396;417148;1539;27997251;19761567;59192
FR;1;2021-07-13;232003;439838;1732;28229254;20201405;60924
FR;1;2021-07-14;170041;151678;402;28399295;20353083;61326
FR;1;2021-07-15;276698;424890;1780;28675993;20777973;63106
FR;1;2021-07-16;288115;401519;1641;28964108;21179492;64747
FR;1;2021-07-17;216161;282378;712;29180269;21461870;65459
FR;1;2021-07-18;101422;107478;282;29281691;21569348;65741
FR;1;2021-07-19;236565;379577;1448;29518256;21948925;67189
FR;1;2021-07-20;303686;381407;1408;29821942;22330332;68597
FR;1;2021-07-21;331234;353917;1357;30153176;22684249;69954
FR;1;2021-07-22;362415;319633;1447;30515591;23003882;71401
FR;1;2021-07-23;345913;343277;1501;30861504;23347159;72902
FR;1;2021-07-24;238397;241437;664;31099901;23588596;73566
FR;1;2021-07-25;112251;76171;209;31212152;23664767;73775
FR;1;2021-07-26;297998;290535;1452;31510150;23955302;75227
FR;1;2021-07-27;384022;269070;1408;31894172;24224372;76635
FR;1;2021-07-28;388418;251641;1425;32282590;24476013;78060
FR;1;2021-07-29;403990;228051;1496;32686580;24704064;79556
FR;1;2021-07-30;367590;246789;1590;33054170;24950853;81146
FR;1;2021-07-31;242807;165035;770;33296977;25115888;81916
FR;1;2021-08-01;103224;47263;202;33400201;25163151;82118
FR;1;2021-08-02;285015;212858;1423;33685216;25376009;83541
FR;1;2021-08-03;324911;209354;1458;34010127;25585363;84999
FR;1;2021-08-04;323410;184470;1322;34333537;25769833;86321
FR;1;2021-08-05;297903;193321;1401;34631440;25963154;87722
FR;1;2021-08-06;287039;224736;1493;34918479;26187890;89215
FR;1;2021-08-07;181094;159065;625;35099573;26346955;89840
FR;1;2021-08-08;67483;59217;210;35167056;26406172;90050
FR;1;2021-08-09;219519;236383;1374;35386575;26642555;91424
FR;1;2021-08-10;248195;241190;1409;35634770;26883745;92833
FR;1;2021-08-11;232156;232878;1145;35866926;27116623;93978
FR;1;2021-08-12;216996;239967;1410;36083922;27356590;95388
FR;1;2021-08-13;198040;236900;1305;36281962;27593490;96693
FR;1;2021-08-14;119846;174787;604;36401808;27768277;97297
FR;1;2021-08-15;33523;46236;157;36435331;27814513;97454
FR;1;2021-08-16;151499;290121;1333;36586830;28104634;98787
FR;1;2021-08-17;168028;291970;1337;36754858;28396604;100124
FR;1;2021-08-18;158101;287037;1304;36912959;28683641;101428
FR;1;2021-08-19;145771;277408;1315;37058730;28961049;102743
FR;1;2021-08-20;135198;307901;1408;37193928;29268950;104151
FR;1;2021-08-21;82380;213210;540;37276308;29482160;104691
FR;1;2021-08-22;27842;82742;186;37304150;29564902;104877
FR;1;2021-08-23;115256;321005;1341;37419406;29885907;106218
FR;1;2021-08-24;123736;319925;1513;37543142;30205832;107731
FR;1;2021-08-25;118258;306365;1671;37661400;30512197;109402
FR;1;2021-08-26;103898;285549;2042;37765298;30797746;111444
FR;1;2021-08-27;104375;320788;2205;37869673;31118534;113649
FR;1;2021-08-28;69488;220796;1039;37939161;31339330;114688
FR;1;2021-08-29;23576;77980;415;37962737;31417310;115103
FR;1;2021-08-30;94145;286281;4154;38056882;31703591;119257
FR;1;2021-08-31;95617;276429;8863;38152499;31980020;128120
FR;1;2021-09-01;91831;244759;19763;38244330;32224779;147883
FR;1;2021-09-02;73116;198052;22873;38317446;32422831;170756
FR;1;2021-09-03;76105;227549;24899;38393551;32650380;195655
FR;1;2021-09-04;68334;189706;10529;38461885;32840086;206184
FR;1;2021-09-05;17913;41223;3895;38479798;32881309;210079
FR;1;2021-09-06;52429;151862;28230;38532227;33033171;238309
FR;1;2021-09-07;49870;139692;27630;38582097;33172863;265939
FR;1;2021-09-08;64407;173885;24597;38646504;33346748;290536
FR;1;2021-09-09;47278;124185;25014;38693782;33470933;315550
FR;2;2020-12-27;0;0;0;0;0;0
FR;2;2020-12-28;0;0;0;0;0;0
FR;2;2020-12-29;0;0;0;0;0;0
FR;2;2020-12-30;0;0;0;0;0;0
FR;2;2020-12-31;0;0;0;0;0;0
FR;2;2021-01-01;0;0;0;0;0;0
FR;2;2021-01-02;0;0;0;0;0;0
FR;2;2021-01-03;0;0;0;0;0;0
FR;2;2021-01-04;0;0;0;0;0;0
FR;2;2021-01-05;0;0;0;0;0;0
FR;2;2021-01-06;0;0;0;0;0;0
FR;2;2021-01-07;0;0;0;0;0;0
FR;2;2021-01-08;0;0;0;0;0;0
FR;2;2021-01-09;0;0;0;0;0;0
FR;2;2021-01-10;0;0;0;0;0;0
FR;2;2021-01-11;0;0;0;0;0;0
FR;2;2021-01-12;0;0;0;0;0;0
FR;2;2021-01-13;0;0;0;0;0;0
FR;2;2021-01-14;940;0;0;940;0;0
FR;2;2021-01-15;300;0;0;1240;0;0
FR;2;2021-01-16;246;0;0;1486;0;0
FR;2;2021-01-17;38;0;0;1524;0;0
FR;2;2021-01-18;3000;0;0;4524;0;0
FR;2;2021-01-19;4605;0;0;9129;0;0
FR;2;2021-01-20;5035;0;0;14164;0;0
FR;2;2021-01-21;5225;0;0;19389;0;0
FR;2;2021-01-22;5023;0;0;24412;0;0
FR;2;2021-01-23;1805;0;0;26217;0;0
FR;2;2021-01-24;130;0;0;26347;0;0
FR;2;2021-01-25;3731;0;0;30078;0;0
FR;2;2021-01-26;3816;0;0;33894;0;0
FR;2;2021-01-27;3504;0;0;37398;0;0
FR;2;2021-01-28;3615;0;0;41013;0;0
FR;2;2021-01-29;3176;0;0;44189;0;0
FR;2;2021-01-30;1096;0;0;45285;0;0
FR;2;2021-01-31;18;0;0;45303;0;0
FR;2;2021-02-01;3315;0;0;48618;0;0
FR;2;2021-02-02;4378;0;0;52996;0;0
FR;2;2021-02-03;5114;0;0;58110;0;0
FR;2;2021-02-04;4808;3;0;62918;3;0
FR;2;2021-02-05;4701;6;0;67619;9;0
FR;2;2021-02-06;1980;3;0;69599;12;0
FR;2;2021-02-07;69;0;0;69668;12;0
FR;2;2021-02-08;7476;8;0;77144;20;0
FR;2;2021-02-09;8320;15;0;85464;35;0
FR;2;2021-02-10;9222;50;0;94686;85;0
FR;2;2021-02-11;10146;66;0;104832;151;0
FR;2;2021-02-12;9913;238;0;114745;389;0
FR;2;2021-02-13;3062;221;0;117807;610;0
FR;2;2021-02-14;322;0;0;118129;610;0
FR;2;2021-02-15;3394;3064;0;121523;3674;0
FR;2;2021-02-16;4998;3877;0;126521;7551;0
FR;2;2021-02-17;4175;4402;0;130696;11953;0
FR;2;2021-02-18;5306;5089;0;136002;17042;0
FR;2;2021-02-19;5254;4323;0;141256;21365;0
FR;2;2021-02-20;1804;1508;0;143060;22873;0
FR;2;2021-02-21;215;86;0;143275;22959;0
FR;2;2021-02-22;3559;3722;0;146834;26681;0
FR;2;2021-02-23;4871;3693;0;151705;30374;0
FR;2;2021-02-24;4901;3467;0;156606;33841;0
FR;2;2021-02-25;5377;3425;0;161983;37266;0
FR;2;2021-02-26;4284;3124;0;166267;40390;0
FR;2;2021-02-27;1564;1042;0;167831;41432;0
FR;2;2021-02-28;136;28;0;167967;41460;0
FR;2;2021-03-01;5043;3764;0;173010;45224;0
FR;2;2021-03-02;6400;4727;0;179410;49951;0
FR;2;2021-03-03;6404;4882;0;185814;54833;0
FR;2;2021-03-04;8240;3964;0;194054;58797;0
FR;2;2021-03-05;7890;4057;0;201944;62854;0
FR;2;2021-03-06;4698;1683;0;206642;64537;0
FR;2;2021-03-07;2337;29;0;208979;64566;0
FR;2;2021-03-08;4061;8310;0;213040;72876;0
FR;2;2021-03-09;7371;8429;0;220411;81305;0
FR;2;2021-03-10;6962;9107;0;227373;90412;0
FR;2;2021-03-11;9236;9207;0;236609;99619;0
FR;2;2021-03-12;7832;8161;0;244441;107780;0
FR;2;2021-03-13;9960;2510;0;254401;110290;0
FR;2;2021-03-14;4803;402;0;259204;110692;0
FR;2;2021-03-15;10764;3483;0;269968;114175;0
FR;2;2021-03-16;16622;4621;0;286590;118796;0
FR;2;2021-03-17;20070;3952;0;306660;122748;0
FR;2;2021-03-18;23168;4907;0;329828;127655;0
FR;2;2021-03-19;23116;4537;0;352944;132192;0
FR;2;2021-03-20;25312;1539;0;378256;133731;0
FR;2;2021-03-21;17584;147;0;395840;133878;0
FR;2;2021-03-22;17607;3079;0;413447;136957;0
FR;2;2021-03-23;22480;4183;0;435927;141140;0
FR;2;2021-03-24;23749;4985;0;459676;146125;0
FR;2;2021-03-25;26529;5018;0;486205;151143;0
FR;2;2021-03-26;26783;4262;0;512988;155405;0
FR;2;2021-03-27;15806;1308;0;528794;156713;0
FR;2;2021-03-28;10504;92;0;539298;156805;0
FR;2;2021-03-29;18829;4278;0;558127;161083;0
FR;2;2021-03-30;24350;6018;0;582477;167101;0
FR;2;2021-03-31;28365;5953;0;610842;173054;0
FR;2;2021-04-01;34278;8479;0;645120;181533;0
FR;2;2021-04-02;29779;7685;0;674899;189218;0
FR;2;2021-04-03;16845;3580;0;691744;192798;0
FR;2;2021-04-04;9237;918;1;700981;193716;1
FR;2;2021-04-05;12273;807;0;713254;194523;1
FR;2;2021-04-06;26951;6926;0;740205;201449;1
FR;2;2021-04-07;30739;7156;0;770944;208605;1
FR;2;2021-04-08;36685;8818;0;807629;217423;1
FR;2;2021-04-09;33633;8592;27;841262;226015;28
FR;2;2021-04-10;19558;8969;0;860820;234984;28
FR;2;2021-04-11;7859;4271;0;868679;239255;28
FR;2;2021-04-12;16962;11251;0;885641;250506;28
FR;2;2021-04-13;19285;16423;1;904926;266929;29
FR;2;2021-04-14;17841;16279;2;922767;283208;31
FR;2;2021-04-15;22005;20755;24;944772;303963;55
FR;2;2021-04-16;20542;20075;38;965314;324038;93
FR;2;2021-04-17;13145;22460;3;978459;346498;96
FR;2;2021-04-18;5839;14403;2;984298;360901;98
FR;2;2021-04-19;16614;16254;17;1000912;377155;115
FR;2;2021-04-20;19092;21577;23;1020004;398732;138
FR;2;2021-04-21;20036;21665;44;1040040;420397;182
FR;2;2021-04-22;23575;24853;16;1063615;445250;198
FR;2;2021-04-23;24332;25349;62;1087947;470599;260
FR;2;2021-04-24;25159;15103;15;1113106;485702;275
FR;2;2021-04-25;9536;8588;4;1122642;494290;279
FR;2;2021-04-26;17002;17198;14;1139644;511488;293
FR;2;2021-04-27;19109;24299;32;1158753;535787;325
FR;2;2021-04-28;22177;26180;96;1180930;561967;421
FR;2;2021-04-29;25293;30130;52;1206223;592097;473
FR;2;2021-04-30;25394;27774;31;1231617;619871;504
FR;2;2021-05-01;14869;9858;2;1246486;629729;506
FR;2;2021-05-02;6566;9183;1;1253052;638912;507
FR;2;2021-05-03;19830;19315;15;1272882;658227;522
FR;2;2021-05-04;18122;29054;12;1291004;687281;534
FR;2;2021-05-05;18099;29407;24;1309103;716688;558
FR;2;2021-05-06;23320;35286;88;1332423;751974;646
FR;2;2021-05-07;25055;33223;64;1357478;785197;710
FR;2;2021-05-08;21148;9701;5;1378626;794898;715
FR;2;2021-05-09;13074;7893;2;1391700;802791;717
FR;2;2021-05-10;32639;22215;20;1424339;825006;737
FR;2;2021-05-11;43329;21071;40;1467668;846077;777
FR;2;2021-05-12;49681;19896;68;1517349;865973;845
FR;2;2021-05-13;50987;5766;10;1568336;871739;855
FR;2;2021-05-14;61002;12952;28;1629338;884691;883
FR;2;2021-05-15;65614;7148;10;1694952;891839;893
FR;2;2021-05-16;43336;2575;4;1738288;894414;897
FR;2;2021-05-17;44445;12584;50;1782733;906998;947
FR;2;2021-05-18;54297;12244;69;1837030;919242;1016
FR;2;2021-05-19;56828;10611;120;1893858;929853;1136
FR;2;2021-05-20;63041;10875;136;1956899;940728;1272
FR;2;2021-05-21;63933;11663;109;2020832;952391;1381
FR;2;2021-05-22;61230;4513;29;2082062;956904;1410
FR;2;2021-05-23;37326;570;8;2119388;957474;1418
FR;2;2021-05-24;17017;2030;19;2136405;959504;1437
FR;2;2021-05-25;20816;12237;142;2157221;971741;1579
FR;2;2021-05-26;19593;11456;140;2176814;983197;1719
FR;2;2021-05-27;22683;12663;116;2199497;995860;1835
FR;2;2021-05-28;29115;14977;122;2228612;1010837;1957
FR;2;2021-05-29;30232;8181;33;2258844;1019018;1990
FR;2;2021-05-30;4562;1812;2;2263406;1020830;1992
FR;2;2021-05-31;28377;18747;114;2291783;1039577;2106
FR;2;2021-06-01;45309;20068;143;2337092;1059645;2249
FR;2;2021-06-02;37187;19308;95;2374279;1078953;2344
FR;2;2021-06-03;50958;23384;89;2425237;1102337;2433
FR;2;2021-06-04;65239;24097;117;2490476;1126434;2550
FR;2;2021-06-05;34306;24041;20;2524782;1150475;2570
FR;2;2021-06-06;4838;6203;4;2529620;1156678;2574
FR;2;2021-06-07;27921;23097;86;2557541;1179775;2660
FR;2;2021-06-08;46098;22958;88;2603639;1202733;2748
FR;2;2021-06-09;34061;20911;50;2637700;1223644;2798
FR;2;2021-06-10;42399;19153;33;2680099;1242797;2831
FR;2;2021-06-11;55088;25248;66;2735187;1268045;2897
FR;2;2021-06-12;30414;19814;27;2765601;1287859;2924
FR;2;2021-06-13;3240;9189;3;2768841;1297048;2927
FR;2;2021-06-14;25105;24187;48;2793946;1321235;2975
FR;2;2021-06-15;38786;22890;62;2832732;1344125;3037
FR;2;2021-06-16;29977;21485;86;2862709;1365610;3123
FR;2;2021-06-17;36687;25901;74;2899396;1391511;3197
FR;2;2021-06-18;46688;28801;60;2946084;1420312;3257
FR;2;2021-06-19;24422;24918;20;2970506;1445230;3277
FR;2;2021-06-20;2711;10071;5;2973217;1455301;3282
FR;2;2021-06-21;17324;42776;50;2990541;1498077;3332
FR;2;2021-06-22;28187;49617;68;3018728;1547694;3400
FR;2;2021-06-23;21647;49620;64;3040375;1597314;3464
FR;2;2021-06-24;28250;50311;83;3068625;1647625;3547
FR;2;2021-06-25;33249;60435;83;3101874;1708060;3630
FR;2;2021-06-26;16265;59292;28;3118139;1767352;3658
FR;2;2021-06-27;2514;29357;11;3120653;1796709;3669
FR;2;2021-06-28;12500;54385;38;3133153;1851094;3707
FR;2;2021-06-29;19758;59909;174;3152911;1911003;3881
FR;2;2021-06-30;16212;57788;215;3169123;1968791;4096
FR;2;2021-07-01;20255;59920;211;3189378;2028711;4307
FR;2;2021-07-02;23937;62225;180;3213315;2090936;4487
FR;2;2021-07-03;11990;57110;155;3225305;2148046;4642
FR;2;2021-07-04;1902;23335;20;3227207;2171381;4662
FR;2;2021-07-05;8979;29372;101;3236186;2200753;4763
FR;2;2021-07-06;14383;36212;129;3250569;2236965;4892
FR;2;2021-07-07;14108;33693;135;3264677;2270658;5027
FR;2;2021-07-08;19492;40304;159;3284169;2310962;5186
FR;2;2021-07-09;26911;54289;193;3311080;2365251;5379
FR;2;2021-07-10;13249;33684;108;3324329;2398935;5487
FR;2;2021-07-11;1639;4329;12;3325968;2403264;5499
FR;2;2021-07-12;12788;37289;110;3338756;2440553;5609
FR;2;2021-07-13;36950;53292;151;3375706;2493845;5760
FR;2;2021-07-14;6402;3579;14;3382108;2497424;5774
FR;2;2021-07-15;46988;47066;152;3429096;2544490;5926
FR;2;2021-07-16;64082;55887;172;3493178;2600377;6098
FR;2;2021-07-17;31437;23964;95;3524615;2624341;6193
FR;2;2021-07-18;5987;4946;18;3530602;2629287;6211
FR;2;2021-07-19;32801;28743;89;3563403;2658030;6300
FR;2;2021-07-20;51779;44606;143;3615182;2702636;6443
FR;2;2021-07-21;45026;34842;90;3660208;2737478;6533
FR;2;2021-07-22;56026;41117;123;3716234;2778595;6656
FR;2;2021-07-23;68094;49149;168;3784328;2827744;6824
FR;2;2021-07-24;36009;21563;79;3820337;2849307;6903
FR;2;2021-07-25;6641;2678;10;3826978;2851985;6913
FR;2;2021-07-26;36117;22523;88;3863095;2874508;7001
FR;2;2021-07-27;62127;34671;178;3925222;2909179;7179
FR;2;2021-07-28;55061;26497;129;3980283;2935676;7308
FR;2;2021-07-29;68103;32802;180;4048386;2968478;7488
FR;2;2021-07-30;74064;37795;212;4122450;3006273;7700
FR;2;2021-07-31;34510;16167;94;4156960;3022440;7794
FR;2;2021-08-01;5218;2308;13;4162178;3024748;7807
FR;2;2021-08-02;35314;16197;95;4197492;3040945;7902
FR;2;2021-08-03;55521;28261;133;4253013;3069206;8035
FR;2;2021-08-04;46219;20861;127;4299232;3090067;8162
FR;2;2021-08-05;54212;31599;207;4353444;3121666;8369
FR;2;2021-08-06;57671;42375;231;4411115;3164041;8600
FR;2;2021-08-07;24884;17596;90;4435999;3181637;8690
FR;2;2021-08-08;3733;3668;18;4439732;3185305;8708
FR;2;2021-08-09;28995;21155;82;4468727;3206460;8790
FR;2;2021-08-10;44573;33547;143;4513300;3240007;8933
FR;2;2021-08-11;34949;25151;133;4548249;3265158;9066
FR;2;2021-08-12;41498;35748;154;4589747;3300906;9220
FR;2;2021-08-13;42130;36304;202;4631877;3337210;9422
FR;2;2021-08-14;18217;22644;88;4650094;3359854;9510
FR;2;2021-08-15;2823;3846;11;4652917;3363700;9521
FR;2;2021-08-16;24634;27384;91;4677551;3391084;9612
FR;2;2021-08-17;37818;43540;185;4715369;3434624;9797
FR;2;2021-08-18;31855;36412;174;4747224;3471036;9971
FR;2;2021-08-19;37004;46593;210;4784228;3517629;10181
FR;2;2021-08-20;39811;55502;243;4824039;3573131;10424
FR;2;2021-08-21;17746;24265;100;4841785;3597396;10524
FR;2;2021-08-22;2806;4315;18;4844591;3601711;10542
FR;2;2021-08-23;18789;35137;113;4863380;3636848;10655
FR;2;2021-08-24;31470;56054;213;4894850;3692902;10868
FR;2;2021-08-25;25545;43426;220;4920395;3736328;11088
FR;2;2021-08-26;31826;55665;359;4952221;3791993;11447
FR;2;2021-08-27;36386;65431;433;4988607;3857424;11880
FR;2;2021-08-28;17392;28365;276;5005999;3885789;12156
FR;2;2021-08-29;2572;5099;43;5008571;3890888;12199
FR;2;2021-08-30;17968;37801;340;5026539;3928689;12539
FR;2;2021-08-31;27623;57497;817;5054162;3986186;13356
FR;2;2021-09-01;20820;39838;1201;5074982;4026024;14557
FR;2;2021-09-02;24732;48585;1805;5099714;4074609;16362
FR;2;2021-09-03;32522;64359;2762;5132236;4138968;19124
FR;2;2021-09-04;16145;27552;1340;5148381;4166520;20464
FR;2;2021-09-05;2117;3733;217;5150498;4170253;20681
FR;2;2021-09-06;13517;28821;1476;5164015;4199074;22157
FR;2;2021-09-07;20484;41026;2668;5184499;4240100;24825
FR;2;2021-09-08;16408;31939;2528;5200907;4272039;27353
FR;2;2021-09-09;19890;40409;3892;5220797;4312448;31245
FR;3;2020-12-27;0;0;0;0;0;0
FR;3;2020-12-28;0;0;0;0;0;0
FR;3;2020-12-29;0;0;0;0;0;0
FR;3;2020-12-30;0;0;0;0;0;0
FR;3;2020-12-31;0;0;0;0;0;0
FR;3;2021-01-01;0;0;0;0;0;0
FR;3;2021-01-02;0;0;0;0;0;0
FR;3;2021-01-03;0;0;0;0;0;0
FR;3;2021-01-04;0;0;0;0;0;0
FR;3;2021-01-05;0;0;0;0;0;0
FR;3;2021-01-06;0;0;0;0;0;0
FR;3;2021-01-07;0;0;0;0;0;0
FR;3;2021-01-08;0;0;0;0;0;0
FR;3;2021-01-09;0;0;0;0;0;0
FR;3;2021-01-10;0;0;0;0;0;0
FR;3;2021-01-11;0;0;0;0;0;0
FR;3;2021-01-12;0;0;0;0;0;0
FR;3;2021-01-13;0;0;0;0;0;0
FR;3;2021-01-14;0;0;0;0;0;0
FR;3;2021-01-15;0;0;0;0;0;0
FR;3;2021-01-16;0;0;0;0;0;0
FR;3;2021-01-17;0;0;0;0;0;0
FR;3;2021-01-18;0;0;0;0;0;0
FR;3;2021-01-19;0;0;0;0;0;0
FR;3;2021-01-20;0;0;0;0;0;0
FR;3;2021-01-21;0;0;0;0;0;0
FR;3;2021-01-22;0;0;0;0;0;0
FR;3;2021-01-23;0;0;0;0;0;0
FR;3;2021-01-24;0;0;0;0;0;0
FR;3;2021-01-25;0;0;0;0;0;0
FR;3;2021-01-26;0;0;0;0;0;0
FR;3;2021-01-27;0;0;0;0;0;0
FR;3;2021-01-28;0;0;0;0;0;0
FR;3;2021-01-29;0;0;0;0;0;0
FR;3;2021-01-30;0;0;0;0;0;0
FR;3;2021-01-31;0;0;0;0;0;0
FR;3;2021-02-01;0;0;0;0;0;0
FR;3;2021-02-02;0;0;0;0;0;0
FR;3;2021-02-03;0;0;0;0;0;0
FR;3;2021-02-04;0;0;0;0;0;0
FR;3;2021-02-05;0;0;0;0;0;0
FR;3;2021-02-06;800;0;0;800;0;0
FR;3;2021-02-07;1375;0;0;2175;0;0
FR;3;2021-02-08;2694;0;0;4869;0;0
FR;3;2021-02-09;6699;0;0;11568;0;0
FR;3;2021-02-10;9449;0;0;21017;0;0
FR;3;2021-02-11;13471;0;0;34488;0;0
FR;3;2021-02-12;13187;0;0;47675;0;0
FR;3;2021-02-13;3586;0;0;51261;0;0
FR;3;2021-02-14;904;0;0;52165;0;0
FR;3;2021-02-15;10264;0;0;62429;0;0
FR;3;2021-02-16;12331;0;0;74760;0;0
FR;3;2021-02-17;10960;0;0;85720;0;0
FR;3;2021-02-18;14731;0;0;100451;0;0
FR;3;2021-02-19;14215;0;0;114666;0;0
FR;3;2021-02-20;3226;0;0;117892;0;0
FR;3;2021-02-21;575;0;0;118467;0;0
FR;3;2021-02-22;9032;0;0;127499;0;0
FR;3;2021-02-23;11228;0;0;138727;0;0
FR;3;2021-02-24;14091;0;0;152818;0;0
FR;3;2021-02-25;44720;0;0;197538;0;0
FR;3;2021-02-26;61696;0;0;259234;0;0
FR;3;2021-02-27;34657;6;0;293891;6;0
FR;3;2021-02-28;2394;0;0;296285;6;0
FR;3;2021-03-01;20193;9;0;316478;15;0
FR;3;2021-03-02;38615;12;0;355093;27;0
FR;3;2021-03-03;48411;14;0;403504;41;0
FR;3;2021-03-04;81908;18;0;485412;59;0
FR;3;2021-03-05;117775;41;0;603187;100;0
FR;3;2021-03-06;120321;47;1;723508;147;1
FR;3;2021-03-07;54981;27;0;778489;174;1
FR;3;2021-03-08;42543;20;0;821032;194;1
FR;3;2021-03-09;78676;30;0;899708;224;1
FR;3;2021-03-10;80544;36;0;980252;260;1
FR;3;2021-03-11;128050;46;0;1108302;306;1
FR;3;2021-03-12;182312;67;0;1290614;373;1
FR;3;2021-03-13;131846;50;0;1422460;423;1
FR;3;2021-03-14;13936;4;0;1436396;427;1
FR;3;2021-03-15;51926;34;0;1488322;461;1
FR;3;2021-03-16;1039;13;0;1489361;474;1
FR;3;2021-03-17;787;6;0;1490148;480;1
FR;3;2021-03-18;1376;4;0;1491524;484;1
FR;3;2021-03-19;70179;36;0;1561703;520;1
FR;3;2021-03-20;65021;35;0;1626724;555;1
FR;3;2021-03-21;5625;4;0;1632349;559;1
FR;3;2021-03-22;37230;30;0;1669579;589;1
FR;3;2021-03-23;84316;49;0;1753895;638;1
FR;3;2021-03-24;90649;88;0;1844544;726;1
FR;3;2021-03-25;149718;114;0;1994262;840;1
FR;3;2021-03-26;165070;152;0;2159332;992;1
FR;3;2021-03-27;68220;88;0;2227552;1080;1
FR;3;2021-03-28;6355;19;0;2233907;1099;1
FR;3;2021-03-29;53912;59;0;2287819;1158;1
FR;3;2021-03-30;92883;87;0;2380702;1245;1
FR;3;2021-03-31;63255;81;0;2443957;1326;1
FR;3;2021-04-01;85820;99;0;2529777;1425;1
FR;3;2021-04-02;86672;143;0;2616449;1568;1
FR;3;2021-04-03;35701;108;0;2652150;1676;1
FR;3;2021-04-04;3470;15;0;2655620;1691;1
FR;3;2021-04-05;4357;21;0;2659977;1712;1
FR;3;2021-04-06;29466;72;0;2689443;1784;1
FR;3;2021-04-07;32059;59;0;2721502;1843;1
FR;3;2021-04-08;78547;232;0;2800049;2075;1
FR;3;2021-04-09;161447;405;0;2961496;2480;1
FR;3;2021-04-10;75518;328;0;3037014;2808;1
FR;3;2021-04-11;7207;42;0;3044221;2850;1
FR;3;2021-04-12;51211;195;0;3095432;3045;1
FR;3;2021-04-13;85941;309;0;3181373;3354;1
FR;3;2021-04-14;67502;337;0;3248875;3691;1
FR;3;2021-04-15;92823;363;0;3341698;4054;1
FR;3;2021-04-16;112222;567;0;3453920;4621;1
FR;3;2021-04-17;53113;320;1;3507033;4941;2
FR;3;2021-04-18;9607;32;0;3516640;4973;2
FR;3;2021-04-19;24859;228;0;3541499;5201;2
FR;3;2021-04-20;45368;389;0;3586867;5590;2
FR;3;2021-04-21;38669;442;0;3625536;6032;2
FR;3;2021-04-22;54451;780;0;3679987;6812;2
FR;3;2021-04-23;70251;1009;0;3750238;7821;2
FR;3;2021-04-24;37064;969;0;3787302;8790;2
FR;3;2021-04-25;6066;152;0;3793368;8942;2
FR;3;2021-04-26;19511;648;0;3812879;9590;2
FR;3;2021-04-27;34200;1240;0;3847079;10830;2
FR;3;2021-04-28;28739;1926;0;3875818;12756;2
FR;3;2021-04-29;45144;5946;0;3920962;18702;2
FR;3;2021-04-30;55269;8921;0;3976231;27623;2
FR;3;2021-05-01;9366;1964;0;3985597;29587;2
FR;3;2021-05-02;2927;498;0;3988524;30085;2
FR;3;2021-05-03;12827;3881;0;4001351;33966;2
FR;3;2021-05-04;22827;8427;0;4024178;42393;2
FR;3;2021-05-05;18463;10567;0;4042641;52960;2
FR;3;2021-05-06;34343;20892;0;4076984;73852;2
FR;3;2021-05-07;43971;28393;0;4120955;102245;2
FR;3;2021-05-08;6614;8877;0;4127569;111122;2
FR;3;2021-05-09;1686;2651;0;4129255;113773;2
FR;3;2021-05-10;14743;12556;0;4143998;126329;2
FR;3;2021-05-11;26818;25720;0;4170816;152049;2
FR;3;2021-05-12;17059;27446;1;4187875;179495;3
FR;3;2021-05-13;2136;3483;0;4190011;182978;3
FR;3;2021-05-14;14340;25735;0;4204351;208713;3
FR;3;2021-05-15;7075;20729;0;4211426;229442;3
FR;3;2021-05-16;885;2677;0;4212311;232119;3
FR;3;2021-05-17;7738;19905;0;4220049;252024;3
FR;3;2021-05-18;13184;29627;0;4233233;281651;3
FR;3;2021-05-19;9017;31855;0;4242250;313506;3
FR;3;2021-05-20;12556;53210;2;4254806;366716;5
FR;3;2021-05-21;12537;65527;0;4267343;432243;5
FR;3;2021-05-22;4817;33295;1;4272160;465538;6
FR;3;2021-05-23;552;2665;0;4272712;468203;6
FR;3;2021-05-24;660;4915;0;4273372;473118;6
FR;3;2021-05-25;5061;45170;0;4278433;518288;6
FR;3;2021-05-26;4752;51048;1;4283185;569336;7
FR;3;2021-05-27;6101;77830;1;4289286;647166;8
FR;3;2021-05-28;7352;99099;0;4296638;746265;8
FR;3;2021-05-29;3179;60282;1;4299817;806547;9
FR;3;2021-05-30;403;8243;0;4300220;814790;9
FR;3;2021-05-31;2185;35990;0;4302405;850780;9
FR;3;2021-06-01;3114;64811;4;4305519;915591;13
FR;3;2021-06-02;2513;58353;0;4308032;973944;13
FR;3;2021-06-03;3304;87576;3;4311336;1061520;16
FR;3;2021-06-04;3952;105118;11;4315288;1166638;27
FR;3;2021-06-05;1855;52242;0;4317143;1218880;27
FR;3;2021-06-06;326;5399;0;4317469;1224279;27
FR;3;2021-06-07;1205;31181;2;4318674;1255460;29
FR;3;2021-06-08;1810;47280;8;4320484;1302740;37
FR;3;2021-06-09;1536;42394;8;4322020;1345134;45
FR;3;2021-06-10;1987;67997;7;4324007;1413131;52
FR;3;2021-06-11;2330;96797;16;4326337;1509928;68
FR;3;2021-06-12;1036;40835;4;4327373;1550763;72
FR;3;2021-06-13;169;3823;1;4327542;1554586;73
FR;3;2021-06-14;839;42664;11;4328381;1597250;84
FR;3;2021-06-15;1205;80695;5;4329586;1677945;89
FR;3;2021-06-16;1077;65780;6;4330663;1743725;95
FR;3;2021-06-17;1486;101855;19;4332149;1845580;114
FR;3;2021-06-18;1777;117922;24;4333926;1963502;138
FR;3;2021-06-19;735;39405;11;4334661;2002907;149
FR;3;2021-06-20;92;3384;0;4334753;2006291;149
FR;3;2021-06-21;607;39289;8;4335360;2045580;157
FR;3;2021-06-22;928;70016;33;4336288;2115596;190
FR;3;2021-06-23;824;50845;15;4337112;2166441;205
FR;3;2021-06-24;1195;77212;23;4338307;2243653;228
FR;3;2021-06-25;1305;89968;40;4339612;2333621;268
FR;3;2021-06-26;548;33137;12;4340160;2366758;280
FR;3;2021-06-27;105;4027;1;4340265;2370785;281
FR;3;2021-06-28;515;30459;14;4340780;2401244;295
FR;3;2021-06-29;764;56147;93;4341544;2457391;388
FR;3;2021-06-30;791;45061;89;4342335;2502452;477
FR;3;2021-07-01;1043;65663;108;4343378;2568115;585
FR;3;2021-07-02;1194;90449;171;4344572;2658564;756
FR;3;2021-07-03;557;31195;54;4345129;2689759;810
FR;3;2021-07-04;86;4275;3;4345215;2694034;813
FR;3;2021-07-05;529;33933;61;4345744;2727967;874
FR;3;2021-07-06;834;56135;88;4346578;2784102;962
FR;3;2021-07-07;767;43084;77;4347345;2827186;1039
FR;3;2021-07-08;1036;60760;99;4348381;2887946;1138
FR;3;2021-07-09;1166;68838;125;4349547;2956784;1263
FR;3;2021-07-10;560;25054;58;4350107;2981838;1321
FR;3;2021-07-11;73;3311;4;4350180;2985149;1325
FR;3;2021-07-12;539;23933;58;4350719;3009082;1383
FR;3;2021-07-13;1526;34766;88;4352245;3043848;1471
FR;3;2021-07-14;153;2651;2;4352398;3046499;1473
FR;3;2021-07-15;1838;30698;82;4354236;3077197;1555
FR;3;2021-07-16;2411;38905;123;4356647;3116102;1678
FR;3;2021-07-17;978;13753;26;4357625;3129855;1704
FR;3;2021-07-18;206;2610;3;4357831;3132465;1707
FR;3;2021-07-19;1185;17242;34;4359016;3149707;1741
FR;3;2021-07-20;1733;27172;93;4360749;3176879;1834
FR;3;2021-07-21;1560;19753;43;4362309;3196632;1877
FR;3;2021-07-22;1750;27804;79;4364059;3224436;1956
FR;3;2021-07-23;2106;30480;113;4366165;3254916;2069
FR;3;2021-07-24;763;7021;23;4366928;3261937;2092
FR;3;2021-07-25;176;1351;1;4367104;3263288;2093
FR;3;2021-07-26;813;10736;28;4367917;3274024;2121
FR;3;2021-07-27;1072;16983;55;4368989;3291007;2176
FR;3;2021-07-28;877;12136;37;4369866;3303143;2213
FR;3;2021-07-29;1045;15872;63;4370911;3319015;2276
FR;3;2021-07-30;1043;18112;75;4371954;3337127;2351
FR;3;2021-07-31;340;3751;13;4372294;3340878;2364
FR;3;2021-08-01;49;484;1;4372343;3341362;2365
FR;3;2021-08-02;318;5163;23;4372661;3346525;2388
FR;3;2021-08-03;413;7589;25;4373074;3354114;2413
FR;3;2021-08-04;369;4893;24;4373443;3359007;2437
FR;3;2021-08-05;360;3750;12;4373803;3362757;2449
FR;3;2021-08-06;389;4786;28;4374192;3367543;2477
FR;3;2021-08-07;160;1926;11;4374352;3369469;2488
FR;3;2021-08-08;61;423;2;4374413;3369892;2490
FR;3;2021-08-09;216;2521;10;4374629;3372413;2500
FR;3;2021-08-10;273;3898;14;4374902;3376311;2514
FR;3;2021-08-11;192;2719;14;4375094;3379030;2528
FR;3;2021-08-12;211;2627;12;4375305;3381657;2540
FR;3;2021-08-13;211;2252;15;4375516;3383909;2555
FR;3;2021-08-14;127;937;1;4375643;3384846;2556
FR;3;2021-08-15;24;161;0;4375667;3385007;2556
FR;3;2021-08-16;83;1092;8;4375750;3386099;2564
FR;3;2021-08-17;121;1495;7;4375871;3387594;2571
FR;3;2021-08-18;135;1347;8;4376006;3388941;2579
FR;3;2021-08-19;124;1427;9;4376130;3390368;2588
FR;3;2021-08-20;120;1629;15;4376250;3391997;2603
FR;3;2021-08-21;58;583;0;4376308;3392580;2603
FR;3;2021-08-22;18;168;1;4376326;3392748;2604
FR;3;2021-08-23;89;921;7;4376415;3393669;2611
FR;3;2021-08-24;88;960;9;4376503;3394629;2620
FR;3;2021-08-25;87;836;2;4376590;3395465;2622
FR;3;2021-08-26;119;877;9;4376709;3396342;2631
FR;3;2021-08-27;134;953;9;4376843;3397295;2640
FR;3;2021-08-28;74;354;3;4376917;3397649;2643
FR;3;2021-08-29;15;124;1;4376932;3397773;2644
FR;3;2021-08-30;57;595;0;4376989;3398368;2644
FR;3;2021-08-31;73;712;7;4377062;3399080;2651
FR;3;2021-09-01;66;467;4;4377128;3399547;2655
FR;3;2021-09-02;62;624;20;4377190;3400171;2675
FR;3;2021-09-03;74;587;16;4377264;3400758;2691
FR;3;2021-09-04;22;279;3;4377286;3401037;2694
FR;3;2021-09-05;10;58;2;4377296;3401095;2696
FR;3;2021-09-06;43;402;3;4377339;3401497;2699
FR;3;2021-09-07;69;482;13;4377408;3401979;2712
FR;3;2021-09-08;59;354;0;4377467;3402333;2712
FR;3;2021-09-09;36;386;3;4377503;3402719;2715
FR;4;2020-12-27;0;0;0;0;0;0
FR;4;2020-12-28;0;0;0;0;0;0
FR;4;2020-12-29;0;0;0;0;0;0
FR;4;2020-12-30;0;0;0;0;0;0
FR;4;2020-12-31;0;0;0;0;0;0
FR;4;2021-01-01;0;0;0;0;0;0
FR;4;2021-01-02;0;0;0;0;0;0
FR;4;2021-01-03;0;0;0;0;0;0
FR;4;2021-01-04;0;0;0;0;0;0
FR;4;2021-01-05;0;0;0;0;0;0
FR;4;2021-01-06;0;0;0;0;0;0
FR;4;2021-01-07;0;0;0;0;0;0
FR;4;2021-01-08;0;0;0;0;0;0
FR;4;2021-01-09;0;0;0;0;0;0
FR;4;2021-01-10;0;0;0;0;0;0
FR;4;2021-01-11;0;0;0;0;0;0
FR;4;2021-01-12;0;0;0;0;0;0
FR;4;2021-01-13;0;0;0;0;0;0
FR;4;2021-01-14;0;0;0;0;0;0
FR;4;2021-01-15;0;0;0;0;0;0
FR;4;2021-01-16;0;0;0;0;0;0
FR;4;2021-01-17;0;0;0;0;0;0
FR;4;2021-01-18;0;0;0;0;0;0
FR;4;2021-01-19;0;0;0;0;0;0
FR;4;2021-01-20;0;0;0;0;0;0
FR;4;2021-01-21;0;0;0;0;0;0
FR;4;2021-01-22;0;0;0;0;0;0
FR;4;2021-01-23;0;0;0;0;0;0
FR;4;2021-01-24;0;0;0;0;0;0
FR;4;2021-01-25;0;0;0;0;0;0
FR;4;2021-01-26;0;0;0;0;0;0
FR;4;2021-01-27;0;0;0;0;0;0
FR;4;2021-01-28;0;0;0;0;0;0
FR;4;2021-01-29;0;0;0;0;0;0
FR;4;2021-01-30;0;0;0;0;0;0
FR;4;2021-01-31;0;0;0;0;0;0
FR;4;2021-02-01;0;0;0;0;0;0
FR;4;2021-02-02;0;0;0;0;0;0
FR;4;2021-02-03;0;0;0;0;0;0
FR;4;2021-02-04;0;0;0;0;0;0
FR;4;2021-02-05;0;0;0;0;0;0
FR;4;2021-02-06;0;0;0;0;0;0
FR;4;2021-02-07;0;0;0;0;0;0
FR;4;2021-02-08;0;0;0;0;0;0
FR;4;2021-02-09;0;0;0;0;0;0
FR;4;2021-02-10;0;0;0;0;0;0
FR;4;2021-02-11;0;0;0;0;0;0
FR;4;2021-02-12;0;0;0;0;0;0
FR;4;2021-02-13;0;0;0;0;0;0
FR;4;2021-02-14;0;0;0;0;0;0
FR;4;2021-02-15;0;0;0;0;0;0
FR;4;2021-02-16;0;0;0;0;0;0
FR;4;2021-02-17;0;0;0;0;0;0
FR;4;2021-02-18;0;0;0;0;0;0
FR;4;2021-02-19;0;0;0;0;0;0
FR;4;2021-02-20;0;0;0;0;0;0
FR;4;2021-02-21;0;0;0;0;0;0
FR;4;2021-02-22;0;0;0;0;0;0
FR;4;2021-02-23;0;0;0;0;0;0
FR;4;2021-02-24;0;0;0;0;0;0
FR;4;2021-02-25;0;0;0;0;0;0
FR;4;2021-02-26;0;0;0;0;0;0
FR;4;2021-02-27;0;0;0;0;0;0
FR;4;2021-02-28;0;0;0;0;0;0
FR;4;2021-03-01;0;0;0;0;0;0
FR;4;2021-03-02;0;0;0;0;0;0
FR;4;2021-03-03;0;0;0;0;0;0
FR;4;2021-03-04;0;0;0;0;0;0
FR;4;2021-03-05;0;1;0;0;1;0
FR;4;2021-03-06;0;0;0;0;1;0
FR;4;2021-03-07;0;0;0;0;1;0
FR;4;2021-03-08;0;0;0;0;1;0
FR;4;2021-03-09;0;0;0;0;1;0
FR;4;2021-03-10;0;0;0;0;1;0
FR;4;2021-03-11;0;0;0;0;1;0
FR;4;2021-03-12;0;0;0;0;1;0
FR;4;2021-03-13;0;0;0;0;1;0
FR;4;2021-03-14;0;0;0;0;1;0
FR;4;2021-03-15;0;0;0;0;1;0
FR;4;2021-03-16;0;0;0;0;1;0
FR;4;2021-03-17;0;0;0;0;1;0
FR;4;2021-03-18;0;0;0;0;1;0
FR;4;2021-03-19;0;0;0;0;1;0
FR;4;2021-03-20;0;0;0;0;1;0
FR;4;2021-03-21;0;0;0;0;1;0
FR;4;2021-03-22;0;0;0;0;1;0
FR;4;2021-03-23;0;0;0;0;1;0
FR;4;2021-03-24;0;0;0;0;1;0
FR;4;2021-03-25;0;0;0;0;1;0
FR;4;2021-03-26;0;0;0;0;1;0
FR;4;2021-03-27;0;0;0;0;1;0
FR;4;2021-03-28;0;0;0;0;1;0
FR;4;2021-03-29;0;0;0;0;1;0
FR;4;2021-03-30;0;0;0;0;1;0
FR;4;2021-03-31;0;1;0;0;2;0
FR;4;2021-04-01;0;0;0;0;2;0
FR;4;2021-04-02;0;1;0;0;3;0
FR;4;2021-04-03;0;0;0;0;3;0
FR;4;2021-04-04;0;0;0;0;3;0
FR;4;2021-04-05;0;0;0;0;3;0
FR;4;2021-04-06;0;5;0;0;8;0
FR;4;2021-04-07;0;0;0;0;8;0
FR;4;2021-04-08;0;2;0;0;10;0
FR;4;2021-04-09;0;3;0;0;13;0
FR;4;2021-04-10;0;0;0;0;13;0
FR;4;2021-04-11;0;0;0;0;13;0
FR;4;2021-04-12;0;3;0;0;16;0
FR;4;2021-04-13;0;2;0;0;18;0
FR;4;2021-04-14;0;0;0;0;18;0
FR;4;2021-04-15;0;0;0;0;18;0
FR;4;2021-04-16;0;0;0;0;18;0
FR;4;2021-04-17;0;0;0;0;18;0
FR;4;2021-04-18;0;0;0;0;18;0
FR;4;2021-04-19;0;0;0;0;18;0
FR;4;2021-04-20;0;0;0;0;18;0
FR;4;2021-04-21;0;0;0;0;18;0
FR;4;2021-04-22;0;0;0;0;18;0
FR;4;2021-04-23;2691;0;0;2691;18;0
FR;4;2021-04-24;1558;0;0;4249;18;0
FR;4;2021-04-25;123;0;0;4372;18;0
FR;4;2021-04-26;2849;0;0;7221;18;0
FR;4;2021-04-27;9458;4;0;16679;22;0
FR;4;2021-04-28;9848;3;0;26527;25;0
FR;4;2021-04-29;15960;8;0;42487;33;0
FR;4;2021-04-30;19180;7;0;61667;40;0
FR;4;2021-05-01;1946;5;0;63613;45;0
FR;4;2021-05-02;462;0;0;64075;45;0
FR;4;2021-05-03;4990;1;0;69065;46;0
FR;4;2021-05-04;8313;8;0;77378;54;0
FR;4;2021-05-05;6078;5;0;83456;59;0
FR;4;2021-05-06;11305;11;0;94761;70;0
FR;4;2021-05-07;19009;9;0;113770;79;0
FR;4;2021-05-08;2293;6;0;116063;85;0
FR;4;2021-05-09;645;2;0;116708;87;0
FR;4;2021-05-10;7159;8;0;123867;95;0
FR;4;2021-05-11;14216;12;0;138083;107;0
FR;4;2021-05-12;10083;16;0;148166;123;0
FR;4;2021-05-13;1509;3;0;149675;126;0
FR;4;2021-05-14;7659;7;0;157334;133;0
FR;4;2021-05-15;3650;8;0;160984;141;0
FR;4;2021-05-16;385;1;0;161369;142;0
FR;4;2021-05-17;4381;3;0;165750;145;0
FR;4;2021-05-18;8667;10;0;174417;155;0
FR;4;2021-05-19;5593;5;0;180010;160;0
FR;4;2021-05-20;9330;6;0;189340;166;0
FR;4;2021-05-21;12651;29;0;201991;195;0
FR;4;2021-05-22;4973;12;0;206964;207;0
FR;4;2021-05-23;451;2;0;207415;209;0
FR;4;2021-05-24;978;3;0;208393;212;0
FR;4;2021-05-25;7485;16;0;215878;228;0
FR;4;2021-05-26;7623;13;0;223501;241;0
FR;4;2021-05-27;14202;34;0;237703;275;0
FR;4;2021-05-28;26387;82;1;264090;357;1
FR;4;2021-05-29;11244;20;0;275334;377;1
FR;4;2021-05-30;877;2;0;276211;379;1
FR;4;2021-05-31;12496;19;0;288707;398;1
FR;4;2021-06-01;19989;41;0;308696;439;1
FR;4;2021-06-02;14340;33;0;323036;472;1
FR;4;2021-06-03;19260;24;0;342296;496;1
FR;4;2021-06-04;22283;45;0;364579;541;1
FR;4;2021-06-05;9612;29;0;374191;570;1
FR;4;2021-06-06;947;0;0;375138;570;1
FR;4;2021-06-07;9011;16;0;384149;586;1
FR;4;2021-06-08;14433;27;0;398582;613;1
FR;4;2021-06-09;12030;24;0;410612;637;1
FR;4;2021-06-10;15205;24;0;425817;661;1
FR;4;2021-06-11;16782;52;0;442599;713;1
FR;4;2021-06-12;7324;27;0;449923;740;1
FR;4;2021-06-13;853;2;0;450776;742;1
FR;4;2021-06-14;6506;22;0;457282;764;1
FR;4;2021-06-15;10742;32;0;468024;796;1
FR;4;2021-06-16;8747;13;0;476771;809;1
FR;4;2021-06-17;10727;24;0;487498;833;1
FR;4;2021-06-18;12253;39;0;499751;872;1
FR;4;2021-06-19;5474;24;0;505225;896;1
FR;4;2021-06-20;631;2;0;505856;898;1
FR;4;2021-06-21;4925;10;0;510781;908;1
FR;4;2021-06-22;7714;20;2;518495;928;3
FR;4;2021-06-23;6953;35;1;525448;963;4
FR;4;2021-06-24;8476;36;0;533924;999;4
FR;4;2021-06-25;9935;37;1;543859;1036;5
FR;4;2021-06-26;4643;20;0;548502;1056;5
FR;4;2021-06-27;612;2;0;549114;1058;5
FR;4;2021-06-28;4593;15;1;553707;1073;6
FR;4;2021-06-29;6824;16;2;560531;1089;8
FR;4;2021-06-30;6437;36;0;566968;1125;8
FR;4;2021-07-01;7921;26;0;574889;1151;8
FR;4;2021-07-02;9211;44;1;584100;1195;9
FR;4;2021-07-03;4710;18;0;588810;1213;9
FR;4;2021-07-04;580;5;0;589390;1218;9
FR;4;2021-07-05;4608;18;2;593998;1236;11
FR;4;2021-07-06;7497;20;4;601495;1256;15
FR;4;2021-07-07;6769;27;1;608264;1283;16
FR;4;2021-07-08;8985;37;3;617249;1320;19
FR;4;2021-07-09;10083;30;1;627332;1350;20
FR;4;2021-07-10;4481;10;2;631813;1360;22
FR;4;2021-07-11;505;0;1;632318;1360;23
FR;4;2021-07-12;5667;27;0;637985;1387;23
FR;4;2021-07-13;14038;26;0;652023;1413;23
FR;4;2021-07-14;2074;6;0;654097;1419;23
FR;4;2021-07-15;18009;32;0;672106;1451;23
FR;4;2021-07-16;22554;65;2;694660;1516;25
FR;4;2021-07-17;9558;16;0;704218;1532;25
FR;4;2021-07-18;1271;3;0;705489;1535;25
FR;4;2021-07-19;12729;26;1;718218;1561;26
FR;4;2021-07-20;17099;28;1;735317;1589;27
FR;4;2021-07-21;15321;28;1;750638;1617;28
FR;4;2021-07-22;17979;40;2;768617;1657;30
FR;4;2021-07-23;20097;48;5;788714;1705;35
FR;4;2021-07-24;9048;29;0;797762;1734;35
FR;4;2021-07-25;1205;6;0;798967;1740;35
FR;4;2021-07-26;10692;18;0;809659;1758;35
FR;4;2021-07-27;14202;31;1;823861;1789;36
FR;4;2021-07-28;12401;18;2;836262;1807;38
FR;4;2021-07-29;13723;46;3;849985;1853;41
FR;4;2021-07-30;15151;39;3;865136;1892;44
FR;4;2021-07-31;6585;11;1;871721;1903;45
FR;4;2021-08-01;791;1;0;872512;1904;45
FR;4;2021-08-02;7513;17;0;880025;1921;45
FR;4;2021-08-03;10275;21;2;890300;1942;47
FR;4;2021-08-04;9073;21;0;899373;1963;47
FR;4;2021-08-05;9175;32;0;908548;1995;47
FR;4;2021-08-06;9660;19;4;918208;2014;51
FR;4;2021-08-07;4649;24;1;922857;2038;52
FR;4;2021-08-08;857;8;0;923714;2046;52
FR;4;2021-08-09;5488;16;0;929202;2062;52
FR;4;2021-08-10;8056;13;0;937258;2075;52
FR;4;2021-08-11;7388;21;2;944646;2096;54
FR;4;2021-08-12;7869;13;1;952515;2109;55
FR;4;2021-08-13;6842;21;0;959357;2130;55
FR;4;2021-08-14;3356;16;0;962713;2146;55
FR;4;2021-08-15;470;2;0;963183;2148;55
FR;4;2021-08-16;3689;7;0;966872;2155;55
FR;4;2021-08-17;5288;8;1;972160;2163;56
FR;4;2021-08-18;4865;24;0;977025;2187;56
FR;4;2021-08-19;5173;13;2;982198;2200;58
FR;4;2021-08-20;4880;10;1;987078;2210;59
FR;4;2021-08-21;2020;14;1;989098;2224;60
FR;4;2021-08-22;328;1;0;989426;2225;60
FR;4;2021-08-23;2597;4;0;992023;2229;60
FR;4;2021-08-24;3479;8;0;995502;2237;60
FR;4;2021-08-25;3324;19;0;998826;2256;60
FR;4;2021-08-26;3501;15;0;1002327;2271;60
FR;4;2021-08-27;3402;16;2;1005729;2287;62
FR;4;2021-08-28;1560;9;0;1007289;2296;62
FR;4;2021-08-29;345;3;2;1007634;2299;64
FR;4;2021-08-30;1810;12;0;1009444;2311;64
FR;4;2021-08-31;2300;12;0;1011744;2323;64
FR;4;2021-09-01;1860;22;1;1013604;2345;65
FR;4;2021-09-02;2126;20;4;1015730;2365;69
FR;4;2021-09-03;2208;34;0;1017938;2399;69
FR;4;2021-09-04;1230;13;0;1019168;2412;69
FR;4;2021-09-05;232;0;0;1019400;2412;69
FR;4;2021-09-06;1268;15;0;1020668;2427;69
FR;4;2021-09-07;1449;9;0;1022117;2436;69
FR;4;2021-09-08;1236;16;4;1023353;2452;73
FR;4;2021-09-09;1169;17;2;1024522;2469;75
FR;0;2020-12-27;321;0;0;321;0;0
FR;0;2020-12-28;333;0;0;654;0;0
FR;0;2020-12-29;232;0;0;886;0;0
FR;0;2020-12-30;277;0;0;1163;0;0
FR;0;2020-12-31;219;0;0;1382;0;0
FR;0;2021-01-01;256;0;0;1638;0;0
FR;0;2021-01-02;205;0;0;1843;0;0
FR;0;2021-01-03;240;0;0;2083;0;0
FR;0;2021-01-04;1714;0;0;3797;0;0
FR;0;2021-01-05;5655;0;0;9452;0;0
FR;0;2021-01-06;11572;0;0;21024;0;0
FR;0;2021-01-07;29019;0;0;50043;0;0
FR;0;2021-01-08;36685;0;0;86728;0;0
FR;0;2021-01-09;11061;0;0;97789;0;0
FR;0;2021-01-10;5750;0;0;103539;0;0
FR;0;2021-01-11;39593;0;0;143132;0;0
FR;0;2021-01-12;61602;0;0;204734;0;0
FR;0;2021-01-13;64551;0;0;269285;0;0
FR;0;2021-01-14;81722;0;0;351007;0;0
FR;0;2021-01-15;68428;0;0;419435;0;0
FR;0;2021-01-16;20000;77;0;439435;77;0
FR;0;2021-01-17;10736;42;0;450171;119;0
FR;0;2021-01-18;85309;161;0;535480;280;0
FR;0;2021-01-19;129944;125;0;665424;405;0
FR;0;2021-01-20;136793;155;0;802217;560;0
FR;0;2021-01-21;157395;131;0;959612;691;0
FR;0;2021-01-22;120282;160;0;1079894;851;0
FR;0;2021-01-23;38174;50;0;1118068;901;0
FR;0;2021-01-24;9547;27;0;1127615;928;0
FR;0;2021-01-25;77687;1215;0;1205302;2143;0
FR;0;2021-01-26;99820;3108;0;1305122;5251;0
FR;0;2021-01-27;106743;5592;0;1411865;10843;0
FR;0;2021-01-28;123694;14353;0;1535559;25196;0
FR;0;2021-01-29;91635;17277;0;1627194;42473;0
FR;0;2021-01-30;28914;4222;0;1656108;46695;0
FR;0;2021-01-31;5051;1678;0;1661159;48373;0
FR;0;2021-02-01;52167;21115;0;1713326;69488;0
FR;0;2021-02-02;71518;34552;0;1784844;104040;0
FR;0;2021-02-03;71711;36949;0;1856555;140989;0
FR;0;2021-02-04;81385;50039;0;1937940;191028;0
FR;0;2021-02-05;67706;45321;0;2005646;236349;0
FR;0;2021-02-06;22014;10393;0;2027660;246742;0
FR;0;2021-02-07;4998;5040;0;2032658;251782;0
FR;0;2021-02-08;46318;45966;0;2078976;297748;0
FR;0;2021-02-09;65460;72388;0;2144436;370136;0
FR;0;2021-02-10;70116;76713;0;2214552;446849;0
FR;0;2021-02-11;86523;99127;0;2301075;545976;0
FR;0;2021-02-12;78491;74204;0;2379566;620180;0
FR;0;2021-02-13;21946;19482;0;2401512;639662;0
FR;0;2021-02-14;4787;7188;0;2406299;646850;0
FR;0;2021-02-15;37494;76479;0;2443793;723329;0
FR;0;2021-02-16;49708;100701;0;2493501;824030;0
FR;0;2021-02-17;49841;102975;1;2543342;927005;1
FR;0;2021-02-18;68924;118501;0;2612266;1045506;1
FR;0;2021-02-19;64456;90730;0;2676722;1136236;1
FR;0;2021-02-20;18249;28414;0;2694971;1164650;1
FR;0;2021-02-21;3069;6372;0;2698040;1171022;1
FR;0;2021-02-22;36950;73125;1;2734990;1244147;2
FR;0;2021-02-23;53157;84037;1;2788147;1328184;3
FR;0;2021-02-24;59128;81104;1;2847275;1409288;4
FR;0;2021-02-25;99774;91363;1;2947049;1500651;5
FR;0;2021-02-26;112673;70998;0;3059722;1571649;5
FR;0;2021-02-27;51669;21977;0;3111391;1593626;5
FR;0;2021-02-28;5908;4413;1;3117299;1598039;6
FR;0;2021-03-01;64538;52776;0;3181837;1650815;6
FR;0;2021-03-02;100368;66235;1;3282205;1717050;7
FR;0;2021-03-03;115154;65539;0;3397359;1782589;7
FR;0;2021-03-04;162400;68872;2;3559759;1851461;9
FR;0;2021-03-05;199639;63349;2;3759398;1914810;11
FR;0;2021-03-06;207014;17811;1;3966412;1932621;12
FR;0;2021-03-07;120703;5467;0;4087115;1938088;12
FR;0;2021-03-08;106107;50788;0;4193222;1988876;12
FR;0;2021-03-09;171324;56770;0;4364546;2045646;12
FR;0;2021-03-10;177454;57202;2;4542000;2102848;14
FR;0;2021-03-11;241414;63101;0;4783414;2165949;14
FR;0;2021-03-12;293398;53514;1;5076812;2219463;15
FR;0;2021-03-13;230289;15302;0;5307101;2234765;15
FR;0;2021-03-14;62839;3434;0;5369940;2238199;15
FR;0;2021-03-15;157364;32633;0;5527304;2270832;15
FR;0;2021-03-16;140527;39522;1;5667831;2310354;16
FR;0;2021-03-17;149479;38781;2;5817310;2349135;18
FR;0;2021-03-18;166613;44617;1;5983923;2393752;19
FR;0;2021-03-19;228787;37470;0;6212710;2431222;19
FR;0;2021-03-20;165870;11780;0;6378580;2443002;19
FR;0;2021-03-21;49358;2626;0;6427938;2445628;19
FR;0;2021-03-22;168797;34280;2;6596735;2479908;21
FR;0;2021-03-23;248946;42400;0;6845681;2522308;21
FR;0;2021-03-24;255487;43842;0;7101168;2566150;21
FR;0;2021-03-25;340395;44749;1;7441563;2610899;22
FR;0;2021-03-26;357499;41899;1;7799062;2652798;23
FR;0;2021-03-27;194450;16649;0;7993512;2669447;23
FR;0;2021-03-28;58881;3731;2;8052393;2673178;25
FR;0;2021-03-29;201983;54286;1;8254376;2727464;26
FR;0;2021-03-30;284063;69681;3;8538439;2797145;29
FR;0;2021-03-31;261647;72931;2;8800086;2870076;31
FR;0;2021-04-01;313099;87814;4;9113185;2957890;35
FR;0;2021-04-02;279981;92138;5;9393166;3050028;40
FR;0;2021-04-03;140171;61853;2;9533337;3111881;42
FR;0;2021-04-04;45365;18664;1;9578702;3130545;43
FR;0;2021-04-05;59634;11002;3;9638336;3141547;46
FR;0;2021-04-06;215534;107867;6;9853870;3249414;52
FR;0;2021-04-07;258341;115458;5;10112211;3364872;57
FR;0;2021-04-08;335648;121426;5;10447859;3486298;62
FR;0;2021-04-09;408210;116495;33;10856069;3602793;95
FR;0;2021-04-10;211549;82751;1;11067618;3685544;96
FR;0;2021-04-11;55477;34594;2;11123095;3720138;98
FR;0;2021-04-12;235535;115226;21;11358630;3835364;119
FR;0;2021-04-13;307663;144971;48;11666293;3980335;167
FR;0;2021-04-14;292137;139414;99;11958430;4119749;266
FR;0;2021-04-15;334439;147870;152;12292869;4267619;418
FR;0;2021-04-16;337687;145777;192;12630556;4413396;610
FR;0;2021-04-17;187702;90258;42;12818258;4503654;652
FR;0;2021-04-18;50980;35427;17;12869238;4539081;669
FR;0;2021-04-19;204144;138383;300;13073382;4677464;969
FR;0;2021-04-20;252455;170730;314;13325837;4848194;1283
FR;0;2021-04-21;251317;168809;489;13577154;5017003;1772
FR;0;2021-04-22;285651;188256;480;13862805;5205259;2252
FR;0;2021-04-23;295054;183279;465;14157859;5388538;2717
FR;0;2021-04-24;189319;111574;76;14347178;5500112;2793
FR;0;2021-04-25;68890;38868;23;14416068;5538980;2816
FR;0;2021-04-26;219513;156109;314;14635581;5695089;3130
FR;0;2021-04-27;282798;187506;539;14918379;5882595;3669
FR;0;2021-04-28;297766;183205;1004;15216145;6065800;4673
FR;0;2021-04-29;355100;196132;845;15571245;6261932;5518
FR;0;2021-04-30;370252;184838;627;15941497;6446770;6145
FR;0;2021-05-01;165133;52532;96;16106630;6499302;6241
FR;0;2021-05-02;90757;37831;47;16197387;6537133;6288
FR;0;2021-05-03;285911;169646;494;16483298;6706779;6782
FR;0;2021-05-04;312716;224316;710;16796014;6931095;7492
FR;0;2021-05-05;323148;224533;714;17119162;7155628;8206
FR;0;2021-05-06;376008;239202;998;17495170;7394830;9204
FR;0;2021-05-07;370025;257336;689;17865195;7652166;9893
FR;0;2021-05-08;220648;66916;130;18085843;7719082;10023
FR;0;2021-05-09;128874;46758;81;18214717;7765840;10104
FR;0;2021-05-10;308960;229023;679;18523677;7994863;10783
FR;0;2021-05-11;400818;258184;867;18924495;8253047;11650
FR;0;2021-05-12;430368;233246;779;19354863;8486293;12429
FR;0;2021-05-13;335675;56896;219;19690538;8543189;12648
FR;0;2021-05-14;450622;167536;583;20141160;8710725;13231
FR;0;2021-05-15;371633;94027;187;20512793;8804752;13418
FR;0;2021-05-16;201425;20831;73;20714218;8825583;13491
FR;0;2021-05-17;373262;149172;862;21087480;8974755;14353
FR;0;2021-05-18;456018;153194;1095;21543498;9127949;15448
FR;0;2021-05-19;464195;145376;1381;22007693;9273325;16829
FR;0;2021-05-20;503738;160397;1298;22511431;9433722;18127
FR;0;2021-05-21;486385;174588;1066;22997816;9608310;19193
FR;0;2021-05-22;345230;79900;351;23343046;9688210;19544
FR;0;2021-05-23;160715;14445;133;23503761;9702655;19677
FR;0;2021-05-24;261372;33251;332;23765133;9735906;20009
FR;0;2021-05-25;397114;189350;1330;24162247;9925256;21339
FR;0;2021-05-26;410511;188204;1304;24572758;10113460;22643
FR;0;2021-05-27;446808;218741;1321;25019566;10332201;23964
FR;0;2021-05-28;426802;259696;1070;25446368;10591897;25034
FR;0;2021-05-29;297499;149457;322;25743867;10741354;25356
FR;0;2021-05-30;106141;32625;86;25850008;10773979;25442
FR;0;2021-05-31;355632;203564;866;26205640;10977543;26308
FR;0;2021-06-01;422274;251704;1136;26627914;11229247;27444
FR;0;2021-06-02;412379;230944;1130;27040293;11460191;28574
FR;0;2021-06-03;458232;258739;973;27498525;11718930;29547
FR;0;2021-06-04;451465;304927;973;27949990;12023857;30520
FR;0;2021-06-05;302251;189106;363;28252241;12212963;30883
FR;0;2021-06-06;131373;49136;128;28383614;12262099;31011
FR;0;2021-06-07;334395;262501;870;28718009;12524600;31881
FR;0;2021-06-08;389772;291352;985;29107781;12815952;32866
FR;0;2021-06-09;380363;276011;1015;29488144;13091963;33881
FR;0;2021-06-10;398134;289465;1028;29886278;13381428;34909
FR;0;2021-06-11;383656;357640;768;30269934;13739068;35677
FR;0;2021-06-12;281156;211532;258;30551090;13950600;35935
FR;0;2021-06-13;103792;74097;107;30654882;14024697;36042
FR;0;2021-06-14;237948;356044;808;30892830;14380741;36850
FR;0;2021-06-15;304467;386171;844;31197297;14766912;37694
FR;0;2021-06-16;310507;357868;844;31507804;15124780;38538
FR;0;2021-06-17;314323;372307;761;31822127;15497087;39299
FR;0;2021-06-18;319089;442903;696;32141216;15939990;39995
FR;0;2021-06-19;223015;274046;245;32364231;16214036;40240
FR;0;2021-06-20;72336;102650;62;32436567;16316686;40302
FR;0;2021-06-21;193129;402231;588;32629696;16718917;40890
FR;0;2021-06-22;220590;467493;725;32850286;17186410;41615
FR;0;2021-06-23;231230;440060;700;33081516;17626470;42315
FR;0;2021-06-24;239271;409465;759;33320787;18035935;43074
FR;0;2021-06-25;224479;522486;807;33545266;18558421;43881
FR;0;2021-06-26;151843;370954;300;33697109;18929375;44181
FR;0;2021-06-27;55091;156440;90;33752200;19085815;44271
FR;0;2021-06-28;152667;453404;694;33904867;19539219;44965
FR;0;2021-06-29;180782;505780;1963;34085649;20044999;46928
FR;0;2021-06-30;201662;481341;1854;34287311;20526340;48782
FR;0;2021-07-01;224166;457915;2126;34511477;20984255;50908
FR;0;2021-07-02;223732;520642;2043;34735209;21504897;52951
FR;0;2021-07-03;140050;368989;893;34875259;21873886;53844
FR;0;2021-07-04;55826;141393;264;34931085;22015279;54108
FR;0;2021-07-05;164522;419675;1590;35095607;22434954;55698
FR;0;2021-07-06;193558;475224;1741;35289165;22910178;57439
FR;0;2021-07-07;208734;439685;1744;35497899;23349863;59183
FR;0;2021-07-08;228262;424328;2012;35726161;23774191;61195
FR;0;2021-07-09;226139;510002;2093;35952300;24284193;63288
FR;0;2021-07-10;146755;339846;948;36099055;24624039;64236
FR;0;2021-07-11;59266;110153;264;36158321;24734192;64500
FR;0;2021-07-12;166390;478397;1707;36324711;25212589;66207
FR;0;2021-07-13;284517;527922;1971;36609228;25740511;68178
FR;0;2021-07-14;178670;157914;418;36787898;25898425;68596
FR;0;2021-07-15;343533;502686;2014;37131431;26401111;70610
FR;0;2021-07-16;377162;496376;1938;37508593;26897487;72548
FR;0;2021-07-17;258134;320111;833;37766727;27217598;73381
FR;0;2021-07-18;108886;115037;303;37875613;27332635;73684
FR;0;2021-07-19;283280;425588;1572;38158893;27758223;75256
FR;0;2021-07-20;374297;453213;1645;38533190;28211436;76901
FR;0;2021-07-21;393141;408540;1491;38926331;28619976;78392
FR;0;2021-07-22;438170;388594;1651;39364501;29008570;80043
FR;0;2021-07-23;436210;422954;1787;39800711;29431524;81830
FR;0;2021-07-24;284217;270050;766;40084928;29701574;82596
FR;0;2021-07-25;120273;80206;220;40205201;29781780;82816
FR;0;2021-07-26;345620;323812;1568;40550821;30105592;84384
FR;0;2021-07-27;461423;320755;1642;41012244;30426347;86026
FR;0;2021-07-28;456757;290292;1593;41469001;30716639;87619
FR;0;2021-07-29;486861;276771;1742;41955862;30993410;89361
FR;0;2021-07-30;457848;302735;1880;42413710;31296145;91241
FR;0;2021-07-31;284242;184964;878;42697952;31481109;92119
FR;0;2021-08-01;109282;50056;216;42807234;31531165;92335
FR;0;2021-08-02;328160;234235;1541;43135394;31765400;93876
FR;0;2021-08-03;391120;245225;1618;43526514;32010625;95494
FR;0;2021-08-04;379071;210245;1473;43905585;32220870;96967
FR;0;2021-08-05;361650;228702;1620;44267235;32449572;98587
FR;0;2021-08-06;354759;271916;1756;44621994;32721488;100343
FR;0;2021-08-07;210787;178611;727;44832781;32900099;101070
FR;0;2021-08-08;72134;63316;230;44904915;32963415;101300
FR;0;2021-08-09;254218;260075;1466;45159133;33223490;102766
FR;0;2021-08-10;301097;278648;1566;45460230;33502138;104332
FR;0;2021-08-11;274685;260769;1294;45734915;33762907;105626
FR;0;2021-08-12;266574;278355;1577;46001489;34041262;107203
FR;0;2021-08-13;247223;275477;1522;46248712;34316739;108725
FR;0;2021-08-14;141546;198384;693;46390258;34515123;109418
FR;0;2021-08-15;36840;50245;168;46427098;34565368;109586
FR;0;2021-08-16;179905;318604;1432;46607003;34883972;111018
FR;0;2021-08-17;211255;337013;1530;46818258;35220985;112548
FR;0;2021-08-18;194956;324820;1486;47013214;35545805;114034
FR;0;2021-08-19;188072;325441;1536;47201286;35871246;115570
FR;0;2021-08-20;180009;365042;1667;47381295;36236288;117237
FR;0;2021-08-21;102204;238072;641;47483499;36474360;117878
FR;0;2021-08-22;30994;87226;205;47514493;36561586;118083
FR;0;2021-08-23;136731;357067;1461;47651224;36918653;119544
FR;0;2021-08-24;158773;376947;1735;47809997;37295600;121279
FR;0;2021-08-25;147214;350646;1893;47957211;37646246;123172
FR;0;2021-08-26;139344;342106;2410;48096555;37988352;125582
FR;0;2021-08-27;144297;387188;2649;48240852;38375540;128231
FR;0;2021-08-28;88514;249524;1318;48329366;38625064;129549
FR;0;2021-08-29;26508;83206;461;48355874;38708270;130010
FR;0;2021-08-30;113980;324689;4494;48469854;39032959;134504
FR;0;2021-08-31;125613;334650;9687;48595467;39367609;144191
FR;0;2021-09-01;114577;285086;20969;48710044;39652695;165160
FR;0;2021-09-02;100036;247281;24702;48810080;39899976;189862
FR;0;2021-09-03;110909;292529;27677;48920989;40192505;217539
FR;0;2021-09-04;85731;217550;11872;49006720;40410055;229411
FR;0;2021-09-05;20272;45014;4114;49026992;40455069;233525
FR;0;2021-09-06;67257;181100;29709;49094249;40636169;263234
FR;0;2021-09-07;71872;181209;30311;49166121;40817378;293545
FR;0;2021-09-08;82110;206194;27129;49248231;41023572;320674
FR;0;2021-09-09;68373;164997;28911;49316604;41188569;349585
