fra;vaccin;jour;n_dose1;n_dose2;n_dose3;n_dose4;n_rappel;n_cum_dose1;n_cum_dose2;n_cum_dose3;n_cum_dose4;n_cum_rappel
FR;1;2020-12-27;609;0;0;0;0;609;0;0;0;0
FR;1;2020-12-28;676;1;0;0;0;1285;1;0;0;0
FR;1;2020-12-29;378;0;0;0;0;1663;1;0;0;0
FR;1;2020-12-30;441;0;0;0;0;2104;1;0;0;0
FR;1;2020-12-31;439;1;0;0;0;2543;2;0;0;0
FR;1;2021-01-01;1149;2;0;0;0;3692;4;0;0;0
FR;1;2021-01-02;362;3;0;0;0;4054;7;0;0;0
FR;1;2021-01-03;402;0;0;0;0;4456;7;0;0;0
FR;1;2021-01-04;2100;3;0;0;0;6556;10;0;0;0
FR;1;2021-01-05;7744;3;0;0;0;14300;13;0;0;0
FR;1;2021-01-06;12454;15;0;0;0;26754;28;0;0;0
FR;1;2021-01-07;29455;13;0;0;0;56209;41;0;0;0
FR;1;2021-01-08;37138;14;0;0;0;93347;55;0;0;0
FR;1;2021-01-09;11211;7;0;0;0;104558;62;0;0;0
FR;1;2021-01-10;6003;5;0;0;0;110561;67;0;0;0
FR;1;2021-01-11;39927;19;0;0;0;150488;86;0;0;0
FR;1;2021-01-12;62132;17;0;0;0;212620;103;0;0;0
FR;1;2021-01-13;65114;37;0;0;0;277734;140;0;0;0
FR;1;2021-01-14;81443;120;0;0;0;359177;260;0;0;0
FR;1;2021-01-15;68606;43;0;0;0;427783;303;0;0;0
FR;1;2021-01-16;19895;72;0;0;0;447678;375;0;0;0
FR;1;2021-01-17;10901;49;0;0;0;458579;424;0;0;0
FR;1;2021-01-18;82818;168;0;0;0;541397;592;0;0;0
FR;1;2021-01-19;125914;179;0;0;0;667311;771;0;0;0
FR;1;2021-01-20;132404;180;0;0;0;799715;951;0;0;0
FR;1;2021-01-21;153051;162;0;0;0;952766;1113;0;0;0
FR;1;2021-01-22;115938;209;0;0;0;1068704;1322;0;0;0
FR;1;2021-01-23;36606;67;0;0;0;1105310;1389;0;0;0
FR;1;2021-01-24;9581;91;0;0;0;1114891;1480;0;0;0
FR;1;2021-01-25;74417;1309;0;0;0;1189308;2789;0;0;0
FR;1;2021-01-26;96452;3401;1;0;0;1285760;6190;1;0;0
FR;1;2021-01-27;103634;6037;0;0;0;1389394;12227;1;0;0
FR;1;2021-01-28;120590;15275;0;0;0;1509984;27502;1;0;0
FR;1;2021-01-29;88884;17954;0;0;0;1598868;45456;1;0;0
FR;1;2021-01-30;27990;4371;0;0;0;1626858;49827;1;0;0
FR;1;2021-01-31;5186;1784;0;0;0;1632044;51611;1;0;0
FR;1;2021-02-01;49713;21786;0;0;0;1681757;73397;1;0;0
FR;1;2021-02-02;67803;36331;0;0;0;1749560;109728;1;0;0
FR;1;2021-02-03;67080;38622;0;0;0;1816640;148350;1;0;0
FR;1;2021-02-04;77129;52381;0;0;0;1893769;200731;1;0;0
FR;1;2021-02-05;63414;46509;0;0;0;1957183;247240;1;0;0
FR;1;2021-02-06;19413;10923;0;0;0;1976596;258163;1;0;0
FR;1;2021-02-07;3661;5495;0;0;0;1980257;263658;1;0;0
FR;1;2021-02-08;36490;47348;0;0;0;2016747;311006;1;0;0
FR;1;2021-02-09;50795;75488;0;0;0;2067542;386494;1;0;0
FR;1;2021-02-10;52054;80220;0;0;0;2119596;466714;1;0;0
FR;1;2021-02-11;63367;102135;0;0;0;2182963;568849;1;0;0
FR;1;2021-02-12;55848;75013;0;0;0;2238811;643862;1;0;0
FR;1;2021-02-13;15459;19331;0;0;0;2254270;663193;1;0;0
FR;1;2021-02-14;3746;7326;0;0;0;2258016;670519;1;0;0
FR;1;2021-02-15;24133;73618;0;0;0;2282149;744137;1;0;0
FR;1;2021-02-16;32766;96526;0;0;0;2314915;840663;1;0;0
FR;1;2021-02-17;35108;100797;20;0;0;2350023;941460;21;0;0
FR;1;2021-02-18;49440;116181;0;0;0;2399463;1057641;21;0;0
FR;1;2021-02-19;45373;87015;1;0;0;2444836;1144656;22;0;0
FR;1;2021-02-20;13383;27167;0;0;0;2458219;1171823;22;0;0
FR;1;2021-02-21;2456;6187;0;0;0;2460675;1178010;22;0;0
FR;1;2021-02-22;24716;69541;2;0;0;2485391;1247551;24;0;0
FR;1;2021-02-23;37423;80974;1;0;0;2522814;1328525;25;0;0
FR;1;2021-02-24;40684;78602;1;0;0;2563498;1407127;26;0;0
FR;1;2021-02-25;50144;87908;1;0;0;2613642;1495035;27;0;0
FR;1;2021-02-26;47203;67608;1;0;0;2660845;1562643;28;0;0
FR;1;2021-02-27;15670;21186;1;0;0;2676515;1583829;29;0;0
FR;1;2021-02-28;3553;4217;2;0;0;2680068;1588046;31;0;0
FR;1;2021-03-01;40168;49804;1;0;0;2720236;1637850;32;0;0
FR;1;2021-03-02;55968;62092;2;0;0;2776204;1699942;34;0;0
FR;1;2021-03-03;61229;60534;0;0;0;2837433;1760476;34;0;0
FR;1;2021-03-04;72986;66881;3;0;0;2910419;1827357;37;0;0
FR;1;2021-03-05;74747;58849;3;0;0;2985166;1886206;40;0;0
FR;1;2021-03-06;82446;15917;2;0;0;3067612;1902123;42;0;0
FR;1;2021-03-07;63717;4678;1;0;0;3131329;1906801;43;0;0
FR;1;2021-03-08;60157;41727;2;0;0;3191486;1948528;45;0;0
FR;1;2021-03-09;85980;47817;1;0;0;3277466;1996345;46;0;0
FR;1;2021-03-10;90898;47890;5;0;0;3368364;2044235;51;0;0
FR;1;2021-03-11;105054;54316;1;0;0;3473418;2098551;52;0;0
FR;1;2021-03-12;104102;45078;1;0;0;3577520;2143629;53;0;0
FR;1;2021-03-13;89188;12675;1;0;0;3666708;2156304;54;0;0
FR;1;2021-03-14;44450;2826;1;0;0;3711158;2159130;55;0;0
FR;1;2021-03-15;95495;28493;3;0;0;3806653;2187623;58;0;0
FR;1;2021-03-16;123582;34351;5;0;0;3930235;2221974;63;0;0
FR;1;2021-03-17;129290;34040;4;0;0;4059525;2256014;67;0;0
FR;1;2021-03-18;142874;39417;5;0;0;4202399;2295431;72;0;0
FR;1;2021-03-19;136228;32436;2;0;0;4338627;2327867;74;0;0
FR;1;2021-03-20;75986;9904;1;0;0;4414613;2337771;75;0;0
FR;1;2021-03-21;26502;2209;1;0;0;4441115;2339980;76;0;0
FR;1;2021-03-22;114740;30700;2;0;0;4555855;2370680;78;0;0
FR;1;2021-03-23;143012;38069;1;0;0;4698867;2408749;79;0;0
FR;1;2021-03-24;141980;38485;0;0;0;4840847;2447234;79;0;0
FR;1;2021-03-25;164989;39649;4;0;0;5005836;2486883;83;0;0
FR;1;2021-03-26;166379;37507;4;1;0;5172215;2524390;87;1;0
FR;1;2021-03-27;110871;15370;1;0;0;5283086;2539760;88;1;0
FR;1;2021-03-28;42299;4064;3;0;0;5325385;2543824;91;1;0
FR;1;2021-03-29;129800;49411;4;0;0;5455185;2593235;95;1;0
FR;1;2021-03-30;167705;63638;5;0;0;5622890;2656873;100;1;0
FR;1;2021-03-31;170914;67453;4;0;0;5793804;2724326;104;1;0
FR;1;2021-04-01;194764;81759;10;0;0;5988568;2806085;114;1;0
FR;1;2021-04-02;164432;85575;7;0;0;6153000;2891660;121;1;0
FR;1;2021-04-03;88236;58083;5;0;0;6241236;2949743;126;1;0
FR;1;2021-04-04;33648;17692;0;0;0;6274884;2967435;126;1;0
FR;1;2021-04-05;46392;9853;11;0;0;6321276;2977288;137;1;0
FR;1;2021-04-06;160289;103215;17;0;0;6481565;3080503;154;1;0
FR;1;2021-04-07;196966;108052;16;0;0;6678531;3188555;170;1;0
FR;1;2021-04-08;222088;113227;13;0;0;6900619;3301782;183;1;0
FR;1;2021-04-09;214538;107614;21;0;0;7115157;3409396;204;1;0
FR;1;2021-04-10;117165;73280;14;0;0;7232322;3482676;218;1;0
FR;1;2021-04-11;40881;30044;6;0;0;7273203;3512720;224;1;0
FR;1;2021-04-12;168445;104173;45;0;0;7441648;3616893;269;1;0
FR;1;2021-04-13;203777;127903;97;1;0;7645425;3744796;366;2;0
FR;1;2021-04-14;208596;122688;207;0;0;7854021;3867484;573;2;0
FR;1;2021-04-15;221645;127412;311;0;0;8075666;3994896;884;2;0
FR;1;2021-04-16;206032;125267;308;0;0;8281698;4120163;1192;2;0
FR;1;2021-04-17;122074;67172;103;0;0;8403772;4187335;1295;2;0
FR;1;2021-04-18;35958;20942;41;0;0;8439730;4208277;1336;2;0
FR;1;2021-04-19;163721;121652;432;0;0;8603451;4329929;1768;2;0
FR;1;2021-04-20;189387;149112;531;0;0;8792838;4479041;2299;2;0
FR;1;2021-04-21;193967;147116;758;0;0;8986805;4626157;3057;2;0
FR;1;2021-04-22;209000;163470;777;0;0;9195805;4789627;3834;2;0
FR;1;2021-04-23;198934;157297;671;0;0;9394739;4946924;4505;2;0
FR;1;2021-04-24;126322;95572;148;0;0;9521061;5042496;4653;2;0
FR;1;2021-04-25;53623;30013;46;0;0;9574684;5072509;4699;2;0
FR;1;2021-04-26;181116;138889;540;0;0;9755800;5211398;5239;2;0
FR;1;2021-04-27;221340;162084;900;0;0;9977140;5373482;6139;2;0
FR;1;2021-04-28;238269;155350;1311;1;1;10215409;5528832;7450;3;1
FR;1;2021-04-29;270256;160698;1208;0;0;10485665;5689530;8658;3;1
FR;1;2021-04-30;271954;148336;1071;0;0;10757619;5837866;9729;3;1
FR;1;2021-05-01;141137;40613;172;0;0;10898756;5878479;9901;3;1
FR;1;2021-05-02;81534;28118;81;0;0;10980290;5906597;9982;3;1
FR;1;2021-05-03;250759;144444;801;0;0;11231049;6051041;10783;3;1
FR;1;2021-05-04;265848;187175;1199;0;0;11496897;6238216;11982;3;1
FR;1;2021-05-05;283849;185129;1265;0;0;11780746;6423345;13247;3;1
FR;1;2021-05-06;309935;183575;1501;0;0;12090681;6606920;14748;3;1
FR;1;2021-05-07;284065;195891;1125;0;0;12374746;6802811;15873;3;1
FR;1;2021-05-08;191645;49448;285;0;0;12566391;6852259;16158;3;1
FR;1;2021-05-09;114048;35466;236;0;0;12680439;6887725;16394;3;1
FR;1;2021-05-10;258180;194255;1184;0;0;12938619;7081980;17578;3;1
FR;1;2021-05-11;318858;210961;1463;0;0;13257477;7292941;19041;3;1
FR;1;2021-05-12;356592;185806;1399;0;0;13614069;7478747;20440;3;1
FR;1;2021-05-13;283423;47608;399;0;0;13897492;7526355;20839;3;1
FR;1;2021-05-14;370464;128563;993;0;0;14267956;7654918;21832;3;1
FR;1;2021-05-15;298069;66129;403;0;0;14566025;7721047;22235;3;1
FR;1;2021-05-16;157760;15501;158;0;0;14723785;7736548;22393;3;1
FR;1;2021-05-17;318910;116242;1438;0;0;15042695;7852790;23831;3;1
FR;1;2021-05-18;383300;111325;1797;0;0;15425995;7964115;25628;3;1
FR;1;2021-05-19;395235;102266;2178;0;0;15821230;8066381;27806;3;1
FR;1;2021-05-20;421772;95967;2043;0;0;16243002;8162348;29849;3;1
FR;1;2021-05-21;399782;97209;1760;0;0;16642784;8259557;31609;3;1
FR;1;2021-05-22;275667;41977;602;0;0;16918451;8301534;32211;3;1
FR;1;2021-05-23;123006;11082;224;0;0;17041457;8312616;32435;3;1
FR;1;2021-05-24;243990;26259;568;0;0;17285447;8338875;33003;3;1
FR;1;2021-05-25;366212;131616;2110;1;0;17651659;8470491;35113;4;1
FR;1;2021-05-26;380789;126261;1991;0;0;18032448;8596752;37104;4;1
FR;1;2021-05-27;406118;128047;1975;0;0;18438566;8724799;39079;4;1
FR;1;2021-05-28;366004;145346;1698;0;0;18804570;8870145;40777;4;1
FR;1;2021-05-29;253812;80894;526;0;0;19058382;8951039;41303;4;1
FR;1;2021-05-30;100968;22568;157;0;0;19159350;8973607;41460;4;1
FR;1;2021-05-31;314291;148871;1281;1;1;19473641;9122478;42741;5;2
FR;1;2021-06-01;361576;166485;1725;1;1;19835217;9288963;44466;6;3
FR;1;2021-06-02;365344;153463;1793;0;0;20200561;9442426;46259;6;3
FR;1;2021-06-03;391351;147531;1651;0;0;20591912;9589957;47910;6;3
FR;1;2021-06-04;363837;175588;1493;1;1;20955749;9765545;49403;7;4
FR;1;2021-06-05;258485;112688;596;0;0;21214234;9878233;49999;7;4
FR;1;2021-06-06;126788;37549;215;0;0;21341022;9915782;50214;7;4
FR;1;2021-06-07;300593;207814;1363;0;0;21641615;10123596;51577;7;4
FR;1;2021-06-08;330666;220689;1642;0;0;21972281;10344285;53219;7;4
FR;1;2021-06-09;336491;211915;1609;0;0;22308772;10556200;54828;7;4
FR;1;2021-06-10;343828;201514;1610;0;0;22652600;10757714;56438;7;4
FR;1;2021-06-11;311846;235060;1297;0;0;22964446;10992774;57735;7;4
FR;1;2021-06-12;244052;150620;433;0;0;23208498;11143394;58168;7;4
FR;1;2021-06-13;100357;61000;188;0;0;23308855;11204394;58356;7;4
FR;1;2021-06-14;207798;288365;1317;1;0;23516653;11492759;59673;8;4
FR;1;2021-06-15;256800;281861;1392;1;0;23773453;11774620;61065;9;4
FR;1;2021-06-16;273615;270587;1263;1;0;24047068;12045207;62328;10;4
FR;1;2021-06-17;268165;244798;1234;1;0;24315233;12290005;63562;11;4
FR;1;2021-06-18;260562;295535;1152;1;0;24575795;12585540;64714;12;4
FR;1;2021-06-19;193436;209490;387;0;0;24769231;12795030;65101;12;4
FR;1;2021-06-20;69693;89120;117;0;0;24838924;12884150;65218;12;4
FR;1;2021-06-21;172329;319772;931;1;1;25011253;13203922;66149;13;5
FR;1;2021-06-22;185821;347848;1100;10;2;25197074;13551770;67249;23;7
FR;1;2021-06-23;204172;339484;1049;0;0;25401246;13891254;68298;23;7
FR;1;2021-06-24;203492;282061;1171;0;0;25604738;14173315;69469;23;7
FR;1;2021-06-25;182636;371775;1196;0;0;25787374;14545090;70665;23;7
FR;1;2021-06-26;131372;278361;503;0;0;25918746;14823451;71168;23;7
FR;1;2021-06-27;52394;122902;145;0;0;25971140;14946353;71313;23;7
FR;1;2021-06-28;136623;368168;1062;0;0;26107763;15314521;72375;23;7
FR;1;2021-06-29;154853;390853;1849;0;0;26262616;15705374;74224;23;7
FR;1;2021-06-30;180019;381108;1664;4;2;26442635;16086482;75888;27;9
FR;1;2021-07-01;201421;332217;1886;5;1;26644056;16418699;77774;32;10
FR;1;2021-07-02;193738;367557;1765;5;2;26837794;16786256;79539;37;12
FR;1;2021-07-03;124464;280439;704;3;1;26962258;17066695;80243;40;13
FR;1;2021-07-04;53927;113690;244;0;0;27016185;17180385;80487;40;13
FR;1;2021-07-05;153897;355980;1500;8;2;27170082;17536365;81987;48;15
FR;1;2021-07-06;173449;382455;1601;45;8;27343531;17918820;83588;93;23
FR;1;2021-07-07;190731;362493;1657;25;5;27534262;18281313;85245;118;28
FR;1;2021-07-08;201520;323085;1826;20;6;27735782;18604398;87071;138;34
FR;1;2021-07-09;189873;387818;1852;3;2;27925655;18992216;88923;141;36
FR;1;2021-07-10;129921;281165;814;1;1;28055576;19273381;89737;142;37
FR;1;2021-07-11;57662;102510;262;0;0;28113238;19375891;89999;142;37
FR;1;2021-07-12;149614;416987;1581;4;0;28262852;19792878;91580;146;37
FR;1;2021-07-13;234131;439344;1805;8;1;28496983;20232222;93385;154;38
FR;1;2021-07-14;171786;151467;417;0;0;28668769;20383689;93802;154;38
FR;1;2021-07-15;279561;424605;1858;1;0;28948330;20808294;95660;155;38
FR;1;2021-07-16;290322;401021;1711;3;1;29238652;21209315;97371;158;39
FR;1;2021-07-17;217293;282060;754;1;0;29455945;21491375;98125;159;39
FR;1;2021-07-18;101972;107264;288;0;0;29557917;21598639;98413;159;39
FR;1;2021-07-19;238099;378935;1496;3;0;29796016;21977574;99909;162;39
FR;1;2021-07-20;305635;380501;1469;0;0;30101651;22358075;101378;162;39
FR;1;2021-07-21;333165;353218;1412;4;2;30434816;22711293;102790;166;41
FR;1;2021-07-22;364581;319080;1502;3;2;30799397;23030373;104292;169;43
FR;1;2021-07-23;349287;343420;1587;4;1;31148684;23373793;105879;173;44
FR;1;2021-07-24;238927;240912;697;1;0;31387611;23614705;106576;174;44
FR;1;2021-07-25;112761;76029;221;0;0;31500372;23690734;106797;174;44
FR;1;2021-07-26;299047;289820;1496;2;2;31799419;23980554;108293;176;46
FR;1;2021-07-27;385751;268493;1457;4;2;32185170;24249047;109750;180;48
FR;1;2021-07-28;390131;251259;1460;4;2;32575301;24500306;111210;184;50
FR;1;2021-07-29;406050;228065;1538;2;1;32981351;24728371;112748;186;51
FR;1;2021-07-30;370637;246866;1637;4;1;33351988;24975237;114385;190;52
FR;1;2021-07-31;243361;165131;793;1;0;33595349;25140368;115178;191;52
FR;1;2021-08-01;105543;47227;233;0;0;33700892;25187595;115411;191;52
FR;1;2021-08-02;297091;213125;1477;2;0;33997983;25400720;116888;193;52
FR;1;2021-08-03;331239;208990;1547;2;1;34329222;25609710;118435;195;53
FR;1;2021-08-04;327917;184212;1438;5;3;34657139;25793922;119873;200;56
FR;1;2021-08-05;301182;193426;1482;0;0;34958321;25987348;121355;200;56
FR;1;2021-08-06;290887;224418;1560;3;1;35249208;26211766;122915;203;57
FR;1;2021-08-07;182623;158818;654;4;3;35431831;26370584;123569;207;60
FR;1;2021-08-08;68848;59124;250;0;0;35500679;26429708;123819;207;60
FR;1;2021-08-09;222693;235672;1442;4;3;35723372;26665380;125261;211;63
FR;1;2021-08-10;252639;240390;1489;2;1;35976011;26905770;126750;213;64
FR;1;2021-08-11;236137;232108;1271;5;1;36212148;27137878;128021;218;65
FR;1;2021-08-12;220705;240123;1486;3;1;36432853;27378001;129507;221;66
FR;1;2021-08-13;201661;238590;1357;2;2;36634514;27616591;130864;223;68
FR;1;2021-08-14;122834;174106;645;0;0;36757348;27790697;131509;223;68
FR;1;2021-08-15;34672;46130;199;1;0;36792020;27836827;131708;224;68
FR;1;2021-08-16;156894;289745;1421;0;0;36948914;28126572;133129;224;68
FR;1;2021-08-17;171541;291410;1422;5;1;37120455;28417982;134551;229;69
FR;1;2021-08-18;161365;286934;1392;6;3;37281820;28704916;135943;235;72
FR;1;2021-08-19;148871;277683;1400;1;0;37430691;28982599;137343;236;72
FR;1;2021-08-20;140453;309170;1529;2;2;37571144;29291769;138872;238;74
FR;1;2021-08-21;84250;213217;586;0;0;37655394;29504986;139458;238;74
FR;1;2021-08-22;28549;82692;232;0;0;37683943;29587678;139690;238;74
FR;1;2021-08-23;118611;321092;1422;2;1;37802554;29908770;141112;240;75
FR;1;2021-08-24;126616;319839;1602;5;1;37929170;30228609;142714;245;76
FR;1;2021-08-25;121486;306558;1779;8;3;38050656;30535167;144493;253;79
FR;1;2021-08-26;106565;286179;2159;10;0;38157221;30821346;146652;263;79
FR;1;2021-08-27;107616;321682;2301;9;3;38264837;31143028;148953;272;82
FR;1;2021-08-28;70993;220713;1099;0;0;38335830;31363741;150052;272;82
FR;1;2021-08-29;24139;78178;469;1;0;38359969;31441919;150521;273;82
FR;1;2021-08-30;96826;286497;4309;6;5098;38456795;31728416;154830;279;5180
FR;1;2021-08-31;98044;276360;9290;15;10139;38554839;32004776;164120;294;15319
FR;1;2021-09-01;112129;245360;21110;7;22120;38666968;32250136;185230;301;37439
FR;1;2021-09-02;85587;197989;24524;18;25476;38752555;32448125;209754;319;62915
FR;1;2021-09-03;82361;227607;26953;21;28005;38834916;32675732;236707;340;90920
FR;1;2021-09-04;71607;189726;11139;11;11671;38906523;32865458;247846;351;102591
FR;1;2021-09-05;18606;41157;4123;2;4279;38925129;32906615;251969;353;106870
FR;1;2021-09-06;59519;151556;30175;15;31169;38984648;33058171;282144;368;138039
FR;1;2021-09-07;57315;139704;30204;30;31168;39041963;33197875;312348;398;169207
FR;1;2021-09-08;71968;173852;26921;22;27906;39113931;33371727;339269;420;197113
FR;1;2021-09-09;54369;124550;28609;24;29680;39168300;33496277;367878;444;226793
FR;1;2021-09-10;66038;152127;30440;23;31624;39234338;33648404;398318;467;258417
FR;1;2021-09-11;52563;146614;9728;15;10328;39286901;33795018;408046;482;268745
FR;1;2021-09-12;10789;29258;2484;1;2642;39297690;33824276;410530;483;271387
FR;1;2021-09-13;51440;104535;38739;30;39987;39349130;33928811;449269;513;311374
FR;1;2021-09-14;53262;96076;51261;66;53017;39402392;34024887;500530;579;364391
FR;1;2021-09-15;60478;139303;50473;55;47004;39462870;34164190;551003;634;411395
FR;1;2021-09-16;46561;81439;53307;71;49511;39509431;34245629;604310;705;460906
FR;1;2021-09-17;53159;109394;45054;61;42658;39562590;34355023;649364;766;503564
FR;1;2021-09-18;37852;118496;11795;19;11264;39600442;34473519;661159;785;514828
FR;1;2021-09-19;6500;21037;2038;1;1974;39606942;34494556;663197;786;516802
FR;1;2021-09-20;36472;74913;46215;65;44150;39643414;34569469;709412;851;560952
FR;1;2021-09-21;34151;68156;56244;71;52660;39677565;34637625;765656;922;613612
FR;1;2021-09-22;38797;118584;49853;76;46848;39716362;34756209;815509;998;660460
FR;1;2021-09-23;31978;62871;54481;85;50856;39748340;34819080;869990;1083;711316
FR;1;2021-09-24;36757;90113;43649;89;41903;39785097;34909193;913639;1172;753219
FR;1;2021-09-25;27635;96674;12301;27;12172;39812732;35005867;925940;1199;765391
FR;1;2021-09-26;4365;15189;1772;5;1695;39817097;35021056;927712;1204;767086
FR;1;2021-09-27;27324;60218;42898;89;41596;39844421;35081274;970610;1293;808682
FR;1;2021-09-28;26877;49471;47174;75;44417;39871298;35130745;1017784;1368;853099
FR;1;2021-09-29;35871;80371;47256;87;45551;39907169;35211116;1065040;1455;898650
FR;1;2021-09-30;26027;46862;47514;80;45409;39933196;35257978;1112554;1535;944059
FR;1;2021-10-01;47247;65764;44871;83;44481;39980443;35323742;1157425;1618;988540
FR;1;2021-10-02;32358;62402;16108;32;16307;40012801;35386144;1173533;1650;1004847
FR;1;2021-10-03;4337;8566;2035;3;2030;40017138;35394710;1175568;1653;1006877
FR;1;2021-10-04;28900;44456;47091;79;46907;40046038;35439166;1222659;1732;1053784
FR;1;2021-10-05;24463;41627;49860;116;49222;40070501;35480793;1272519;1848;1103006
FR;1;2021-10-06;34600;61404;57474;102;57190;40105101;35542197;1329993;1950;1160196
FR;1;2021-10-07;21022;39860;53016;75;51864;40126123;35582057;1383009;2025;1212060
FR;1;2021-10-08;35451;59626;60379;83;61101;40161574;35641683;1443388;2108;1273161
FR;1;2021-10-09;27438;48009;25485;29;25992;40189012;35689692;1468873;2137;1299153
FR;1;2021-10-10;3700;5806;2748;7;2854;40192712;35695498;1471621;2144;1302007
FR;1;2021-10-11;24810;38183;54573;88;55192;40217522;35733681;1526194;2232;1357199
FR;1;2021-10-12;23303;36544;58041;127;59120;40240825;35770225;1584235;2359;1416319
FR;1;2021-10-13;32891;47847;64156;124;65648;40273716;35818072;1648391;2483;1481967
FR;1;2021-10-14;21642;34780;53738;103;54313;40295358;35852852;1702129;2586;1536280
FR;1;2021-10-15;32618;48820;72309;165;74951;40327976;35901672;1774438;2751;1611231
FR;1;2021-10-16;25978;35290;34860;44;36397;40353954;35936962;1809298;2795;1647628
FR;1;2021-10-17;3102;4058;3408;2;3315;40357056;35941020;1812706;2797;1650943
FR;1;2021-10-18;23767;34919;66816;131;69683;40380823;35975939;1879522;2928;1720626
FR;1;2021-10-19;20670;35295;75640;135;79548;40401493;36011234;1955162;3063;1800174
FR;1;2021-10-20;29855;44255;96159;178;99802;40431348;36055489;2051321;3241;1899976
FR;1;2021-10-21;19672;35078;83144;107;86998;40451020;36090567;2134465;3348;1986974
FR;1;2021-10-22;29626;47718;103715;196;109620;40480646;36138285;2238180;3544;2096594
FR;1;2021-10-23;23023;35156;44859;57;47365;40503669;36173441;2283039;3601;2143959
FR;1;2021-10-24;2375;3869;3579;6;3730;40506044;36177310;2286618;3607;2147689
FR;1;2021-10-25;22404;30789;82005;143;85791;40528448;36208099;2368623;3750;2233480
FR;1;2021-10-26;19313;27677;86077;162;90288;40547761;36235776;2454700;3912;2323768
FR;1;2021-10-27;26176;39672;107781;252;112649;40573937;36275448;2562481;4164;2436417
FR;1;2021-10-28;18770;27135;86915;150;91635;40592707;36302583;2649396;4314;2528052
FR;1;2021-10-29;25915;40280;114800;200;121576;40618622;36342863;2764196;4514;2649628
FR;1;2021-10-30;17686;28715;49352;74;51927;40636308;36371578;2813548;4588;2701555
FR;1;2021-10-31;2058;3183;3445;2;3680;40638366;36374761;2816993;4590;2705235
FR;1;2021-11-01;7850;4247;3027;3;3279;40646216;36379008;2820020;4593;2708514
FR;1;2021-11-02;22141;33247;92365;156;97736;40668357;36412255;2912385;4749;2806250
FR;1;2021-11-03;26524;41615;117466;215;123837;40694881;36453870;3029851;4964;2930087
FR;1;2021-11-04;19571;30335;105764;213;111870;40714452;36484205;3135615;5177;3041957
FR;1;2021-11-05;26958;42312;138744;229;147351;40741410;36526517;3274359;5406;3189308
FR;1;2021-11-06;18829;29843;63454;123;66444;40760239;36556360;3337813;5529;3255752
FR;1;2021-11-07;1799;3313;4964;6;5296;40762038;36559673;3342777;5535;3261048
FR;1;2021-11-08;17818;32306;125969;224;132572;40779856;36591979;3468746;5759;3393620
FR;1;2021-11-09;19454;37710;159259;334;169009;40799310;36629689;3628005;6093;3562629
FR;1;2021-11-10;28815;49208;181854;440;192415;40828125;36678897;3809859;6533;3755044
FR;1;2021-11-11;3963;5939;12208;26;13010;40832088;36684836;3822067;6559;3768054
FR;1;2021-11-12;25983;46853;174773;245;186395;40858071;36731689;3996840;6804;3954449
FR;1;2021-11-13;18718;29227;76808;111;81749;40876789;36760916;4073648;6915;4036198
FR;1;2021-11-14;2034;3288;6815;5;7369;40878823;36764204;4080463;6920;4043567
FR;1;2021-11-15;18711;34855;156372;304;166167;40897534;36799059;4236835;7224;4209734
FR;1;2021-11-16;21268;37923;192057;377;204863;40918802;36836982;4428892;7601;4414597
FR;1;2021-11-17;28563;45689;193184;399;204969;40947365;36882671;4622076;8000;4619566
FR;1;2021-11-18;21099;39105;182437;458;194444;40968464;36921776;4804513;8458;4814010
FR;1;2021-11-19;30803;53368;230188;530;246616;40999267;36975144;5034701;8988;5060626
FR;1;2021-11-20;23748;33301;96958;201;103598;41023015;37008445;5131659;9189;5164224
FR;1;2021-11-21;2320;3983;9101;19;9957;41025335;37012428;5140760;9208;5174181
FR;1;2021-11-22;21376;30480;175842;465;189366;41046711;37042908;5316602;9673;5363547
FR;1;2021-11-23;23909;41120;221129;539;237837;41070620;37084028;5537731;10212;5601384
FR;1;2021-11-24;30279;49807;217280;703;234422;41100899;37133835;5755011;10915;5835806
FR;1;2021-11-25;23564;44032;244409;718;264002;41124463;37177867;5999420;11633;6099808
FR;1;2021-11-26;30594;66795;356728;833;388422;41155057;37244662;6356148;12466;6488230
FR;1;2021-11-27;21849;45392;202583;371;222567;41176906;37290054;6558731;12837;6710797
FR;1;2021-11-28;3158;9643;54765;63;61019;41180064;37299697;6613496;12900;6771816
FR;1;2021-11-29;17863;49537;326318;840;354350;41197927;37349234;6939814;13740;7126166
FR;1;2021-11-30;22752;65006;431077;952;470679;41220679;37414240;7370891;14692;7596845
FR;1;2021-12-01;25190;69382;442802;1129;481663;41245869;37483622;7813693;15821;8078508
FR;1;2021-12-02;20045;64588;489307;1228;532769;41265914;37548210;8303000;17049;8611277
FR;1;2021-12-03;22871;82087;542662;1308;591694;41288785;37630297;8845662;18357;9202971
FR;1;2021-12-04;16385;53973;299049;653;328890;41305170;37684270;9144711;19010;9531861
FR;1;2021-12-05;3629;13895;81505;143;91056;41308799;37698165;9226216;19153;9622917
FR;1;2021-12-06;24033;62702;415363;1065;455062;41332832;37760867;9641579;20218;10077979
FR;1;2021-12-07;19938;75802;522873;1534;572500;41352770;37836669;10164452;21752;10650479
FR;1;2021-12-08;21645;75851;458290;1544;502005;41374415;37912520;10622742;23296;11152484
FR;1;2021-12-09;19419;74099;492841;1626;540715;41393834;37986619;11115583;24922;11693199
FR;1;2021-12-10;23253;87816;547328;1585;599936;41417087;38074435;11662911;26507;12293135
FR;1;2021-12-11;16529;59135;302704;748;335452;41433616;38133570;11965615;27255;12628587
FR;1;2021-12-12;4347;16018;83189;179;94061;41437963;38149588;12048804;27434;12722648
FR;1;2021-12-13;15727;63793;366880;1093;406198;41453690;38213381;12415684;28527;13128846
FR;1;2021-12-14;20735;80442;464615;1744;515098;41474425;38293823;12880299;30271;13643944
FR;1;2021-12-15;21554;77563;408980;1309;453059;41495979;38371386;13289279;31580;14097003
FR;1;2021-12-16;20017;77432;451767;1577;500535;41515996;38448818;13741046;33157;14597538
FR;1;2021-12-17;22561;86782;479850;1733;530934;41538557;38535600;14220896;34890;15128472
FR;1;2021-12-18;17594;54754;257577;730;288487;41556151;38590354;14478473;35620;15416959
FR;1;2021-12-19;5547;17112;79143;194;90724;41561698;38607466;14557616;35814;15507683
FR;1;2021-12-20;20887;63239;316156;1080;355238;41582585;38670705;14873772;36894;15862921
FR;1;2021-12-21;26203;73226;372665;1420;418011;41608788;38743931;15246437;38314;16280932
FR;1;2021-12-22;24927;66052;310556;1215;349561;41633715;38809983;15556993;39529;16630493
FR;1;2021-12-23;21254;52422;241429;953;273021;41654969;38862405;15798422;40482;16903514
FR;1;2021-12-24;7111;18367;67128;258;77046;41662080;38880772;15865550;40740;16980560
FR;1;2021-12-25;503;2815;5577;15;6535;41662583;38883587;15871127;40755;16987095
FR;1;2021-12-26;2749;7585;26929;70;31445;41665332;38891172;15898056;40825;17018540
FR;1;2021-12-27;18241;53603;235059;706;265725;41683573;38944775;16133115;41531;17284265
FR;1;2021-12-28;23264;62081;291989;1026;330178;41706837;39006856;16425104;42557;17614443
FR;1;2021-12-29;22204;55614;254946;918;288169;41729041;39062470;16680050;43475;17902612
FR;1;2021-12-30;21231;46584;212121;857;239594;41750272;39109054;16892171;44332;18142206
FR;1;2021-12-31;7461;16609;61845;229;70383;41757733;39125663;16954016;44561;18212589
FR;1;2022-01-01;1042;2497;5649;30;6584;41758775;39128160;16959665;44591;18219173
FR;1;2022-01-02;3058;8054;28882;50;33522;41761833;39136214;16988547;44641;18252695
FR;1;2022-01-03;22394;54193;228187;786;257629;41784227;39190407;17216734;45427;18510324
FR;1;2022-01-04;25517;64965;299192;1237;337236;41809744;39255372;17515926;46664;18847560
FR;1;2022-01-05;30027;64122;274807;1097;310153;41839771;39319494;17790733;47761;19157713
FR;1;2022-01-06;26743;66147;306836;1397;346481;41866514;39385641;18097569;49158;19504194
FR;1;2022-01-07;31516;74947;349784;1535;393923;41898030;39460588;18447353;50693;19898117
FR;1;2022-01-08;23373;51409;222477;696;251101;41921403;39511997;18669830;51389;20149218
FR;1;2022-01-09;7076;17158;66014;163;76136;41928479;39529155;18735844;51552;20225354
FR;1;2022-01-10;21702;60069;236729;953;267545;41950181;39589224;18972573;52505;20492899
FR;1;2022-01-11;26609;63492;282231;1277;317790;41976790;39652716;19254804;53782;20810689
FR;1;2022-01-12;28849;62459;246187;1104;277965;42005639;39715175;19500991;54886;21088654
FR;1;2022-01-13;24683;60062;262757;1252;296084;42030322;39775237;19763748;56138;21384738
FR;1;2022-01-14;27927;66649;313929;1366;351205;42058249;39841886;20077677;57504;21735943
FR;1;2022-01-15;19318;44389;199289;619;223865;42077567;39886275;20276966;58123;21959808
FR;1;2022-01-16;5139;12969;51511;135;59570;42082706;39899244;20328477;58258;22019378
FR;1;2022-01-17;16829;39765;184798;780;206849;42099535;39939009;20513275;59038;22226227
FR;1;2022-01-18;19359;45879;212374;1151;236997;42118894;39984888;20725649;60189;22463224
FR;1;2022-01-19;20270;43976;176065;897;197177;42139164;40028864;20901714;61086;22660401
FR;1;2022-01-20;16759;40549;183621;1137;204713;42155923;40069413;21085335;62223;22865114
FR;1;2022-01-21;19887;47006;228917;1406;253320;42175810;40116419;21314252;63629;23118434
FR;1;2022-01-22;13833;33343;144479;578;161375;42189643;40149762;21458731;64207;23279809
FR;1;2022-01-23;3349;8789;33414;131;38327;42192992;40158551;21492145;64338;23318136
FR;1;2022-01-24;11787;32958;142173;708;158239;42204779;40191509;21634318;65046;23476375
FR;1;2022-01-25;14171;38222;163357;1048;181540;42218950;40229731;21797675;66094;23657915
FR;1;2022-01-26;14853;37563;150224;932;166307;42233803;40267294;21947899;67026;23824222
FR;1;2022-01-27;12320;33113;143419;885;157922;42246123;40300407;22091318;67911;23982144
FR;1;2022-01-28;16298;55449;198271;1144;222440;42262421;40355856;22289589;69055;24204584
FR;1;2022-01-29;10263;35443;135186;522;151542;42272684;40391299;22424775;69577;24356126
FR;1;2022-01-30;2479;9276;29673;86;34463;42275163;40400575;22454448;69663;24390589
FR;1;2022-01-31;8745;32369;104319;531;117390;42283908;40432944;22558767;70194;24507979
FR;1;2022-02-01;10690;36417;127043;862;141247;42294598;40469361;22685810;71056;24649226
FR;1;2022-02-02;11756;41426;130335;780;145874;42306354;40510787;22816145;71836;24795100
FR;1;2022-02-03;9097;33662;116984;782;130359;42315451;40544449;22933129;72618;24925459
FR;1;2022-02-04;11493;48180;172551;966;192786;42326944;40592629;23105680;73584;25118245
FR;1;2022-02-05;7984;33965;117563;391;133061;42334928;40626594;23223243;73975;25251306
FR;1;2022-02-06;1695;8026;22741;85;26906;42336623;40634620;23245984;74060;25278212
FR;1;2022-02-07;7252;35459;119065;452;134977;42343875;40670079;23365049;74512;25413189
FR;1;2022-02-08;7640;31804;125616;693;140599;42351515;40701883;23490665;75205;25553788
FR;1;2022-02-09;8543;36400;135229;695;152465;42360058;40738283;23625894;75900;25706253
FR;1;2022-02-10;6727;29630;116334;673;130113;42366785;40767913;23742228;76573;25836366
FR;1;2022-02-11;8632;41468;165091;877;185309;42375417;40809381;23907319;77450;26021675
FR;1;2022-02-12;5306;27566;106680;378;120858;42380723;40836947;24013999;77828;26142533
FR;1;2022-02-13;1226;5709;21711;65;25325;42381949;40842656;24035710;77893;26167858
FR;1;2022-02-14;5424;27164;118055;392;133081;42387373;40869820;24153765;78285;26300939
FR;1;2022-02-15;5652;28498;118882;610;132500;42393025;40898318;24272647;78895;26433439
FR;1;2022-02-16;5689;28360;110397;595;123023;42398714;40926678;24383044;79490;26556462
FR;1;2022-02-17;4493;19611;73111;487;80206;42403207;40946289;24456155;79977;26636668
FR;1;2022-02-18;5564;26721;99166;670;108123;42408771;40973010;24555321;80647;26744791
FR;1;2022-02-19;3542;17156;59470;304;66047;42412313;40990166;24614791;80951;26810838
FR;1;2022-02-20;787;3245;10695;35;12317;42413100;40993411;24625486;80986;26823155
FR;1;2022-02-21;3378;14567;52809;286;57656;42416478;41007978;24678295;81272;26880811
FR;1;2022-02-22;3732;15458;51885;499;55616;42420210;41023436;24730180;81771;26936427
FR;1;2022-02-23;4175;17760;57459;508;62561;42424385;41041196;24787639;82279;26998988
FR;1;2022-02-24;3263;13015;43590;435;46379;42427648;41054211;24831229;82714;27045367
FR;1;2022-02-25;4427;19739;64877;695;68740;42432075;41073950;24896106;83409;27114107
FR;1;2022-02-26;2684;12793;41352;309;45105;42434759;41086743;24937458;83718;27159212
FR;1;2022-02-27;641;2181;7119;42;7984;42435400;41088924;24944577;83760;27167196
FR;1;2022-02-28;2579;10434;34936;303;37361;42437979;41099358;24979513;84063;27204557
FR;1;2022-03-01;3206;10578;38673;390;39609;42441185;41109936;25018186;84453;27244166
FR;1;2022-03-02;3559;12065;41832;393;43895;42444744;41122001;25060018;84846;27288061
FR;1;2022-03-03;2369;7866;26147;324;26477;42447113;41129867;25086165;85170;27314538
FR;1;2022-03-04;2667;10363;35409;589;34900;42449780;41140230;25121574;85759;27349438
FR;1;2022-03-05;1812;6328;21952;278;22343;42451592;41146558;25143526;86037;27371781
FR;1;2022-03-06;352;948;2914;38;3115;42451944;41147506;25146440;86075;27374896
FR;1;2022-03-07;1617;4642;16422;245;15885;42453561;41152148;25162862;86320;27390781
FR;1;2022-03-08;1599;5182;17143;307;15966;42455160;41157330;25180005;86627;27406747
FR;1;2022-03-09;1910;6585;19794;368;19146;42457070;41163915;25199799;86995;27425893
FR;1;2022-03-10;1319;4671;15258;306;14290;42458389;41168586;25215057;87301;27440183
FR;1;2022-03-11;1702;6358;21692;481;19842;42460091;41174944;25236749;87782;27460025
FR;1;2022-03-12;1227;4639;15355;278;14905;42461318;41179583;25252104;88060;27474930
FR;1;2022-03-13;242;607;2113;117;2061;42461560;41180190;25254217;88177;27476991
FR;1;2022-03-14;1088;3630;13380;3876;12504;42462648;41183820;25267597;92053;27489495
FR;1;2022-03-15;1284;4018;14611;6862;13097;42463932;41187838;25282208;98915;27502592
FR;1;2022-03-16;1631;4873;17367;11513;16422;42465563;41192711;25299575;110428;27519014
FR;1;2022-03-17;1116;3288;11700;9642;10798;42466679;41195999;25311275;120070;27529812
FR;1;2022-03-18;1681;4814;17935;16487;16369;42468360;41200813;25329210;136557;27546181
FR;1;2022-03-19;1120;3267;11885;8452;11353;42469480;41204080;25341095;145009;27557534
FR;1;2022-03-20;220;542;1721;1012;1755;42469700;41204622;25342816;146021;27559289
FR;1;2022-03-21;1047;2709;11483;13444;10828;42470747;41207331;25354299;159465;27570117
FR;1;2022-03-22;1195;3113;12236;18685;11225;42471942;41210444;25366535;178150;27581342
FR;1;2022-03-23;1475;4227;15999;20099;15680;42473417;41214671;25382534;198249;27597022
FR;1;2022-03-24;1077;2574;10376;16022;9626;42474494;41217245;25392910;214271;27606648
FR;1;2022-03-25;1505;4091;16702;25292;15349;42475999;41221336;25409612;239563;27621997
FR;1;2022-03-26;1100;2981;10845;11436;10506;42477099;41224317;25420457;250999;27632503
FR;1;2022-03-27;229;539;1738;1379;1790;42477328;41224856;25422195;252378;27634293
FR;1;2022-03-28;1040;2448;9957;15875;9579;42478368;41227304;25432152;268253;27643872
FR;1;2022-03-29;1118;2721;11542;25076;10905;42479486;41230025;25443694;293329;27654777
FR;1;2022-03-30;1609;3494;14142;24165;13676;42481095;41233519;25457836;317494;27668453
FR;1;2022-03-31;1274;2740;11669;22609;11177;42482369;41236259;25469505;340103;27679630
FR;1;2022-04-01;1971;3966;18434;28486;17293;42484340;41240225;25487939;368589;27696923
FR;1;2022-04-02;900;1864;8185;9213;7933;42485240;41242089;25496124;377802;27704856
FR;1;2022-04-03;197;369;1430;1054;1430;42485437;41242458;25497554;378856;27706286
FR;1;2022-04-04;1346;2286;11317;17636;10689;42486783;41244744;25508871;396492;27716975
FR;1;2022-04-05;1336;2578;12967;31138;11990;42488119;41247322;25521838;427630;27728965
FR;1;2022-04-06;1346;2815;12169;23827;11592;42489465;41250137;25534007;451457;27740557
FR;1;2022-04-07;1155;2594;12308;31005;11772;42490620;41252731;25546315;482462;27752329
FR;1;2022-04-08;1571;3521;17518;40536;16426;42492191;41256252;25563833;522998;27768755
FR;1;2022-04-09;811;1980;8391;12484;8088;42493002;41258232;25572224;535482;27776843
FR;1;2022-04-10;192;482;1828;1833;1870;42493194;41258714;25574052;537315;27778713
FR;1;2022-04-11;964;2144;10945;22201;10653;42494158;41260858;25584997;559516;27789366
FR;1;2022-04-12;1226;2424;12763;37950;12259;42495384;41263282;25597760;597466;27801625
FR;1;2022-04-13;1186;2678;12232;30521;11955;42496570;41265960;25609992;627987;27813580
FR;1;2022-04-14;1180;2376;12032;33433;12040;42497750;41268336;25622024;661420;27825620
FR;1;2022-04-15;1444;2868;14358;33152;13731;42499194;41271204;25636382;694572;27839351
FR;1;2022-04-16;653;1388;5831;7976;5751;42499847;41272592;25642213;702548;27845102
FR;1;2022-04-17;150;272;929;1116;971;42499997;41272864;25643142;703664;27846073
FR;1;2022-04-18;130;411;2628;996;2652;42500127;41273275;25645770;704660;27848725
FR;1;2022-04-19;1209;2528;11753;27771;11442;42501336;41275803;25657523;732431;27860167
FR;1;2022-04-20;1292;2562;12142;26783;11968;42502628;41278365;25669665;759214;27872135
FR;1;2022-04-21;1215;2381;11490;33032;11642;42503843;41280746;25681155;792246;27883777
FR;1;2022-04-22;1487;3015;15173;35394;14760;42505330;41283761;25696328;827640;27898537
FR;1;2022-04-23;753;1563;6721;9884;6627;42506083;41285324;25703049;837524;27905164
FR;1;2022-04-24;194;359;1372;1518;1324;42506277;41285683;25704421;839042;27906488
FR;1;2022-04-25;999;2065;9841;19603;9738;42507276;41287748;25714262;858645;27916226
FR;1;2022-04-26;1303;2586;12576;36498;12178;42508579;41290334;25726838;895143;27928404
FR;1;2022-04-27;1295;2369;10616;29098;10755;42509874;41292703;25737454;924241;27939159
FR;1;2022-04-28;1255;2308;11529;34042;11356;42511129;41295011;25748983;958283;27950515
FR;1;2022-04-29;1584;3165;14371;35369;13800;42512713;41298176;25763354;993652;27964315
FR;1;2022-04-30;818;1442;6429;9149;6273;42513531;41299618;25769783;1002801;27970588
FR;1;2022-05-01;168;277;817;946;813;42513699;41299895;25770600;1003747;27971401
FR;1;2022-05-02;977;2219;10312;16813;10198;42514676;41302114;25780912;1020560;27981599
FR;1;2022-05-03;1426;2742;12633;32703;12527;42516102;41304856;25793545;1053263;27994126
FR;1;2022-05-04;1296;2580;11169;23670;11328;42517398;41307436;25804714;1076933;28005454
FR;1;2022-05-05;1350;2431;12026;31543;11915;42518748;41309867;25816740;1108476;28017369
FR;1;2022-05-06;1690;3142;14172;34725;13734;42520438;41313009;25830912;1143201;28031103
FR;1;2022-05-07;839;1455;5956;9076;5987;42521277;41314464;25836868;1152277;28037090
FR;1;2022-05-08;185;323;1056;1456;1117;42521462;41314787;25837924;1153733;28038207
FR;1;2022-05-09;1033;1893;9213;19130;9124;42522495;41316680;25847137;1172863;28047331
FR;1;2022-05-10;1388;2549;12496;36859;12079;42523883;41319229;25859633;1209722;28059410
FR;1;2022-05-11;1385;2242;9845;25859;9751;42525268;41321471;25869478;1235581;28069161
FR;1;2022-05-12;1266;2269;10414;33313;10115;42526534;41323740;25879892;1268894;28079276
FR;1;2022-05-13;1585;2716;12729;35569;12368;42528119;41326456;25892621;1304463;28091644
FR;1;2022-05-14;768;1287;5468;10192;5345;42528887;41327743;25898089;1314655;28096989
FR;1;2022-05-15;214;381;1171;1345;1232;42529101;41328124;25899260;1316000;28098221
FR;1;2022-05-16;943;1686;8025;19955;8064;42530044;41329810;25907285;1335955;28106285
FR;1;2022-05-17;1250;2198;11075;35953;10675;42531294;41332008;25918360;1371908;28116960
FR;1;2022-05-18;1267;2027;8983;25564;8942;42532561;41334035;25927343;1397472;28125902
FR;1;2022-05-19;1162;2295;9788;33730;9850;42533723;41336330;25937131;1431202;28135752
FR;1;2022-05-20;1535;2669;12376;37514;11962;42535258;41338999;25949507;1468716;28147714
FR;1;2022-05-21;762;1353;5232;9367;5149;42536020;41340352;25954739;1478083;28152863
FR;1;2022-05-22;189;281;942;1384;943;42536209;41340633;25955681;1479467;28153806
FR;1;2022-05-23;939;1775;8344;19305;8281;42537148;41342408;25964025;1498772;28162087
FR;1;2022-05-24;1258;2389;10663;36970;10516;42538406;41344797;25974688;1535742;28172603
FR;1;2022-05-25;1249;2218;8752;23562;8892;42539655;41347015;25983440;1559304;28181495
FR;1;2022-05-26;155;292;1556;1098;1545;42539810;41347307;25984996;1560402;28183040
FR;1;2022-05-27;1083;2101;8735;20392;8487;42540893;41349408;25993731;1580794;28191527
FR;1;2022-05-28;480;1029;3677;6522;3715;42541373;41350437;25997408;1587316;28195242
FR;1;2022-05-29;113;250;701;887;708;42541486;41350687;25998109;1588203;28195950
FR;1;2022-05-30;802;1687;6532;18482;6556;42542288;41352374;26004641;1606685;28202506
FR;1;2022-05-31;1246;2123;9196;34200;9073;42543534;41354497;26013837;1640885;28211579
FR;1;2022-06-01;1189;2272;10326;23252;10171;42544723;41356769;26024163;1664137;28221750
FR;1;2022-06-02;1171;2204;10543;33969;10109;42545894;41358973;26034706;1698106;28231859
FR;1;2022-06-03;1341;2657;12584;37023;12014;42547235;41361630;26047290;1735129;28243873
FR;1;2022-06-04;658;1246;4675;8628;4749;42547893;41362876;26051965;1743757;28248622
FR;1;2022-06-05;122;278;804;1043;825;42548015;41363154;26052769;1744800;28249447
FR;1;2022-06-06;142;339;1952;1160;1927;42548157;41363493;26054721;1745960;28251374
FR;1;2022-06-07;1107;2206;9098;33958;8764;42549264;41365699;26063819;1779918;28260138
FR;1;2022-06-08;1067;2143;8557;27463;8436;42550331;41367842;26072376;1807381;28268574
FR;1;2022-06-09;1031;2076;9832;37352;9492;42551362;41369918;26082208;1844733;28278066
FR;1;2022-06-10;1289;2503;12026;42946;11614;42552651;41372421;26094234;1887679;28289680
FR;1;2022-06-11;639;1426;5116;11059;5158;42553290;41373847;26099350;1898738;28294838
FR;1;2022-06-12;140;354;1000;1675;1057;42553430;41374201;26100350;1900413;28295895
FR;1;2022-06-13;868;1707;6876;22146;6731;42554298;41375908;26107226;1922559;28302626
FR;1;2022-06-14;1048;2096;9714;42656;9121;42555346;41378004;26116940;1965215;28311747
FR;1;2022-06-15;1011;1845;8350;29163;8048;42556357;41379849;26125290;1994378;28319795
FR;1;2022-06-16;908;1754;9139;38277;8613;42557265;41381603;26134429;2032655;28328408
FR;1;2022-06-17;1181;2483;11519;44650;11006;42558446;41384086;26145948;2077305;28339414
FR;1;2022-06-18;539;1241;4295;10522;4230;42558985;41385327;26150243;2087827;28343644
FR;1;2022-06-19;127;312;990;1536;1066;42559112;41385639;26151233;2089363;28344710
FR;1;2022-06-20;818;1625;8051;24863;7726;42559930;41387264;26159284;2114226;28352436
FR;1;2022-06-21;1060;2067;9662;47607;8759;42560990;41389331;26168946;2161833;28361195
FR;1;2022-06-22;993;1960;8253;36921;7727;42561983;41391291;26177199;2198754;28368922
FR;1;2022-06-23;1015;2071;9889;52564;9153;42562998;41393362;26187088;2251318;28378075
FR;1;2022-06-24;1214;2628;12704;65695;11492;42564212;41395990;26199792;2317013;28389567
FR;1;2022-06-25;660;1475;5854;18877;5643;42564872;41397465;26205646;2335890;28395210
FR;1;2022-06-26;161;387;1683;3482;1586;42565033;41397852;26207329;2339372;28396796
FR;1;2022-06-27;898;1701;9039;45725;8313;42565931;41399553;26216368;2385097;28405109
FR;1;2022-06-28;1180;2493;13523;86133;12105;42567111;41402046;26229891;2471230;28417214
FR;1;2022-06-29;1196;2248;11251;66986;10325;42568307;41404294;26241142;2538216;28427539
FR;1;2022-06-30;1236;2290;13055;89602;11422;42569543;41406584;26254197;2627818;28438961
FR;1;2022-07-01;1499;2886;16164;108598;14026;42571042;41409470;26270361;2736416;28452987
FR;1;2022-07-02;723;1475;7390;33580;6641;42571765;41410945;26277751;2769996;28459628
FR;1;2022-07-03;223;453;1897;6033;1706;42571988;41411398;26279648;2776029;28461334
FR;1;2022-07-04;1156;2180;12243;75002;10702;42573144;41413578;26291891;2851031;28472036
FR;1;2022-07-05;1356;2608;16485;125169;13960;42574500;41416186;26308376;2976200;28485996
FR;1;2022-07-06;1287;2206;13710;92571;11733;42575787;41418392;26322086;3068771;28497729
FR;1;2022-07-07;1366;2387;15910;118022;13041;42577153;41420779;26337996;3186793;28510770
FR;1;2022-07-08;1437;2676;18379;128273;14796;42578590;41423455;26356375;3315066;28525566
FR;1;2022-07-09;639;1213;6996;35428;6051;42579229;41424668;26363371;3350494;28531617
FR;1;2022-07-10;208;425;2120;6457;1917;42579437;41425093;26365491;3356951;28533534
FR;1;2022-07-11;1105;2007;13273;82695;11037;42580542;41427100;26378764;3439646;28544571
FR;1;2022-07-12;1378;2521;18052;131871;14575;42581920;41429621;26396816;3571517;28559146
FR;2;2020-12-27;0;0;0;0;0;0;0;0;0;0
FR;2;2020-12-28;0;0;0;0;0;0;0;0;0;0
FR;2;2020-12-29;0;0;0;0;0;0;0;0;0;0
FR;2;2020-12-30;0;0;0;0;0;0;0;0;0;0
FR;2;2020-12-31;0;0;0;0;0;0;0;0;0;0
FR;2;2021-01-01;0;0;0;0;0;0;0;0;0;0
FR;2;2021-01-02;0;0;0;0;0;0;0;0;0;0
FR;2;2021-01-03;0;0;0;0;0;0;0;0;0;0
FR;2;2021-01-04;0;0;0;0;0;0;0;0;0;0
FR;2;2021-01-05;0;0;0;0;0;0;0;0;0;0
FR;2;2021-01-06;0;0;0;0;0;0;0;0;0;0
FR;2;2021-01-07;0;0;0;0;0;0;0;0;0;0
FR;2;2021-01-08;0;0;0;0;0;0;0;0;0;0
FR;2;2021-01-09;0;0;0;0;0;0;0;0;0;0
FR;2;2021-01-10;0;0;0;0;0;0;0;0;0;0
FR;2;2021-01-11;0;0;0;0;0;0;0;0;0;0
FR;2;2021-01-12;0;0;0;0;0;0;0;0;0;0
FR;2;2021-01-13;0;0;0;0;0;0;0;0;0;0
FR;2;2021-01-14;1672;0;0;0;0;1672;0;0;0;0
FR;2;2021-01-15;397;0;0;0;0;2069;0;0;0;0
FR;2;2021-01-16;315;0;0;0;0;2384;0;0;0;0
FR;2;2021-01-17;81;0;0;0;0;2465;0;0;0;0
FR;2;2021-01-18;3074;2;0;0;0;5539;2;0;0;0
FR;2;2021-01-19;4680;0;0;0;0;10219;2;0;0;0
FR;2;2021-01-20;5135;6;0;0;0;15354;8;0;0;0
FR;2;2021-01-21;5341;9;0;0;0;20695;17;0;0;0
FR;2;2021-01-22;5118;11;0;0;0;25813;28;0;0;0
FR;2;2021-01-23;1870;1;0;0;0;27683;29;0;0;0
FR;2;2021-01-24;160;2;0;0;0;27843;31;0;0;0
FR;2;2021-01-25;3812;3;0;0;0;31655;34;0;0;0
FR;2;2021-01-26;3920;5;0;0;0;35575;39;0;0;0
FR;2;2021-01-27;3599;2;0;0;0;39174;41;0;0;0
FR;2;2021-01-28;3750;8;0;0;0;42924;49;0;0;0
FR;2;2021-01-29;3294;2;0;0;0;46218;51;0;0;0
FR;2;2021-01-30;1130;2;0;0;0;47348;53;0;0;0
FR;2;2021-01-31;45;2;0;0;0;47393;55;0;0;0
FR;2;2021-02-01;3401;7;0;0;0;50794;62;0;0;0
FR;2;2021-02-02;4490;13;0;0;0;55284;75;0;0;0
FR;2;2021-02-03;5219;7;0;0;0;60503;82;0;0;0
FR;2;2021-02-04;4933;10;0;0;0;65436;92;0;0;0
FR;2;2021-02-05;4811;13;0;0;0;70247;105;0;0;0
FR;2;2021-02-06;2040;14;0;0;0;72287;119;0;0;0
FR;2;2021-02-07;101;4;0;0;0;72388;123;0;0;0
FR;2;2021-02-08;7554;22;0;0;0;79942;145;0;0;0
FR;2;2021-02-09;8424;27;0;0;0;88366;172;0;0;0
FR;2;2021-02-10;9341;58;0;0;0;97707;230;0;0;0
FR;2;2021-02-11;10284;109;0;0;0;107991;339;0;0;0
FR;2;2021-02-12;10055;266;0;0;0;118046;605;0;0;0
FR;2;2021-02-13;3120;223;0;0;0;121166;828;0;0;0
FR;2;2021-02-14;355;9;0;0;0;121521;837;0;0;0
FR;2;2021-02-15;3456;3106;0;0;0;124977;3943;0;0;0
FR;2;2021-02-16;5071;4081;0;0;0;130048;8024;0;0;0
FR;2;2021-02-17;4255;4499;0;0;0;134303;12523;0;0;0
FR;2;2021-02-18;5400;5138;0;0;0;139703;17661;0;0;0
FR;2;2021-02-19;5324;4427;0;0;0;145027;22088;0;0;0
FR;2;2021-02-20;1869;1516;0;0;0;146896;23604;0;0;0
FR;2;2021-02-21;242;90;0;0;0;147138;23694;0;0;0
FR;2;2021-02-22;3612;3764;0;0;0;150750;27458;0;0;0
FR;2;2021-02-23;4954;3716;0;0;0;155704;31174;0;0;0
FR;2;2021-02-24;5010;3507;0;0;0;160714;34681;0;0;0
FR;2;2021-02-25;5486;3465;0;0;0;166200;38146;0;0;0
FR;2;2021-02-26;4362;3161;0;0;0;170562;41307;0;0;0
FR;2;2021-02-27;1624;1058;0;0;0;172186;42365;0;0;0
FR;2;2021-02-28;177;27;0;0;0;172363;42392;0;0;0
FR;2;2021-03-01;5181;3715;0;0;0;177544;46107;0;0;0
FR;2;2021-03-02;6531;4733;0;0;0;184075;50840;0;0;0
FR;2;2021-03-03;6536;4935;0;0;0;190611;55775;0;0;0
FR;2;2021-03-04;8403;4102;0;0;0;199014;59877;0;0;0
FR;2;2021-03-05;8029;4068;0;0;0;207043;63945;0;0;0
FR;2;2021-03-06;4785;1681;0;0;0;211828;65626;0;0;0
FR;2;2021-03-07;2372;30;0;0;0;214200;65656;0;0;0
FR;2;2021-03-08;4165;8355;0;0;0;218365;74011;0;0;0
FR;2;2021-03-09;7490;8535;1;0;0;225855;82546;1;0;0
FR;2;2021-03-10;7102;9157;0;0;0;232957;91703;1;0;0
FR;2;2021-03-11;9376;9274;1;0;0;242333;100977;2;0;0
FR;2;2021-03-12;7973;8273;0;0;0;250306;109250;2;0;0
FR;2;2021-03-13;10048;2572;0;0;0;260354;111822;2;0;0
FR;2;2021-03-14;4839;396;0;0;0;265193;112218;2;0;0
FR;2;2021-03-15;10909;3493;0;0;0;276102;115711;2;0;0
FR;2;2021-03-16;16763;4664;1;0;0;292865;120375;3;0;0
FR;2;2021-03-17;20232;3982;0;0;0;313097;124357;3;0;0
FR;2;2021-03-18;23368;5023;0;0;0;336465;129380;3;0;0
FR;2;2021-03-19;23303;4610;0;0;0;359768;133990;3;0;0
FR;2;2021-03-20;25447;1568;0;0;0;385215;135558;3;0;0
FR;2;2021-03-21;17670;151;0;0;0;402885;135709;3;0;0
FR;2;2021-03-22;17783;3178;0;0;0;420668;138887;3;0;0
FR;2;2021-03-23;22690;4212;0;0;0;443358;143099;3;0;0
FR;2;2021-03-24;23955;5036;0;0;0;467313;148135;3;0;0
FR;2;2021-03-25;26748;5153;1;0;0;494061;153288;4;0;0
FR;2;2021-03-26;26981;4227;0;0;0;521042;157515;4;0;0
FR;2;2021-03-27;15918;1342;0;0;0;536960;158857;4;0;0
FR;2;2021-03-28;10561;131;0;0;0;547521;158988;4;0;0
FR;2;2021-03-29;18990;4305;0;0;0;566511;163293;4;0;0
FR;2;2021-03-30;24581;6051;0;0;0;591092;169344;4;0;0
FR;2;2021-03-31;28557;5934;0;0;0;619649;175278;4;0;0
FR;2;2021-04-01;34546;8532;1;0;0;654195;183810;5;0;0
FR;2;2021-04-02;29978;7689;0;0;0;684173;191499;5;0;0
FR;2;2021-04-03;16954;3927;0;0;0;701127;195426;5;0;0
FR;2;2021-04-04;9305;1101;2;0;0;710432;196527;7;0;0
FR;2;2021-04-05;12444;801;0;0;0;722876;197328;7;0;0
FR;2;2021-04-06;27148;7109;0;0;0;750024;204437;7;0;0
FR;2;2021-04-07;30926;7120;1;0;0;780950;211557;8;0;0
FR;2;2021-04-08;36887;8681;1;0;0;817837;220238;9;0;0
FR;2;2021-04-09;33837;8495;28;0;0;851674;228733;37;0;0
FR;2;2021-04-10;19681;9106;1;0;0;871355;237839;38;0;0
FR;2;2021-04-11;7942;4250;1;0;0;879297;242089;39;0;0
FR;2;2021-04-12;17122;11089;0;0;0;896419;253178;39;0;0
FR;2;2021-04-13;19452;16096;1;0;0;915871;269274;40;0;0
FR;2;2021-04-14;18062;16336;7;0;0;933933;285610;47;0;0
FR;2;2021-04-15;22193;21300;27;0;0;956126;306910;74;0;0
FR;2;2021-04-16;20706;20324;45;0;0;976832;327234;119;0;0
FR;2;2021-04-17;13255;22463;5;0;0;990087;349697;124;0;0
FR;2;2021-04-18;5908;14393;6;0;0;995995;364090;130;0;0
FR;2;2021-04-19;16837;16294;24;0;0;1012832;380384;154;0;0
FR;2;2021-04-20;19323;21634;38;0;0;1032155;402018;192;0;0
FR;2;2021-04-21;20285;21750;76;0;0;1052440;423768;268;0;0
FR;2;2021-04-22;23816;24875;41;0;0;1076256;448643;309;0;0
FR;2;2021-04-23;24523;25379;76;0;0;1100779;474022;385;0;0
FR;2;2021-04-24;25304;15072;104;0;0;1126083;489094;489;0;0
FR;2;2021-04-25;9595;8606;5;0;0;1135678;497700;494;0;0
FR;2;2021-04-26;17159;17374;21;0;0;1152837;515074;515;0;0
FR;2;2021-04-27;19241;24157;40;0;0;1172078;539231;555;0;0
FR;2;2021-04-28;22333;26286;112;0;0;1194411;565517;667;0;0
FR;2;2021-04-29;25469;30245;69;0;0;1219880;595762;736;0;0
FR;2;2021-04-30;25530;27818;49;1;0;1245410;623580;785;1;0
FR;2;2021-05-01;14985;9862;6;0;0;1260395;633442;791;1;0
FR;2;2021-05-02;6637;9174;2;0;0;1267032;642616;793;1;0
FR;2;2021-05-03;20016;19210;40;0;0;1287048;661826;833;1;0
FR;2;2021-05-04;18281;29062;33;0;0;1305329;690888;866;1;0
FR;2;2021-05-05;18368;29418;48;0;0;1323697;720306;914;1;0
FR;2;2021-05-06;23542;35271;131;0;0;1347239;755577;1045;1;0
FR;2;2021-05-07;25328;33206;97;0;0;1372567;788783;1142;1;0
FR;2;2021-05-08;21337;10074;14;0;0;1393904;798857;1156;1;0
FR;2;2021-05-09;13163;7793;7;0;0;1407067;806650;1163;1;0
FR;2;2021-05-10;32938;21985;49;0;0;1440005;828635;1212;1;0
FR;2;2021-05-11;43598;20984;101;0;0;1483603;849619;1313;1;0
FR;2;2021-05-12;50046;19750;143;0;0;1533649;869369;1456;1;0
FR;2;2021-05-13;51292;5707;31;0;0;1584941;875076;1487;1;0
FR;2;2021-05-14;61347;12894;132;0;0;1646288;887970;1619;1;0
FR;2;2021-05-15;65931;7129;39;0;0;1712219;895099;1658;1;0
FR;2;2021-05-16;43584;2570;10;0;0;1755803;897669;1668;1;0
FR;2;2021-05-17;44744;12538;114;0;0;1800547;910207;1782;1;0
FR;2;2021-05-18;54639;12252;191;0;0;1855186;922459;1973;1;0
FR;2;2021-05-19;57169;10575;281;0;0;1912355;933034;2254;1;0
FR;2;2021-05-20;63433;10826;288;0;0;1975788;943860;2542;1;0
FR;2;2021-05-21;64294;11634;230;0;0;2040082;955494;2772;1;0
FR;2;2021-05-22;61480;4512;65;0;0;2101562;960006;2837;1;0
FR;2;2021-05-23;37532;572;22;0;0;2139094;960578;2859;1;0
FR;2;2021-05-24;17237;2042;35;0;0;2156331;962620;2894;1;0
FR;2;2021-05-25;21108;12216;240;0;0;2177439;974836;3134;1;0
FR;2;2021-05-26;19934;11464;229;0;0;2197373;986300;3363;1;0
FR;2;2021-05-27;22994;12648;182;0;0;2220367;998948;3545;1;0
FR;2;2021-05-28;29391;14968;190;0;0;2249758;1013916;3735;1;0
FR;2;2021-05-29;30419;8186;57;0;0;2280177;1022102;3792;1;0
FR;2;2021-05-30;4646;1817;6;0;0;2284823;1023919;3798;1;0
FR;2;2021-05-31;28587;18726;184;0;0;2313410;1042645;3982;1;0
FR;2;2021-06-01;45717;19970;224;0;0;2359127;1062615;4206;1;0
FR;2;2021-06-02;37469;19251;182;0;0;2396596;1081866;4388;1;0
FR;2;2021-06-03;51276;23271;161;0;0;2447872;1105137;4549;1;0
FR;2;2021-06-04;65512;24056;215;0;0;2513384;1129193;4764;1;0
FR;2;2021-06-05;34597;24044;52;0;0;2547981;1153237;4816;1;0
FR;2;2021-06-06;4954;6192;10;0;0;2552935;1159429;4826;1;0
FR;2;2021-06-07;28171;23034;149;0;0;2581106;1182463;4975;1;0
FR;2;2021-06-08;46372;22904;143;0;0;2627478;1205367;5118;1;0
FR;2;2021-06-09;34287;20926;107;0;0;2661765;1226293;5225;1;0
FR;2;2021-06-10;42638;19122;95;1;0;2704403;1245415;5320;2;0
FR;2;2021-06-11;55293;25192;134;0;0;2759696;1270607;5454;2;0
FR;2;2021-06-12;30558;19772;53;0;0;2790254;1290379;5507;2;0
FR;2;2021-06-13;3330;9189;13;0;0;2793584;1299568;5520;2;0
FR;2;2021-06-14;25298;24152;92;0;0;2818882;1323720;5612;2;0
FR;2;2021-06-15;39041;22828;154;0;0;2857923;1346548;5766;2;0
FR;2;2021-06-16;30160;21407;134;0;0;2888083;1367955;5900;2;0
FR;2;2021-06-17;36907;25846;150;0;0;2924990;1393801;6050;2;0
FR;2;2021-06-18;46852;28842;122;0;0;2971842;1422643;6172;2;0
FR;2;2021-06-19;24525;24892;39;0;0;2996367;1447535;6211;2;0
FR;2;2021-06-20;3741;10059;9;0;0;3000108;1457594;6220;2;0
FR;2;2021-06-21;17527;42840;87;0;0;3017635;1500434;6307;2;0
FR;2;2021-06-22;28359;49556;110;0;0;3045994;1549990;6417;2;0
FR;2;2021-06-23;21788;49577;107;1;1;3067782;1599567;6524;3;1
FR;2;2021-06-24;28376;50279;133;0;0;3096158;1649846;6657;3;1
FR;2;2021-06-25;33399;60405;127;0;0;3129557;1710251;6784;3;1
FR;2;2021-06-26;16382;59266;54;1;0;3145939;1769517;6838;4;1
FR;2;2021-06-27;2566;29313;22;1;0;3148505;1798830;6860;5;1
FR;2;2021-06-28;12638;54329;83;0;0;3161143;1853159;6943;5;1
FR;2;2021-06-29;19846;59909;178;0;0;3180989;1913068;7121;5;1
FR;2;2021-06-30;16323;57918;252;17;0;3197312;1970986;7373;22;1
FR;2;2021-07-01;20489;59892;227;0;0;3217801;2030878;7600;22;1
FR;2;2021-07-02;24071;62143;184;0;0;3241872;2093021;7784;22;1
FR;2;2021-07-03;12113;57093;153;0;0;3253985;2150114;7937;22;1
FR;2;2021-07-04;1958;23303;18;0;0;3255943;2173417;7955;22;1
FR;2;2021-07-05;9170;29370;106;0;0;3265113;2202787;8061;22;1
FR;2;2021-07-06;14577;36216;135;0;0;3279690;2239003;8196;22;1
FR;2;2021-07-07;14408;33655;139;0;0;3294098;2272658;8335;22;1
FR;2;2021-07-08;19716;40308;162;0;0;3313814;2312966;8497;22;1
FR;2;2021-07-09;27097;54282;202;1;0;3340911;2367248;8699;23;1
FR;2;2021-07-10;13386;33678;107;0;0;3354297;2400926;8806;23;1
FR;2;2021-07-11;1807;4358;16;0;0;3356104;2405284;8822;23;1
FR;2;2021-07-12;12965;37266;119;0;0;3369069;2442550;8941;23;1
FR;2;2021-07-13;37112;53188;150;0;0;3406181;2495738;9091;23;1
FR;2;2021-07-14;6614;3564;15;0;0;3412795;2499302;9106;23;1
FR;2;2021-07-15;47237;47028;156;0;0;3460032;2546330;9262;23;1
FR;2;2021-07-16;64309;55799;187;0;0;3524341;2602129;9449;23;1
FR;2;2021-07-17;31595;23928;96;0;0;3555936;2626057;9545;23;1
FR;2;2021-07-18;6086;4859;19;0;0;3562022;2630916;9564;23;1
FR;2;2021-07-19;32995;28657;94;0;0;3595017;2659573;9658;23;1
FR;2;2021-07-20;51991;44541;155;0;0;3647008;2704114;9813;23;1
FR;2;2021-07-21;45246;34722;93;0;0;3692254;2738836;9906;23;1
FR;2;2021-07-22;56275;41099;128;1;0;3748529;2779935;10034;24;1
FR;2;2021-07-23;68284;49055;170;0;0;3816813;2828990;10204;24;1
FR;2;2021-07-24;36171;21596;82;0;0;3852984;2850586;10286;24;1
FR;2;2021-07-25;6744;2640;10;0;0;3859728;2853226;10296;24;1
FR;2;2021-07-26;36309;22435;91;1;0;3896037;2875661;10387;25;1
FR;2;2021-07-27;62372;34600;180;0;0;3958409;2910261;10567;25;1
FR;2;2021-07-28;55310;26435;132;0;0;4013719;2936696;10699;25;1
FR;2;2021-07-29;68464;32784;189;0;0;4082183;2969480;10888;25;1
FR;2;2021-07-30;74448;37785;222;1;0;4156631;3007265;11110;26;1
FR;2;2021-07-31;34762;16194;104;0;0;4191393;3023459;11214;26;1
FR;2;2021-08-01;5409;2272;19;0;0;4196802;3025731;11233;26;1
FR;2;2021-08-02;35870;16201;101;0;0;4232672;3041932;11334;26;1
FR;2;2021-08-03;55973;28287;142;0;0;4288645;3070219;11476;26;1
FR;2;2021-08-04;46625;20855;128;1;0;4335270;3091074;11604;27;1
FR;2;2021-08-05;54626;31582;215;0;0;4389896;3122656;11819;27;1
FR;2;2021-08-06;58089;42386;242;1;0;4447985;3165042;12061;28;1
FR;2;2021-08-07;25143;17607;89;0;0;4473128;3182649;12150;28;1
FR;2;2021-08-08;3833;3665;21;0;0;4476961;3186314;12171;28;1
FR;2;2021-08-09;29304;21112;92;0;0;4506265;3207426;12263;28;1
FR;2;2021-08-10;44996;33498;154;0;0;4551261;3240924;12417;28;1
FR;2;2021-08-11;35267;25174;151;0;0;4586528;3266098;12568;28;1
FR;2;2021-08-12;41899;35722;162;0;0;4628427;3301820;12730;28;1
FR;2;2021-08-13;42592;37140;218;0;0;4671019;3338960;12948;28;1
FR;2;2021-08-14;18511;22221;93;0;0;4689530;3361181;13041;28;1
FR;2;2021-08-15;3837;3806;17;0;0;4693367;3364987;13058;28;1
FR;2;2021-08-16;25082;27180;110;0;0;4718449;3392167;13168;28;1
FR;2;2021-08-17;38254;43462;205;2;0;4756703;3435629;13373;30;1
FR;2;2021-08-18;32250;36369;195;1;1;4788953;3471998;13568;31;2
FR;2;2021-08-19;37433;46573;224;0;0;4826386;3518571;13792;31;2
FR;2;2021-08-20;40560;55611;269;1;0;4866946;3574182;14061;32;2
FR;2;2021-08-21;18121;24302;115;0;0;4885067;3598484;14176;32;2
FR;2;2021-08-22;2905;4321;22;1;1;4887972;3602805;14198;33;3
FR;2;2021-08-23;19245;35162;131;1;0;4907217;3637967;14329;34;3
FR;2;2021-08-24;31943;56041;236;0;0;4939160;3694008;14565;34;3
FR;2;2021-08-25;25927;43446;250;0;0;4965087;3737454;14815;34;3
FR;2;2021-08-26;32357;55808;387;0;0;4997444;3793262;15202;34;3
FR;2;2021-08-27;36998;65619;479;2;0;5034442;3858881;15681;36;3
FR;2;2021-08-28;17817;28501;300;0;0;5052259;3887382;15981;36;3
FR;2;2021-08-29;2654;5036;47;0;0;5054913;3892418;16028;36;3
FR;2;2021-08-30;18413;37738;400;0;755;5073326;3930156;16428;36;758
FR;2;2021-08-31;28074;57493;887;4;1543;5101400;3987649;17315;40;2301
FR;2;2021-09-01;21592;39855;1309;0;2109;5122992;4027504;18624;40;4410
FR;2;2021-09-02;25482;48638;1962;2;3313;5148474;4076142;20586;42;7723
FR;2;2021-09-03;33407;64487;2988;3;4838;5181881;4140629;23574;45;12561
FR;2;2021-09-04;16829;27716;1442;1;2366;5198710;4168345;25016;46;14927
FR;2;2021-09-05;2262;3613;266;0;413;5200972;4171958;25282;46;15340
FR;2;2021-09-06;14039;28717;1769;1;2938;5215011;4200675;27051;47;18278
FR;2;2021-09-07;21106;41069;3020;13;4879;5236117;4241744;30071;60;23157
FR;2;2021-09-08;17243;31930;2732;6;4479;5253360;4273674;32803;66;27636
FR;2;2021-09-09;20975;40451;4432;3;6779;5274335;4314125;37235;69;34415
FR;2;2021-09-10;28200;51188;5283;4;8853;5302535;4365313;42518;73;43268
FR;2;2021-09-11;13654;22398;2404;5;3954;5316189;4387711;44922;78;47222
FR;2;2021-09-12;1822;2779;288;0;509;5318011;4390490;45210;78;47731
FR;2;2021-09-13;11657;21436;2471;4;4014;5329668;4411926;47681;82;51745
FR;2;2021-09-14;18571;32775;5085;13;9066;5348239;4444701;52766;95;60811
FR;2;2021-09-15;14911;28271;5167;3;7777;5363150;4472972;57933;98;68588
FR;2;2021-09-16;16074;32768;6736;13;10525;5379224;4505740;64669;111;79113
FR;2;2021-09-17;20911;47115;8780;10;14597;5400135;4552855;73449;121;93710
FR;2;2021-09-18;9856;20931;3803;6;6024;5409991;4573786;77252;127;99734
FR;2;2021-09-19;1165;2630;396;0;641;5411156;4576416;77648;127;100375
FR;2;2021-09-20;7492;18771;3853;7;6152;5418648;4595187;81501;134;106527
FR;2;2021-09-21;11212;30003;6495;5;10742;5429860;4625190;87996;139;117269
FR;2;2021-09-22;9407;23529;5491;6;8512;5439267;4648719;93487;145;125781
FR;2;2021-09-23;10725;28890;7880;9;12636;5449992;4677609;101367;154;138417
FR;2;2021-09-24;15070;42898;10875;18;17212;5465062;4720507;112242;172;155629
FR;2;2021-09-25;7258;18765;3963;9;6097;5472320;4739272;116205;181;161726
FR;2;2021-09-26;1079;2558;495;0;633;5473399;4741830;116700;181;162359
FR;2;2021-09-27;6313;16427;4284;8;6538;5479712;4758257;120984;189;168897
FR;2;2021-09-28;9238;25553;7768;13;12074;5488950;4783810;128752;202;180971
FR;2;2021-09-29;8081;20206;6066;25;9258;5497031;4804016;134818;227;190229
FR;2;2021-09-30;9864;25808;9504;16;14085;5506895;4829824;144322;243;204314
FR;2;2021-10-01;13972;35670;12916;25;19268;5520867;4865494;157238;268;223582
FR;2;2021-10-02;6874;15895;4846;7;7013;5527741;4881389;162084;275;230595
FR;2;2021-10-03;841;1928;492;1;511;5528582;4883317;162576;276;231106
FR;2;2021-10-04;5820;13910;5518;5;7860;5534402;4897227;168094;281;238966
FR;2;2021-10-05;9052;22543;11119;19;15718;5543454;4919770;179213;300;254684
FR;2;2021-10-06;7782;17746;8241;11;11077;5551236;4937516;187454;311;265761
FR;2;2021-10-07;9197;22189;12381;15;16846;5560433;4959705;199835;326;282607
FR;2;2021-10-08;13428;32065;17348;27;23550;5573861;4991770;217183;353;306157
FR;2;2021-10-09;5999;12839;6042;6;7888;5579860;5004609;223225;359;314045
FR;2;2021-10-10;884;1623;436;2;627;5580744;5006232;223661;361;314672
FR;2;2021-10-11;5604;11578;6454;17;8825;5586348;5017810;230115;378;323497
FR;2;2021-10-12;8030;17776;12542;13;16751;5594378;5035586;242657;391;340248
FR;2;2021-10-13;6943;14841;10247;12;13617;5601321;5050427;252904;403;353865
FR;2;2021-10-14;8311;17928;14992;13;19451;5609632;5068355;267896;416;373316
FR;2;2021-10-15;11849;26295;20903;26;27957;5621481;5094650;288799;442;401273
FR;2;2021-10-16;5140;8731;1818;0;3207;5626621;5103381;290617;442;404480
FR;2;2021-10-17;651;1176;184;0;371;5627272;5104557;290801;442;404851
FR;2;2021-10-18;4560;7399;661;2;1660;5631832;5111956;291462;444;406511
FR;2;2021-10-19;6236;9885;730;5;2046;5638068;5121841;292192;449;408557
FR;2;2021-10-20;5163;8081;757;3;1682;5643231;5129922;292949;452;410239
FR;2;2021-10-21;6090;9969;778;5;2104;5649321;5139891;293727;457;412343
FR;2;2021-10-22;8448;14583;1148;4;2885;5657769;5154474;294875;461;415228
FR;2;2021-10-23;3841;5998;586;0;1230;5661610;5160472;295461;461;416458
FR;2;2021-10-24;493;890;100;0;205;5662103;5161362;295561;461;416663
FR;2;2021-10-25;3357;5362;305;1;828;5665460;5166724;295866;462;417491
FR;2;2021-10-26;4176;7258;1128;4;2009;5669636;5173982;296994;466;419500
FR;2;2021-10-27;3675;6617;1193;5;1995;5673311;5180599;298187;471;421495
FR;2;2021-10-28;4597;7697;1729;3;2744;5677908;5188296;299916;474;424239
FR;2;2021-10-29;5407;11079;2435;4;3673;5683315;5199375;302351;478;427912
FR;2;2021-10-30;2748;4436;973;1;1430;5686063;5203811;303324;479;429342
FR;2;2021-10-31;364;533;139;1;190;5686427;5204344;303463;480;429532
FR;2;2021-11-01;427;549;177;0;265;5686854;5204893;303640;480;429797
FR;2;2021-11-02;3290;6759;1182;0;1762;5690144;5211652;304822;480;431559
FR;2;2021-11-03;3339;6238;1386;2;1968;5693483;5217890;306208;482;433527
FR;2;2021-11-04;3986;7089;1764;4;2492;5697469;5224979;307972;486;436019
FR;2;2021-11-05;5228;10509;2866;5;3947;5702697;5235488;310838;491;439966
FR;2;2021-11-06;2594;4678;1401;0;1816;5705291;5240166;312239;491;441782
FR;2;2021-11-07;506;866;219;0;289;5705797;5241032;312458;491;442071
FR;2;2021-11-08;2578;5360;1201;3;1673;5708375;5246392;313659;494;443744
FR;2;2021-11-09;2750;6942;2397;6;3182;5711125;5253334;316056;500;446926
FR;2;2021-11-10;2587;5696;5099;6;6277;5713712;5259030;321155;506;453203
FR;2;2021-11-11;441;749;737;2;915;5714153;5259779;321892;508;454118
FR;2;2021-11-12;2951;8112;8967;8;10909;5717104;5267891;330859;516;465027
FR;2;2021-11-13;1537;3379;3867;7;4529;5718641;5271270;334726;523;469556
FR;2;2021-11-14;255;596;349;1;485;5718896;5271866;335075;524;470041
FR;2;2021-11-15;1622;3679;4441;9;5330;5720518;5275545;339516;533;475371
FR;2;2021-11-16;2184;5923;8301;14;10077;5722702;5281468;347817;547;485448
FR;2;2021-11-17;1739;4546;6623;8;7841;5724441;5286014;354440;555;493289
FR;2;2021-11-18;2190;5942;9177;11;11010;5726631;5291956;363617;566;504299
FR;2;2021-11-19;2698;7791;12965;19;15465;5729329;5299747;376582;585;519764
FR;2;2021-11-20;1564;3333;5173;5;6078;5730893;5303080;381755;590;525842
FR;2;2021-11-21;246;516;540;0;662;5731139;5303596;382295;590;526504
FR;2;2021-11-22;1276;2616;4475;5;5405;5732415;5306212;386770;595;531909
FR;2;2021-11-23;1615;4299;8194;9;9898;5734030;5310511;394964;604;541807
FR;2;2021-11-24;1417;3775;7472;14;8730;5735447;5314286;402436;618;550537
FR;2;2021-11-25;1812;4887;11454;21;13654;5737259;5319173;413890;639;564191
FR;2;2021-11-26;2540;7771;22660;31;26073;5739799;5326944;436550;670;590264
FR;2;2021-11-27;1496;4149;12262;18;14012;5741295;5331093;448812;688;604276
FR;2;2021-11-28;292;845;1970;3;2297;5741587;5331938;450782;691;606573
FR;2;2021-11-29;1443;4372;15079;23;17248;5743030;5336310;465861;714;623821
FR;2;2021-11-30;1911;6731;26226;36;29982;5744941;5343041;492087;750;653803
FR;2;2021-12-01;1909;6073;26194;29;29519;5746850;5349114;518281;779;683322
FR;2;2021-12-02;1909;6828;37698;52;41948;5748759;5355942;555979;831;725270
FR;2;2021-12-03;2552;10096;53600;111;59331;5751311;5366038;609579;942;784601
FR;2;2021-12-04;1848;6301;37101;38;40781;5753159;5372339;646680;980;825382
FR;2;2021-12-05;458;2258;14254;14;15988;5753617;5374597;660934;994;841370
FR;2;2021-12-06;2482;9889;77695;109;84743;5756099;5384486;738629;1103;926113
FR;2;2021-12-07;3455;15339;122418;238;133723;5759554;5399825;861047;1341;1059836
FR;2;2021-12-08;3720;16038;133183;330;145377;5763274;5415863;994230;1671;1205213
FR;2;2021-12-09;4547;19635;170174;554;185547;5767821;5435498;1164404;2225;1390760
FR;2;2021-12-10;4672;22834;188628;490;206083;5772493;5458332;1353032;2715;1596843
FR;2;2021-12-11;3682;16622;132432;239;144866;5776175;5474954;1485464;2954;1741709
FR;2;2021-12-12;1256;7130;59085;83;65135;5777431;5482084;1544549;3037;1806844
FR;2;2021-12-13;5526;26859;220665;605;242956;5782957;5508943;1765214;3642;2049800
FR;2;2021-12-14;7017;37507;300736;909;332194;5789974;5546450;2065950;4551;2381994
FR;2;2021-12-15;6559;36240;285195;956;315798;5796533;5582690;2351145;5507;2697792
FR;2;2021-12-16;7761;37922;312115;981;343705;5804294;5620612;2663260;6488;3041497
FR;2;2021-12-17;8678;41253;327851;976;360942;5812972;5661865;2991111;7464;3402439
FR;2;2021-12-18;6512;26566;212330;448;233639;5819484;5688431;3203441;7912;3636078
FR;2;2021-12-19;2602;11468;90208;182;100366;5822086;5699899;3293649;8094;3736444
FR;2;2021-12-20;9550;33597;275185;706;303352;5831636;5733496;3568834;8800;4039796
FR;2;2021-12-21;11559;38342;309606;969;341402;5843195;5771838;3878440;9769;4381198
FR;2;2021-12-22;10457;32844;265092;952;292475;5853652;5804682;4143532;10721;4673673
FR;2;2021-12-23;9430;26697;199478;700;221265;5863082;5831379;4343010;11421;4894938
FR;2;2021-12-24;2782;7502;43850;140;49563;5865864;5838881;4386860;11561;4944501
FR;2;2021-12-25;201;692;2002;10;2494;5866065;5839573;4388862;11571;4946995
FR;2;2021-12-26;1322;4205;25149;71;28673;5867387;5843778;4414011;11642;4975668
FR;2;2021-12-27;8074;29933;218400;659;243325;5875461;5873711;4632411;12301;5218993
FR;2;2021-12-28;9838;36326;272073;742;301956;5885299;5910037;4904484;13043;5520949
FR;2;2021-12-29;9497;32279;246116;766;272687;5894796;5942316;5150600;13809;5793636
FR;2;2021-12-30;9461;28131;208818;662;231467;5904257;5970447;5359418;14471;6025103
FR;2;2021-12-31;3009;8371;54982;177;61235;5907266;5978818;5414400;14648;6086338
FR;2;2022-01-01;227;688;2851;7;3344;5907493;5979506;5417251;14655;6089682
FR;2;2022-01-02;1504;4858;29510;75;33399;5908997;5984364;5446761;14730;6123081
FR;2;2022-01-03;9589;35398;266511;806;293875;5918586;6019762;5713272;15536;6416956
FR;2;2022-01-04;12847;45394;342073;1068;376968;5931433;6065156;6055345;16604;6793924
FR;2;2022-01-05;11269;38660;294158;886;323801;5942702;6103816;6349503;17490;7117725
FR;2;2022-01-06;13653;43523;331933;1298;364731;5956355;6147339;6681436;18788;7482456
FR;2;2022-01-07;14223;47625;361087;1270;396412;5970578;6194964;7042523;20058;7878868
FR;2;2022-01-08;7948;28146;201259;515;221694;5978526;6223110;7243782;20573;8100562
FR;2;2022-01-09;2749;8989;62522;137;69521;5981275;6232099;7306304;20710;8170083
FR;2;2022-01-10;10093;31938;232459;857;255049;5991368;6264037;7538763;21567;8425132
FR;2;2022-01-11;11469;36242;265894;1030;290579;6002837;6300279;7804657;22597;8715711
FR;2;2022-01-12;8761;29824;206313;862;226173;6011598;6330103;8010970;23459;8941884
FR;2;2022-01-13;9387;31349;224477;832;244821;6020985;6361452;8235447;24291;9186705
FR;2;2022-01-14;9743;35655;254525;920;277679;6030728;6397107;8489972;25211;9464384
FR;2;2022-01-15;5358;19454;140776;363;153634;6036086;6416561;8630748;25574;9618018
FR;2;2022-01-16;1511;5502;35876;81;39837;6037597;6422063;8666624;25655;9657855
FR;2;2022-01-17;5546;19296;135397;601;147250;6043143;6441359;8802021;26256;9805105
FR;2;2022-01-18;6418;21523;148613;648;160468;6049561;6462882;8950634;26904;9965573
FR;2;2022-01-19;4389;16350;105088;552;113705;6053950;6479232;9055722;27456;10079278
FR;2;2022-01-20;4867;17599;115285;603;123682;6058817;6496831;9171007;28059;10202960
FR;2;2022-01-21;5196;20062;137328;679;147747;6064013;6516893;9308335;28738;10350707
FR;2;2022-01-22;3030;10959;74258;260;80325;6067043;6527852;9382593;28998;10431032
FR;2;2022-01-23;724;2732;15238;41;16834;6067767;6530584;9397831;29039;10447866
FR;2;2022-01-24;3291;12822;75063;430;81022;6071058;6543406;9472894;29469;10528888
FR;2;2022-01-25;3572;14438;79617;496;85452;6074630;6557844;9552511;29965;10614340
FR;2;2022-01-26;2514;10678;58964;363;62996;6077144;6568522;9611475;30328;10677336
FR;2;2022-01-27;2680;11301;64173;388;67910;6079824;6579823;9675648;30716;10745246
FR;2;2022-01-28;3548;18362;91714;429;98952;6083372;6598185;9767362;31145;10844198
FR;2;2022-01-29;1894;9243;48844;164;52928;6085266;6607428;9816206;31309;10897126
FR;2;2022-01-30;464;2235;9452;38;10602;6085730;6609663;9825658;31347;10907728
FR;2;2022-01-31;1888;9577;43824;208;47337;6087618;6619240;9869482;31555;10955065
FR;2;2022-02-01;1913;10055;47024;279;50108;6089531;6629295;9916506;31834;11005173
FR;2;2022-02-02;1608;9018;41107;251;44171;6091139;6638313;9957613;32085;11049344
FR;2;2022-02-03;1723;8948;40513;204;42915;6092862;6647261;9998126;32289;11092259
FR;2;2022-02-04;2152;15217;66634;299;71347;6095014;6662478;10064760;32588;11163606
FR;2;2022-02-05;1361;8529;35942;132;39231;6096375;6671007;10100702;32720;11202837
FR;2;2022-02-06;274;1771;6124;16;6898;6096649;6672778;10106826;32736;11209735
FR;2;2022-02-07;1350;9586;37748;134;41301;6097999;6682364;10144574;32870;11251036
FR;2;2022-02-08;1300;9822;40929;173;43719;6099299;6692186;10185503;33043;11294755
FR;2;2022-02-09;1160;8826;37039;174;40459;6100459;6701012;10222542;33217;11335214
FR;2;2022-02-10;1025;7989;33835;204;36505;6101484;6709001;10256377;33421;11371719
FR;2;2022-02-11;1390;12081;53340;223;57691;6102874;6721082;10309717;33644;11429410
FR;2;2022-02-12;750;6533;27986;83;30805;6103624;6727615;10337703;33727;11460215
FR;2;2022-02-13;200;1339;4833;20;5574;6103824;6728954;10342536;33747;11465789
FR;2;2022-02-14;834;6726;30267;90;33228;6104658;6735680;10372803;33837;11499017
FR;2;2022-02-15;773;6459;28045;141;29987;6105431;6742139;10400848;33978;11529004
FR;2;2022-02-16;655;5357;22058;123;23623;6106086;6747496;10422906;34101;11552627
FR;2;2022-02-17;518;3777;14146;98;14612;6106604;6751273;10437052;34199;11567239
FR;2;2022-02-18;722;5363;20430;134;21126;6107326;6756636;10457482;34333;11588365
FR;2;2022-02-19;430;3053;10529;66;11243;6107756;6759689;10468011;34399;11599608
FR;2;2022-02-20;104;513;1456;3;1604;6107860;6760202;10469467;34402;11601212
FR;2;2022-02-21;422;2684;9117;65;9494;6108282;6762886;10478584;34467;11610706
FR;2;2022-02-22;390;2564;8890;76;8793;6108672;6765450;10487474;34543;11619499
FR;2;2022-02-23;431;2602;8988;82;9266;6109103;6768052;10496462;34625;11628765
FR;2;2022-02-24;314;2031;6798;81;6827;6109417;6770083;10503260;34706;11635592
FR;2;2022-02-25;457;3200;11415;108;11279;6109874;6773283;10514675;34814;11646871
FR;2;2022-02-26;296;1892;6035;49;6340;6110170;6775175;10520710;34863;11653211
FR;2;2022-02-27;76;313;905;5;948;6110246;6775488;10521615;34868;11654159
FR;2;2022-02-28;330;1685;5523;53;5531;6110576;6777173;10527138;34921;11659690
FR;2;2022-03-01;277;1559;5475;45;5192;6110853;6778732;10532613;34966;11664882
FR;2;2022-03-02;298;1434;5244;45;5087;6111151;6780166;10537857;35011;11669969
FR;2;2022-03-03;225;1109;3706;42;3483;6111376;6781275;10541563;35053;11673452
FR;2;2022-03-04;242;1466;4856;73;4502;6111618;6782741;10546419;35126;11677954
FR;2;2022-03-05;173;904;2979;32;2723;6111791;6783645;10549398;35158;11680677
FR;2;2022-03-06;42;182;279;5;319;6111833;6783827;10549677;35163;11680996
FR;2;2022-03-07;155;655;1985;70;1774;6111988;6784482;10551662;35233;11682770
FR;2;2022-03-08;144;657;2270;51;1902;6112132;6785139;10553932;35284;11684672
FR;2;2022-03-09;154;705;2345;37;2045;6112286;6785844;10556277;35321;11686717
FR;2;2022-03-10;121;601;1691;35;1466;6112407;6786445;10557968;35356;11688183
FR;2;2022-03-11;171;755;2767;57;2366;6112578;6787200;10560735;35413;11690549
FR;2;2022-03-12;145;484;1784;27;1553;6112723;6787684;10562519;35440;11692102
FR;2;2022-03-13;25;75;201;29;202;6112748;6787759;10562720;35469;11692304
FR;2;2022-03-14;127;468;1565;529;1294;6112875;6788227;10564285;35998;11693598
FR;2;2022-03-15;138;427;1707;689;1325;6113013;6788654;10565992;36687;11694923
FR;2;2022-03-16;141;472;2012;1611;1590;6113154;6789126;10568004;38298;11696513
FR;2;2022-03-17;93;412;1408;1193;1144;6113247;6789538;10569412;39491;11697657
FR;2;2022-03-18;145;492;2018;1792;1660;6113392;6790030;10571430;41283;11699317
FR;2;2022-03-19;108;319;1210;940;1015;6113500;6790349;10572640;42223;11700332
FR;2;2022-03-20;13;77;191;59;168;6113513;6790426;10572831;42282;11700500
FR;2;2022-03-21;96;305;1212;1483;1076;6113609;6790731;10574043;43765;11701576
FR;2;2022-03-22;117;386;1528;1829;1290;6113726;6791117;10575571;45594;11702866
FR;2;2022-03-23;139;358;1669;3032;1465;6113865;6791475;10577240;48626;11704331
FR;2;2022-03-24;116;291;1182;1546;998;6113981;6791766;10578422;50172;11705329
FR;2;2022-03-25;119;361;1803;2449;1473;6114100;6792127;10580225;52621;11706802
FR;2;2022-03-26;77;247;1203;1222;952;6114177;6792374;10581428;53843;11707754
FR;2;2022-03-27;19;36;153;100;132;6114196;6792410;10581581;53943;11707886
FR;2;2022-03-28;94;286;1135;1588;994;6114290;6792696;10582716;55531;11708880
FR;2;2022-03-29;108;257;1324;2463;1104;6114398;6792953;10584040;57994;11709984
FR;2;2022-03-30;91;312;1487;3183;1320;6114489;6793265;10585527;61177;11711304
FR;2;2022-03-31;104;282;1273;2330;1087;6114593;6793547;10586800;63507;11712391
FR;2;2022-04-01;121;320;1566;2343;1319;6114714;6793867;10588366;65850;11713710
FR;2;2022-04-02;72;161;845;891;737;6114786;6794028;10589211;66741;11714447
FR;2;2022-04-03;16;53;128;112;142;6114802;6794081;10589339;66853;11714589
FR;2;2022-04-04;109;232;985;1436;793;6114911;6794313;10590324;68289;11715382
FR;2;2022-04-05;143;289;1313;2876;1140;6115054;6794602;10591637;71165;11716522
FR;2;2022-04-06;88;249;1305;2517;1128;6115142;6794851;10592942;73682;11717650
FR;2;2022-04-07;120;215;1298;2681;1037;6115262;6795066;10594240;76363;11718687
FR;2;2022-04-08;124;332;1624;3230;1322;6115386;6795398;10595864;79593;11720009
FR;2;2022-04-09;90;219;899;1045;731;6115476;6795617;10596763;80638;11720740
FR;2;2022-04-10;37;47;143;162;119;6115513;6795664;10596906;80800;11720859
FR;2;2022-04-11;86;187;884;1531;773;6115599;6795851;10597790;82331;11721632
FR;2;2022-04-12;176;266;1178;2737;1057;6115775;6796117;10598968;85068;11722689
FR;2;2022-04-13;144;228;1122;2451;982;6115919;6796345;10600090;87519;11723671
FR;2;2022-04-14;114;220;1084;2673;916;6116033;6796565;10601174;90192;11724587
FR;2;2022-04-15;112;245;1196;2275;1065;6116145;6796810;10602370;92467;11725652
FR;2;2022-04-16;65;108;541;545;452;6116210;6796918;10602911;93012;11726104
FR;2;2022-04-17;15;26;57;53;53;6116225;6796944;10602968;93065;11726157
FR;2;2022-04-18;12;35;119;70;114;6116237;6796979;10603087;93135;11726271
FR;2;2022-04-19;112;237;1115;1707;947;6116349;6797216;10604202;94842;11727218
FR;2;2022-04-20;95;238;1099;2145;929;6116444;6797454;10605301;96987;11728147
FR;2;2022-04-21;111;230;978;1893;834;6116555;6797684;10606279;98880;11728981
FR;2;2022-04-22;97;270;1241;2085;1023;6116652;6797954;10607520;100965;11730004
FR;2;2022-04-23;66;154;644;762;573;6116718;6798108;10608164;101727;11730577
FR;2;2022-04-24;12;29;101;68;79;6116730;6798137;10608265;101795;11730656
FR;2;2022-04-25;103;203;820;1313;709;6116833;6798340;10609085;103108;11731365
FR;2;2022-04-26;109;183;1038;1997;876;6116942;6798523;10610123;105105;11732241
FR;2;2022-04-27;96;177;857;1757;760;6117038;6798700;10610980;106862;11733001
FR;2;2022-04-28;91;214;948;1904;842;6117129;6798914;10611928;108766;11733843
FR;2;2022-04-29;81;279;1129;1691;1037;6117210;6799193;10613057;110457;11734880
FR;2;2022-04-30;65;126;470;538;429;6117275;6799319;10613527;110995;11735309
FR;2;2022-05-01;20;24;83;48;84;6117295;6799343;10613610;111043;11735393
FR;2;2022-05-02;114;221;760;1206;655;6117409;6799564;10614370;112249;11736048
FR;2;2022-05-03;149;227;995;1766;934;6117558;6799791;10615365;114015;11736982
FR;2;2022-05-04;87;221;922;1808;865;6117645;6800012;10616287;115823;11737847
FR;2;2022-05-05;126;193;850;1697;765;6117771;6800205;10617137;117520;11738612
FR;2;2022-05-06;133;241;1098;1848;1011;6117904;6800446;10618235;119368;11739623
FR;2;2022-05-07;40;97;470;504;406;6117944;6800543;10618705;119872;11740029
FR;2;2022-05-08;45;53;106;70;100;6117989;6800596;10618811;119942;11740129
FR;2;2022-05-09;101;173;651;984;603;6118090;6800769;10619462;120926;11740732
FR;2;2022-05-10;119;240;936;1829;891;6118209;6801009;10620398;122755;11741623
FR;2;2022-05-11;100;167;809;1871;787;6118309;6801176;10621207;124626;11742410
FR;2;2022-05-12;110;166;838;2093;799;6118419;6801342;10622045;126719;11743209
FR;2;2022-05-13;99;230;964;2086;892;6118518;6801572;10623009;128805;11744101
FR;2;2022-05-14;76;116;450;554;408;6118594;6801688;10623459;129359;11744509
FR;2;2022-05-15;24;36;93;87;106;6118618;6801724;10623552;129446;11744615
FR;2;2022-05-16;103;169;599;921;536;6118721;6801893;10624151;130367;11745151
FR;2;2022-05-17;95;183;687;1685;655;6118816;6802076;10624838;132052;11745806
FR;2;2022-05-18;80;179;638;1420;643;6118896;6802255;10625476;133472;11746449
FR;2;2022-05-19;69;159;706;1814;747;6118965;6802414;10626182;135286;11747196
FR;2;2022-05-20;106;176;868;1700;775;6119071;6802590;10627050;136986;11747971
FR;2;2022-05-21;47;96;396;517;338;6119118;6802686;10627446;137503;11748309
FR;2;2022-05-22;8;23;69;37;57;6119126;6802709;10627515;137540;11748366
FR;2;2022-05-23;85;130;498;929;469;6119211;6802839;10628013;138469;11748835
FR;2;2022-05-24;86;161;622;1594;611;6119297;6803000;10628635;140063;11749446
FR;2;2022-05-25;70;141;537;1142;490;6119367;6803141;10629172;141205;11749936
FR;2;2022-05-26;8;28;75;41;81;6119375;6803169;10629247;141246;11750017
FR;2;2022-05-27;44;121;453;814;435;6119419;6803290;10629700;142060;11750452
FR;2;2022-05-28;28;60;220;243;220;6119447;6803350;10629920;142303;11750672
FR;2;2022-05-29;13;34;43;25;51;6119460;6803384;10629963;142328;11750723
FR;2;2022-05-30;65;108;418;719;404;6119525;6803492;10630381;143047;11751127
FR;2;2022-05-31;76;133;553;1274;503;6119601;6803625;10630934;144321;11751630
FR;2;2022-06-01;56;151;551;1039;532;6119657;6803776;10631485;145360;11752162
FR;2;2022-06-02;92;168;620;1389;583;6119749;6803944;10632105;146749;11752745
FR;2;2022-06-03;70;155;661;1603;588;6119819;6804099;10632766;148352;11753333
FR;2;2022-06-04;53;92;279;432;265;6119872;6804191;10633045;148784;11753598
FR;2;2022-06-05;11;17;62;57;47;6119883;6804208;10633107;148841;11753645
FR;2;2022-06-06;11;23;91;74;89;6119894;6804231;10633198;148915;11753734
FR;2;2022-06-07;98;217;657;1528;569;6119992;6804448;10633855;150443;11754303
FR;2;2022-06-08;70;116;472;1160;406;6120062;6804564;10634327;151603;11754709
FR;2;2022-06-09;91;163;598;1906;557;6120153;6804727;10634925;153509;11755266
FR;2;2022-06-10;84;164;637;1678;609;6120237;6804891;10635562;155187;11755875
FR;2;2022-06-11;42;81;284;526;257;6120279;6804972;10635846;155713;11756132
FR;2;2022-06-12;18;38;58;78;60;6120297;6805010;10635904;155791;11756192
FR;2;2022-06-13;35;117;384;948;369;6120332;6805127;10636288;156739;11756561
FR;2;2022-06-14;65;153;592;2084;530;6120397;6805280;10636880;158823;11757091
FR;2;2022-06-15;73;99;494;1495;424;6120470;6805379;10637374;160318;11757515
FR;2;2022-06-16;127;123;484;1410;410;6120597;6805502;10637858;161728;11757925
FR;2;2022-06-17;67;130;572;1815;498;6120664;6805632;10638430;163543;11758423
FR;2;2022-06-18;74;90;221;578;193;6120738;6805722;10638651;164121;11758616
FR;2;2022-06-19;11;13;52;71;40;6120749;6805735;10638703;164192;11758656
FR;2;2022-06-20;59;123;387;1026;379;6120808;6805858;10639090;165218;11759035
FR;2;2022-06-21;104;114;520;2111;450;6120912;6805972;10639610;167329;11759485
FR;2;2022-06-22;37;104;448;1884;401;6120949;6806076;10640058;169213;11759886
FR;2;2022-06-23;56;107;530;2280;446;6121005;6806183;10640588;171493;11760332
FR;2;2022-06-24;64;119;698;3175;562;6121069;6806302;10641286;174668;11760894
FR;2;2022-06-25;29;88;293;986;250;6121098;6806390;10641579;175654;11761144
FR;2;2022-06-26;30;28;131;194;97;6121128;6806418;10641710;175848;11761241
FR;2;2022-06-27;77;133;556;2469;461;6121205;6806551;10642266;178317;11761702
FR;2;2022-06-28;110;138;799;4800;643;6121315;6806689;10643065;183117;11762345
FR;2;2022-06-29;71;147;760;4336;622;6121386;6806836;10643825;187453;11762967
FR;2;2022-06-30;70;133;814;5135;604;6121456;6806969;10644639;192588;11763571
FR;2;2022-07-01;105;149;1001;6649;736;6121561;6807118;10645640;199237;11764307
FR;2;2022-07-02;63;126;444;1969;365;6121624;6807244;10646084;201206;11764672
FR;2;2022-07-03;23;25;143;333;127;6121647;6807269;10646227;201539;11764799
FR;2;2022-07-04;116;166;721;3758;558;6121763;6807435;10646948;205297;11765357
FR;2;2022-07-05;113;183;1080;6785;788;6121876;6807618;10648028;212082;11766145
FR;2;2022-07-06;92;145;916;5743;664;6121968;6807763;10648944;217825;11766809
FR;2;2022-07-07;80;183;985;6435;711;6122048;6807946;10649929;224260;11767520
FR;2;2022-07-08;58;114;1049;6979;712;6122106;6808060;10650978;231239;11768232
FR;2;2022-07-09;33;59;403;1856;290;6122139;6808119;10651381;233095;11768522
FR;2;2022-07-10;6;17;91;307;77;6122145;6808136;10651472;233402;11768599
FR;2;2022-07-11;65;108;623;3756;487;6122210;6808244;10652095;237158;11769086
FR;2;2022-07-12;91;166;985;6218;743;6122301;6808410;10653080;243376;11769829
FR;3;2020-12-27;0;0;0;0;0;0;0;0;0;0
FR;3;2020-12-28;0;0;0;0;0;0;0;0;0;0
FR;3;2020-12-29;0;0;0;0;0;0;0;0;0;0
FR;3;2020-12-30;0;0;0;0;0;0;0;0;0;0
FR;3;2020-12-31;0;0;0;0;0;0;0;0;0;0
FR;3;2021-01-01;0;0;0;0;0;0;0;0;0;0
FR;3;2021-01-02;0;0;0;0;0;0;0;0;0;0
FR;3;2021-01-03;0;0;0;0;0;0;0;0;0;0
FR;3;2021-01-04;0;0;0;0;0;0;0;0;0;0
FR;3;2021-01-05;0;0;0;0;0;0;0;0;0;0
FR;3;2021-01-06;0;0;0;0;0;0;0;0;0;0
FR;3;2021-01-07;0;0;0;0;0;0;0;0;0;0
FR;3;2021-01-08;0;0;0;0;0;0;0;0;0;0
FR;3;2021-01-09;0;0;0;0;0;0;0;0;0;0
FR;3;2021-01-10;0;0;0;0;0;0;0;0;0;0
FR;3;2021-01-11;0;0;0;0;0;0;0;0;0;0
FR;3;2021-01-12;0;0;0;0;0;0;0;0;0;0
FR;3;2021-01-13;0;0;0;0;0;0;0;0;0;0
FR;3;2021-01-14;0;0;0;0;0;0;0;0;0;0
FR;3;2021-01-15;0;0;0;0;0;0;0;0;0;0
FR;3;2021-01-16;0;0;0;0;0;0;0;0;0;0
FR;3;2021-01-17;0;0;0;0;0;0;0;0;0;0
FR;3;2021-01-18;0;0;0;0;0;0;0;0;0;0
FR;3;2021-01-19;0;0;0;0;0;0;0;0;0;0
FR;3;2021-01-20;0;0;0;0;0;0;0;0;0;0
FR;3;2021-01-21;0;0;0;0;0;0;0;0;0;0
FR;3;2021-01-22;0;0;0;0;0;0;0;0;0;0
FR;3;2021-01-23;0;0;0;0;0;0;0;0;0;0
FR;3;2021-01-24;0;0;0;0;0;0;0;0;0;0
FR;3;2021-01-25;0;0;0;0;0;0;0;0;0;0
FR;3;2021-01-26;0;0;0;0;0;0;0;0;0;0
FR;3;2021-01-27;0;0;0;0;0;0;0;0;0;0
FR;3;2021-01-28;0;0;0;0;0;0;0;0;0;0
FR;3;2021-01-29;0;0;0;0;0;0;0;0;0;0
FR;3;2021-01-30;0;0;0;0;0;0;0;0;0;0
FR;3;2021-01-31;0;0;0;0;0;0;0;0;0;0
FR;3;2021-02-01;0;0;0;0;0;0;0;0;0;0
FR;3;2021-02-02;0;0;0;0;0;0;0;0;0;0
FR;3;2021-02-03;0;0;0;0;0;0;0;0;0;0
FR;3;2021-02-04;0;0;0;0;0;0;0;0;0;0
FR;3;2021-02-05;0;0;0;0;0;0;0;0;0;0
FR;3;2021-02-06;1612;0;0;0;0;1612;0;0;0;0
FR;3;2021-02-07;1423;1;0;0;0;3035;1;0;0;0
FR;3;2021-02-08;2785;1;0;0;0;5820;2;0;0;0
FR;3;2021-02-09;6782;0;0;0;0;12602;2;0;0;0
FR;3;2021-02-10;9607;0;0;0;0;22209;2;0;0;0
FR;3;2021-02-11;13618;1;0;0;0;35827;3;0;0;0
FR;3;2021-02-12;13403;0;0;0;0;49230;3;0;0;0
FR;3;2021-02-13;3792;1;0;0;0;53022;4;0;0;0
FR;3;2021-02-14;972;0;0;0;0;53994;4;0;0;0
FR;3;2021-02-15;10489;1;0;0;0;64483;5;0;0;0
FR;3;2021-02-16;12547;4;0;0;0;77030;9;0;0;0
FR;3;2021-02-17;11154;0;0;0;0;88184;9;0;0;0
FR;3;2021-02-18;14941;2;0;0;0;103125;11;0;0;0
FR;3;2021-02-19;14359;1;0;0;0;117484;12;0;0;0
FR;3;2021-02-20;3330;0;0;0;0;120814;12;0;0;0
FR;3;2021-02-21;618;0;0;0;0;121432;12;0;0;0
FR;3;2021-02-22;9165;0;0;0;0;130597;12;0;0;0
FR;3;2021-02-23;11395;2;0;0;0;141992;14;0;0;0
FR;3;2021-02-24;14301;1;0;0;0;156293;15;0;0;0
FR;3;2021-02-25;44931;1;0;0;0;201224;16;0;0;0
FR;3;2021-02-26;61886;4;0;0;0;263110;20;0;0;0
FR;3;2021-02-27;34801;10;0;0;0;297911;30;0;0;0
FR;3;2021-02-28;2463;0;0;0;0;300374;30;0;0;0
FR;3;2021-03-01;20515;14;0;0;0;320889;44;0;0;0
FR;3;2021-03-02;38867;20;0;0;0;359756;64;0;0;0
FR;3;2021-03-03;48735;15;0;0;0;408491;79;0;0;0
FR;3;2021-03-04;82220;21;0;0;0;490711;100;0;0;0
FR;3;2021-03-05;118129;39;0;0;0;608840;139;0;0;0
FR;3;2021-03-06;120713;59;1;0;0;729553;198;1;0;0
FR;3;2021-03-07;55178;27;0;0;0;784731;225;1;0;0
FR;3;2021-03-08;42811;28;0;0;0;827542;253;1;0;0
FR;3;2021-03-09;78968;49;0;0;0;906510;302;1;0;0
FR;3;2021-03-10;80973;46;0;0;0;987483;348;1;0;0
FR;3;2021-03-11;128431;58;0;0;0;1115914;406;1;0;0
FR;3;2021-03-12;182721;99;0;0;0;1298635;505;1;0;0
FR;3;2021-03-13;132150;73;0;0;0;1430785;578;1;0;0
FR;3;2021-03-14;14055;5;0;0;0;1444840;583;1;0;0
FR;3;2021-03-15;52229;54;0;0;0;1497069;637;1;0;0
FR;3;2021-03-16;1213;33;0;0;0;1498282;670;1;0;0
FR;3;2021-03-17;944;38;0;0;0;1499226;708;1;0;0
FR;3;2021-03-18;1568;23;0;0;0;1500794;731;1;0;0
FR;3;2021-03-19;70453;50;0;0;0;1571247;781;1;0;0
FR;3;2021-03-20;65230;45;0;0;0;1636477;826;1;0;0
FR;3;2021-03-21;5758;7;0;0;0;1642235;833;1;0;0
FR;3;2021-03-22;37499;42;0;0;0;1679734;875;1;0;0
FR;3;2021-03-23;84656;68;0;0;0;1764390;943;1;0;0
FR;3;2021-03-24;90939;93;0;0;0;1855329;1036;1;0;0
FR;3;2021-03-25;150051;131;0;0;0;2005380;1167;1;0;0
FR;3;2021-03-26;165417;153;0;0;0;2170797;1320;1;0;0
FR;3;2021-03-27;68458;101;0;0;0;2239255;1421;1;0;0
FR;3;2021-03-28;6472;21;0;0;0;2245727;1442;1;0;0
FR;3;2021-03-29;54163;71;0;0;0;2299890;1513;1;0;0
FR;3;2021-03-30;93169;100;0;0;0;2393059;1613;1;0;0
FR;3;2021-03-31;63531;98;0;0;0;2456590;1711;1;0;0
FR;3;2021-04-01;86125;105;0;0;0;2542715;1816;1;0;0
FR;3;2021-04-02;86900;165;0;0;0;2629615;1981;1;0;0
FR;3;2021-04-03;35873;123;0;0;0;2665488;2104;1;0;0
FR;3;2021-04-04;3572;18;0;0;0;2669060;2122;1;0;0
FR;3;2021-04-05;4487;28;0;0;0;2673547;2150;1;0;0
FR;3;2021-04-06;29749;92;0;0;0;2703296;2242;1;0;0
FR;3;2021-04-07;32340;86;0;0;0;2735636;2328;1;0;0
FR;3;2021-04-08;78815;246;0;0;0;2814451;2574;1;0;0
FR;3;2021-04-09;161748;423;0;0;0;2976199;2997;1;0;0
FR;3;2021-04-10;75758;338;0;0;0;3051957;3335;1;0;0
FR;3;2021-04-11;7310;46;0;0;0;3059267;3381;1;0;0
FR;3;2021-04-12;51471;211;0;0;0;3110738;3592;1;0;0
FR;3;2021-04-13;86224;327;0;0;0;3196962;3919;1;0;0
FR;3;2021-04-14;67835;357;0;0;0;3264797;4276;1;0;0
FR;3;2021-04-15;93224;378;0;0;0;3358021;4654;1;0;0
FR;3;2021-04-16;112518;591;0;0;0;3470539;5245;1;0;0
FR;3;2021-04-17;53315;334;1;0;0;3523854;5579;2;0;0
FR;3;2021-04-18;9745;38;0;0;0;3533599;5617;2;0;0
FR;3;2021-04-19;25104;252;0;0;0;3558703;5869;2;0;0
FR;3;2021-04-20;45673;405;0;0;0;3604376;6274;2;0;0
FR;3;2021-04-21;38971;483;0;0;0;3643347;6757;2;0;0
FR;3;2021-04-22;54706;800;0;0;0;3698053;7557;2;0;0
FR;3;2021-04-23;70488;1032;0;0;0;3768541;8589;2;0;0
FR;3;2021-04-24;37242;1033;0;0;0;3805783;9622;2;0;0
FR;3;2021-04-25;6207;150;0;0;0;3811990;9772;2;0;0
FR;3;2021-04-26;19785;670;0;0;0;3831775;10442;2;0;0
FR;3;2021-04-27;34473;1273;0;0;0;3866248;11715;2;0;0
FR;3;2021-04-28;28967;1964;0;0;0;3895215;13679;2;0;0
FR;3;2021-04-29;45381;6005;0;0;0;3940596;19684;2;0;0
FR;3;2021-04-30;55458;8980;1;0;0;3996054;28664;3;0;0
FR;3;2021-05-01;9511;2011;0;0;0;4005565;30675;3;0;0
FR;3;2021-05-02;3074;483;0;0;0;4008639;31158;3;0;0
FR;3;2021-05-03;13060;3883;0;0;0;4021699;35041;3;0;0
FR;3;2021-05-04;23112;8448;0;0;0;4044811;43489;3;0;0
FR;3;2021-05-05;18756;10670;0;0;0;4063567;54159;3;0;0
FR;3;2021-05-06;34626;21006;0;0;0;4098193;75165;3;0;0
FR;3;2021-05-07;44201;28592;0;0;0;4142394;103757;3;0;0
FR;3;2021-05-08;6786;9090;0;0;0;4149180;112847;3;0;0
FR;3;2021-05-09;1794;2662;0;0;0;4150974;115509;3;0;0
FR;3;2021-05-10;14991;12730;0;0;0;4165965;128239;3;0;0
FR;3;2021-05-11;27093;25963;0;0;0;4193058;154202;3;0;0
FR;3;2021-05-12;17267;27707;0;0;0;4210325;181909;3;0;0
FR;3;2021-05-13;2281;3491;0;0;0;4212606;185400;3;0;0
FR;3;2021-05-14;14515;25895;0;0;0;4227121;211295;3;0;0
FR;3;2021-05-15;7233;20882;0;0;0;4234354;232177;3;0;0
FR;3;2021-05-16;976;2654;0;0;0;4235330;234831;3;0;0
FR;3;2021-05-17;7962;20033;0;0;0;4243292;254864;3;0;0
FR;3;2021-05-18;13411;29836;0;0;0;4256703;284700;3;0;0
FR;3;2021-05-19;9268;31174;0;0;0;4265971;315874;3;0;0
FR;3;2021-05-20;12802;53455;3;0;0;4278773;369329;6;0;0
FR;3;2021-05-21;12759;65779;2;0;0;4291532;435108;8;0;0
FR;3;2021-05-22;4963;33463;1;0;0;4296495;468571;9;0;0
FR;3;2021-05-23;650;2655;0;0;0;4297145;471226;9;0;0
FR;3;2021-05-24;882;4900;0;0;0;4298027;476126;9;0;0
FR;3;2021-05-25;5306;45868;1;0;0;4303333;521994;10;0;0
FR;3;2021-05-26;4975;51490;1;0;0;4308308;573484;11;0;0
FR;3;2021-05-27;6326;78383;3;0;0;4314634;651867;14;0;0
FR;3;2021-05-28;7541;99501;2;0;0;4322175;751368;16;0;0
FR;3;2021-05-29;3348;60605;1;0;0;4325523;811973;17;0;0
FR;3;2021-05-30;548;8186;0;0;0;4326071;820159;17;0;0
FR;3;2021-05-31;2439;35717;3;0;0;4328510;855876;20;0;0
FR;3;2021-06-01;3401;64784;10;0;0;4331911;920660;30;0;0
FR;3;2021-06-02;2729;58494;6;0;0;4334640;979154;36;0;0
FR;3;2021-06-03;3492;87415;10;0;0;4338132;1066569;46;0;0
FR;3;2021-06-04;4114;105373;22;0;0;4342246;1171942;68;0;0
FR;3;2021-06-05;1980;52373;4;0;0;4344226;1224315;72;0;0
FR;3;2021-06-06;506;5340;1;0;0;4344732;1229655;73;0;0
FR;3;2021-06-07;1475;30970;11;0;0;4346207;1260625;84;0;0
FR;3;2021-06-08;2054;47261;18;0;0;4348261;1307886;102;0;0
FR;3;2021-06-09;1792;42081;13;0;0;4350053;1349967;115;0;0
FR;3;2021-06-10;2246;67712;17;0;0;4352299;1417679;132;0;0
FR;3;2021-06-11;2479;96644;34;0;0;4354778;1514323;166;0;0
FR;3;2021-06-12;1175;40732;6;0;0;4355953;1555055;172;0;0
FR;3;2021-06-13;279;3733;3;0;0;4356232;1558788;175;0;0
FR;3;2021-06-14;1043;42499;17;0;0;4357275;1601287;192;0;0
FR;3;2021-06-15;1365;80509;20;0;0;4358640;1681796;212;0;0
FR;3;2021-06-16;1256;65548;20;0;0;4359896;1747344;232;0;0
FR;3;2021-06-17;1661;101961;41;0;0;4361557;1849305;273;0;0
FR;3;2021-06-18;1870;118113;62;0;0;4363427;1967418;335;0;0
FR;3;2021-06-19;801;39390;22;0;0;4364228;2006808;357;0;0
FR;3;2021-06-20;159;3308;0;0;0;4364387;2010116;357;0;0
FR;3;2021-06-21;770;39175;16;0;0;4365157;2049291;373;0;0
FR;3;2021-06-22;1062;69973;52;0;0;4366219;2119264;425;0;0
FR;3;2021-06-23;941;50804;39;0;0;4367160;2170068;464;0;0
FR;3;2021-06-24;1310;77162;48;0;0;4368470;2247230;512;0;0
FR;3;2021-06-25;1403;90242;73;0;0;4369873;2337472;585;0;0
FR;3;2021-06-26;629;33106;29;0;0;4370502;2370578;614;0;0
FR;3;2021-06-27;166;3928;1;0;0;4370668;2374506;615;0;0
FR;3;2021-06-28;649;30266;27;0;0;4371317;2404772;642;0;0
FR;3;2021-06-29;854;56281;95;0;0;4372171;2461053;737;0;0
FR;3;2021-06-30;903;45090;93;0;0;4373074;2506143;830;0;0
FR;3;2021-07-01;1162;65816;108;0;0;4374236;2571959;938;0;0
FR;3;2021-07-02;1303;90392;170;0;0;4375539;2662351;1108;0;0
FR;3;2021-07-03;602;31170;52;0;0;4376141;2693521;1160;0;0
FR;3;2021-07-04;143;4178;3;0;0;4376284;2697699;1163;0;0
FR;3;2021-07-05;610;33790;60;0;0;4376894;2731489;1223;0;0
FR;3;2021-07-06;959;56007;88;0;0;4377853;2787496;1311;0;0
FR;3;2021-07-07;870;43010;80;0;0;4378723;2830506;1391;0;0
FR;3;2021-07-08;1123;60711;99;0;0;4379846;2891217;1490;0;0
FR;3;2021-07-09;1259;68822;128;0;0;4381105;2960039;1618;0;0
FR;3;2021-07-10;642;25043;59;0;0;4381747;2985082;1677;0;0
FR;3;2021-07-11;129;3250;4;0;0;4381876;2988332;1681;0;0
FR;3;2021-07-12;660;23791;59;0;0;4382536;3012123;1740;0;0
FR;3;2021-07-13;1645;34653;90;0;0;4384181;3046776;1830;0;0
FR;3;2021-07-14;265;2558;2;0;0;4384446;3049334;1832;0;0
FR;3;2021-07-15;1935;30573;85;0;0;4386381;3079907;1917;0;0
FR;3;2021-07-16;2520;38786;122;0;0;4388901;3118693;2039;0;0
FR;3;2021-07-17;1046;13723;26;0;0;4389947;3132416;2065;0;0
FR;3;2021-07-18;263;2583;3;0;0;4390210;3134999;2068;0;0
FR;3;2021-07-19;1275;17093;37;0;0;4391485;3152092;2105;0;0
FR;3;2021-07-20;1823;27062;98;0;0;4393308;3179154;2203;0;0
FR;3;2021-07-21;1649;19643;44;0;0;4394957;3198797;2247;0;0
FR;3;2021-07-22;1851;27690;83;0;0;4396808;3226487;2330;0;0
FR;3;2021-07-23;2215;30383;117;0;0;4399023;3256870;2447;0;0
FR;3;2021-07-24;823;6982;25;0;0;4399846;3263852;2472;0;0
FR;3;2021-07-25;210;1325;1;0;0;4400056;3265177;2473;0;0
FR;3;2021-07-26;927;10635;28;0;0;4400983;3275812;2501;0;0
FR;3;2021-07-27;1167;16908;56;0;0;4402150;3292720;2557;0;0
FR;3;2021-07-28;988;12054;40;0;0;4403138;3304774;2597;0;0
FR;3;2021-07-29;1126;15782;63;0;0;4404264;3320556;2660;0;0
FR;3;2021-07-30;1127;18034;79;0;0;4405391;3338590;2739;0;0
FR;3;2021-07-31;406;3746;15;0;0;4405797;3342336;2754;0;0
FR;3;2021-08-01;113;476;1;0;0;4405910;3342812;2755;0;0
FR;3;2021-08-02;420;5122;22;0;0;4406330;3347934;2777;0;0
FR;3;2021-08-03;492;7546;27;0;0;4406822;3355480;2804;0;0
FR;3;2021-08-04;435;4868;26;0;0;4407257;3360348;2830;0;0
FR;3;2021-08-05;429;3701;12;0;0;4407686;3364049;2842;0;0
FR;3;2021-08-06;454;4754;30;0;0;4408140;3368803;2872;0;0
FR;3;2021-08-07;214;1917;11;0;0;4408354;3370720;2883;0;0
FR;3;2021-08-08;249;429;2;0;0;4408603;3371149;2885;0;0
FR;3;2021-08-09;314;2460;11;0;0;4408917;3373609;2896;0;0
FR;3;2021-08-10;368;3837;15;0;0;4409285;3377446;2911;0;0
FR;3;2021-08-11;287;2699;15;0;0;4409572;3380145;2926;0;0
FR;3;2021-08-12;277;2615;12;0;0;4409849;3382760;2938;0;0
FR;3;2021-08-13;277;2262;16;0;0;4410126;3385022;2954;0;0
FR;3;2021-08-14;171;909;1;0;0;4410297;3385931;2955;0;0
FR;3;2021-08-15;55;174;0;0;0;4410352;3386105;2955;0;0
FR;3;2021-08-16;123;1060;8;0;0;4410475;3387165;2963;0;0
FR;3;2021-08-17;186;1483;8;0;0;4410661;3388648;2971;0;0
FR;3;2021-08-18;200;1343;10;0;0;4410861;3389991;2981;0;0
FR;3;2021-08-19;165;1402;10;0;0;4411026;3391393;2991;0;0
FR;3;2021-08-20;167;1625;16;0;0;4411193;3393018;3007;0;0
FR;3;2021-08-21;93;587;2;0;0;4411286;3393605;3009;0;0
FR;3;2021-08-22;42;186;1;0;0;4411328;3393791;3010;0;0
FR;3;2021-08-23;140;922;7;0;0;4411468;3394713;3017;0;0
FR;3;2021-08-24;124;956;10;0;0;4411592;3395669;3027;0;0
FR;3;2021-08-25;137;835;3;0;0;4411729;3396504;3030;0;0
FR;3;2021-08-26;171;860;9;0;0;4411900;3397364;3039;0;0
FR;3;2021-08-27;175;954;9;0;0;4412075;3398318;3048;0;0
FR;3;2021-08-28;99;371;4;0;0;4412174;3398689;3052;0;0
FR;3;2021-08-29;128;135;1;0;0;4412302;3398824;3053;0;0
FR;3;2021-08-30;99;590;0;0;129;4412401;3399414;3053;0;129
FR;3;2021-08-31;130;700;7;0;147;4412531;3400114;3060;0;276
FR;3;2021-09-01;116;472;5;0;118;4412647;3400586;3065;0;394
FR;3;2021-09-02;100;629;22;0;117;4412747;3401215;3087;0;511
FR;3;2021-09-03;116;581;17;0;126;4412863;3401796;3104;0;637
FR;3;2021-09-04;54;301;3;0;56;4412917;3402097;3107;0;693
FR;3;2021-09-05;51;68;5;0;28;4412968;3402165;3112;0;721
FR;3;2021-09-06;116;387;4;0;144;4413084;3402552;3116;0;865
FR;3;2021-09-07;123;462;14;0;125;4413207;3403014;3130;0;990
FR;3;2021-09-08;119;361;2;0;98;4413326;3403375;3132;0;1088
FR;3;2021-09-09;93;387;8;0;110;4413419;3403762;3140;0;1198
FR;3;2021-09-10;100;412;3;0;100;4413519;3404174;3143;0;1298
FR;3;2021-09-11;76;236;4;0;66;4413595;3404410;3147;0;1364
FR;3;2021-09-12;37;47;1;0;18;4413632;3404457;3148;0;1382
FR;3;2021-09-13;72;313;7;0;105;4413704;3404770;3155;0;1487
FR;3;2021-09-14;72;284;6;0;101;4413776;3405054;3161;0;1588
FR;3;2021-09-15;60;259;3;0;6;4413836;3405313;3164;0;1594
FR;3;2021-09-16;60;333;5;0;5;4413896;3405646;3169;0;1599
FR;3;2021-09-17;51;340;3;0;7;4413947;3405986;3172;0;1606
FR;3;2021-09-18;36;175;1;0;1;4413983;3406161;3173;0;1607
FR;3;2021-09-19;27;31;2;0;1;4414010;3406192;3175;0;1608
FR;3;2021-09-20;79;200;0;0;1;4414089;3406392;3175;0;1609
FR;3;2021-09-21;59;286;6;0;7;4414148;3406678;3181;0;1616
FR;3;2021-09-22;64;228;6;0;7;4414212;3406906;3187;0;1623
FR;3;2021-09-23;36;270;11;0;7;4414248;3407176;3198;0;1630
FR;3;2021-09-24;27;323;12;0;19;4414275;3407499;3210;0;1649
FR;3;2021-09-25;30;147;3;0;3;4414305;3407646;3213;0;1652
FR;3;2021-09-26;15;57;1;0;1;4414320;3407703;3214;0;1653
FR;3;2021-09-27;41;292;3;0;5;4414361;3407995;3217;0;1658
FR;3;2021-09-28;49;251;6;0;10;4414410;3408246;3223;0;1668
FR;3;2021-09-29;35;226;10;0;14;4414445;3408472;3233;0;1682
FR;3;2021-09-30;38;199;8;0;10;4414483;3408671;3241;0;1692
FR;3;2021-10-01;18;165;6;0;6;4414501;3408836;3247;0;1698
FR;3;2021-10-02;16;89;0;0;0;4414517;3408925;3247;0;1698
FR;3;2021-10-03;19;18;1;0;2;4414536;3408943;3248;0;1700
FR;3;2021-10-04;30;158;4;0;4;4414566;3409101;3252;0;1704
FR;3;2021-10-05;16;151;10;0;13;4414582;3409252;3262;0;1717
FR;3;2021-10-06;31;153;8;0;9;4414613;3409405;3270;0;1726
FR;3;2021-10-07;19;137;6;0;6;4414632;3409542;3276;0;1732
FR;3;2021-10-08;22;143;10;0;9;4414654;3409685;3286;0;1741
FR;3;2021-10-09;13;70;1;0;1;4414667;3409755;3287;0;1742
FR;3;2021-10-10;13;17;2;0;2;4414680;3409772;3289;0;1744
FR;3;2021-10-11;15;121;4;0;5;4414695;3409893;3293;0;1749
FR;3;2021-10-12;18;108;5;0;5;4414713;3410001;3298;0;1754
FR;3;2021-10-13;23;116;8;0;6;4414736;3410117;3306;0;1760
FR;3;2021-10-14;16;157;3;0;4;4414752;3410274;3309;0;1764
FR;3;2021-10-15;23;154;8;0;11;4414775;3410428;3317;0;1775
FR;3;2021-10-16;11;77;6;0;8;4414786;3410505;3323;0;1783
FR;3;2021-10-17;11;24;0;0;0;4414797;3410529;3323;0;1783
FR;3;2021-10-18;18;122;2;0;2;4414815;3410651;3325;0;1785
FR;3;2021-10-19;16;119;19;0;21;4414831;3410770;3344;0;1806
FR;3;2021-10-20;22;128;6;0;7;4414853;3410898;3350;0;1813
FR;3;2021-10-21;26;131;17;0;13;4414879;3411029;3367;0;1826
FR;3;2021-10-22;21;125;16;0;20;4414900;3411154;3383;0;1846
FR;3;2021-10-23;12;59;2;0;1;4414912;3411213;3385;0;1847
FR;3;2021-10-24;7;32;0;0;0;4414919;3411245;3385;0;1847
FR;3;2021-10-25;22;149;7;0;7;4414941;3411394;3392;0;1854
FR;3;2021-10-26;19;112;22;0;19;4414960;3411506;3414;0;1873
FR;3;2021-10-27;17;110;9;0;9;4414977;3411616;3423;0;1882
FR;3;2021-10-28;20;119;33;0;36;4414997;3411735;3456;0;1918
FR;3;2021-10-29;11;114;64;0;54;4415008;3411849;3520;0;1972
FR;3;2021-10-30;9;65;11;1;10;4415017;3411914;3531;1;1982
FR;3;2021-10-31;7;22;1;0;1;4415024;3411936;3532;1;1983
FR;3;2021-11-01;8;22;2;0;1;4415032;3411958;3534;1;1984
FR;3;2021-11-02;9;104;8;0;10;4415041;3412062;3542;1;1994
FR;3;2021-11-03;19;112;10;0;10;4415060;3412174;3552;1;2004
FR;3;2021-11-04;18;93;4;0;3;4415078;3412267;3556;1;2007
FR;3;2021-11-05;17;135;8;1;5;4415095;3412402;3564;2;2012
FR;3;2021-11-06;7;63;3;0;3;4415102;3412465;3567;2;2015
FR;3;2021-11-07;6;21;1;0;1;4415108;3412486;3568;2;2016
FR;3;2021-11-08;11;137;7;0;5;4415119;3412623;3575;2;2021
FR;3;2021-11-09;12;143;5;0;5;4415131;3412766;3580;2;2026
FR;3;2021-11-10;13;169;14;0;15;4415144;3412935;3594;2;2041
FR;3;2021-11-11;10;50;3;0;3;4415154;3412985;3597;2;2044
FR;3;2021-11-12;12;148;6;0;4;4415166;3413133;3603;2;2048
FR;3;2021-11-13;7;75;9;0;10;4415173;3413208;3612;2;2058
FR;3;2021-11-14;3;23;0;0;0;4415176;3413231;3612;2;2058
FR;3;2021-11-15;5;186;10;0;11;4415181;3413417;3622;2;2069
FR;3;2021-11-16;3;152;11;0;10;4415184;3413569;3633;2;2079
FR;3;2021-11-17;6;166;10;0;7;4415190;3413735;3643;2;2086
FR;3;2021-11-18;13;166;10;0;11;4415203;3413901;3653;2;2097
FR;3;2021-11-19;10;213;22;0;27;4415213;3414114;3675;2;2124
FR;3;2021-11-20;6;107;5;0;5;4415219;3414221;3680;2;2129
FR;3;2021-11-21;3;26;3;0;3;4415222;3414247;3683;2;2132
FR;3;2021-11-22;11;219;10;0;10;4415233;3414466;3693;2;2142
FR;3;2021-11-23;8;211;15;0;14;4415241;3414677;3708;2;2156
FR;3;2021-11-24;5;221;9;0;17;4415246;3414898;3717;2;2173
FR;3;2021-11-25;9;256;11;0;10;4415255;3415154;3728;2;2183
FR;3;2021-11-26;7;324;35;0;32;4415262;3415478;3763;2;2215
FR;3;2021-11-27;8;160;20;0;21;4415270;3415638;3783;2;2236
FR;3;2021-11-28;3;62;7;0;7;4415273;3415700;3790;2;2243
FR;3;2021-11-29;5;287;19;0;20;4415278;3415987;3809;2;2263
FR;3;2021-11-30;5;369;26;0;29;4415283;3416356;3835;2;2292
FR;3;2021-12-01;22;407;35;0;36;4415305;3416763;3870;2;2328
FR;3;2021-12-02;9;439;33;0;36;4415314;3417202;3903;2;2364
FR;3;2021-12-03;3;499;37;0;38;4415317;3417701;3940;2;2402
FR;3;2021-12-04;3;255;26;0;28;4415320;3417956;3966;2;2430
FR;3;2021-12-05;1;73;5;0;5;4415321;3418029;3971;2;2435
FR;3;2021-12-06;5;461;14;0;15;4415326;3418490;3985;2;2450
FR;3;2021-12-07;4;538;20;0;24;4415330;3419028;4005;2;2474
FR;3;2021-12-08;6;490;29;0;30;4415336;3419518;4034;2;2504
FR;3;2021-12-09;3;549;17;0;22;4415339;3420067;4051;2;2526
FR;3;2021-12-10;9;566;29;0;25;4415348;3420633;4080;2;2551
FR;3;2021-12-11;4;357;10;0;9;4415352;3420990;4090;2;2560
FR;3;2021-12-12;1;115;3;0;3;4415353;3421105;4093;2;2563
FR;3;2021-12-13;2;543;19;0;21;4415355;3421648;4112;2;2584
FR;3;2021-12-14;7;689;18;0;21;4415362;3422337;4130;2;2605
FR;3;2021-12-15;9;657;17;0;21;4415371;3422994;4147;2;2626
FR;3;2021-12-16;10;668;19;0;18;4415381;3423662;4166;2;2644
FR;3;2021-12-17;5;745;18;0;19;4415386;3424407;4184;2;2663
FR;3;2021-12-18;4;392;4;0;5;4415390;3424799;4188;2;2668
FR;3;2021-12-19;3;200;2;0;2;4415393;3424999;4190;2;2670
FR;3;2021-12-20;8;682;23;0;28;4415401;3425681;4213;2;2698
FR;3;2021-12-21;3;768;10;0;13;4415404;3426449;4223;2;2711
FR;3;2021-12-22;8;723;9;0;10;4415412;3427172;4232;2;2721
FR;3;2021-12-23;2;621;9;0;8;4415414;3427793;4241;2;2729
FR;3;2021-12-24;2;257;3;0;6;4415416;3428050;4244;2;2735
FR;3;2021-12-25;0;25;0;0;0;4415416;3428075;4244;2;2735
FR;3;2021-12-26;0;92;1;0;1;4415416;3428167;4245;2;2736
FR;3;2021-12-27;7;522;17;0;20;4415423;3428689;4262;2;2756
FR;3;2021-12-28;1;667;6;0;5;4415424;3429356;4268;2;2761
FR;3;2021-12-29;4;556;14;0;16;4415428;3429912;4282;2;2777
FR;3;2021-12-30;1;581;7;0;10;4415429;3430493;4289;2;2787
FR;3;2021-12-31;0;201;5;0;7;4415429;3430694;4294;2;2794
FR;3;2022-01-01;0;26;0;0;2;4415429;3430720;4294;2;2796
FR;3;2022-01-02;0;81;0;0;0;4415429;3430801;4294;2;2796
FR;3;2022-01-03;4;554;17;0;21;4415433;3431355;4311;2;2817
FR;3;2022-01-04;6;610;9;0;8;4415439;3431965;4320;2;2825
FR;3;2022-01-05;4;539;10;0;14;4415443;3432504;4330;2;2839
FR;3;2022-01-06;5;531;9;0;11;4415448;3433035;4339;2;2850
FR;3;2022-01-07;2;564;11;0;13;4415450;3433599;4350;2;2863
FR;3;2022-01-08;2;277;4;0;5;4415452;3433876;4354;2;2868
FR;3;2022-01-09;0;118;0;0;0;4415452;3433994;4354;2;2868
FR;3;2022-01-10;2;468;12;0;12;4415454;3434462;4366;2;2880
FR;3;2022-01-11;2;517;1;0;1;4415456;3434979;4367;2;2881
FR;3;2022-01-12;2;438;9;0;10;4415458;3435417;4376;2;2891
FR;3;2022-01-13;3;415;11;0;12;4415461;3435832;4387;2;2903
FR;3;2022-01-14;3;468;10;0;13;4415464;3436300;4397;2;2916
FR;3;2022-01-15;0;295;2;0;3;4415464;3436595;4399;2;2919
FR;3;2022-01-16;1;115;1;0;1;4415465;3436710;4400;2;2920
FR;3;2022-01-17;2;344;8;0;9;4415467;3437054;4408;2;2929
FR;3;2022-01-18;2;402;1;0;2;4415469;3437456;4409;2;2931
FR;3;2022-01-19;2;345;5;0;10;4415471;3437801;4414;2;2941
FR;3;2022-01-20;1;375;5;0;3;4415472;3438176;4419;2;2944
FR;3;2022-01-21;4;366;5;0;7;4415476;3438542;4424;2;2951
FR;3;2022-01-22;2;230;1;0;2;4415478;3438772;4425;2;2953
FR;3;2022-01-23;0;82;0;0;1;4415478;3438854;4425;2;2954
FR;3;2022-01-24;2;343;1;0;6;4415480;3439197;4426;2;2960
FR;3;2022-01-25;0;189;0;0;0;4415480;3439386;4426;2;2960
FR;3;2022-01-26;0;83;0;0;0;4415480;3439469;4426;2;2960
FR;3;2022-01-27;0;55;0;0;0;4415480;3439524;4426;2;2960
FR;3;2022-01-28;0;132;0;0;0;4415480;3439656;4426;2;2960
FR;3;2022-01-29;0;109;0;0;0;4415480;3439765;4426;2;2960
FR;3;2022-01-30;0;51;0;0;0;4415480;3439816;4426;2;2960
FR;3;2022-01-31;0;96;0;0;0;4415480;3439912;4426;2;2960
FR;3;2022-02-01;0;107;0;0;1;4415480;3440019;4426;2;2961
FR;3;2022-02-02;0;94;0;0;0;4415480;3440113;4426;2;2961
FR;3;2022-02-03;0;101;0;0;0;4415480;3440214;4426;2;2961
FR;3;2022-02-04;0;123;0;0;0;4415480;3440337;4426;2;2961
FR;3;2022-02-05;0;73;0;0;0;4415480;3440410;4426;2;2961
FR;3;2022-02-06;0;11;0;0;0;4415480;3440421;4426;2;2961
FR;3;2022-02-07;0;89;0;0;1;4415480;3440510;4426;2;2962
FR;3;2022-02-08;0;0;0;0;0;4415480;3440510;4426;2;2962
FR;3;2022-02-09;0;0;0;0;0;4415480;3440510;4426;2;2962
FR;3;2022-02-10;0;0;0;0;0;4415480;3440510;4426;2;2962
FR;3;2022-02-11;0;0;0;0;0;4415480;3440510;4426;2;2962
FR;3;2022-02-12;0;0;0;0;0;4415480;3440510;4426;2;2962
FR;3;2022-02-13;0;0;0;0;0;4415480;3440510;4426;2;2962
FR;3;2022-02-14;0;0;0;0;0;4415480;3440510;4426;2;2962
FR;3;2022-02-15;0;0;0;0;0;4415480;3440510;4426;2;2962
FR;3;2022-02-16;0;0;0;0;0;4415480;3440510;4426;2;2962
FR;3;2022-02-17;0;0;0;0;0;4415480;3440510;4426;2;2962
FR;3;2022-02-18;0;0;0;0;0;4415480;3440510;4426;2;2962
FR;3;2022-02-19;0;0;0;0;0;4415480;3440510;4426;2;2962
FR;3;2022-02-20;0;0;0;0;0;4415480;3440510;4426;2;2962
FR;3;2022-02-21;2;0;0;0;0;4415482;3440510;4426;2;2962
FR;3;2022-02-22;0;0;0;0;0;4415482;3440510;4426;2;2962
FR;3;2022-02-23;0;0;0;0;0;4415482;3440510;4426;2;2962
FR;3;2022-02-24;0;0;0;0;0;4415482;3440510;4426;2;2962
FR;3;2022-02-25;0;0;0;0;0;4415482;3440510;4426;2;2962
FR;3;2022-02-26;0;0;0;0;0;4415482;3440510;4426;2;2962
FR;3;2022-02-27;0;0;0;0;0;4415482;3440510;4426;2;2962
FR;3;2022-02-28;1;0;0;0;0;4415483;3440510;4426;2;2962
FR;3;2022-03-01;1;0;0;0;0;4415484;3440510;4426;2;2962
FR;3;2022-03-02;0;0;0;0;0;4415484;3440510;4426;2;2962
FR;3;2022-03-03;0;0;0;0;0;4415484;3440510;4426;2;2962
FR;3;2022-03-04;0;0;0;0;0;4415484;3440510;4426;2;2962
FR;3;2022-03-05;0;0;0;0;0;4415484;3440510;4426;2;2962
FR;3;2022-03-06;1;0;0;0;0;4415485;3440510;4426;2;2962
FR;3;2022-03-07;0;0;0;0;0;4415485;3440510;4426;2;2962
FR;3;2022-03-08;1;0;0;0;0;4415486;3440510;4426;2;2962
FR;3;2022-03-09;0;0;0;0;0;4415486;3440510;4426;2;2962
FR;3;2022-03-10;0;0;0;0;0;4415486;3440510;4426;2;2962
FR;3;2022-03-11;0;0;0;0;0;4415486;3440510;4426;2;2962
FR;3;2022-03-12;0;0;0;0;0;4415486;3440510;4426;2;2962
FR;3;2022-03-13;0;0;0;0;0;4415486;3440510;4426;2;2962
FR;3;2022-03-14;0;0;0;0;0;4415486;3440510;4426;2;2962
FR;3;2022-03-15;0;0;0;0;0;4415486;3440510;4426;2;2962
FR;3;2022-03-16;0;0;0;0;0;4415486;3440510;4426;2;2962
FR;3;2022-03-17;0;0;0;0;0;4415486;3440510;4426;2;2962
FR;3;2022-03-18;0;0;0;0;0;4415486;3440510;4426;2;2962
FR;3;2022-03-19;0;0;0;0;0;4415486;3440510;4426;2;2962
FR;3;2022-03-20;1;0;0;0;0;4415487;3440510;4426;2;2962
FR;3;2022-03-21;0;0;0;0;0;4415487;3440510;4426;2;2962
FR;3;2022-03-22;0;0;0;0;0;4415487;3440510;4426;2;2962
FR;3;2022-03-23;1;0;0;0;0;4415488;3440510;4426;2;2962
FR;3;2022-03-24;0;0;0;0;0;4415488;3440510;4426;2;2962
FR;3;2022-03-25;1;0;0;0;0;4415489;3440510;4426;2;2962
FR;3;2022-03-26;0;0;0;0;0;4415489;3440510;4426;2;2962
FR;3;2022-03-27;0;0;0;0;0;4415489;3440510;4426;2;2962
FR;3;2022-03-28;0;0;0;0;0;4415489;3440510;4426;2;2962
FR;3;2022-03-29;0;0;0;0;0;4415489;3440510;4426;2;2962
FR;3;2022-03-30;0;0;0;0;0;4415489;3440510;4426;2;2962
FR;3;2022-03-31;0;0;0;0;0;4415489;3440510;4426;2;2962
FR;3;2022-04-01;0;0;0;0;0;4415489;3440510;4426;2;2962
FR;3;2022-04-02;0;0;0;0;0;4415489;3440510;4426;2;2962
FR;3;2022-04-03;0;0;0;0;0;4415489;3440510;4426;2;2962
FR;3;2022-04-04;0;0;0;0;0;4415489;3440510;4426;2;2962
FR;3;2022-04-05;0;0;0;0;0;4415489;3440510;4426;2;2962
FR;3;2022-04-06;0;0;0;0;0;4415489;3440510;4426;2;2962
FR;3;2022-04-07;0;0;0;0;0;4415489;3440510;4426;2;2962
FR;3;2022-04-08;0;0;0;0;0;4415489;3440510;4426;2;2962
FR;3;2022-04-09;0;0;0;0;0;4415489;3440510;4426;2;2962
FR;3;2022-04-10;0;0;0;0;0;4415489;3440510;4426;2;2962
FR;3;2022-04-11;0;0;0;0;0;4415489;3440510;4426;2;2962
FR;3;2022-04-12;0;0;0;0;0;4415489;3440510;4426;2;2962
FR;3;2022-04-13;0;0;0;0;0;4415489;3440510;4426;2;2962
FR;3;2022-04-14;0;0;0;0;0;4415489;3440510;4426;2;2962
FR;3;2022-04-15;1;0;0;0;0;4415490;3440510;4426;2;2962
FR;3;2022-04-16;0;0;0;0;0;4415490;3440510;4426;2;2962
FR;3;2022-04-17;0;0;0;0;0;4415490;3440510;4426;2;2962
FR;3;2022-04-18;0;0;0;0;0;4415490;3440510;4426;2;2962
FR;3;2022-04-19;0;0;0;0;0;4415490;3440510;4426;2;2962
FR;3;2022-04-20;0;0;0;0;0;4415490;3440510;4426;2;2962
FR;3;2022-04-21;0;0;0;0;0;4415490;3440510;4426;2;2962
FR;3;2022-04-22;0;0;0;0;0;4415490;3440510;4426;2;2962
FR;3;2022-04-23;0;0;0;0;0;4415490;3440510;4426;2;2962
FR;3;2022-04-24;0;0;0;0;0;4415490;3440510;4426;2;2962
FR;3;2022-04-25;0;0;0;0;0;4415490;3440510;4426;2;2962
FR;3;2022-04-26;0;0;0;0;0;4415490;3440510;4426;2;2962
FR;3;2022-04-27;0;0;0;0;0;4415490;3440510;4426;2;2962
FR;3;2022-04-28;0;0;0;0;0;4415490;3440510;4426;2;2962
FR;3;2022-04-29;0;0;0;0;0;4415490;3440510;4426;2;2962
FR;3;2022-04-30;0;0;0;0;0;4415490;3440510;4426;2;2962
FR;3;2022-05-01;0;0;0;0;0;4415490;3440510;4426;2;2962
FR;3;2022-05-02;0;0;0;0;0;4415490;3440510;4426;2;2962
FR;3;2022-05-03;0;0;0;0;0;4415490;3440510;4426;2;2962
FR;3;2022-05-04;0;0;0;0;0;4415490;3440510;4426;2;2962
FR;3;2022-05-05;0;0;0;0;0;4415490;3440510;4426;2;2962
FR;3;2022-05-06;0;0;0;0;0;4415490;3440510;4426;2;2962
FR;3;2022-05-07;0;0;0;0;0;4415490;3440510;4426;2;2962
FR;3;2022-05-08;0;0;0;0;0;4415490;3440510;4426;2;2962
FR;3;2022-05-09;0;0;0;0;0;4415490;3440510;4426;2;2962
FR;3;2022-05-10;0;0;0;0;0;4415490;3440510;4426;2;2962
FR;3;2022-05-11;0;0;0;0;0;4415490;3440510;4426;2;2962
FR;3;2022-05-12;0;0;0;0;0;4415490;3440510;4426;2;2962
FR;3;2022-05-13;0;0;0;0;0;4415490;3440510;4426;2;2962
FR;3;2022-05-14;1;0;0;0;0;4415491;3440510;4426;2;2962
FR;3;2022-05-15;0;0;0;0;0;4415491;3440510;4426;2;2962
FR;3;2022-05-16;0;0;0;0;0;4415491;3440510;4426;2;2962
FR;3;2022-05-17;0;0;0;0;0;4415491;3440510;4426;2;2962
FR;3;2022-05-18;0;0;0;0;0;4415491;3440510;4426;2;2962
FR;3;2022-05-19;0;0;0;0;0;4415491;3440510;4426;2;2962
FR;3;2022-05-20;0;0;0;0;0;4415491;3440510;4426;2;2962
FR;3;2022-05-21;0;0;0;0;0;4415491;3440510;4426;2;2962
FR;3;2022-05-22;0;0;0;0;0;4415491;3440510;4426;2;2962
FR;3;2022-05-23;0;0;0;0;0;4415491;3440510;4426;2;2962
FR;3;2022-05-24;0;0;0;0;0;4415491;3440510;4426;2;2962
FR;3;2022-05-25;0;0;0;0;0;4415491;3440510;4426;2;2962
FR;3;2022-05-26;0;0;0;0;0;4415491;3440510;4426;2;2962
FR;3;2022-05-27;0;0;0;0;0;4415491;3440510;4426;2;2962
FR;3;2022-05-28;0;0;0;0;0;4415491;3440510;4426;2;2962
FR;3;2022-05-29;0;0;0;0;0;4415491;3440510;4426;2;2962
FR;3;2022-05-30;0;0;0;0;0;4415491;3440510;4426;2;2962
FR;3;2022-05-31;0;0;0;0;0;4415491;3440510;4426;2;2962
FR;3;2022-06-01;0;0;0;0;0;4415491;3440510;4426;2;2962
FR;3;2022-06-02;0;0;0;0;0;4415491;3440510;4426;2;2962
FR;3;2022-06-03;0;0;0;0;0;4415491;3440510;4426;2;2962
FR;3;2022-06-04;0;0;0;0;0;4415491;3440510;4426;2;2962
FR;3;2022-06-05;0;0;0;0;0;4415491;3440510;4426;2;2962
FR;3;2022-06-06;0;0;0;0;0;4415491;3440510;4426;2;2962
FR;3;2022-06-07;0;0;0;0;0;4415491;3440510;4426;2;2962
FR;3;2022-06-08;0;0;0;0;0;4415491;3440510;4426;2;2962
FR;3;2022-06-09;0;0;0;0;0;4415491;3440510;4426;2;2962
FR;3;2022-06-10;0;0;0;0;0;4415491;3440510;4426;2;2962
FR;3;2022-06-11;0;0;0;0;0;4415491;3440510;4426;2;2962
FR;3;2022-06-12;0;0;0;0;0;4415491;3440510;4426;2;2962
FR;3;2022-06-13;1;0;0;0;0;4415492;3440510;4426;2;2962
FR;3;2022-06-14;0;0;0;0;0;4415492;3440510;4426;2;2962
FR;3;2022-06-15;0;0;0;0;0;4415492;3440510;4426;2;2962
FR;3;2022-06-16;0;0;0;0;0;4415492;3440510;4426;2;2962
FR;3;2022-06-17;0;0;0;0;0;4415492;3440510;4426;2;2962
FR;3;2022-06-18;0;0;0;0;0;4415492;3440510;4426;2;2962
FR;3;2022-06-19;0;0;0;0;0;4415492;3440510;4426;2;2962
FR;3;2022-06-20;0;0;0;0;0;4415492;3440510;4426;2;2962
FR;3;2022-06-21;0;0;0;0;0;4415492;3440510;4426;2;2962
FR;3;2022-06-22;0;0;0;0;0;4415492;3440510;4426;2;2962
FR;3;2022-06-23;0;0;0;0;0;4415492;3440510;4426;2;2962
FR;3;2022-06-24;0;0;0;0;0;4415492;3440510;4426;2;2962
FR;3;2022-06-25;0;0;0;0;0;4415492;3440510;4426;2;2962
FR;3;2022-06-26;0;0;0;0;0;4415492;3440510;4426;2;2962
FR;3;2022-06-27;0;0;0;0;0;4415492;3440510;4426;2;2962
FR;3;2022-06-28;0;0;0;0;0;4415492;3440510;4426;2;2962
FR;3;2022-06-29;1;0;0;0;0;4415493;3440510;4426;2;2962
FR;3;2022-06-30;0;0;0;0;0;4415493;3440510;4426;2;2962
FR;3;2022-07-01;0;0;0;0;0;4415493;3440510;4426;2;2962
FR;3;2022-07-02;0;0;0;0;0;4415493;3440510;4426;2;2962
FR;3;2022-07-03;0;0;0;0;0;4415493;3440510;4426;2;2962
FR;3;2022-07-04;0;0;0;0;0;4415493;3440510;4426;2;2962
FR;3;2022-07-05;0;0;0;0;0;4415493;3440510;4426;2;2962
FR;3;2022-07-06;0;0;0;0;0;4415493;3440510;4426;2;2962
FR;3;2022-07-07;0;0;0;0;0;4415493;3440510;4426;2;2962
FR;3;2022-07-08;0;0;0;0;0;4415493;3440510;4426;2;2962
FR;3;2022-07-09;0;0;0;0;0;4415493;3440510;4426;2;2962
FR;3;2022-07-10;0;0;0;0;0;4415493;3440510;4426;2;2962
FR;3;2022-07-11;0;0;0;0;0;4415493;3440510;4426;2;2962
FR;3;2022-07-12;0;0;0;0;0;4415493;3440510;4426;2;2962
FR;4;2020-12-27;0;0;0;0;0;0;0;0;0;0
FR;4;2020-12-28;0;0;0;0;0;0;0;0;0;0
FR;4;2020-12-29;0;0;0;0;0;0;0;0;0;0
FR;4;2020-12-30;0;0;0;0;0;0;0;0;0;0
FR;4;2020-12-31;0;0;0;0;0;0;0;0;0;0
FR;4;2021-01-01;0;0;0;0;0;0;0;0;0;0
FR;4;2021-01-02;0;0;0;0;0;0;0;0;0;0
FR;4;2021-01-03;0;0;0;0;0;0;0;0;0;0
FR;4;2021-01-04;0;0;0;0;0;0;0;0;0;0
FR;4;2021-01-05;0;0;0;0;0;0;0;0;0;0
FR;4;2021-01-06;0;0;0;0;0;0;0;0;0;0
FR;4;2021-01-07;0;0;0;0;0;0;0;0;0;0
FR;4;2021-01-08;0;0;0;0;0;0;0;0;0;0
FR;4;2021-01-09;0;0;0;0;0;0;0;0;0;0
FR;4;2021-01-10;0;0;0;0;0;0;0;0;0;0
FR;4;2021-01-11;0;0;0;0;0;0;0;0;0;0
FR;4;2021-01-12;0;0;0;0;0;0;0;0;0;0
FR;4;2021-01-13;0;0;0;0;0;0;0;0;0;0
FR;4;2021-01-14;0;0;0;0;0;0;0;0;0;0
FR;4;2021-01-15;0;0;0;0;0;0;0;0;0;0
FR;4;2021-01-16;0;0;0;0;0;0;0;0;0;0
FR;4;2021-01-17;0;0;0;0;0;0;0;0;0;0
FR;4;2021-01-18;0;0;0;0;0;0;0;0;0;0
FR;4;2021-01-19;0;0;0;0;0;0;0;0;0;0
FR;4;2021-01-20;0;0;0;0;0;0;0;0;0;0
FR;4;2021-01-21;0;0;0;0;0;0;0;0;0;0
FR;4;2021-01-22;0;0;0;0;0;0;0;0;0;0
FR;4;2021-01-23;0;0;0;0;0;0;0;0;0;0
FR;4;2021-01-24;0;0;0;0;0;0;0;0;0;0
FR;4;2021-01-25;0;0;0;0;0;0;0;0;0;0
FR;4;2021-01-26;0;0;0;0;0;0;0;0;0;0
FR;4;2021-01-27;0;0;0;0;0;0;0;0;0;0
FR;4;2021-01-28;0;0;0;0;0;0;0;0;0;0
FR;4;2021-01-29;0;0;0;0;0;0;0;0;0;0
FR;4;2021-01-30;0;0;0;0;0;0;0;0;0;0
FR;4;2021-01-31;0;0;0;0;0;0;0;0;0;0
FR;4;2021-02-01;0;0;0;0;0;0;0;0;0;0
FR;4;2021-02-02;0;0;0;0;0;0;0;0;0;0
FR;4;2021-02-03;0;0;0;0;0;0;0;0;0;0
FR;4;2021-02-04;0;0;0;0;0;0;0;0;0;0
FR;4;2021-02-05;0;0;0;0;0;0;0;0;0;0
FR;4;2021-02-06;0;0;0;0;0;0;0;0;0;0
FR;4;2021-02-07;0;0;0;0;0;0;0;0;0;0
FR;4;2021-02-08;0;0;0;0;0;0;0;0;0;0
FR;4;2021-02-09;0;0;0;0;0;0;0;0;0;0
FR;4;2021-02-10;0;0;0;0;0;0;0;0;0;0
FR;4;2021-02-11;0;0;0;0;0;0;0;0;0;0
FR;4;2021-02-12;0;0;0;0;0;0;0;0;0;0
FR;4;2021-02-13;0;0;0;0;0;0;0;0;0;0
FR;4;2021-02-14;0;0;0;0;0;0;0;0;0;0
FR;4;2021-02-15;0;0;0;0;0;0;0;0;0;0
FR;4;2021-02-16;0;0;0;0;0;0;0;0;0;0
FR;4;2021-02-17;0;0;0;0;0;0;0;0;0;0
FR;4;2021-02-18;0;0;0;0;0;0;0;0;0;0
FR;4;2021-02-19;0;0;0;0;0;0;0;0;0;0
FR;4;2021-02-20;0;0;0;0;0;0;0;0;0;0
FR;4;2021-02-21;0;0;0;0;0;0;0;0;0;0
FR;4;2021-02-22;0;0;0;0;0;0;0;0;0;0
FR;4;2021-02-23;0;0;0;0;0;0;0;0;0;0
FR;4;2021-02-24;0;0;0;0;0;0;0;0;0;0
FR;4;2021-02-25;0;0;0;0;0;0;0;0;0;0
FR;4;2021-02-26;0;0;0;0;0;0;0;0;0;0
FR;4;2021-02-27;0;0;0;0;0;0;0;0;0;0
FR;4;2021-02-28;0;0;0;0;0;0;0;0;0;0
FR;4;2021-03-01;0;0;0;0;0;0;0;0;0;0
FR;4;2021-03-02;0;0;0;0;0;0;0;0;0;0
FR;4;2021-03-03;0;0;0;0;0;0;0;0;0;0
FR;4;2021-03-04;0;0;0;0;0;0;0;0;0;0
FR;4;2021-03-05;0;0;0;0;0;0;0;0;0;0
FR;4;2021-03-06;0;0;0;0;0;0;0;0;0;0
FR;4;2021-03-07;0;0;0;0;0;0;0;0;0;0
FR;4;2021-03-08;0;0;0;0;0;0;0;0;0;0
FR;4;2021-03-09;0;0;0;0;0;0;0;0;0;0
FR;4;2021-03-10;0;0;0;0;0;0;0;0;0;0
FR;4;2021-03-11;0;0;0;0;0;0;0;0;0;0
FR;4;2021-03-12;0;0;0;0;0;0;0;0;0;0
FR;4;2021-03-13;0;0;0;0;0;0;0;0;0;0
FR;4;2021-03-14;0;0;0;0;0;0;0;0;0;0
FR;4;2021-03-15;0;0;0;0;0;0;0;0;0;0
FR;4;2021-03-16;0;0;0;0;0;0;0;0;0;0
FR;4;2021-03-17;0;0;0;0;0;0;0;0;0;0
FR;4;2021-03-18;0;0;0;0;0;0;0;0;0;0
FR;4;2021-03-19;0;0;0;0;0;0;0;0;0;0
FR;4;2021-03-20;0;0;0;0;0;0;0;0;0;0
FR;4;2021-03-21;0;0;0;0;0;0;0;0;0;0
FR;4;2021-03-22;0;0;0;0;0;0;0;0;0;0
FR;4;2021-03-23;0;0;0;0;0;0;0;0;0;0
FR;4;2021-03-24;0;0;0;0;0;0;0;0;0;0
FR;4;2021-03-25;0;0;0;0;0;0;0;0;0;0
FR;4;2021-03-26;0;0;0;0;0;0;0;0;0;0
FR;4;2021-03-27;0;0;0;0;0;0;0;0;0;0
FR;4;2021-03-28;0;0;0;0;0;0;0;0;0;0
FR;4;2021-03-29;0;0;0;0;0;0;0;0;0;0
FR;4;2021-03-30;0;0;0;0;0;0;0;0;0;0
FR;4;2021-03-31;0;0;0;0;0;0;0;0;0;0
FR;4;2021-04-01;0;0;0;0;0;0;0;0;0;0
FR;4;2021-04-02;0;0;0;0;0;0;0;0;0;0
FR;4;2021-04-03;0;0;0;0;0;0;0;0;0;0
FR;4;2021-04-04;0;0;0;0;0;0;0;0;0;0
FR;4;2021-04-05;0;0;0;0;0;0;0;0;0;0
FR;4;2021-04-06;0;0;0;0;0;0;0;0;0;0
FR;4;2021-04-07;0;0;0;0;0;0;0;0;0;0
FR;4;2021-04-08;0;0;0;0;0;0;0;0;0;0
FR;4;2021-04-09;0;0;0;0;0;0;0;0;0;0
FR;4;2021-04-10;0;0;0;0;0;0;0;0;0;0
FR;4;2021-04-11;0;0;0;0;0;0;0;0;0;0
FR;4;2021-04-12;0;0;0;0;0;0;0;0;0;0
FR;4;2021-04-13;0;0;0;0;0;0;0;0;0;0
FR;4;2021-04-14;0;0;0;0;0;0;0;0;0;0
FR;4;2021-04-15;0;0;0;0;0;0;0;0;0;0
FR;4;2021-04-16;0;0;0;0;0;0;0;0;0;0
FR;4;2021-04-17;0;0;0;0;0;0;0;0;0;0
FR;4;2021-04-18;0;0;0;0;0;0;0;0;0;0
FR;4;2021-04-19;0;0;0;0;0;0;0;0;0;0
FR;4;2021-04-20;0;0;0;0;0;0;0;0;0;0
FR;4;2021-04-21;0;0;0;0;0;0;0;0;0;0
FR;4;2021-04-22;0;0;0;0;0;0;0;0;0;0
FR;4;2021-04-23;3923;0;0;0;0;3923;0;0;0;0
FR;4;2021-04-24;1569;0;0;0;0;5492;0;0;0;0
FR;4;2021-04-25;125;0;0;0;0;5617;0;0;0;0
FR;4;2021-04-26;2869;1;0;0;0;8486;1;0;0;0
FR;4;2021-04-27;9520;3;0;0;0;18006;4;0;0;0
FR;4;2021-04-28;9904;6;0;0;0;27910;10;0;0;0
FR;4;2021-04-29;15992;8;0;0;0;43902;18;0;0;0
FR;4;2021-04-30;19232;10;0;0;0;63134;28;0;0;0
FR;4;2021-05-01;1994;6;0;0;0;65128;34;0;0;0
FR;4;2021-05-02;482;0;0;0;0;65610;34;0;0;0
FR;4;2021-05-03;5061;2;0;0;0;70671;36;0;0;0
FR;4;2021-05-04;8399;11;0;0;0;79070;47;0;0;0
FR;4;2021-05-05;6184;7;0;0;0;85254;54;0;0;0
FR;4;2021-05-06;11381;11;0;0;0;96635;65;0;0;0
FR;4;2021-05-07;19124;9;0;0;0;115759;74;0;0;0
FR;4;2021-05-08;2377;6;0;0;0;118136;80;0;0;0
FR;4;2021-05-09;686;3;0;0;0;118822;83;0;0;0
FR;4;2021-05-10;7240;5;1;0;0;126062;88;1;0;0
FR;4;2021-05-11;14317;12;0;0;0;140379;100;1;0;0
FR;4;2021-05-12;10168;15;0;0;0;150547;115;1;0;0
FR;4;2021-05-13;1579;3;0;0;0;152126;118;1;0;0
FR;4;2021-05-14;7764;7;0;0;0;159890;125;1;0;0
FR;4;2021-05-15;3718;8;1;0;0;163608;133;2;0;0
FR;4;2021-05-16;417;1;0;0;0;164025;134;2;0;0
FR;4;2021-05-17;4477;6;0;0;0;168502;140;2;0;0
FR;4;2021-05-18;8757;10;0;0;0;177259;150;2;0;0
FR;4;2021-05-19;5690;7;0;0;0;182949;157;2;0;0
FR;4;2021-05-20;9483;7;0;0;0;192432;164;2;0;0
FR;4;2021-05-21;12794;30;0;0;0;205226;194;2;0;0
FR;4;2021-05-22;5056;15;0;0;0;210282;209;2;0;0
FR;4;2021-05-23;494;4;0;0;0;210776;213;2;0;0
FR;4;2021-05-24;1057;7;0;0;0;211833;220;2;0;0
FR;4;2021-05-25;7623;16;0;0;0;219456;236;2;0;0
FR;4;2021-05-26;7726;16;0;0;0;227182;252;2;0;0
FR;4;2021-05-27;14331;35;0;0;0;241513;287;2;0;0
FR;4;2021-05-28;26586;82;1;0;0;268099;369;3;0;0
FR;4;2021-05-29;11382;18;0;0;0;279481;387;3;0;0
FR;4;2021-05-30;971;6;0;0;0;280452;393;3;0;0
FR;4;2021-05-31;12690;21;0;0;0;293142;414;3;0;0
FR;4;2021-06-01;20256;47;1;0;0;313398;461;4;0;0
FR;4;2021-06-02;14520;33;0;0;0;327918;494;4;0;0
FR;4;2021-06-03;19419;24;1;0;0;347337;518;5;0;0
FR;4;2021-06-04;22516;47;0;0;0;369853;565;5;0;0
FR;4;2021-06-05;9713;32;0;0;0;379566;597;5;0;0
FR;4;2021-06-06;1039;1;0;0;0;380605;598;5;0;0
FR;4;2021-06-07;9226;19;0;0;0;389831;617;5;0;0
FR;4;2021-06-08;14612;31;0;0;0;404443;648;5;0;0
FR;4;2021-06-09;12204;25;0;0;0;416647;673;5;0;0
FR;4;2021-06-10;15400;30;0;0;0;432047;703;5;0;0
FR;4;2021-06-11;16982;56;0;0;0;449029;759;5;0;0
FR;4;2021-06-12;7447;27;0;0;0;456476;786;5;0;0
FR;4;2021-06-13;907;3;0;0;0;457383;789;5;0;0
FR;4;2021-06-14;6646;26;0;0;0;464029;815;5;0;0
FR;4;2021-06-15;10884;37;0;0;0;474913;852;5;0;0
FR;4;2021-06-16;8907;15;0;0;0;483820;867;5;0;0
FR;4;2021-06-17;10896;37;0;0;0;494716;904;5;0;0
FR;4;2021-06-18;12421;45;0;0;0;507137;949;5;0;0
FR;4;2021-06-19;5568;25;0;0;0;512705;974;5;0;0
FR;4;2021-06-20;822;5;0;0;0;513527;979;5;0;0
FR;4;2021-06-21;5094;20;0;0;0;518621;999;5;0;0
FR;4;2021-06-22;7906;28;2;0;0;526527;1027;7;0;0
FR;4;2021-06-23;7096;40;2;0;0;533623;1067;9;0;0
FR;4;2021-06-24;8647;46;1;0;0;542270;1113;10;0;0
FR;4;2021-06-25;10171;39;2;0;0;552441;1152;12;0;0
FR;4;2021-06-26;4842;21;0;0;0;557283;1173;12;0;0
FR;4;2021-06-27;763;4;0;0;0;558046;1177;12;0;0
FR;4;2021-06-28;4824;16;1;0;0;562870;1193;13;0;0
FR;4;2021-06-29;7102;27;2;0;0;569972;1220;15;0;0
FR;4;2021-06-30;6714;39;2;0;0;576686;1259;17;0;0
FR;4;2021-07-01;8193;40;0;0;0;584879;1299;17;0;0
FR;4;2021-07-02;9416;52;1;0;0;594295;1351;18;0;0
FR;4;2021-07-03;4846;19;0;0;0;599141;1370;18;0;0
FR;4;2021-07-04;687;5;0;0;0;599828;1375;18;0;0
FR;4;2021-07-05;4770;19;2;0;0;604598;1394;20;0;0
FR;4;2021-07-06;7722;28;4;0;0;612320;1422;24;0;0
FR;4;2021-07-07;7073;34;2;0;0;619393;1456;26;0;0
FR;4;2021-07-08;9226;40;2;0;0;628619;1496;28;0;0
FR;4;2021-07-09;10276;34;1;0;0;638895;1530;29;0;0
FR;4;2021-07-10;4635;14;2;0;0;643530;1544;31;0;0
FR;4;2021-07-11;582;4;1;0;0;644112;1548;32;0;0
FR;4;2021-07-12;5870;29;0;0;0;649982;1577;32;0;0
FR;4;2021-07-13;14232;29;0;0;0;664214;1606;32;0;0
FR;4;2021-07-14;2286;15;0;0;0;666500;1621;32;0;0
FR;4;2021-07-15;18234;36;0;0;0;684734;1657;32;0;0
FR;4;2021-07-16;22823;70;2;0;0;707557;1727;34;0;0
FR;4;2021-07-17;9736;20;0;0;0;717293;1747;34;0;0
FR;4;2021-07-18;1355;4;0;0;0;718648;1751;34;0;0
FR;4;2021-07-19;12987;30;1;0;0;731635;1781;35;0;0
FR;4;2021-07-20;17336;26;1;0;0;748971;1807;36;0;0
FR;4;2021-07-21;15611;33;0;0;0;764582;1840;36;0;0
FR;4;2021-07-22;18239;44;2;0;0;782821;1884;38;0;0
FR;4;2021-07-23;20409;57;7;0;0;803230;1941;45;0;0
FR;4;2021-07-24;9286;32;0;0;0;812516;1973;45;0;0
FR;4;2021-07-25;1351;8;0;0;0;813867;1981;45;0;0
FR;4;2021-07-26;11033;21;0;0;0;824900;2002;45;0;0
FR;4;2021-07-27;14670;35;3;0;0;839570;2037;48;0;0
FR;4;2021-07-28;12930;26;2;0;0;852500;2063;50;0;0
FR;4;2021-07-29;14084;54;4;0;0;866584;2117;54;0;0
FR;4;2021-07-30;15488;45;2;0;0;882072;2162;56;0;0
FR;4;2021-07-31;6833;14;2;0;0;888905;2176;58;0;0
FR;4;2021-08-01;905;1;0;0;0;889810;2177;58;0;0
FR;4;2021-08-02;7911;30;0;0;0;897721;2207;58;0;0
FR;4;2021-08-03;10792;32;2;0;0;908513;2239;60;0;0
FR;4;2021-08-04;9737;29;0;0;0;918250;2268;60;0;0
FR;4;2021-08-05;9817;41;0;0;0;928067;2309;60;0;0
FR;4;2021-08-06;10190;30;3;0;0;938257;2339;63;0;0
FR;4;2021-08-07;5093;30;1;0;0;943350;2369;64;0;0
FR;4;2021-08-08;1219;13;0;0;0;944569;2382;64;0;0
FR;4;2021-08-09;6336;31;0;0;0;950905;2413;64;0;0
FR;4;2021-08-10;8745;18;0;0;0;959650;2431;64;0;0
FR;4;2021-08-11;7937;33;4;0;0;967587;2464;68;0;0
FR;4;2021-08-12;8583;30;1;0;0;976170;2494;69;0;0
FR;4;2021-08-13;7552;24;0;1;0;983722;2518;69;1;0
FR;4;2021-08-14;3789;20;0;0;0;987511;2538;69;1;0
FR;4;2021-08-15;770;5;0;0;0;988281;2543;69;1;0
FR;4;2021-08-16;4005;17;0;0;0;992286;2560;69;1;0
FR;4;2021-08-17;5623;17;1;0;0;997909;2577;70;1;0
FR;4;2021-08-18;5165;37;0;0;0;1003074;2614;70;1;0
FR;4;2021-08-19;5482;33;3;0;0;1008556;2647;73;1;0
FR;4;2021-08-20;5213;24;1;0;0;1013769;2671;74;1;0
FR;4;2021-08-21;2310;21;1;0;0;1016079;2692;75;1;0
FR;4;2021-08-22;404;2;0;0;0;1016483;2694;75;1;0
FR;4;2021-08-23;2927;19;1;0;0;1019410;2713;76;1;0
FR;4;2021-08-24;3751;15;0;0;0;1023161;2728;76;1;0
FR;4;2021-08-25;3539;25;1;0;0;1026700;2753;77;1;0
FR;4;2021-08-26;3707;20;2;0;0;1030407;2773;79;1;0
FR;4;2021-08-27;3607;31;2;0;0;1034014;2804;81;1;0
FR;4;2021-08-28;1725;9;1;0;0;1035739;2813;82;1;0
FR;4;2021-08-29;387;7;1;0;0;1036126;2820;83;1;0
FR;4;2021-08-30;2009;25;0;0;15;1038135;2845;83;1;15
FR;4;2021-08-31;2484;20;0;0;13;1040619;2865;83;1;28
FR;4;2021-09-01;2080;38;1;0;21;1042699;2903;84;1;49
FR;4;2021-09-02;2302;31;4;0;18;1045001;2934;88;1;67
FR;4;2021-09-03;2359;44;5;0;34;1047360;2978;93;1;101
FR;4;2021-09-04;1374;17;0;0;8;1048734;2995;93;1;109
FR;4;2021-09-05;432;2;0;0;2;1049166;2997;93;1;111
FR;4;2021-09-06;1709;60;0;0;22;1050875;3057;93;1;133
FR;4;2021-09-07;1676;18;1;0;9;1052551;3075;94;1;142
FR;4;2021-09-08;1281;26;3;0;19;1053832;3101;97;1;161
FR;4;2021-09-09;1386;23;2;0;9;1055218;3124;99;1;170
FR;4;2021-09-10;1519;31;2;0;23;1056737;3155;101;1;193
FR;4;2021-09-11;742;11;0;0;3;1057479;3166;101;1;196
FR;4;2021-09-12;168;4;0;0;3;1057647;3170;101;1;199
FR;4;2021-09-13;1317;22;1;0;16;1058964;3192;102;1;215
FR;4;2021-09-14;1497;9;2;0;6;1060461;3201;104;1;221
FR;4;2021-09-15;1094;27;1;0;24;1061555;3228;105;1;245
FR;4;2021-09-16;1100;22;2;0;15;1062655;3250;107;1;260
FR;4;2021-09-17;894;21;1;0;12;1063549;3271;108;1;272
FR;4;2021-09-18;462;6;1;0;5;1064011;3277;109;1;277
FR;4;2021-09-19;181;3;0;0;2;1064192;3280;109;1;279
FR;4;2021-09-20;452;19;0;0;13;1064644;3299;109;1;292
FR;4;2021-09-21;424;11;0;0;7;1065068;3310;109;1;299
FR;4;2021-09-22;372;19;2;0;13;1065440;3329;111;1;312
FR;4;2021-09-23;479;16;1;0;15;1065919;3345;112;1;327
FR;4;2021-09-24;411;13;2;0;9;1066330;3358;114;1;336
FR;4;2021-09-25;280;9;1;0;4;1066610;3367;115;1;340
FR;4;2021-09-26;73;2;0;0;1;1066683;3369;115;1;341
FR;4;2021-09-27;262;10;1;0;8;1066945;3379;116;1;349
FR;4;2021-09-28;316;8;0;0;8;1067261;3387;116;1;357
FR;4;2021-09-29;373;18;1;0;12;1067634;3405;117;1;369
FR;4;2021-09-30;363;40;0;0;21;1067997;3445;117;1;390
FR;4;2021-10-01;410;50;0;0;44;1068407;3495;117;1;434
FR;4;2021-10-02;196;22;1;0;13;1068603;3517;118;1;447
FR;4;2021-10-03;85;1;0;0;0;1068688;3518;118;1;447
FR;4;2021-10-04;360;20;1;0;16;1069048;3538;119;1;463
FR;4;2021-10-05;278;19;2;0;15;1069326;3557;121;1;478
FR;4;2021-10-06;246;22;1;0;18;1069572;3579;122;1;496
FR;4;2021-10-07;258;25;2;0;13;1069830;3604;124;1;509
FR;4;2021-10-08;353;23;2;0;19;1070183;3627;126;1;528
FR;4;2021-10-09;193;6;6;0;7;1070376;3633;132;1;535
FR;4;2021-10-10;95;3;2;0;3;1070471;3636;134;1;538
FR;4;2021-10-11;247;15;1;0;14;1070718;3651;135;1;552
FR;4;2021-10-12;206;14;0;0;13;1070924;3665;135;1;565
FR;4;2021-10-13;219;28;1;0;25;1071143;3693;136;1;590
FR;4;2021-10-14;308;21;4;0;15;1071451;3714;140;1;605
FR;4;2021-10-15;321;24;5;0;25;1071772;3738;145;1;630
FR;4;2021-10-16;166;6;2;0;6;1071938;3744;147;1;636
FR;4;2021-10-17;70;2;0;0;1;1072008;3746;147;1;637
FR;4;2021-10-18;279;15;1;0;12;1072287;3761;148;1;649
FR;4;2021-10-19;213;14;2;0;15;1072500;3775;150;1;664
FR;4;2021-10-20;227;27;4;0;15;1072727;3802;154;1;679
FR;4;2021-10-21;239;17;0;0;13;1072966;3819;154;1;692
FR;4;2021-10-22;212;25;2;0;20;1073178;3844;156;1;712
FR;4;2021-10-23;115;16;1;0;15;1073293;3860;157;1;727
FR;4;2021-10-24;38;4;0;0;1;1073331;3864;157;1;728
FR;4;2021-10-25;212;7;2;0;9;1073543;3871;159;1;737
FR;4;2021-10-26;196;14;0;0;12;1073739;3885;159;1;749
FR;4;2021-10-27;194;11;4;0;11;1073933;3896;163;1;760
FR;4;2021-10-28;184;18;4;0;21;1074117;3914;167;1;781
FR;4;2021-10-29;220;15;2;0;13;1074337;3929;169;1;794
FR;4;2021-10-30;102;2;1;0;2;1074439;3931;170;1;796
FR;4;2021-10-31;56;3;2;0;3;1074495;3934;172;1;799
FR;4;2021-11-01;75;27;4;0;24;1074570;3961;176;1;823
FR;4;2021-11-02;156;20;2;0;21;1074726;3981;178;1;844
FR;4;2021-11-03;129;20;8;1;18;1074855;4001;186;2;862
FR;4;2021-11-04;179;15;1;0;12;1075034;4016;187;2;874
FR;4;2021-11-05;128;17;1;0;16;1075162;4033;188;2;890
FR;4;2021-11-06;77;6;1;0;6;1075239;4039;189;2;896
FR;4;2021-11-07;78;2;2;0;4;1075317;4041;191;2;900
FR;4;2021-11-08;158;20;1;0;20;1075475;4061;192;2;920
FR;4;2021-11-09;155;14;3;0;16;1075630;4075;195;2;936
FR;4;2021-11-10;115;29;6;0;31;1075745;4104;201;2;967
FR;4;2021-11-11;91;10;0;0;10;1075836;4114;201;2;977
FR;4;2021-11-12;103;19;2;0;18;1075939;4133;203;2;995
FR;4;2021-11-13;74;15;2;0;14;1076013;4148;205;2;1009
FR;4;2021-11-14;54;5;3;0;7;1076067;4153;208;2;1016
FR;4;2021-11-15;98;26;2;0;24;1076165;4179;210;2;1040
FR;4;2021-11-16;103;13;2;0;15;1076268;4192;212;2;1055
FR;4;2021-11-17;118;29;4;0;29;1076386;4221;216;2;1084
FR;4;2021-11-18;100;34;12;0;41;1076486;4255;228;2;1125
FR;4;2021-11-19;84;19;3;0;20;1076570;4274;231;2;1145
FR;4;2021-11-20;75;8;1;0;8;1076645;4282;232;2;1153
FR;4;2021-11-21;62;7;2;0;9;1076707;4289;234;2;1162
FR;4;2021-11-22;104;27;7;0;30;1076811;4316;241;2;1192
FR;4;2021-11-23;75;29;5;0;26;1076886;4345;246;2;1218
FR;4;2021-11-24;85;23;10;0;23;1076971;4368;256;2;1241
FR;4;2021-11-25;87;28;14;0;30;1077058;4396;270;2;1271
FR;4;2021-11-26;82;43;12;0;45;1077140;4439;282;2;1316
FR;4;2021-11-27;37;22;15;0;25;1077177;4461;297;2;1341
FR;4;2021-11-28;48;8;0;0;7;1077225;4469;297;2;1348
FR;4;2021-11-29;87;31;15;0;39;1077312;4500;312;2;1387
FR;4;2021-11-30;72;36;12;0;40;1077384;4536;324;2;1427
FR;4;2021-12-01;87;59;19;0;66;1077471;4595;343;2;1493
FR;4;2021-12-02;101;48;19;0;53;1077572;4643;362;2;1546
FR;4;2021-12-03;98;36;15;0;44;1077670;4679;377;2;1590
FR;4;2021-12-04;70;31;18;0;44;1077740;4710;395;2;1634
FR;4;2021-12-05;61;6;1;0;7;1077801;4716;396;2;1641
FR;4;2021-12-06;103;46;20;0;60;1077904;4762;416;2;1701
FR;4;2021-12-07;80;35;9;0;34;1077984;4797;425;2;1735
FR;4;2021-12-08;67;29;16;0;35;1078051;4826;441;2;1770
FR;4;2021-12-09;61;32;10;0;38;1078112;4858;451;2;1808
FR;4;2021-12-10;63;64;20;0;68;1078175;4922;471;2;1876
FR;4;2021-12-11;27;34;7;0;34;1078202;4956;478;2;1910
FR;4;2021-12-12;24;10;3;0;13;1078226;4966;481;2;1923
FR;4;2021-12-13;70;40;13;0;48;1078296;5006;494;2;1971
FR;4;2021-12-14;58;43;17;0;54;1078354;5049;511;2;2025
FR;4;2021-12-15;61;63;28;0;83;1078415;5112;539;2;2108
FR;4;2021-12-16;32;44;19;0;57;1078447;5156;558;2;2165
FR;4;2021-12-17;39;55;12;0;60;1078486;5211;570;2;2225
FR;4;2021-12-18;48;29;2;0;30;1078534;5240;572;2;2255
FR;4;2021-12-19;15;4;1;0;4;1078549;5244;573;2;2259
FR;4;2021-12-20;38;38;10;0;41;1078587;5282;583;2;2300
FR;4;2021-12-21;27;30;15;0;36;1078614;5312;598;2;2336
FR;4;2021-12-22;36;37;10;0;38;1078650;5349;608;2;2374
FR;4;2021-12-23;39;45;8;0;49;1078689;5394;616;2;2423
FR;4;2021-12-24;23;26;10;0;30;1078712;5420;626;2;2453
FR;4;2021-12-25;6;3;3;0;4;1078718;5423;629;2;2457
FR;4;2021-12-26;4;3;1;0;2;1078722;5426;630;2;2459
FR;4;2021-12-27;28;41;9;0;43;1078750;5467;639;2;2502
FR;4;2021-12-28;24;28;7;0;29;1078774;5495;646;2;2531
FR;4;2021-12-29;48;25;10;0;29;1078822;5520;656;2;2560
FR;4;2021-12-30;42;18;12;0;21;1078864;5538;668;2;2581
FR;4;2021-12-31;18;5;8;0;10;1078882;5543;676;2;2591
FR;4;2022-01-01;5;4;4;0;6;1078887;5547;680;2;2597
FR;4;2022-01-02;40;5;16;0;20;1078927;5552;696;2;2617
FR;4;2022-01-03;39;54;21;1;60;1078966;5606;717;3;2677
FR;4;2022-01-04;32;27;13;0;30;1078998;5633;730;3;2707
FR;4;2022-01-05;47;21;17;0;22;1079045;5654;747;3;2729
FR;4;2022-01-06;46;20;22;0;34;1079091;5674;769;3;2763
FR;4;2022-01-07;28;20;15;0;20;1079119;5694;784;3;2783
FR;4;2022-01-08;8;6;10;0;12;1079127;5700;794;3;2795
FR;4;2022-01-09;18;2;2;0;3;1079145;5702;796;3;2798
FR;4;2022-01-10;40;22;17;0;34;1079185;5724;813;3;2832
FR;4;2022-01-11;25;30;12;0;34;1079210;5754;825;3;2866
FR;4;2022-01-12;32;21;13;0;23;1079242;5775;838;3;2889
FR;4;2022-01-13;48;19;27;0;37;1079290;5794;865;3;2926
FR;4;2022-01-14;23;28;13;0;31;1079313;5822;878;3;2957
FR;4;2022-01-15;11;6;8;0;12;1079324;5828;886;3;2969
FR;4;2022-01-16;9;9;11;0;19;1079333;5837;897;3;2988
FR;4;2022-01-17;24;18;12;0;24;1079357;5855;909;3;3012
FR;4;2022-01-18;16;13;8;0;18;1079373;5868;917;3;3030
FR;4;2022-01-19;29;23;10;0;31;1079402;5891;927;3;3061
FR;4;2022-01-20;31;34;11;0;37;1079433;5925;938;3;3098
FR;4;2022-01-21;9;12;19;1;16;1079442;5937;957;4;3114
FR;4;2022-01-22;30;9;2;0;9;1079472;5946;959;4;3123
FR;4;2022-01-23;6;2;4;0;6;1079478;5948;963;4;3129
FR;4;2022-01-24;14;21;8;0;27;1079492;5969;971;4;3156
FR;4;2022-01-25;20;31;8;1;35;1079512;6000;979;5;3191
FR;4;2022-01-26;19;14;6;1;15;1079531;6014;985;6;3206
FR;4;2022-01-27;19;18;6;0;22;1079550;6032;991;6;3228
FR;4;2022-01-28;13;23;8;0;26;1079563;6055;999;6;3254
FR;4;2022-01-29;16;6;4;0;9;1079579;6061;1003;6;3263
FR;4;2022-01-30;16;3;1;0;4;1079595;6064;1004;6;3267
FR;4;2022-01-31;19;27;7;0;30;1079614;6091;1011;6;3297
FR;4;2022-02-01;9;19;11;0;19;1079623;6110;1022;6;3316
FR;4;2022-02-02;17;11;10;2;16;1079640;6121;1032;8;3332
FR;4;2022-02-03;13;23;9;0;26;1079653;6144;1041;8;3358
FR;4;2022-02-04;7;5;7;0;9;1079660;6149;1048;8;3367
FR;4;2022-02-05;7;14;1;0;13;1079667;6163;1049;8;3380
FR;4;2022-02-06;6;3;2;0;4;1079673;6166;1051;8;3384
FR;4;2022-02-07;14;19;7;0;19;1079687;6185;1058;8;3403
FR;4;2022-02-08;16;20;13;1;21;1079703;6205;1071;9;3424
FR;4;2022-02-09;16;11;7;0;14;1079719;6216;1078;9;3438
FR;4;2022-02-10;17;23;9;0;24;1079736;6239;1087;9;3462
FR;4;2022-02-11;18;14;8;0;19;1079754;6253;1095;9;3481
FR;4;2022-02-12;23;6;2;0;6;1079777;6259;1097;9;3487
FR;4;2022-02-13;7;3;3;0;6;1079784;6262;1100;9;3493
FR;4;2022-02-14;18;10;7;0;13;1079802;6272;1107;9;3506
FR;4;2022-02-15;16;7;1;0;7;1079818;6279;1108;9;3513
FR;4;2022-02-16;14;9;10;0;15;1079832;6288;1118;9;3528
FR;4;2022-02-17;10;4;4;0;6;1079842;6292;1122;9;3534
FR;4;2022-02-18;17;15;6;0;19;1079859;6307;1128;9;3553
FR;4;2022-02-19;16;3;2;0;4;1079875;6310;1130;9;3557
FR;4;2022-02-20;7;3;0;0;2;1079882;6313;1130;9;3559
FR;4;2022-02-21;22;3;3;0;4;1079904;6316;1133;9;3563
FR;4;2022-02-22;8;4;8;0;8;1079912;6320;1141;9;3571
FR;4;2022-02-23;16;6;9;0;9;1079928;6326;1150;9;3580
FR;4;2022-02-24;9;5;3;0;6;1079937;6331;1153;9;3586
FR;4;2022-02-25;15;5;7;0;6;1079952;6336;1160;9;3592
FR;4;2022-02-26;26;3;0;0;3;1079978;6339;1160;9;3595
FR;4;2022-02-27;9;0;1;0;1;1079987;6339;1161;9;3596
FR;4;2022-02-28;14;3;2;0;3;1080001;6342;1163;9;3599
FR;4;2022-03-01;6;2;7;0;3;1080007;6344;1170;9;3602
FR;4;2022-03-02;12;2;3;0;4;1080019;6346;1173;9;3606
FR;4;2022-03-03;16;5;1;0;4;1080035;6351;1174;9;3610
FR;4;2022-03-04;7;7;2;1;5;1080042;6358;1176;10;3615
FR;4;2022-03-05;9;2;0;0;2;1080051;6360;1176;10;3617
FR;4;2022-03-06;4;0;1;0;1;1080055;6360;1177;10;3618
FR;4;2022-03-07;10;4;1;0;3;1080065;6364;1178;10;3621
FR;4;2022-03-08;13;3;0;0;3;1080078;6367;1178;10;3624
FR;4;2022-03-09;8;5;2;0;6;1080086;6372;1180;10;3630
FR;4;2022-03-10;5;1;5;0;2;1080091;6373;1185;10;3632
FR;4;2022-03-11;8;3;5;0;2;1080099;6376;1190;10;3634
FR;4;2022-03-12;9;2;0;0;0;1080108;6378;1190;10;3634
FR;4;2022-03-13;5;1;1;0;2;1080113;6379;1191;10;3636
FR;4;2022-03-14;4;1;1;0;2;1080117;6380;1192;10;3638
FR;4;2022-03-15;6;3;2;0;2;1080123;6383;1194;10;3640
FR;4;2022-03-16;7;3;3;0;3;1080130;6386;1197;10;3643
FR;4;2022-03-17;3;4;1;0;5;1080133;6390;1198;10;3648
FR;4;2022-03-18;9;3;0;0;3;1080142;6393;1198;10;3651
FR;4;2022-03-19;1;1;0;0;1;1080143;6394;1198;10;3652
FR;4;2022-03-20;2;0;2;0;1;1080145;6394;1200;10;3653
FR;4;2022-03-21;5;3;0;0;3;1080150;6397;1200;10;3656
FR;4;2022-03-22;3;2;2;0;3;1080153;6399;1202;10;3659
FR;4;2022-03-23;6;4;4;0;7;1080159;6403;1206;10;3666
FR;4;2022-03-24;2;4;3;1;5;1080161;6407;1209;11;3671
FR;4;2022-03-25;3;1;2;0;1;1080164;6408;1211;11;3672
FR;4;2022-03-26;5;5;0;0;5;1080169;6413;1211;11;3677
FR;4;2022-03-27;1;0;1;0;0;1080170;6413;1212;11;3677
FR;4;2022-03-28;5;1;3;0;3;1080175;6414;1215;11;3680
FR;4;2022-03-29;8;0;4;1;0;1080183;6414;1219;12;3680
FR;4;2022-03-30;1;4;0;0;4;1080184;6418;1219;12;3684
FR;4;2022-03-31;2;3;1;1;3;1080186;6421;1220;13;3687
FR;4;2022-04-01;13;2;5;0;5;1080199;6423;1225;13;3692
FR;4;2022-04-02;4;4;0;0;3;1080203;6427;1225;13;3695
FR;4;2022-04-03;0;0;0;0;0;1080203;6427;1225;13;3695
FR;4;2022-04-04;4;4;3;0;4;1080207;6431;1228;13;3699
FR;4;2022-04-05;3;3;1;1;2;1080210;6434;1229;14;3701
FR;4;2022-04-06;4;0;0;0;0;1080214;6434;1229;14;3701
FR;4;2022-04-07;3;2;3;2;5;1080217;6436;1232;16;3706
FR;4;2022-04-08;4;1;1;0;1;1080221;6437;1233;16;3707
FR;4;2022-04-09;0;0;1;1;1;1080221;6437;1234;17;3708
FR;4;2022-04-10;1;2;0;0;2;1080222;6439;1234;17;3710
FR;4;2022-04-11;3;2;4;0;4;1080225;6441;1238;17;3714
FR;4;2022-04-12;3;1;4;0;2;1080228;6442;1242;17;3716
FR;4;2022-04-13;4;7;2;0;9;1080232;6449;1244;17;3725
FR;4;2022-04-14;6;4;1;1;4;1080238;6453;1245;18;3729
FR;4;2022-04-15;5;8;1;0;9;1080243;6461;1246;18;3738
FR;4;2022-04-16;1;0;0;0;0;1080244;6461;1246;18;3738
FR;4;2022-04-17;2;1;0;0;1;1080246;6462;1246;18;3739
FR;4;2022-04-18;2;2;5;0;3;1080248;6464;1251;18;3742
FR;4;2022-04-19;2;0;1;0;0;1080250;6464;1252;18;3742
FR;4;2022-04-20;13;4;1;0;3;1080263;6468;1253;18;3745
FR;4;2022-04-21;5;1;0;0;1;1080268;6469;1253;18;3746
FR;4;2022-04-22;1;0;1;0;0;1080269;6469;1254;18;3746
FR;4;2022-04-23;2;3;2;0;5;1080271;6472;1256;18;3751
FR;4;2022-04-24;0;2;0;0;2;1080271;6474;1256;18;3753
FR;4;2022-04-25;3;4;3;0;7;1080274;6478;1259;18;3760
FR;4;2022-04-26;4;4;1;0;4;1080278;6482;1260;18;3764
FR;4;2022-04-27;4;0;0;1;0;1080282;6482;1260;19;3764
FR;4;2022-04-28;2;5;5;0;6;1080284;6487;1265;19;3770
FR;4;2022-04-29;3;2;0;0;1;1080287;6489;1265;19;3771
FR;4;2022-04-30;0;1;1;0;2;1080287;6490;1266;19;3773
FR;4;2022-05-01;0;0;0;0;0;1080287;6490;1266;19;3773
FR;4;2022-05-02;4;14;6;0;17;1080291;6504;1272;19;3790
FR;4;2022-05-03;2;4;2;0;5;1080293;6508;1274;19;3795
FR;4;2022-05-04;7;4;1;0;4;1080300;6512;1275;19;3799
FR;4;2022-05-05;2;2;1;1;1;1080302;6514;1276;20;3800
FR;4;2022-05-06;2;1;1;0;1;1080304;6515;1277;20;3801
FR;4;2022-05-07;0;0;0;0;0;1080304;6515;1277;20;3801
FR;4;2022-05-08;1;1;0;0;1;1080305;6516;1277;20;3802
FR;4;2022-05-09;5;0;0;0;0;1080310;6516;1277;20;3802
FR;4;2022-05-10;1;1;0;2;3;1080311;6517;1277;22;3805
FR;4;2022-05-11;2;2;1;0;3;1080313;6519;1278;22;3808
FR;4;2022-05-12;5;3;1;1;4;1080318;6522;1279;23;3812
FR;4;2022-05-13;0;0;2;0;2;1080318;6522;1281;23;3814
FR;4;2022-05-14;0;2;0;0;2;1080318;6524;1281;23;3816
FR;4;2022-05-15;1;2;0;0;0;1080319;6526;1281;23;3816
FR;4;2022-05-16;5;2;1;0;2;1080324;6528;1282;23;3818
FR;4;2022-05-17;3;1;2;0;3;1080327;6529;1284;23;3821
FR;4;2022-05-18;0;4;0;0;4;1080327;6533;1284;23;3825
FR;4;2022-05-19;2;2;3;0;4;1080329;6535;1287;23;3829
FR;4;2022-05-20;2;1;3;0;1;1080331;6536;1290;23;3830
FR;4;2022-05-21;2;0;1;0;1;1080333;6536;1291;23;3831
FR;4;2022-05-22;0;0;1;0;1;1080333;6536;1292;23;3832
FR;4;2022-05-23;0;0;2;0;0;1080333;6536;1294;23;3832
FR;4;2022-05-24;1;4;0;0;4;1080334;6540;1294;23;3836
FR;4;2022-05-25;1;3;0;0;1;1080335;6543;1294;23;3837
FR;4;2022-05-26;2;0;0;0;0;1080337;6543;1294;23;3837
FR;4;2022-05-27;0;1;0;0;1;1080337;6544;1294;23;3838
FR;4;2022-05-28;1;0;0;0;0;1080338;6544;1294;23;3838
FR;4;2022-05-29;0;0;0;0;0;1080338;6544;1294;23;3838
FR;4;2022-05-30;2;4;2;0;5;1080340;6548;1296;23;3843
FR;4;2022-05-31;2;1;0;0;1;1080342;6549;1296;23;3844
FR;4;2022-06-01;1;11;7;0;15;1080343;6560;1303;23;3859
FR;4;2022-06-02;1;5;1;0;5;1080344;6565;1304;23;3864
FR;4;2022-06-03;0;5;4;1;6;1080344;6570;1308;24;3870
FR;4;2022-06-04;0;1;0;0;1;1080344;6571;1308;24;3871
FR;4;2022-06-05;0;0;0;0;0;1080344;6571;1308;24;3871
FR;4;2022-06-06;4;0;2;0;1;1080348;6571;1310;24;3872
FR;4;2022-06-07;3;1;0;1;1;1080351;6572;1310;25;3873
FR;4;2022-06-08;0;3;2;0;5;1080351;6575;1312;25;3878
FR;4;2022-06-09;1;1;0;0;1;1080352;6576;1312;25;3879
FR;4;2022-06-10;2;0;3;0;1;1080354;6576;1315;25;3880
FR;4;2022-06-11;0;0;0;0;0;1080354;6576;1315;25;3880
FR;4;2022-06-12;4;0;0;0;0;1080358;6576;1315;25;3880
FR;4;2022-06-13;3;1;2;0;1;1080361;6577;1317;25;3881
FR;4;2022-06-14;3;2;0;0;2;1080364;6579;1317;25;3883
FR;4;2022-06-15;5;0;3;0;0;1080369;6579;1320;25;3883
FR;4;2022-06-16;0;2;1;1;1;1080369;6581;1321;26;3884
FR;4;2022-06-17;2;1;0;0;1;1080371;6582;1321;26;3885
FR;4;2022-06-18;0;0;0;0;0;1080371;6582;1321;26;3885
FR;4;2022-06-19;0;0;0;0;0;1080371;6582;1321;26;3885
FR;4;2022-06-20;3;2;1;0;3;1080374;6584;1322;26;3888
FR;4;2022-06-21;2;2;3;1;3;1080376;6586;1325;27;3891
FR;4;2022-06-22;2;2;0;0;2;1080378;6588;1325;27;3893
FR;4;2022-06-23;3;3;3;0;5;1080381;6591;1328;27;3898
FR;4;2022-06-24;0;0;1;0;0;1080381;6591;1329;27;3898
FR;4;2022-06-25;1;0;0;0;0;1080382;6591;1329;27;3898
FR;4;2022-06-26;0;0;0;0;0;1080382;6591;1329;27;3898
FR;4;2022-06-27;1;2;0;3;2;1080383;6593;1329;30;3900
FR;4;2022-06-28;0;2;2;1;3;1080383;6595;1331;31;3903
FR;4;2022-06-29;0;0;0;0;0;1080383;6595;1331;31;3903
FR;4;2022-06-30;1;0;0;0;0;1080384;6595;1331;31;3903
FR;4;2022-07-01;1;0;1;0;0;1080385;6595;1332;31;3903
FR;4;2022-07-02;0;1;0;0;0;1080385;6596;1332;31;3903
FR;4;2022-07-03;0;0;0;0;0;1080385;6596;1332;31;3903
FR;4;2022-07-04;2;0;0;0;0;1080387;6596;1332;31;3903
FR;4;2022-07-05;1;0;0;0;0;1080388;6596;1332;31;3903
FR;4;2022-07-06;5;0;0;0;0;1080393;6596;1332;31;3903
FR;4;2022-07-07;1;0;2;1;0;1080394;6596;1334;32;3903
FR;4;2022-07-08;2;0;0;0;0;1080396;6596;1334;32;3903
FR;4;2022-07-09;2;0;1;0;1;1080398;6596;1335;32;3904
FR;4;2022-07-10;1;0;0;0;0;1080399;6596;1335;32;3904
FR;4;2022-07-11;2;0;1;0;0;1080401;6596;1336;32;3904
FR;4;2022-07-12;0;0;0;0;0;1080401;6596;1336;32;3904
FR;5;2020-12-27;0;0;0;0;0;0;0;0;0;0
FR;5;2020-12-28;0;0;0;0;0;0;0;0;0;0
FR;5;2020-12-29;0;0;0;0;0;0;0;0;0;0
FR;5;2020-12-30;0;0;0;0;0;0;0;0;0;0
FR;5;2020-12-31;0;0;0;0;0;0;0;0;0;0
FR;5;2021-01-01;0;0;0;0;0;0;0;0;0;0
FR;5;2021-01-02;0;0;0;0;0;0;0;0;0;0
FR;5;2021-01-03;0;0;0;0;0;0;0;0;0;0
FR;5;2021-01-04;0;0;0;0;0;0;0;0;0;0
FR;5;2021-01-05;0;0;0;0;0;0;0;0;0;0
FR;5;2021-01-06;0;0;0;0;0;0;0;0;0;0
FR;5;2021-01-07;0;0;0;0;0;0;0;0;0;0
FR;5;2021-01-08;0;0;0;0;0;0;0;0;0;0
FR;5;2021-01-09;0;0;0;0;0;0;0;0;0;0
FR;5;2021-01-10;0;0;0;0;0;0;0;0;0;0
FR;5;2021-01-11;0;0;0;0;0;0;0;0;0;0
FR;5;2021-01-12;0;0;0;0;0;0;0;0;0;0
FR;5;2021-01-13;0;0;0;0;0;0;0;0;0;0
FR;5;2021-01-14;0;0;0;0;0;0;0;0;0;0
FR;5;2021-01-15;0;0;0;0;0;0;0;0;0;0
FR;5;2021-01-16;0;0;0;0;0;0;0;0;0;0
FR;5;2021-01-17;0;0;0;0;0;0;0;0;0;0
FR;5;2021-01-18;0;0;0;0;0;0;0;0;0;0
FR;5;2021-01-19;0;0;0;0;0;0;0;0;0;0
FR;5;2021-01-20;0;0;0;0;0;0;0;0;0;0
FR;5;2021-01-21;0;0;0;0;0;0;0;0;0;0
FR;5;2021-01-22;0;0;0;0;0;0;0;0;0;0
FR;5;2021-01-23;0;0;0;0;0;0;0;0;0;0
FR;5;2021-01-24;0;0;0;0;0;0;0;0;0;0
FR;5;2021-01-25;0;0;0;0;0;0;0;0;0;0
FR;5;2021-01-26;0;0;0;0;0;0;0;0;0;0
FR;5;2021-01-27;0;0;0;0;0;0;0;0;0;0
FR;5;2021-01-28;0;0;0;0;0;0;0;0;0;0
FR;5;2021-01-29;0;0;0;0;0;0;0;0;0;0
FR;5;2021-01-30;0;0;0;0;0;0;0;0;0;0
FR;5;2021-01-31;0;0;0;0;0;0;0;0;0;0
FR;5;2021-02-01;0;0;0;0;0;0;0;0;0;0
FR;5;2021-02-02;0;0;0;0;0;0;0;0;0;0
FR;5;2021-02-03;0;0;0;0;0;0;0;0;0;0
FR;5;2021-02-04;0;0;0;0;0;0;0;0;0;0
FR;5;2021-02-05;0;0;0;0;0;0;0;0;0;0
FR;5;2021-02-06;0;0;0;0;0;0;0;0;0;0
FR;5;2021-02-07;0;0;0;0;0;0;0;0;0;0
FR;5;2021-02-08;0;0;0;0;0;0;0;0;0;0
FR;5;2021-02-09;0;0;0;0;0;0;0;0;0;0
FR;5;2021-02-10;0;0;0;0;0;0;0;0;0;0
FR;5;2021-02-11;0;0;0;0;0;0;0;0;0;0
FR;5;2021-02-12;0;0;0;0;0;0;0;0;0;0
FR;5;2021-02-13;0;0;0;0;0;0;0;0;0;0
FR;5;2021-02-14;0;0;0;0;0;0;0;0;0;0
FR;5;2021-02-15;0;0;0;0;0;0;0;0;0;0
FR;5;2021-02-16;0;0;0;0;0;0;0;0;0;0
FR;5;2021-02-17;0;0;0;0;0;0;0;0;0;0
FR;5;2021-02-18;0;0;0;0;0;0;0;0;0;0
FR;5;2021-02-19;0;0;0;0;0;0;0;0;0;0
FR;5;2021-02-20;0;0;0;0;0;0;0;0;0;0
FR;5;2021-02-21;0;0;0;0;0;0;0;0;0;0
FR;5;2021-02-22;0;0;0;0;0;0;0;0;0;0
FR;5;2021-02-23;0;0;0;0;0;0;0;0;0;0
FR;5;2021-02-24;0;0;0;0;0;0;0;0;0;0
FR;5;2021-02-25;0;0;0;0;0;0;0;0;0;0
FR;5;2021-02-26;0;0;0;0;0;0;0;0;0;0
FR;5;2021-02-27;0;0;0;0;0;0;0;0;0;0
FR;5;2021-02-28;0;0;0;0;0;0;0;0;0;0
FR;5;2021-03-01;0;0;0;0;0;0;0;0;0;0
FR;5;2021-03-02;0;0;0;0;0;0;0;0;0;0
FR;5;2021-03-03;0;0;0;0;0;0;0;0;0;0
FR;5;2021-03-04;0;0;0;0;0;0;0;0;0;0
FR;5;2021-03-05;0;0;0;0;0;0;0;0;0;0
FR;5;2021-03-06;0;0;0;0;0;0;0;0;0;0
FR;5;2021-03-07;0;0;0;0;0;0;0;0;0;0
FR;5;2021-03-08;0;0;0;0;0;0;0;0;0;0
FR;5;2021-03-09;0;0;0;0;0;0;0;0;0;0
FR;5;2021-03-10;0;0;0;0;0;0;0;0;0;0
FR;5;2021-03-11;0;0;0;0;0;0;0;0;0;0
FR;5;2021-03-12;0;0;0;0;0;0;0;0;0;0
FR;5;2021-03-13;0;0;0;0;0;0;0;0;0;0
FR;5;2021-03-14;0;0;0;0;0;0;0;0;0;0
FR;5;2021-03-15;0;0;0;0;0;0;0;0;0;0
FR;5;2021-03-16;0;0;0;0;0;0;0;0;0;0
FR;5;2021-03-17;0;0;0;0;0;0;0;0;0;0
FR;5;2021-03-18;0;0;0;0;0;0;0;0;0;0
FR;5;2021-03-19;0;0;0;0;0;0;0;0;0;0
FR;5;2021-03-20;0;0;0;0;0;0;0;0;0;0
FR;5;2021-03-21;0;0;0;0;0;0;0;0;0;0
FR;5;2021-03-22;0;0;0;0;0;0;0;0;0;0
FR;5;2021-03-23;0;0;0;0;0;0;0;0;0;0
FR;5;2021-03-24;0;0;0;0;0;0;0;0;0;0
FR;5;2021-03-25;0;0;0;0;0;0;0;0;0;0
FR;5;2021-03-26;0;0;0;0;0;0;0;0;0;0
FR;5;2021-03-27;0;0;0;0;0;0;0;0;0;0
FR;5;2021-03-28;0;0;0;0;0;0;0;0;0;0
FR;5;2021-03-29;0;0;0;0;0;0;0;0;0;0
FR;5;2021-03-30;0;0;0;0;0;0;0;0;0;0
FR;5;2021-03-31;0;0;0;0;0;0;0;0;0;0
FR;5;2021-04-01;0;0;0;0;0;0;0;0;0;0
FR;5;2021-04-02;0;0;0;0;0;0;0;0;0;0
FR;5;2021-04-03;0;0;0;0;0;0;0;0;0;0
FR;5;2021-04-04;0;0;0;0;0;0;0;0;0;0
FR;5;2021-04-05;0;0;0;0;0;0;0;0;0;0
FR;5;2021-04-06;0;0;0;0;0;0;0;0;0;0
FR;5;2021-04-07;0;0;0;0;0;0;0;0;0;0
FR;5;2021-04-08;0;0;0;0;0;0;0;0;0;0
FR;5;2021-04-09;0;0;0;0;0;0;0;0;0;0
FR;5;2021-04-10;0;0;0;0;0;0;0;0;0;0
FR;5;2021-04-11;0;0;0;0;0;0;0;0;0;0
FR;5;2021-04-12;0;0;0;0;0;0;0;0;0;0
FR;5;2021-04-13;0;0;0;0;0;0;0;0;0;0
FR;5;2021-04-14;0;0;0;0;0;0;0;0;0;0
FR;5;2021-04-15;0;0;0;0;0;0;0;0;0;0
FR;5;2021-04-16;0;0;0;0;0;0;0;0;0;0
FR;5;2021-04-17;0;0;0;0;0;0;0;0;0;0
FR;5;2021-04-18;0;0;0;0;0;0;0;0;0;0
FR;5;2021-04-19;0;0;0;0;0;0;0;0;0;0
FR;5;2021-04-20;0;0;0;0;0;0;0;0;0;0
FR;5;2021-04-21;0;0;0;0;0;0;0;0;0;0
FR;5;2021-04-22;0;0;0;0;0;0;0;0;0;0
FR;5;2021-04-23;0;0;0;0;0;0;0;0;0;0
FR;5;2021-04-24;0;0;0;0;0;0;0;0;0;0
FR;5;2021-04-25;0;0;0;0;0;0;0;0;0;0
FR;5;2021-04-26;0;0;0;0;0;0;0;0;0;0
FR;5;2021-04-27;0;0;0;0;0;0;0;0;0;0
FR;5;2021-04-28;0;0;0;0;0;0;0;0;0;0
FR;5;2021-04-29;0;0;0;0;0;0;0;0;0;0
FR;5;2021-04-30;0;0;0;0;0;0;0;0;0;0
FR;5;2021-05-01;0;0;0;0;0;0;0;0;0;0
FR;5;2021-05-02;0;0;0;0;0;0;0;0;0;0
FR;5;2021-05-03;0;0;0;0;0;0;0;0;0;0
FR;5;2021-05-04;0;0;0;0;0;0;0;0;0;0
FR;5;2021-05-05;0;0;0;0;0;0;0;0;0;0
FR;5;2021-05-06;0;0;0;0;0;0;0;0;0;0
FR;5;2021-05-07;0;0;0;0;0;0;0;0;0;0
FR;5;2021-05-08;0;0;0;0;0;0;0;0;0;0
FR;5;2021-05-09;0;0;0;0;0;0;0;0;0;0
FR;5;2021-05-10;0;0;0;0;0;0;0;0;0;0
FR;5;2021-05-11;0;0;0;0;0;0;0;0;0;0
FR;5;2021-05-12;0;0;0;0;0;0;0;0;0;0
FR;5;2021-05-13;0;0;0;0;0;0;0;0;0;0
FR;5;2021-05-14;0;0;0;0;0;0;0;0;0;0
FR;5;2021-05-15;0;0;0;0;0;0;0;0;0;0
FR;5;2021-05-16;0;0;0;0;0;0;0;0;0;0
FR;5;2021-05-17;0;0;0;0;0;0;0;0;0;0
FR;5;2021-05-18;0;0;0;0;0;0;0;0;0;0
FR;5;2021-05-19;0;0;0;0;0;0;0;0;0;0
FR;5;2021-05-20;0;0;0;0;0;0;0;0;0;0
FR;5;2021-05-21;0;0;0;0;0;0;0;0;0;0
FR;5;2021-05-22;0;0;0;0;0;0;0;0;0;0
FR;5;2021-05-23;0;0;0;0;0;0;0;0;0;0
FR;5;2021-05-24;0;0;0;0;0;0;0;0;0;0
FR;5;2021-05-25;0;0;0;0;0;0;0;0;0;0
FR;5;2021-05-26;0;0;0;0;0;0;0;0;0;0
FR;5;2021-05-27;0;0;0;0;0;0;0;0;0;0
FR;5;2021-05-28;0;0;0;0;0;0;0;0;0;0
FR;5;2021-05-29;0;0;0;0;0;0;0;0;0;0
FR;5;2021-05-30;0;0;0;0;0;0;0;0;0;0
FR;5;2021-05-31;0;0;0;0;0;0;0;0;0;0
FR;5;2021-06-01;0;0;0;0;0;0;0;0;0;0
FR;5;2021-06-02;0;0;0;0;0;0;0;0;0;0
FR;5;2021-06-03;0;0;0;0;0;0;0;0;0;0
FR;5;2021-06-04;0;0;0;0;0;0;0;0;0;0
FR;5;2021-06-05;0;0;0;0;0;0;0;0;0;0
FR;5;2021-06-06;0;0;0;0;0;0;0;0;0;0
FR;5;2021-06-07;0;0;0;0;0;0;0;0;0;0
FR;5;2021-06-08;0;0;0;0;0;0;0;0;0;0
FR;5;2021-06-09;0;0;0;0;0;0;0;0;0;0
FR;5;2021-06-10;0;0;0;0;0;0;0;0;0;0
FR;5;2021-06-11;0;0;0;0;0;0;0;0;0;0
FR;5;2021-06-12;0;0;0;0;0;0;0;0;0;0
FR;5;2021-06-13;0;0;0;0;0;0;0;0;0;0
FR;5;2021-06-14;0;0;0;0;0;0;0;0;0;0
FR;5;2021-06-15;0;0;0;0;0;0;0;0;0;0
FR;5;2021-06-16;0;0;0;0;0;0;0;0;0;0
FR;5;2021-06-17;0;0;0;0;0;0;0;0;0;0
FR;5;2021-06-18;0;0;0;0;0;0;0;0;0;0
FR;5;2021-06-19;0;0;0;0;0;0;0;0;0;0
FR;5;2021-06-20;0;0;0;0;0;0;0;0;0;0
FR;5;2021-06-21;0;0;0;0;0;0;0;0;0;0
FR;5;2021-06-22;0;0;0;0;0;0;0;0;0;0
FR;5;2021-06-23;0;0;0;0;0;0;0;0;0;0
FR;5;2021-06-24;0;0;0;0;0;0;0;0;0;0
FR;5;2021-06-25;0;0;0;0;0;0;0;0;0;0
FR;5;2021-06-26;0;0;0;0;0;0;0;0;0;0
FR;5;2021-06-27;0;0;0;0;0;0;0;0;0;0
FR;5;2021-06-28;0;0;0;0;0;0;0;0;0;0
FR;5;2021-06-29;0;0;0;0;0;0;0;0;0;0
FR;5;2021-06-30;0;0;0;0;0;0;0;0;0;0
FR;5;2021-07-01;0;0;0;0;0;0;0;0;0;0
FR;5;2021-07-02;0;0;0;0;0;0;0;0;0;0
FR;5;2021-07-03;0;0;0;0;0;0;0;0;0;0
FR;5;2021-07-04;0;0;0;0;0;0;0;0;0;0
FR;5;2021-07-05;0;0;0;0;0;0;0;0;0;0
FR;5;2021-07-06;0;0;0;0;0;0;0;0;0;0
FR;5;2021-07-07;0;0;0;0;0;0;0;0;0;0
FR;5;2021-07-08;0;0;0;0;0;0;0;0;0;0
FR;5;2021-07-09;0;0;0;0;0;0;0;0;0;0
FR;5;2021-07-10;0;0;0;0;0;0;0;0;0;0
FR;5;2021-07-11;0;0;0;0;0;0;0;0;0;0
FR;5;2021-07-12;0;0;0;0;0;0;0;0;0;0
FR;5;2021-07-13;0;0;0;0;0;0;0;0;0;0
FR;5;2021-07-14;0;0;0;0;0;0;0;0;0;0
FR;5;2021-07-15;0;0;0;0;0;0;0;0;0;0
FR;5;2021-07-16;0;0;0;0;0;0;0;0;0;0
FR;5;2021-07-17;0;0;0;0;0;0;0;0;0;0
FR;5;2021-07-18;0;0;0;0;0;0;0;0;0;0
FR;5;2021-07-19;0;0;0;0;0;0;0;0;0;0
FR;5;2021-07-20;0;0;0;0;0;0;0;0;0;0
FR;5;2021-07-21;0;0;0;0;0;0;0;0;0;0
FR;5;2021-07-22;0;0;0;0;0;0;0;0;0;0
FR;5;2021-07-23;0;0;0;0;0;0;0;0;0;0
FR;5;2021-07-24;0;0;0;0;0;0;0;0;0;0
FR;5;2021-07-25;0;0;0;0;0;0;0;0;0;0
FR;5;2021-07-26;0;0;0;0;0;0;0;0;0;0
FR;5;2021-07-27;0;0;0;0;0;0;0;0;0;0
FR;5;2021-07-28;0;0;0;0;0;0;0;0;0;0
FR;5;2021-07-29;0;0;0;0;0;0;0;0;0;0
FR;5;2021-07-30;0;0;0;0;0;0;0;0;0;0
FR;5;2021-07-31;0;0;0;0;0;0;0;0;0;0
FR;5;2021-08-01;0;0;0;0;0;0;0;0;0;0
FR;5;2021-08-02;0;0;0;0;0;0;0;0;0;0
FR;5;2021-08-03;0;0;0;0;0;0;0;0;0;0
FR;5;2021-08-04;0;0;0;0;0;0;0;0;0;0
FR;5;2021-08-05;0;0;0;0;0;0;0;0;0;0
FR;5;2021-08-06;0;0;0;0;0;0;0;0;0;0
FR;5;2021-08-07;0;0;0;0;0;0;0;0;0;0
FR;5;2021-08-08;0;0;0;0;0;0;0;0;0;0
FR;5;2021-08-09;0;0;0;0;0;0;0;0;0;0
FR;5;2021-08-10;0;0;0;0;0;0;0;0;0;0
FR;5;2021-08-11;0;0;0;0;0;0;0;0;0;0
FR;5;2021-08-12;0;0;0;0;0;0;0;0;0;0
FR;5;2021-08-13;0;0;0;0;0;0;0;0;0;0
FR;5;2021-08-14;0;0;0;0;0;0;0;0;0;0
FR;5;2021-08-15;0;0;0;0;0;0;0;0;0;0
FR;5;2021-08-16;0;0;0;0;0;0;0;0;0;0
FR;5;2021-08-17;0;0;0;0;0;0;0;0;0;0
FR;5;2021-08-18;0;0;0;0;0;0;0;0;0;0
FR;5;2021-08-19;0;0;0;0;0;0;0;0;0;0
FR;5;2021-08-20;0;0;0;0;0;0;0;0;0;0
FR;5;2021-08-21;0;0;0;0;0;0;0;0;0;0
FR;5;2021-08-22;0;0;0;0;0;0;0;0;0;0
FR;5;2021-08-23;0;0;0;0;0;0;0;0;0;0
FR;5;2021-08-24;0;0;0;0;0;0;0;0;0;0
FR;5;2021-08-25;0;0;0;0;0;0;0;0;0;0
FR;5;2021-08-26;0;0;0;0;0;0;0;0;0;0
FR;5;2021-08-27;0;0;0;0;0;0;0;0;0;0
FR;5;2021-08-28;0;0;0;0;0;0;0;0;0;0
FR;5;2021-08-29;0;0;0;0;0;0;0;0;0;0
FR;5;2021-08-30;0;0;0;0;0;0;0;0;0;0
FR;5;2021-08-31;0;0;0;0;0;0;0;0;0;0
FR;5;2021-09-01;0;0;0;0;0;0;0;0;0;0
FR;5;2021-09-02;0;0;0;0;0;0;0;0;0;0
FR;5;2021-09-03;0;0;0;0;0;0;0;0;0;0
FR;5;2021-09-04;0;0;0;0;0;0;0;0;0;0
FR;5;2021-09-05;0;0;0;0;0;0;0;0;0;0
FR;5;2021-09-06;0;0;0;0;0;0;0;0;0;0
FR;5;2021-09-07;0;0;0;0;0;0;0;0;0;0
FR;5;2021-09-08;0;0;0;0;0;0;0;0;0;0
FR;5;2021-09-09;0;0;0;0;0;0;0;0;0;0
FR;5;2021-09-10;0;0;0;0;0;0;0;0;0;0
FR;5;2021-09-11;0;0;0;0;0;0;0;0;0;0
FR;5;2021-09-12;0;0;0;0;0;0;0;0;0;0
FR;5;2021-09-13;0;0;0;0;0;0;0;0;0;0
FR;5;2021-09-14;0;0;0;0;0;0;0;0;0;0
FR;5;2021-09-15;0;0;0;0;0;0;0;0;0;0
FR;5;2021-09-16;0;0;0;0;0;0;0;0;0;0
FR;5;2021-09-17;0;0;0;0;0;0;0;0;0;0
FR;5;2021-09-18;0;0;0;0;0;0;0;0;0;0
FR;5;2021-09-19;0;0;0;0;0;0;0;0;0;0
FR;5;2021-09-20;0;0;0;0;0;0;0;0;0;0
FR;5;2021-09-21;0;0;0;0;0;0;0;0;0;0
FR;5;2021-09-22;0;0;0;0;0;0;0;0;0;0
FR;5;2021-09-23;0;0;0;0;0;0;0;0;0;0
FR;5;2021-09-24;0;0;0;0;0;0;0;0;0;0
FR;5;2021-09-25;0;0;0;0;0;0;0;0;0;0
FR;5;2021-09-26;0;0;0;0;0;0;0;0;0;0
FR;5;2021-09-27;0;0;0;0;0;0;0;0;0;0
FR;5;2021-09-28;0;0;0;0;0;0;0;0;0;0
FR;5;2021-09-29;0;0;0;0;0;0;0;0;0;0
FR;5;2021-09-30;0;0;0;0;0;0;0;0;0;0
FR;5;2021-10-01;0;0;0;0;0;0;0;0;0;0
FR;5;2021-10-02;0;0;0;0;0;0;0;0;0;0
FR;5;2021-10-03;0;0;0;0;0;0;0;0;0;0
FR;5;2021-10-04;0;0;0;0;0;0;0;0;0;0
FR;5;2021-10-05;0;0;0;0;0;0;0;0;0;0
FR;5;2021-10-06;0;0;0;0;0;0;0;0;0;0
FR;5;2021-10-07;0;0;0;0;0;0;0;0;0;0
FR;5;2021-10-08;0;0;0;0;0;0;0;0;0;0
FR;5;2021-10-09;0;0;0;0;0;0;0;0;0;0
FR;5;2021-10-10;0;0;0;0;0;0;0;0;0;0
FR;5;2021-10-11;0;0;0;0;0;0;0;0;0;0
FR;5;2021-10-12;0;0;0;0;0;0;0;0;0;0
FR;5;2021-10-13;0;0;0;0;0;0;0;0;0;0
FR;5;2021-10-14;0;0;0;0;0;0;0;0;0;0
FR;5;2021-10-15;0;0;0;0;0;0;0;0;0;0
FR;5;2021-10-16;0;0;0;0;0;0;0;0;0;0
FR;5;2021-10-17;0;0;0;0;0;0;0;0;0;0
FR;5;2021-10-18;0;0;0;0;0;0;0;0;0;0
FR;5;2021-10-19;0;0;0;0;0;0;0;0;0;0
FR;5;2021-10-20;0;0;0;0;0;0;0;0;0;0
FR;5;2021-10-21;0;0;0;0;0;0;0;0;0;0
FR;5;2021-10-22;0;0;0;0;0;0;0;0;0;0
FR;5;2021-10-23;0;0;0;0;0;0;0;0;0;0
FR;5;2021-10-24;0;0;0;0;0;0;0;0;0;0
FR;5;2021-10-25;0;0;0;0;0;0;0;0;0;0
FR;5;2021-10-26;0;0;0;0;0;0;0;0;0;0
FR;5;2021-10-27;0;0;0;0;0;0;0;0;0;0
FR;5;2021-10-28;0;0;0;0;0;0;0;0;0;0
FR;5;2021-10-29;0;0;0;0;0;0;0;0;0;0
FR;5;2021-10-30;0;0;0;0;0;0;0;0;0;0
FR;5;2021-10-31;0;0;0;0;0;0;0;0;0;0
FR;5;2021-11-01;0;0;0;0;0;0;0;0;0;0
FR;5;2021-11-02;0;0;0;0;0;0;0;0;0;0
FR;5;2021-11-03;0;0;0;0;0;0;0;0;0;0
FR;5;2021-11-04;0;0;0;0;0;0;0;0;0;0
FR;5;2021-11-05;0;0;0;0;0;0;0;0;0;0
FR;5;2021-11-06;0;0;0;0;0;0;0;0;0;0
FR;5;2021-11-07;0;0;0;0;0;0;0;0;0;0
FR;5;2021-11-08;0;0;0;0;0;0;0;0;0;0
FR;5;2021-11-09;0;0;0;0;0;0;0;0;0;0
FR;5;2021-11-10;0;0;0;0;0;0;0;0;0;0
FR;5;2021-11-11;0;0;0;0;0;0;0;0;0;0
FR;5;2021-11-12;0;0;0;0;0;0;0;0;0;0
FR;5;2021-11-13;0;0;0;0;0;0;0;0;0;0
FR;5;2021-11-14;0;0;0;0;0;0;0;0;0;0
FR;5;2021-11-15;0;0;0;0;0;0;0;0;0;0
FR;5;2021-11-16;0;0;0;0;0;0;0;0;0;0
FR;5;2021-11-17;0;0;0;0;0;0;0;0;0;0
FR;5;2021-11-18;0;0;0;0;0;0;0;0;0;0
FR;5;2021-11-19;0;0;0;0;0;0;0;0;0;0
FR;5;2021-11-20;0;0;0;0;0;0;0;0;0;0
FR;5;2021-11-21;0;0;0;0;0;0;0;0;0;0
FR;5;2021-11-22;0;0;0;0;0;0;0;0;0;0
FR;5;2021-11-23;0;0;0;0;0;0;0;0;0;0
FR;5;2021-11-24;0;0;0;0;0;0;0;0;0;0
FR;5;2021-11-25;0;0;0;0;0;0;0;0;0;0
FR;5;2021-11-26;0;0;0;0;0;0;0;0;0;0
FR;5;2021-11-27;0;0;0;0;0;0;0;0;0;0
FR;5;2021-11-28;0;0;0;0;0;0;0;0;0;0
FR;5;2021-11-29;0;0;0;0;0;0;0;0;0;0
FR;5;2021-11-30;0;0;0;0;0;0;0;0;0;0
FR;5;2021-12-01;0;0;0;0;0;0;0;0;0;0
FR;5;2021-12-02;0;0;0;0;0;0;0;0;0;0
FR;5;2021-12-03;0;0;0;0;0;0;0;0;0;0
FR;5;2021-12-04;0;0;0;0;0;0;0;0;0;0
FR;5;2021-12-05;0;0;0;0;0;0;0;0;0;0
FR;5;2021-12-06;0;0;0;0;0;0;0;0;0;0
FR;5;2021-12-07;0;0;0;0;0;0;0;0;0;0
FR;5;2021-12-08;0;0;0;0;0;0;0;0;0;0
FR;5;2021-12-09;0;0;0;0;0;0;0;0;0;0
FR;5;2021-12-10;0;0;0;0;0;0;0;0;0;0
FR;5;2021-12-11;0;0;0;0;0;0;0;0;0;0
FR;5;2021-12-12;0;0;0;0;0;0;0;0;0;0
FR;5;2021-12-13;0;0;0;0;0;0;0;0;0;0
FR;5;2021-12-14;29;45;77;0;88;29;45;77;0;88
FR;5;2021-12-15;196;44;37;0;49;225;89;114;0;137
FR;5;2021-12-16;181;21;44;0;48;406;110;158;0;185
FR;5;2021-12-17;311;16;72;0;74;717;126;230;0;259
FR;5;2021-12-18;765;24;22;0;29;1482;150;252;0;288
FR;5;2021-12-19;586;15;15;0;17;2068;165;267;0;305
FR;5;2021-12-20;1223;31;35;0;38;3291;196;302;0;343
FR;5;2021-12-21;1536;22;54;1;60;4827;218;356;1;403
FR;5;2021-12-22;4069;40;37;0;46;8896;258;393;1;449
FR;5;2021-12-23;3042;16;21;0;25;11938;274;414;1;474
FR;5;2021-12-24;760;19;9;0;15;12698;293;423;1;489
FR;5;2021-12-25;61;5;1;0;2;12759;298;424;1;491
FR;5;2021-12-26;623;6;3;0;4;13382;304;427;1;495
FR;5;2021-12-27;4080;25;21;0;23;17462;329;448;1;518
FR;5;2021-12-28;5204;23;41;1;43;22666;352;489;2;561
FR;5;2021-12-29;8106;34;66;2;69;30772;386;555;4;630
FR;5;2021-12-30;5173;18;33;0;39;35945;404;588;4;669
FR;5;2021-12-31;1553;8;10;0;11;37498;412;598;4;680
FR;5;2022-01-01;185;2;2;0;3;37683;414;600;4;683
FR;5;2022-01-02;1489;1;1;0;1;39172;415;601;4;684
FR;5;2022-01-03;3061;36;33;0;32;42233;451;634;4;716
FR;5;2022-01-04;3034;39;33;0;42;45267;490;667;4;758
FR;5;2022-01-05;19323;203;97;1;108;64590;693;764;5;866
FR;5;2022-01-06;3746;133;122;0;142;68336;826;886;5;1008
FR;5;2022-01-07;5007;200;48;2;56;73343;1026;934;7;1064
FR;5;2022-01-08;13658;514;45;0;52;87001;1540;979;7;1116
FR;5;2022-01-09;5754;399;15;0;20;92755;1939;994;7;1136
FR;5;2022-01-10;3455;326;25;0;29;96210;2265;1019;7;1165
FR;5;2022-01-11;3672;284;38;0;41;99882;2549;1057;7;1206
FR;5;2022-01-12;22652;3005;90;0;113;122534;5554;1147;7;1319
FR;5;2022-01-13;4036;622;30;0;32;126570;6176;1177;7;1351
FR;5;2022-01-14;4843;581;44;0;51;131413;6757;1221;7;1402
FR;5;2022-01-15;14684;1746;38;3;49;146097;8503;1259;10;1451
FR;5;2022-01-16;4727;666;3;0;5;150824;9169;1262;10;1456
FR;5;2022-01-17;2298;715;26;0;29;153122;9884;1288;10;1485
FR;5;2022-01-18;2430;870;30;0;40;155552;10754;1318;10;1525
FR;5;2022-01-19;18482;6422;74;2;142;174034;17176;1392;12;1667
FR;5;2022-01-20;1920;1067;25;0;34;175954;18243;1417;12;1701
FR;5;2022-01-21;3076;1371;47;1;59;179030;19614;1464;13;1760
FR;5;2022-01-22;10721;3454;33;1;43;189751;23068;1497;14;1803
FR;5;2022-01-23;2629;1415;5;0;9;192380;24483;1502;14;1812
FR;5;2022-01-24;1160;1340;19;0;23;193540;25823;1521;14;1835
FR;5;2022-01-25;1220;1548;19;2;29;194760;27371;1540;16;1864
FR;5;2022-01-26;10752;12027;50;1;89;205512;39398;1590;17;1953
FR;5;2022-01-27;1292;1693;10;0;17;206804;41091;1600;17;1970
FR;5;2022-01-28;1699;3347;16;0;19;208503;44438;1616;17;1989
FR;5;2022-01-29;6236;8040;68;0;96;214739;52478;1684;17;2085
FR;5;2022-01-30;1509;2950;5;0;18;216248;55428;1689;17;2103
FR;5;2022-01-31;589;1773;23;0;24;216837;57201;1712;17;2127
FR;5;2022-02-01;712;1706;10;0;15;217549;58907;1722;17;2142
FR;5;2022-02-02;6957;15655;52;0;94;224506;74562;1774;17;2236
FR;5;2022-02-03;491;1690;14;0;13;224997;76252;1788;17;2249
FR;5;2022-02-04;944;3002;19;0;31;225941;79254;1807;17;2280
FR;5;2022-02-05;3534;8917;23;0;37;229475;88171;1830;17;2317
FR;5;2022-02-06;737;2397;10;0;19;230212;90568;1840;17;2336
FR;5;2022-02-07;884;1596;22;0;24;231096;92164;1862;17;2360
FR;5;2022-02-08;722;1287;18;0;20;231818;93451;1880;17;2380
FR;5;2022-02-09;4541;12877;44;0;76;236359;106328;1924;17;2456
FR;5;2022-02-10;646;1059;14;0;15;237005;107387;1938;17;2471
FR;5;2022-02-11;793;2031;16;0;21;237798;109418;1954;17;2492
FR;5;2022-02-12;2286;6811;33;0;53;240084;116229;1987;17;2545
FR;5;2022-02-13;465;1540;8;0;8;240549;117769;1995;17;2553
FR;5;2022-02-14;678;1288;10;0;13;241227;119057;2005;17;2566
FR;5;2022-02-15;482;886;9;0;14;241709;119943;2014;17;2580
FR;5;2022-02-16;2980;9123;41;1;58;244689;129066;2055;18;2638
FR;5;2022-02-17;436;809;6;0;7;245125;129875;2061;18;2645
FR;5;2022-02-18;649;1407;13;0;17;245774;131282;2074;18;2662
FR;5;2022-02-19;1372;4315;16;0;28;247146;135597;2090;18;2690
FR;5;2022-02-20;247;879;6;0;8;247393;136476;2096;18;2698
FR;5;2022-02-21;221;607;2;0;4;247614;137083;2098;18;2702
FR;5;2022-02-22;262;545;17;0;17;247876;137628;2115;18;2719
FR;5;2022-02-23;1909;6926;22;1;42;249785;144554;2137;19;2761
FR;5;2022-02-24;182;374;6;1;7;249967;144928;2143;20;2768
FR;5;2022-02-25;336;949;13;0;12;250303;145877;2156;20;2780
FR;5;2022-02-26;972;3070;10;0;14;251275;148947;2166;20;2794
FR;5;2022-02-27;149;506;0;0;3;251424;149453;2166;20;2797
FR;5;2022-02-28;162;369;1;0;1;251586;149822;2167;20;2798
FR;5;2022-03-01;130;280;6;0;7;251716;150102;2173;20;2805
FR;5;2022-03-02;1240;4156;28;3;40;252956;154258;2201;23;2845
FR;5;2022-03-03;121;251;5;0;10;253077;154509;2206;23;2855
FR;5;2022-03-04;194;488;13;0;14;253271;154997;2219;23;2869
FR;5;2022-03-05;677;1990;8;0;16;253948;156987;2227;23;2885
FR;5;2022-03-06;108;260;0;0;0;254056;157247;2227;23;2885
FR;5;2022-03-07;71;228;5;0;3;254127;157475;2232;23;2888
FR;5;2022-03-08;46;130;7;1;7;254173;157605;2239;24;2895
FR;5;2022-03-09;909;3078;24;0;36;255082;160683;2263;24;2931
FR;5;2022-03-10;82;201;8;0;12;255164;160884;2271;24;2943
FR;5;2022-03-11;148;369;13;1;15;255312;161253;2284;25;2958
FR;5;2022-03-12;758;1613;13;1;30;256070;162866;2297;26;2988
FR;5;2022-03-13;78;100;0;0;0;256148;162966;2297;26;2988
FR;5;2022-03-14;67;119;7;1;7;256215;163085;2304;27;2995
FR;5;2022-03-15;83;99;4;0;7;256298;163184;2308;27;3002
FR;5;2022-03-16;883;1827;15;3;36;257181;165011;2323;30;3038
FR;5;2022-03-17;66;123;8;4;10;257247;165134;2331;34;3048
FR;5;2022-03-18;172;318;13;4;18;257419;165452;2344;38;3066
FR;5;2022-03-19;751;1162;12;5;33;258170;166614;2356;43;3099
FR;5;2022-03-20;45;93;1;0;1;258215;166707;2357;43;3100
FR;5;2022-03-21;71;120;10;6;15;258286;166827;2367;49;3115
FR;5;2022-03-22;56;119;8;8;9;258342;166946;2375;57;3124
FR;5;2022-03-23;804;1461;14;8;36;259146;168407;2389;65;3160
FR;5;2022-03-24;70;93;8;7;7;259216;168500;2397;72;3167
FR;5;2022-03-25;222;291;14;8;18;259438;168791;2411;80;3185
FR;5;2022-03-26;707;853;12;5;26;260145;169644;2423;85;3211
FR;5;2022-03-27;74;80;0;0;3;260219;169724;2423;85;3214
FR;5;2022-03-28;81;91;1;2;3;260300;169815;2424;87;3217
FR;5;2022-03-29;71;82;10;4;12;260371;169897;2434;91;3229
FR;5;2022-03-30;823;1116;16;13;29;261194;171013;2450;104;3258
FR;5;2022-03-31;102;125;1;4;6;261296;171138;2451;108;3264
FR;5;2022-04-01;110;86;7;12;11;261406;171224;2458;120;3275
FR;5;2022-04-02;330;349;3;3;15;261736;171573;2461;123;3290
FR;5;2022-04-03;54;59;1;0;1;261790;171632;2462;123;3291
FR;5;2022-04-04;40;57;4;1;8;261830;171689;2466;124;3299
FR;5;2022-04-05;51;60;6;7;9;261881;171749;2472;131;3308
FR;5;2022-04-06;421;439;7;15;16;262302;172188;2479;146;3324
FR;5;2022-04-07;45;68;5;7;7;262347;172256;2484;153;3331
FR;5;2022-04-08;133;112;12;14;15;262480;172368;2496;167;3346
FR;5;2022-04-09;311;323;2;5;17;262791;172691;2498;172;3363
FR;5;2022-04-10;43;31;2;0;2;262834;172722;2500;172;3365
FR;5;2022-04-11;50;60;3;2;4;262884;172782;2503;174;3369
FR;5;2022-04-12;59;54;3;3;5;262943;172836;2506;177;3374
FR;5;2022-04-13;382;413;3;8;16;263325;173249;2509;185;3390
FR;5;2022-04-14;48;48;5;5;9;263373;173297;2514;190;3399
FR;5;2022-04-15;91;109;4;5;5;263464;173406;2518;195;3404
FR;5;2022-04-16;188;184;2;1;13;263652;173590;2520;196;3417
FR;5;2022-04-17;12;10;1;0;1;263664;173600;2521;196;3418
FR;5;2022-04-18;8;9;2;0;2;263672;173609;2523;196;3420
FR;5;2022-04-19;74;71;6;1;6;263746;173680;2529;197;3426
FR;5;2022-04-20;361;349;9;6;12;264107;174029;2538;203;3438
FR;5;2022-04-21;42;64;9;10;12;264149;174093;2547;213;3450
FR;5;2022-04-22;113;96;5;4;5;264262;174189;2552;217;3455
FR;5;2022-04-23;209;193;3;2;10;264471;174382;2555;219;3465
FR;5;2022-04-24;37;35;0;0;3;264508;174417;2555;219;3468
FR;5;2022-04-25;69;65;1;1;4;264577;174482;2556;220;3472
FR;5;2022-04-26;60;62;2;1;5;264637;174544;2558;221;3477
FR;5;2022-04-27;335;316;2;7;14;264972;174860;2560;228;3491
FR;5;2022-04-28;80;54;4;5;8;265052;174914;2564;233;3499
FR;5;2022-04-29;117;84;5;18;12;265169;174998;2569;251;3511
FR;5;2022-04-30;183;114;2;3;10;265352;175112;2571;254;3521
FR;5;2022-05-01;11;7;0;0;0;265363;175119;2571;254;3521
FR;5;2022-05-02;51;29;4;5;2;265414;175148;2575;259;3523
FR;5;2022-05-03;84;57;2;5;11;265498;175205;2577;264;3534
FR;5;2022-05-04;278;204;1;2;7;265776;175409;2578;266;3541
FR;5;2022-05-05;62;32;3;4;5;265838;175441;2581;270;3546
FR;5;2022-05-06;105;64;2;3;5;265943;175505;2583;273;3551
FR;5;2022-05-07;171;117;3;10;13;266114;175622;2586;283;3564
FR;5;2022-05-08;8;8;0;0;2;266122;175630;2586;283;3566
FR;5;2022-05-09;44;34;15;3;16;266166;175664;2601;286;3582
FR;5;2022-05-10;54;49;3;4;5;266220;175713;2604;290;3587
FR;5;2022-05-11;327;237;12;7;21;266547;175950;2616;297;3608
FR;5;2022-05-12;46;34;1;3;2;266593;175984;2617;300;3610
FR;5;2022-05-13;109;83;3;8;9;266702;176067;2620;308;3619
FR;5;2022-05-14;209;131;0;1;8;266911;176198;2620;309;3627
FR;5;2022-05-15;22;9;2;0;1;266933;176207;2622;309;3628
FR;5;2022-05-16;52;34;4;5;4;266985;176241;2626;314;3632
FR;5;2022-05-17;72;40;5;0;2;267057;176281;2631;314;3634
FR;5;2022-05-18;289;214;4;4;8;267346;176495;2635;318;3642
FR;5;2022-05-19;44;35;5;3;3;267390;176530;2640;321;3645
FR;5;2022-05-20;76;63;3;10;1;267466;176593;2643;331;3646
FR;5;2022-05-21;242;166;2;3;17;267708;176759;2645;334;3663
FR;5;2022-05-22;20;14;2;5;2;267728;176773;2647;339;3665
FR;5;2022-05-23;42;29;4;3;6;267770;176802;2651;342;3671
FR;5;2022-05-24;47;45;3;2;5;267817;176847;2654;344;3676
FR;5;2022-05-25;329;256;4;1;16;268146;177103;2658;345;3692
FR;5;2022-05-26;17;5;0;1;2;268163;177108;2658;346;3694
FR;5;2022-05-27;98;54;4;4;9;268261;177162;2662;350;3703
FR;5;2022-05-28;99;77;5;3;10;268360;177239;2667;353;3713
FR;5;2022-05-29;14;14;1;0;2;268374;177253;2668;353;3715
FR;5;2022-05-30;56;41;2;1;2;268430;177294;2670;354;3717
FR;5;2022-05-31;57;43;1;8;1;268487;177337;2671;362;3718
FR;5;2022-06-01;255;241;9;2;25;268742;177578;2680;364;3743
FR;5;2022-06-02;62;61;5;0;9;268804;177639;2685;364;3752
FR;5;2022-06-03;81;71;4;5;10;268885;177710;2689;369;3762
FR;5;2022-06-04;156;109;2;1;9;269041;177819;2691;370;3771
FR;5;2022-06-05;17;11;0;0;1;269058;177830;2691;370;3772
FR;5;2022-06-06;15;9;0;0;0;269073;177839;2691;370;3772
FR;5;2022-06-07;49;56;1;1;2;269122;177895;2692;371;3774
FR;5;2022-06-08;282;224;3;4;17;269404;178119;2695;375;3791
FR;5;2022-06-09;52;41;6;3;7;269456;178160;2701;378;3798
FR;5;2022-06-10;80;72;1;1;6;269536;178232;2702;379;3804
FR;5;2022-06-11;169;141;3;3;10;269705;178373;2705;382;3814
FR;5;2022-06-12;17;16;0;0;2;269722;178389;2705;382;3816
FR;5;2022-06-13;56;46;9;3;9;269778;178435;2714;385;3825
FR;5;2022-06-14;59;56;1;3;6;269837;178491;2715;388;3831
FR;5;2022-06-15;265;260;5;2;27;270102;178751;2720;390;3858
FR;5;2022-06-16;46;29;4;2;4;270148;178780;2724;392;3862
FR;5;2022-06-17;97;66;5;5;10;270245;178846;2729;397;3872
FR;5;2022-06-18;140;95;10;2;26;270385;178941;2739;399;3898
FR;5;2022-06-19;26;15;0;1;4;270411;178956;2739;400;3902
FR;5;2022-06-20;53;49;7;0;10;270464;179005;2746;400;3912
FR;5;2022-06-21;48;73;5;3;7;270512;179078;2751;403;3919
FR;5;2022-06-22;221;246;7;8;33;270733;179324;2758;411;3952
FR;5;2022-06-23;51;35;2;5;6;270784;179359;2760;416;3958
FR;5;2022-06-24;88;70;14;5;16;270872;179429;2774;421;3974
FR;5;2022-06-25;152;124;3;7;14;271024;179553;2777;428;3988
FR;5;2022-06-26;26;19;2;0;5;271050;179572;2779;428;3993
FR;5;2022-06-27;55;58;5;7;11;271105;179630;2784;435;4004
FR;5;2022-06-28;70;49;8;2;14;271175;179679;2792;437;4018
FR;5;2022-06-29;296;266;9;20;34;271471;179945;2801;457;4052
FR;5;2022-06-30;86;56;9;12;16;271557;180001;2810;469;4068
FR;5;2022-07-01;120;63;7;11;10;271677;180064;2817;480;4078
FR;5;2022-07-02;189;126;4;0;22;271866;180190;2821;480;4100
FR;5;2022-07-03;31;22;1;0;4;271897;180212;2822;480;4104
FR;5;2022-07-04;99;63;2;5;6;271996;180275;2824;485;4110
FR;5;2022-07-05;103;72;3;8;13;272099;180347;2827;493;4123
FR;5;2022-07-06;276;168;9;36;27;272375;180515;2836;529;4150
FR;5;2022-07-07;85;68;5;9;13;272460;180583;2841;538;4163
FR;5;2022-07-08;149;118;7;13;25;272609;180701;2848;551;4188
FR;5;2022-07-09;115;67;1;8;10;272724;180768;2849;559;4198
FR;5;2022-07-10;15;6;0;0;1;272739;180774;2849;559;4199
FR;5;2022-07-11;90;70;9;2;18;272829;180844;2858;561;4217
FR;5;2022-07-12;58;56;4;9;7;272887;180900;2862;570;4224
FR;6;2020-12-27;0;0;0;0;0;0;0;0;0;0
FR;6;2020-12-28;0;0;0;0;0;0;0;0;0;0
FR;6;2020-12-29;0;0;0;0;0;0;0;0;0;0
FR;6;2020-12-30;0;0;0;0;0;0;0;0;0;0
FR;6;2020-12-31;0;0;0;0;0;0;0;0;0;0
FR;6;2021-01-01;0;0;0;0;0;0;0;0;0;0
FR;6;2021-01-02;0;0;0;0;0;0;0;0;0;0
FR;6;2021-01-03;0;0;0;0;0;0;0;0;0;0
FR;6;2021-01-04;0;0;0;0;0;0;0;0;0;0
FR;6;2021-01-05;0;0;0;0;0;0;0;0;0;0
FR;6;2021-01-06;0;0;0;0;0;0;0;0;0;0
FR;6;2021-01-07;0;0;0;0;0;0;0;0;0;0
FR;6;2021-01-08;0;0;0;0;0;0;0;0;0;0
FR;6;2021-01-09;0;0;0;0;0;0;0;0;0;0
FR;6;2021-01-10;0;0;0;0;0;0;0;0;0;0
FR;6;2021-01-11;0;0;0;0;0;0;0;0;0;0
FR;6;2021-01-12;0;0;0;0;0;0;0;0;0;0
FR;6;2021-01-13;0;0;0;0;0;0;0;0;0;0
FR;6;2021-01-14;0;0;0;0;0;0;0;0;0;0
FR;6;2021-01-15;0;0;0;0;0;0;0;0;0;0
FR;6;2021-01-16;0;0;0;0;0;0;0;0;0;0
FR;6;2021-01-17;0;0;0;0;0;0;0;0;0;0
FR;6;2021-01-18;0;0;0;0;0;0;0;0;0;0
FR;6;2021-01-19;0;0;0;0;0;0;0;0;0;0
FR;6;2021-01-20;0;0;0;0;0;0;0;0;0;0
FR;6;2021-01-21;0;0;0;0;0;0;0;0;0;0
FR;6;2021-01-22;0;0;0;0;0;0;0;0;0;0
FR;6;2021-01-23;0;0;0;0;0;0;0;0;0;0
FR;6;2021-01-24;0;0;0;0;0;0;0;0;0;0
FR;6;2021-01-25;0;0;0;0;0;0;0;0;0;0
FR;6;2021-01-26;0;0;0;0;0;0;0;0;0;0
FR;6;2021-01-27;0;0;0;0;0;0;0;0;0;0
FR;6;2021-01-28;0;0;0;0;0;0;0;0;0;0
FR;6;2021-01-29;0;0;0;0;0;0;0;0;0;0
FR;6;2021-01-30;0;0;0;0;0;0;0;0;0;0
FR;6;2021-01-31;0;0;0;0;0;0;0;0;0;0
FR;6;2021-02-01;0;0;0;0;0;0;0;0;0;0
FR;6;2021-02-02;0;0;0;0;0;0;0;0;0;0
FR;6;2021-02-03;0;0;0;0;0;0;0;0;0;0
FR;6;2021-02-04;0;0;0;0;0;0;0;0;0;0
FR;6;2021-02-05;0;0;0;0;0;0;0;0;0;0
FR;6;2021-02-06;0;0;0;0;0;0;0;0;0;0
FR;6;2021-02-07;0;0;0;0;0;0;0;0;0;0
FR;6;2021-02-08;0;0;0;0;0;0;0;0;0;0
FR;6;2021-02-09;0;0;0;0;0;0;0;0;0;0
FR;6;2021-02-10;0;0;0;0;0;0;0;0;0;0
FR;6;2021-02-11;0;0;0;0;0;0;0;0;0;0
FR;6;2021-02-12;0;0;0;0;0;0;0;0;0;0
FR;6;2021-02-13;0;0;0;0;0;0;0;0;0;0
FR;6;2021-02-14;0;0;0;0;0;0;0;0;0;0
FR;6;2021-02-15;0;0;0;0;0;0;0;0;0;0
FR;6;2021-02-16;0;0;0;0;0;0;0;0;0;0
FR;6;2021-02-17;0;0;0;0;0;0;0;0;0;0
FR;6;2021-02-18;0;0;0;0;0;0;0;0;0;0
FR;6;2021-02-19;0;0;0;0;0;0;0;0;0;0
FR;6;2021-02-20;0;0;0;0;0;0;0;0;0;0
FR;6;2021-02-21;0;0;0;0;0;0;0;0;0;0
FR;6;2021-02-22;0;0;0;0;0;0;0;0;0;0
FR;6;2021-02-23;0;0;0;0;0;0;0;0;0;0
FR;6;2021-02-24;0;0;0;0;0;0;0;0;0;0
FR;6;2021-02-25;0;0;0;0;0;0;0;0;0;0
FR;6;2021-02-26;0;0;0;0;0;0;0;0;0;0
FR;6;2021-02-27;0;0;0;0;0;0;0;0;0;0
FR;6;2021-02-28;0;0;0;0;0;0;0;0;0;0
FR;6;2021-03-01;0;0;0;0;0;0;0;0;0;0
FR;6;2021-03-02;0;0;0;0;0;0;0;0;0;0
FR;6;2021-03-03;0;0;0;0;0;0;0;0;0;0
FR;6;2021-03-04;0;0;0;0;0;0;0;0;0;0
FR;6;2021-03-05;0;0;0;0;0;0;0;0;0;0
FR;6;2021-03-06;0;0;0;0;0;0;0;0;0;0
FR;6;2021-03-07;0;0;0;0;0;0;0;0;0;0
FR;6;2021-03-08;0;0;0;0;0;0;0;0;0;0
FR;6;2021-03-09;0;0;0;0;0;0;0;0;0;0
FR;6;2021-03-10;0;0;0;0;0;0;0;0;0;0
FR;6;2021-03-11;0;0;0;0;0;0;0;0;0;0
FR;6;2021-03-12;0;0;0;0;0;0;0;0;0;0
FR;6;2021-03-13;0;0;0;0;0;0;0;0;0;0
FR;6;2021-03-14;0;0;0;0;0;0;0;0;0;0
FR;6;2021-03-15;0;0;0;0;0;0;0;0;0;0
FR;6;2021-03-16;0;0;0;0;0;0;0;0;0;0
FR;6;2021-03-17;0;0;0;0;0;0;0;0;0;0
FR;6;2021-03-18;0;0;0;0;0;0;0;0;0;0
FR;6;2021-03-19;0;0;0;0;0;0;0;0;0;0
FR;6;2021-03-20;0;0;0;0;0;0;0;0;0;0
FR;6;2021-03-21;0;0;0;0;0;0;0;0;0;0
FR;6;2021-03-22;0;0;0;0;0;0;0;0;0;0
FR;6;2021-03-23;0;0;0;0;0;0;0;0;0;0
FR;6;2021-03-24;0;0;0;0;0;0;0;0;0;0
FR;6;2021-03-25;0;0;0;0;0;0;0;0;0;0
FR;6;2021-03-26;0;0;0;0;0;0;0;0;0;0
FR;6;2021-03-27;0;0;0;0;0;0;0;0;0;0
FR;6;2021-03-28;0;0;0;0;0;0;0;0;0;0
FR;6;2021-03-29;0;0;0;0;0;0;0;0;0;0
FR;6;2021-03-30;0;0;0;0;0;0;0;0;0;0
FR;6;2021-03-31;0;0;0;0;0;0;0;0;0;0
FR;6;2021-04-01;0;0;0;0;0;0;0;0;0;0
FR;6;2021-04-02;0;0;0;0;0;0;0;0;0;0
FR;6;2021-04-03;0;0;0;0;0;0;0;0;0;0
FR;6;2021-04-04;0;0;0;0;0;0;0;0;0;0
FR;6;2021-04-05;0;0;0;0;0;0;0;0;0;0
FR;6;2021-04-06;0;0;0;0;0;0;0;0;0;0
FR;6;2021-04-07;0;0;0;0;0;0;0;0;0;0
FR;6;2021-04-08;0;0;0;0;0;0;0;0;0;0
FR;6;2021-04-09;0;0;0;0;0;0;0;0;0;0
FR;6;2021-04-10;0;0;0;0;0;0;0;0;0;0
FR;6;2021-04-11;0;0;0;0;0;0;0;0;0;0
FR;6;2021-04-12;0;0;0;0;0;0;0;0;0;0
FR;6;2021-04-13;0;0;0;0;0;0;0;0;0;0
FR;6;2021-04-14;0;0;0;0;0;0;0;0;0;0
FR;6;2021-04-15;0;0;0;0;0;0;0;0;0;0
FR;6;2021-04-16;0;0;0;0;0;0;0;0;0;0
FR;6;2021-04-17;0;0;0;0;0;0;0;0;0;0
FR;6;2021-04-18;0;0;0;0;0;0;0;0;0;0
FR;6;2021-04-19;0;0;0;0;0;0;0;0;0;0
FR;6;2021-04-20;0;0;0;0;0;0;0;0;0;0
FR;6;2021-04-21;0;0;0;0;0;0;0;0;0;0
FR;6;2021-04-22;0;0;0;0;0;0;0;0;0;0
FR;6;2021-04-23;0;0;0;0;0;0;0;0;0;0
FR;6;2021-04-24;0;0;0;0;0;0;0;0;0;0
FR;6;2021-04-25;0;0;0;0;0;0;0;0;0;0
FR;6;2021-04-26;0;0;0;0;0;0;0;0;0;0
FR;6;2021-04-27;0;0;0;0;0;0;0;0;0;0
FR;6;2021-04-28;0;0;0;0;0;0;0;0;0;0
FR;6;2021-04-29;0;0;0;0;0;0;0;0;0;0
FR;6;2021-04-30;0;0;0;0;0;0;0;0;0;0
FR;6;2021-05-01;0;0;0;0;0;0;0;0;0;0
FR;6;2021-05-02;0;0;0;0;0;0;0;0;0;0
FR;6;2021-05-03;0;0;0;0;0;0;0;0;0;0
FR;6;2021-05-04;0;0;0;0;0;0;0;0;0;0
FR;6;2021-05-05;0;0;0;0;0;0;0;0;0;0
FR;6;2021-05-06;0;0;0;0;0;0;0;0;0;0
FR;6;2021-05-07;0;0;0;0;0;0;0;0;0;0
FR;6;2021-05-08;0;0;0;0;0;0;0;0;0;0
FR;6;2021-05-09;0;0;0;0;0;0;0;0;0;0
FR;6;2021-05-10;0;0;0;0;0;0;0;0;0;0
FR;6;2021-05-11;0;0;0;0;0;0;0;0;0;0
FR;6;2021-05-12;0;0;0;0;0;0;0;0;0;0
FR;6;2021-05-13;0;0;0;0;0;0;0;0;0;0
FR;6;2021-05-14;0;0;0;0;0;0;0;0;0;0
FR;6;2021-05-15;0;0;0;0;0;0;0;0;0;0
FR;6;2021-05-16;0;0;0;0;0;0;0;0;0;0
FR;6;2021-05-17;0;0;0;0;0;0;0;0;0;0
FR;6;2021-05-18;0;0;0;0;0;0;0;0;0;0
FR;6;2021-05-19;0;0;0;0;0;0;0;0;0;0
FR;6;2021-05-20;0;0;0;0;0;0;0;0;0;0
FR;6;2021-05-21;0;0;0;0;0;0;0;0;0;0
FR;6;2021-05-22;0;0;0;0;0;0;0;0;0;0
FR;6;2021-05-23;0;0;0;0;0;0;0;0;0;0
FR;6;2021-05-24;0;0;0;0;0;0;0;0;0;0
FR;6;2021-05-25;0;0;0;0;0;0;0;0;0;0
FR;6;2021-05-26;0;0;0;0;0;0;0;0;0;0
FR;6;2021-05-27;0;0;0;0;0;0;0;0;0;0
FR;6;2021-05-28;0;0;0;0;0;0;0;0;0;0
FR;6;2021-05-29;0;0;0;0;0;0;0;0;0;0
FR;6;2021-05-30;0;0;0;0;0;0;0;0;0;0
FR;6;2021-05-31;0;0;0;0;0;0;0;0;0;0
FR;6;2021-06-01;0;0;0;0;0;0;0;0;0;0
FR;6;2021-06-02;0;0;0;0;0;0;0;0;0;0
FR;6;2021-06-03;0;0;0;0;0;0;0;0;0;0
FR;6;2021-06-04;0;0;0;0;0;0;0;0;0;0
FR;6;2021-06-05;0;0;0;0;0;0;0;0;0;0
FR;6;2021-06-06;0;0;0;0;0;0;0;0;0;0
FR;6;2021-06-07;0;0;0;0;0;0;0;0;0;0
FR;6;2021-06-08;0;0;0;0;0;0;0;0;0;0
FR;6;2021-06-09;0;0;0;0;0;0;0;0;0;0
FR;6;2021-06-10;0;0;0;0;0;0;0;0;0;0
FR;6;2021-06-11;0;0;0;0;0;0;0;0;0;0
FR;6;2021-06-12;0;0;0;0;0;0;0;0;0;0
FR;6;2021-06-13;0;0;0;0;0;0;0;0;0;0
FR;6;2021-06-14;0;0;0;0;0;0;0;0;0;0
FR;6;2021-06-15;0;0;0;0;0;0;0;0;0;0
FR;6;2021-06-16;0;0;0;0;0;0;0;0;0;0
FR;6;2021-06-17;0;0;0;0;0;0;0;0;0;0
FR;6;2021-06-18;0;0;0;0;0;0;0;0;0;0
FR;6;2021-06-19;0;0;0;0;0;0;0;0;0;0
FR;6;2021-06-20;0;0;0;0;0;0;0;0;0;0
FR;6;2021-06-21;0;0;0;0;0;0;0;0;0;0
FR;6;2021-06-22;0;0;0;0;0;0;0;0;0;0
FR;6;2021-06-23;0;0;0;0;0;0;0;0;0;0
FR;6;2021-06-24;0;0;0;0;0;0;0;0;0;0
FR;6;2021-06-25;0;0;0;0;0;0;0;0;0;0
FR;6;2021-06-26;0;0;0;0;0;0;0;0;0;0
FR;6;2021-06-27;0;0;0;0;0;0;0;0;0;0
FR;6;2021-06-28;0;0;0;0;0;0;0;0;0;0
FR;6;2021-06-29;0;0;0;0;0;0;0;0;0;0
FR;6;2021-06-30;0;0;0;0;0;0;0;0;0;0
FR;6;2021-07-01;0;0;0;0;0;0;0;0;0;0
FR;6;2021-07-02;0;0;0;0;0;0;0;0;0;0
FR;6;2021-07-03;0;0;0;0;0;0;0;0;0;0
FR;6;2021-07-04;0;0;0;0;0;0;0;0;0;0
FR;6;2021-07-05;0;0;0;0;0;0;0;0;0;0
FR;6;2021-07-06;0;0;0;0;0;0;0;0;0;0
FR;6;2021-07-07;0;0;0;0;0;0;0;0;0;0
FR;6;2021-07-08;0;0;0;0;0;0;0;0;0;0
FR;6;2021-07-09;0;0;0;0;0;0;0;0;0;0
FR;6;2021-07-10;0;0;0;0;0;0;0;0;0;0
FR;6;2021-07-11;0;0;0;0;0;0;0;0;0;0
FR;6;2021-07-12;0;0;0;0;0;0;0;0;0;0
FR;6;2021-07-13;0;0;0;0;0;0;0;0;0;0
FR;6;2021-07-14;0;0;0;0;0;0;0;0;0;0
FR;6;2021-07-15;0;0;0;0;0;0;0;0;0;0
FR;6;2021-07-16;0;0;0;0;0;0;0;0;0;0
FR;6;2021-07-17;0;0;0;0;0;0;0;0;0;0
FR;6;2021-07-18;0;0;0;0;0;0;0;0;0;0
FR;6;2021-07-19;0;0;0;0;0;0;0;0;0;0
FR;6;2021-07-20;0;0;0;0;0;0;0;0;0;0
FR;6;2021-07-21;0;0;0;0;0;0;0;0;0;0
FR;6;2021-07-22;0;0;0;0;0;0;0;0;0;0
FR;6;2021-07-23;0;0;0;0;0;0;0;0;0;0
FR;6;2021-07-24;0;0;0;0;0;0;0;0;0;0
FR;6;2021-07-25;0;0;0;0;0;0;0;0;0;0
FR;6;2021-07-26;0;0;0;0;0;0;0;0;0;0
FR;6;2021-07-27;0;0;0;0;0;0;0;0;0;0
FR;6;2021-07-28;0;0;0;0;0;0;0;0;0;0
FR;6;2021-07-29;0;0;0;0;0;0;0;0;0;0
FR;6;2021-07-30;0;0;0;0;0;0;0;0;0;0
FR;6;2021-07-31;0;0;0;0;0;0;0;0;0;0
FR;6;2021-08-01;0;0;0;0;0;0;0;0;0;0
FR;6;2021-08-02;0;0;0;0;0;0;0;0;0;0
FR;6;2021-08-03;0;0;0;0;0;0;0;0;0;0
FR;6;2021-08-04;0;0;0;0;0;0;0;0;0;0
FR;6;2021-08-05;0;0;0;0;0;0;0;0;0;0
FR;6;2021-08-06;0;0;0;0;0;0;0;0;0;0
FR;6;2021-08-07;0;0;0;0;0;0;0;0;0;0
FR;6;2021-08-08;0;0;0;0;0;0;0;0;0;0
FR;6;2021-08-09;0;0;0;0;0;0;0;0;0;0
FR;6;2021-08-10;0;0;0;0;0;0;0;0;0;0
FR;6;2021-08-11;0;0;0;0;0;0;0;0;0;0
FR;6;2021-08-12;0;0;0;0;0;0;0;0;0;0
FR;6;2021-08-13;0;0;0;0;0;0;0;0;0;0
FR;6;2021-08-14;0;0;0;0;0;0;0;0;0;0
FR;6;2021-08-15;0;0;0;0;0;0;0;0;0;0
FR;6;2021-08-16;0;0;0;0;0;0;0;0;0;0
FR;6;2021-08-17;0;0;0;0;0;0;0;0;0;0
FR;6;2021-08-18;0;0;0;0;0;0;0;0;0;0
FR;6;2021-08-19;0;0;0;0;0;0;0;0;0;0
FR;6;2021-08-20;0;0;0;0;0;0;0;0;0;0
FR;6;2021-08-21;0;0;0;0;0;0;0;0;0;0
FR;6;2021-08-22;0;0;0;0;0;0;0;0;0;0
FR;6;2021-08-23;0;0;0;0;0;0;0;0;0;0
FR;6;2021-08-24;0;0;0;0;0;0;0;0;0;0
FR;6;2021-08-25;0;0;0;0;0;0;0;0;0;0
FR;6;2021-08-26;0;0;0;0;0;0;0;0;0;0
FR;6;2021-08-27;0;0;0;0;0;0;0;0;0;0
FR;6;2021-08-28;0;0;0;0;0;0;0;0;0;0
FR;6;2021-08-29;0;0;0;0;0;0;0;0;0;0
FR;6;2021-08-30;0;0;0;0;0;0;0;0;0;0
FR;6;2021-08-31;0;0;0;0;0;0;0;0;0;0
FR;6;2021-09-01;0;0;0;0;0;0;0;0;0;0
FR;6;2021-09-02;0;0;0;0;0;0;0;0;0;0
FR;6;2021-09-03;0;0;0;0;0;0;0;0;0;0
FR;6;2021-09-04;0;0;0;0;0;0;0;0;0;0
FR;6;2021-09-05;0;0;0;0;0;0;0;0;0;0
FR;6;2021-09-06;0;0;0;0;0;0;0;0;0;0
FR;6;2021-09-07;0;0;0;0;0;0;0;0;0;0
FR;6;2021-09-08;0;0;0;0;0;0;0;0;0;0
FR;6;2021-09-09;0;0;0;0;0;0;0;0;0;0
FR;6;2021-09-10;0;0;0;0;0;0;0;0;0;0
FR;6;2021-09-11;0;0;0;0;0;0;0;0;0;0
FR;6;2021-09-12;0;0;0;0;0;0;0;0;0;0
FR;6;2021-09-13;0;0;0;0;0;0;0;0;0;0
FR;6;2021-09-14;0;0;0;0;0;0;0;0;0;0
FR;6;2021-09-15;0;0;0;0;0;0;0;0;0;0
FR;6;2021-09-16;0;0;0;0;0;0;0;0;0;0
FR;6;2021-09-17;0;0;0;0;0;0;0;0;0;0
FR;6;2021-09-18;0;0;0;0;0;0;0;0;0;0
FR;6;2021-09-19;0;0;0;0;0;0;0;0;0;0
FR;6;2021-09-20;0;0;0;0;0;0;0;0;0;0
FR;6;2021-09-21;0;0;0;0;0;0;0;0;0;0
FR;6;2021-09-22;0;0;0;0;0;0;0;0;0;0
FR;6;2021-09-23;0;0;0;0;0;0;0;0;0;0
FR;6;2021-09-24;0;0;0;0;0;0;0;0;0;0
FR;6;2021-09-25;0;0;0;0;0;0;0;0;0;0
FR;6;2021-09-26;0;0;0;0;0;0;0;0;0;0
FR;6;2021-09-27;0;0;0;0;0;0;0;0;0;0
FR;6;2021-09-28;0;0;0;0;0;0;0;0;0;0
FR;6;2021-09-29;0;0;0;0;0;0;0;0;0;0
FR;6;2021-09-30;0;0;0;0;0;0;0;0;0;0
FR;6;2021-10-01;0;0;0;0;0;0;0;0;0;0
FR;6;2021-10-02;0;0;0;0;0;0;0;0;0;0
FR;6;2021-10-03;0;0;0;0;0;0;0;0;0;0
FR;6;2021-10-04;0;0;0;0;0;0;0;0;0;0
FR;6;2021-10-05;0;0;0;0;0;0;0;0;0;0
FR;6;2021-10-06;0;0;0;0;0;0;0;0;0;0
FR;6;2021-10-07;0;0;0;0;0;0;0;0;0;0
FR;6;2021-10-08;0;0;0;0;0;0;0;0;0;0
FR;6;2021-10-09;0;0;0;0;0;0;0;0;0;0
FR;6;2021-10-10;0;0;0;0;0;0;0;0;0;0
FR;6;2021-10-11;0;0;0;0;0;0;0;0;0;0
FR;6;2021-10-12;0;0;0;0;0;0;0;0;0;0
FR;6;2021-10-13;0;0;0;0;0;0;0;0;0;0
FR;6;2021-10-14;0;0;0;0;0;0;0;0;0;0
FR;6;2021-10-15;0;0;0;0;0;0;0;0;0;0
FR;6;2021-10-16;0;0;0;0;0;0;0;0;0;0
FR;6;2021-10-17;0;0;0;0;0;0;0;0;0;0
FR;6;2021-10-18;0;0;0;0;0;0;0;0;0;0
FR;6;2021-10-19;0;0;0;0;0;0;0;0;0;0
FR;6;2021-10-20;0;0;0;0;0;0;0;0;0;0
FR;6;2021-10-21;0;0;0;0;0;0;0;0;0;0
FR;6;2021-10-22;0;0;0;0;0;0;0;0;0;0
FR;6;2021-10-23;0;0;0;0;0;0;0;0;0;0
FR;6;2021-10-24;0;0;0;0;0;0;0;0;0;0
FR;6;2021-10-25;0;0;0;0;0;0;0;0;0;0
FR;6;2021-10-26;0;0;0;0;0;0;0;0;0;0
FR;6;2021-10-27;0;0;0;0;0;0;0;0;0;0
FR;6;2021-10-28;0;0;0;0;0;0;0;0;0;0
FR;6;2021-10-29;0;0;0;0;0;0;0;0;0;0
FR;6;2021-10-30;0;0;0;0;0;0;0;0;0;0
FR;6;2021-10-31;0;0;0;0;0;0;0;0;0;0
FR;6;2021-11-01;0;0;0;0;0;0;0;0;0;0
FR;6;2021-11-02;0;0;0;0;0;0;0;0;0;0
FR;6;2021-11-03;0;0;0;0;0;0;0;0;0;0
FR;6;2021-11-04;0;0;0;0;0;0;0;0;0;0
FR;6;2021-11-05;0;0;0;0;0;0;0;0;0;0
FR;6;2021-11-06;0;0;0;0;0;0;0;0;0;0
FR;6;2021-11-07;0;0;0;0;0;0;0;0;0;0
FR;6;2021-11-08;0;0;0;0;0;0;0;0;0;0
FR;6;2021-11-09;0;0;0;0;0;0;0;0;0;0
FR;6;2021-11-10;0;0;0;0;0;0;0;0;0;0
FR;6;2021-11-11;0;0;0;0;0;0;0;0;0;0
FR;6;2021-11-12;0;0;0;0;0;0;0;0;0;0
FR;6;2021-11-13;0;0;0;0;0;0;0;0;0;0
FR;6;2021-11-14;0;0;0;0;0;0;0;0;0;0
FR;6;2021-11-15;0;0;0;0;0;0;0;0;0;0
FR;6;2021-11-16;0;0;0;0;0;0;0;0;0;0
FR;6;2021-11-17;0;0;0;0;0;0;0;0;0;0
FR;6;2021-11-18;0;0;0;0;0;0;0;0;0;0
FR;6;2021-11-19;0;0;0;0;0;0;0;0;0;0
FR;6;2021-11-20;0;0;0;0;0;0;0;0;0;0
FR;6;2021-11-21;0;0;0;0;0;0;0;0;0;0
FR;6;2021-11-22;0;0;0;0;0;0;0;0;0;0
FR;6;2021-11-23;0;0;0;0;0;0;0;0;0;0
FR;6;2021-11-24;0;0;0;0;0;0;0;0;0;0
FR;6;2021-11-25;0;0;0;0;0;0;0;0;0;0
FR;6;2021-11-26;0;0;0;0;0;0;0;0;0;0
FR;6;2021-11-27;0;0;0;0;0;0;0;0;0;0
FR;6;2021-11-28;0;0;0;0;0;0;0;0;0;0
FR;6;2021-11-29;0;0;0;0;0;0;0;0;0;0
FR;6;2021-11-30;0;0;0;0;0;0;0;0;0;0
FR;6;2021-12-01;0;0;0;0;0;0;0;0;0;0
FR;6;2021-12-02;0;0;0;0;0;0;0;0;0;0
FR;6;2021-12-03;0;0;0;0;0;0;0;0;0;0
FR;6;2021-12-04;0;0;0;0;0;0;0;0;0;0
FR;6;2021-12-05;0;0;0;0;0;0;0;0;0;0
FR;6;2021-12-06;0;0;0;0;0;0;0;0;0;0
FR;6;2021-12-07;0;0;0;0;0;0;0;0;0;0
FR;6;2021-12-08;0;0;0;0;0;0;0;0;0;0
FR;6;2021-12-09;0;0;0;0;0;0;0;0;0;0
FR;6;2021-12-10;0;0;0;0;0;0;0;0;0;0
FR;6;2021-12-11;0;0;0;0;0;0;0;0;0;0
FR;6;2021-12-12;0;0;0;0;0;0;0;0;0;0
FR;6;2021-12-13;0;0;0;0;0;0;0;0;0;0
FR;6;2021-12-14;0;0;0;0;0;0;0;0;0;0
FR;6;2021-12-15;0;0;0;0;0;0;0;0;0;0
FR;6;2021-12-16;0;0;0;0;0;0;0;0;0;0
FR;6;2021-12-17;0;0;0;0;0;0;0;0;0;0
FR;6;2021-12-18;0;0;0;0;0;0;0;0;0;0
FR;6;2021-12-19;0;0;0;0;0;0;0;0;0;0
FR;6;2021-12-20;0;0;0;0;0;0;0;0;0;0
FR;6;2021-12-21;0;0;0;0;0;0;0;0;0;0
FR;6;2021-12-22;0;0;0;0;0;0;0;0;0;0
FR;6;2021-12-23;0;0;0;0;0;0;0;0;0;0
FR;6;2021-12-24;0;0;0;0;0;0;0;0;0;0
FR;6;2021-12-25;0;0;0;0;0;0;0;0;0;0
FR;6;2021-12-26;0;0;0;0;0;0;0;0;0;0
FR;6;2021-12-27;0;0;0;0;0;0;0;0;0;0
FR;6;2021-12-28;0;0;0;0;0;0;0;0;0;0
FR;6;2021-12-29;0;0;0;0;0;0;0;0;0;0
FR;6;2021-12-30;0;0;0;0;0;0;0;0;0;0
FR;6;2021-12-31;0;0;0;0;0;0;0;0;0;0
FR;6;2022-01-01;0;0;0;0;0;0;0;0;0;0
FR;6;2022-01-02;0;0;0;0;0;0;0;0;0;0
FR;6;2022-01-03;0;0;0;0;0;0;0;0;0;0
FR;6;2022-01-04;0;0;0;0;0;0;0;0;0;0
FR;6;2022-01-05;0;0;0;0;0;0;0;0;0;0
FR;6;2022-01-06;0;0;0;0;0;0;0;0;0;0
FR;6;2022-01-07;0;0;0;0;0;0;0;0;0;0
FR;6;2022-01-08;0;0;0;0;0;0;0;0;0;0
FR;6;2022-01-09;0;0;0;0;0;0;0;0;0;0
FR;6;2022-01-10;0;0;0;0;0;0;0;0;0;0
FR;6;2022-01-11;0;0;0;0;0;0;0;0;0;0
FR;6;2022-01-12;0;0;0;0;0;0;0;0;0;0
FR;6;2022-01-13;0;0;0;0;0;0;0;0;0;0
FR;6;2022-01-14;0;0;0;0;0;0;0;0;0;0
FR;6;2022-01-15;0;0;0;0;0;0;0;0;0;0
FR;6;2022-01-16;0;0;0;0;0;0;0;0;0;0
FR;6;2022-01-17;0;0;0;0;0;0;0;0;0;0
FR;6;2022-01-18;0;0;0;0;0;0;0;0;0;0
FR;6;2022-01-19;0;0;0;0;0;0;0;0;0;0
FR;6;2022-01-20;0;0;0;0;0;0;0;0;0;0
FR;6;2022-01-21;0;0;0;0;0;0;0;0;0;0
FR;6;2022-01-22;0;0;0;0;0;0;0;0;0;0
FR;6;2022-01-23;0;0;0;0;0;0;0;0;0;0
FR;6;2022-01-24;0;0;0;0;0;0;0;0;0;0
FR;6;2022-01-25;0;0;0;0;0;0;0;0;0;0
FR;6;2022-01-26;0;0;0;0;0;0;0;0;0;0
FR;6;2022-01-27;0;0;0;0;0;0;0;0;0;0
FR;6;2022-01-28;0;0;0;0;0;0;0;0;0;0
FR;6;2022-01-29;0;0;0;0;0;0;0;0;0;0
FR;6;2022-01-30;0;0;0;0;0;0;0;0;0;0
FR;6;2022-01-31;0;0;0;0;0;0;0;0;0;0
FR;6;2022-02-01;0;0;0;0;0;0;0;0;0;0
FR;6;2022-02-02;0;0;0;0;0;0;0;0;0;0
FR;6;2022-02-03;0;0;0;0;0;0;0;0;0;0
FR;6;2022-02-04;0;0;0;0;0;0;0;0;0;0
FR;6;2022-02-05;0;0;0;0;0;0;0;0;0;0
FR;6;2022-02-06;0;0;0;0;0;0;0;0;0;0
FR;6;2022-02-07;0;0;0;0;0;0;0;0;0;0
FR;6;2022-02-08;0;0;0;0;0;0;0;0;0;0
FR;6;2022-02-09;0;0;0;0;0;0;0;0;0;0
FR;6;2022-02-10;0;0;0;0;0;0;0;0;0;0
FR;6;2022-02-11;0;0;0;0;0;0;0;0;0;0
FR;6;2022-02-12;0;0;0;0;0;0;0;0;0;0
FR;6;2022-02-13;0;0;0;0;0;0;0;0;0;0
FR;6;2022-02-14;0;0;0;0;0;0;0;0;0;0
FR;6;2022-02-15;0;0;0;0;0;0;0;0;0;0
FR;6;2022-02-16;0;0;0;0;0;0;0;0;0;0
FR;6;2022-02-17;0;0;0;0;0;0;0;0;0;0
FR;6;2022-02-18;0;0;0;0;0;0;0;0;0;0
FR;6;2022-02-19;0;0;0;0;0;0;0;0;0;0
FR;6;2022-02-20;0;0;0;0;0;0;0;0;0;0
FR;6;2022-02-21;0;0;0;0;0;0;0;0;0;0
FR;6;2022-02-22;0;0;0;0;0;0;0;0;0;0
FR;6;2022-02-23;0;0;0;0;0;0;0;0;0;0
FR;6;2022-02-24;0;0;0;0;0;0;0;0;0;0
FR;6;2022-02-25;0;0;0;0;0;0;0;0;0;0
FR;6;2022-02-26;1;0;0;0;0;1;0;0;0;0
FR;6;2022-02-27;0;0;0;0;0;1;0;0;0;0
FR;6;2022-02-28;0;0;0;0;0;1;0;0;0;0
FR;6;2022-03-01;3;0;0;0;0;4;0;0;0;0
FR;6;2022-03-02;97;9;2;0;7;101;9;2;0;7
FR;6;2022-03-03;0;0;0;0;0;101;9;2;0;7
FR;6;2022-03-04;91;4;0;0;4;192;13;2;0;11
FR;6;2022-03-05;391;23;2;0;14;583;36;4;0;25
FR;6;2022-03-06;7;1;0;0;0;590;37;4;0;25
FR;6;2022-03-07;337;19;0;0;13;927;56;4;0;38
FR;6;2022-03-08;230;14;0;0;5;1157;70;4;0;43
FR;6;2022-03-09;519;29;2;0;21;1676;99;6;0;64
FR;6;2022-03-10;206;19;0;1;12;1882;118;6;1;76
FR;6;2022-03-11;328;21;6;0;21;2210;139;12;1;97
FR;6;2022-03-12;518;25;1;0;20;2728;164;13;1;117
FR;6;2022-03-13;40;2;0;0;1;2768;166;13;1;118
FR;6;2022-03-14;201;4;2;0;3;2969;170;15;1;121
FR;6;2022-03-15;112;11;2;0;9;3081;181;17;1;130
FR;6;2022-03-16;310;17;1;1;14;3391;198;18;2;144
FR;6;2022-03-17;117;6;1;2;4;3508;204;19;4;148
FR;6;2022-03-18;215;10;0;0;6;3723;214;19;4;154
FR;6;2022-03-19;307;19;2;0;9;4030;233;21;4;163
FR;6;2022-03-20;15;5;0;0;1;4045;238;21;4;164
FR;6;2022-03-21;132;23;1;0;4;4177;261;22;4;168
FR;6;2022-03-22;97;15;0;0;4;4274;276;22;4;172
FR;6;2022-03-23;226;108;3;0;14;4500;384;25;4;186
FR;6;2022-03-24;100;15;1;3;4;4600;399;26;7;190
FR;6;2022-03-25;203;141;2;1;15;4803;540;28;8;205
FR;6;2022-03-26;331;295;7;1;19;5134;835;35;9;224
FR;6;2022-03-27;32;30;1;0;1;5166;865;36;9;225
FR;6;2022-03-28;200;208;8;1;17;5366;1073;44;10;242
FR;6;2022-03-29;124;189;12;2;12;5490;1262;56;12;254
FR;6;2022-03-30;305;476;10;2;22;5795;1738;66;14;276
FR;6;2022-03-31;124;140;10;0;14;5919;1878;76;14;290
FR;6;2022-04-01;195;150;11;2;23;6114;2028;87;16;313
FR;6;2022-04-02;205;241;9;1;13;6319;2269;96;17;326
FR;6;2022-04-03;17;21;0;0;1;6336;2290;96;17;327
FR;6;2022-04-04;132;114;6;1;9;6468;2404;102;18;336
FR;6;2022-04-05;145;88;15;1;11;6613;2492;117;19;347
FR;6;2022-04-06;204;245;22;26;27;6817;2737;139;45;374
FR;6;2022-04-07;127;96;15;9;17;6944;2833;154;54;391
FR;6;2022-04-08;199;170;16;3;17;7143;3003;170;57;408
FR;6;2022-04-09;145;139;6;12;13;7288;3142;176;69;421
FR;6;2022-04-10;10;20;3;0;1;7298;3162;179;69;422
FR;6;2022-04-11;101;106;4;0;5;7399;3268;183;69;427
FR;6;2022-04-12;136;75;5;8;10;7535;3343;188;77;437
FR;6;2022-04-13;161;175;7;5;13;7696;3518;195;82;450
FR;6;2022-04-14;100;103;5;10;8;7796;3621;200;92;458
FR;6;2022-04-15;160;148;11;7;19;7956;3769;211;99;477
FR;6;2022-04-16;127;132;5;0;14;8083;3901;216;99;491
FR;6;2022-04-17;8;9;4;0;4;8091;3910;220;99;495
FR;6;2022-04-18;8;15;3;0;4;8099;3925;223;99;499
FR;6;2022-04-19;97;112;4;3;3;8196;4037;227;102;502
FR;6;2022-04-20;177;227;8;7;15;8373;4264;235;109;517
FR;6;2022-04-21;111;93;8;4;11;8484;4357;243;113;528
FR;6;2022-04-22;138;160;13;12;13;8622;4517;256;125;541
FR;6;2022-04-23;106;129;1;1;7;8728;4646;257;126;548
FR;6;2022-04-24;5;21;1;0;0;8733;4667;258;126;548
FR;6;2022-04-25;91;128;3;8;11;8824;4795;261;134;559
FR;6;2022-04-26;101;128;18;2;16;8925;4923;279;136;575
FR;6;2022-04-27;197;159;21;1;27;9122;5082;300;137;602
FR;6;2022-04-28;109;87;7;1;8;9231;5169;307;138;610
FR;6;2022-04-29;191;168;16;2;20;9422;5337;323;140;630
FR;6;2022-04-30;133;125;7;1;24;9555;5462;330;141;654
FR;6;2022-05-01;7;6;0;0;0;9562;5468;330;141;654
FR;6;2022-05-02;94;65;3;4;3;9656;5533;333;145;657
FR;6;2022-05-03;136;92;11;2;7;9792;5625;344;147;664
FR;6;2022-05-04;167;118;25;12;29;9959;5743;369;159;693
FR;6;2022-05-05;101;70;8;3;12;10060;5813;377;162;705
FR;6;2022-05-06;152;110;10;9;16;10212;5923;387;171;721
FR;6;2022-05-07;138;93;13;3;23;10350;6016;400;174;744
FR;6;2022-05-08;20;8;6;5;7;10370;6024;406;179;751
FR;6;2022-05-09;86;73;9;7;13;10456;6097;415;186;764
FR;6;2022-05-10;111;80;15;7;12;10567;6177;430;193;776
FR;6;2022-05-11;130;124;11;14;20;10697;6301;441;207;796
FR;6;2022-05-12;105;76;7;5;15;10802;6377;448;212;811
FR;6;2022-05-13;154;95;17;21;20;10956;6472;465;233;831
FR;6;2022-05-14;81;60;6;7;15;11037;6532;471;240;846
FR;6;2022-05-15;12;7;0;0;0;11049;6539;471;240;846
FR;6;2022-05-16;64;54;6;2;12;11113;6593;477;242;858
FR;6;2022-05-17;123;77;5;7;11;11236;6670;482;249;869
FR;6;2022-05-18;131;116;5;1;13;11367;6786;487;250;882
FR;6;2022-05-19;124;57;6;8;9;11491;6843;493;258;891
FR;6;2022-05-20;127;115;13;3;18;11618;6958;506;261;909
FR;6;2022-05-21;92;69;14;3;12;11710;7027;520;264;921
FR;6;2022-05-22;19;12;5;0;4;11729;7039;525;264;925
FR;6;2022-05-23;77;72;4;2;7;11806;7111;529;266;932
FR;6;2022-05-24;116;98;8;2;16;11922;7209;537;268;948
FR;6;2022-05-25;139;129;6;3;11;12061;7338;543;271;959
FR;6;2022-05-26;7;9;3;0;9;12068;7347;546;271;968
FR;6;2022-05-27;127;105;15;11;18;12195;7452;561;282;986
FR;6;2022-05-28;52;75;1;5;8;12247;7527;562;287;994
FR;6;2022-05-29;8;10;0;0;1;12255;7537;562;287;995
FR;6;2022-05-30;70;70;7;4;4;12325;7607;569;291;999
FR;6;2022-05-31;87;102;10;2;14;12412;7709;579;293;1013
FR;6;2022-06-01;97;89;10;1;11;12509;7798;589;294;1024
FR;6;2022-06-02;88;60;6;3;9;12597;7858;595;297;1033
FR;6;2022-06-03;126;102;13;7;21;12723;7960;608;304;1054
FR;6;2022-06-04;62;51;10;0;12;12785;8011;618;304;1066
FR;6;2022-06-05;16;15;2;1;4;12801;8026;620;305;1070
FR;6;2022-06-06;9;6;0;0;0;12810;8032;620;305;1070
FR;6;2022-06-07;79;90;3;4;8;12889;8122;623;309;1078
FR;6;2022-06-08;92;110;13;5;20;12981;8232;636;314;1098
FR;6;2022-06-09;75;81;15;3;15;13056;8313;651;317;1113
FR;6;2022-06-10;116;93;26;9;22;13172;8406;677;326;1135
FR;6;2022-06-11;83;62;6;10;12;13255;8468;683;336;1147
FR;6;2022-06-12;6;14;1;0;2;13261;8482;684;336;1149
FR;6;2022-06-13;74;59;18;1;7;13335;8541;702;337;1156
FR;6;2022-06-14;98;100;8;5;16;13433;8641;710;342;1172
FR;6;2022-06-15;80;85;7;8;15;13513;8726;717;350;1187
FR;6;2022-06-16;53;40;11;7;14;13566;8766;728;357;1201
FR;6;2022-06-17;85;81;3;13;11;13651;8847;731;370;1212
FR;6;2022-06-18;72;60;12;0;20;13723;8907;743;370;1232
FR;6;2022-06-19;6;6;3;0;4;13729;8913;746;370;1236
FR;6;2022-06-20;42;41;4;1;6;13771;8954;750;371;1242
FR;6;2022-06-21;59;73;7;7;15;13830;9027;757;378;1257
FR;6;2022-06-22;84;85;8;2;17;13914;9112;765;380;1274
FR;6;2022-06-23;64;39;13;7;15;13978;9151;778;387;1289
FR;6;2022-06-24;73;82;7;14;17;14051;9233;785;401;1306
FR;6;2022-06-25;67;61;4;3;8;14118;9294;789;404;1314
FR;6;2022-06-26;5;7;1;0;1;14123;9301;790;404;1315
FR;6;2022-06-27;52;50;4;9;12;14175;9351;794;413;1327
FR;6;2022-06-28;67;47;5;3;15;14242;9398;799;416;1342
FR;6;2022-06-29;97;117;26;37;19;14339;9515;825;453;1361
FR;6;2022-06-30;82;59;33;9;12;14421;9574;858;462;1373
FR;6;2022-07-01;113;94;24;32;17;14534;9668;882;494;1390
FR;6;2022-07-02;56;66;23;2;34;14590;9734;905;496;1424
FR;6;2022-07-03;11;4;4;3;4;14601;9738;909;499;1428
FR;6;2022-07-04;61;43;3;23;13;14662;9781;912;522;1441
FR;6;2022-07-05;65;52;18;67;25;14727;9833;930;589;1466
FR;6;2022-07-06;93;64;7;11;12;14820;9897;937;600;1478
FR;6;2022-07-07;91;79;42;37;14;14911;9976;979;637;1492
FR;6;2022-07-08;136;87;42;26;10;15047;10063;1021;663;1502
FR;6;2022-07-09;53;50;16;29;26;15100;10113;1037;692;1528
FR;6;2022-07-10;3;6;8;0;9;15103;10119;1045;692;1537
FR;6;2022-07-11;53;40;5;3;9;15156;10159;1050;695;1546
FR;6;2022-07-12;69;60;12;22;12;15225;10219;1062;717;1558
FR;0;2020-12-27;609;0;0;0;0;609;0;0;0;0
FR;0;2020-12-28;676;1;0;0;0;1285;1;0;0;0
FR;0;2020-12-29;378;0;0;0;0;1663;1;0;0;0
FR;0;2020-12-30;441;0;0;0;0;2104;1;0;0;0
FR;0;2020-12-31;439;1;0;0;0;2543;2;0;0;0
FR;0;2021-01-01;1149;2;0;0;0;3692;4;0;0;0
FR;0;2021-01-02;362;3;0;0;0;4054;7;0;0;0
FR;0;2021-01-03;402;0;0;0;0;4456;7;0;0;0
FR;0;2021-01-04;2100;3;0;0;0;6556;10;0;0;0
FR;0;2021-01-05;7744;3;0;0;0;14300;13;0;0;0
FR;0;2021-01-06;12454;15;0;0;0;26754;28;0;0;0
FR;0;2021-01-07;29455;13;0;0;0;56209;41;0;0;0
FR;0;2021-01-08;37138;14;0;0;0;93347;55;0;0;0
FR;0;2021-01-09;11211;7;0;0;0;104558;62;0;0;0
FR;0;2021-01-10;6003;5;0;0;0;110561;67;0;0;0
FR;0;2021-01-11;39927;19;0;0;0;150488;86;0;0;0
FR;0;2021-01-12;62132;17;0;0;0;212620;103;0;0;0
FR;0;2021-01-13;65114;37;0;0;0;277734;140;0;0;0
FR;0;2021-01-14;83115;120;0;0;0;360849;260;0;0;0
FR;0;2021-01-15;69003;43;0;0;0;429852;303;0;0;0
FR;0;2021-01-16;20210;72;0;0;0;450062;375;0;0;0
FR;0;2021-01-17;10982;49;0;0;0;461044;424;0;0;0
FR;0;2021-01-18;85892;170;0;0;0;546936;594;0;0;0
FR;0;2021-01-19;130594;179;0;0;0;677530;773;0;0;0
FR;0;2021-01-20;137539;186;0;0;0;815069;959;0;0;0
FR;0;2021-01-21;158392;171;0;0;0;973461;1130;0;0;0
FR;0;2021-01-22;121056;220;0;0;0;1094517;1350;0;0;0
FR;0;2021-01-23;38476;68;0;0;0;1132993;1418;0;0;0
FR;0;2021-01-24;9741;93;0;0;0;1142734;1511;0;0;0
FR;0;2021-01-25;78229;1312;0;0;0;1220963;2823;0;0;0
FR;0;2021-01-26;100372;3406;1;0;0;1321335;6229;1;0;0
FR;0;2021-01-27;107233;6039;0;0;0;1428568;12268;1;0;0
FR;0;2021-01-28;124340;15283;0;0;0;1552908;27551;1;0;0
FR;0;2021-01-29;92178;17956;0;0;0;1645086;45507;1;0;0
FR;0;2021-01-30;29120;4373;0;0;0;1674206;49880;1;0;0
FR;0;2021-01-31;5231;1786;0;0;0;1679437;51666;1;0;0
FR;0;2021-02-01;53114;21793;0;0;0;1732551;73459;1;0;0
FR;0;2021-02-02;72293;36344;0;0;0;1804844;109803;1;0;0
FR;0;2021-02-03;72299;38629;0;0;0;1877143;148432;1;0;0
FR;0;2021-02-04;82062;52391;0;0;0;1959205;200823;1;0;0
FR;0;2021-02-05;68225;46522;0;0;0;2027430;247345;1;0;0
FR;0;2021-02-06;23065;10937;0;0;0;2050495;258282;1;0;0
FR;0;2021-02-07;5185;5500;0;0;0;2055680;263782;1;0;0
FR;0;2021-02-08;46829;47371;0;0;0;2102509;311153;1;0;0
FR;0;2021-02-09;66001;75515;0;0;0;2168510;386668;1;0;0
FR;0;2021-02-10;71002;80278;0;0;0;2239512;466946;1;0;0
FR;0;2021-02-11;87269;102245;0;0;0;2326781;569191;1;0;0
FR;0;2021-02-12;79306;75279;0;0;0;2406087;644470;1;0;0
FR;0;2021-02-13;22371;19555;0;0;0;2428458;664025;1;0;0
FR;0;2021-02-14;5073;7335;0;0;0;2433531;671360;1;0;0
FR;0;2021-02-15;38078;76725;0;0;0;2471609;748085;1;0;0
FR;0;2021-02-16;50384;100611;0;0;0;2521993;848696;1;0;0
FR;0;2021-02-17;50517;105296;20;0;0;2572510;953992;21;0;0
FR;0;2021-02-18;69781;121321;0;0;0;2642291;1075313;21;0;0
FR;0;2021-02-19;65056;91443;1;0;0;2707347;1166756;22;0;0
FR;0;2021-02-20;18582;28683;0;0;0;2725929;1195439;22;0;0
FR;0;2021-02-21;3316;6277;0;0;0;2729245;1201716;22;0;0
FR;0;2021-02-22;37493;73305;2;0;0;2766738;1275021;24;0;0
FR;0;2021-02-23;53772;84692;1;0;0;2820510;1359713;25;0;0
FR;0;2021-02-24;59995;82110;1;0;0;2880505;1441823;26;0;0
FR;0;2021-02-25;100561;91374;1;0;0;2981066;1533197;27;0;0
FR;0;2021-02-26;113451;70773;1;0;0;3094517;1603970;28;0;0
FR;0;2021-02-27;52095;22254;1;0;0;3146612;1626224;29;0;0
FR;0;2021-02-28;6193;4244;2;0;0;3152805;1630468;31;0;0
FR;0;2021-03-01;65864;53533;1;0;0;3218669;1684001;32;0;0
FR;0;2021-03-02;101366;66845;2;0;0;3320035;1750846;34;0;0
FR;0;2021-03-03;116500;65484;0;0;0;3436535;1816330;34;0;0
FR;0;2021-03-04;163609;71004;3;0;0;3600144;1887334;37;0;0
FR;0;2021-03-05;200905;62956;3;0;0;3801049;1950290;40;0;0
FR;0;2021-03-06;207944;17657;3;0;0;4008993;1967947;43;0;0
FR;0;2021-03-07;121267;4735;1;0;0;4130260;1972682;44;0;0
FR;0;2021-03-08;107133;50110;2;0;0;4237393;2022792;46;0;0
FR;0;2021-03-09;172438;56401;2;0;0;4409831;2079193;48;0;0
FR;0;2021-03-10;178973;57093;5;0;0;4588804;2136286;53;0;0
FR;0;2021-03-11;242861;63648;2;0;0;4831665;2199934;55;0;0
FR;0;2021-03-12;294796;53450;1;0;0;5126461;2253384;56;0;0
FR;0;2021-03-13;231387;15320;1;0;0;5357848;2268704;57;0;0
FR;0;2021-03-14;63344;3227;1;0;0;5421192;2271931;58;0;0
FR;0;2021-03-15;158633;32040;3;0;0;5579825;2303971;61;0;0
FR;0;2021-03-16;141558;39048;6;0;0;5721383;2343019;67;0;0
FR;0;2021-03-17;150466;38060;4;0;0;5871849;2381079;71;0;0
FR;0;2021-03-18;167810;44463;5;0;0;6039659;2425542;76;0;0
FR;0;2021-03-19;229984;37096;2;0;0;6269643;2462638;78;0;0
FR;0;2021-03-20;166663;11517;1;0;0;6436306;2474155;79;0;0
FR;0;2021-03-21;49930;2367;1;0;0;6486236;2476522;80;0;0
FR;0;2021-03-22;170022;33920;2;0;0;6656258;2510442;82;0;0
FR;0;2021-03-23;250358;42349;1;0;0;6906616;2552791;83;0;0
FR;0;2021-03-24;256874;43614;0;0;0;7163490;2596405;83;0;0
FR;0;2021-03-25;341788;44933;5;0;0;7505278;2641338;88;0;0
FR;0;2021-03-26;358777;41887;4;1;0;7864055;2683225;92;1;0
FR;0;2021-03-27;195247;16813;1;0;0;8059302;2700038;93;1;0
FR;0;2021-03-28;59332;4216;3;0;0;8118634;2704254;96;1;0
FR;0;2021-03-29;202953;53787;4;0;0;8321587;2758041;100;1;0
FR;0;2021-03-30;285455;69789;5;0;0;8607042;2827830;105;1;0
FR;0;2021-03-31;263002;73485;4;0;0;8870044;2901315;109;1;0
FR;0;2021-04-01;315436;90396;11;0;0;9185480;2991711;120;1;0
FR;0;2021-04-02;281310;93429;7;0;0;9466790;3085140;127;1;0
FR;0;2021-04-03;141063;62133;5;0;0;9607853;3147273;132;1;0
FR;0;2021-04-04;46525;18811;2;0;0;9654378;3166084;134;1;0
FR;0;2021-04-05;63323;10682;11;0;0;9717701;3176766;145;1;0
FR;0;2021-04-06;217186;110416;17;0;0;9934887;3287182;162;1;0
FR;0;2021-04-07;260232;115258;17;0;0;10195119;3402440;179;1;0
FR;0;2021-04-08;337790;122154;14;0;0;10532909;3524594;193;1;0
FR;0;2021-04-09;410123;116533;49;0;0;10943032;3641127;242;1;0
FR;0;2021-04-10;212604;82724;15;0;0;11155636;3723851;257;1;0
FR;0;2021-04-11;56133;34340;7;0;0;11211769;3758191;264;1;0
FR;0;2021-04-12;237038;115473;45;0;0;11448807;3873664;309;1;0
FR;0;2021-04-13;309453;144326;98;1;0;11758260;4017990;407;2;0
FR;0;2021-04-14;294493;139381;214;0;0;12052753;4157371;621;2;0
FR;0;2021-04-15;337062;149090;338;0;0;12389815;4306461;959;2;0
FR;0;2021-04-16;339256;146182;353;0;0;12729071;4452643;1312;2;0
FR;0;2021-04-17;188644;89969;109;0;0;12917715;4542612;1421;2;0
FR;0;2021-04-18;51611;35373;47;0;0;12969326;4577985;1468;2;0
FR;0;2021-04-19;205662;138198;456;0;0;13174988;4716183;1924;2;0
FR;0;2021-04-20;254383;171151;569;0;0;13429371;4887334;2493;2;0
FR;0;2021-04-21;253223;169349;834;0;0;13682594;5056683;3327;2;0
FR;0;2021-04-22;287522;189145;818;0;0;13970116;5245828;4145;2;0
FR;0;2021-04-23;297868;183708;747;0;0;14267984;5429536;4892;2;0
FR;0;2021-04-24;190437;111677;252;0;0;14458421;5541213;5144;2;0
FR;0;2021-04-25;69550;38769;51;0;0;14527971;5579982;5195;2;0
FR;0;2021-04-26;220929;156934;561;0;0;14748900;5736916;5756;2;0
FR;0;2021-04-27;284574;187517;940;0;0;15033474;5924433;6696;2;0
FR;0;2021-04-28;299473;183606;1423;1;1;15332947;6108039;8119;3;1
FR;0;2021-04-29;357098;196956;1277;0;0;15690045;6304995;9396;3;1
FR;0;2021-04-30;372174;185144;1121;1;0;16062219;6490139;10517;4;1
FR;0;2021-05-01;167627;52492;178;0;0;16229846;6542631;10695;4;1
FR;0;2021-05-02;91727;37775;83;0;0;16321573;6580406;10778;4;1
FR;0;2021-05-03;288896;167539;841;0;0;16610469;6747945;11619;4;1
FR;0;2021-05-04;315640;224696;1232;0;0;16926109;6972641;12851;4;1
FR;0;2021-05-05;327157;225224;1313;0;0;17253266;7197865;14164;4;1
FR;0;2021-05-06;379484;239863;1632;0;0;17632750;7437728;15796;4;1
FR;0;2021-05-07;372718;257699;1222;0;0;18005468;7695427;17018;4;1
FR;0;2021-05-08;222145;68618;299;0;0;18227613;7764045;17317;4;1
FR;0;2021-05-09;129691;45924;243;0;0;18357304;7809969;17560;4;1
FR;0;2021-05-10;313349;228975;1234;0;0;18670653;8038944;18794;4;1
FR;0;2021-05-11;403866;257920;1564;0;0;19074519;8296864;20358;4;1
FR;0;2021-05-12;434073;233278;1542;0;0;19508592;8530142;21900;4;1
FR;0;2021-05-13;338575;56809;430;0;0;19847167;8586951;22330;4;1
FR;0;2021-05-14;454090;167359;1125;0;0;20301257;8754310;23455;4;1
FR;0;2021-05-15;374951;94148;443;0;0;20676208;8848458;23898;4;1
FR;0;2021-05-16;202737;20726;168;0;0;20878945;8869184;24066;4;1
FR;0;2021-05-17;376093;148819;1552;0;0;21255038;9018003;25618;4;1
FR;0;2021-05-18;460107;153423;1988;0;0;21715145;9171426;27606;4;1
FR;0;2021-05-19;467362;144022;2459;0;0;22182507;9315448;30065;4;1
FR;0;2021-05-20;507490;160255;2334;0;0;22689997;9475703;32399;4;1
FR;0;2021-05-21;489629;174652;1992;0;0;23179626;9650355;34391;4;1
FR;0;2021-05-22;347166;79967;668;0;0;23526792;9730322;35059;4;1
FR;0;2021-05-23;161682;14313;246;0;0;23688474;9744635;35305;4;1
FR;0;2021-05-24;263166;33208;603;0;0;23951640;9777843;35908;4;1
FR;0;2021-05-25;400249;189716;2351;1;0;24351889;9967559;38259;5;1
FR;0;2021-05-26;413424;189231;2221;0;0;24765313;10156790;40480;5;1
FR;0;2021-05-27;449769;219114;2160;0;0;25215082;10375904;42640;5;1
FR;0;2021-05-28;429522;259897;1891;0;0;25644604;10635801;44531;5;1
FR;0;2021-05-29;298961;149703;584;0;0;25943565;10785504;45115;5;1
FR;0;2021-05-30;107133;32577;163;0;0;26050698;10818081;45278;5;1
FR;0;2021-05-31;358007;203335;1468;1;1;26408705;11021416;46746;6;2
FR;0;2021-06-01;430950;251286;1960;1;1;26839655;11272702;48706;7;3
FR;0;2021-06-02;420062;231241;1981;0;0;27259717;11503943;50687;7;3
FR;0;2021-06-03;465538;258241;1823;0;0;27725255;11762184;52510;7;3
FR;0;2021-06-04;455979;305064;1730;1;1;28181234;12067248;54240;8;4
FR;0;2021-06-05;304775;189137;652;0;0;28486009;12256385;54892;8;4
FR;0;2021-06-06;133287;49082;226;0;0;28619296;12305467;55118;8;4
FR;0;2021-06-07;339465;261837;1523;0;0;28958761;12567304;56641;8;4
FR;0;2021-06-08;393704;290885;1803;0;0;29352465;12858189;58444;8;4
FR;0;2021-06-09;384774;274947;1729;0;0;29737239;13133136;60173;8;4
FR;0;2021-06-10;404112;288378;1722;1;0;30141351;13421514;61895;9;4
FR;0;2021-06-11;386600;356952;1465;0;0;30527951;13778466;63360;9;4
FR;0;2021-06-12;283232;211151;492;0;0;30811183;13989617;63852;9;4
FR;0;2021-06-13;104873;73925;204;0;0;30916056;14063542;64056;9;4
FR;0;2021-06-14;240785;355042;1426;1;0;31156841;14418584;65482;10;4
FR;0;2021-06-15;308090;385235;1566;1;0;31464931;14803819;67048;11;4
FR;0;2021-06-16;313938;357557;1417;1;0;31778869;15161376;68465;12;4
FR;0;2021-06-17;317629;372642;1425;1;0;32096498;15534018;69890;13;4
FR;0;2021-06-18;321705;442535;1336;1;0;32418203;15976553;71226;14;4
FR;0;2021-06-19;224330;273797;448;0;0;32642533;16250350;71674;14;4
FR;0;2021-06-20;74415;102492;126;0;0;32716948;16352842;71800;14;4
FR;0;2021-06-21;195720;401807;1034;1;1;32912668;16754649;72834;15;5
FR;0;2021-06-22;223148;467405;1264;10;2;33135816;17222054;74098;25;7
FR;0;2021-06-23;233997;439905;1197;1;1;33369813;17661959;75295;26;8
FR;0;2021-06-24;241825;409548;1353;0;0;33611638;18071507;76648;26;8
FR;0;2021-06-25;227609;522461;1398;0;0;33839247;18593968;78046;26;8
FR;0;2021-06-26;153225;370754;586;1;0;33992472;18964722;78632;27;8
FR;0;2021-06-27;55889;156147;168;1;0;34048361;19120869;78800;28;8
FR;0;2021-06-28;154734;452779;1173;0;0;34203095;19573648;79973;28;8
FR;0;2021-06-29;182655;507070;2124;0;0;34385750;20080718;82097;28;8
FR;0;2021-06-30;203959;484155;2011;21;2;34589709;20564873;84108;49;10
FR;0;2021-07-01;231265;457965;2221;5;1;34820974;21022838;86329;54;11
FR;0;2021-07-02;228528;520144;2120;5;2;35049502;21542982;88449;59;13
FR;0;2021-07-03;142025;368721;909;3;1;35191527;21911703;89358;62;14
FR;0;2021-07-04;56715;141176;265;0;0;35248242;22052879;89623;62;14
FR;0;2021-07-05;168447;419159;1668;8;2;35416689;22472038;91291;70;16
FR;0;2021-07-06;196707;474706;1828;45;8;35613396;22946744;93119;115;24
FR;0;2021-07-07;213082;439192;1878;25;5;35826478;23385936;94997;140;29
FR;0;2021-07-08;231585;424144;2089;20;6;36058063;23810080;97086;160;35
FR;0;2021-07-09;228505;510956;2183;4;2;36286568;24321036;99269;164;37
FR;0;2021-07-10;148584;339900;982;1;1;36435152;24660936;100251;165;38
FR;0;2021-07-11;60180;110122;283;0;0;36495332;24771058;100534;165;38
FR;0;2021-07-12;169109;478073;1759;4;0;36664441;25249131;102293;169;38
FR;0;2021-07-13;287120;527214;2045;8;1;36951561;25776345;104338;177;39
FR;0;2021-07-14;180951;157604;434;0;0;37132512;25933949;104772;177;39
FR;0;2021-07-15;346967;502242;2099;1;0;37479479;26436191;106871;178;39
FR;0;2021-07-16;379974;495676;2022;3;1;37859453;26931867;108893;181;40
FR;0;2021-07-17;259670;319731;876;1;0;38119123;27251598;109769;182;40
FR;0;2021-07-18;109676;114710;310;0;0;38228799;27366308;110079;182;40
FR;0;2021-07-19;285356;424715;1628;3;0;38514155;27791023;111707;185;40
FR;0;2021-07-20;376785;452130;1723;0;0;38890940;28243153;113430;185;40
FR;0;2021-07-21;395671;407616;1549;4;2;39286611;28650769;114979;189;42
FR;0;2021-07-22;440946;387913;1715;4;2;39727557;29038682;116694;193;44
FR;0;2021-07-23;440195;422915;1881;4;1;40167752;29461597;118575;197;45
FR;0;2021-07-24;285207;269522;804;1;0;40452959;29731119;119379;198;45
FR;0;2021-07-25;121066;80002;232;0;0;40574025;29811121;119611;198;45
FR;0;2021-07-26;347316;322911;1615;3;2;40921341;30134032;121226;201;47
FR;0;2021-07-27;463960;320036;1696;4;2;41385301;30454068;122922;205;49
FR;0;2021-07-28;459359;289774;1634;4;2;41844660;30743842;124556;209;51
FR;0;2021-07-29;489724;276685;1794;2;1;42334384;31020527;126350;211;52
FR;0;2021-07-30;461700;302730;1940;5;1;42796084;31323257;128290;216;53
FR;0;2021-07-31;285362;185085;914;1;0;43081446;31508342;129204;217;53
FR;0;2021-08-01;111970;49976;253;0;0;43193416;31558318;129457;217;53
FR;0;2021-08-02;341292;234478;1600;2;0;43534708;31792796;131057;219;53
FR;0;2021-08-03;398496;244855;1718;2;1;43933204;32037651;132775;221;54
FR;0;2021-08-04;384714;209964;1592;6;3;44317918;32247615;134367;227;57
FR;0;2021-08-05;366054;228750;1709;0;0;44683972;32476365;136076;227;57
FR;0;2021-08-06;359620;271588;1835;4;1;45043592;32747953;137911;231;58
FR;0;2021-08-07;213073;178372;755;4;3;45256665;32926325;138666;235;61
FR;0;2021-08-08;74149;63231;273;0;0;45330814;32989556;138939;235;61
FR;0;2021-08-09;258647;259275;1545;4;3;45589461;33248831;140484;239;64
FR;0;2021-08-10;306748;277743;1658;2;1;45896209;33526574;142142;241;65
FR;0;2021-08-11;279628;260014;1441;5;1;46175837;33786588;143583;246;66
FR;0;2021-08-12;271464;278490;1661;3;1;46447301;34065078;145244;249;67
FR;0;2021-08-13;252082;278016;1591;3;2;46699383;34343094;146835;252;69
FR;0;2021-08-14;145305;197256;739;0;0;46844688;34540350;147574;252;69
FR;0;2021-08-15;39334;50115;216;1;0;46884022;34590465;147790;253;69
FR;0;2021-08-16;186104;318002;1539;0;0;47070126;34908467;149329;253;69
FR;0;2021-08-17;215604;336372;1636;7;1;47285730;35244839;150965;260;70
FR;0;2021-08-18;198980;324683;1597;7;4;47484710;35569522;152562;267;74
FR;0;2021-08-19;191951;325691;1637;1;0;47676661;35895213;154199;268;74
FR;0;2021-08-20;186393;366430;1815;3;2;47863054;36261643;156014;271;76
FR;0;2021-08-21;104774;238127;704;0;0;47967828;36499770;156718;271;76
FR;0;2021-08-22;31900;87201;255;1;1;47999728;36586971;156973;272;77
FR;0;2021-08-23;140923;357195;1561;3;1;48140651;36944166;158534;275;78
FR;0;2021-08-24;162434;376851;1848;5;1;48303085;37321017;160382;280;79
FR;0;2021-08-25;151089;350864;2033;8;3;48454174;37671881;162415;288;82
FR;0;2021-08-26;142800;342867;2557;10;0;48596974;38014748;164972;298;82
FR;0;2021-08-27;148396;388286;2791;11;3;48745370;38403034;167763;309;85
FR;0;2021-08-28;90634;249594;1404;0;0;48836004;38652628;169167;309;85
FR;0;2021-08-29;27308;83356;518;1;0;48863312;38735984;169685;310;85
FR;0;2021-08-30;117347;324850;4709;6;5997;48980659;39060834;174394;316;6082
FR;0;2021-08-31;128732;334573;10184;19;11842;49109391;39395407;184578;335;17924
FR;0;2021-09-01;135917;285725;22425;7;24368;49245308;39681132;207003;342;42292
FR;0;2021-09-02;113471;247287;26512;20;28924;49358779;39928419;233515;362;71216
FR;0;2021-09-03;118243;292719;29963;24;33003;49477022;40221138;263478;386;104219
FR;0;2021-09-04;89864;217760;12584;12;14101;49566886;40438898;276062;398;118320
FR;0;2021-09-05;21351;44840;4394;2;4722;49588237;40483738;280456;400;123042
FR;0;2021-09-06;75383;180720;31948;16;34273;49663620;40664458;312404;416;157315
FR;0;2021-09-07;80220;181253;33239;43;36181;49743840;40845711;345643;459;193496
FR;0;2021-09-08;90611;206169;29658;28;32502;49834451;41051880;375301;487;225998
FR;0;2021-09-09;76823;165411;33051;27;36578;49911274;41217291;408352;514;262576
FR;0;2021-09-10;95857;203758;35728;27;40600;50007131;41421049;444080;541;303176
FR;0;2021-09-11;67035;169259;12136;20;14351;50074166;41590308;456216;561;317527
FR;0;2021-09-12;12816;32088;2773;1;3172;50086982;41622396;458989;562;320699
FR;0;2021-09-13;64486;126306;41218;34;44122;50151468;41748702;500207;596;364821
FR;0;2021-09-14;73402;129144;56354;79;62190;50224870;41877846;556561;675;427011
FR;0;2021-09-15;76543;167860;55644;58;54811;50301413;42045706;612205;733;481822
FR;0;2021-09-16;63795;114562;60050;84;60056;50365208;42160268;672255;817;541878
FR;0;2021-09-17;75015;156870;53838;71;57274;50440223;42317138;726093;888;599152
FR;0;2021-09-18;48206;139608;15600;25;17294;50488429;42456746;741693;913;616446
FR;0;2021-09-19;7873;23701;2436;1;2618;50496302;42480447;744129;914;619064
FR;0;2021-09-20;44495;93903;50068;72;50316;50540797;42574350;794197;986;669380
FR;0;2021-09-21;45846;98456;62745;76;63416;50586643;42672806;856942;1062;732796
FR;0;2021-09-22;48640;142360;55352;82;55380;50635283;42815166;912294;1144;788176
FR;0;2021-09-23;43218;92047;62373;94;63514;50678501;42907213;974667;1238;851690
FR;0;2021-09-24;52265;133347;54538;107;59143;50730766;43040560;1029205;1345;910833
FR;0;2021-09-25;35203;115595;16268;36;18276;50765969;43156155;1045473;1381;929109
FR;0;2021-09-26;5532;17806;2268;5;2330;50771501;43173961;1047741;1386;931439
FR;0;2021-09-27;33940;76947;47186;97;48147;50805441;43250908;1094927;1483;979586
FR;0;2021-09-28;36480;75283;54948;88;56509;50841921;43326191;1149875;1571;1036095
FR;0;2021-09-29;44360;100821;53333;112;54835;50886281;43427012;1203208;1683;1090930
FR;0;2021-09-30;36292;72909;57026;96;59525;50922573;43499921;1260234;1779;1150455
FR;0;2021-10-01;61647;101649;57793;108;63799;50984220;43601570;1318027;1887;1214254
FR;0;2021-10-02;39444;78408;20955;39;23333;51023664;43679978;1338982;1926;1237587
FR;0;2021-10-03;5282;10513;2528;4;2543;51028946;43690491;1341510;1930;1240130
FR;0;2021-10-04;35110;58544;52614;84;54787;51064056;43749035;1394124;2014;1294917
FR;0;2021-10-05;33809;64340;60991;135;64968;51097865;43813375;1455115;2149;1359885
FR;0;2021-10-06;42659;79325;65724;113;68294;51140524;43892700;1520839;2262;1428179
FR;0;2021-10-07;30496;62211;65405;90;68729;51171020;43954911;1586244;2352;1496908
FR;0;2021-10-08;49254;91857;77739;110;84679;51220274;44046768;1663983;2462;1581587
FR;0;2021-10-09;33643;60924;31534;35;33888;51253917;44107692;1695517;2497;1615475
FR;0;2021-10-10;4692;7449;3188;9;3486;51258609;44115141;1698705;2506;1618961
FR;0;2021-10-11;30676;49897;61032;105;64036;51289285;44165038;1759737;2611;1682997
FR;0;2021-10-12;31557;54442;70588;140;75889;51320842;44219480;1830325;2751;1758886
FR;0;2021-10-13;40076;62832;74412;136;79296;51360918;44282312;1904737;2887;1838182
FR;0;2021-10-14;30277;52886;68737;116;73783;51391195;44335198;1973474;3003;1911965
FR;0;2021-10-15;44811;75293;93225;191;102944;51436006;44410491;2066699;3194;2014909
FR;0;2021-10-16;31295;44104;36686;44;39618;51467301;44454595;2103385;3238;2054527
FR;0;2021-10-17;3834;5260;3592;2;3687;51471135;44459855;2106977;3240;2058214
FR;0;2021-10-18;28624;42455;67480;133;71357;51499759;44502310;2174457;3373;2129571
FR;0;2021-10-19;27135;45313;76391;140;81630;51526894;44547623;2250848;3513;2211201
FR;0;2021-10-20;35267;52491;96926;181;101506;51562161;44600114;2347774;3694;2312707
FR;0;2021-10-21;26027;45195;83939;112;89128;51588188;44645309;2431713;3806;2401835
FR;0;2021-10-22;38307;62451;104881;200;112545;51626495;44707760;2536594;4006;2514380
FR;0;2021-10-23;26991;41229;45448;57;48611;51653486;44748989;2582042;4063;2562991
FR;0;2021-10-24;2913;4795;3679;6;3936;51656399;44753784;2585721;4069;2566927
FR;0;2021-10-25;25995;36307;82319;144;86635;51682394;44790091;2668040;4213;2653562
FR;0;2021-10-26;23704;35061;87227;166;92328;51706098;44825152;2755267;4379;2745890
FR;0;2021-10-27;30062;46410;108987;257;114664;51736160;44871562;2864254;4636;2860554
FR;0;2021-10-28;23571;34969;88681;153;94436;51759731;44906531;2952935;4789;2954990
FR;0;2021-10-29;31553;51488;117301;204;125316;51791284;44958019;3070236;4993;3080306
FR;0;2021-10-30;20545;33218;50337;76;53369;51811829;44991237;3120573;5069;3133675
FR;0;2021-10-31;2485;3741;3587;3;3874;51814314;44994978;3124160;5072;3137549
FR;0;2021-11-01;8360;4845;3210;3;3569;51822674;44999823;3127370;5075;3141118
FR;0;2021-11-02;25596;40130;93557;156;99529;51848270;45039953;3220927;5231;3240647
FR;0;2021-11-03;30011;47985;118870;218;125833;51878281;45087938;3339797;5449;3366480
FR;0;2021-11-04;23754;37532;107533;217;114377;51902035;45125470;3447330;5666;3480857
FR;0;2021-11-05;32331;52973;141619;235;151319;51934366;45178443;3588949;5901;3632176
FR;0;2021-11-06;21507;34590;64859;123;68269;51955873;45213033;3653808;6024;3700445
FR;0;2021-11-07;2389;4202;5186;6;5590;51958262;45217235;3658994;6030;3706035
FR;0;2021-11-08;20565;37823;127178;227;134270;51978827;45255058;3786172;6257;3840305
FR;0;2021-11-09;22371;44809;161664;340;172212;52001198;45299867;3947836;6597;4012517
FR;0;2021-11-10;31530;55102;186973;446;198738;52032728;45354969;4134809;7043;4211255
FR;0;2021-11-11;4505;6748;12948;28;13938;52037233;45361717;4147757;7071;4225193
FR;0;2021-11-12;29049;55132;183748;253;197326;52066282;45416849;4331505;7324;4422519
FR;0;2021-11-13;20336;32696;80686;118;86302;52086618;45449545;4412191;7442;4508821
FR;0;2021-11-14;2346;3912;7167;6;7861;52088964;45453457;4419358;7448;4516682
FR;0;2021-11-15;20436;38746;160825;313;171532;52109400;45492203;4580183;7761;4688214
FR;0;2021-11-16;23558;44011;200371;391;214965;52132958;45536214;4780554;8152;4903179
FR;0;2021-11-17;30426;50430;199821;407;212846;52163384;45586644;4980375;8559;5116025
FR;0;2021-11-18;23402;45247;191636;469;205506;52186786;45631891;5172011;9028;5321531
FR;0;2021-11-19;33595;61391;243178;549;262128;52220381;45693282;5415189;9577;5583659
FR;0;2021-11-20;25393;36749;102137;206;109689;52245774;45730031;5517326;9783;5693348
FR;0;2021-11-21;2631;4532;9646;19;10631;52248405;45734563;5526972;9802;5703979
FR;0;2021-11-22;22767;33342;180334;470;194811;52271172;45767905;5707306;10272;5898790
FR;0;2021-11-23;25607;45659;229343;548;247775;52296779;45813564;5936649;10820;6146565
FR;0;2021-11-24;31786;53826;224771;717;243192;52328565;45867390;6161420;11537;6389757
FR;0;2021-11-25;25472;49203;255888;739;277696;52354037;45916593;6417308;12276;6667453
FR;0;2021-11-26;33223;74933;379435;864;414572;52387260;45991526;6796743;13140;7082025
FR;0;2021-11-27;23390;49723;214880;389;236625;52410650;46041249;7011623;13529;7318650
FR;0;2021-11-28;3501;10558;56742;66;63330;52414151;46051807;7068365;13595;7381980
FR;0;2021-11-29;19398;54227;341431;863;371657;52433549;46106034;7409796;14458;7753637
FR;0;2021-11-30;24740;72142;457341;988;500730;52458289;46178176;7867137;15446;8254367
FR;0;2021-12-01;27208;75921;469050;1158;511284;52485497;46254097;8336187;16604;8765651
FR;0;2021-12-02;22064;71903;527057;1280;574806;52507561;46326000;8863244;17884;9340457
FR;0;2021-12-03;25524;92718;596314;1419;651107;52533085;46418718;9459558;19303;9991564
FR;0;2021-12-04;18306;60560;336194;691;369743;52551391;46479278;9795752;19994;10361307
FR;0;2021-12-05;4149;16232;95765;157;107056;52555540;46495510;9891517;20151;10468363
FR;0;2021-12-06;26623;73098;493092;1174;539880;52582163;46568608;10384609;21325;11008243
FR;0;2021-12-07;23477;91714;645320;1772;706281;52605640;46660322;11029929;23097;11714524
FR;0;2021-12-08;25438;92408;591518;1874;647447;52631078;46752730;11621447;24971;12361971
FR;0;2021-12-09;24030;94315;663042;2180;726322;52655108;46847045;12284489;27151;13088293
FR;0;2021-12-10;27997;111280;736005;2075;806112;52683105;46958325;13020494;29226;13894405
FR;0;2021-12-11;20242;76148;435153;987;480361;52703347;47034473;13455647;30213;14374766
FR;0;2021-12-12;5628;23273;142280;262;159212;52708975;47057746;13597927;30475;14533978
FR;0;2021-12-13;21325;91235;587577;1698;649223;52730300;47148981;14185504;32173;15183201
FR;0;2021-12-14;27846;118726;765463;2653;847455;52758146;47267707;14950967;34826;16030656
FR;0;2021-12-15;28379;114567;694257;2265;769010;52786525;47382274;15645224;37091;16799666
FR;0;2021-12-16;28001;116087;763964;2558;844363;52814526;47498361;16409188;39649;17644029
FR;0;2021-12-17;31594;128851;807803;2709;892029;52846120;47627212;17216991;42358;18536058
FR;0;2021-12-18;24923;81765;469935;1178;522190;52871043;47708977;17686926;43536;19058248
FR;0;2021-12-19;8753;28799;169369;376;191113;52879796;47737776;17856295;43912;19249361
FR;0;2021-12-20;31706;97587;591409;1786;658697;52911502;47835363;18447704;45698;19908058
FR;0;2021-12-21;39328;112388;682350;2390;759522;52950830;47947751;19130054;48088;20667580
FR;0;2021-12-22;39497;99696;575704;2167;642130;52990327;48047447;19705758;50255;21309710
FR;0;2021-12-23;33767;79801;440945;1653;494368;53024094;48127248;20146703;51908;21804078
FR;0;2021-12-24;10678;26171;111000;398;126660;53034772;48153419;20257703;52306;21930738
FR;0;2021-12-25;771;3540;7583;25;9035;53035543;48156959;20265286;52331;21939773
FR;0;2021-12-26;4698;11891;52083;141;60125;53040241;48168850;20317369;52472;21999898
FR;0;2021-12-27;30430;84124;453506;1365;509136;53070671;48252974;20770875;53837;22509034
FR;0;2021-12-28;38331;99125;564116;1769;632211;53109002;48352099;21334991;55606;23141245
FR;0;2021-12-29;39859;88508;501152;1686;560970;53148861;48440607;21836143;57292;23702215
FR;0;2021-12-30;35908;75332;420991;1519;471131;53184769;48515939;22257134;58811;24173346
FR;0;2021-12-31;12041;25194;116850;406;131646;53196810;48541133;22373984;59217;24304992
FR;0;2022-01-01;1459;3217;8506;37;9939;53198269;48544350;22382490;59254;24314931
FR;0;2022-01-02;6091;12999;58409;125;66942;53204360;48557349;22440899;59379;24381873
FR;0;2022-01-03;35087;90235;494769;1593;551617;53239447;48647584;22935668;60972;24933490
FR;0;2022-01-04;41436;111035;641320;2305;714284;53280883;48758619;23576988;63277;25647774
FR;0;2022-01-05;60670;103545;569089;1984;634098;53341553;48862164;24146077;65261;26281872
FR;0;2022-01-06;44193;110354;638922;2695;711399;53385746;48972518;24784999;67956;26993271
FR;0;2022-01-07;50776;123356;710945;2807;790424;53436522;49095874;25495944;70763;27783695
FR;0;2022-01-08;44989;80352;423795;1211;472864;53481511;49176226;25919739;71974;28256559
FR;0;2022-01-09;15597;26666;128553;300;145680;53497108;49202892;26048292;72274;28402239
FR;0;2022-01-10;35292;92823;469242;1810;522669;53532400;49295715;26517534;74084;28924908
FR;0;2022-01-11;41777;100565;548176;2307;608445;53574177;49396280;27065710;76391;29533353
FR;0;2022-01-12;60296;95747;452612;1966;504284;53634473;49492027;27518322;78357;30037637
FR;0;2022-01-13;38157;92467;487302;2084;540986;53672630;49584494;28005624;80441;30578623
FR;0;2022-01-14;42539;103381;568521;2286;628979;53715169;49687875;28574145;82727;31207602
FR;0;2022-01-15;39371;65890;340113;985;377563;53754540;49753765;28914258;83712;31585165
FR;0;2022-01-16;11387;19261;87402;216;99432;53765927;49773026;29001660;83928;31684597
FR;0;2022-01-17;24699;60138;320241;1381;354161;53790626;49833164;29321901;85309;32038758
FR;0;2022-01-18;28225;68687;361026;1799;397525;53818851;49901851;29682927;87108;32436283
FR;0;2022-01-19;43172;67116;281242;1451;311065;53862023;49968967;29964169;88559;32747348
FR;0;2022-01-20;23578;59624;298947;1740;328469;53885601;50028591;30263116;90299;33075817
FR;0;2022-01-21;28172;68817;366316;2087;401149;53913773;50097408;30629432;92386;33476966
FR;0;2022-01-22;27616;47995;218773;839;241754;53941389;50145403;30848205;93225;33718720
FR;0;2022-01-23;6708;13020;48661;172;55177;53948097;50158423;30896866;93397;33773897
FR;0;2022-01-24;16254;47484;217264;1138;239317;53964351;50205907;31114130;94535;34013214
FR;0;2022-01-25;18983;54428;243001;1547;267056;53983334;50260335;31357131;96082;34280270
FR;0;2022-01-26;28138;60365;209244;1297;229407;54011472;50320700;31566375;97379;34509677
FR;0;2022-01-27;16311;46180;207608;1273;225871;54027783;50366880;31773983;98652;34735548
FR;0;2022-01-28;21558;77313;290009;1573;321437;54049341;50444193;32063992;100225;35056985
FR;0;2022-01-29;18409;52841;184102;686;204575;54067750;50497034;32248094;100911;35261560
FR;0;2022-01-30;4468;14515;39131;124;45087;54072218;50511549;32287225;101035;35306647
FR;0;2022-01-31;11241;43842;148173;739;164781;54083459;50555391;32435398;101774;35471428
FR;0;2022-02-01;13324;48304;174088;1141;191390;54096783;50603695;32609486;102915;35662818
FR;0;2022-02-02;20338;66204;171504;1033;190155;54117121;50669899;32780990;103948;35852973
FR;0;2022-02-03;11324;44424;157520;986;173313;54128445;50714323;32938510;104934;36026286
FR;0;2022-02-04;14596;66527;239211;1265;264173;54143041;50780850;33177721;106199;36290459
FR;0;2022-02-05;12886;51498;153529;523;172342;54155927;50832348;33331250;106722;36462801
FR;0;2022-02-06;2712;12208;28877;101;33827;54158639;50844556;33360127;106823;36496628
FR;0;2022-02-07;9500;46749;156842;586;176322;54168139;50891305;33516969;107409;36672950
FR;0;2022-02-08;9678;42933;166576;867;184359;54177817;50934238;33683545;108276;36857309
FR;0;2022-02-09;14260;58114;172319;869;193014;54192077;50992352;33855864;109145;37050323
FR;0;2022-02-10;8415;38701;150192;877;166657;54200492;51031053;34006056;110022;37216980
FR;0;2022-02-11;10833;55594;218455;1100;243040;54211325;51086647;34224511;111122;37460020
FR;0;2022-02-12;8365;40916;134701;461;151722;54219690;51127563;34359212;111583;37611742
FR;0;2022-02-13;1898;8591;26555;85;30913;54221588;51136154;34385767;111668;37642655
FR;0;2022-02-14;6954;35188;148339;482;166335;54228542;51171342;34534106;112150;37808990
FR;0;2022-02-15;6923;35850;146937;751;162508;54235465;51207192;34681043;112901;37971498
FR;0;2022-02-16;9338;42849;132506;719;146719;54244803;51250041;34813549;113620;38118217
FR;0;2022-02-17;5457;24201;87267;585;94831;54250260;51274242;34900816;114205;38213048
FR;0;2022-02-18;6952;33506;119615;804;129285;54257212;51307748;35020431;115009;38342333
FR;0;2022-02-19;5360;24527;70017;370;77322;54262572;51332275;35090448;115379;38419655
FR;0;2022-02-20;1145;4640;12157;38;13931;54263717;51336915;35102605;115417;38433586
FR;0;2022-02-21;4045;17861;61931;351;67158;54267762;51354776;35164536;115768;38500744
FR;0;2022-02-22;4392;18571;60800;575;64434;54272154;51373347;35225336;116343;38565178
FR;0;2022-02-23;6531;27294;66478;591;71878;54278685;51400641;35291814;116934;38637056
FR;0;2022-02-24;3768;15425;50397;517;53219;54282453;51416066;35342211;117451;38690275
FR;0;2022-02-25;5235;23893;76312;803;80037;54287688;51439959;35418523;118254;38770312
FR;0;2022-02-26;3979;17758;47397;358;51462;54291667;51457717;35465920;118612;38821774
FR;0;2022-02-27;875;3000;8025;47;8936;54292542;51460717;35473945;118659;38830710
FR;0;2022-02-28;3086;12491;40462;356;42896;54295628;51473208;35514407;119015;38873606
FR;0;2022-03-01;3623;12419;44161;435;44811;54299251;51485627;35558568;119450;38918417
FR;0;2022-03-02;5206;17666;47109;441;49033;54304457;51503293;35605677;119891;38967450
FR;0;2022-03-03;2731;9231;29859;366;29974;54307188;51512524;35635536;120257;38997424
FR;0;2022-03-04;3201;12328;40280;663;39425;54310389;51524852;35675816;120920;39036849
FR;0;2022-03-05;3062;9247;24941;310;25098;54313451;51534099;35700757;121230;39061947
FR;0;2022-03-06;514;1391;3194;43;3435;54313965;51535490;35703951;121273;39065382
FR;0;2022-03-07;2190;5548;18413;315;17678;54316155;51541038;35722364;121588;39083060
FR;0;2022-03-08;2033;5986;19420;359;17883;54318188;51547024;35741784;121947;39100943
FR;0;2022-03-09;3500;10402;22167;405;21254;54321688;51557426;35763951;122352;39122197
FR;0;2022-03-10;1733;5493;16962;342;15782;54323421;51562919;35780913;122694;39137979
FR;0;2022-03-11;2357;7506;24483;539;22246;54325778;51570425;35805396;123233;39160225
FR;0;2022-03-12;2657;6763;17153;306;16508;54328435;51577188;35822549;123539;39176733
FR;0;2022-03-13;390;785;2315;146;2266;54328825;51577973;35824864;123685;39178999
FR;0;2022-03-14;1487;4222;14955;4406;13810;54330312;51582195;35839819;128091;39192809
FR;0;2022-03-15;1623;4558;16326;7551;14440;54331935;51586753;35856145;135642;39207249
FR;0;2022-03-16;2972;7192;19398;13128;18065;54334907;51593945;35875543;148770;39225314
FR;0;2022-03-17;1395;3833;13118;10841;11961;54336302;51597778;35888661;159611;39237275
FR;0;2022-03-18;2222;5637;19966;18283;18056;54338524;51603415;35908627;177894;39255331
FR;0;2022-03-19;2287;4768;13109;9397;12411;54340811;51608183;35921736;187291;39267742
FR;0;2022-03-20;296;717;1915;1071;1926;54341107;51608900;35923651;188362;39269668
FR;0;2022-03-21;1351;3160;12706;14933;11926;54342458;51612060;35936357;203295;39281594
FR;0;2022-03-22;1468;3635;13774;20522;12531;54343926;51615695;35950131;223817;39294125
FR;0;2022-03-23;2651;6158;17689;23139;17202;54346577;51621853;35967820;246956;39311327
FR;0;2022-03-24;1365;2977;11570;17579;10640;54347942;51624830;35979390;264535;39321967
FR;0;2022-03-25;2053;4885;18523;27750;16856;54349995;51629715;35997913;292285;39338823
FR;0;2022-03-26;2220;4381;12067;12664;11508;54352215;51634096;36009980;304949;39350331
FR;0;2022-03-27;355;685;1893;1479;1926;54352570;51634781;36011873;306428;39352257
FR;0;2022-03-28;1420;3034;11104;17466;10596;54353990;51637815;36022977;323894;39362853
FR;0;2022-03-29;1429;3249;12892;27546;12033;54355419;51641064;36035869;351440;39374886
FR;0;2022-03-30;2829;5402;15655;27363;15051;54358248;51646466;36051524;378803;39389937
FR;0;2022-03-31;1606;3290;12954;24944;12287;54359854;51649756;36064478;403747;39402224
FR;0;2022-04-01;2410;4524;20023;30843;18651;54362264;51654280;36084501;434590;39420875
FR;0;2022-04-02;1511;2619;9042;10108;8701;54363775;51656899;36093543;444698;39429576
FR;0;2022-04-03;284;502;1559;1166;1574;54364059;51657401;36095102;445864;39431150
FR;0;2022-04-04;1631;2693;12315;19074;11503;54365690;51660094;36107417;464938;39442653
FR;0;2022-04-05;1678;3018;14302;34023;13152;54367368;51663112;36121719;498961;39455805
FR;0;2022-04-06;2063;3748;13503;26385;12763;54369431;51666860;36135222;525346;39468568
FR;0;2022-04-07;1450;2975;13629;33704;12838;54370881;51669835;36148851;559050;39481406
FR;0;2022-04-08;2031;4136;19171;43783;17781;54372912;51673971;36168022;602833;39499187
FR;0;2022-04-09;1357;2661;9299;13547;8850;54374269;51676632;36177321;616380;39508037
FR;0;2022-04-10;283;582;1976;1995;1994;54374552;51677214;36179297;618375;39510031
FR;0;2022-04-11;1204;2499;11840;23734;11439;54375756;51679713;36191137;642109;39521470
FR;0;2022-04-12;1600;2820;13953;40698;13333;54377356;51682533;36205090;682807;39534803
FR;0;2022-04-13;1877;3501;13366;32985;12975;54379233;51686034;36218456;715792;39547778
FR;0;2022-04-14;1448;2751;13127;36122;12977;54380681;51688785;36231583;751914;39560755
FR;0;2022-04-15;1813;3378;15570;35439;14829;54382494;51692163;36247153;787353;39575584
FR;0;2022-04-16;1034;1812;6379;8522;6230;54383528;51693975;36253532;795875;39581814
FR;0;2022-04-17;187;318;991;1169;1030;54383715;51694293;36254523;797044;39582844
FR;0;2022-04-18;160;472;2757;1066;2775;54383875;51694765;36257280;798110;39585619
FR;0;2022-04-19;1494;2948;12879;29482;12398;54385369;51697713;36270159;827592;39598017
FR;0;2022-04-20;1938;3380;13259;28941;12927;54387307;51701093;36283418;856533;39610944
FR;0;2022-04-21;1484;2769;12485;34939;12500;54388791;51703862;36295903;891472;39623444
FR;0;2022-04-22;1836;3541;16433;37495;15801;54390627;51707403;36312336;928967;39639245
FR;0;2022-04-23;1136;2042;7371;10649;7222;54391763;51709445;36319707;939616;39646467
FR;0;2022-04-24;248;446;1474;1586;1408;54392011;51709891;36321181;941202;39647875
FR;0;2022-04-25;1265;2465;10668;20925;10469;54393276;51712356;36331849;962127;39658344
FR;0;2022-04-26;1577;2963;13635;38498;13079;54394853;51715319;36345484;1000625;39671423
FR;0;2022-04-27;1927;3021;11496;30864;11556;54396780;51718340;36356980;1031489;39682979
FR;0;2022-04-28;1537;2668;12493;35952;12220;54398317;51721008;36369473;1067441;39695199
FR;0;2022-04-29;1976;3698;15521;37080;14870;54400293;51724706;36384994;1104521;39710069
FR;0;2022-04-30;1199;1808;6909;9691;6738;54401492;51726514;36391903;1114212;39716807
FR;0;2022-05-01;206;314;900;994;897;54401698;51726828;36392803;1115206;39717704
FR;0;2022-05-02;1240;2548;11085;18028;10875;54402938;51729376;36403888;1133234;39728579
FR;0;2022-05-03;1797;3122;13643;34476;13484;54404735;51732498;36417531;1167710;39742063
FR;0;2022-05-04;1835;3127;12118;25492;12233;54406570;51735625;36429649;1193202;39754296
FR;0;2022-05-05;1641;2728;12888;33248;12698;54408211;51738353;36442537;1226450;39766994
FR;0;2022-05-06;2082;3558;15283;36585;14767;54410293;51741911;36457820;1263035;39781761
FR;0;2022-05-07;1188;1762;6442;9593;6429;54411481;51743673;36464262;1272628;39788190
FR;0;2022-05-08;259;393;1168;1531;1227;54411740;51744066;36465430;1274159;39789417
FR;0;2022-05-09;1269;2173;9888;20124;9756;54413009;51746239;36475318;1294283;39799173
FR;0;2022-05-10;1673;2919;13450;38701;12990;54414682;51749158;36488768;1332984;39812163
FR;0;2022-05-11;1944;2772;10678;27751;10582;54416626;51751930;36499446;1360735;39822745
FR;0;2022-05-12;1532;2548;11261;35415;10935;54418158;51754478;36510707;1396150;39833680
FR;0;2022-05-13;1947;3124;13715;37684;13291;54420105;51757602;36524422;1433834;39846971
FR;0;2022-05-14;1135;1596;5924;10754;5778;54421240;51759198;36530346;1444588;39852749
FR;0;2022-05-15;273;435;1266;1432;1339;54421513;51759633;36531612;1446020;39854088
FR;0;2022-05-16;1167;1945;8635;20883;8618;54422680;51761578;36540247;1466903;39862706
FR;0;2022-05-17;1543;2499;11774;37645;11346;54424223;51764077;36552021;1504548;39874052
FR;0;2022-05-18;1767;2540;9630;26989;9610;54425990;51766617;36561651;1531537;39883662
FR;0;2022-05-19;1401;2548;10508;35555;10613;54427391;51769165;36572159;1567092;39894275
FR;0;2022-05-20;1846;3024;13263;39227;12757;54429237;51772189;36585422;1606319;39907032
FR;0;2022-05-21;1145;1684;5645;9890;5517;54430382;51773873;36591067;1616209;39912549
FR;0;2022-05-22;236;330;1019;1426;1007;54430618;51774203;36592086;1617635;39913556
FR;0;2022-05-23;1143;2006;8852;20239;8763;54431761;51776209;36600938;1637874;39922319
FR;0;2022-05-24;1508;2697;11296;38568;11152;54433269;51778906;36612234;1676442;39933471
FR;0;2022-05-25;1788;2747;9299;24708;9410;54435057;51781653;36621533;1701150;39942881
FR;0;2022-05-26;189;334;1634;1140;1637;54435246;51781987;36623167;1702290;39944518
FR;0;2022-05-27;1352;2382;9207;21221;8950;54436598;51784369;36632374;1723511;39953468
FR;0;2022-05-28;660;1241;3903;6773;3953;54437258;51785610;36636277;1730284;39957421
FR;0;2022-05-29;148;308;745;912;762;54437406;51785918;36637022;1731196;39958183
FR;0;2022-05-30;995;1910;6961;19206;6971;54438401;51787828;36643983;1750402;39965154
FR;0;2022-05-31;1468;2402;9760;35484;9592;54439869;51790230;36653743;1785886;39974746
FR;0;2022-06-01;1598;2764;10903;24294;10754;54441467;51792994;36664646;1810180;39985500
FR;0;2022-06-02;1414;2498;11175;35361;10715;54442881;51795492;36675821;1845541;39996215
FR;0;2022-06-03;1618;2990;13266;38639;12639;54444499;51798482;36689087;1884180;40008854
FR;0;2022-06-04;929;1499;4966;9061;5036;54445428;51799981;36694053;1893241;40013890
FR;0;2022-06-05;166;321;868;1101;877;54445594;51800302;36694921;1894342;40014767
FR;0;2022-06-06;181;377;2045;1234;2017;54445775;51800679;36696966;1895576;40016784
FR;0;2022-06-07;1336;2570;9759;35492;9344;54447111;51803249;36706725;1931068;40026128
FR;0;2022-06-08;1511;2596;9047;28632;8884;54448622;51805845;36715772;1959700;40035012
FR;0;2022-06-09;1250;2362;10451;39264;10072;54449872;51808207;36726223;1998964;40045084
FR;0;2022-06-10;1571;2832;12693;44634;12252;54451443;51811039;36738916;2043598;40057336
FR;0;2022-06-11;933;1710;5409;11598;5437;54452376;51812749;36744325;2055196;40062773
FR;0;2022-06-12;185;422;1059;1753;1121;54452561;51813171;36745384;2056949;40063894
FR;0;2022-06-13;1037;1930;7289;23098;7117;54453598;51815101;36752673;2080047;40071011
FR;0;2022-06-14;1273;2407;10315;44748;9675;54454871;51817508;36762988;2124795;40080686
FR;0;2022-06-15;1434;2289;8859;30668;8514;54456305;51819797;36771847;2155463;40089200
FR;0;2022-06-16;1134;1948;9639;39697;9042;54457439;51821745;36781486;2195160;40098242
FR;0;2022-06-17;1432;2761;12099;46483;11526;54458871;51824506;36793585;2241643;40109768
FR;0;2022-06-18;825;1486;4538;11102;4469;54459696;51825992;36798123;2252745;40114237
FR;0;2022-06-19;170;346;1045;1608;1114;54459866;51826338;36799168;2254353;40115351
FR;0;2022-06-20;975;1840;8450;25890;8124;54460841;51828178;36807618;2280243;40123475
FR;0;2022-06-21;1273;2329;10197;49729;9234;54462114;51830507;36817815;2329972;40132709
FR;0;2022-06-22;1337;2397;8716;38815;8180;54463451;51832904;36826531;2368787;40140889
FR;0;2022-06-23;1189;2255;10437;54856;9625;54464640;51835159;36836968;2423643;40150514
FR;0;2022-06-24;1439;2899;13424;68889;12087;54466079;51838058;36850392;2492532;40162601
FR;0;2022-06-25;909;1748;6154;19873;5915;54466988;51839806;36856546;2512405;40168516
FR;0;2022-06-26;222;441;1817;3676;1689;54467210;51840247;36858363;2516081;40170205
FR;0;2022-06-27;1083;1944;9604;48213;8799;54468293;51842191;36867967;2564294;40179004
FR;0;2022-06-28;1427;2729;14337;90939;12780;54469720;51844920;36882304;2655233;40191784
FR;0;2022-06-29;1661;2778;12046;71379;11000;54471381;51847698;36894350;2726612;40202784
FR;0;2022-06-30;1475;2538;13911;94758;12054;54472856;51850236;36908261;2821370;40214838
FR;0;2022-07-01;1838;3192;17197;115290;14789;54474694;51853428;36925458;2936660;40229627
FR;0;2022-07-02;1031;1794;7861;35551;7062;54475725;51855222;36933319;2972211;40236689
FR;0;2022-07-03;288;504;2045;6369;1841;54476013;51855726;36935364;2978580;40238530
FR;0;2022-07-04;1434;2452;12969;78788;11279;54477447;51858178;36948333;3057368;40249809
FR;0;2022-07-05;1638;2915;17586;132029;14786;54479085;51861093;36965919;3189397;40264595
FR;0;2022-07-06;1753;2583;14642;98361;12436;54480838;51863676;36980561;3287758;40277031
FR;0;2022-07-07;1623;2717;16944;124504;13779;54482461;51866393;36997505;3412262;40290810
FR;0;2022-07-08;1782;2995;19477;135291;15543;54484243;51869388;37016982;3547553;40306353
FR;0;2022-07-09;842;1389;7417;37321;6378;54485085;51870777;37024399;3584874;40312731
FR;0;2022-07-10;233;454;2219;6764;2004;54485318;51871231;37026618;3591638;40314735
FR;0;2022-07-11;1315;2225;13911;86456;11551;54486633;51873456;37040529;3678094;40326286
FR;0;2022-07-12;1596;2803;19053;138120;15337;54488229;51876259;37059582;3816214;40341623
