fra;vaccin;jour;n_dose1;n_dose2;n_dose3;n_dose4;n_rappel;n_cum_dose1;n_cum_dose2;n_cum_dose3;n_cum_dose4;n_cum_rappel
FR;1;2020-12-27;594;0;0;0;0;594;0;0;0;0
FR;1;2020-12-28;649;0;0;0;0;1243;0;0;0;0
FR;1;2020-12-29;368;0;0;0;0;1611;0;0;0;0
FR;1;2020-12-30;433;0;0;0;0;2044;0;0;0;0
FR;1;2020-12-31;360;0;0;0;0;2404;0;0;0;0
FR;1;2021-01-01;1108;0;0;0;0;3512;0;0;0;0
FR;1;2021-01-02;348;1;0;0;0;3860;1;0;0;0
FR;1;2021-01-03;394;0;0;0;0;4254;1;0;0;0
FR;1;2021-01-04;2074;0;0;0;0;6328;1;0;0;0
FR;1;2021-01-05;6820;2;0;0;0;13148;3;0;0;0
FR;1;2021-01-06;12276;4;0;0;0;25424;7;0;0;0
FR;1;2021-01-07;29429;3;0;0;0;54853;10;0;0;0
FR;1;2021-01-08;37106;2;0;0;0;91959;12;0;0;0
FR;1;2021-01-09;11206;2;0;0;0;103165;14;0;0;0
FR;1;2021-01-10;5987;0;0;0;0;109152;14;0;0;0
FR;1;2021-01-11;39912;7;0;0;0;149064;21;0;0;0
FR;1;2021-01-12;62095;6;0;0;0;211159;27;0;0;0
FR;1;2021-01-13;65038;16;0;0;0;276197;43;0;0;0
FR;1;2021-01-14;81421;23;0;0;0;357618;66;0;0;0
FR;1;2021-01-15;68577;7;0;0;0;426195;73;0;0;0
FR;1;2021-01-16;19891;75;0;0;0;446086;148;0;0;0
FR;1;2021-01-17;10895;45;0;0;0;456981;193;0;0;0
FR;1;2021-01-18;82737;168;0;0;0;539718;361;0;0;0
FR;1;2021-01-19;125881;143;0;0;0;665599;504;0;0;0
FR;1;2021-01-20;132355;167;0;0;0;797954;671;0;0;0
FR;1;2021-01-21;153015;143;0;0;0;950969;814;0;0;0
FR;1;2021-01-22;115904;177;0;0;0;1066873;991;0;0;0
FR;1;2021-01-23;36591;56;0;0;0;1103464;1047;0;0;0
FR;1;2021-01-24;9577;48;0;0;0;1113041;1095;0;0;0
FR;1;2021-01-25;74393;1228;0;0;0;1187434;2323;0;0;0
FR;1;2021-01-26;96419;3151;1;0;0;1283853;5474;1;0;0
FR;1;2021-01-27;103612;5714;0;0;0;1387465;11188;1;0;0
FR;1;2021-01-28;120564;14437;0;0;0;1508029;25625;1;0;0
FR;1;2021-01-29;88859;17366;0;0;0;1596888;42991;1;0;0
FR;1;2021-01-30;27970;4223;0;0;0;1624858;47214;1;0;0
FR;1;2021-01-31;5174;1710;0;0;0;1630032;48924;1;0;0
FR;1;2021-02-01;49686;21096;0;0;0;1679718;70020;1;0;0
FR;1;2021-02-02;67772;34651;0;0;0;1747490;104671;1;0;0
FR;1;2021-02-03;67038;37105;0;0;0;1814528;141776;1;0;0
FR;1;2021-02-04;77087;50212;0;0;0;1891615;191988;1;0;0
FR;1;2021-02-05;63394;45430;0;0;0;1955009;237418;1;0;0
FR;1;2021-02-06;19391;10493;0;0;0;1974400;247911;1;0;0
FR;1;2021-02-07;3652;5051;0;0;0;1978052;252962;1;0;0
FR;1;2021-02-08;36474;46138;0;0;0;2014526;299100;1;0;0
FR;1;2021-02-09;50776;72581;0;0;0;2065302;371681;1;0;0
FR;1;2021-02-10;52020;76816;0;0;0;2117322;448497;1;0;0
FR;1;2021-02-11;63332;99039;0;0;0;2180654;547536;1;0;0
FR;1;2021-02-12;55825;74086;0;0;0;2236479;621622;1;0;0
FR;1;2021-02-13;15444;19317;0;0;0;2251923;640939;1;0;0
FR;1;2021-02-14;3739;7250;0;0;0;2255662;648189;1;0;0
FR;1;2021-02-15;24121;73556;0;0;0;2279783;721745;1;0;0
FR;1;2021-02-16;32744;96741;0;0;0;2312527;818486;1;0;0
FR;1;2021-02-17;35077;98781;1;0;0;2347604;917267;2;0;0
FR;1;2021-02-18;49392;113588;0;0;0;2396996;1030855;2;0;0
FR;1;2021-02-19;45351;86397;1;0;0;2442347;1117252;3;0;0
FR;1;2021-02-20;13374;26967;0;0;0;2455721;1144219;3;0;0
FR;1;2021-02-21;2448;6304;0;0;0;2458169;1150523;3;0;0
FR;1;2021-02-22;24694;69477;2;0;0;2482863;1220000;5;0;0
FR;1;2021-02-23;37405;80436;1;0;0;2520268;1300436;6;0;0
FR;1;2021-02-24;40652;77682;1;0;0;2560920;1378118;7;0;0
FR;1;2021-02-25;50122;87806;1;0;0;2611042;1465924;8;0;0
FR;1;2021-02-26;47169;67817;0;0;0;2658211;1533741;8;0;0
FR;1;2021-02-27;15664;20971;0;0;0;2673875;1554712;8;0;0
FR;1;2021-02-28;3550;4392;1;0;0;2677425;1559104;9;0;0
FR;1;2021-03-01;40119;49120;1;0;0;2717544;1608224;10;0;0
FR;1;2021-03-02;55931;61538;2;0;0;2773475;1669762;12;0;0
FR;1;2021-03-03;61165;60520;0;0;0;2834640;1730282;12;0;0
FR;1;2021-03-04;72948;65072;3;0;0;2907588;1795354;15;0;0
FR;1;2021-03-05;74714;59123;3;0;0;2982302;1854477;18;0;0
FR;1;2021-03-06;82421;16059;2;0;0;3064723;1870536;20;0;0
FR;1;2021-03-07;63696;5331;1;0;0;3128419;1875867;21;0;0
FR;1;2021-03-08;60129;42375;2;0;0;3188548;1918242;23;0;0
FR;1;2021-03-09;85932;48177;1;0;0;3274480;1966419;24;0;0
FR;1;2021-03-10;90831;48012;5;0;0;3365311;2014431;29;0;0
FR;1;2021-03-11;104988;53838;1;0;0;3470299;2068269;30;0;0
FR;1;2021-03-12;104064;45147;0;0;0;3574363;2113416;30;0;0
FR;1;2021-03-13;89165;12710;1;0;0;3663528;2126126;31;0;0
FR;1;2021-03-14;44433;3011;1;0;0;3707961;2129137;32;0;0
FR;1;2021-03-15;95448;29038;3;0;0;3803409;2158175;35;0;0
FR;1;2021-03-16;123556;34832;4;0;0;3926965;2193007;39;0;0
FR;1;2021-03-17;129241;34706;4;0;0;4056206;2227713;43;0;0
FR;1;2021-03-18;142821;39657;5;0;0;4199027;2267370;48;0;0
FR;1;2021-03-19;136195;32805;2;0;0;4335222;2300175;50;0;0
FR;1;2021-03-20;75965;10141;1;0;0;4411187;2310316;51;0;0
FR;1;2021-03-21;26469;2456;1;0;0;4437656;2312772;52;0;0
FR;1;2021-03-22;114653;31088;2;0;0;4552309;2343860;54;0;0
FR;1;2021-03-23;142956;38155;1;0;0;4695265;2382015;55;0;0
FR;1;2021-03-24;141934;38760;0;0;0;4837199;2420775;55;0;0
FR;1;2021-03-25;164949;39541;4;0;0;5002148;2460316;59;0;0
FR;1;2021-03-26;166344;37449;4;0;0;5168492;2497765;63;0;0
FR;1;2021-03-27;110854;15250;1;0;0;5279346;2513015;64;0;0
FR;1;2021-03-28;42282;3711;3;0;0;5321628;2516726;67;0;0
FR;1;2021-03-29;129776;49855;4;0;0;5451404;2566581;71;0;0
FR;1;2021-03-30;167638;63480;4;0;0;5619042;2630061;75;0;0
FR;1;2021-03-31;170860;66905;4;0;0;5789902;2696966;79;0;0
FR;1;2021-04-01;194653;79423;11;0;0;5984555;2776389;90;0;0
FR;1;2021-04-02;164387;84329;7;0;0;6148942;2860718;97;0;0
FR;1;2021-04-03;88210;58089;5;0;0;6237152;2918807;102;0;0
FR;1;2021-04-04;33432;17732;0;0;0;6270584;2936539;102;0;0
FR;1;2021-04-05;46353;10126;11;0;0;6316937;2946665;113;0;0
FR;1;2021-04-06;160203;101011;16;0;0;6477140;3047676;129;0;0
FR;1;2021-04-07;196891;108060;16;0;0;6674031;3155736;145;0;0
FR;1;2021-04-08;221976;112308;13;0;0;6896007;3268044;158;0;0
FR;1;2021-04-09;214477;107370;21;0;0;7110484;3375414;179;0;0
FR;1;2021-04-10;117128;73345;14;0;0;7227612;3448759;193;0;0
FR;1;2021-04-11;40803;30238;6;0;0;7268415;3478997;199;0;0
FR;1;2021-04-12;168316;103686;45;0;0;7436731;3582683;244;0;0
FR;1;2021-04-13;203699;128006;96;1;0;7640430;3710689;340;1;0
FR;1;2021-04-14;208488;122647;203;0;0;7848918;3833336;543;1;0
FR;1;2021-04-15;221555;126650;311;0;0;8070473;3959986;854;1;0
FR;1;2021-04-16;205966;124999;307;0;0;8276439;4084985;1161;1;0
FR;1;2021-04-17;122047;67395;102;0;0;8398486;4152380;1263;1;0
FR;1;2021-04-18;35915;20998;39;0;0;8434401;4173378;1302;1;0
FR;1;2021-04-19;163621;121755;429;0;0;8598022;4295133;1731;1;0
FR;1;2021-04-20;189311;148584;530;0;0;8787333;4443717;2261;1;0
FR;1;2021-04-21;193869;146617;754;0;0;8981202;4590334;3015;1;0
FR;1;2021-04-22;208855;162575;777;0;0;9190057;4752909;3792;1;0
FR;1;2021-04-23;198893;156781;666;0;0;9388950;4909690;4458;1;0
FR;1;2021-04-24;126292;95432;145;0;0;9515242;5005122;4603;1;0
FR;1;2021-04-25;53544;30087;46;0;0;9568786;5035209;4649;1;0
FR;1;2021-04-26;181048;138116;537;0;0;9749834;5173325;5186;1;0
FR;1;2021-04-27;221274;161752;898;0;0;9971108;5335077;6084;1;0
FR;1;2021-04-28;238193;154950;1308;1;1;10209301;5490027;7392;2;1
FR;1;2021-04-29;270191;159918;1205;0;0;10479492;5649945;8597;2;1
FR;1;2021-04-30;271899;147954;1069;0;0;10751391;5797899;9666;2;1
FR;1;2021-05-01;141057;40674;172;0;0;10892448;5838573;9838;2;1
FR;1;2021-05-02;81448;28119;80;0;0;10973896;5866692;9918;2;1
FR;1;2021-05-03;250632;146167;797;0;0;11224528;6012859;10715;2;1
FR;1;2021-05-04;265723;186780;1197;0;0;11490251;6199639;11912;2;1
FR;1;2021-05-05;283719;184448;1262;0;0;11773970;6384087;13174;2;1
FR;1;2021-05-06;309809;182909;1493;0;0;12083779;6566996;14667;2;1
FR;1;2021-05-07;283986;195503;1125;0;0;12367765;6762499;15792;2;1
FR;1;2021-05-08;191615;48305;283;0;0;12559380;6810804;16075;2;1
FR;1;2021-05-09;114006;36121;236;0;0;12673386;6846925;16311;2;1
FR;1;2021-05-10;257974;193983;1178;0;0;12931360;7040908;17489;2;1
FR;1;2021-05-11;318752;211081;1461;0;0;13250112;7251989;18950;2;1
FR;1;2021-05-12;356486;185667;1397;0;0;13606598;7437656;20347;2;1
FR;1;2021-05-13;283341;47716;398;0;0;13889939;7485372;20745;2;1
FR;1;2021-05-14;370394;128609;985;0;0;14260333;7613981;21730;2;1
FR;1;2021-05-15;297866;66068;402;0;0;14558199;7680049;22132;2;1
FR;1;2021-05-16;157709;15533;158;0;0;14715908;7695582;22290;2;1
FR;1;2021-05-17;318796;116496;1434;0;0;15034704;7812078;23724;2;1
FR;1;2021-05-18;383006;111124;1793;0;0;15417710;7923202;25517;2;1
FR;1;2021-05-19;395139;102669;2166;0;0;15812849;8025871;27683;2;1
FR;1;2021-05-20;421621;96152;2037;0;0;16234470;8122023;29720;2;1
FR;1;2021-05-21;399679;97233;1752;0;0;16634149;8219256;31472;2;1
FR;1;2021-05-22;275615;41996;601;0;0;16909764;8261252;32073;2;1
FR;1;2021-05-23;122944;11179;224;0;0;17032708;8272431;32297;2;1
FR;1;2021-05-24;243943;26249;564;0;0;17276651;8298680;32861;2;1
FR;1;2021-05-25;366014;131670;2103;1;0;17642665;8430350;34964;3;1
FR;1;2021-05-26;380704;125592;1983;0;0;18023369;8555942;36947;3;1
FR;1;2021-05-27;406017;127996;1968;0;0;18429386;8683938;38915;3;1
FR;1;2021-05-28;365901;145293;1692;0;0;18795287;8829231;40607;3;1
FR;1;2021-05-29;253779;80867;524;0;0;19049066;8910098;41131;3;1
FR;1;2021-05-30;100893;22527;156;0;0;19149959;8932625;41287;3;1
FR;1;2021-05-31;314171;148834;1279;1;1;19464130;9081459;42566;4;2
FR;1;2021-06-01;361085;166578;1720;1;1;19825215;9248037;44286;5;3
FR;1;2021-06-02;364129;153096;1785;0;0;20189344;9401133;46071;5;3
FR;1;2021-06-03;389827;147590;1642;0;0;20579171;9548723;47713;5;3
FR;1;2021-06-04;363271;175574;1486;1;1;20942442;9724297;49199;6;4
FR;1;2021-06-05;258415;112672;596;0;0;21200857;9836969;49795;6;4
FR;1;2021-06-06;126709;37526;215;0;0;21327566;9874495;50010;6;4
FR;1;2021-06-07;299680;207902;1357;0;0;21627246;10082397;51367;6;4
FR;1;2021-06-08;330445;220763;1630;0;0;21957691;10303160;52997;6;4
FR;1;2021-06-09;336270;212336;1600;0;0;22293961;10515496;54597;6;4
FR;1;2021-06-10;343564;202068;1605;0;0;22637525;10717564;56202;6;4
FR;1;2021-06-11;311645;235281;1287;0;0;22949170;10952845;57489;6;4
FR;1;2021-06-12;243971;150647;430;0;0;23193141;11103492;57919;6;4
FR;1;2021-06-13;100297;61007;188;0;0;23293438;11164499;58107;6;4
FR;1;2021-06-14;207633;289016;1311;1;0;23501071;11453515;59418;7;4
FR;1;2021-06-15;256593;282254;1386;1;0;23757664;11735769;60804;8;4
FR;1;2021-06-16;273438;270575;1259;1;0;24031102;12006344;62063;9;4
FR;1;2021-06-17;268009;244463;1227;1;0;24299111;12250807;63290;10;4
FR;1;2021-06-18;260364;295660;1146;1;0;24559475;12546467;64436;11;4
FR;1;2021-06-19;193402;209461;384;0;0;24752877;12755928;64820;11;4
FR;1;2021-06-20;69633;89118;117;0;0;24822510;12845046;64937;11;4
FR;1;2021-06-21;172160;319831;924;1;1;24994670;13164877;65861;12;5
FR;1;2021-06-22;185638;347777;1093;10;2;25180308;13512654;66954;22;7
FR;1;2021-06-23;203986;339390;1046;0;0;25384294;13852044;68000;22;7
FR;1;2021-06-24;203330;281956;1161;0;0;25587624;14134000;69161;22;7
FR;1;2021-06-25;182429;371766;1196;0;0;25770053;14505766;70357;22;7
FR;1;2021-06-26;131306;278281;500;0;0;25901359;14784047;70857;22;7
FR;1;2021-06-27;52361;122949;143;0;0;25953720;14906996;71000;22;7
FR;1;2021-06-28;136465;368285;1055;0;0;26090185;15275281;72055;22;7
FR;1;2021-06-29;154707;390495;1845;0;0;26244892;15665776;73900;22;7
FR;1;2021-06-30;179840;378544;1661;4;2;26424732;16044320;75561;26;9
FR;1;2021-07-01;201037;332169;1886;5;1;26625769;16376489;77447;31;10
FR;1;2021-07-02;193026;367676;1764;5;3;26818795;16744165;79211;36;13
FR;1;2021-07-03;124314;280457;704;3;1;26943109;17024622;79915;39;14
FR;1;2021-07-04;53890;113683;244;0;0;26996999;17138305;80159;39;14
FR;1;2021-07-05;153501;356080;1498;8;2;27150500;17494385;81657;47;16
FR;1;2021-07-06;173166;382537;1597;44;8;27323666;17876922;83254;91;24
FR;1;2021-07-07;190385;362573;1654;24;5;27514051;18239495;84908;115;29
FR;1;2021-07-08;201230;323104;1825;20;8;27715281;18562599;86733;135;37
FR;1;2021-07-09;189616;387190;1851;3;2;27904897;18949789;88584;138;39
FR;1;2021-07-10;129820;281111;814;1;1;28034717;19230900;89398;139;40
FR;1;2021-07-11;57602;102484;260;0;0;28092319;19333384;89658;139;40
FR;1;2021-07-12;149402;416998;1573;4;0;28241721;19750382;91231;143;40
FR;1;2021-07-13;234008;439474;1803;7;2;28475729;20189856;93034;150;42
FR;1;2021-07-14;171630;151576;415;0;0;28647359;20341432;93449;150;42
FR;1;2021-07-15;279337;424800;1855;1;0;28926696;20766232;95304;151;42
FR;1;2021-07-16;290112;401278;1709;3;1;29216808;21167510;97013;154;43
FR;1;2021-07-17;217228;282121;754;1;0;29434036;21449631;97767;155;43
FR;1;2021-07-18;101947;107311;288;0;0;29535983;21556942;98055;155;43
FR;1;2021-07-19;238007;379400;1495;3;0;29773990;21936342;99550;158;43
FR;1;2021-07-20;305516;380936;1466;0;0;30079506;22317278;101016;158;43
FR;1;2021-07-21;333043;353596;1410;4;2;30412549;22670874;102426;162;45
FR;1;2021-07-22;364333;319518;1499;3;2;30776882;22990392;103925;165;47
FR;1;2021-07-23;347560;343747;1582;4;2;31124442;23334139;105507;169;49
FR;1;2021-07-24;238884;241087;695;1;0;31363326;23575226;106202;170;49
FR;1;2021-07-25;112722;76058;214;0;0;31476048;23651284;106416;170;49
FR;1;2021-07-26;298955;290298;1495;2;2;31775003;23941582;107911;172;51
FR;1;2021-07-27;385641;268916;1457;4;2;32160644;24210498;109368;176;53
FR;1;2021-07-28;390041;251605;1460;4;2;32550685;24462103;110828;180;55
FR;1;2021-07-29;405941;228424;1537;2;1;32956626;24690527;112365;182;56
FR;1;2021-07-30;370479;247119;1632;4;1;33327105;24937646;113997;186;57
FR;1;2021-07-31;243319;165114;792;1;0;33570424;25102760;114789;187;57
FR;1;2021-08-01;105485;47228;232;0;0;33675909;25149988;115021;187;57
FR;1;2021-08-02;296842;213309;1473;2;0;33972751;25363297;116494;189;57
FR;1;2021-08-03;330994;209330;1544;2;1;34303745;25572627;118038;191;58
FR;1;2021-08-04;327641;184444;1435;5;3;34631386;25757071;119473;196;61
FR;1;2021-08-05;300972;193588;1478;0;0;34932358;25950659;120951;196;61
FR;1;2021-08-06;290675;224646;1558;3;1;35223033;26175305;122509;199;62
FR;1;2021-08-07;182539;158826;654;4;3;35405572;26334131;123163;203;65
FR;1;2021-08-08;68791;59151;246;0;0;35474363;26393282;123409;203;65
FR;1;2021-08-09;222554;236114;1435;4;3;35696917;26629396;124844;207;68
FR;1;2021-08-10;252384;240992;1485;2;1;35949301;26870388;126329;209;69
FR;1;2021-08-11;235923;232573;1267;5;1;36185224;27102961;127596;214;70
FR;1;2021-08-12;220457;240306;1482;3;1;36405681;27343267;129078;217;71
FR;1;2021-08-13;201535;238522;1351;2;2;36607216;27581789;130429;219;73
FR;1;2021-08-14;122780;174173;645;0;0;36729996;27755962;131074;219;73
FR;1;2021-08-15;34631;46122;195;1;0;36764627;27802084;131269;220;73
FR;1;2021-08-16;156599;289946;1420;0;0;36921226;28092030;132689;220;73
FR;1;2021-08-17;171335;291778;1418;4;1;37092561;28383808;134107;224;74
FR;1;2021-08-18;161198;287199;1382;6;3;37253759;28671007;135489;230;77
FR;1;2021-08-19;148711;277574;1392;1;0;37402470;28948581;136881;231;77
FR;1;2021-08-20;140251;308467;1518;2;2;37542721;29257048;138399;233;79
FR;1;2021-08-21;84188;213265;584;0;0;37626909;29470313;138983;233;79
FR;1;2021-08-22;28526;82685;228;0;0;37655435;29552998;139211;233;79
FR;1;2021-08-23;118524;321236;1416;2;1;37773959;29874234;140627;235;80
FR;1;2021-08-24;126507;319950;1591;5;1;37900466;30194184;142218;240;81
FR;1;2021-08-25;121342;306595;1772;8;3;38021808;30500779;143990;248;84
FR;1;2021-08-26;106451;286161;2153;10;1;38128259;30786940;146143;258;85
FR;1;2021-08-27;107444;321150;2298;8;3;38235703;31108090;148441;266;88
FR;1;2021-08-28;70909;220673;1100;0;0;38306612;31328763;149541;266;88
FR;1;2021-08-29;24122;78126;461;1;0;38330734;31406889;150002;267;88
FR;1;2021-08-30;96771;286548;4307;6;5169;38427505;31693437;154309;273;5257
FR;1;2021-08-31;97953;276491;9265;14;10197;38525458;31969928;163574;287;15454
FR;1;2021-09-01;111242;245262;21082;7;21975;38636700;32215190;184656;294;37429
FR;1;2021-09-02;84245;198061;24498;11;25382;38720945;32413251;209154;305;62811
FR;1;2021-09-03;82051;227663;26927;21;27918;38802996;32640914;236081;326;90729
FR;1;2021-09-04;71418;189705;11135;11;11608;38874414;32830619;247216;337;102337
FR;1;2021-09-05;18576;41195;4117;2;4280;38892990;32871814;251333;339;106617
FR;1;2021-09-06;59236;151695;30158;15;31029;38952226;33023509;281491;354;137646
FR;1;2021-09-07;56338;139737;30191;27;31045;39008564;33163246;311682;381;168691
FR;1;2021-09-08;70083;173823;26902;20;27733;39078647;33337069;338584;401;196424
FR;1;2021-09-09;53264;124448;28578;23;29527;39131911;33461517;367162;424;225951
FR;1;2021-09-10;65208;152030;30408;21;31451;39197119;33613547;397570;445;257402
FR;1;2021-09-11;51809;146586;9713;13;10209;39248928;33760133;407283;458;267611
FR;1;2021-09-12;10695;29251;2478;2;2624;39259623;33789384;409761;460;270235
FR;1;2021-09-13;51237;104605;38707;28;39679;39310860;33893989;448468;488;309914
FR;1;2021-09-14;53070;96107;51213;65;52554;39363930;33990096;499681;553;362468
FR;1;2021-09-15;60154;139218;50415;56;46872;39424084;34129314;550096;609;409340
FR;1;2021-09-16;46399;81392;53242;72;49378;39470483;34210706;603338;681;458718
FR;1;2021-09-17;52998;109376;45004;61;42569;39523481;34320082;648342;742;501287
FR;1;2021-09-18;37769;118447;11785;19;11244;39561250;34438529;660127;761;512531
FR;1;2021-09-19;6464;21033;2030;1;1967;39567714;34459562;662157;762;514498
FR;1;2021-09-20;36361;74873;46131;66;43996;39604075;34534435;708288;828;558494
FR;1;2021-09-21;34039;68149;56165;73;52479;39638114;34602584;764453;901;610973
FR;1;2021-09-22;38638;118374;49778;77;46694;39676752;34720958;814231;978;657667
FR;1;2021-09-23;31831;62676;54413;86;50641;39708583;34783634;868644;1064;708308
FR;1;2021-09-24;36597;89751;43606;92;41826;39745180;34873385;912250;1156;750134
FR;1;2021-09-25;27559;96503;12293;27;12150;39772739;34969888;924543;1183;762284
FR;1;2021-09-26;4346;15218;1766;4;1703;39777085;34985106;926309;1187;763987
FR;1;2021-09-27;27279;60240;42857;89;41522;39804364;35045346;969166;1276;805509
FR;1;2021-09-28;26803;49430;47105;75;44270;39831167;35094776;1016271;1351;849779
FR;1;2021-09-29;35791;80315;47196;86;45439;39866958;35175091;1063467;1437;895218
FR;1;2021-09-30;25886;46189;47439;80;45255;39892844;35221280;1110906;1517;940473
FR;1;2021-10-01;46600;64665;44833;83;44361;39939444;35285945;1155739;1600;984834
FR;1;2021-10-02;32098;62239;16093;32;16275;39971542;35348184;1171832;1632;1001109
FR;1;2021-10-03;4294;8607;2026;3;2036;39975836;35356791;1173858;1635;1003145
FR;1;2021-10-04;28460;44364;47062;78;46871;40004296;35401155;1220920;1713;1050016
FR;1;2021-10-05;23805;41567;49780;116;49082;40028101;35442722;1270700;1829;1099098
FR;1;2021-10-06;34069;61152;57388;102;57033;40062170;35503874;1328088;1931;1156131
FR;1;2021-10-07;20765;39658;52955;75;51765;40082935;35543532;1381043;2006;1207896
FR;1;2021-10-08;34603;59472;60315;83;60978;40117538;35603004;1441358;2089;1268874
FR;1;2021-10-09;27287;47895;25454;29;25953;40144825;35650899;1466812;2118;1294827
FR;1;2021-10-10;3565;5714;2741;7;2841;40148390;35656613;1469553;2125;1297668
FR;1;2021-10-11;24531;38151;54537;88;55133;40172921;35694764;1524090;2213;1352801
FR;1;2021-10-12;22894;36541;57994;126;59007;40195815;35731305;1582084;2339;1411808
FR;1;2021-10-13;32649;47681;64124;124;65563;40228464;35778986;1646208;2463;1477371
FR;1;2021-10-14;21505;34635;53704;102;54212;40249969;35813621;1699912;2565;1531583
FR;1;2021-10-15;32399;48629;72277;165;74894;40282368;35862250;1772189;2730;1606477
FR;1;2021-10-16;25845;35233;34845;45;36367;40308213;35897483;1807034;2775;1642844
FR;1;2021-10-17;3078;4034;3403;2;3311;40311291;35901517;1810437;2777;1646155
FR;1;2021-10-18;22386;34292;66780;131;69607;40333677;35935809;1877217;2908;1715762
FR;1;2021-10-19;20399;33024;75605;136;79474;40354076;35968833;1952822;3044;1795236
FR;1;2021-10-20;29687;43983;96104;176;99664;40383763;36012816;2048926;3220;1894900
FR;1;2021-10-21;19408;35023;83084;107;86937;40403171;36047839;2132010;3327;1981837
FR;1;2021-10-22;29466;47397;103664;195;109506;40432637;36095236;2235674;3522;2091343
FR;1;2021-10-23;22908;34968;44835;57;47327;40455545;36130204;2280509;3579;2138670
FR;1;2021-10-24;2364;3871;3577;6;3740;40457909;36134075;2284086;3585;2142410
FR;1;2021-10-25;22345;30700;81963;143;85713;40480254;36164775;2366049;3728;2228123
FR;1;2021-10-26;19238;27580;86032;162;90219;40499492;36192355;2452081;3890;2318342
FR;1;2021-10-27;26061;39626;107721;252;112543;40525553;36231981;2559802;4142;2430885
FR;1;2021-10-28;18475;26919;86866;150;91517;40544028;36258900;2646668;4292;2522402
FR;1;2021-10-29;25809;39767;114748;201;121430;40569837;36298667;2761416;4493;2643832
FR;1;2021-10-30;17519;28544;49320;76;51899;40587356;36327211;2810736;4569;2695731
FR;1;2021-10-31;2044;3218;3440;2;3680;40589400;36330429;2814176;4571;2699411
FR;1;2021-11-01;7287;4093;3011;3;3255;40596687;36334522;2817187;4574;2702666
FR;1;2021-11-02;21502;33075;92309;157;97612;40618189;36367597;2909496;4731;2800278
FR;1;2021-11-03;25997;41303;117403;215;123713;40644186;36408900;3026899;4946;2923991
FR;1;2021-11-04;19353;30192;105690;212;111757;40663539;36439092;3132589;5158;3035748
FR;1;2021-11-05;26759;42040;138671;227;147208;40690298;36481132;3271260;5385;3182956
FR;1;2021-11-06;18696;29758;63417;123;66368;40708994;36510890;3334677;5508;3249324
FR;1;2021-11-07;1773;3376;4944;6;5296;40710767;36514266;3339621;5514;3254620
FR;1;2021-11-08;17384;32257;125878;224;132397;40728151;36546523;3465499;5738;3387017
FR;1;2021-11-09;19064;37633;159171;336;168828;40747215;36584156;3624670;6074;3555845
FR;1;2021-11-10;28447;48778;181771;440;192242;40775662;36632934;3806441;6514;3748087
FR;1;2021-11-11;3413;5591;12164;26;12958;40779075;36638525;3818605;6540;3761045
FR;1;2021-11-12;25823;46816;174709;241;186275;40804898;36685341;3993314;6781;3947320
FR;1;2021-11-13;18592;29194;76780;111;81720;40823490;36714535;4070094;6892;4029040
FR;1;2021-11-14;1992;3355;6807;5;7386;40825482;36717890;4076901;6897;4036426
FR;1;2021-11-15;18437;34833;156270;303;166022;40843919;36752723;4233171;7200;4202448
FR;1;2021-11-16;20868;37796;191954;377;204666;40864787;36790519;4425125;7577;4407114
FR;1;2021-11-17;28338;45628;193112;399;204859;40893125;36836147;4618237;7976;4611973
FR;1;2021-11-18;20897;37699;182334;458;194271;40914022;36873846;4800571;8434;4806244
FR;1;2021-11-19;30707;53277;230092;529;246459;40944729;36927123;5030663;8963;5052703
FR;1;2021-11-20;23600;33207;96919;200;103547;40968329;36960330;5127582;9163;5156250
FR;1;2021-11-21;2301;4033;9087;18;9979;40970630;36964363;5136669;9181;5166229
FR;1;2021-11-22;21267;30340;175757;465;189237;40991897;36994703;5312426;9646;5355466
FR;1;2021-11-23;23726;40965;221031;538;237654;41015623;37035668;5533457;10184;5593120
FR;1;2021-11-24;30163;49612;217224;703;234303;41045786;37085280;5750681;10887;5827423
FR;1;2021-11-25;23390;43675;244298;719;263817;41069176;37128955;5994979;11606;6091240
FR;1;2021-11-26;30457;66423;356622;834;388320;41099633;37195378;6351601;12440;6479560
FR;1;2021-11-27;21642;45135;202520;372;222479;41121275;37240513;6554121;12812;6702039
FR;1;2021-11-28;3132;9689;54742;63;61036;41124407;37250202;6608863;12875;6763075
FR;1;2021-11-29;17772;49394;326224;841;354154;41142179;37299596;6935087;13716;7117229
FR;1;2021-11-30;22449;64708;430970;948;470526;41164628;37364304;7366057;14664;7587755
FR;1;2021-12-01;24067;69106;442671;1129;481463;41188695;37433410;7808728;15793;8069218
FR;1;2021-12-02;19753;64209;489197;1224;532594;41208448;37497619;8297925;17017;8601812
FR;1;2021-12-03;22684;81656;542543;1303;591468;41231132;37579275;8840468;18320;9193280
FR;1;2021-12-04;16334;53841;298991;652;328803;41247466;37633116;9139459;18972;9522083
FR;1;2021-12-05;3620;13916;81481;143;91062;41251086;37647032;9220940;19115;9613145
FR;1;2021-12-06;16615;62656;415258;1062;454941;41267701;37709688;9636198;20177;10068086
FR;1;2021-12-07;19691;75692;522725;1531;572260;41287392;37785380;10158923;21708;10640346
FR;1;2021-12-08;21438;75437;458171;1541;501854;41308830;37860817;10617094;23249;11142200
FR;1;2021-12-09;19283;73893;492696;1626;540522;41328113;37934710;11109790;24875;11682722
FR;1;2021-12-10;22344;87493;547179;1583;599758;41350457;38022203;11656969;26458;12282480
FR;1;2021-12-11;16485;58915;302649;746;335397;41366942;38081118;11959618;27204;12617877
FR;1;2021-12-12;4324;15944;83155;179;94071;41371266;38097062;12042773;27383;12711948
FR;1;2021-12-13;15391;63627;366765;1095;406117;41386657;38160689;12409538;28478;13118065
FR;1;2021-12-14;19882;80104;464478;1738;514947;41406539;38240793;12874016;30216;13633012
FR;1;2021-12-15;21224;77132;408855;1307;452907;41427763;38317925;13282871;31523;14085919
FR;1;2021-12-16;19838;77225;451607;1574;500400;41447601;38395150;13734478;33097;14586319
FR;1;2021-12-17;22384;86589;479721;1735;530833;41469985;38481739;14214199;34832;15117152
FR;1;2021-12-18;17563;54630;257531;730;288451;41487548;38536369;14471730;35562;15405603
FR;1;2021-12-19;5533;17182;79116;194;90775;41493081;38553551;14550846;35756;15496378
FR;1;2021-12-20;20716;63003;316049;1080;355125;41513797;38616554;14866895;36836;15851503
FR;1;2021-12-21;26036;73020;372566;1420;417927;41539833;38689574;15239461;38256;16269430
FR;1;2021-12-22;24844;65710;310441;1214;349417;41564677;38755284;15549902;39470;16618847
FR;1;2021-12-23;21149;52198;241343;948;272939;41585826;38807482;15791245;40418;16891786
FR;1;2021-12-24;7049;18232;67091;256;77036;41592875;38825714;15858336;40674;16968822
FR;1;2021-12-25;493;2755;5565;15;6536;41593368;38828469;15863901;40689;16975358
FR;1;2021-12-26;2746;7583;26914;68;31445;41596114;38836052;15890815;40757;17006803
FR;1;2021-12-27;18052;53223;234973;707;265637;41614166;38889275;16125788;41464;17272440
FR;1;2021-12-28;23186;61772;291902;1024;330069;41637352;38951047;16417690;42488;17602509
FR;1;2021-12-29;22155;55413;254864;917;288094;41659507;39006460;16672554;43405;17890603
FR;1;2021-12-30;21167;46043;212053;857;239520;41680674;39052503;16884607;44262;18130123
FR;1;2021-12-31;7249;16465;61809;229;70313;41687923;39068968;16946416;44491;18200436
FR;1;2022-01-01;769;2481;5638;29;6572;41688692;39071449;16952054;44520;18207008
FR;1;2022-01-02;3031;8068;28852;50;33515;41691723;39079517;16980906;44570;18240523
FR;1;2022-01-03;18856;51952;228030;783;257288;41710579;39131469;17208936;45353;18497811
FR;1;2022-01-04;24604;64486;299109;1235;337103;41735183;39195955;17508045;46588;18834914
FR;1;2022-01-05;28935;63484;274703;1096;309993;41764118;39259439;17782748;47684;19144907
FR;1;2022-01-06;26324;65795;306727;1392;346361;41790442;39325234;18089475;49076;19491268
FR;1;2022-01-07;31152;74302;349672;1534;393718;41821594;39399536;18439147;50610;19884986
FR;1;2022-01-08;23291;51361;222442;694;251075;41844885;39450897;18661589;51304;20136061
FR;1;2022-01-09;7072;17225;65998;162;76156;41851957;39468122;18727587;51466;20212217
FR;1;2022-01-10;21226;53470;236616;951;266862;41873183;39521592;18964203;52417;20479079
FR;1;2022-01-11;26350;62606;282130;1276;317654;41899533;39584198;19246333;53693;20796733
FR;1;2022-01-12;28538;61831;246087;1103;277843;41928071;39646029;19492420;54796;21074576
FR;1;2022-01-13;24288;59629;262620;1250;295968;41952359;39705658;19755040;56046;21370544
FR;1;2022-01-14;27682;66402;313818;1364;351099;41980041;39772060;20068858;57410;21721643
FR;1;2022-01-15;19237;44284;199228;618;223813;41999278;39816344;20268086;58028;21945456
FR;1;2022-01-16;5131;12997;51479;135;59570;42004409;39829341;20319565;58163;22005026
FR;1;2022-01-17;16662;39607;184729;779;206784;42021071;39868948;20504294;58942;22211810
FR;1;2022-01-18;19183;45454;212284;1149;236908;42040254;39914402;20716578;60091;22448718
FR;1;2022-01-19;20057;43746;175986;894;197109;42060311;39958148;20892564;60985;22645827
FR;1;2022-01-20;16510;40205;183503;1136;204573;42076821;39998353;21076067;62121;22850400
FR;1;2022-01-21;19625;46907;228819;1398;253238;42096446;40045260;21304886;63519;23103638
FR;1;2022-01-22;13824;33076;144439;578;161325;42110270;40078336;21449325;64097;23264963
FR;1;2022-01-23;3340;8827;33385;130;38322;42113610;40087163;21482710;64227;23303285
FR;1;2022-01-24;11691;32523;142105;705;158203;42125301;40119686;21624815;64932;23461488
FR;1;2022-01-25;14061;37784;163289;1049;181485;42139362;40157470;21788104;65981;23642973
FR;1;2022-01-26;14779;36613;150123;927;166161;42154141;40194083;21938227;66908;23809134
FR;1;2022-01-27;12247;32543;143314;878;157781;42166388;40226626;22081541;67786;23966915
FR;1;2022-01-28;16174;53812;198176;1143;222419;42182562;40280438;22279717;68929;24189334
FR;1;2022-01-29;10238;35436;135149;520;151528;42192800;40315874;22414866;69449;24340862
FR;1;2022-01-30;2471;9341;29653;84;34460;42195271;40325215;22444519;69533;24375322
FR;1;2022-01-31;8702;32311;104268;530;117375;42203973;40357526;22548787;70063;24492697
FR;1;2022-02-01;9956;35805;126953;853;141109;42213929;40393331;22675740;70916;24633806
FR;1;2022-02-02;11076;40765;130223;765;145744;42225005;40434096;22805963;71681;24779550
FR;1;2022-02-03;8649;32974;116890;768;130270;42233654;40467070;22922853;72449;24909820
FR;1;2022-02-04;11331;47856;172459;963;192727;42244985;40514926;23095312;73412;25102547
FR;1;2022-02-05;7680;33921;117527;391;133033;42252665;40548847;23212839;73803;25235580
FR;1;2022-02-06;1686;8068;22723;83;26900;42254351;40556915;23235562;73886;25262480
FR;1;2022-02-07;6962;35215;118998;449;134929;42261313;40592130;23354560;74335;25397409
FR;1;2022-02-08;7476;31368;125557;689;140519;42268789;40623498;23480117;75024;25537928
FR;1;2022-02-09;8364;35781;135153;692;152343;42277153;40659279;23615270;75716;25690271
FR;1;2022-02-10;6515;28833;116216;669;129918;42283668;40688112;23731486;76385;25820189
FR;1;2022-02-11;8513;41149;164999;872;185190;42292181;40729261;23896485;77257;26005379
FR;1;2022-02-12;5250;27487;106645;378;120811;42297431;40756748;24003130;77635;26126190
FR;1;2022-02-13;1211;5685;21685;61;25296;42298642;40762433;24024815;77696;26151486
FR;1;2022-02-14;5322;26997;117964;389;132981;42303964;40789430;24142779;78085;26284467
FR;1;2022-02-15;5538;27933;118737;609;132303;42309502;40817363;24261516;78694;26416770
FR;1;2022-02-16;5603;27858;110291;591;122878;42315105;40845221;24371807;79285;26539648
FR;1;2022-02-17;4365;18845;73028;484;80058;42319470;40864066;24444835;79769;26619706
FR;1;2022-02-18;5442;26277;99082;667;107998;42324912;40890343;24543917;80436;26727704
FR;1;2022-02-19;3501;17045;59433;303;66001;42328413;40907388;24603350;80739;26793705
FR;1;2022-02-20;775;3205;10674;35;12294;42329188;40910593;24614024;80774;26805999
FR;1;2022-02-21;3306;14419;52749;286;57585;42332494;40925012;24666773;81060;26863584
FR;1;2022-02-22;3655;15292;51822;496;55535;42336149;40940304;24718595;81556;26919119
FR;1;2022-02-23;4130;17441;57370;508;62447;42340279;40957745;24775965;82064;26981566
FR;1;2022-02-24;3203;12514;43507;431;46266;42343482;40970259;24819472;82495;27027832
FR;1;2022-02-25;4337;19202;64774;691;68609;42347819;40989461;24884246;83186;27096441
FR;1;2022-02-26;2665;12494;41305;305;45056;42350484;41001955;24925551;83491;27141497
FR;1;2022-02-27;631;2160;7106;42;7968;42351115;41004115;24932657;83533;27149465
FR;1;2022-02-28;2533;9948;34872;300;37289;42353648;41014063;24967529;83833;27186754
FR;1;2022-03-01;2546;10145;38336;373;39232;42356194;41024208;25005865;84206;27225986
FR;1;2022-03-02;3349;11730;41630;387;43669;42359543;41035938;25047495;84593;27269655
FR;1;2022-03-03;2224;7299;25837;296;26141;42361767;41043237;25073332;84889;27295796
FR;1;2022-03-04;2601;10098;35227;567;34691;42364368;41053335;25108559;85456;27330487
FR;1;2022-03-05;1626;6261;21860;273;22244;42365994;41059596;25130419;85729;27352731
FR;1;2022-03-06;337;924;2903;37;3097;42366331;41060520;25133322;85766;27355828
FR;1;2022-03-07;1303;4493;16264;241;15718;42367634;41065013;25149586;86007;27371546
FR;1;2022-03-08;1470;4968;16929;301;15745;42369104;41069981;25166515;86308;27387291
FR;1;2022-03-09;1814;6284;19432;362;18791;42370918;41076265;25185947;86670;27406082
FR;1;2022-03-10;1224;4040;14613;291;13628;42372142;41080305;25200560;86961;27419710
FR;1;2022-03-11;1648;6054;21478;477;19615;42373790;41086359;25222038;87438;27439325
FR;1;2022-03-12;1193;4551;15253;273;14785;42374983;41090910;25237291;87711;27454110
FR;1;2022-03-13;228;588;2005;114;1953;42375211;41091498;25239296;87825;27456063
FR;1;2022-03-14;1027;3443;12942;3872;12071;42376238;41094941;25252238;91697;27468134
FR;1;2022-03-15;1193;3655;13787;6842;12243;42377431;41098596;25266025;98539;27480377
FR;1;2022-03-16;1542;4522;16119;11501;15202;42378973;41103118;25282144;110040;27495579
FR;1;2022-03-17;1050;2942;10762;9560;9843;42380023;41106060;25292906;119600;27505422
FR;1;2022-03-18;1606;4532;17419;16418;15830;42381629;41110592;25310325;136018;27521252
FR;1;2022-03-19;1082;3096;11720;8438;11171;42382711;41113688;25322045;144456;27532423
FR;1;2022-03-20;203;495;1537;997;1567;42382914;41114183;25323582;145453;27533990
FR;1;2022-03-21;1001;2529;10003;13332;9374;42383915;41116712;25333585;158785;27543364
FR;1;2022-03-22;1130;2898;11334;18601;10325;42385045;41119610;25344919;177386;27553689
FR;1;2022-03-23;1376;3683;12926;19933;12469;42386421;41123293;25357845;197319;27566158
FR;1;2022-03-24;996;2329;9302;15756;8549;42387417;41125622;25367147;213075;27574707
FR;1;2022-03-25;1417;3769;15672;25078;14306;42388834;41129391;25382819;238153;27589013
FR;1;2022-03-26;1069;2715;10485;11338;10126;42389903;41132106;25393304;249491;27599139
FR;1;2022-03-27;220;511;1671;1339;1719;42390123;41132617;25394975;250830;27600858
FR;1;2022-03-28;978;2173;9053;15405;8648;42391101;41134790;25404028;266235;27609506
FR;1;2022-03-29;1055;2541;10759;24029;10112;42392156;41137331;25414787;290264;27619618
FR;1;2022-03-30;1481;3194;12896;23066;12421;42393637;41140525;25427683;313330;27632039
FR;2;2020-12-27;0;0;0;0;0;0;0;0;0;0
FR;2;2020-12-28;0;0;0;0;0;0;0;0;0;0
FR;2;2020-12-29;0;0;0;0;0;0;0;0;0;0
FR;2;2020-12-30;0;0;0;0;0;0;0;0;0;0
FR;2;2020-12-31;0;0;0;0;0;0;0;0;0;0
FR;2;2021-01-01;0;0;0;0;0;0;0;0;0;0
FR;2;2021-01-02;0;0;0;0;0;0;0;0;0;0
FR;2;2021-01-03;0;0;0;0;0;0;0;0;0;0
FR;2;2021-01-04;0;0;0;0;0;0;0;0;0;0
FR;2;2021-01-05;0;0;0;0;0;0;0;0;0;0
FR;2;2021-01-06;0;0;0;0;0;0;0;0;0;0
FR;2;2021-01-07;0;0;0;0;0;0;0;0;0;0
FR;2;2021-01-08;0;0;0;0;0;0;0;0;0;0
FR;2;2021-01-09;0;0;0;0;0;0;0;0;0;0
FR;2;2021-01-10;0;0;0;0;0;0;0;0;0;0
FR;2;2021-01-11;0;0;0;0;0;0;0;0;0;0
FR;2;2021-01-12;0;0;0;0;0;0;0;0;0;0
FR;2;2021-01-13;0;0;0;0;0;0;0;0;0;0
FR;2;2021-01-14;1702;0;0;0;0;1702;0;0;0;0
FR;2;2021-01-15;390;0;0;0;0;2092;0;0;0;0
FR;2;2021-01-16;312;0;0;0;0;2404;0;0;0;0
FR;2;2021-01-17;80;0;0;0;0;2484;0;0;0;0
FR;2;2021-01-18;3072;0;0;0;0;5556;0;0;0;0
FR;2;2021-01-19;4674;0;0;0;0;10230;0;0;0;0
FR;2;2021-01-20;5133;3;0;0;0;15363;3;0;0;0
FR;2;2021-01-21;5332;4;0;0;0;20695;7;0;0;0
FR;2;2021-01-22;5114;1;0;0;0;25809;8;0;0;0
FR;2;2021-01-23;1863;0;0;0;0;27672;8;0;0;0
FR;2;2021-01-24;160;1;0;0;0;27832;9;0;0;0
FR;2;2021-01-25;3810;1;0;0;0;31642;10;0;0;0
FR;2;2021-01-26;3914;0;0;0;0;35556;10;0;0;0
FR;2;2021-01-27;3595;1;0;0;0;39151;11;0;0;0
FR;2;2021-01-28;3740;1;0;0;0;42891;12;0;0;0
FR;2;2021-01-29;3286;2;0;0;0;46177;14;0;0;0
FR;2;2021-01-30;1129;1;0;0;0;47306;15;0;0;0
FR;2;2021-01-31;45;1;0;0;0;47351;16;0;0;0
FR;2;2021-02-01;3399;2;0;0;0;50750;18;0;0;0
FR;2;2021-02-02;4485;8;0;0;0;55235;26;0;0;0
FR;2;2021-02-03;5214;5;0;0;0;60449;31;0;0;0
FR;2;2021-02-04;4926;6;0;0;0;65375;37;0;0;0
FR;2;2021-02-05;4809;13;0;0;0;70184;50;0;0;0
FR;2;2021-02-06;2037;9;0;0;0;72221;59;0;0;0
FR;2;2021-02-07;97;4;0;0;0;72318;63;0;0;0
FR;2;2021-02-08;7549;16;0;0;0;79867;79;0;0;0
FR;2;2021-02-09;8418;25;0;0;0;88285;104;0;0;0
FR;2;2021-02-10;9336;55;0;0;0;97621;159;0;0;0
FR;2;2021-02-11;10271;77;0;0;0;107892;236;0;0;0
FR;2;2021-02-12;10046;248;0;0;0;117938;484;0;0;0
FR;2;2021-02-13;3116;227;0;0;0;121054;711;0;0;0
FR;2;2021-02-14;349;2;0;0;0;121403;713;0;0;0
FR;2;2021-02-15;3453;3079;0;0;0;124856;3792;0;0;0
FR;2;2021-02-16;5065;3926;0;0;0;129921;7718;0;0;0
FR;2;2021-02-17;4249;4418;0;0;0;134170;12136;0;0;0
FR;2;2021-02-18;5399;5099;0;0;0;139569;17235;0;0;0
FR;2;2021-02-19;5320;4345;0;0;0;144889;21580;0;0;0
FR;2;2021-02-20;1864;1508;0;0;0;146753;23088;0;0;0
FR;2;2021-02-21;239;86;0;0;0;146992;23174;0;0;0
FR;2;2021-02-22;3610;3722;0;0;0;150602;26896;0;0;0
FR;2;2021-02-23;4951;3691;0;0;0;155553;30587;0;0;0
FR;2;2021-02-24;5007;3461;0;0;0;160560;34048;0;0;0
FR;2;2021-02-25;5479;3440;0;0;0;166039;37488;0;0;0
FR;2;2021-02-26;4355;3134;0;0;0;170394;40622;0;0;0
FR;2;2021-02-27;1622;1045;0;0;0;172016;41667;0;0;0
FR;2;2021-02-28;176;32;0;0;0;172192;41699;0;0;0
FR;2;2021-03-01;5171;3750;0;0;0;177363;45449;0;0;0
FR;2;2021-03-02;6526;4719;0;0;0;183889;50168;0;0;0
FR;2;2021-03-03;6531;4893;0;0;0;190420;55061;0;0;0
FR;2;2021-03-04;8393;3969;0;0;0;198813;59030;0;0;0
FR;2;2021-03-05;8023;4063;0;0;0;206836;63093;0;0;0
FR;2;2021-03-06;4782;1684;0;0;0;211618;64777;0;0;0
FR;2;2021-03-07;2371;31;0;0;0;213989;64808;0;0;0
FR;2;2021-03-08;4163;8313;0;0;0;218152;73121;0;0;0
FR;2;2021-03-09;7482;8443;1;0;0;225634;81564;1;0;0
FR;2;2021-03-10;7092;9108;0;0;0;232726;90672;1;0;0
FR;2;2021-03-11;9370;9190;1;0;0;242096;99862;2;0;0
FR;2;2021-03-12;7968;8182;0;0;0;250064;108044;2;0;0
FR;2;2021-03-13;10045;2523;0;0;0;260109;110567;2;0;0
FR;2;2021-03-14;4838;402;0;0;0;264947;110969;2;0;0
FR;2;2021-03-15;10904;3487;0;0;0;275851;114456;2;0;0
FR;2;2021-03-16;16753;4637;1;0;0;292604;119093;3;0;0
FR;2;2021-03-17;20217;3959;0;0;0;312821;123052;3;0;0
FR;2;2021-03-18;23361;4915;0;0;0;336182;127967;3;0;0
FR;2;2021-03-19;23295;4537;0;0;0;359477;132504;3;0;0
FR;2;2021-03-20;25438;1541;0;0;0;384915;134045;3;0;0
FR;2;2021-03-21;17669;146;0;0;0;402584;134191;3;0;0
FR;2;2021-03-22;17780;3089;0;0;0;420364;137280;3;0;0
FR;2;2021-03-23;22681;4194;0;0;0;443045;141474;3;0;0
FR;2;2021-03-24;23952;4988;0;0;0;466997;146462;3;0;0
FR;2;2021-03-25;26734;5040;1;0;0;493731;151502;4;0;0
FR;2;2021-03-26;26973;4264;0;0;0;520704;155766;4;0;0
FR;2;2021-03-27;15913;1318;0;0;0;536617;157084;4;0;0
FR;2;2021-03-28;10560;105;0;0;0;547177;157189;4;0;0
FR;2;2021-03-29;18980;4279;0;0;0;566157;161468;4;0;0
FR;2;2021-03-30;24570;6014;0;0;0;590727;167482;4;0;0
FR;2;2021-03-31;28547;5939;0;0;0;619274;173421;4;0;0
FR;2;2021-04-01;34540;8489;1;0;0;653814;181910;5;0;0
FR;2;2021-04-02;29973;7664;0;0;0;683787;189574;5;0;0
FR;2;2021-04-03;16951;3611;0;0;0;700738;193185;5;0;0
FR;2;2021-04-04;9304;930;2;0;0;710042;194115;7;0;0
FR;2;2021-04-05;12437;811;0;0;0;722479;194926;7;0;0
FR;2;2021-04-06;27134;6937;0;0;0;749613;201863;7;0;0
FR;2;2021-04-07;30923;7167;1;0;0;780536;209030;8;0;0
FR;2;2021-04-08;36877;8800;1;0;0;817413;217830;9;0;0
FR;2;2021-04-09;33824;8586;28;0;0;851237;226416;37;0;0
FR;2;2021-04-10;19677;8980;1;0;0;870914;235396;38;0;0
FR;2;2021-04-11;7939;4262;1;0;0;878853;239658;39;0;0
FR;2;2021-04-12;17119;11214;0;0;0;895972;250872;39;0;0
FR;2;2021-04-13;19445;16354;1;0;0;915417;267226;40;0;0
FR;2;2021-04-14;18056;16268;7;0;0;933473;283494;47;0;0
FR;2;2021-04-15;22183;20758;26;0;0;955656;304252;73;0;0
FR;2;2021-04-16;20704;20045;45;0;0;976360;324297;118;0;0
FR;2;2021-04-17;13250;22443;5;0;0;989610;346740;123;0;0
FR;2;2021-04-18;5907;14388;6;0;0;995517;361128;129;0;0
FR;2;2021-04-19;16826;16247;24;0;0;1012343;377375;153;0;0
FR;2;2021-04-20;19312;21546;38;0;0;1031655;398921;191;0;0
FR;2;2021-04-21;20280;21657;76;0;0;1051935;420578;267;0;0
FR;2;2021-04-22;23804;24842;41;0;0;1075739;445420;308;0;0
FR;2;2021-04-23;24509;25339;76;0;0;1100248;470759;384;0;0
FR;2;2021-04-24;25299;15081;102;0;0;1125547;485840;486;0;0
FR;2;2021-04-25;9592;8592;5;0;0;1135139;494432;491;0;0
FR;2;2021-04-26;17154;17200;21;0;0;1152293;511632;512;0;0
FR;2;2021-04-27;19238;24276;40;0;0;1171531;535908;552;0;0
FR;2;2021-04-28;22330;26176;112;0;0;1193861;562084;664;0;0
FR;2;2021-04-29;25462;30128;69;0;0;1219323;592212;733;0;0
FR;2;2021-04-30;25530;27748;49;1;0;1244853;619960;782;1;0
FR;2;2021-05-01;14979;9866;6;0;0;1259832;629826;788;1;0
FR;2;2021-05-02;6634;9174;2;0;0;1266466;639000;790;1;0
FR;2;2021-05-03;20012;19289;40;0;0;1286478;658289;830;1;0
FR;2;2021-05-04;18280;29028;33;0;0;1304758;687317;863;1;0
FR;2;2021-05-05;18358;29376;48;0;0;1323116;716693;911;1;0
FR;2;2021-05-06;23533;35235;131;0;0;1346649;751928;1042;1;0
FR;2;2021-05-07;25320;33205;97;0;0;1371969;785133;1139;1;0
FR;2;2021-05-08;21332;9708;14;0;0;1393301;794841;1153;1;0
FR;2;2021-05-09;13160;7880;7;0;0;1406461;802721;1160;1;0
FR;2;2021-05-10;32934;22181;48;0;0;1439395;824902;1208;1;0
FR;2;2021-05-11;43589;21053;101;0;0;1482984;845955;1309;1;0
FR;2;2021-05-12;50032;19876;142;0;0;1533016;865831;1451;1;0
FR;2;2021-05-13;51286;5768;31;0;0;1584302;871599;1482;1;0
FR;2;2021-05-14;61337;12921;132;0;0;1645639;884520;1614;1;0
FR;2;2021-05-15;65918;7139;39;0;0;1711557;891659;1653;1;0
FR;2;2021-05-16;43577;2568;10;0;0;1755134;894227;1663;1;0
FR;2;2021-05-17;44739;12563;113;0;0;1799873;906790;1776;1;0
FR;2;2021-05-18;54632;12234;191;0;0;1854505;919024;1967;1;0
FR;2;2021-05-19;57159;10600;281;0;0;1911664;929624;2248;1;0
FR;2;2021-05-20;63427;10843;286;0;0;1975091;940467;2534;1;0
FR;2;2021-05-21;64281;11654;230;0;0;2039372;952121;2764;1;0
FR;2;2021-05-22;61475;4504;65;0;0;2100847;956625;2829;1;0
FR;2;2021-05-23;37529;569;22;0;0;2138376;957194;2851;1;0
FR;2;2021-05-24;17232;2032;33;0;0;2155608;959226;2884;1;0
FR;2;2021-05-25;21099;12231;239;0;0;2176707;971457;3123;1;0
FR;2;2021-05-26;19925;11444;229;0;0;2196632;982901;3352;1;0
FR;2;2021-05-27;22987;12660;181;0;0;2219619;995561;3533;1;0
FR;2;2021-05-28;29384;14949;190;0;0;2249003;1010510;3723;1;0
FR;2;2021-05-29;30411;8177;57;0;0;2279414;1018687;3780;1;0
FR;2;2021-05-30;4646;1813;6;0;0;2284060;1020500;3786;1;0
FR;2;2021-05-31;28580;18715;183;0;0;2312640;1039215;3969;1;0
FR;2;2021-06-01;45704;20022;221;0;0;2358344;1059237;4190;1;0
FR;2;2021-06-02;37458;19295;181;0;0;2395802;1078532;4371;1;0
FR;2;2021-06-03;51261;23355;161;0;0;2447063;1101887;4532;1;0
FR;2;2021-06-04;65504;24049;215;0;0;2512567;1125936;4747;1;0
FR;2;2021-06-05;34596;24024;51;0;0;2547163;1149960;4798;1;0
FR;2;2021-06-06;4946;6199;10;0;0;2552109;1156159;4808;1;0
FR;2;2021-06-07;28159;23056;146;0;0;2580268;1179215;4954;1;0
FR;2;2021-06-08;46370;22923;143;0;0;2626638;1202138;5097;1;0
FR;2;2021-06-09;34277;20916;107;0;0;2660915;1223054;5204;1;0
FR;2;2021-06-10;42631;19137;95;1;0;2703546;1242191;5299;2;0
FR;2;2021-06-11;55276;25227;133;0;0;2758822;1267418;5432;2;0
FR;2;2021-06-12;30556;19780;53;0;0;2789378;1287198;5485;2;0
FR;2;2021-06-13;3327;9182;13;0;0;2792705;1296380;5498;2;0
FR;2;2021-06-14;25294;24167;92;0;0;2817999;1320547;5590;2;0
FR;2;2021-06-15;39025;22853;154;0;0;2857024;1343400;5744;2;0
FR;2;2021-06-16;30154;21456;134;0;0;2887178;1364856;5878;2;0
FR;2;2021-06-17;36897;25867;150;0;0;2924075;1390723;6028;2;0
FR;2;2021-06-18;46841;28794;122;0;0;2970916;1419517;6150;2;0
FR;2;2021-06-19;24523;24893;39;0;0;2995439;1444410;6189;2;0
FR;2;2021-06-20;3737;10062;10;0;0;2999176;1454472;6199;2;0
FR;2;2021-06-21;17520;42835;87;0;0;3016696;1497307;6286;2;0
FR;2;2021-06-22;28353;49541;110;0;0;3045049;1546848;6396;2;0
FR;2;2021-06-23;21783;49564;106;1;1;3066832;1596412;6502;3;1
FR;2;2021-06-24;28370;50290;133;0;0;3095202;1646702;6635;3;1
FR;2;2021-06-25;33392;60378;126;0;0;3128594;1707080;6761;3;1
FR;2;2021-06-26;16368;59237;54;1;0;3144962;1766317;6815;4;1
FR;2;2021-06-27;2564;29322;22;1;0;3147526;1795639;6837;5;1
FR;2;2021-06-28;12633;54338;80;0;0;3160159;1849977;6917;5;1
FR;2;2021-06-29;19837;59878;178;0;0;3179996;1909855;7095;5;1
FR;2;2021-06-30;16315;57846;251;17;0;3196311;1967701;7346;22;1
FR;2;2021-07-01;20472;59885;227;0;0;3216783;2027586;7573;22;1
FR;2;2021-07-02;24067;62121;183;0;0;3240850;2089707;7756;22;1
FR;2;2021-07-03;12106;57078;153;0;0;3252956;2146785;7909;22;1
FR;2;2021-07-04;1957;23309;18;0;0;3254913;2170094;7927;22;1
FR;2;2021-07-05;9165;29359;106;0;0;3264078;2199453;8033;22;1
FR;2;2021-07-06;14569;36192;134;0;0;3278647;2235645;8167;22;1
FR;2;2021-07-07;14398;33666;138;0;0;3293045;2269311;8305;22;1
FR;2;2021-07-08;19708;40289;162;0;0;3312753;2309600;8467;22;1
FR;2;2021-07-09;27088;54259;202;1;1;3339841;2363859;8669;23;2
FR;2;2021-07-10;13380;33659;107;0;0;3353221;2397518;8776;23;2
FR;2;2021-07-11;1801;4336;16;0;0;3355022;2401854;8792;23;2
FR;2;2021-07-12;12959;37263;118;0;0;3367981;2439117;8910;23;2
FR;2;2021-07-13;37106;53232;150;0;0;3405087;2492349;9060;23;2
FR;2;2021-07-14;6601;3570;15;0;0;3411688;2495919;9075;23;2
FR;2;2021-07-15;47220;47026;156;0;0;3458908;2542945;9231;23;2
FR;2;2021-07-16;64303;55821;187;0;0;3523211;2598766;9418;23;2
FR;2;2021-07-17;31588;23931;96;0;0;3554799;2622697;9514;23;2
FR;2;2021-07-18;6085;4897;19;0;0;3560884;2627594;9533;23;2
FR;2;2021-07-19;32982;28686;93;0;0;3593866;2656280;9626;23;2
FR;2;2021-07-20;51982;44560;155;0;0;3645848;2700840;9781;23;2
FR;2;2021-07-21;45243;34783;93;0;0;3691091;2735623;9874;23;2
FR;2;2021-07-22;56266;41114;128;1;0;3747357;2776737;10002;24;2
FR;2;2021-07-23;68271;49093;170;0;0;3815628;2825830;10172;24;2
FR;2;2021-07-24;36160;21576;82;0;0;3851788;2847406;10254;24;2
FR;2;2021-07-25;6736;2658;10;0;0;3858524;2850064;10264;24;2
FR;2;2021-07-26;36286;22469;91;1;0;3894810;2872533;10355;25;2
FR;2;2021-07-27;62342;34628;180;0;0;3957152;2907161;10535;25;2
FR;2;2021-07-28;55278;26460;133;0;0;4012430;2933621;10668;25;2
FR;2;2021-07-29;68434;32774;189;0;0;4080864;2966395;10857;25;2
FR;2;2021-07-30;74415;37775;222;1;1;4155279;3004170;11079;26;3
FR;2;2021-07-31;34744;16173;104;0;0;4190023;3020343;11183;26;3
FR;2;2021-08-01;5393;2292;19;0;0;4195416;3022635;11202;26;3
FR;2;2021-08-02;35848;16205;101;0;0;4231264;3038840;11303;26;3
FR;2;2021-08-03;55946;28281;142;0;0;4287210;3067121;11445;26;3
FR;2;2021-08-04;46615;20861;128;0;0;4333825;3087982;11573;26;3
FR;2;2021-08-05;54600;31582;215;0;0;4388425;3119564;11788;26;3
FR;2;2021-08-06;58065;42384;242;1;0;4446490;3161948;12030;27;3
FR;2;2021-08-07;25130;17600;89;0;0;4471620;3179548;12119;27;3
FR;2;2021-08-08;3831;3671;21;0;0;4475451;3183219;12140;27;3
FR;2;2021-08-09;29281;21135;91;0;0;4504732;3204354;12231;27;3
FR;2;2021-08-10;44977;33513;152;0;0;4549709;3237867;12383;27;3
FR;2;2021-08-11;35258;25163;150;0;0;4584967;3263030;12533;27;3
FR;2;2021-08-12;41874;35733;162;0;0;4626841;3298763;12695;27;3
FR;2;2021-08-13;42578;37013;218;0;0;4669419;3335776;12913;27;3
FR;2;2021-08-14;18502;22265;93;0;0;4687921;3358041;13006;27;3
FR;2;2021-08-15;3791;3814;17;0;0;4691712;3361855;13023;27;3
FR;2;2021-08-16;25070;27220;110;0;0;4716782;3389075;13133;27;3
FR;2;2021-08-17;38246;43482;205;1;0;4755028;3432557;13338;28;3
FR;2;2021-08-18;32241;36385;192;1;1;4787269;3468942;13530;29;4
FR;2;2021-08-19;37423;46601;224;0;0;4824692;3515543;13754;29;4
FR;2;2021-08-20;40550;55581;269;1;0;4865242;3571124;14023;30;4
FR;2;2021-08-21;18112;24295;113;0;0;4883354;3595419;14136;30;4
FR;2;2021-08-22;2901;4324;22;1;1;4886255;3599743;14158;31;5
FR;2;2021-08-23;19237;35150;131;1;1;4905492;3634893;14289;32;6
FR;2;2021-08-24;31932;56027;234;0;0;4937424;3690920;14523;32;6
FR;2;2021-08-25;25925;43422;250;0;0;4963349;3734342;14773;32;6
FR;2;2021-08-26;32339;55773;387;0;0;4995688;3790115;15160;32;6
FR;2;2021-08-27;36992;65561;477;3;1;5032680;3855676;15637;35;7
FR;2;2021-08-28;17808;28459;300;0;0;5050488;3884135;15937;35;7
FR;2;2021-08-29;2654;5032;47;0;0;5053142;3889167;15984;35;7
FR;2;2021-08-30;18407;37748;399;0;761;5071549;3926915;16383;35;768
FR;2;2021-08-31;28071;57503;881;4;1533;5099620;3984418;17264;39;2301
FR;2;2021-09-01;21582;39817;1305;0;2084;5121202;4024235;18569;39;4385
FR;2;2021-09-02;25474;48592;1957;2;3268;5146676;4072827;20526;41;7653
FR;2;2021-09-03;33403;64465;2986;3;4813;5180079;4137292;23512;44;12466
FR;2;2021-09-04;16822;27674;1441;1;2341;5196901;4164966;24953;45;14807
FR;2;2021-09-05;2257;3620;263;0;412;5199158;4168586;25216;45;15219
FR;2;2021-09-06;14029;28734;1768;1;2929;5213187;4197320;26984;46;18148
FR;2;2021-09-07;21094;41045;3019;13;4842;5234281;4238365;30003;59;22990
FR;2;2021-09-08;17236;31909;2729;6;4436;5251517;4270274;32732;65;27426
FR;2;2021-09-09;20967;40431;4426;3;6718;5272484;4310705;37158;68;34144
FR;2;2021-09-10;28186;51092;5278;4;8775;5300670;4361797;42436;72;42919
FR;2;2021-09-11;13649;22329;2401;5;3915;5314319;4384126;44837;77;46834
FR;2;2021-09-12;1821;2795;282;0;502;5316140;4386921;45119;77;47336
FR;2;2021-09-13;11655;21451;2465;4;3991;5327795;4408372;47584;81;51327
FR;2;2021-09-14;18564;32772;5080;13;9001;5346359;4441144;52664;94;60328
FR;2;2021-09-15;14908;28282;5163;3;7778;5361267;4469426;57827;97;68106
FR;2;2021-09-16;16063;32751;6731;14;10514;5377330;4502177;64558;111;78620
FR;2;2021-09-17;20907;47068;8773;10;14559;5398237;4549245;73331;121;93179
FR;2;2021-09-18;9852;20917;3801;6;6022;5408089;4570162;77132;127;99201
FR;2;2021-09-19;1164;2656;395;0;650;5409253;4572818;77527;127;99851
FR;2;2021-09-20;7486;18805;3850;7;6148;5416739;4591623;81377;134;105999
FR;2;2021-09-21;11201;30010;6492;5;10736;5427940;4621633;87869;139;116735
FR;2;2021-09-22;9405;23546;5489;7;8509;5437345;4645179;93358;146;125244
FR;2;2021-09-23;10718;28864;7876;9;12630;5448063;4674043;101234;155;137874
FR;2;2021-09-24;15060;42821;10865;18;17149;5463123;4716864;112099;173;155023
FR;2;2021-09-25;7257;18706;3959;10;6071;5470380;4735570;116058;183;161094
FR;2;2021-09-26;1078;2563;494;0;637;5471458;4738133;116552;183;161731
FR;2;2021-09-27;6308;16448;4285;7;6549;5477766;4754581;120837;190;168280
FR;2;2021-09-28;9240;25535;7759;13;12053;5487006;4780116;128596;203;180333
FR;2;2021-09-29;8077;20208;6065;25;9251;5495083;4800324;134661;228;189584
FR;2;2021-09-30;9862;25777;9495;16;14071;5504945;4826101;144156;244;203655
FR;2;2021-10-01;13962;35616;12905;25;19213;5518907;4861717;157061;269;222868
FR;2;2021-10-02;6869;15863;4843;6;6992;5525776;4877580;161904;275;229860
FR;2;2021-10-03;841;1961;490;1;517;5526617;4879541;162394;276;230377
FR;2;2021-10-04;5816;13927;5512;5;7857;5532433;4893468;167906;281;238234
FR;2;2021-10-05;9047;22532;11119;19;15705;5541480;4916000;179025;300;253939
FR;2;2021-10-06;7777;17746;8236;11;11060;5549257;4933746;187261;311;264999
FR;2;2021-10-07;9193;22183;12369;15;16814;5558450;4955929;199630;326;281813
FR;2;2021-10-08;13420;32020;17344;27;23509;5571870;4987949;216974;353;305322
FR;2;2021-10-09;5996;12817;6039;6;7871;5577866;5000766;223013;359;313193
FR;2;2021-10-10;881;1636;435;2;630;5578747;5002402;223448;361;313823
FR;2;2021-10-11;5601;11615;6454;17;8837;5584348;5014017;229902;378;322660
FR;2;2021-10-12;8031;17752;12532;13;16722;5592379;5031769;242434;391;339382
FR;2;2021-10-13;6936;14849;10244;11;13596;5599315;5046618;252678;402;352978
FR;2;2021-10-14;8312;17924;14984;13;19437;5607627;5064542;267662;415;372415
FR;2;2021-10-15;11842;26255;20893;26;27922;5619469;5090797;288555;441;400337
FR;2;2021-10-16;5136;8730;1815;0;3205;5624605;5099527;290370;441;403542
FR;2;2021-10-17;650;1196;183;0;377;5625255;5100723;290553;441;403919
FR;2;2021-10-18;4555;7434;659;2;1679;5629810;5108157;291212;443;405598
FR;2;2021-10-19;6236;9913;728;5;2067;5636046;5118070;291940;448;407665
FR;2;2021-10-20;5159;8115;756;3;1685;5641205;5126185;292696;451;409350
FR;2;2021-10-21;6086;9968;777;5;2090;5647291;5136153;293473;456;411440
FR;2;2021-10-22;8442;14546;1140;4;2861;5655733;5150699;294613;460;414301
FR;2;2021-10-23;3840;5998;580;0;1237;5659573;5156697;295193;460;415538
FR;2;2021-10-24;493;882;99;0;199;5660066;5157579;295292;460;415737
FR;2;2021-10-25;3358;5387;296;1;827;5663424;5162966;295588;461;416564
FR;2;2021-10-26;4172;7248;1118;4;1993;5667596;5170214;296706;465;418557
FR;2;2021-10-27;3671;6633;1191;5;2000;5671267;5176847;297897;470;420557
FR;2;2021-10-28;4594;7692;1724;3;2734;5675861;5184539;299621;473;423291
FR;2;2021-10-29;5406;11077;2427;4;3663;5681267;5195616;302048;477;426954
FR;2;2021-10-30;2748;4428;971;1;1426;5684015;5200044;303019;478;428380
FR;2;2021-10-31;364;551;138;1;187;5684379;5200595;303157;479;428567
FR;2;2021-11-01;411;555;170;0;260;5684790;5201150;303327;479;428827
FR;2;2021-11-02;3285;6766;1177;0;1757;5688075;5207916;304504;479;430584
FR;2;2021-11-03;3332;6255;1380;2;1964;5691407;5214171;305884;481;432548
FR;2;2021-11-04;3984;7106;1756;4;2487;5695391;5221277;307640;485;435035
FR;2;2021-11-05;5220;10496;2862;5;3939;5700611;5231773;310502;490;438974
FR;2;2021-11-06;2589;4653;1396;0;1802;5703200;5236426;311898;490;440776
FR;2;2021-11-07;507;872;215;0;288;5703707;5237298;312113;490;441064
FR;2;2021-11-08;2575;5384;1199;3;1683;5706282;5242682;313312;493;442747
FR;2;2021-11-09;2748;6958;2389;6;3171;5709030;5249640;315701;499;445918
FR;2;2021-11-10;2582;5711;5087;6;6257;5711612;5255351;320788;505;452175
FR;2;2021-11-11;432;735;730;2;909;5712044;5256086;321518;507;453084
FR;2;2021-11-12;2946;8109;8958;8;10891;5714990;5264195;330476;515;463975
FR;2;2021-11-13;1529;3366;3864;7;4521;5716519;5267561;334340;522;468496
FR;2;2021-11-14;253;614;345;1;488;5716772;5268175;334685;523;468984
FR;2;2021-11-15;1618;3714;4432;9;5324;5718390;5271889;339117;532;474308
FR;2;2021-11-16;2181;5955;8285;14;10062;5720571;5277844;347402;546;484370
FR;2;2021-11-17;1736;4576;6614;8;7832;5722307;5282420;354016;554;492202
FR;2;2021-11-18;2186;5944;9166;11;10984;5724493;5288364;363182;565;503186
FR;2;2021-11-19;2696;7790;12954;19;15459;5727189;5296154;376136;584;518645
FR;2;2021-11-20;1565;3316;5164;5;6061;5728754;5299470;381300;589;524706
FR;2;2021-11-21;246;522;539;0;665;5729000;5299992;381839;589;525371
FR;2;2021-11-22;1274;2633;4466;5;5398;5730274;5302625;386305;594;530769
FR;2;2021-11-23;1612;4322;8183;9;9886;5731886;5306947;394488;603;540655
FR;2;2021-11-24;1420;3808;7455;15;8710;5733306;5310755;401943;618;549365
FR;2;2021-11-25;1809;4898;11441;21;13635;5735115;5315653;413384;639;563000
FR;2;2021-11-26;2533;7784;22640;31;26057;5737648;5323437;436024;670;589057
FR;2;2021-11-27;1497;4134;12254;18;13989;5739145;5327571;448278;688;603046
FR;2;2021-11-28;292;844;1965;3;2292;5739437;5328415;450243;691;605338
FR;2;2021-11-29;1444;4386;15069;23;17230;5740881;5332801;465312;714;622568
FR;2;2021-11-30;1910;6762;26218;36;29974;5742791;5339563;491530;750;652542
FR;2;2021-12-01;1899;6095;26181;29;29495;5744690;5345658;517711;779;682037
FR;2;2021-12-02;1909;6828;37679;52;41918;5746599;5352486;555390;831;723955
FR;2;2021-12-03;2548;10090;53583;112;59292;5749147;5362576;608973;943;783247
FR;2;2021-12-04;1847;6270;37083;38;40739;5750994;5368846;646056;981;823986
FR;2;2021-12-05;458;2291;14248;13;15991;5751452;5371137;660304;994;839977
FR;2;2021-12-06;2453;9895;77672;109;84730;5753905;5381032;737976;1103;924707
FR;2;2021-12-07;3441;15332;122405;238;133675;5757346;5396364;860381;1341;1058382
FR;2;2021-12-08;3716;16040;133161;330;145347;5761062;5412404;993542;1671;1203729
FR;2;2021-12-09;4544;19600;170126;554;185460;5765606;5432004;1163668;2225;1389189
FR;2;2021-12-10;4667;22802;188595;489;206011;5770273;5454806;1352263;2714;1595200
FR;2;2021-12-11;3681;16607;132417;238;144836;5773954;5471413;1484680;2952;1740036
FR;2;2021-12-12;1257;7142;59071;83;65130;5775211;5478555;1543751;3035;1805166
FR;2;2021-12-13;5523;26851;220637;604;242915;5780734;5505406;1764388;3639;2048081
FR;2;2021-12-14;7018;37502;300695;909;332140;5787752;5542908;2065083;4548;2380221
FR;2;2021-12-15;6559;36229;285151;955;315738;5794311;5579137;2350234;5503;2695959
FR;2;2021-12-16;7765;37928;312085;981;343678;5802076;5617065;2662319;6484;3039637
FR;2;2021-12-17;8683;41208;327813;975;360861;5810759;5658273;2990132;7459;3400498
FR;2;2021-12-18;6517;26567;212310;448;233614;5817276;5684840;3202442;7907;3634112
FR;2;2021-12-19;2602;11511;90195;184;100386;5819878;5696351;3292637;8091;3734498
FR;2;2021-12-20;9550;33601;275127;707;303300;5829428;5729952;3567764;8798;4037798
FR;2;2021-12-21;11555;38298;309565;970;341323;5840983;5768250;3877329;9768;4379121
FR;2;2021-12-22;10452;32881;265065;952;292462;5851435;5801131;4142394;10720;4671583
FR;2;2021-12-23;9429;26711;199439;700;221243;5860864;5827842;4341833;11420;4892826
FR;2;2021-12-24;2780;7506;43841;140;49563;5863644;5835348;4385674;11560;4942389
FR;2;2021-12-25;201;706;2000;10;2502;5863845;5836054;4387674;11570;4944891
FR;2;2021-12-26;1322;4212;25143;71;28679;5865167;5840266;4412817;11641;4973570
FR;2;2021-12-27;8077;29924;218372;658;243283;5873244;5870190;4631189;12299;5216853
FR;2;2021-12-28;9842;36344;272055;741;301945;5883086;5906534;4903244;13040;5518798
FR;2;2021-12-29;9492;32287;246090;766;272660;5892578;5938821;5149334;13806;5791458
FR;2;2021-12-30;9450;28133;208797;662;231459;5902028;5966954;5358131;14468;6022917
FR;2;2021-12-31;3009;8398;54972;177;61241;5905037;5975352;5413103;14645;6084158
FR;2;2022-01-01;227;690;2848;7;3336;5905264;5976042;5415951;14652;6087494
FR;2;2022-01-02;1505;4851;29505;74;33392;5906769;5980893;5445456;14726;6120886
FR;2;2022-01-03;9578;35338;266491;807;293841;5916347;6016231;5711947;15533;6414727
FR;2;2022-01-04;12838;45344;342048;1067;376923;5929185;6061575;6053995;16600;6791650
FR;2;2022-01-05;11270;38665;294120;884;323787;5940455;6100240;6348115;17484;7115437
FR;2;2022-01-06;13651;43458;331902;1296;364661;5954106;6143698;6680017;18780;7480098
FR;2;2022-01-07;14224;47616;361054;1268;396373;5968330;6191314;7041071;20048;7876471
FR;2;2022-01-08;7946;28139;201243;514;221663;5976276;6219453;7242314;20562;8098134
FR;2;2022-01-09;2749;9033;62513;137;69536;5979025;6228486;7304827;20699;8167670
FR;2;2022-01-10;10086;31918;232429;857;255030;5989111;6260404;7537256;21556;8422700
FR;2;2022-01-11;11463;36255;265852;1030;290548;6000574;6296659;7803108;22586;8713248
FR;2;2022-01-12;8755;29840;206282;861;226158;6009329;6326499;8009390;23447;8939406
FR;2;2022-01-13;9383;31333;224447;830;244793;6018712;6357832;8233837;24277;9184199
FR;2;2022-01-14;9739;35691;254497;919;277669;6028451;6393523;8488334;25196;9461868
FR;2;2022-01-15;5353;19443;140757;358;153623;6033804;6412966;8629091;25554;9615491
FR;2;2022-01-16;1513;5540;35862;80;39850;6035317;6418506;8664953;25634;9655341
FR;2;2022-01-17;5546;19310;135376;601;147244;6040863;6437816;8800329;26235;9802585
FR;2;2022-01-18;6416;21543;148594;647;160473;6047279;6459359;8948923;26882;9963058
FR;2;2022-01-19;4385;16376;105072;552;113683;6051664;6475735;9053995;27434;10076741
FR;2;2022-01-20;4865;17588;115259;601;123657;6056529;6493323;9169254;28035;10200398
FR;2;2022-01-21;5190;20059;137311;677;147729;6061719;6513382;9306565;28712;10348127
FR;2;2022-01-22;3026;10975;74248;259;80326;6064745;6524357;9380813;28971;10428453
FR;2;2022-01-23;722;2740;15233;41;16840;6065467;6527097;9396046;29012;10445293
FR;2;2022-01-24;3289;12839;75053;428;81008;6068756;6539936;9471099;29440;10526301
FR;2;2022-01-25;3573;14435;79601;495;85442;6072329;6554371;9550700;29935;10611743
FR;2;2022-01-26;2514;10654;58952;363;62982;6074843;6565025;9609652;30298;10674725
FR;2;2022-01-27;2683;11212;64153;388;67885;6077526;6576237;9673805;30686;10742610
FR;2;2022-01-28;3540;18439;91701;430;98961;6081066;6594676;9765506;31116;10841571
FR;2;2022-01-29;1890;9265;48831;163;52917;6082956;6603941;9814337;31279;10894488
FR;2;2022-01-30;466;2252;9453;37;10611;6083422;6606193;9823790;31316;10905099
FR;2;2022-01-31;1885;9610;43810;208;47340;6085307;6615803;9867600;31524;10952439
FR;2;2022-02-01;1907;10050;47014;278;50100;6087214;6625853;9914614;31802;11002539
FR;2;2022-02-02;1603;9032;41091;251;44159;6088817;6634885;9955705;32053;11046698
FR;2;2022-02-03;1715;8936;40500;204;42901;6090532;6643821;9996205;32257;11089599
FR;2;2022-02-04;2149;15225;66611;297;71337;6092681;6659046;10062816;32554;11160936
FR;2;2022-02-05;1360;8542;35929;131;39229;6094041;6667588;10098745;32685;11200165
FR;2;2022-02-06;274;1786;6122;16;6897;6094315;6669374;10104867;32701;11207062
FR;2;2022-02-07;1344;9613;37738;133;41300;6095659;6678987;10142605;32834;11248362
FR;2;2022-02-08;1295;9801;40923;173;43703;6096954;6688788;10183528;33007;11292065
FR;2;2022-02-09;1160;8801;37027;172;40442;6098114;6697589;10220555;33179;11332507
FR;2;2022-02-10;1015;7969;33825;203;36492;6099129;6705558;10254380;33382;11368999
FR;2;2022-02-11;1390;12074;53332;222;57676;6100519;6717632;10307712;33604;11426675
FR;2;2022-02-12;750;6523;27982;83;30799;6101269;6724155;10335694;33687;11457474
FR;2;2022-02-13;198;1333;4832;20;5572;6101467;6725488;10340526;33707;11463046
FR;2;2022-02-14;834;6721;30252;89;33217;6102301;6732209;10370778;33796;11496263
FR;2;2022-02-15;772;6444;28039;140;29978;6103073;6738653;10398817;33936;11526241
FR;2;2022-02-16;653;5335;22029;123;23586;6103726;6743988;10420846;34059;11549827
FR;2;2022-02-17;512;3766;14138;98;14601;6104238;6747754;10434984;34157;11564428
FR;2;2022-02-18;720;5356;20424;133;21118;6104958;6753110;10455408;34290;11585546
FR;2;2022-02-19;426;3040;10526;66;11235;6105384;6756150;10465934;34356;11596781
FR;2;2022-02-20;101;510;1455;3;1602;6105485;6756660;10467389;34359;11598383
FR;2;2022-02-21;416;2678;9107;65;9482;6105901;6759338;10476496;34424;11607865
FR;2;2022-02-22;390;2560;8886;75;8787;6106291;6761898;10485382;34499;11616652
FR;2;2022-02-23;430;2594;8978;82;9258;6106721;6764492;10494360;34581;11625910
FR;2;2022-02-24;312;2024;6790;81;6817;6107033;6766516;10501150;34662;11632727
FR;2;2022-02-25;454;3188;11405;108;11268;6107487;6769704;10512555;34770;11643995
FR;2;2022-02-26;290;1886;6032;49;6337;6107777;6771590;10518587;34819;11650332
FR;2;2022-02-27;72;309;902;5;944;6107849;6771899;10519489;34824;11651276
FR;2;2022-02-28;326;1673;5509;50;5515;6108175;6773572;10524998;34874;11656791
FR;2;2022-03-01;267;1548;5463;44;5178;6108442;6775120;10530461;34918;11661969
FR;2;2022-03-02;296;1428;5230;43;5071;6108738;6776548;10535691;34961;11667040
FR;2;2022-03-03;223;1091;3686;40;3464;6108961;6777639;10539377;35001;11670504
FR;2;2022-03-04;230;1455;4843;73;4488;6109191;6779094;10544220;35074;11674992
FR;2;2022-03-05;167;892;2969;31;2707;6109358;6779986;10547189;35105;11677699
FR;2;2022-03-06;36;176;269;5;309;6109394;6780162;10547458;35110;11678008
FR;2;2022-03-07;152;650;1977;68;1768;6109546;6780812;10549435;35178;11679776
FR;2;2022-03-08;140;648;2257;49;1890;6109686;6781460;10551692;35227;11681666
FR;2;2022-03-09;149;690;2327;36;2028;6109835;6782150;10554019;35263;11683694
FR;2;2022-03-10;113;584;1656;34;1429;6109948;6782734;10555675;35297;11685123
FR;2;2022-03-11;166;746;2759;57;2357;6110114;6783480;10558434;35354;11687480
FR;2;2022-03-12;140;473;1779;27;1547;6110254;6783953;10560213;35381;11689027
FR;2;2022-03-13;25;73;201;29;202;6110279;6784026;10560414;35410;11689229
FR;2;2022-03-14;119;447;1537;529;1266;6110398;6784473;10561951;35939;11690495
FR;2;2022-03-15;140;409;1686;687;1300;6110538;6784882;10563637;36626;11691795
FR;2;2022-03-16;136;445;1957;1610;1532;6110674;6785327;10565594;38236;11693327
FR;2;2022-03-17;92;404;1386;1190;1126;6110766;6785731;10566980;39426;11694453
FR;2;2022-03-18;139;480;1996;1786;1633;6110905;6786211;10568976;41212;11696086
FR;2;2022-03-19;106;318;1206;935;1012;6111011;6786529;10570182;42147;11697098
FR;2;2022-03-20;12;71;173;58;147;6111023;6786600;10570355;42205;11697245
FR;2;2022-03-21;94;288;1165;1475;1027;6111117;6786888;10571520;43680;11698272
FR;2;2022-03-22;113;371;1495;1826;1253;6111230;6787259;10573015;45506;11699525
FR;2;2022-03-23;134;325;1621;3019;1404;6111364;6787584;10574636;48525;11700929
FR;2;2022-03-24;105;271;1146;1532;951;6111469;6787855;10575782;50057;11701880
FR;2;2022-03-25;112;346;1727;2429;1409;6111581;6788201;10577509;52486;11703289
FR;2;2022-03-26;67;236;1171;1216;917;6111648;6788437;10578680;53702;11704206
FR;2;2022-03-27;17;36;141;93;120;6111665;6788473;10578821;53795;11704326
FR;2;2022-03-28;86;267;1101;1567;957;6111751;6788740;10579922;55362;11705283
FR;2;2022-03-29;98;241;1281;2392;1063;6111849;6788981;10581203;57754;11706346
FR;2;2022-03-30;84;279;1420;2989;1244;6111933;6789260;10582623;60743;11707590
FR;3;2020-12-27;0;0;0;0;0;0;0;0;0;0
FR;3;2020-12-28;0;0;0;0;0;0;0;0;0;0
FR;3;2020-12-29;0;0;0;0;0;0;0;0;0;0
FR;3;2020-12-30;0;0;0;0;0;0;0;0;0;0
FR;3;2020-12-31;0;0;0;0;0;0;0;0;0;0
FR;3;2021-01-01;0;0;0;0;0;0;0;0;0;0
FR;3;2021-01-02;0;0;0;0;0;0;0;0;0;0
FR;3;2021-01-03;0;0;0;0;0;0;0;0;0;0
FR;3;2021-01-04;0;0;0;0;0;0;0;0;0;0
FR;3;2021-01-05;0;0;0;0;0;0;0;0;0;0
FR;3;2021-01-06;0;0;0;0;0;0;0;0;0;0
FR;3;2021-01-07;0;0;0;0;0;0;0;0;0;0
FR;3;2021-01-08;0;0;0;0;0;0;0;0;0;0
FR;3;2021-01-09;0;0;0;0;0;0;0;0;0;0
FR;3;2021-01-10;0;0;0;0;0;0;0;0;0;0
FR;3;2021-01-11;0;0;0;0;0;0;0;0;0;0
FR;3;2021-01-12;0;0;0;0;0;0;0;0;0;0
FR;3;2021-01-13;0;0;0;0;0;0;0;0;0;0
FR;3;2021-01-14;0;0;0;0;0;0;0;0;0;0
FR;3;2021-01-15;0;0;0;0;0;0;0;0;0;0
FR;3;2021-01-16;0;0;0;0;0;0;0;0;0;0
FR;3;2021-01-17;0;0;0;0;0;0;0;0;0;0
FR;3;2021-01-18;0;0;0;0;0;0;0;0;0;0
FR;3;2021-01-19;0;0;0;0;0;0;0;0;0;0
FR;3;2021-01-20;0;0;0;0;0;0;0;0;0;0
FR;3;2021-01-21;0;0;0;0;0;0;0;0;0;0
FR;3;2021-01-22;0;0;0;0;0;0;0;0;0;0
FR;3;2021-01-23;0;0;0;0;0;0;0;0;0;0
FR;3;2021-01-24;0;0;0;0;0;0;0;0;0;0
FR;3;2021-01-25;0;0;0;0;0;0;0;0;0;0
FR;3;2021-01-26;0;0;0;0;0;0;0;0;0;0
FR;3;2021-01-27;0;0;0;0;0;0;0;0;0;0
FR;3;2021-01-28;0;0;0;0;0;0;0;0;0;0
FR;3;2021-01-29;0;0;0;0;0;0;0;0;0;0
FR;3;2021-01-30;0;0;0;0;0;0;0;0;0;0
FR;3;2021-01-31;0;0;0;0;0;0;0;0;0;0
FR;3;2021-02-01;0;0;0;0;0;0;0;0;0;0
FR;3;2021-02-02;0;0;0;0;0;0;0;0;0;0
FR;3;2021-02-03;0;0;0;0;0;0;0;0;0;0
FR;3;2021-02-04;0;0;0;0;0;0;0;0;0;0
FR;3;2021-02-05;0;0;0;0;0;0;0;0;0;0
FR;3;2021-02-06;1704;0;0;0;0;1704;0;0;0;0
FR;3;2021-02-07;1422;0;0;0;0;3126;0;0;0;0
FR;3;2021-02-08;2779;0;0;0;0;5905;0;0;0;0
FR;3;2021-02-09;6780;0;0;0;0;12685;0;0;0;0
FR;3;2021-02-10;9601;0;0;0;0;22286;0;0;0;0
FR;3;2021-02-11;13607;0;0;0;0;35893;0;0;0;0
FR;3;2021-02-12;13393;0;0;0;0;49286;0;0;0;0
FR;3;2021-02-13;3778;0;0;0;0;53064;0;0;0;0
FR;3;2021-02-14;972;0;0;0;0;54036;0;0;0;0
FR;3;2021-02-15;10476;0;0;0;0;64512;0;0;0;0
FR;3;2021-02-16;12541;0;0;0;0;77053;0;0;0;0
FR;3;2021-02-17;11147;0;0;0;0;88200;0;0;0;0
FR;3;2021-02-18;14933;0;0;0;0;103133;0;0;0;0
FR;3;2021-02-19;14357;1;0;0;0;117490;1;0;0;0
FR;3;2021-02-20;3329;0;0;0;0;120819;1;0;0;0
FR;3;2021-02-21;618;0;0;0;0;121437;1;0;0;0
FR;3;2021-02-22;9159;0;0;0;0;130596;1;0;0;0
FR;3;2021-02-23;11394;1;0;0;0;141990;2;0;0;0
FR;3;2021-02-24;14297;0;0;0;0;156287;2;0;0;0
FR;3;2021-02-25;44927;0;0;0;0;201214;2;0;0;0
FR;3;2021-02-26;61881;0;0;0;0;263095;2;0;0;0
FR;3;2021-02-27;34800;5;0;0;0;297895;7;0;0;0
FR;3;2021-02-28;2463;0;0;0;0;300358;7;0;0;0
FR;3;2021-03-01;20503;9;0;0;0;320861;16;0;0;0
FR;3;2021-03-02;38859;17;0;0;0;359720;33;0;0;0
FR;3;2021-03-03;48725;16;0;0;0;408445;49;0;0;0
FR;3;2021-03-04;82210;19;0;0;0;490655;68;0;0;0
FR;3;2021-03-05;118120;37;0;0;0;608775;105;0;0;0
FR;3;2021-03-06;120708;49;1;0;0;729483;154;1;0;0
FR;3;2021-03-07;55173;26;0;0;0;784656;180;1;0;0
FR;3;2021-03-08;42805;23;0;0;0;827461;203;1;0;0
FR;3;2021-03-09;78969;39;0;0;0;906430;242;1;0;0
FR;3;2021-03-10;80960;42;0;0;0;987390;284;1;0;0
FR;3;2021-03-11;128410;48;0;0;0;1115800;332;1;0;0
FR;3;2021-03-12;182712;75;0;0;0;1298512;407;1;0;0
FR;3;2021-03-13;132138;56;0;0;0;1430650;463;1;0;0
FR;3;2021-03-14;14054;4;0;0;0;1444704;467;1;0;0
FR;3;2021-03-15;52217;40;0;0;0;1496921;507;1;0;0
FR;3;2021-03-16;1207;16;0;0;0;1498128;523;1;0;0
FR;3;2021-03-17;940;17;0;0;0;1499068;540;1;0;0
FR;3;2021-03-18;1563;9;0;0;0;1500631;549;1;0;0
FR;3;2021-03-19;70441;43;0;0;0;1571072;592;1;0;0
FR;3;2021-03-20;65224;40;0;0;0;1636296;632;1;0;0
FR;3;2021-03-21;5754;4;0;0;0;1642050;636;1;0;0
FR;3;2021-03-22;37492;36;0;0;0;1679542;672;1;0;0
FR;3;2021-03-23;84646;59;0;0;0;1764188;731;1;0;0
FR;3;2021-03-24;90927;90;0;0;0;1855115;821;1;0;0
FR;3;2021-03-25;150037;122;0;0;0;2005152;943;1;0;0
FR;3;2021-03-26;165407;149;0;0;0;2170559;1092;1;0;0
FR;3;2021-03-27;68453;94;0;0;0;2239012;1186;1;0;0
FR;3;2021-03-28;6468;19;0;0;0;2245480;1205;1;0;0
FR;3;2021-03-29;54150;68;0;0;0;2299630;1273;1;0;0
FR;3;2021-03-30;93154;96;0;0;0;2392784;1369;1;0;0
FR;3;2021-03-31;63517;84;0;0;0;2456301;1453;1;0;0
FR;3;2021-04-01;86116;101;0;0;0;2542417;1554;1;0;0
FR;3;2021-04-02;86882;146;0;0;0;2629299;1700;1;0;0
FR;3;2021-04-03;35866;113;0;0;0;2665165;1813;1;0;0
FR;3;2021-04-04;3569;14;0;0;0;2668734;1827;1;0;0
FR;3;2021-04-05;4481;26;0;0;0;2673215;1853;1;0;0
FR;3;2021-04-06;29737;78;0;0;0;2702952;1931;1;0;0
FR;3;2021-04-07;32333;70;0;0;0;2735285;2001;1;0;0
FR;3;2021-04-08;78804;235;0;0;0;2814089;2236;1;0;0
FR;3;2021-04-09;161745;409;0;0;0;2975834;2645;1;0;0
FR;3;2021-04-10;75750;331;0;0;0;3051584;2976;1;0;0
FR;3;2021-04-11;7307;44;0;0;0;3058891;3020;1;0;0
FR;3;2021-04-12;51464;200;0;0;0;3110355;3220;1;0;0
FR;3;2021-04-13;86215;312;0;0;0;3196570;3532;1;0;0
FR;3;2021-04-14;67832;337;0;0;0;3264402;3869;1;0;0
FR;3;2021-04-15;93219;365;0;0;0;3357621;4234;1;0;0
FR;3;2021-04-16;112513;565;0;0;0;3470134;4799;1;0;0
FR;3;2021-04-17;53311;318;1;0;0;3523445;5117;2;0;0
FR;3;2021-04-18;9741;32;0;0;0;3533186;5149;2;0;0
FR;3;2021-04-19;25101;234;0;0;0;3558287;5383;2;0;0
FR;3;2021-04-20;45667;391;0;0;0;3603954;5774;2;0;0
FR;3;2021-04-21;38960;456;0;0;0;3642914;6230;2;0;0
FR;3;2021-04-22;54697;776;0;0;0;3697611;7006;2;0;0
FR;3;2021-04-23;70477;1009;0;0;0;3768088;8015;2;0;0
FR;3;2021-04-24;37240;971;0;0;0;3805328;8986;2;0;0
FR;3;2021-04-25;6200;157;0;0;0;3811528;9143;2;0;0
FR;3;2021-04-26;19781;646;0;0;0;3831309;9789;2;0;0
FR;3;2021-04-27;34467;1248;0;0;0;3865776;11037;2;0;0
FR;3;2021-04-28;28955;1925;0;0;0;3894731;12962;2;0;0
FR;3;2021-04-29;45371;5946;0;0;0;3940102;18908;2;0;0
FR;3;2021-04-30;55451;8911;1;0;0;3995553;27819;3;0;0
FR;3;2021-05-01;9507;1963;0;0;0;4005060;29782;3;0;0
FR;3;2021-05-02;3069;491;0;0;0;4008129;30273;3;0;0
FR;3;2021-05-03;13053;3882;0;0;0;4021182;34155;3;0;0
FR;3;2021-05-04;23107;8394;0;0;0;4044289;42549;3;0;0
FR;3;2021-05-05;18746;10568;0;0;0;4063035;53117;3;0;0
FR;3;2021-05-06;34613;20869;0;0;0;4097648;73986;3;0;0
FR;3;2021-05-07;44196;28369;0;0;0;4141844;102355;3;0;0
FR;3;2021-05-08;6776;8838;0;0;0;4148620;111193;3;0;0
FR;3;2021-05-09;1792;2653;0;0;0;4150412;113846;3;0;0
FR;3;2021-05-10;14984;12546;0;0;0;4165396;126392;3;0;0
FR;3;2021-05-11;27090;25703;0;0;0;4192486;152095;3;0;0
FR;3;2021-05-12;17262;27429;0;0;0;4209748;179524;3;0;0
FR;3;2021-05-13;2275;3481;0;0;0;4212023;183005;3;0;0
FR;3;2021-05-14;14510;25704;0;0;0;4226533;208709;3;0;0
FR;3;2021-05-15;7228;20725;0;0;0;4233761;229434;3;0;0
FR;3;2021-05-16;973;2674;0;0;0;4234734;232108;3;0;0
FR;3;2021-05-17;7954;19904;0;0;0;4242688;252012;3;0;0
FR;3;2021-05-18;13402;29612;0;0;0;4256090;281624;3;0;0
FR;3;2021-05-19;9260;31795;0;0;0;4265350;313419;3;0;0
FR;3;2021-05-20;12799;53162;3;0;0;4278149;366581;6;0;0
FR;3;2021-05-21;12759;65464;2;0;0;4290908;432045;8;0;0
FR;3;2021-05-22;4958;33257;1;0;0;4295866;465302;9;0;0
FR;3;2021-05-23;649;2662;0;0;0;4296515;467964;9;0;0
FR;3;2021-05-24;875;4922;0;0;0;4297390;472886;9;0;0
FR;3;2021-05-25;5293;45145;1;0;0;4302683;518031;10;0;0
FR;3;2021-05-26;4965;51012;1;0;0;4307648;569043;11;0;0
FR;3;2021-05-27;6318;77757;3;0;0;4313966;646800;14;0;0
FR;3;2021-05-28;7539;99007;2;0;0;4321505;745807;16;0;0
FR;3;2021-05-29;3344;60229;1;0;0;4324849;806036;17;0;0
FR;3;2021-05-30;544;8232;0;0;0;4325393;814268;17;0;0
FR;3;2021-05-31;2429;35938;3;0;0;4327822;850206;20;0;0
FR;3;2021-06-01;3394;64748;10;0;0;4331216;914954;30;0;0
FR;3;2021-06-02;2721;58279;6;0;0;4333937;973233;36;0;0
FR;3;2021-06-03;3489;87489;10;0;0;4337426;1060722;46;0;0
FR;3;2021-06-04;4103;105025;22;0;0;4341529;1165747;68;0;0
FR;3;2021-06-05;1967;52207;4;0;0;4343496;1217954;72;0;0
FR;3;2021-06-06;503;5397;1;0;0;4343999;1223351;73;0;0
FR;3;2021-06-07;1460;31138;11;0;0;4345459;1254489;84;0;0
FR;3;2021-06-08;2043;47222;18;0;0;4347502;1301711;102;0;0
FR;3;2021-06-09;1782;42354;13;0;0;4349284;1344065;115;0;0
FR;3;2021-06-10;2240;67906;17;0;0;4351524;1411971;132;0;0
FR;3;2021-06-11;2467;96706;34;0;0;4353991;1508677;166;0;0
FR;3;2021-06-12;1171;40815;6;0;0;4355162;1549492;172;0;0
FR;3;2021-06-13;275;3818;3;0;0;4355437;1553310;175;0;0
FR;3;2021-06-14;1035;42622;17;0;0;4356472;1595932;192;0;0
FR;3;2021-06-15;1362;80613;20;0;0;4357834;1676545;212;0;0
FR;3;2021-06-16;1251;65714;19;0;0;4359085;1742259;231;0;0
FR;3;2021-06-17;1654;101764;41;0;0;4360739;1844023;272;0;0
FR;3;2021-06-18;1867;117841;61;0;0;4362606;1961864;333;0;0
FR;3;2021-06-19;800;39360;22;0;0;4363406;2001224;355;0;0
FR;3;2021-06-20;158;3389;0;0;0;4363564;2004613;355;0;0
FR;3;2021-06-21;761;39260;16;0;0;4364325;2043873;371;0;0
FR;3;2021-06-22;1060;69959;52;0;0;4365385;2113832;423;0;0
FR;3;2021-06-23;940;50802;38;0;0;4366325;2164634;461;0;0
FR;3;2021-06-24;1302;77130;48;0;0;4367627;2241764;509;0;0
FR;3;2021-06-25;1399;89901;73;0;0;4369026;2331665;582;0;0
FR;3;2021-06-26;624;33127;29;0;0;4369650;2364792;611;0;0
FR;3;2021-06-27;163;4013;1;0;0;4369813;2368805;612;0;0
FR;3;2021-06-28;646;30425;27;0;0;4370459;2399230;639;0;0
FR;3;2021-06-29;851;56132;95;0;0;4371310;2455362;734;0;0
FR;3;2021-06-30;897;45061;93;0;0;4372207;2500423;827;0;0
FR;3;2021-07-01;1159;65634;108;0;0;4373366;2566057;935;0;0
FR;3;2021-07-02;1291;90352;170;0;0;4374657;2656409;1105;0;0
FR;3;2021-07-03;600;31168;52;0;0;4375257;2687577;1157;0;0
FR;3;2021-07-04;140;4277;3;0;0;4375397;2691854;1160;0;0
FR;3;2021-07-05;605;33911;60;0;0;4376002;2725765;1220;0;0
FR;3;2021-07-06;952;56064;88;0;0;4376954;2781829;1308;0;0
FR;3;2021-07-07;868;43047;79;0;0;4377822;2824876;1387;0;0
FR;3;2021-07-08;1123;60708;99;0;0;4378945;2885584;1486;0;0
FR;3;2021-07-09;1258;68800;128;0;0;4380203;2954384;1614;0;0
FR;3;2021-07-10;639;25042;59;0;0;4380842;2979426;1673;0;0
FR;3;2021-07-11;127;3310;4;0;0;4380969;2982736;1677;0;0
FR;3;2021-07-12;658;23890;59;0;0;4381627;3006626;1736;0;0
FR;3;2021-07-13;1643;34738;90;0;0;4383270;3041364;1826;0;0
FR;3;2021-07-14;260;2648;2;0;0;4383530;3044012;1828;0;0
FR;3;2021-07-15;1930;30674;85;0;0;4385460;3074686;1913;0;0
FR;3;2021-07-16;2518;38870;122;0;0;4387978;3113556;2035;0;0
FR;3;2021-07-17;1042;13751;26;0;0;4389020;3127307;2061;0;0
FR;3;2021-07-18;261;2621;3;0;0;4389281;3129928;2064;0;0
FR;3;2021-07-19;1270;17221;37;0;0;4390551;3147149;2101;0;0
FR;3;2021-07-20;1819;27157;98;0;0;4392370;3174306;2199;0;0
FR;3;2021-07-21;1643;19732;44;0;0;4394013;3194038;2243;0;0
FR;3;2021-07-22;1846;27772;82;0;0;4395859;3221810;2325;0;0
FR;3;2021-07-23;2211;30453;117;0;0;4398070;3252263;2442;0;0
FR;3;2021-07-24;819;7012;25;0;0;4398889;3259275;2467;0;0
FR;3;2021-07-25;208;1355;1;0;0;4399097;3260630;2468;0;0
FR;3;2021-07-26;919;10716;28;0;0;4400016;3271346;2496;0;0
FR;3;2021-07-27;1164;16956;56;0;0;4401180;3288302;2552;0;0
FR;3;2021-07-28;985;12116;40;0;0;4402165;3300418;2592;0;0
FR;3;2021-07-29;1126;15854;63;0;0;4403291;3316272;2655;0;0
FR;3;2021-07-30;1123;18114;79;0;0;4404414;3334386;2734;0;0
FR;3;2021-07-31;405;3743;15;0;0;4404819;3338129;2749;0;0
FR;3;2021-08-01;111;484;1;0;0;4404930;3338613;2750;0;0
FR;3;2021-08-02;416;5160;22;0;0;4405346;3343773;2772;0;0
FR;3;2021-08-03;485;7602;27;0;0;4405831;3351375;2799;0;0
FR;3;2021-08-04;434;4900;26;0;0;4406265;3356275;2825;0;0
FR;3;2021-08-05;427;3746;12;0;0;4406692;3360021;2837;0;0
FR;3;2021-08-06;450;4800;30;0;0;4407142;3364821;2867;0;0
FR;3;2021-08-07;213;1919;11;0;0;4407355;3366740;2878;0;0
FR;3;2021-08-08;242;430;2;0;0;4407597;3367170;2880;0;0
FR;3;2021-08-09;310;2521;11;0;0;4407907;3369691;2891;0;0
FR;3;2021-08-10;357;3891;15;0;0;4408264;3373582;2906;0;0
FR;3;2021-08-11;284;2727;15;0;0;4408548;3376309;2921;0;0
FR;3;2021-08-12;273;2635;12;0;0;4408821;3378944;2933;0;0
FR;3;2021-08-13;274;2266;16;0;0;4409095;3381210;2949;0;0
FR;3;2021-08-14;167;925;1;0;0;4409262;3382135;2950;0;0
FR;3;2021-08-15;55;168;0;0;0;4409317;3382303;2950;0;0
FR;3;2021-08-16;122;1095;8;0;0;4409439;3383398;2958;0;0
FR;3;2021-08-17;186;1511;8;0;0;4409625;3384909;2966;0;0
FR;3;2021-08-18;191;1374;10;0;0;4409816;3386283;2976;0;0
FR;3;2021-08-19;161;1435;10;0;0;4409977;3387718;2986;0;0
FR;3;2021-08-20;162;1638;16;0;0;4410139;3389356;3002;0;0
FR;3;2021-08-21;93;587;2;0;0;4410232;3389943;3004;0;0
FR;3;2021-08-22;38;187;1;0;0;4410270;3390130;3005;0;0
FR;3;2021-08-23;139;941;7;0;0;4410409;3391071;3012;0;0
FR;3;2021-08-24;123;968;10;0;0;4410532;3392039;3022;0;0
FR;3;2021-08-25;135;852;2;0;0;4410667;3392891;3024;0;0
FR;3;2021-08-26;168;875;9;0;0;4410835;3393766;3033;0;0
FR;3;2021-08-27;171;967;9;0;0;4411006;3394733;3042;0;0
FR;3;2021-08-28;95;370;4;0;0;4411101;3395103;3046;0;0
FR;3;2021-08-29;124;134;1;0;0;4411225;3395237;3047;0;0
FR;3;2021-08-30;94;600;0;0;137;4411319;3395837;3047;0;137
FR;3;2021-08-31;125;717;7;0;158;4411444;3396554;3054;0;295
FR;3;2021-09-01;113;483;5;0;126;4411557;3397037;3059;0;421
FR;3;2021-09-02;99;636;22;0;123;4411656;3397673;3081;0;544
FR;3;2021-09-03;112;592;17;0;131;4411768;3398265;3098;0;675
FR;3;2021-09-04;51;298;3;0;59;4411819;3398563;3101;0;734
FR;3;2021-09-05;51;69;5;0;30;4411870;3398632;3106;0;764
FR;3;2021-09-06;111;405;4;0;151;4411981;3399037;3110;0;915
FR;3;2021-09-07;118;481;14;0;133;4412099;3399518;3124;0;1048
FR;3;2021-09-08;114;369;2;0;105;4412213;3399887;3126;0;1153
FR;3;2021-09-09;87;400;8;0;117;4412300;3400287;3134;0;1270
FR;3;2021-09-10;97;426;3;0;105;4412397;3400713;3137;0;1375
FR;3;2021-09-11;73;234;4;0;65;4412470;3400947;3141;0;1440
FR;3;2021-09-12;36;49;1;0;17;4412506;3400996;3142;0;1457
FR;3;2021-09-13;65;331;7;0;112;4412571;3401327;3149;0;1569
FR;3;2021-09-14;66;294;6;0;107;4412637;3401621;3155;0;1676
FR;3;2021-09-15;57;263;3;0;6;4412694;3401884;3158;0;1682
FR;3;2021-09-16;59;342;5;0;5;4412753;3402226;3163;0;1687
FR;3;2021-09-17;49;350;3;0;7;4412802;3402576;3166;0;1694
FR;3;2021-09-18;34;178;1;0;1;4412836;3402754;3167;0;1695
FR;3;2021-09-19;27;32;2;0;1;4412863;3402786;3169;0;1696
FR;3;2021-09-20;76;211;0;0;1;4412939;3402997;3169;0;1697
FR;3;2021-09-21;55;290;6;0;7;4412994;3403287;3175;0;1704
FR;3;2021-09-22;61;230;6;0;7;4413055;3403517;3181;0;1711
FR;3;2021-09-23;34;275;10;0;6;4413089;3403792;3191;0;1717
FR;3;2021-09-24;22;317;12;0;19;4413111;3404109;3203;0;1736
FR;3;2021-09-25;28;156;3;0;3;4413139;3404265;3206;0;1739
FR;3;2021-09-26;15;55;1;0;1;4413154;3404320;3207;0;1740
FR;3;2021-09-27;38;290;3;0;5;4413192;3404610;3210;0;1745
FR;3;2021-09-28;49;259;6;0;10;4413241;3404869;3216;0;1755
FR;3;2021-09-29;32;224;10;0;13;4413273;3405093;3226;0;1768
FR;3;2021-09-30;37;200;8;0;10;4413310;3405293;3234;0;1778
FR;3;2021-10-01;17;170;5;0;6;4413327;3405463;3239;0;1784
FR;3;2021-10-02;14;93;0;0;0;4413341;3405556;3239;0;1784
FR;3;2021-10-03;18;20;1;0;2;4413359;3405576;3240;0;1786
FR;3;2021-10-04;28;164;4;0;4;4413387;3405740;3244;0;1790
FR;3;2021-10-05;15;156;10;0;13;4413402;3405896;3254;0;1803
FR;3;2021-10-06;29;163;7;0;8;4413431;3406059;3261;0;1811
FR;3;2021-10-07;16;146;6;0;6;4413447;3406205;3267;0;1817
FR;3;2021-10-08;20;146;10;0;9;4413467;3406351;3277;0;1826
FR;3;2021-10-09;11;73;1;0;1;4413478;3406424;3278;0;1827
FR;3;2021-10-10;8;16;2;0;2;4413486;3406440;3280;0;1829
FR;3;2021-10-11;13;126;4;0;5;4413499;3406566;3284;0;1834
FR;3;2021-10-12;16;116;4;0;4;4413515;3406682;3288;0;1838
FR;3;2021-10-13;22;118;7;0;5;4413537;3406800;3295;0;1843
FR;3;2021-10-14;16;162;3;0;4;4413553;3406962;3298;0;1847
FR;3;2021-10-15;21;154;8;0;11;4413574;3407116;3306;0;1858
FR;3;2021-10-16;10;80;6;0;8;4413584;3407196;3312;0;1866
FR;3;2021-10-17;9;24;0;0;0;4413593;3407220;3312;0;1866
FR;3;2021-10-18;17;131;2;0;1;4413610;3407351;3314;0;1867
FR;3;2021-10-19;14;131;19;0;21;4413624;3407482;3333;0;1888
FR;3;2021-10-20;18;136;5;0;6;4413642;3407618;3338;0;1894
FR;3;2021-10-21;22;137;17;0;13;4413664;3407755;3355;0;1907
FR;3;2021-10-22;17;128;16;0;20;4413681;3407883;3371;0;1927
FR;3;2021-10-23;11;59;2;0;1;4413692;3407942;3373;0;1928
FR;3;2021-10-24;7;27;0;0;0;4413699;3407969;3373;0;1928
FR;3;2021-10-25;21;154;6;0;6;4413720;3408123;3379;0;1934
FR;3;2021-10-26;17;120;22;0;19;4413737;3408243;3401;0;1953
FR;3;2021-10-27;15;117;9;0;9;4413752;3408360;3410;0;1962
FR;3;2021-10-28;19;129;33;0;36;4413771;3408489;3443;0;1998
FR;3;2021-10-29;10;124;64;0;54;4413781;3408613;3507;0;2052
FR;3;2021-10-30;8;73;11;1;10;4413789;3408686;3518;1;2062
FR;3;2021-10-31;5;23;1;0;1;4413794;3408709;3519;1;2063
FR;3;2021-11-01;5;21;2;0;1;4413799;3408730;3521;1;2064
FR;3;2021-11-02;9;110;8;0;10;4413808;3408840;3529;1;2074
FR;3;2021-11-03;19;125;9;0;9;4413827;3408965;3538;1;2083
FR;3;2021-11-04;15;98;3;0;2;4413842;3409063;3541;1;2085
FR;3;2021-11-05;16;148;8;1;5;4413858;3409211;3549;2;2090
FR;3;2021-11-06;6;67;3;0;3;4413864;3409278;3552;2;2093
FR;3;2021-11-07;6;20;1;0;1;4413870;3409298;3553;2;2094
FR;3;2021-11-08;9;144;7;0;5;4413879;3409442;3560;2;2099
FR;3;2021-11-09;9;156;5;0;5;4413888;3409598;3565;2;2104
FR;3;2021-11-10;11;190;13;0;14;4413899;3409788;3578;2;2118
FR;3;2021-11-11;5;53;3;0;3;4413904;3409841;3581;2;2121
FR;3;2021-11-12;9;165;6;0;4;4413913;3410006;3587;2;2125
FR;3;2021-11-13;5;80;8;0;10;4413918;3410086;3595;2;2135
FR;3;2021-11-14;2;20;0;0;0;4413920;3410106;3595;2;2135
FR;3;2021-11-15;3;196;9;0;9;4413923;3410302;3604;2;2144
FR;3;2021-11-16;2;169;11;0;10;4413925;3410471;3615;2;2154
FR;3;2021-11-17;5;185;10;0;7;4413930;3410656;3625;2;2161
FR;3;2021-11-18;10;186;10;0;11;4413940;3410842;3635;2;2172
FR;3;2021-11-19;5;238;22;0;27;4413945;3411080;3657;2;2199
FR;3;2021-11-20;5;119;5;0;5;4413950;3411199;3662;2;2204
FR;3;2021-11-21;3;31;3;0;3;4413953;3411230;3665;2;2207
FR;3;2021-11-22;10;243;10;0;10;4413963;3411473;3675;2;2217
FR;3;2021-11-23;6;236;15;0;14;4413969;3411709;3690;2;2231
FR;3;2021-11-24;5;253;9;0;17;4413974;3411962;3699;2;2248
FR;3;2021-11-25;9;289;11;0;10;4413983;3412251;3710;2;2258
FR;3;2021-11-26;5;382;33;0;30;4413988;3412633;3743;2;2288
FR;3;2021-11-27;5;178;19;0;20;4413993;3412811;3762;2;2308
FR;3;2021-11-28;2;61;7;0;7;4413995;3412872;3769;2;2315
FR;3;2021-11-29;4;334;19;0;20;4413999;3413206;3788;2;2335
FR;3;2021-11-30;4;427;26;0;29;4414003;3413633;3814;2;2364
FR;3;2021-12-01;18;470;32;0;33;4414021;3414103;3846;2;2397
FR;3;2021-12-02;9;500;33;0;36;4414030;3414603;3879;2;2433
FR;3;2021-12-03;3;579;37;0;38;4414033;3415182;3916;2;2471
FR;3;2021-12-04;3;284;26;0;28;4414036;3415466;3942;2;2499
FR;3;2021-12-05;1;83;5;0;5;4414037;3415549;3947;2;2504
FR;3;2021-12-06;5;518;14;0;16;4414042;3416067;3961;2;2520
FR;3;2021-12-07;4;618;20;0;24;4414046;3416685;3981;2;2544
FR;3;2021-12-08;3;546;29;0;29;4414049;3417231;4010;2;2573
FR;3;2021-12-09;3;605;17;0;22;4414052;3417836;4027;2;2595
FR;3;2021-12-10;9;639;29;0;25;4414061;3418475;4056;2;2620
FR;3;2021-12-11;4;395;10;0;9;4414065;3418870;4066;2;2629
FR;3;2021-12-12;1;122;3;0;3;4414066;3418992;4069;2;2632
FR;3;2021-12-13;2;609;19;0;20;4414068;3419601;4088;2;2652
FR;3;2021-12-14;7;771;18;0;21;4414075;3420372;4106;2;2673
FR;3;2021-12-15;7;733;17;0;21;4414082;3421105;4123;2;2694
FR;3;2021-12-16;9;738;19;0;18;4414091;3421843;4142;2;2712
FR;3;2021-12-17;4;810;18;0;19;4414095;3422653;4160;2;2731
FR;3;2021-12-18;4;416;4;0;5;4414099;3423069;4164;2;2736
FR;3;2021-12-19;3;208;2;0;2;4414102;3423277;4166;2;2738
FR;3;2021-12-20;8;731;23;0;28;4414110;3424008;4189;2;2766
FR;3;2021-12-21;3;816;10;0;14;4414113;3424824;4199;2;2780
FR;3;2021-12-22;6;764;9;0;11;4414119;3425588;4208;2;2791
FR;3;2021-12-23;1;657;9;0;8;4414120;3426245;4217;2;2799
FR;3;2021-12-24;2;276;3;0;6;4414122;3426521;4220;2;2805
FR;3;2021-12-25;0;25;0;0;0;4414122;3426546;4220;2;2805
FR;3;2021-12-26;0;95;1;0;1;4414122;3426641;4221;2;2806
FR;3;2021-12-27;7;544;17;0;19;4414129;3427185;4238;2;2825
FR;3;2021-12-28;1;695;6;0;5;4414130;3427880;4244;2;2830
FR;3;2021-12-29;4;575;14;0;16;4414134;3428455;4258;2;2846
FR;3;2021-12-30;1;605;7;0;10;4414135;3429060;4265;2;2856
FR;3;2021-12-31;0;208;5;0;6;4414135;3429268;4270;2;2862
FR;3;2022-01-01;0;27;0;0;2;4414135;3429295;4270;2;2864
FR;3;2022-01-02;0;82;0;0;0;4414135;3429377;4270;2;2864
FR;3;2022-01-03;3;564;17;0;20;4414138;3429941;4287;2;2884
FR;3;2022-01-04;6;625;9;0;8;4414144;3430566;4296;2;2892
FR;3;2022-01-05;3;557;10;0;14;4414147;3431123;4306;2;2906
FR;3;2022-01-06;4;554;9;0;12;4414151;3431677;4315;2;2918
FR;3;2022-01-07;2;577;11;0;14;4414153;3432254;4326;2;2932
FR;3;2022-01-08;2;286;4;0;5;4414155;3432540;4330;2;2937
FR;3;2022-01-09;0;118;0;0;0;4414155;3432658;4330;2;2937
FR;3;2022-01-10;2;481;12;0;12;4414157;3433139;4342;2;2949
FR;3;2022-01-11;2;535;1;0;1;4414159;3433674;4343;2;2950
FR;3;2022-01-12;3;449;9;0;10;4414162;3434123;4352;2;2960
FR;3;2022-01-13;3;427;11;0;12;4414165;3434550;4363;2;2972
FR;3;2022-01-14;3;483;10;0;12;4414168;3435033;4373;2;2984
FR;3;2022-01-15;0;299;2;0;3;4414168;3435332;4375;2;2987
FR;3;2022-01-16;0;116;1;0;1;4414168;3435448;4376;2;2988
FR;3;2022-01-17;2;352;8;0;10;4414170;3435800;4384;2;2998
FR;3;2022-01-18;2;419;1;0;2;4414172;3436219;4385;2;3000
FR;3;2022-01-19;1;351;5;0;10;4414173;3436570;4390;2;3010
FR;3;2022-01-20;1;380;5;0;3;4414174;3436950;4395;2;3013
FR;3;2022-01-21;2;376;5;0;8;4414176;3437326;4400;2;3021
FR;3;2022-01-22;2;233;1;0;3;4414178;3437559;4401;2;3024
FR;3;2022-01-23;0;82;0;0;1;4414178;3437641;4401;2;3025
FR;3;2022-01-24;2;352;1;0;6;4414180;3437993;4402;2;3031
FR;3;2022-01-25;0;194;0;0;0;4414180;3438187;4402;2;3031
FR;3;2022-01-26;0;89;0;0;0;4414180;3438276;4402;2;3031
FR;3;2022-01-27;0;60;0;0;0;4414180;3438336;4402;2;3031
FR;3;2022-01-28;0;134;0;0;0;4414180;3438470;4402;2;3031
FR;3;2022-01-29;0;110;0;0;0;4414180;3438580;4402;2;3031
FR;3;2022-01-30;0;51;0;0;0;4414180;3438631;4402;2;3031
FR;3;2022-01-31;0;98;0;0;0;4414180;3438729;4402;2;3031
FR;3;2022-02-01;0;110;0;0;1;4414180;3438839;4402;2;3032
FR;3;2022-02-02;0;98;0;0;0;4414180;3438937;4402;2;3032
FR;3;2022-02-03;0;101;0;0;0;4414180;3439038;4402;2;3032
FR;3;2022-02-04;0;124;0;0;0;4414180;3439162;4402;2;3032
FR;3;2022-02-05;0;73;0;0;0;4414180;3439235;4402;2;3032
FR;3;2022-02-06;0;11;0;0;0;4414180;3439246;4402;2;3032
FR;3;2022-02-07;0;89;0;0;1;4414180;3439335;4402;2;3033
FR;3;2022-02-08;0;0;0;0;0;4414180;3439335;4402;2;3033
FR;3;2022-02-09;0;0;0;0;0;4414180;3439335;4402;2;3033
FR;3;2022-02-10;0;0;0;0;0;4414180;3439335;4402;2;3033
FR;3;2022-02-11;0;0;0;0;0;4414180;3439335;4402;2;3033
FR;3;2022-02-12;0;0;0;0;0;4414180;3439335;4402;2;3033
FR;3;2022-02-13;0;0;0;0;0;4414180;3439335;4402;2;3033
FR;3;2022-02-14;0;0;0;0;0;4414180;3439335;4402;2;3033
FR;3;2022-02-15;0;0;0;0;0;4414180;3439335;4402;2;3033
FR;3;2022-02-16;0;0;0;0;0;4414180;3439335;4402;2;3033
FR;3;2022-02-17;0;0;0;0;0;4414180;3439335;4402;2;3033
FR;3;2022-02-18;0;0;0;0;0;4414180;3439335;4402;2;3033
FR;3;2022-02-19;0;0;0;0;0;4414180;3439335;4402;2;3033
FR;3;2022-02-20;0;0;0;0;0;4414180;3439335;4402;2;3033
FR;3;2022-02-21;2;0;0;0;0;4414182;3439335;4402;2;3033
FR;3;2022-02-22;0;0;0;0;0;4414182;3439335;4402;2;3033
FR;3;2022-02-23;0;0;0;0;0;4414182;3439335;4402;2;3033
FR;3;2022-02-24;0;0;0;0;0;4414182;3439335;4402;2;3033
FR;3;2022-02-25;0;0;0;0;0;4414182;3439335;4402;2;3033
FR;3;2022-02-26;0;0;0;0;0;4414182;3439335;4402;2;3033
FR;3;2022-02-27;0;0;0;0;0;4414182;3439335;4402;2;3033
FR;3;2022-02-28;1;0;0;0;0;4414183;3439335;4402;2;3033
FR;3;2022-03-01;1;0;0;0;0;4414184;3439335;4402;2;3033
FR;3;2022-03-02;0;0;0;0;0;4414184;3439335;4402;2;3033
FR;3;2022-03-03;0;0;0;0;0;4414184;3439335;4402;2;3033
FR;3;2022-03-04;0;0;0;0;0;4414184;3439335;4402;2;3033
FR;3;2022-03-05;0;0;0;0;0;4414184;3439335;4402;2;3033
FR;3;2022-03-06;1;0;0;0;0;4414185;3439335;4402;2;3033
FR;3;2022-03-07;0;0;0;0;0;4414185;3439335;4402;2;3033
FR;3;2022-03-08;1;0;0;0;0;4414186;3439335;4402;2;3033
FR;3;2022-03-09;0;0;0;0;0;4414186;3439335;4402;2;3033
FR;3;2022-03-10;0;0;0;0;0;4414186;3439335;4402;2;3033
FR;3;2022-03-11;0;0;0;0;0;4414186;3439335;4402;2;3033
FR;3;2022-03-12;0;0;0;0;0;4414186;3439335;4402;2;3033
FR;3;2022-03-13;0;0;0;0;0;4414186;3439335;4402;2;3033
FR;3;2022-03-14;0;0;0;0;0;4414186;3439335;4402;2;3033
FR;3;2022-03-15;0;0;0;0;0;4414186;3439335;4402;2;3033
FR;3;2022-03-16;0;0;0;0;0;4414186;3439335;4402;2;3033
FR;3;2022-03-17;0;0;0;0;0;4414186;3439335;4402;2;3033
FR;3;2022-03-18;0;0;0;0;0;4414186;3439335;4402;2;3033
FR;3;2022-03-19;0;0;0;0;0;4414186;3439335;4402;2;3033
FR;3;2022-03-20;1;0;0;0;0;4414187;3439335;4402;2;3033
FR;3;2022-03-21;0;0;0;0;0;4414187;3439335;4402;2;3033
FR;3;2022-03-22;0;0;0;0;0;4414187;3439335;4402;2;3033
FR;3;2022-03-23;1;0;0;0;0;4414188;3439335;4402;2;3033
FR;3;2022-03-24;0;0;0;0;0;4414188;3439335;4402;2;3033
FR;3;2022-03-25;1;0;0;0;0;4414189;3439335;4402;2;3033
FR;3;2022-03-26;0;0;0;0;0;4414189;3439335;4402;2;3033
FR;3;2022-03-27;0;0;0;0;0;4414189;3439335;4402;2;3033
FR;3;2022-03-28;0;0;0;0;0;4414189;3439335;4402;2;3033
FR;3;2022-03-29;0;0;0;0;0;4414189;3439335;4402;2;3033
FR;3;2022-03-30;0;0;0;0;0;4414189;3439335;4402;2;3033
FR;4;2020-12-27;0;0;0;0;0;0;0;0;0;0
FR;4;2020-12-28;0;0;0;0;0;0;0;0;0;0
FR;4;2020-12-29;0;0;0;0;0;0;0;0;0;0
FR;4;2020-12-30;0;0;0;0;0;0;0;0;0;0
FR;4;2020-12-31;0;0;0;0;0;0;0;0;0;0
FR;4;2021-01-01;0;0;0;0;0;0;0;0;0;0
FR;4;2021-01-02;0;0;0;0;0;0;0;0;0;0
FR;4;2021-01-03;0;0;0;0;0;0;0;0;0;0
FR;4;2021-01-04;0;0;0;0;0;0;0;0;0;0
FR;4;2021-01-05;0;0;0;0;0;0;0;0;0;0
FR;4;2021-01-06;0;0;0;0;0;0;0;0;0;0
FR;4;2021-01-07;0;0;0;0;0;0;0;0;0;0
FR;4;2021-01-08;0;0;0;0;0;0;0;0;0;0
FR;4;2021-01-09;0;0;0;0;0;0;0;0;0;0
FR;4;2021-01-10;0;0;0;0;0;0;0;0;0;0
FR;4;2021-01-11;0;0;0;0;0;0;0;0;0;0
FR;4;2021-01-12;0;0;0;0;0;0;0;0;0;0
FR;4;2021-01-13;0;0;0;0;0;0;0;0;0;0
FR;4;2021-01-14;0;0;0;0;0;0;0;0;0;0
FR;4;2021-01-15;0;0;0;0;0;0;0;0;0;0
FR;4;2021-01-16;0;0;0;0;0;0;0;0;0;0
FR;4;2021-01-17;0;0;0;0;0;0;0;0;0;0
FR;4;2021-01-18;0;0;0;0;0;0;0;0;0;0
FR;4;2021-01-19;0;0;0;0;0;0;0;0;0;0
FR;4;2021-01-20;0;0;0;0;0;0;0;0;0;0
FR;4;2021-01-21;0;0;0;0;0;0;0;0;0;0
FR;4;2021-01-22;0;0;0;0;0;0;0;0;0;0
FR;4;2021-01-23;0;0;0;0;0;0;0;0;0;0
FR;4;2021-01-24;0;0;0;0;0;0;0;0;0;0
FR;4;2021-01-25;0;0;0;0;0;0;0;0;0;0
FR;4;2021-01-26;0;0;0;0;0;0;0;0;0;0
FR;4;2021-01-27;0;0;0;0;0;0;0;0;0;0
FR;4;2021-01-28;0;0;0;0;0;0;0;0;0;0
FR;4;2021-01-29;0;0;0;0;0;0;0;0;0;0
FR;4;2021-01-30;0;0;0;0;0;0;0;0;0;0
FR;4;2021-01-31;0;0;0;0;0;0;0;0;0;0
FR;4;2021-02-01;0;0;0;0;0;0;0;0;0;0
FR;4;2021-02-02;0;0;0;0;0;0;0;0;0;0
FR;4;2021-02-03;0;0;0;0;0;0;0;0;0;0
FR;4;2021-02-04;0;0;0;0;0;0;0;0;0;0
FR;4;2021-02-05;0;0;0;0;0;0;0;0;0;0
FR;4;2021-02-06;0;0;0;0;0;0;0;0;0;0
FR;4;2021-02-07;0;0;0;0;0;0;0;0;0;0
FR;4;2021-02-08;0;0;0;0;0;0;0;0;0;0
FR;4;2021-02-09;0;0;0;0;0;0;0;0;0;0
FR;4;2021-02-10;0;0;0;0;0;0;0;0;0;0
FR;4;2021-02-11;0;0;0;0;0;0;0;0;0;0
FR;4;2021-02-12;0;0;0;0;0;0;0;0;0;0
FR;4;2021-02-13;0;0;0;0;0;0;0;0;0;0
FR;4;2021-02-14;0;0;0;0;0;0;0;0;0;0
FR;4;2021-02-15;0;0;0;0;0;0;0;0;0;0
FR;4;2021-02-16;0;0;0;0;0;0;0;0;0;0
FR;4;2021-02-17;0;0;0;0;0;0;0;0;0;0
FR;4;2021-02-18;0;0;0;0;0;0;0;0;0;0
FR;4;2021-02-19;0;0;0;0;0;0;0;0;0;0
FR;4;2021-02-20;0;0;0;0;0;0;0;0;0;0
FR;4;2021-02-21;0;0;0;0;0;0;0;0;0;0
FR;4;2021-02-22;0;0;0;0;0;0;0;0;0;0
FR;4;2021-02-23;0;0;0;0;0;0;0;0;0;0
FR;4;2021-02-24;0;0;0;0;0;0;0;0;0;0
FR;4;2021-02-25;0;0;0;0;0;0;0;0;0;0
FR;4;2021-02-26;0;0;0;0;0;0;0;0;0;0
FR;4;2021-02-27;0;0;0;0;0;0;0;0;0;0
FR;4;2021-02-28;0;0;0;0;0;0;0;0;0;0
FR;4;2021-03-01;0;0;0;0;0;0;0;0;0;0
FR;4;2021-03-02;0;0;0;0;0;0;0;0;0;0
FR;4;2021-03-03;0;0;0;0;0;0;0;0;0;0
FR;4;2021-03-04;0;0;0;0;0;0;0;0;0;0
FR;4;2021-03-05;0;0;0;0;0;0;0;0;0;0
FR;4;2021-03-06;0;0;0;0;0;0;0;0;0;0
FR;4;2021-03-07;0;0;0;0;0;0;0;0;0;0
FR;4;2021-03-08;0;0;0;0;0;0;0;0;0;0
FR;4;2021-03-09;0;0;0;0;0;0;0;0;0;0
FR;4;2021-03-10;0;0;0;0;0;0;0;0;0;0
FR;4;2021-03-11;0;0;0;0;0;0;0;0;0;0
FR;4;2021-03-12;0;0;0;0;0;0;0;0;0;0
FR;4;2021-03-13;0;0;0;0;0;0;0;0;0;0
FR;4;2021-03-14;0;0;0;0;0;0;0;0;0;0
FR;4;2021-03-15;0;0;0;0;0;0;0;0;0;0
FR;4;2021-03-16;0;0;0;0;0;0;0;0;0;0
FR;4;2021-03-17;0;0;0;0;0;0;0;0;0;0
FR;4;2021-03-18;0;0;0;0;0;0;0;0;0;0
FR;4;2021-03-19;0;0;0;0;0;0;0;0;0;0
FR;4;2021-03-20;0;0;0;0;0;0;0;0;0;0
FR;4;2021-03-21;0;0;0;0;0;0;0;0;0;0
FR;4;2021-03-22;0;0;0;0;0;0;0;0;0;0
FR;4;2021-03-23;0;0;0;0;0;0;0;0;0;0
FR;4;2021-03-24;0;0;0;0;0;0;0;0;0;0
FR;4;2021-03-25;0;0;0;0;0;0;0;0;0;0
FR;4;2021-03-26;0;0;0;0;0;0;0;0;0;0
FR;4;2021-03-27;0;0;0;0;0;0;0;0;0;0
FR;4;2021-03-28;0;0;0;0;0;0;0;0;0;0
FR;4;2021-03-29;0;0;0;0;0;0;0;0;0;0
FR;4;2021-03-30;0;0;0;0;0;0;0;0;0;0
FR;4;2021-03-31;0;0;0;0;0;0;0;0;0;0
FR;4;2021-04-01;0;0;0;0;0;0;0;0;0;0
FR;4;2021-04-02;0;0;0;0;0;0;0;0;0;0
FR;4;2021-04-03;0;0;0;0;0;0;0;0;0;0
FR;4;2021-04-04;0;0;0;0;0;0;0;0;0;0
FR;4;2021-04-05;0;0;0;0;0;0;0;0;0;0
FR;4;2021-04-06;0;0;0;0;0;0;0;0;0;0
FR;4;2021-04-07;0;0;0;0;0;0;0;0;0;0
FR;4;2021-04-08;0;0;0;0;0;0;0;0;0;0
FR;4;2021-04-09;0;0;0;0;0;0;0;0;0;0
FR;4;2021-04-10;0;0;0;0;0;0;0;0;0;0
FR;4;2021-04-11;0;0;0;0;0;0;0;0;0;0
FR;4;2021-04-12;0;0;0;0;0;0;0;0;0;0
FR;4;2021-04-13;0;0;0;0;0;0;0;0;0;0
FR;4;2021-04-14;0;0;0;0;0;0;0;0;0;0
FR;4;2021-04-15;0;0;0;0;0;0;0;0;0;0
FR;4;2021-04-16;0;0;0;0;0;0;0;0;0;0
FR;4;2021-04-17;0;0;0;0;0;0;0;0;0;0
FR;4;2021-04-18;0;0;0;0;0;0;0;0;0;0
FR;4;2021-04-19;0;0;0;0;0;0;0;0;0;0
FR;4;2021-04-20;0;0;0;0;0;0;0;0;0;0
FR;4;2021-04-21;0;0;0;0;0;0;0;0;0;0
FR;4;2021-04-22;0;0;0;0;0;0;0;0;0;0
FR;4;2021-04-23;4091;0;0;0;0;4091;0;0;0;0
FR;4;2021-04-24;1569;0;0;0;0;5660;0;0;0;0
FR;4;2021-04-25;124;0;0;0;0;5784;0;0;0;0
FR;4;2021-04-26;2868;1;0;0;0;8652;1;0;0;0
FR;4;2021-04-27;9520;3;0;0;0;18172;4;0;0;0
FR;4;2021-04-28;9903;6;0;0;0;28075;10;0;0;0
FR;4;2021-04-29;15989;8;0;0;0;44064;18;0;0;0
FR;4;2021-04-30;19223;10;0;0;0;63287;28;0;0;0
FR;4;2021-05-01;1989;6;0;0;0;65276;34;0;0;0
FR;4;2021-05-02;481;0;0;0;0;65757;34;0;0;0
FR;4;2021-05-03;5057;2;0;0;0;70814;36;0;0;0
FR;4;2021-05-04;8396;10;0;0;0;79210;46;0;0;0
FR;4;2021-05-05;6179;7;0;0;0;85389;53;0;0;0
FR;4;2021-05-06;11379;11;0;0;0;96768;64;0;0;0
FR;4;2021-05-07;19115;9;0;0;0;115883;73;0;0;0
FR;4;2021-05-08;2375;6;0;0;0;118258;79;0;0;0
FR;4;2021-05-09;685;3;0;0;0;118943;82;0;0;0
FR;4;2021-05-10;7234;5;1;0;0;126177;87;1;0;0
FR;4;2021-05-11;14310;11;0;0;0;140487;98;1;0;0
FR;4;2021-05-12;10157;15;0;0;0;150644;113;1;0;0
FR;4;2021-05-13;1578;3;0;0;0;152222;116;1;0;0
FR;4;2021-05-14;7753;6;0;0;0;159975;122;1;0;0
FR;4;2021-05-15;3712;8;1;0;0;163687;130;2;0;0
FR;4;2021-05-16;418;1;0;0;0;164105;131;2;0;0
FR;4;2021-05-17;4473;6;0;0;0;168578;137;2;0;0
FR;4;2021-05-18;8743;9;0;0;0;177321;146;2;0;0
FR;4;2021-05-19;5686;7;0;0;0;183007;153;2;0;0
FR;4;2021-05-20;9476;7;0;0;0;192483;160;2;0;0
FR;4;2021-05-21;12782;29;0;0;0;205265;189;2;0;0
FR;4;2021-05-22;5051;15;0;0;0;210316;204;2;0;0
FR;4;2021-05-23;494;4;0;0;0;210810;208;2;0;0
FR;4;2021-05-24;1049;7;0;0;0;211859;215;2;0;0
FR;4;2021-05-25;7617;15;0;0;0;219476;230;2;0;0
FR;4;2021-05-26;7720;16;0;0;0;227196;246;2;0;0
FR;4;2021-05-27;14327;35;0;0;0;241523;281;2;0;0
FR;4;2021-05-28;26576;82;1;0;0;268099;363;3;0;0
FR;4;2021-05-29;11381;18;0;0;0;279480;381;3;0;0
FR;4;2021-05-30;970;6;0;0;0;280450;387;3;0;0
FR;4;2021-05-31;12684;21;0;0;0;293134;408;3;0;0
FR;4;2021-06-01;20242;46;1;0;0;313376;454;4;0;0
FR;4;2021-06-02;14514;33;0;0;0;327890;487;4;0;0
FR;4;2021-06-03;19401;24;1;0;0;347291;511;5;0;0
FR;4;2021-06-04;22504;47;0;0;0;369795;558;5;0;0
FR;4;2021-06-05;9712;32;0;0;0;379507;590;5;0;0
FR;4;2021-06-06;1037;0;0;0;0;380544;590;5;0;0
FR;4;2021-06-07;9223;19;0;0;0;389767;609;5;0;0
FR;4;2021-06-08;14606;31;0;0;0;404373;640;5;0;0
FR;4;2021-06-09;12200;25;0;0;0;416573;665;5;0;0
FR;4;2021-06-10;15395;30;0;0;0;431968;695;5;0;0
FR;4;2021-06-11;16973;55;0;0;0;448941;750;5;0;0
FR;4;2021-06-12;7441;27;0;0;0;456382;777;5;0;0
FR;4;2021-06-13;907;2;0;0;0;457289;779;5;0;0
FR;4;2021-06-14;6646;25;0;0;0;463935;804;5;0;0
FR;4;2021-06-15;10877;37;0;0;0;474812;841;5;0;0
FR;4;2021-06-16;8901;14;0;0;0;483713;855;5;0;0
FR;4;2021-06-17;10893;36;0;0;0;494606;891;5;0;0
FR;4;2021-06-18;12416;45;0;0;0;507022;936;5;0;0
FR;4;2021-06-19;5565;25;0;0;0;512587;961;5;0;0
FR;4;2021-06-20;814;5;0;0;0;513401;966;5;0;0
FR;4;2021-06-21;5079;20;0;0;0;518480;986;5;0;0
FR;4;2021-06-22;7903;27;2;0;0;526383;1013;7;0;0
FR;4;2021-06-23;7090;39;2;0;0;533473;1052;9;0;0
FR;4;2021-06-24;8643;45;1;0;0;542116;1097;10;0;0
FR;4;2021-06-25;10165;39;2;0;0;552281;1136;12;0;0
FR;4;2021-06-26;4838;21;0;0;0;557119;1157;12;0;0
FR;4;2021-06-27;758;3;0;0;0;557877;1160;12;0;0
FR;4;2021-06-28;4813;16;1;0;0;562690;1176;13;0;0
FR;4;2021-06-29;7095;27;2;0;0;569785;1203;15;0;0
FR;4;2021-06-30;6705;40;2;0;0;576490;1243;17;0;0
FR;4;2021-07-01;8183;39;0;0;0;584673;1282;17;0;0
FR;4;2021-07-02;9412;52;1;0;0;594085;1334;18;0;0
FR;4;2021-07-03;4841;19;0;0;0;598926;1353;18;0;0
FR;4;2021-07-04;685;5;0;0;0;599611;1358;18;0;0
FR;4;2021-07-05;4765;19;2;0;0;604376;1377;20;0;0
FR;4;2021-07-06;7712;28;4;0;0;612088;1405;24;0;0
FR;4;2021-07-07;7061;34;2;0;0;619149;1439;26;0;0
FR;4;2021-07-08;9215;38;2;0;0;628364;1477;28;0;0
FR;4;2021-07-09;10270;33;1;0;0;638634;1510;29;0;0
FR;4;2021-07-10;4634;14;2;0;0;643268;1524;31;0;0
FR;4;2021-07-11;579;4;1;0;0;643847;1528;32;0;0
FR;4;2021-07-12;5867;29;0;0;0;649714;1557;32;0;0
FR;4;2021-07-13;14226;29;0;0;0;663940;1586;32;0;0
FR;4;2021-07-14;2280;14;0;0;0;666220;1600;32;0;0
FR;4;2021-07-15;18226;36;0;0;0;684446;1636;32;0;0
FR;4;2021-07-16;22814;70;2;0;0;707260;1706;34;0;0
FR;4;2021-07-17;9734;20;0;0;0;716994;1726;34;0;0
FR;4;2021-07-18;1350;4;0;0;0;718344;1730;34;0;0
FR;4;2021-07-19;12968;28;1;0;0;731312;1758;35;0;0
FR;4;2021-07-20;17321;26;1;0;0;748633;1784;36;0;0
FR;4;2021-07-21;15598;33;0;0;0;764231;1817;36;0;0
FR;4;2021-07-22;18230;43;2;0;0;782461;1860;38;0;0
FR;4;2021-07-23;20398;57;7;0;0;802859;1917;45;0;0
FR;4;2021-07-24;9271;32;0;0;0;812130;1949;45;0;0
FR;4;2021-07-25;1342;8;0;0;0;813472;1957;45;0;0
FR;4;2021-07-26;11021;20;0;0;0;824493;1977;45;0;0
FR;4;2021-07-27;14649;34;3;0;0;839142;2011;48;0;0
FR;4;2021-07-28;12909;25;2;0;0;852051;2036;50;0;0
FR;4;2021-07-29;14063;54;4;0;0;866114;2090;54;0;0
FR;4;2021-07-30;15468;45;2;0;0;881582;2135;56;0;0
FR;4;2021-07-31;6813;14;2;0;0;888395;2149;58;0;0
FR;4;2021-08-01;902;1;0;0;0;889297;2150;58;0;0
FR;4;2021-08-02;7890;29;0;0;0;897187;2179;58;0;0
FR;4;2021-08-03;10784;32;2;0;0;907971;2211;60;0;0
FR;4;2021-08-04;9716;29;0;0;0;917687;2240;60;0;0
FR;4;2021-08-05;9801;41;0;0;0;927488;2281;60;0;0
FR;4;2021-08-06;10169;31;3;0;0;937657;2312;63;0;0
FR;4;2021-08-07;5077;30;1;0;0;942734;2342;64;0;0
FR;4;2021-08-08;1212;13;0;0;0;943946;2355;64;0;0
FR;4;2021-08-09;6319;30;0;0;0;950265;2385;64;0;0
FR;4;2021-08-10;8738;20;0;0;0;959003;2405;64;0;0
FR;4;2021-08-11;7922;33;3;0;0;966925;2438;67;0;0
FR;4;2021-08-12;8577;29;1;0;0;975502;2467;68;0;0
FR;4;2021-08-13;7534;24;0;1;0;983036;2491;68;1;0
FR;4;2021-08-14;3780;20;0;0;0;986816;2511;68;1;0
FR;4;2021-08-15;767;5;0;0;0;987583;2516;68;1;0
FR;4;2021-08-16;4000;16;0;0;0;991583;2532;68;1;0
FR;4;2021-08-17;5611;15;1;0;0;997194;2547;69;1;0
FR;4;2021-08-18;5152;34;0;0;0;1002346;2581;69;1;0
FR;4;2021-08-19;5470;34;3;0;0;1007816;2615;72;1;0
FR;4;2021-08-20;5199;23;1;0;0;1013015;2638;73;1;0
FR;4;2021-08-21;2303;21;1;0;0;1015318;2659;74;1;0
FR;4;2021-08-22;400;2;0;0;0;1015718;2661;74;1;0
FR;4;2021-08-23;2912;18;1;0;0;1018630;2679;75;1;0
FR;4;2021-08-24;3736;15;0;0;0;1022366;2694;75;1;0
FR;4;2021-08-25;3528;25;0;0;0;1025894;2719;75;1;0
FR;4;2021-08-26;3698;20;1;0;0;1029592;2739;76;1;0
FR;4;2021-08-27;3597;31;2;0;0;1033189;2770;78;1;0
FR;4;2021-08-28;1720;10;1;0;0;1034909;2780;79;1;0
FR;4;2021-08-29;386;7;1;0;0;1035295;2787;80;1;0
FR;4;2021-08-30;2000;24;0;0;14;1037295;2811;80;1;14
FR;4;2021-08-31;2473;20;0;0;13;1039768;2831;80;1;27
FR;4;2021-09-01;2070;38;1;0;21;1041838;2869;81;1;48
FR;4;2021-09-02;2299;31;4;0;18;1044137;2900;85;1;66
FR;4;2021-09-03;2351;44;5;0;32;1046488;2944;90;1;98
FR;4;2021-09-04;1370;17;0;0;5;1047858;2961;90;1;103
FR;4;2021-09-05;428;2;0;0;2;1048286;2963;90;1;105
FR;4;2021-09-06;1701;61;0;0;23;1049987;3024;90;1;128
FR;4;2021-09-07;1670;18;0;0;8;1051657;3042;90;1;136
FR;4;2021-09-08;1277;26;3;1;19;1052934;3068;93;2;155
FR;4;2021-09-09;1384;23;2;0;9;1054318;3091;95;2;164
FR;4;2021-09-10;1513;31;2;0;23;1055831;3122;97;2;187
FR;4;2021-09-11;734;11;0;0;3;1056565;3133;97;2;190
FR;4;2021-09-12;167;4;0;0;2;1056732;3137;97;2;192
FR;4;2021-09-13;1308;21;1;0;15;1058040;3158;98;2;207
FR;4;2021-09-14;1490;9;2;0;6;1059530;3167;100;2;213
FR;4;2021-09-15;1087;26;1;0;24;1060617;3193;101;2;237
FR;4;2021-09-16;1094;22;2;0;15;1061711;3215;103;2;252
FR;4;2021-09-17;889;21;1;0;12;1062600;3236;104;2;264
FR;4;2021-09-18;459;5;1;0;4;1063059;3241;105;2;268
FR;4;2021-09-19;181;2;0;0;1;1063240;3243;105;2;269
FR;4;2021-09-20;442;18;0;0;12;1063682;3261;105;2;281
FR;4;2021-09-21;420;11;0;0;7;1064102;3272;105;2;288
FR;4;2021-09-22;372;20;2;0;14;1064474;3292;107;2;302
FR;4;2021-09-23;474;13;1;0;12;1064948;3305;108;2;314
FR;4;2021-09-24;407;13;2;0;9;1065355;3318;110;2;323
FR;4;2021-09-25;281;9;1;0;4;1065636;3327;111;2;327
FR;4;2021-09-26;71;2;0;0;1;1065707;3329;111;2;328
FR;4;2021-09-27;259;10;1;0;8;1065966;3339;112;2;336
FR;4;2021-09-28;314;8;0;0;8;1066280;3347;112;2;344
FR;4;2021-09-29;370;19;1;0;13;1066650;3366;113;2;357
FR;4;2021-09-30;357;39;0;0;20;1067007;3405;113;2;377
FR;4;2021-10-01;397;49;0;0;43;1067404;3454;113;2;420
FR;4;2021-10-02;192;22;1;0;13;1067596;3476;114;2;433
FR;4;2021-10-03;83;1;0;0;0;1067679;3477;114;2;433
FR;4;2021-10-04;352;19;1;0;15;1068031;3496;115;2;448
FR;4;2021-10-05;272;19;2;0;15;1068303;3515;117;2;463
FR;4;2021-10-06;242;22;1;0;18;1068545;3537;118;2;481
FR;4;2021-10-07;251;26;2;0;14;1068796;3563;120;2;495
FR;4;2021-10-08;351;22;2;0;18;1069147;3585;122;2;513
FR;4;2021-10-09;191;6;6;0;7;1069338;3591;128;2;520
FR;4;2021-10-10;93;3;2;0;3;1069431;3594;130;2;523
FR;4;2021-10-11;243;14;1;0;13;1069674;3608;131;2;536
FR;4;2021-10-12;202;14;0;0;13;1069876;3622;131;2;549
FR;4;2021-10-13;217;28;1;0;25;1070093;3650;132;2;574
FR;4;2021-10-14;304;20;4;0;14;1070397;3670;136;2;588
FR;4;2021-10-15;318;24;5;0;25;1070715;3694;141;2;613
FR;4;2021-10-16;163;6;2;0;6;1070878;3700;143;2;619
FR;4;2021-10-17;70;2;0;0;1;1070948;3702;143;2;620
FR;4;2021-10-18;275;16;1;0;12;1071223;3718;144;2;632
FR;4;2021-10-19;205;14;2;0;15;1071428;3732;146;2;647
FR;4;2021-10-20;224;27;3;0;14;1071652;3759;149;2;661
FR;4;2021-10-21;230;17;0;0;13;1071882;3776;149;2;674
FR;4;2021-10-22;206;26;2;0;21;1072088;3802;151;2;695
FR;4;2021-10-23;115;16;1;0;15;1072203;3818;152;2;710
FR;4;2021-10-24;37;4;0;0;1;1072240;3822;152;2;711
FR;4;2021-10-25;205;7;2;0;9;1072445;3829;154;2;720
FR;4;2021-10-26;193;13;0;0;11;1072638;3842;154;2;731
FR;4;2021-10-27;188;11;4;0;11;1072826;3853;158;2;742
FR;4;2021-10-28;180;18;4;0;21;1073006;3871;162;2;763
FR;4;2021-10-29;218;16;2;0;14;1073224;3887;164;2;777
FR;4;2021-10-30;100;2;0;0;1;1073324;3889;164;2;778
FR;4;2021-10-31;55;3;2;0;3;1073379;3892;166;2;781
FR;4;2021-11-01;74;27;4;0;24;1073453;3919;170;2;805
FR;4;2021-11-02;150;20;2;0;21;1073603;3939;172;2;826
FR;4;2021-11-03;125;20;8;1;18;1073728;3959;180;3;844
FR;4;2021-11-04;173;13;1;0;10;1073901;3972;181;3;854
FR;4;2021-11-05;123;17;1;0;16;1074024;3989;182;3;870
FR;4;2021-11-06;77;6;1;0;6;1074101;3995;183;3;876
FR;4;2021-11-07;73;2;2;0;4;1074174;3997;185;3;880
FR;4;2021-11-08;158;16;1;0;16;1074332;4013;186;3;896
FR;4;2021-11-09;150;14;3;0;16;1074482;4027;189;3;912
FR;4;2021-11-10;110;27;6;0;29;1074592;4054;195;3;941
FR;4;2021-11-11;80;9;0;0;9;1074672;4063;195;3;950
FR;4;2021-11-12;94;18;2;0;18;1074766;4081;197;3;968
FR;4;2021-11-13;72;15;2;0;14;1074838;4096;199;3;982
FR;4;2021-11-14;52;5;3;0;7;1074890;4101;202;3;989
FR;4;2021-11-15;93;26;2;0;24;1074983;4127;204;3;1013
FR;4;2021-11-16;98;12;2;0;14;1075081;4139;206;3;1027
FR;4;2021-11-17;111;29;4;0;29;1075192;4168;210;3;1056
FR;4;2021-11-18;95;34;11;0;39;1075287;4202;221;3;1095
FR;4;2021-11-19;78;19;3;0;20;1075365;4221;224;3;1115
FR;4;2021-11-20;60;6;1;0;6;1075425;4227;225;3;1121
FR;4;2021-11-21;61;7;2;0;9;1075486;4234;227;3;1130
FR;4;2021-11-22;99;27;6;0;29;1075585;4261;233;3;1159
FR;4;2021-11-23;71;30;5;0;27;1075656;4291;238;3;1186
FR;4;2021-11-24;84;23;9;0;22;1075740;4314;247;3;1208
FR;4;2021-11-25;83;29;14;0;31;1075823;4343;261;3;1239
FR;4;2021-11-26;78;42;12;0;44;1075901;4385;273;3;1283
FR;4;2021-11-27;31;23;17;0;26;1075932;4408;290;3;1309
FR;4;2021-11-28;46;8;0;0;7;1075978;4416;290;3;1316
FR;4;2021-11-29;80;31;14;0;38;1076058;4447;304;3;1354
FR;4;2021-11-30;57;36;13;0;40;1076115;4483;317;3;1394
FR;4;2021-12-01;68;60;19;0;67;1076183;4543;336;3;1461
FR;4;2021-12-02;95;47;17;0;50;1076278;4590;353;3;1511
FR;4;2021-12-03;98;36;15;0;44;1076376;4626;368;3;1555
FR;4;2021-12-04;67;31;19;0;44;1076443;4657;387;3;1599
FR;4;2021-12-05;55;5;1;0;6;1076498;4662;388;3;1605
FR;4;2021-12-06;91;45;21;0;60;1076589;4707;409;3;1665
FR;4;2021-12-07;76;33;10;0;33;1076665;4740;419;3;1698
FR;4;2021-12-08;64;28;18;0;33;1076729;4768;437;3;1731
FR;4;2021-12-09;57;32;10;0;38;1076786;4800;447;3;1769
FR;4;2021-12-10;59;62;21;0;67;1076845;4862;468;3;1836
FR;4;2021-12-11;24;33;7;0;33;1076869;4895;475;3;1869
FR;4;2021-12-12;21;10;3;0;13;1076890;4905;478;3;1882
FR;4;2021-12-13;64;39;13;0;48;1076954;4944;491;3;1930
FR;4;2021-12-14;53;43;14;0;51;1077007;4987;505;3;1981
FR;4;2021-12-15;55;61;29;0;81;1077062;5048;534;3;2062
FR;4;2021-12-16;29;43;19;0;55;1077091;5091;553;3;2117
FR;4;2021-12-17;36;54;12;0;59;1077127;5145;565;3;2176
FR;4;2021-12-18;47;29;2;0;30;1077174;5174;567;3;2206
FR;4;2021-12-19;14;4;1;0;4;1077188;5178;568;3;2210
FR;4;2021-12-20;33;38;12;0;43;1077221;5216;580;3;2253
FR;4;2021-12-21;24;30;14;0;35;1077245;5246;594;3;2288
FR;4;2021-12-22;35;35;11;0;36;1077280;5281;605;3;2324
FR;4;2021-12-23;38;43;8;0;47;1077318;5324;613;3;2371
FR;4;2021-12-24;22;25;10;0;29;1077340;5349;623;3;2400
FR;4;2021-12-25;6;3;3;0;4;1077346;5352;626;3;2404
FR;4;2021-12-26;4;3;1;0;2;1077350;5355;627;3;2406
FR;4;2021-12-27;26;42;9;0;43;1077376;5397;636;3;2449
FR;4;2021-12-28;24;28;8;0;29;1077400;5425;644;3;2478
FR;4;2021-12-29;44;23;10;0;27;1077444;5448;654;3;2505
FR;4;2021-12-30;36;16;12;0;19;1077480;5464;666;3;2524
FR;4;2021-12-31;18;4;8;0;10;1077498;5468;674;3;2534
FR;4;2022-01-01;4;3;4;0;5;1077502;5471;678;3;2539
FR;4;2022-01-02;38;4;14;0;17;1077540;5475;692;3;2556
FR;4;2022-01-03;36;48;19;1;53;1077576;5523;711;4;2609
FR;4;2022-01-04;25;24;11;1;25;1077601;5547;722;5;2634
FR;4;2022-01-05;40;19;16;0;19;1077641;5566;738;5;2653
FR;4;2022-01-06;41;18;20;0;30;1077682;5584;758;5;2683
FR;4;2022-01-07;18;18;15;0;18;1077700;5602;773;5;2701
FR;4;2022-01-08;7;5;9;0;11;1077707;5607;782;5;2712
FR;4;2022-01-09;15;1;1;0;2;1077722;5608;783;5;2714
FR;4;2022-01-10;34;21;16;0;32;1077756;5629;799;5;2746
FR;4;2022-01-11;21;29;12;0;31;1077777;5658;811;5;2777
FR;4;2022-01-12;29;16;12;0;17;1077806;5674;823;5;2794
FR;4;2022-01-13;46;17;26;0;33;1077852;5691;849;5;2827
FR;4;2022-01-14;19;26;12;0;28;1077871;5717;861;5;2855
FR;4;2022-01-15;10;6;7;0;11;1077881;5723;868;5;2866
FR;4;2022-01-16;9;8;10;0;17;1077890;5731;878;5;2883
FR;4;2022-01-17;22;17;10;0;21;1077912;5748;888;5;2904
FR;4;2022-01-18;15;13;7;0;17;1077927;5761;895;5;2921
FR;4;2022-01-19;26;20;9;0;27;1077953;5781;904;5;2948
FR;4;2022-01-20;29;34;13;0;37;1077982;5815;917;5;2985
FR;4;2022-01-21;6;12;18;1;15;1077988;5827;935;6;3000
FR;4;2022-01-22;27;9;2;0;9;1078015;5836;937;6;3009
FR;4;2022-01-23;5;2;4;0;6;1078020;5838;941;6;3015
FR;4;2022-01-24;13;20;8;0;27;1078033;5858;949;6;3042
FR;4;2022-01-25;19;30;8;1;34;1078052;5888;957;7;3076
FR;4;2022-01-26;17;15;6;1;16;1078069;5903;963;8;3092
FR;4;2022-01-27;15;18;5;0;21;1078084;5921;968;8;3113
FR;4;2022-01-28;12;22;7;0;24;1078096;5943;975;8;3137
FR;4;2022-01-29;14;5;3;0;7;1078110;5948;978;8;3144
FR;4;2022-01-30;16;2;0;0;2;1078126;5950;978;8;3146
FR;4;2022-01-31;17;25;6;0;28;1078143;5975;984;8;3174
FR;4;2022-02-01;9;18;11;0;18;1078152;5993;995;8;3192
FR;4;2022-02-02;16;11;9;2;15;1078168;6004;1004;10;3207
FR;4;2022-02-03;10;19;9;0;22;1078178;6023;1013;10;3229
FR;4;2022-02-04;5;4;7;0;8;1078183;6027;1020;10;3237
FR;4;2022-02-05;6;14;1;0;13;1078189;6041;1021;10;3250
FR;4;2022-02-06;5;2;1;0;2;1078194;6043;1022;10;3252
FR;4;2022-02-07;10;17;6;0;17;1078204;6060;1028;10;3269
FR;4;2022-02-08;13;18;12;1;19;1078217;6078;1040;11;3288
FR;4;2022-02-09;13;11;7;0;14;1078230;6089;1047;11;3302
FR;4;2022-02-10;18;22;8;0;22;1078248;6111;1055;11;3324
FR;4;2022-02-11;17;14;7;0;18;1078265;6125;1062;11;3342
FR;4;2022-02-12;23;5;0;0;3;1078288;6130;1062;11;3345
FR;4;2022-02-13;7;3;3;0;6;1078295;6133;1065;11;3351
FR;4;2022-02-14;16;10;7;0;13;1078311;6143;1072;11;3364
FR;4;2022-02-15;14;7;0;0;6;1078325;6150;1072;11;3370
FR;4;2022-02-16;10;8;9;0;13;1078335;6158;1081;11;3383
FR;4;2022-02-17;8;3;4;0;5;1078343;6161;1085;11;3388
FR;4;2022-02-18;16;13;6;0;17;1078359;6174;1091;11;3405
FR;4;2022-02-19;16;2;1;0;3;1078375;6176;1092;11;3408
FR;4;2022-02-20;6;2;0;0;1;1078381;6178;1092;11;3409
FR;4;2022-02-21;22;3;2;0;3;1078403;6181;1094;11;3412
FR;4;2022-02-22;8;4;8;0;8;1078411;6185;1102;11;3420
FR;4;2022-02-23;15;6;6;0;6;1078426;6191;1108;11;3426
FR;4;2022-02-24;7;3;2;0;3;1078433;6194;1110;11;3429
FR;4;2022-02-25;15;4;7;0;5;1078448;6198;1117;11;3434
FR;4;2022-02-26;24;3;0;0;3;1078472;6201;1117;11;3437
FR;4;2022-02-27;8;0;0;0;0;1078480;6201;1117;11;3437
FR;4;2022-02-28;13;3;2;0;3;1078493;6204;1119;11;3440
FR;4;2022-03-01;5;2;7;0;3;1078498;6206;1126;11;3443
FR;4;2022-03-02;8;2;3;0;4;1078506;6208;1129;11;3447
FR;4;2022-03-03;10;2;1;0;1;1078516;6210;1130;11;3448
FR;4;2022-03-04;6;5;2;1;4;1078522;6215;1132;12;3452
FR;4;2022-03-05;8;2;0;0;2;1078530;6217;1132;12;3454
FR;4;2022-03-06;2;0;1;0;1;1078532;6217;1133;12;3455
FR;4;2022-03-07;8;4;1;0;3;1078540;6221;1134;12;3458
FR;4;2022-03-08;13;1;0;0;1;1078553;6222;1134;12;3459
FR;4;2022-03-09;7;3;2;0;4;1078560;6225;1136;12;3463
FR;4;2022-03-10;4;0;4;0;1;1078564;6225;1140;12;3464
FR;4;2022-03-11;6;1;5;0;0;1078570;6226;1145;12;3464
FR;4;2022-03-12;9;2;0;0;0;1078579;6228;1145;12;3464
FR;4;2022-03-13;4;0;0;0;0;1078583;6228;1145;12;3464
FR;4;2022-03-14;3;0;0;0;0;1078586;6228;1145;12;3464
FR;4;2022-03-15;3;2;1;0;0;1078589;6230;1146;12;3464
FR;4;2022-03-16;4;1;3;0;2;1078593;6231;1149;12;3466
FR;4;2022-03-17;0;1;3;0;2;1078593;6232;1152;12;3468
FR;4;2022-03-18;6;0;0;0;0;1078599;6232;1152;12;3468
FR;4;2022-03-19;1;0;0;0;0;1078600;6232;1152;12;3468
FR;4;2022-03-20;2;0;0;0;0;1078602;6232;1152;12;3468
FR;4;2022-03-21;5;0;0;0;0;1078607;6232;1152;12;3468
FR;4;2022-03-22;0;1;0;0;1;1078607;6233;1152;12;3469
FR;4;2022-03-23;4;3;1;0;4;1078611;6236;1153;12;3473
FR;4;2022-03-24;2;2;0;1;1;1078613;6238;1153;13;3474
FR;4;2022-03-25;2;0;1;0;0;1078615;6238;1154;13;3474
FR;4;2022-03-26;5;5;0;0;5;1078620;6243;1154;13;3479
FR;4;2022-03-27;0;0;0;0;0;1078620;6243;1154;13;3479
FR;4;2022-03-28;3;1;0;0;0;1078623;6244;1154;13;3479
FR;4;2022-03-29;4;0;3;1;0;1078627;6244;1157;14;3479
FR;4;2022-03-30;0;1;0;0;1;1078627;6245;1157;14;3480
FR;5;2020-12-27;0;0;0;0;0;0;0;0;0;0
FR;5;2020-12-28;0;0;0;0;0;0;0;0;0;0
FR;5;2020-12-29;0;0;0;0;0;0;0;0;0;0
FR;5;2020-12-30;0;0;0;0;0;0;0;0;0;0
FR;5;2020-12-31;0;0;0;0;0;0;0;0;0;0
FR;5;2021-01-01;0;0;0;0;0;0;0;0;0;0
FR;5;2021-01-02;0;0;0;0;0;0;0;0;0;0
FR;5;2021-01-03;0;0;0;0;0;0;0;0;0;0
FR;5;2021-01-04;0;0;0;0;0;0;0;0;0;0
FR;5;2021-01-05;0;0;0;0;0;0;0;0;0;0
FR;5;2021-01-06;0;0;0;0;0;0;0;0;0;0
FR;5;2021-01-07;0;0;0;0;0;0;0;0;0;0
FR;5;2021-01-08;0;0;0;0;0;0;0;0;0;0
FR;5;2021-01-09;0;0;0;0;0;0;0;0;0;0
FR;5;2021-01-10;0;0;0;0;0;0;0;0;0;0
FR;5;2021-01-11;0;0;0;0;0;0;0;0;0;0
FR;5;2021-01-12;0;0;0;0;0;0;0;0;0;0
FR;5;2021-01-13;0;0;0;0;0;0;0;0;0;0
FR;5;2021-01-14;0;0;0;0;0;0;0;0;0;0
FR;5;2021-01-15;0;0;0;0;0;0;0;0;0;0
FR;5;2021-01-16;0;0;0;0;0;0;0;0;0;0
FR;5;2021-01-17;0;0;0;0;0;0;0;0;0;0
FR;5;2021-01-18;0;0;0;0;0;0;0;0;0;0
FR;5;2021-01-19;0;0;0;0;0;0;0;0;0;0
FR;5;2021-01-20;0;0;0;0;0;0;0;0;0;0
FR;5;2021-01-21;0;0;0;0;0;0;0;0;0;0
FR;5;2021-01-22;0;0;0;0;0;0;0;0;0;0
FR;5;2021-01-23;0;0;0;0;0;0;0;0;0;0
FR;5;2021-01-24;0;0;0;0;0;0;0;0;0;0
FR;5;2021-01-25;0;0;0;0;0;0;0;0;0;0
FR;5;2021-01-26;0;0;0;0;0;0;0;0;0;0
FR;5;2021-01-27;0;0;0;0;0;0;0;0;0;0
FR;5;2021-01-28;0;0;0;0;0;0;0;0;0;0
FR;5;2021-01-29;0;0;0;0;0;0;0;0;0;0
FR;5;2021-01-30;0;0;0;0;0;0;0;0;0;0
FR;5;2021-01-31;0;0;0;0;0;0;0;0;0;0
FR;5;2021-02-01;0;0;0;0;0;0;0;0;0;0
FR;5;2021-02-02;0;0;0;0;0;0;0;0;0;0
FR;5;2021-02-03;0;0;0;0;0;0;0;0;0;0
FR;5;2021-02-04;0;0;0;0;0;0;0;0;0;0
FR;5;2021-02-05;0;0;0;0;0;0;0;0;0;0
FR;5;2021-02-06;0;0;0;0;0;0;0;0;0;0
FR;5;2021-02-07;0;0;0;0;0;0;0;0;0;0
FR;5;2021-02-08;0;0;0;0;0;0;0;0;0;0
FR;5;2021-02-09;0;0;0;0;0;0;0;0;0;0
FR;5;2021-02-10;0;0;0;0;0;0;0;0;0;0
FR;5;2021-02-11;0;0;0;0;0;0;0;0;0;0
FR;5;2021-02-12;0;0;0;0;0;0;0;0;0;0
FR;5;2021-02-13;0;0;0;0;0;0;0;0;0;0
FR;5;2021-02-14;0;0;0;0;0;0;0;0;0;0
FR;5;2021-02-15;0;0;0;0;0;0;0;0;0;0
FR;5;2021-02-16;0;0;0;0;0;0;0;0;0;0
FR;5;2021-02-17;0;0;0;0;0;0;0;0;0;0
FR;5;2021-02-18;0;0;0;0;0;0;0;0;0;0
FR;5;2021-02-19;0;0;0;0;0;0;0;0;0;0
FR;5;2021-02-20;0;0;0;0;0;0;0;0;0;0
FR;5;2021-02-21;0;0;0;0;0;0;0;0;0;0
FR;5;2021-02-22;0;0;0;0;0;0;0;0;0;0
FR;5;2021-02-23;0;0;0;0;0;0;0;0;0;0
FR;5;2021-02-24;0;0;0;0;0;0;0;0;0;0
FR;5;2021-02-25;0;0;0;0;0;0;0;0;0;0
FR;5;2021-02-26;0;0;0;0;0;0;0;0;0;0
FR;5;2021-02-27;0;0;0;0;0;0;0;0;0;0
FR;5;2021-02-28;0;0;0;0;0;0;0;0;0;0
FR;5;2021-03-01;0;0;0;0;0;0;0;0;0;0
FR;5;2021-03-02;0;0;0;0;0;0;0;0;0;0
FR;5;2021-03-03;0;0;0;0;0;0;0;0;0;0
FR;5;2021-03-04;0;0;0;0;0;0;0;0;0;0
FR;5;2021-03-05;0;0;0;0;0;0;0;0;0;0
FR;5;2021-03-06;0;0;0;0;0;0;0;0;0;0
FR;5;2021-03-07;0;0;0;0;0;0;0;0;0;0
FR;5;2021-03-08;0;0;0;0;0;0;0;0;0;0
FR;5;2021-03-09;0;0;0;0;0;0;0;0;0;0
FR;5;2021-03-10;0;0;0;0;0;0;0;0;0;0
FR;5;2021-03-11;0;0;0;0;0;0;0;0;0;0
FR;5;2021-03-12;0;0;0;0;0;0;0;0;0;0
FR;5;2021-03-13;0;0;0;0;0;0;0;0;0;0
FR;5;2021-03-14;0;0;0;0;0;0;0;0;0;0
FR;5;2021-03-15;0;0;0;0;0;0;0;0;0;0
FR;5;2021-03-16;0;0;0;0;0;0;0;0;0;0
FR;5;2021-03-17;0;0;0;0;0;0;0;0;0;0
FR;5;2021-03-18;0;0;0;0;0;0;0;0;0;0
FR;5;2021-03-19;0;0;0;0;0;0;0;0;0;0
FR;5;2021-03-20;0;0;0;0;0;0;0;0;0;0
FR;5;2021-03-21;0;0;0;0;0;0;0;0;0;0
FR;5;2021-03-22;0;0;0;0;0;0;0;0;0;0
FR;5;2021-03-23;0;0;0;0;0;0;0;0;0;0
FR;5;2021-03-24;0;0;0;0;0;0;0;0;0;0
FR;5;2021-03-25;0;0;0;0;0;0;0;0;0;0
FR;5;2021-03-26;0;0;0;0;0;0;0;0;0;0
FR;5;2021-03-27;0;0;0;0;0;0;0;0;0;0
FR;5;2021-03-28;0;0;0;0;0;0;0;0;0;0
FR;5;2021-03-29;0;0;0;0;0;0;0;0;0;0
FR;5;2021-03-30;0;0;0;0;0;0;0;0;0;0
FR;5;2021-03-31;0;0;0;0;0;0;0;0;0;0
FR;5;2021-04-01;0;0;0;0;0;0;0;0;0;0
FR;5;2021-04-02;0;0;0;0;0;0;0;0;0;0
FR;5;2021-04-03;0;0;0;0;0;0;0;0;0;0
FR;5;2021-04-04;0;0;0;0;0;0;0;0;0;0
FR;5;2021-04-05;0;0;0;0;0;0;0;0;0;0
FR;5;2021-04-06;0;0;0;0;0;0;0;0;0;0
FR;5;2021-04-07;0;0;0;0;0;0;0;0;0;0
FR;5;2021-04-08;0;0;0;0;0;0;0;0;0;0
FR;5;2021-04-09;0;0;0;0;0;0;0;0;0;0
FR;5;2021-04-10;0;0;0;0;0;0;0;0;0;0
FR;5;2021-04-11;0;0;0;0;0;0;0;0;0;0
FR;5;2021-04-12;0;0;0;0;0;0;0;0;0;0
FR;5;2021-04-13;0;0;0;0;0;0;0;0;0;0
FR;5;2021-04-14;0;0;0;0;0;0;0;0;0;0
FR;5;2021-04-15;0;0;0;0;0;0;0;0;0;0
FR;5;2021-04-16;0;0;0;0;0;0;0;0;0;0
FR;5;2021-04-17;0;0;0;0;0;0;0;0;0;0
FR;5;2021-04-18;0;0;0;0;0;0;0;0;0;0
FR;5;2021-04-19;0;0;0;0;0;0;0;0;0;0
FR;5;2021-04-20;0;0;0;0;0;0;0;0;0;0
FR;5;2021-04-21;0;0;0;0;0;0;0;0;0;0
FR;5;2021-04-22;0;0;0;0;0;0;0;0;0;0
FR;5;2021-04-23;0;0;0;0;0;0;0;0;0;0
FR;5;2021-04-24;0;0;0;0;0;0;0;0;0;0
FR;5;2021-04-25;0;0;0;0;0;0;0;0;0;0
FR;5;2021-04-26;0;0;0;0;0;0;0;0;0;0
FR;5;2021-04-27;0;0;0;0;0;0;0;0;0;0
FR;5;2021-04-28;0;0;0;0;0;0;0;0;0;0
FR;5;2021-04-29;0;0;0;0;0;0;0;0;0;0
FR;5;2021-04-30;0;0;0;0;0;0;0;0;0;0
FR;5;2021-05-01;0;0;0;0;0;0;0;0;0;0
FR;5;2021-05-02;0;0;0;0;0;0;0;0;0;0
FR;5;2021-05-03;0;0;0;0;0;0;0;0;0;0
FR;5;2021-05-04;0;0;0;0;0;0;0;0;0;0
FR;5;2021-05-05;0;0;0;0;0;0;0;0;0;0
FR;5;2021-05-06;0;0;0;0;0;0;0;0;0;0
FR;5;2021-05-07;0;0;0;0;0;0;0;0;0;0
FR;5;2021-05-08;0;0;0;0;0;0;0;0;0;0
FR;5;2021-05-09;0;0;0;0;0;0;0;0;0;0
FR;5;2021-05-10;0;0;0;0;0;0;0;0;0;0
FR;5;2021-05-11;0;0;0;0;0;0;0;0;0;0
FR;5;2021-05-12;0;0;0;0;0;0;0;0;0;0
FR;5;2021-05-13;0;0;0;0;0;0;0;0;0;0
FR;5;2021-05-14;0;0;0;0;0;0;0;0;0;0
FR;5;2021-05-15;0;0;0;0;0;0;0;0;0;0
FR;5;2021-05-16;0;0;0;0;0;0;0;0;0;0
FR;5;2021-05-17;0;0;0;0;0;0;0;0;0;0
FR;5;2021-05-18;0;0;0;0;0;0;0;0;0;0
FR;5;2021-05-19;0;0;0;0;0;0;0;0;0;0
FR;5;2021-05-20;0;0;0;0;0;0;0;0;0;0
FR;5;2021-05-21;0;0;0;0;0;0;0;0;0;0
FR;5;2021-05-22;0;0;0;0;0;0;0;0;0;0
FR;5;2021-05-23;0;0;0;0;0;0;0;0;0;0
FR;5;2021-05-24;0;0;0;0;0;0;0;0;0;0
FR;5;2021-05-25;0;0;0;0;0;0;0;0;0;0
FR;5;2021-05-26;0;0;0;0;0;0;0;0;0;0
FR;5;2021-05-27;0;0;0;0;0;0;0;0;0;0
FR;5;2021-05-28;0;0;0;0;0;0;0;0;0;0
FR;5;2021-05-29;0;0;0;0;0;0;0;0;0;0
FR;5;2021-05-30;0;0;0;0;0;0;0;0;0;0
FR;5;2021-05-31;0;0;0;0;0;0;0;0;0;0
FR;5;2021-06-01;0;0;0;0;0;0;0;0;0;0
FR;5;2021-06-02;0;0;0;0;0;0;0;0;0;0
FR;5;2021-06-03;0;0;0;0;0;0;0;0;0;0
FR;5;2021-06-04;0;0;0;0;0;0;0;0;0;0
FR;5;2021-06-05;0;0;0;0;0;0;0;0;0;0
FR;5;2021-06-06;0;0;0;0;0;0;0;0;0;0
FR;5;2021-06-07;0;0;0;0;0;0;0;0;0;0
FR;5;2021-06-08;0;0;0;0;0;0;0;0;0;0
FR;5;2021-06-09;0;0;0;0;0;0;0;0;0;0
FR;5;2021-06-10;0;0;0;0;0;0;0;0;0;0
FR;5;2021-06-11;0;0;0;0;0;0;0;0;0;0
FR;5;2021-06-12;0;0;0;0;0;0;0;0;0;0
FR;5;2021-06-13;0;0;0;0;0;0;0;0;0;0
FR;5;2021-06-14;0;0;0;0;0;0;0;0;0;0
FR;5;2021-06-15;0;0;0;0;0;0;0;0;0;0
FR;5;2021-06-16;0;0;0;0;0;0;0;0;0;0
FR;5;2021-06-17;0;0;0;0;0;0;0;0;0;0
FR;5;2021-06-18;0;0;0;0;0;0;0;0;0;0
FR;5;2021-06-19;0;0;0;0;0;0;0;0;0;0
FR;5;2021-06-20;0;0;0;0;0;0;0;0;0;0
FR;5;2021-06-21;0;0;0;0;0;0;0;0;0;0
FR;5;2021-06-22;0;0;0;0;0;0;0;0;0;0
FR;5;2021-06-23;0;0;0;0;0;0;0;0;0;0
FR;5;2021-06-24;0;0;0;0;0;0;0;0;0;0
FR;5;2021-06-25;0;0;0;0;0;0;0;0;0;0
FR;5;2021-06-26;0;0;0;0;0;0;0;0;0;0
FR;5;2021-06-27;0;0;0;0;0;0;0;0;0;0
FR;5;2021-06-28;0;0;0;0;0;0;0;0;0;0
FR;5;2021-06-29;0;0;0;0;0;0;0;0;0;0
FR;5;2021-06-30;0;0;0;0;0;0;0;0;0;0
FR;5;2021-07-01;0;0;0;0;0;0;0;0;0;0
FR;5;2021-07-02;0;0;0;0;0;0;0;0;0;0
FR;5;2021-07-03;0;0;0;0;0;0;0;0;0;0
FR;5;2021-07-04;0;0;0;0;0;0;0;0;0;0
FR;5;2021-07-05;0;0;0;0;0;0;0;0;0;0
FR;5;2021-07-06;0;0;0;0;0;0;0;0;0;0
FR;5;2021-07-07;0;0;0;0;0;0;0;0;0;0
FR;5;2021-07-08;0;0;0;0;0;0;0;0;0;0
FR;5;2021-07-09;0;0;0;0;0;0;0;0;0;0
FR;5;2021-07-10;0;0;0;0;0;0;0;0;0;0
FR;5;2021-07-11;0;0;0;0;0;0;0;0;0;0
FR;5;2021-07-12;0;0;0;0;0;0;0;0;0;0
FR;5;2021-07-13;0;0;0;0;0;0;0;0;0;0
FR;5;2021-07-14;0;0;0;0;0;0;0;0;0;0
FR;5;2021-07-15;0;0;0;0;0;0;0;0;0;0
FR;5;2021-07-16;0;0;0;0;0;0;0;0;0;0
FR;5;2021-07-17;0;0;0;0;0;0;0;0;0;0
FR;5;2021-07-18;0;0;0;0;0;0;0;0;0;0
FR;5;2021-07-19;0;0;0;0;0;0;0;0;0;0
FR;5;2021-07-20;0;0;0;0;0;0;0;0;0;0
FR;5;2021-07-21;0;0;0;0;0;0;0;0;0;0
FR;5;2021-07-22;0;0;0;0;0;0;0;0;0;0
FR;5;2021-07-23;0;0;0;0;0;0;0;0;0;0
FR;5;2021-07-24;0;0;0;0;0;0;0;0;0;0
FR;5;2021-07-25;0;0;0;0;0;0;0;0;0;0
FR;5;2021-07-26;0;0;0;0;0;0;0;0;0;0
FR;5;2021-07-27;0;0;0;0;0;0;0;0;0;0
FR;5;2021-07-28;0;0;0;0;0;0;0;0;0;0
FR;5;2021-07-29;0;0;0;0;0;0;0;0;0;0
FR;5;2021-07-30;0;0;0;0;0;0;0;0;0;0
FR;5;2021-07-31;0;0;0;0;0;0;0;0;0;0
FR;5;2021-08-01;0;0;0;0;0;0;0;0;0;0
FR;5;2021-08-02;0;0;0;0;0;0;0;0;0;0
FR;5;2021-08-03;0;0;0;0;0;0;0;0;0;0
FR;5;2021-08-04;0;0;0;0;0;0;0;0;0;0
FR;5;2021-08-05;0;0;0;0;0;0;0;0;0;0
FR;5;2021-08-06;0;0;0;0;0;0;0;0;0;0
FR;5;2021-08-07;0;0;0;0;0;0;0;0;0;0
FR;5;2021-08-08;0;0;0;0;0;0;0;0;0;0
FR;5;2021-08-09;0;0;0;0;0;0;0;0;0;0
FR;5;2021-08-10;0;0;0;0;0;0;0;0;0;0
FR;5;2021-08-11;0;0;0;0;0;0;0;0;0;0
FR;5;2021-08-12;0;0;0;0;0;0;0;0;0;0
FR;5;2021-08-13;0;0;0;0;0;0;0;0;0;0
FR;5;2021-08-14;0;0;0;0;0;0;0;0;0;0
FR;5;2021-08-15;0;0;0;0;0;0;0;0;0;0
FR;5;2021-08-16;0;0;0;0;0;0;0;0;0;0
FR;5;2021-08-17;0;0;0;0;0;0;0;0;0;0
FR;5;2021-08-18;0;0;0;0;0;0;0;0;0;0
FR;5;2021-08-19;0;0;0;0;0;0;0;0;0;0
FR;5;2021-08-20;0;0;0;0;0;0;0;0;0;0
FR;5;2021-08-21;0;0;0;0;0;0;0;0;0;0
FR;5;2021-08-22;0;0;0;0;0;0;0;0;0;0
FR;5;2021-08-23;0;0;0;0;0;0;0;0;0;0
FR;5;2021-08-24;0;0;0;0;0;0;0;0;0;0
FR;5;2021-08-25;0;0;0;0;0;0;0;0;0;0
FR;5;2021-08-26;0;0;0;0;0;0;0;0;0;0
FR;5;2021-08-27;0;0;0;0;0;0;0;0;0;0
FR;5;2021-08-28;0;0;0;0;0;0;0;0;0;0
FR;5;2021-08-29;0;0;0;0;0;0;0;0;0;0
FR;5;2021-08-30;0;0;0;0;0;0;0;0;0;0
FR;5;2021-08-31;0;0;0;0;0;0;0;0;0;0
FR;5;2021-09-01;0;0;0;0;0;0;0;0;0;0
FR;5;2021-09-02;0;0;0;0;0;0;0;0;0;0
FR;5;2021-09-03;0;0;0;0;0;0;0;0;0;0
FR;5;2021-09-04;0;0;0;0;0;0;0;0;0;0
FR;5;2021-09-05;0;0;0;0;0;0;0;0;0;0
FR;5;2021-09-06;0;0;0;0;0;0;0;0;0;0
FR;5;2021-09-07;0;0;0;0;0;0;0;0;0;0
FR;5;2021-09-08;0;0;0;0;0;0;0;0;0;0
FR;5;2021-09-09;0;0;0;0;0;0;0;0;0;0
FR;5;2021-09-10;0;0;0;0;0;0;0;0;0;0
FR;5;2021-09-11;0;0;0;0;0;0;0;0;0;0
FR;5;2021-09-12;0;0;0;0;0;0;0;0;0;0
FR;5;2021-09-13;0;0;0;0;0;0;0;0;0;0
FR;5;2021-09-14;0;0;0;0;0;0;0;0;0;0
FR;5;2021-09-15;0;0;0;0;0;0;0;0;0;0
FR;5;2021-09-16;0;0;0;0;0;0;0;0;0;0
FR;5;2021-09-17;0;0;0;0;0;0;0;0;0;0
FR;5;2021-09-18;0;0;0;0;0;0;0;0;0;0
FR;5;2021-09-19;0;0;0;0;0;0;0;0;0;0
FR;5;2021-09-20;0;0;0;0;0;0;0;0;0;0
FR;5;2021-09-21;0;0;0;0;0;0;0;0;0;0
FR;5;2021-09-22;0;0;0;0;0;0;0;0;0;0
FR;5;2021-09-23;0;0;0;0;0;0;0;0;0;0
FR;5;2021-09-24;0;0;0;0;0;0;0;0;0;0
FR;5;2021-09-25;0;0;0;0;0;0;0;0;0;0
FR;5;2021-09-26;0;0;0;0;0;0;0;0;0;0
FR;5;2021-09-27;0;0;0;0;0;0;0;0;0;0
FR;5;2021-09-28;0;0;0;0;0;0;0;0;0;0
FR;5;2021-09-29;0;0;0;0;0;0;0;0;0;0
FR;5;2021-09-30;0;0;0;0;0;0;0;0;0;0
FR;5;2021-10-01;0;0;0;0;0;0;0;0;0;0
FR;5;2021-10-02;0;0;0;0;0;0;0;0;0;0
FR;5;2021-10-03;0;0;0;0;0;0;0;0;0;0
FR;5;2021-10-04;0;0;0;0;0;0;0;0;0;0
FR;5;2021-10-05;0;0;0;0;0;0;0;0;0;0
FR;5;2021-10-06;0;0;0;0;0;0;0;0;0;0
FR;5;2021-10-07;0;0;0;0;0;0;0;0;0;0
FR;5;2021-10-08;0;0;0;0;0;0;0;0;0;0
FR;5;2021-10-09;0;0;0;0;0;0;0;0;0;0
FR;5;2021-10-10;0;0;0;0;0;0;0;0;0;0
FR;5;2021-10-11;0;0;0;0;0;0;0;0;0;0
FR;5;2021-10-12;0;0;0;0;0;0;0;0;0;0
FR;5;2021-10-13;0;0;0;0;0;0;0;0;0;0
FR;5;2021-10-14;0;0;0;0;0;0;0;0;0;0
FR;5;2021-10-15;0;0;0;0;0;0;0;0;0;0
FR;5;2021-10-16;0;0;0;0;0;0;0;0;0;0
FR;5;2021-10-17;0;0;0;0;0;0;0;0;0;0
FR;5;2021-10-18;0;0;0;0;0;0;0;0;0;0
FR;5;2021-10-19;0;0;0;0;0;0;0;0;0;0
FR;5;2021-10-20;0;0;0;0;0;0;0;0;0;0
FR;5;2021-10-21;0;0;0;0;0;0;0;0;0;0
FR;5;2021-10-22;0;0;0;0;0;0;0;0;0;0
FR;5;2021-10-23;0;0;0;0;0;0;0;0;0;0
FR;5;2021-10-24;0;0;0;0;0;0;0;0;0;0
FR;5;2021-10-25;0;0;0;0;0;0;0;0;0;0
FR;5;2021-10-26;0;0;0;0;0;0;0;0;0;0
FR;5;2021-10-27;0;0;0;0;0;0;0;0;0;0
FR;5;2021-10-28;0;0;0;0;0;0;0;0;0;0
FR;5;2021-10-29;0;0;0;0;0;0;0;0;0;0
FR;5;2021-10-30;0;0;0;0;0;0;0;0;0;0
FR;5;2021-10-31;0;0;0;0;0;0;0;0;0;0
FR;5;2021-11-01;0;0;0;0;0;0;0;0;0;0
FR;5;2021-11-02;0;0;0;0;0;0;0;0;0;0
FR;5;2021-11-03;0;0;0;0;0;0;0;0;0;0
FR;5;2021-11-04;0;0;0;0;0;0;0;0;0;0
FR;5;2021-11-05;0;0;0;0;0;0;0;0;0;0
FR;5;2021-11-06;0;0;0;0;0;0;0;0;0;0
FR;5;2021-11-07;0;0;0;0;0;0;0;0;0;0
FR;5;2021-11-08;0;0;0;0;0;0;0;0;0;0
FR;5;2021-11-09;0;0;0;0;0;0;0;0;0;0
FR;5;2021-11-10;0;0;0;0;0;0;0;0;0;0
FR;5;2021-11-11;0;0;0;0;0;0;0;0;0;0
FR;5;2021-11-12;0;0;0;0;0;0;0;0;0;0
FR;5;2021-11-13;0;0;0;0;0;0;0;0;0;0
FR;5;2021-11-14;0;0;0;0;0;0;0;0;0;0
FR;5;2021-11-15;0;0;0;0;0;0;0;0;0;0
FR;5;2021-11-16;0;0;0;0;0;0;0;0;0;0
FR;5;2021-11-17;0;0;0;0;0;0;0;0;0;0
FR;5;2021-11-18;0;0;0;0;0;0;0;0;0;0
FR;5;2021-11-19;0;0;0;0;0;0;0;0;0;0
FR;5;2021-11-20;0;0;0;0;0;0;0;0;0;0
FR;5;2021-11-21;0;0;0;0;0;0;0;0;0;0
FR;5;2021-11-22;0;0;0;0;0;0;0;0;0;0
FR;5;2021-11-23;0;0;0;0;0;0;0;0;0;0
FR;5;2021-11-24;0;0;0;0;0;0;0;0;0;0
FR;5;2021-11-25;0;0;0;0;0;0;0;0;0;0
FR;5;2021-11-26;0;0;0;0;0;0;0;0;0;0
FR;5;2021-11-27;0;0;0;0;0;0;0;0;0;0
FR;5;2021-11-28;0;0;0;0;0;0;0;0;0;0
FR;5;2021-11-29;0;0;0;0;0;0;0;0;0;0
FR;5;2021-11-30;0;0;0;0;0;0;0;0;0;0
FR;5;2021-12-01;0;0;0;0;0;0;0;0;0;0
FR;5;2021-12-02;0;0;0;0;0;0;0;0;0;0
FR;5;2021-12-03;0;0;0;0;0;0;0;0;0;0
FR;5;2021-12-04;0;0;0;0;0;0;0;0;0;0
FR;5;2021-12-05;0;0;0;0;0;0;0;0;0;0
FR;5;2021-12-06;0;0;0;0;0;0;0;0;0;0
FR;5;2021-12-07;0;0;0;0;0;0;0;0;0;0
FR;5;2021-12-08;0;0;0;0;0;0;0;0;0;0
FR;5;2021-12-09;0;0;0;0;0;0;0;0;0;0
FR;5;2021-12-10;0;0;0;0;0;0;0;0;0;0
FR;5;2021-12-11;0;0;0;0;0;0;0;0;0;0
FR;5;2021-12-12;0;0;0;0;0;0;0;0;0;0
FR;5;2021-12-13;0;0;0;0;0;0;0;0;0;0
FR;5;2021-12-14;28;45;77;0;88;28;45;77;0;88
FR;5;2021-12-15;195;43;37;0;49;223;88;114;0;137
FR;5;2021-12-16;180;21;44;0;48;403;109;158;0;185
FR;5;2021-12-17;310;16;72;0;74;713;125;230;0;259
FR;5;2021-12-18;762;24;22;0;29;1475;149;252;0;288
FR;5;2021-12-19;586;15;15;0;17;2061;164;267;0;305
FR;5;2021-12-20;1220;31;35;0;38;3281;195;302;0;343
FR;5;2021-12-21;1534;22;54;1;60;4815;217;356;1;403
FR;5;2021-12-22;4069;40;37;0;46;8884;257;393;1;449
FR;5;2021-12-23;3040;16;21;0;25;11924;273;414;1;474
FR;5;2021-12-24;759;18;9;0;15;12683;291;423;1;489
FR;5;2021-12-25;61;5;1;0;2;12744;296;424;1;491
FR;5;2021-12-26;623;6;3;0;4;13367;302;427;1;495
FR;5;2021-12-27;4080;25;21;0;23;17447;327;448;1;518
FR;5;2021-12-28;5199;22;41;1;42;22646;349;489;2;560
FR;5;2021-12-29;8101;34;65;2;68;30747;383;554;4;628
FR;5;2021-12-30;5171;18;33;0;39;35918;401;587;4;667
FR;5;2021-12-31;1553;8;10;0;11;37471;409;597;4;678
FR;5;2022-01-01;185;1;2;0;2;37656;410;599;4;680
FR;5;2022-01-02;1489;1;1;0;1;39145;411;600;4;681
FR;5;2022-01-03;3053;36;33;0;32;42198;447;633;4;713
FR;5;2022-01-04;3034;39;33;0;42;45232;486;666;4;755
FR;5;2022-01-05;19311;202;97;1;107;64543;688;763;5;862
FR;5;2022-01-06;3739;133;122;0;142;68282;821;885;5;1004
FR;5;2022-01-07;5006;200;48;2;56;73288;1021;933;7;1060
FR;5;2022-01-08;13648;513;45;0;52;86936;1534;978;7;1112
FR;5;2022-01-09;5755;399;15;0;20;92691;1933;993;7;1132
FR;5;2022-01-10;3452;326;25;0;29;96143;2259;1018;7;1161
FR;5;2022-01-11;3667;284;38;0;41;99810;2543;1056;7;1202
FR;5;2022-01-12;22650;3003;90;0;113;122460;5546;1146;7;1315
FR;5;2022-01-13;4033;622;30;0;32;126493;6168;1176;7;1347
FR;5;2022-01-14;4842;581;43;0;50;131335;6749;1219;7;1397
FR;5;2022-01-15;14678;1746;38;3;49;146013;8495;1257;10;1446
FR;5;2022-01-16;4727;666;3;0;5;150740;9161;1260;10;1451
FR;5;2022-01-17;2294;715;26;0;29;153034;9876;1286;10;1480
FR;5;2022-01-18;2429;869;30;0;40;155463;10745;1316;10;1520
FR;5;2022-01-19;18479;6418;74;2;142;173942;17163;1390;12;1662
FR;5;2022-01-20;1918;1067;24;0;33;175860;18230;1414;12;1695
FR;5;2022-01-21;3074;1369;47;1;59;178934;19599;1461;13;1754
FR;5;2022-01-22;10720;3454;33;1;43;189654;23053;1494;14;1797
FR;5;2022-01-23;2627;1413;5;0;8;192281;24466;1499;14;1805
FR;5;2022-01-24;1157;1340;19;0;23;193438;25806;1518;14;1828
FR;5;2022-01-25;1218;1548;19;2;29;194656;27354;1537;16;1857
FR;5;2022-01-26;10744;12014;50;1;89;205400;39368;1587;17;1946
FR;5;2022-01-27;1291;1690;10;0;17;206691;41058;1597;17;1963
FR;5;2022-01-28;1695;3347;16;0;19;208386;44405;1613;17;1982
FR;5;2022-01-29;6237;8040;68;0;96;214623;52445;1681;17;2078
FR;5;2022-01-30;1509;2950;5;0;18;216132;55395;1686;17;2096
FR;5;2022-01-31;587;1772;23;0;24;216719;57167;1709;17;2120
FR;5;2022-02-01;709;1702;10;0;15;217428;58869;1719;17;2135
FR;5;2022-02-02;6952;15653;52;0;94;224380;74522;1771;17;2229
FR;5;2022-02-03;486;1688;13;0;11;224866;76210;1784;17;2240
FR;5;2022-02-04;937;3001;19;0;31;225803;79211;1803;17;2271
FR;5;2022-02-05;3531;8914;23;0;37;229334;88125;1826;17;2308
FR;5;2022-02-06;736;2397;10;0;19;230070;90522;1836;17;2327
FR;5;2022-02-07;882;1595;22;0;24;230952;92117;1858;17;2351
FR;5;2022-02-08;719;1283;18;0;19;231671;93400;1876;17;2370
FR;5;2022-02-09;4533;12874;44;0;76;236204;106274;1920;17;2446
FR;5;2022-02-10;645;1058;13;0;14;236849;107332;1933;17;2460
FR;5;2022-02-11;793;2026;16;0;21;237642;109358;1949;17;2481
FR;5;2022-02-12;2285;6809;32;0;52;239927;116167;1981;17;2533
FR;5;2022-02-13;465;1539;8;0;8;240392;117706;1989;17;2541
FR;5;2022-02-14;678;1288;10;0;13;241070;118994;1999;17;2554
FR;5;2022-02-15;482;883;9;0;14;241552;119877;2008;17;2568
FR;5;2022-02-16;2977;9122;41;1;58;244529;128999;2049;18;2626
FR;5;2022-02-17;435;803;6;0;7;244964;129802;2055;18;2633
FR;5;2022-02-18;648;1407;13;0;17;245612;131209;2068;18;2650
FR;5;2022-02-19;1370;4314;16;0;28;246982;135523;2084;18;2678
FR;5;2022-02-20;247;879;6;0;8;247229;136402;2090;18;2686
FR;5;2022-02-21;220;605;2;0;4;247449;137007;2092;18;2690
FR;5;2022-02-22;259;544;17;0;17;247708;137551;2109;18;2707
FR;5;2022-02-23;1907;6920;22;1;42;249615;144471;2131;19;2749
FR;5;2022-02-24;181;371;5;1;5;249796;144842;2136;20;2754
FR;5;2022-02-25;333;949;13;0;12;250129;145791;2149;20;2766
FR;5;2022-02-26;970;3065;10;0;14;251099;148856;2159;20;2780
FR;5;2022-02-27;146;506;0;0;3;251245;149362;2159;20;2783
FR;5;2022-02-28;160;369;1;0;1;251405;149731;2160;20;2784
FR;5;2022-03-01;123;278;6;0;7;251528;150009;2166;20;2791
FR;5;2022-03-02;1236;4146;28;3;40;252764;154155;2194;23;2831
FR;5;2022-03-03;117;249;6;0;9;252881;154404;2200;23;2840
FR;5;2022-03-04;192;482;13;0;13;253073;154886;2213;23;2853
FR;5;2022-03-05;675;1990;8;0;16;253748;156876;2221;23;2869
FR;5;2022-03-06;107;260;0;0;0;253855;157136;2221;23;2869
FR;5;2022-03-07;70;228;4;0;3;253925;157364;2225;23;2872
FR;5;2022-03-08;46;128;7;1;7;253971;157492;2232;24;2879
FR;5;2022-03-09;904;3075;23;0;35;254875;160567;2255;24;2914
FR;5;2022-03-10;81;200;7;0;10;254956;160767;2262;24;2924
FR;5;2022-03-11;145;368;14;1;15;255101;161135;2276;25;2939
FR;5;2022-03-12;758;1613;12;1;29;255859;162748;2288;26;2968
FR;5;2022-03-13;76;99;0;0;0;255935;162847;2288;26;2968
FR;5;2022-03-14;67;116;7;1;7;256002;162963;2295;27;2975
FR;5;2022-03-15;81;99;3;0;6;256083;163062;2298;27;2981
FR;5;2022-03-16;880;1822;15;3;34;256963;164884;2313;30;3015
FR;5;2022-03-17;66;122;8;4;10;257029;165006;2321;34;3025
FR;5;2022-03-18;170;318;13;3;18;257199;165324;2334;37;3043
FR;5;2022-03-19;748;1160;12;5;32;257947;166484;2346;42;3075
FR;5;2022-03-20;44;92;1;0;1;257991;166576;2347;42;3076
FR;5;2022-03-21;71;115;10;6;15;258062;166691;2357;48;3091
FR;5;2022-03-22;55;113;8;6;8;258117;166804;2365;54;3099
FR;5;2022-03-23;799;1457;13;8;35;258916;168261;2378;62;3134
FR;5;2022-03-24;67;89;8;7;7;258983;168350;2386;69;3141
FR;5;2022-03-25;220;286;14;8;17;259203;168636;2400;77;3158
FR;5;2022-03-26;702;848;12;6;26;259905;169484;2412;83;3184
FR;5;2022-03-27;74;78;0;0;3;259979;169562;2412;83;3187
FR;5;2022-03-28;80;91;1;2;3;260059;169653;2413;85;3190
FR;5;2022-03-29;66;81;10;4;12;260125;169734;2423;89;3202
FR;5;2022-03-30;812;1104;13;13;28;260937;170838;2436;102;3230
FR;6;2020-12-27;0;0;0;0;0;0;0;0;0;0
FR;6;2020-12-28;0;0;0;0;0;0;0;0;0;0
FR;6;2020-12-29;0;0;0;0;0;0;0;0;0;0
FR;6;2020-12-30;0;0;0;0;0;0;0;0;0;0
FR;6;2020-12-31;0;0;0;0;0;0;0;0;0;0
FR;6;2021-01-01;0;0;0;0;0;0;0;0;0;0
FR;6;2021-01-02;0;0;0;0;0;0;0;0;0;0
FR;6;2021-01-03;0;0;0;0;0;0;0;0;0;0
FR;6;2021-01-04;0;0;0;0;0;0;0;0;0;0
FR;6;2021-01-05;0;0;0;0;0;0;0;0;0;0
FR;6;2021-01-06;0;0;0;0;0;0;0;0;0;0
FR;6;2021-01-07;0;0;0;0;0;0;0;0;0;0
FR;6;2021-01-08;0;0;0;0;0;0;0;0;0;0
FR;6;2021-01-09;0;0;0;0;0;0;0;0;0;0
FR;6;2021-01-10;0;0;0;0;0;0;0;0;0;0
FR;6;2021-01-11;0;0;0;0;0;0;0;0;0;0
FR;6;2021-01-12;0;0;0;0;0;0;0;0;0;0
FR;6;2021-01-13;0;0;0;0;0;0;0;0;0;0
FR;6;2021-01-14;0;0;0;0;0;0;0;0;0;0
FR;6;2021-01-15;0;0;0;0;0;0;0;0;0;0
FR;6;2021-01-16;0;0;0;0;0;0;0;0;0;0
FR;6;2021-01-17;0;0;0;0;0;0;0;0;0;0
FR;6;2021-01-18;0;0;0;0;0;0;0;0;0;0
FR;6;2021-01-19;0;0;0;0;0;0;0;0;0;0
FR;6;2021-01-20;0;0;0;0;0;0;0;0;0;0
FR;6;2021-01-21;0;0;0;0;0;0;0;0;0;0
FR;6;2021-01-22;0;0;0;0;0;0;0;0;0;0
FR;6;2021-01-23;0;0;0;0;0;0;0;0;0;0
FR;6;2021-01-24;0;0;0;0;0;0;0;0;0;0
FR;6;2021-01-25;0;0;0;0;0;0;0;0;0;0
FR;6;2021-01-26;0;0;0;0;0;0;0;0;0;0
FR;6;2021-01-27;0;0;0;0;0;0;0;0;0;0
FR;6;2021-01-28;0;0;0;0;0;0;0;0;0;0
FR;6;2021-01-29;0;0;0;0;0;0;0;0;0;0
FR;6;2021-01-30;0;0;0;0;0;0;0;0;0;0
FR;6;2021-01-31;0;0;0;0;0;0;0;0;0;0
FR;6;2021-02-01;0;0;0;0;0;0;0;0;0;0
FR;6;2021-02-02;0;0;0;0;0;0;0;0;0;0
FR;6;2021-02-03;0;0;0;0;0;0;0;0;0;0
FR;6;2021-02-04;0;0;0;0;0;0;0;0;0;0
FR;6;2021-02-05;0;0;0;0;0;0;0;0;0;0
FR;6;2021-02-06;0;0;0;0;0;0;0;0;0;0
FR;6;2021-02-07;0;0;0;0;0;0;0;0;0;0
FR;6;2021-02-08;0;0;0;0;0;0;0;0;0;0
FR;6;2021-02-09;0;0;0;0;0;0;0;0;0;0
FR;6;2021-02-10;0;0;0;0;0;0;0;0;0;0
FR;6;2021-02-11;0;0;0;0;0;0;0;0;0;0
FR;6;2021-02-12;0;0;0;0;0;0;0;0;0;0
FR;6;2021-02-13;0;0;0;0;0;0;0;0;0;0
FR;6;2021-02-14;0;0;0;0;0;0;0;0;0;0
FR;6;2021-02-15;0;0;0;0;0;0;0;0;0;0
FR;6;2021-02-16;0;0;0;0;0;0;0;0;0;0
FR;6;2021-02-17;0;0;0;0;0;0;0;0;0;0
FR;6;2021-02-18;0;0;0;0;0;0;0;0;0;0
FR;6;2021-02-19;0;0;0;0;0;0;0;0;0;0
FR;6;2021-02-20;0;0;0;0;0;0;0;0;0;0
FR;6;2021-02-21;0;0;0;0;0;0;0;0;0;0
FR;6;2021-02-22;0;0;0;0;0;0;0;0;0;0
FR;6;2021-02-23;0;0;0;0;0;0;0;0;0;0
FR;6;2021-02-24;0;0;0;0;0;0;0;0;0;0
FR;6;2021-02-25;0;0;0;0;0;0;0;0;0;0
FR;6;2021-02-26;0;0;0;0;0;0;0;0;0;0
FR;6;2021-02-27;0;0;0;0;0;0;0;0;0;0
FR;6;2021-02-28;0;0;0;0;0;0;0;0;0;0
FR;6;2021-03-01;0;0;0;0;0;0;0;0;0;0
FR;6;2021-03-02;0;0;0;0;0;0;0;0;0;0
FR;6;2021-03-03;0;0;0;0;0;0;0;0;0;0
FR;6;2021-03-04;0;0;0;0;0;0;0;0;0;0
FR;6;2021-03-05;0;0;0;0;0;0;0;0;0;0
FR;6;2021-03-06;0;0;0;0;0;0;0;0;0;0
FR;6;2021-03-07;0;0;0;0;0;0;0;0;0;0
FR;6;2021-03-08;0;0;0;0;0;0;0;0;0;0
FR;6;2021-03-09;0;0;0;0;0;0;0;0;0;0
FR;6;2021-03-10;0;0;0;0;0;0;0;0;0;0
FR;6;2021-03-11;0;0;0;0;0;0;0;0;0;0
FR;6;2021-03-12;0;0;0;0;0;0;0;0;0;0
FR;6;2021-03-13;0;0;0;0;0;0;0;0;0;0
FR;6;2021-03-14;0;0;0;0;0;0;0;0;0;0
FR;6;2021-03-15;0;0;0;0;0;0;0;0;0;0
FR;6;2021-03-16;0;0;0;0;0;0;0;0;0;0
FR;6;2021-03-17;0;0;0;0;0;0;0;0;0;0
FR;6;2021-03-18;0;0;0;0;0;0;0;0;0;0
FR;6;2021-03-19;0;0;0;0;0;0;0;0;0;0
FR;6;2021-03-20;0;0;0;0;0;0;0;0;0;0
FR;6;2021-03-21;0;0;0;0;0;0;0;0;0;0
FR;6;2021-03-22;0;0;0;0;0;0;0;0;0;0
FR;6;2021-03-23;0;0;0;0;0;0;0;0;0;0
FR;6;2021-03-24;0;0;0;0;0;0;0;0;0;0
FR;6;2021-03-25;0;0;0;0;0;0;0;0;0;0
FR;6;2021-03-26;0;0;0;0;0;0;0;0;0;0
FR;6;2021-03-27;0;0;0;0;0;0;0;0;0;0
FR;6;2021-03-28;0;0;0;0;0;0;0;0;0;0
FR;6;2021-03-29;0;0;0;0;0;0;0;0;0;0
FR;6;2021-03-30;0;0;0;0;0;0;0;0;0;0
FR;6;2021-03-31;0;0;0;0;0;0;0;0;0;0
FR;6;2021-04-01;0;0;0;0;0;0;0;0;0;0
FR;6;2021-04-02;0;0;0;0;0;0;0;0;0;0
FR;6;2021-04-03;0;0;0;0;0;0;0;0;0;0
FR;6;2021-04-04;0;0;0;0;0;0;0;0;0;0
FR;6;2021-04-05;0;0;0;0;0;0;0;0;0;0
FR;6;2021-04-06;0;0;0;0;0;0;0;0;0;0
FR;6;2021-04-07;0;0;0;0;0;0;0;0;0;0
FR;6;2021-04-08;0;0;0;0;0;0;0;0;0;0
FR;6;2021-04-09;0;0;0;0;0;0;0;0;0;0
FR;6;2021-04-10;0;0;0;0;0;0;0;0;0;0
FR;6;2021-04-11;0;0;0;0;0;0;0;0;0;0
FR;6;2021-04-12;0;0;0;0;0;0;0;0;0;0
FR;6;2021-04-13;0;0;0;0;0;0;0;0;0;0
FR;6;2021-04-14;0;0;0;0;0;0;0;0;0;0
FR;6;2021-04-15;0;0;0;0;0;0;0;0;0;0
FR;6;2021-04-16;0;0;0;0;0;0;0;0;0;0
FR;6;2021-04-17;0;0;0;0;0;0;0;0;0;0
FR;6;2021-04-18;0;0;0;0;0;0;0;0;0;0
FR;6;2021-04-19;0;0;0;0;0;0;0;0;0;0
FR;6;2021-04-20;0;0;0;0;0;0;0;0;0;0
FR;6;2021-04-21;0;0;0;0;0;0;0;0;0;0
FR;6;2021-04-22;0;0;0;0;0;0;0;0;0;0
FR;6;2021-04-23;0;0;0;0;0;0;0;0;0;0
FR;6;2021-04-24;0;0;0;0;0;0;0;0;0;0
FR;6;2021-04-25;0;0;0;0;0;0;0;0;0;0
FR;6;2021-04-26;0;0;0;0;0;0;0;0;0;0
FR;6;2021-04-27;0;0;0;0;0;0;0;0;0;0
FR;6;2021-04-28;0;0;0;0;0;0;0;0;0;0
FR;6;2021-04-29;0;0;0;0;0;0;0;0;0;0
FR;6;2021-04-30;0;0;0;0;0;0;0;0;0;0
FR;6;2021-05-01;0;0;0;0;0;0;0;0;0;0
FR;6;2021-05-02;0;0;0;0;0;0;0;0;0;0
FR;6;2021-05-03;0;0;0;0;0;0;0;0;0;0
FR;6;2021-05-04;0;0;0;0;0;0;0;0;0;0
FR;6;2021-05-05;0;0;0;0;0;0;0;0;0;0
FR;6;2021-05-06;0;0;0;0;0;0;0;0;0;0
FR;6;2021-05-07;0;0;0;0;0;0;0;0;0;0
FR;6;2021-05-08;0;0;0;0;0;0;0;0;0;0
FR;6;2021-05-09;0;0;0;0;0;0;0;0;0;0
FR;6;2021-05-10;0;0;0;0;0;0;0;0;0;0
FR;6;2021-05-11;0;0;0;0;0;0;0;0;0;0
FR;6;2021-05-12;0;0;0;0;0;0;0;0;0;0
FR;6;2021-05-13;0;0;0;0;0;0;0;0;0;0
FR;6;2021-05-14;0;0;0;0;0;0;0;0;0;0
FR;6;2021-05-15;0;0;0;0;0;0;0;0;0;0
FR;6;2021-05-16;0;0;0;0;0;0;0;0;0;0
FR;6;2021-05-17;0;0;0;0;0;0;0;0;0;0
FR;6;2021-05-18;0;0;0;0;0;0;0;0;0;0
FR;6;2021-05-19;0;0;0;0;0;0;0;0;0;0
FR;6;2021-05-20;0;0;0;0;0;0;0;0;0;0
FR;6;2021-05-21;0;0;0;0;0;0;0;0;0;0
FR;6;2021-05-22;0;0;0;0;0;0;0;0;0;0
FR;6;2021-05-23;0;0;0;0;0;0;0;0;0;0
FR;6;2021-05-24;0;0;0;0;0;0;0;0;0;0
FR;6;2021-05-25;0;0;0;0;0;0;0;0;0;0
FR;6;2021-05-26;0;0;0;0;0;0;0;0;0;0
FR;6;2021-05-27;0;0;0;0;0;0;0;0;0;0
FR;6;2021-05-28;0;0;0;0;0;0;0;0;0;0
FR;6;2021-05-29;0;0;0;0;0;0;0;0;0;0
FR;6;2021-05-30;0;0;0;0;0;0;0;0;0;0
FR;6;2021-05-31;0;0;0;0;0;0;0;0;0;0
FR;6;2021-06-01;0;0;0;0;0;0;0;0;0;0
FR;6;2021-06-02;0;0;0;0;0;0;0;0;0;0
FR;6;2021-06-03;0;0;0;0;0;0;0;0;0;0
FR;6;2021-06-04;0;0;0;0;0;0;0;0;0;0
FR;6;2021-06-05;0;0;0;0;0;0;0;0;0;0
FR;6;2021-06-06;0;0;0;0;0;0;0;0;0;0
FR;6;2021-06-07;0;0;0;0;0;0;0;0;0;0
FR;6;2021-06-08;0;0;0;0;0;0;0;0;0;0
FR;6;2021-06-09;0;0;0;0;0;0;0;0;0;0
FR;6;2021-06-10;0;0;0;0;0;0;0;0;0;0
FR;6;2021-06-11;0;0;0;0;0;0;0;0;0;0
FR;6;2021-06-12;0;0;0;0;0;0;0;0;0;0
FR;6;2021-06-13;0;0;0;0;0;0;0;0;0;0
FR;6;2021-06-14;0;0;0;0;0;0;0;0;0;0
FR;6;2021-06-15;0;0;0;0;0;0;0;0;0;0
FR;6;2021-06-16;0;0;0;0;0;0;0;0;0;0
FR;6;2021-06-17;0;0;0;0;0;0;0;0;0;0
FR;6;2021-06-18;0;0;0;0;0;0;0;0;0;0
FR;6;2021-06-19;0;0;0;0;0;0;0;0;0;0
FR;6;2021-06-20;0;0;0;0;0;0;0;0;0;0
FR;6;2021-06-21;0;0;0;0;0;0;0;0;0;0
FR;6;2021-06-22;0;0;0;0;0;0;0;0;0;0
FR;6;2021-06-23;0;0;0;0;0;0;0;0;0;0
FR;6;2021-06-24;0;0;0;0;0;0;0;0;0;0
FR;6;2021-06-25;0;0;0;0;0;0;0;0;0;0
FR;6;2021-06-26;0;0;0;0;0;0;0;0;0;0
FR;6;2021-06-27;0;0;0;0;0;0;0;0;0;0
FR;6;2021-06-28;0;0;0;0;0;0;0;0;0;0
FR;6;2021-06-29;0;0;0;0;0;0;0;0;0;0
FR;6;2021-06-30;0;0;0;0;0;0;0;0;0;0
FR;6;2021-07-01;0;0;0;0;0;0;0;0;0;0
FR;6;2021-07-02;0;0;0;0;0;0;0;0;0;0
FR;6;2021-07-03;0;0;0;0;0;0;0;0;0;0
FR;6;2021-07-04;0;0;0;0;0;0;0;0;0;0
FR;6;2021-07-05;0;0;0;0;0;0;0;0;0;0
FR;6;2021-07-06;0;0;0;0;0;0;0;0;0;0
FR;6;2021-07-07;0;0;0;0;0;0;0;0;0;0
FR;6;2021-07-08;0;0;0;0;0;0;0;0;0;0
FR;6;2021-07-09;0;0;0;0;0;0;0;0;0;0
FR;6;2021-07-10;0;0;0;0;0;0;0;0;0;0
FR;6;2021-07-11;0;0;0;0;0;0;0;0;0;0
FR;6;2021-07-12;0;0;0;0;0;0;0;0;0;0
FR;6;2021-07-13;0;0;0;0;0;0;0;0;0;0
FR;6;2021-07-14;0;0;0;0;0;0;0;0;0;0
FR;6;2021-07-15;0;0;0;0;0;0;0;0;0;0
FR;6;2021-07-16;0;0;0;0;0;0;0;0;0;0
FR;6;2021-07-17;0;0;0;0;0;0;0;0;0;0
FR;6;2021-07-18;0;0;0;0;0;0;0;0;0;0
FR;6;2021-07-19;0;0;0;0;0;0;0;0;0;0
FR;6;2021-07-20;0;0;0;0;0;0;0;0;0;0
FR;6;2021-07-21;0;0;0;0;0;0;0;0;0;0
FR;6;2021-07-22;0;0;0;0;0;0;0;0;0;0
FR;6;2021-07-23;0;0;0;0;0;0;0;0;0;0
FR;6;2021-07-24;0;0;0;0;0;0;0;0;0;0
FR;6;2021-07-25;0;0;0;0;0;0;0;0;0;0
FR;6;2021-07-26;0;0;0;0;0;0;0;0;0;0
FR;6;2021-07-27;0;0;0;0;0;0;0;0;0;0
FR;6;2021-07-28;0;0;0;0;0;0;0;0;0;0
FR;6;2021-07-29;0;0;0;0;0;0;0;0;0;0
FR;6;2021-07-30;0;0;0;0;0;0;0;0;0;0
FR;6;2021-07-31;0;0;0;0;0;0;0;0;0;0
FR;6;2021-08-01;0;0;0;0;0;0;0;0;0;0
FR;6;2021-08-02;0;0;0;0;0;0;0;0;0;0
FR;6;2021-08-03;0;0;0;0;0;0;0;0;0;0
FR;6;2021-08-04;0;0;0;0;0;0;0;0;0;0
FR;6;2021-08-05;0;0;0;0;0;0;0;0;0;0
FR;6;2021-08-06;0;0;0;0;0;0;0;0;0;0
FR;6;2021-08-07;0;0;0;0;0;0;0;0;0;0
FR;6;2021-08-08;0;0;0;0;0;0;0;0;0;0
FR;6;2021-08-09;0;0;0;0;0;0;0;0;0;0
FR;6;2021-08-10;0;0;0;0;0;0;0;0;0;0
FR;6;2021-08-11;0;0;0;0;0;0;0;0;0;0
FR;6;2021-08-12;0;0;0;0;0;0;0;0;0;0
FR;6;2021-08-13;0;0;0;0;0;0;0;0;0;0
FR;6;2021-08-14;0;0;0;0;0;0;0;0;0;0
FR;6;2021-08-15;0;0;0;0;0;0;0;0;0;0
FR;6;2021-08-16;0;0;0;0;0;0;0;0;0;0
FR;6;2021-08-17;0;0;0;0;0;0;0;0;0;0
FR;6;2021-08-18;0;0;0;0;0;0;0;0;0;0
FR;6;2021-08-19;0;0;0;0;0;0;0;0;0;0
FR;6;2021-08-20;0;0;0;0;0;0;0;0;0;0
FR;6;2021-08-21;0;0;0;0;0;0;0;0;0;0
FR;6;2021-08-22;0;0;0;0;0;0;0;0;0;0
FR;6;2021-08-23;0;0;0;0;0;0;0;0;0;0
FR;6;2021-08-24;0;0;0;0;0;0;0;0;0;0
FR;6;2021-08-25;0;0;0;0;0;0;0;0;0;0
FR;6;2021-08-26;0;0;0;0;0;0;0;0;0;0
FR;6;2021-08-27;0;0;0;0;0;0;0;0;0;0
FR;6;2021-08-28;0;0;0;0;0;0;0;0;0;0
FR;6;2021-08-29;0;0;0;0;0;0;0;0;0;0
FR;6;2021-08-30;0;0;0;0;0;0;0;0;0;0
FR;6;2021-08-31;0;0;0;0;0;0;0;0;0;0
FR;6;2021-09-01;0;0;0;0;0;0;0;0;0;0
FR;6;2021-09-02;0;0;0;0;0;0;0;0;0;0
FR;6;2021-09-03;0;0;0;0;0;0;0;0;0;0
FR;6;2021-09-04;0;0;0;0;0;0;0;0;0;0
FR;6;2021-09-05;0;0;0;0;0;0;0;0;0;0
FR;6;2021-09-06;0;0;0;0;0;0;0;0;0;0
FR;6;2021-09-07;0;0;0;0;0;0;0;0;0;0
FR;6;2021-09-08;0;0;0;0;0;0;0;0;0;0
FR;6;2021-09-09;0;0;0;0;0;0;0;0;0;0
FR;6;2021-09-10;0;0;0;0;0;0;0;0;0;0
FR;6;2021-09-11;0;0;0;0;0;0;0;0;0;0
FR;6;2021-09-12;0;0;0;0;0;0;0;0;0;0
FR;6;2021-09-13;0;0;0;0;0;0;0;0;0;0
FR;6;2021-09-14;0;0;0;0;0;0;0;0;0;0
FR;6;2021-09-15;0;0;0;0;0;0;0;0;0;0
FR;6;2021-09-16;0;0;0;0;0;0;0;0;0;0
FR;6;2021-09-17;0;0;0;0;0;0;0;0;0;0
FR;6;2021-09-18;0;0;0;0;0;0;0;0;0;0
FR;6;2021-09-19;0;0;0;0;0;0;0;0;0;0
FR;6;2021-09-20;0;0;0;0;0;0;0;0;0;0
FR;6;2021-09-21;0;0;0;0;0;0;0;0;0;0
FR;6;2021-09-22;0;0;0;0;0;0;0;0;0;0
FR;6;2021-09-23;0;0;0;0;0;0;0;0;0;0
FR;6;2021-09-24;0;0;0;0;0;0;0;0;0;0
FR;6;2021-09-25;0;0;0;0;0;0;0;0;0;0
FR;6;2021-09-26;0;0;0;0;0;0;0;0;0;0
FR;6;2021-09-27;0;0;0;0;0;0;0;0;0;0
FR;6;2021-09-28;0;0;0;0;0;0;0;0;0;0
FR;6;2021-09-29;0;0;0;0;0;0;0;0;0;0
FR;6;2021-09-30;0;0;0;0;0;0;0;0;0;0
FR;6;2021-10-01;0;0;0;0;0;0;0;0;0;0
FR;6;2021-10-02;0;0;0;0;0;0;0;0;0;0
FR;6;2021-10-03;0;0;0;0;0;0;0;0;0;0
FR;6;2021-10-04;0;0;0;0;0;0;0;0;0;0
FR;6;2021-10-05;0;0;0;0;0;0;0;0;0;0
FR;6;2021-10-06;0;0;0;0;0;0;0;0;0;0
FR;6;2021-10-07;0;0;0;0;0;0;0;0;0;0
FR;6;2021-10-08;0;0;0;0;0;0;0;0;0;0
FR;6;2021-10-09;0;0;0;0;0;0;0;0;0;0
FR;6;2021-10-10;0;0;0;0;0;0;0;0;0;0
FR;6;2021-10-11;0;0;0;0;0;0;0;0;0;0
FR;6;2021-10-12;0;0;0;0;0;0;0;0;0;0
FR;6;2021-10-13;0;0;0;0;0;0;0;0;0;0
FR;6;2021-10-14;0;0;0;0;0;0;0;0;0;0
FR;6;2021-10-15;0;0;0;0;0;0;0;0;0;0
FR;6;2021-10-16;0;0;0;0;0;0;0;0;0;0
FR;6;2021-10-17;0;0;0;0;0;0;0;0;0;0
FR;6;2021-10-18;0;0;0;0;0;0;0;0;0;0
FR;6;2021-10-19;0;0;0;0;0;0;0;0;0;0
FR;6;2021-10-20;0;0;0;0;0;0;0;0;0;0
FR;6;2021-10-21;0;0;0;0;0;0;0;0;0;0
FR;6;2021-10-22;0;0;0;0;0;0;0;0;0;0
FR;6;2021-10-23;0;0;0;0;0;0;0;0;0;0
FR;6;2021-10-24;0;0;0;0;0;0;0;0;0;0
FR;6;2021-10-25;0;0;0;0;0;0;0;0;0;0
FR;6;2021-10-26;0;0;0;0;0;0;0;0;0;0
FR;6;2021-10-27;0;0;0;0;0;0;0;0;0;0
FR;6;2021-10-28;0;0;0;0;0;0;0;0;0;0
FR;6;2021-10-29;0;0;0;0;0;0;0;0;0;0
FR;6;2021-10-30;0;0;0;0;0;0;0;0;0;0
FR;6;2021-10-31;0;0;0;0;0;0;0;0;0;0
FR;6;2021-11-01;0;0;0;0;0;0;0;0;0;0
FR;6;2021-11-02;0;0;0;0;0;0;0;0;0;0
FR;6;2021-11-03;0;0;0;0;0;0;0;0;0;0
FR;6;2021-11-04;0;0;0;0;0;0;0;0;0;0
FR;6;2021-11-05;0;0;0;0;0;0;0;0;0;0
FR;6;2021-11-06;0;0;0;0;0;0;0;0;0;0
FR;6;2021-11-07;0;0;0;0;0;0;0;0;0;0
FR;6;2021-11-08;0;0;0;0;0;0;0;0;0;0
FR;6;2021-11-09;0;0;0;0;0;0;0;0;0;0
FR;6;2021-11-10;0;0;0;0;0;0;0;0;0;0
FR;6;2021-11-11;0;0;0;0;0;0;0;0;0;0
FR;6;2021-11-12;0;0;0;0;0;0;0;0;0;0
FR;6;2021-11-13;0;0;0;0;0;0;0;0;0;0
FR;6;2021-11-14;0;0;0;0;0;0;0;0;0;0
FR;6;2021-11-15;0;0;0;0;0;0;0;0;0;0
FR;6;2021-11-16;0;0;0;0;0;0;0;0;0;0
FR;6;2021-11-17;0;0;0;0;0;0;0;0;0;0
FR;6;2021-11-18;0;0;0;0;0;0;0;0;0;0
FR;6;2021-11-19;0;0;0;0;0;0;0;0;0;0
FR;6;2021-11-20;0;0;0;0;0;0;0;0;0;0
FR;6;2021-11-21;0;0;0;0;0;0;0;0;0;0
FR;6;2021-11-22;0;0;0;0;0;0;0;0;0;0
FR;6;2021-11-23;0;0;0;0;0;0;0;0;0;0
FR;6;2021-11-24;0;0;0;0;0;0;0;0;0;0
FR;6;2021-11-25;0;0;0;0;0;0;0;0;0;0
FR;6;2021-11-26;0;0;0;0;0;0;0;0;0;0
FR;6;2021-11-27;0;0;0;0;0;0;0;0;0;0
FR;6;2021-11-28;0;0;0;0;0;0;0;0;0;0
FR;6;2021-11-29;0;0;0;0;0;0;0;0;0;0
FR;6;2021-11-30;0;0;0;0;0;0;0;0;0;0
FR;6;2021-12-01;0;0;0;0;0;0;0;0;0;0
FR;6;2021-12-02;0;0;0;0;0;0;0;0;0;0
FR;6;2021-12-03;0;0;0;0;0;0;0;0;0;0
FR;6;2021-12-04;0;0;0;0;0;0;0;0;0;0
FR;6;2021-12-05;0;0;0;0;0;0;0;0;0;0
FR;6;2021-12-06;0;0;0;0;0;0;0;0;0;0
FR;6;2021-12-07;0;0;0;0;0;0;0;0;0;0
FR;6;2021-12-08;0;0;0;0;0;0;0;0;0;0
FR;6;2021-12-09;0;0;0;0;0;0;0;0;0;0
FR;6;2021-12-10;0;0;0;0;0;0;0;0;0;0
FR;6;2021-12-11;0;0;0;0;0;0;0;0;0;0
FR;6;2021-12-12;0;0;0;0;0;0;0;0;0;0
FR;6;2021-12-13;0;0;0;0;0;0;0;0;0;0
FR;6;2021-12-14;0;0;0;0;0;0;0;0;0;0
FR;6;2021-12-15;0;0;0;0;0;0;0;0;0;0
FR;6;2021-12-16;0;0;0;0;0;0;0;0;0;0
FR;6;2021-12-17;0;0;0;0;0;0;0;0;0;0
FR;6;2021-12-18;0;0;0;0;0;0;0;0;0;0
FR;6;2021-12-19;0;0;0;0;0;0;0;0;0;0
FR;6;2021-12-20;0;0;0;0;0;0;0;0;0;0
FR;6;2021-12-21;0;0;0;0;0;0;0;0;0;0
FR;6;2021-12-22;0;0;0;0;0;0;0;0;0;0
FR;6;2021-12-23;0;0;0;0;0;0;0;0;0;0
FR;6;2021-12-24;0;0;0;0;0;0;0;0;0;0
FR;6;2021-12-25;0;0;0;0;0;0;0;0;0;0
FR;6;2021-12-26;0;0;0;0;0;0;0;0;0;0
FR;6;2021-12-27;0;0;0;0;0;0;0;0;0;0
FR;6;2021-12-28;0;0;0;0;0;0;0;0;0;0
FR;6;2021-12-29;0;0;0;0;0;0;0;0;0;0
FR;6;2021-12-30;0;0;0;0;0;0;0;0;0;0
FR;6;2021-12-31;0;0;0;0;0;0;0;0;0;0
FR;6;2022-01-01;0;0;0;0;0;0;0;0;0;0
FR;6;2022-01-02;0;0;0;0;0;0;0;0;0;0
FR;6;2022-01-03;0;0;0;0;0;0;0;0;0;0
FR;6;2022-01-04;0;0;0;0;0;0;0;0;0;0
FR;6;2022-01-05;0;0;0;0;0;0;0;0;0;0
FR;6;2022-01-06;0;0;0;0;0;0;0;0;0;0
FR;6;2022-01-07;0;0;0;0;0;0;0;0;0;0
FR;6;2022-01-08;0;0;0;0;0;0;0;0;0;0
FR;6;2022-01-09;0;0;0;0;0;0;0;0;0;0
FR;6;2022-01-10;0;0;0;0;0;0;0;0;0;0
FR;6;2022-01-11;0;0;0;0;0;0;0;0;0;0
FR;6;2022-01-12;0;0;0;0;0;0;0;0;0;0
FR;6;2022-01-13;0;0;0;0;0;0;0;0;0;0
FR;6;2022-01-14;0;0;0;0;0;0;0;0;0;0
FR;6;2022-01-15;0;0;0;0;0;0;0;0;0;0
FR;6;2022-01-16;0;0;0;0;0;0;0;0;0;0
FR;6;2022-01-17;0;0;0;0;0;0;0;0;0;0
FR;6;2022-01-18;0;0;0;0;0;0;0;0;0;0
FR;6;2022-01-19;0;0;0;0;0;0;0;0;0;0
FR;6;2022-01-20;0;0;0;0;0;0;0;0;0;0
FR;6;2022-01-21;0;0;0;0;0;0;0;0;0;0
FR;6;2022-01-22;0;0;0;0;0;0;0;0;0;0
FR;6;2022-01-23;0;0;0;0;0;0;0;0;0;0
FR;6;2022-01-24;0;0;0;0;0;0;0;0;0;0
FR;6;2022-01-25;0;0;0;0;0;0;0;0;0;0
FR;6;2022-01-26;0;0;0;0;0;0;0;0;0;0
FR;6;2022-01-27;0;0;0;0;0;0;0;0;0;0
FR;6;2022-01-28;0;0;0;0;0;0;0;0;0;0
FR;6;2022-01-29;0;0;0;0;0;0;0;0;0;0
FR;6;2022-01-30;0;0;0;0;0;0;0;0;0;0
FR;6;2022-01-31;0;0;0;0;0;0;0;0;0;0
FR;6;2022-02-01;0;0;0;0;0;0;0;0;0;0
FR;6;2022-02-02;0;0;0;0;0;0;0;0;0;0
FR;6;2022-02-03;0;0;0;0;0;0;0;0;0;0
FR;6;2022-02-04;0;0;0;0;0;0;0;0;0;0
FR;6;2022-02-05;0;0;0;0;0;0;0;0;0;0
FR;6;2022-02-06;0;0;0;0;0;0;0;0;0;0
FR;6;2022-02-07;0;0;0;0;0;0;0;0;0;0
FR;6;2022-02-08;0;0;0;0;0;0;0;0;0;0
FR;6;2022-02-09;0;0;0;0;0;0;0;0;0;0
FR;6;2022-02-10;0;0;0;0;0;0;0;0;0;0
FR;6;2022-02-11;0;0;0;0;0;0;0;0;0;0
FR;6;2022-02-12;0;0;0;0;0;0;0;0;0;0
FR;6;2022-02-13;0;0;0;0;0;0;0;0;0;0
FR;6;2022-02-14;0;0;0;0;0;0;0;0;0;0
FR;6;2022-02-15;0;0;0;0;0;0;0;0;0;0
FR;6;2022-02-16;0;0;0;0;0;0;0;0;0;0
FR;6;2022-02-17;0;0;0;0;0;0;0;0;0;0
FR;6;2022-02-18;0;0;0;0;0;0;0;0;0;0
FR;6;2022-02-19;0;0;0;0;0;0;0;0;0;0
FR;6;2022-02-20;0;0;0;0;0;0;0;0;0;0
FR;6;2022-02-21;0;0;0;0;0;0;0;0;0;0
FR;6;2022-02-22;0;0;0;0;0;0;0;0;0;0
FR;6;2022-02-23;0;0;0;0;0;0;0;0;0;0
FR;6;2022-02-24;0;0;0;0;0;0;0;0;0;0
FR;6;2022-02-25;0;0;0;0;0;0;0;0;0;0
FR;6;2022-02-26;0;0;0;0;0;0;0;0;0;0
FR;6;2022-02-27;0;0;0;0;0;0;0;0;0;0
FR;6;2022-02-28;0;0;0;0;0;0;0;0;0;0
FR;6;2022-03-01;0;0;0;0;0;0;0;0;0;0
FR;6;2022-03-02;96;9;2;0;7;96;9;2;0;7
FR;6;2022-03-03;0;0;0;0;0;96;9;2;0;7
FR;6;2022-03-04;91;4;0;0;4;187;13;2;0;11
FR;6;2022-03-05;390;23;2;0;14;577;36;4;0;25
FR;6;2022-03-06;7;1;0;0;0;584;37;4;0;25
FR;6;2022-03-07;336;19;0;0;13;920;56;4;0;38
FR;6;2022-03-08;230;14;0;0;5;1150;70;4;0;43
FR;6;2022-03-09;519;29;2;0;21;1669;99;6;0;64
FR;6;2022-03-10;207;18;0;1;12;1876;117;6;1;76
FR;6;2022-03-11;328;21;6;0;21;2204;138;12;1;97
FR;6;2022-03-12;516;25;1;0;20;2720;163;13;1;117
FR;6;2022-03-13;40;2;0;0;1;2760;165;13;1;118
FR;6;2022-03-14;201;4;2;0;3;2961;169;15;1;121
FR;6;2022-03-15;112;11;2;0;9;3073;180;17;1;130
FR;6;2022-03-16;310;16;1;1;14;3383;196;18;2;144
FR;6;2022-03-17;117;6;1;2;4;3500;202;19;4;148
FR;6;2022-03-18;213;11;0;0;6;3713;213;19;4;154
FR;6;2022-03-19;303;20;2;0;10;4016;233;21;4;164
FR;6;2022-03-20;15;5;0;0;1;4031;238;21;4;165
FR;6;2022-03-21;131;22;1;0;4;4162;260;22;4;169
FR;6;2022-03-22;97;8;0;0;2;4259;268;22;4;171
FR;6;2022-03-23;225;108;3;0;14;4484;376;25;4;185
FR;6;2022-03-24;99;14;1;3;4;4583;390;26;7;189
FR;6;2022-03-25;203;141;2;1;15;4786;531;28;8;204
FR;6;2022-03-26;331;296;7;1;19;5117;827;35;9;223
FR;6;2022-03-27;32;30;1;0;1;5149;857;36;9;224
FR;6;2022-03-28;199;207;8;1;17;5348;1064;44;10;241
FR;6;2022-03-29;126;189;14;2;15;5474;1253;58;12;256
FR;6;2022-03-30;297;474;9;2;21;5771;1727;67;14;277
FR;0;2020-12-27;594;0;0;0;0;594;0;0;0;0
FR;0;2020-12-28;649;0;0;0;0;1243;0;0;0;0
FR;0;2020-12-29;368;0;0;0;0;1611;0;0;0;0
FR;0;2020-12-30;433;0;0;0;0;2044;0;0;0;0
FR;0;2020-12-31;360;0;0;0;0;2404;0;0;0;0
FR;0;2021-01-01;1108;0;0;0;0;3512;0;0;0;0
FR;0;2021-01-02;348;1;0;0;0;3860;1;0;0;0
FR;0;2021-01-03;394;0;0;0;0;4254;1;0;0;0
FR;0;2021-01-04;2074;0;0;0;0;6328;1;0;0;0
FR;0;2021-01-05;6820;2;0;0;0;13148;3;0;0;0
FR;0;2021-01-06;12276;4;0;0;0;25424;7;0;0;0
FR;0;2021-01-07;29429;3;0;0;0;54853;10;0;0;0
FR;0;2021-01-08;37106;2;0;0;0;91959;12;0;0;0
FR;0;2021-01-09;11206;2;0;0;0;103165;14;0;0;0
FR;0;2021-01-10;5987;0;0;0;0;109152;14;0;0;0
FR;0;2021-01-11;39912;7;0;0;0;149064;21;0;0;0
FR;0;2021-01-12;62095;6;0;0;0;211159;27;0;0;0
FR;0;2021-01-13;65038;16;0;0;0;276197;43;0;0;0
FR;0;2021-01-14;83123;23;0;0;0;359320;66;0;0;0
FR;0;2021-01-15;68967;7;0;0;0;428287;73;0;0;0
FR;0;2021-01-16;20203;75;0;0;0;448490;148;0;0;0
FR;0;2021-01-17;10975;45;0;0;0;459465;193;0;0;0
FR;0;2021-01-18;85809;168;0;0;0;545274;361;0;0;0
FR;0;2021-01-19;130555;143;0;0;0;675829;504;0;0;0
FR;0;2021-01-20;137488;170;0;0;0;813317;674;0;0;0
FR;0;2021-01-21;158347;147;0;0;0;971664;821;0;0;0
FR;0;2021-01-22;121018;178;0;0;0;1092682;999;0;0;0
FR;0;2021-01-23;38454;56;0;0;0;1131136;1055;0;0;0
FR;0;2021-01-24;9737;49;0;0;0;1140873;1104;0;0;0
FR;0;2021-01-25;78203;1229;0;0;0;1219076;2333;0;0;0
FR;0;2021-01-26;100333;3151;1;0;0;1319409;5484;1;0;0
FR;0;2021-01-27;107207;5715;0;0;0;1426616;11199;1;0;0
FR;0;2021-01-28;124304;14438;0;0;0;1550920;25637;1;0;0
FR;0;2021-01-29;92145;17368;0;0;0;1643065;43005;1;0;0
FR;0;2021-01-30;29099;4224;0;0;0;1672164;47229;1;0;0
FR;0;2021-01-31;5219;1711;0;0;0;1677383;48940;1;0;0
FR;0;2021-02-01;53085;21098;0;0;0;1730468;70038;1;0;0
FR;0;2021-02-02;72257;34659;0;0;0;1802725;104697;1;0;0
FR;0;2021-02-03;72252;37110;0;0;0;1874977;141807;1;0;0
FR;0;2021-02-04;82013;50218;0;0;0;1956990;192025;1;0;0
FR;0;2021-02-05;68203;45443;0;0;0;2025193;237468;1;0;0
FR;0;2021-02-06;23132;10502;0;0;0;2048325;247970;1;0;0
FR;0;2021-02-07;5171;5055;0;0;0;2053496;253025;1;0;0
FR;0;2021-02-08;46802;46154;0;0;0;2100298;299179;1;0;0
FR;0;2021-02-09;65974;72606;0;0;0;2166272;371785;1;0;0
FR;0;2021-02-10;70957;76871;0;0;0;2237229;448656;1;0;0
FR;0;2021-02-11;87210;99116;0;0;0;2324439;547772;1;0;0
FR;0;2021-02-12;79264;74334;0;0;0;2403703;622106;1;0;0
FR;0;2021-02-13;22338;19544;0;0;0;2426041;641650;1;0;0
FR;0;2021-02-14;5060;7252;0;0;0;2431101;648902;1;0;0
FR;0;2021-02-15;38050;76635;0;0;0;2469151;725537;1;0;0
FR;0;2021-02-16;50350;100667;0;0;0;2519501;826204;1;0;0
FR;0;2021-02-17;50473;103199;1;0;0;2569974;929403;2;0;0
FR;0;2021-02-18;69724;118687;0;0;0;2639698;1048090;2;0;0
FR;0;2021-02-19;65028;90743;1;0;0;2704726;1138833;3;0;0
FR;0;2021-02-20;18567;28475;0;0;0;2723293;1167308;3;0;0
FR;0;2021-02-21;3305;6390;0;0;0;2726598;1173698;3;0;0
FR;0;2021-02-22;37463;73199;2;0;0;2764061;1246897;5;0;0
FR;0;2021-02-23;53750;84128;1;0;0;2817811;1331025;6;0;0
FR;0;2021-02-24;59956;81143;1;0;0;2877767;1412168;7;0;0
FR;0;2021-02-25;100528;91246;1;0;0;2978295;1503414;8;0;0
FR;0;2021-02-26;113405;70951;0;0;0;3091700;1574365;8;0;0
FR;0;2021-02-27;52086;22021;0;0;0;3143786;1596386;8;0;0
FR;0;2021-02-28;6189;4424;1;0;0;3149975;1600810;9;0;0
FR;0;2021-03-01;65793;52879;1;0;0;3215768;1653689;10;0;0
FR;0;2021-03-02;101316;66274;2;0;0;3317084;1719963;12;0;0
FR;0;2021-03-03;116421;65429;0;0;0;3433505;1785392;12;0;0
FR;0;2021-03-04;163551;69060;3;0;0;3597056;1854452;15;0;0
FR;0;2021-03-05;200857;63223;3;0;0;3797913;1917675;18;0;0
FR;0;2021-03-06;207911;17792;3;0;0;4005824;1935467;21;0;0
FR;0;2021-03-07;121240;5388;1;0;0;4127064;1940855;22;0;0
FR;0;2021-03-08;107097;50711;2;0;0;4234161;1991566;24;0;0
FR;0;2021-03-09;172383;56659;2;0;0;4406544;2048225;26;0;0
FR;0;2021-03-10;178883;57162;5;0;0;4585427;2105387;31;0;0
FR;0;2021-03-11;242768;63076;2;0;0;4828195;2168463;33;0;0
FR;0;2021-03-12;294744;53404;0;0;0;5122939;2221867;33;0;0
FR;0;2021-03-13;231349;15289;1;0;0;5354288;2237156;34;0;0
FR;0;2021-03-14;63325;3417;1;0;0;5417613;2240573;35;0;0
FR;0;2021-03-15;158569;32565;3;0;0;5576182;2273138;38;0;0
FR;0;2021-03-16;141516;39485;5;0;0;5717698;2312623;43;0;0
FR;0;2021-03-17;150398;38682;4;0;0;5868096;2351305;47;0;0
FR;0;2021-03-18;167745;44581;5;0;0;6035841;2395886;52;0;0
FR;0;2021-03-19;229931;37385;2;0;0;6265772;2433271;54;0;0
FR;0;2021-03-20;166627;11722;1;0;0;6432399;2444993;55;0;0
FR;0;2021-03-21;49892;2606;1;0;0;6482291;2447599;56;0;0
FR;0;2021-03-22;169925;34213;2;0;0;6652216;2481812;58;0;0
FR;0;2021-03-23;250283;42408;1;0;0;6902499;2524220;59;0;0
FR;0;2021-03-24;256813;43838;0;0;0;7159312;2568058;59;0;0
FR;0;2021-03-25;341720;44703;5;0;0;7501032;2612761;64;0;0
FR;0;2021-03-26;358724;41862;4;0;0;7859756;2654623;68;0;0
FR;0;2021-03-27;195220;16662;1;0;0;8054976;2671285;69;0;0
FR;0;2021-03-28;59310;3835;3;0;0;8114286;2675120;72;0;0
FR;0;2021-03-29;202906;54202;4;0;0;8317192;2729322;76;0;0
FR;0;2021-03-30;285362;69590;4;0;0;8602554;2798912;80;0;0
FR;0;2021-03-31;262924;72928;4;0;0;8865478;2871840;84;0;0
FR;0;2021-04-01;315309;88013;12;0;0;9180787;2959853;96;0;0
FR;0;2021-04-02;281242;92139;7;0;0;9462029;3051992;103;0;0
FR;0;2021-04-03;141027;61813;5;0;0;9603056;3113805;108;0;0
FR;0;2021-04-04;46305;18676;2;0;0;9649361;3132481;110;0;0
FR;0;2021-04-05;63271;10963;11;0;0;9712632;3143444;121;0;0
FR;0;2021-04-06;217074;108026;16;0;0;9929706;3251470;137;0;0
FR;0;2021-04-07;260147;115297;17;0;0;10189853;3366767;154;0;0
FR;0;2021-04-08;337657;121343;14;0;0;10527510;3488110;168;0;0
FR;0;2021-04-09;410046;116366;49;0;0;10937556;3604476;217;0;0
FR;0;2021-04-10;212555;82656;15;0;0;11150111;3687132;232;0;0
FR;0;2021-04-11;56049;34544;7;0;0;11206160;3721676;239;0;0
FR;0;2021-04-12;236899;115100;45;0;0;11443059;3836776;284;0;0
FR;0;2021-04-13;309359;144672;97;1;0;11752418;3981448;381;1;0
FR;0;2021-04-14;294376;139252;210;0;0;12046794;4120700;591;1;0
FR;0;2021-04-15;336957;147773;337;0;0;12383751;4268473;928;1;0
FR;0;2021-04-16;339183;145609;352;0;0;12722934;4414082;1280;1;0
FR;0;2021-04-17;188608;90156;108;0;0;12911542;4504238;1388;1;0
FR;0;2021-04-18;51563;35418;45;0;0;12963105;4539656;1433;1;0
FR;0;2021-04-19;205548;138236;453;0;0;13168653;4677892;1886;1;0
FR;0;2021-04-20;254290;170521;568;0;0;13422943;4848413;2454;1;0
FR;0;2021-04-21;253109;168730;830;0;0;13676052;5017143;3284;1;0
FR;0;2021-04-22;287356;188193;818;0;0;13963408;5205336;4102;1;0
FR;0;2021-04-23;297970;183129;742;0;0;14261378;5388465;4844;1;0
FR;0;2021-04-24;190400;111484;247;0;0;14451778;5499949;5091;1;0
FR;0;2021-04-25;69460;38836;51;0;0;14521238;5538785;5142;1;0
FR;0;2021-04-26;220851;155963;558;0;0;14742089;5694748;5700;1;0
FR;0;2021-04-27;284499;187279;938;0;0;15026588;5882027;6638;1;0
FR;0;2021-04-28;299381;183057;1420;1;1;15325969;6065084;8058;2;1
FR;0;2021-04-29;357013;196000;1274;0;0;15682982;6261084;9332;2;1
FR;0;2021-04-30;372103;184623;1119;1;0;16055085;6445707;10451;3;1
FR;0;2021-05-01;167532;52509;178;0;0;16222617;6498216;10629;3;1
FR;0;2021-05-02;91632;37784;82;0;0;16314249;6536000;10711;3;1
FR;0;2021-05-03;288754;169340;837;0;0;16603003;6705340;11548;3;1
FR;0;2021-05-04;315506;224212;1230;0;0;16918509;6929552;12778;3;1
FR;0;2021-05-05;327002;224399;1310;0;0;17245511;7153951;14088;3;1
FR;0;2021-05-06;379334;239024;1624;0;0;17624845;7392975;15712;3;1
FR;0;2021-05-07;372617;257087;1222;0;0;17997462;7650062;16934;3;1
FR;0;2021-05-08;222098;66857;297;0;0;18219560;7716919;17231;3;1
FR;0;2021-05-09;129643;46657;243;0;0;18349203;7763576;17474;3;1
FR;0;2021-05-10;313126;228715;1227;0;0;18662329;7992291;18701;3;1
FR;0;2021-05-11;403741;257848;1562;0;0;19066070;8250139;20263;3;1
FR;0;2021-05-12;433937;232987;1539;0;0;19500007;8483126;21802;3;1
FR;0;2021-05-13;338480;56968;429;0;0;19838487;8540094;22231;3;1
FR;0;2021-05-14;453994;167240;1117;0;0;20292481;8707334;23348;3;1
FR;0;2021-05-15;374724;93940;442;0;0;20667205;8801274;23790;3;1
FR;0;2021-05-16;202677;20776;168;0;0;20869882;8822050;23958;3;1
FR;0;2021-05-17;375962;148969;1547;0;0;21245844;8971019;25505;3;1
FR;0;2021-05-18;459783;152979;1984;0;0;21705627;9123998;27489;3;1
FR;0;2021-05-19;467244;145071;2447;0;0;22172871;9269069;29936;3;1
FR;0;2021-05-20;507323;160164;2326;0;0;22680194;9429233;32262;3;1
FR;0;2021-05-21;489501;174380;1984;0;0;23169695;9603613;34246;3;1
FR;0;2021-05-22;347099;79772;667;0;0;23516794;9683385;34913;3;1
FR;0;2021-05-23;161616;14414;246;0;0;23678410;9697799;35159;3;1
FR;0;2021-05-24;263099;33210;597;0;0;23941509;9731009;35756;3;1
FR;0;2021-05-25;400023;189061;2343;1;0;24341532;9920070;38099;4;1
FR;0;2021-05-26;413314;188064;2213;0;0;24754846;10108134;40312;4;1
FR;0;2021-05-27;449649;218449;2152;0;0;25204495;10326583;42464;4;1
FR;0;2021-05-28;429400;259331;1885;0;0;25633895;10585914;44349;4;1
FR;0;2021-05-29;298915;149291;582;0;0;25932810;10735205;44931;4;1
FR;0;2021-05-30;107053;32578;162;0;0;26039863;10767783;45093;4;1
FR;0;2021-05-31;357864;203508;1465;1;1;26397727;10971291;46558;5;2
FR;0;2021-06-01;430425;251394;1952;1;1;26828152;11222685;48510;6;3
FR;0;2021-06-02;418822;230703;1972;0;0;27246974;11453388;50482;6;3
FR;0;2021-06-03;463978;258458;1814;0;0;27710952;11711846;52296;6;3
FR;0;2021-06-04;455382;304695;1723;1;1;28166334;12016541;54019;7;4
FR;0;2021-06-05;304690;188935;651;0;0;28471024;12205476;54670;7;4
FR;0;2021-06-06;133195;49122;226;0;0;28604219;12254598;54896;7;4
FR;0;2021-06-07;338522;262115;1514;0;0;28942741;12516713;56410;7;4
FR;0;2021-06-08;393464;290939;1791;0;0;29336205;12807652;58201;7;4
FR;0;2021-06-09;384529;275631;1720;0;0;29720734;13083283;59921;7;4
FR;0;2021-06-10;403830;289141;1717;1;0;30124564;13372424;61638;8;4
FR;0;2021-06-11;386361;357269;1454;0;0;30510925;13729693;63092;8;4
FR;0;2021-06-12;283139;211269;489;0;0;30794064;13940962;63581;8;4
FR;0;2021-06-13;104806;74009;204;0;0;30898870;14014971;63785;8;4
FR;0;2021-06-14;240608;355830;1420;1;0;31139478;14370801;65205;9;4
FR;0;2021-06-15;307857;385757;1560;1;0;31447335;14756558;66765;10;4
FR;0;2021-06-16;313744;357759;1412;1;0;31761079;15114317;68177;11;4
FR;0;2021-06-17;317453;372130;1418;1;0;32078532;15486447;69595;12;4
FR;0;2021-06-18;321488;442340;1329;1;0;32400020;15928787;70924;13;4
FR;0;2021-06-19;224290;273739;445;0;0;32624310;16202526;71369;13;4
FR;0;2021-06-20;74342;102574;127;0;0;32698652;16305100;71496;13;4
FR;0;2021-06-21;195520;401946;1027;1;1;32894172;16707046;72523;14;5
FR;0;2021-06-22;222954;467304;1257;10;2;33117126;17174350;73780;24;7
FR;0;2021-06-23;233799;439795;1192;1;1;33350925;17614145;74972;25;8
FR;0;2021-06-24;241645;409421;1343;0;0;33592570;18023566;76315;25;8
FR;0;2021-06-25;227385;522084;1397;0;0;33819955;18545650;77712;25;8
FR;0;2021-06-26;153136;370666;583;1;0;33973091;18916316;78295;26;8
FR;0;2021-06-27;55846;156287;166;1;0;34028937;19072603;78461;27;8
FR;0;2021-06-28;154557;453064;1163;0;0;34183494;19525667;79624;27;8
FR;0;2021-06-29;182490;506532;2120;0;0;34365984;20032199;81744;27;8
FR;0;2021-06-30;203757;481491;2007;21;2;34569741;20513690;83751;48;10
FR;0;2021-07-01;230851;457727;2221;5;1;34800592;20971417;85972;53;11
FR;0;2021-07-02;227796;520201;2118;5;3;35028388;21491618;88090;58;14
FR;0;2021-07-03;141861;368722;909;3;1;35170249;21860340;88999;61;15
FR;0;2021-07-04;56672;141274;265;0;0;35226921;22001614;89264;61;15
FR;0;2021-07-05;168036;419369;1666;8;2;35394957;22420983;90930;69;17
FR;0;2021-07-06;196399;474821;1823;44;8;35591356;22895804;92753;113;25
FR;0;2021-07-07;212712;439320;1873;24;5;35804068;23335124;94626;137;30
FR;0;2021-07-08;231276;424139;2088;20;8;36035344;23759263;96714;157;38
FR;0;2021-07-09;228232;510282;2182;4;3;36263576;24269545;98896;161;41
FR;0;2021-07-10;148473;339826;982;1;1;36412049;24609371;99878;162;42
FR;0;2021-07-11;60109;110134;281;0;0;36472158;24719505;100159;162;42
FR;0;2021-07-12;168886;478180;1750;4;0;36641044;25197685;101909;166;42
FR;0;2021-07-13;286983;527473;2043;7;2;36928027;25725158;103952;173;44
FR;0;2021-07-14;180771;157808;432;0;0;37108798;25882966;104384;173;44
FR;0;2021-07-15;346713;502536;2096;1;0;37455511;26385502;106480;174;44
FR;0;2021-07-16;379747;496039;2020;3;1;37835258;26881541;108500;177;45
FR;0;2021-07-17;259592;319823;876;1;0;38094850;27201364;109376;178;45
FR;0;2021-07-18;109643;114833;310;0;0;38204493;27316197;109686;178;45
FR;0;2021-07-19;285227;425335;1626;3;0;38489720;27741532;111312;181;45
FR;0;2021-07-20;376638;452679;1720;0;0;38866358;28194211;113032;181;45
FR;0;2021-07-21;395527;408144;1547;4;2;39261885;28602355;114579;185;47
FR;0;2021-07-22;440675;388447;1711;4;2;39702560;28990802;116290;189;49
FR;0;2021-07-23;438440;423350;1876;4;2;40141000;29414152;118166;193;51
FR;0;2021-07-24;285134;269707;802;1;0;40426134;29683859;118968;194;51
FR;0;2021-07-25;121008;80079;225;0;0;40547142;29763938;119193;194;51
FR;0;2021-07-26;347181;323503;1614;3;2;40894323;30087441;120807;197;53
FR;0;2021-07-27;463796;320534;1696;4;2;41358119;30407975;122503;201;55
FR;0;2021-07-28;459213;290206;1635;4;2;41817332;30698181;124138;205;57
FR;0;2021-07-29;489564;277106;1793;2;1;42306896;30975287;125931;207;58
FR;0;2021-07-30;461485;303053;1935;5;2;42768381;31278340;127866;212;60
FR;0;2021-07-31;285281;185044;913;1;0;43053662;31463384;128779;213;60
FR;0;2021-08-01;111891;50005;252;0;0;43165553;31513389;129031;213;60
FR;0;2021-08-02;340996;234703;1596;2;0;43506549;31748092;130627;215;60
FR;0;2021-08-03;398209;245245;1715;2;1;43904758;31993337;132342;217;61
FR;0;2021-08-04;384406;210234;1589;5;3;44289164;32203571;133931;222;64
FR;0;2021-08-05;365800;228957;1705;0;0;44654964;32432528;135636;222;64
FR;0;2021-08-06;359359;271861;1833;4;1;45014323;32704389;137469;226;65
FR;0;2021-08-07;212959;178375;755;4;3;45227282;32882764;138224;230;68
FR;0;2021-08-08;74076;63265;269;0;0;45301358;32946029;138493;230;68
FR;0;2021-08-09;258464;259800;1537;4;3;45559822;33205829;140030;234;71
FR;0;2021-08-10;306456;278416;1652;2;1;45866278;33484245;141682;236;72
FR;0;2021-08-11;279387;260496;1435;5;1;46145665;33744741;143117;241;73
FR;0;2021-08-12;271181;278703;1657;3;1;46416846;34023444;144774;244;74
FR;0;2021-08-13;251921;277825;1585;3;2;46668767;34301269;146359;247;76
FR;0;2021-08-14;145229;197383;739;0;0;46813996;34498652;147098;247;76
FR;0;2021-08-15;39244;50109;212;1;0;46853240;34548761;147310;248;76
FR;0;2021-08-16;185791;318277;1538;0;0;47039031;34867038;148848;248;76
FR;0;2021-08-17;215378;336786;1632;5;1;47254409;35203824;150480;253;77
FR;0;2021-08-18;198782;324992;1584;7;4;47453191;35528816;152064;260;81
FR;0;2021-08-19;191765;325644;1629;1;0;47644956;35854460;153693;261;81
FR;0;2021-08-20;186162;365709;1804;3;2;47831118;36220169;155497;264;83
FR;0;2021-08-21;104696;238168;700;0;0;47935814;36458337;156197;264;83
FR;0;2021-08-22;31865;87198;251;1;1;47967679;36545535;156448;265;84
FR;0;2021-08-23;140812;357345;1555;3;2;48108491;36902880;158003;268;86
FR;0;2021-08-24;162298;376960;1835;5;1;48270789;37279840;159838;273;87
FR;0;2021-08-25;150930;350894;2024;8;3;48421719;37630734;161862;281;90
FR;0;2021-08-26;142656;342829;2550;10;1;48564375;37973563;164412;291;91
FR;0;2021-08-27;148204;387709;2786;11;4;48712579;38361272;167198;302;95
FR;0;2021-08-28;90532;249512;1405;0;0;48803111;38610784;168603;302;95
FR;0;2021-08-29;27286;83299;510;1;0;48830397;38694083;169113;303;95
FR;0;2021-08-30;117272;324920;4706;6;6081;48947669;39019003;173819;309;6176
FR;0;2021-08-31;128622;334731;10153;18;11901;49076291;39353734;183972;327;18077
FR;0;2021-09-01;135007;285600;22393;7;24206;49211298;39639334;206365;334;42283
FR;0;2021-09-02;112117;247320;26481;13;28791;49323415;39886654;232846;347;71074
FR;0;2021-09-03;117917;292764;29935;24;32894;49441332;40179418;262781;371;103968
FR;0;2021-09-04;89661;217694;12579;12;14013;49530993;40397112;275360;383;117981
FR;0;2021-09-05;21312;44886;4385;2;4724;49552305;40441998;279745;385;122705
FR;0;2021-09-06;75077;180895;31930;16;34132;49627382;40622893;311675;401;156837
FR;0;2021-09-07;79220;181281;33224;40;36028;49706602;40804174;344899;441;192865
FR;0;2021-09-08;88710;206127;29636;27;32293;49795312;41010301;374535;468;225158
FR;0;2021-09-09;75702;165302;33014;26;36371;49871014;41175603;407549;494;261529
FR;0;2021-09-10;95004;203579;35691;25;40354;49966018;41379182;443240;519;301883
FR;0;2021-09-11;66265;169160;12118;18;14192;50032283;41548342;455358;537;316075
FR;0;2021-09-12;12719;32099;2761;2;3145;50045002;41580441;458119;539;319220
FR;0;2021-09-13;64265;126408;41180;32;43797;50109267;41706849;499299;571;363017
FR;0;2021-09-14;73190;129182;56301;78;61668;50182457;41836031;555600;649;424685
FR;0;2021-09-15;76206;167789;55582;59;54680;50258663;42003820;611182;708;479365
FR;0;2021-09-16;63615;114507;59980;86;59912;50322278;42118327;671162;794;539277
FR;0;2021-09-17;74843;156815;53781;71;57147;50397121;42275142;724943;865;596424
FR;0;2021-09-18;48114;139547;15588;25;17271;50445235;42414689;740531;890;613695
FR;0;2021-09-19;7836;23723;2427;1;2619;50453071;42438412;742958;891;616314
FR;0;2021-09-20;44365;93907;49981;73;50157;50497436;42532319;792939;964;666471
FR;0;2021-09-21;45715;98460;62663;78;63229;50543151;42630779;855602;1042;729700
FR;0;2021-09-22;48476;142170;55275;84;55224;50591627;42772949;910877;1126;784924
FR;0;2021-09-23;43057;91828;62300;95;63289;50634684;42864777;973177;1221;848213
FR;0;2021-09-24;52086;132902;54485;110;59003;50686770;42997679;1027662;1331;907216
FR;0;2021-09-25;35125;115374;16256;37;18228;50721895;43113053;1043918;1368;925444
FR;0;2021-09-26;5510;17838;2261;4;2342;50727405;43130891;1046179;1372;927786
FR;0;2021-09-27;33884;76988;47146;96;48084;50761289;43207879;1093325;1468;975870
FR;0;2021-09-28;36406;75232;54870;88;56341;50797695;43283111;1148195;1556;1032211
FR;0;2021-09-29;44270;100766;53272;111;54716;50841965;43383877;1201467;1667;1086927
FR;0;2021-09-30;36142;72205;56942;96;59356;50878107;43456082;1258409;1763;1146283
FR;0;2021-10-01;60976;100500;57743;108;63623;50939083;43556582;1316152;1871;1209906
FR;0;2021-10-02;39173;78217;20937;38;23280;50978256;43634799;1337089;1909;1233186
FR;0;2021-10-03;5236;10589;2517;4;2555;50983492;43645388;1339606;1913;1235741
FR;0;2021-10-04;34656;58474;52579;83;54747;51018148;43703862;1392185;1996;1290488
FR;0;2021-10-05;33139;64274;60911;135;64815;51051287;43768136;1453096;2131;1355303
FR;0;2021-10-06;42117;79083;65632;113;68119;51093404;43847219;1518728;2244;1423422
FR;0;2021-10-07;30225;62013;65332;90;68599;51123629;43909232;1584060;2334;1492021
FR;0;2021-10-08;48394;91660;77671;110;84514;51172023;44000892;1661731;2444;1576535
FR;0;2021-10-09;33485;60791;31500;35;33832;51205508;44061683;1693231;2479;1610367
FR;0;2021-10-10;4547;7369;3180;9;3476;51210055;44069052;1696411;2488;1613843
FR;0;2021-10-11;30388;49906;60996;105;63988;51240443;44118958;1757407;2593;1677831
FR;0;2021-10-12;31143;54423;70530;139;75746;51271586;44173381;1827937;2732;1753577
FR;0;2021-10-13;39824;62676;74376;135;79189;51311410;44236057;1902313;2867;1832766
FR;0;2021-10-14;30137;52741;68695;115;73667;51341547;44288798;1971008;2982;1906433
FR;0;2021-10-15;44580;75062;93183;191;102852;51386127;44363860;2064191;3173;2009285
FR;0;2021-10-16;31154;44049;36668;45;39586;51417281;44407909;2100859;3218;2048871
FR;0;2021-10-17;3807;5256;3586;2;3689;51421088;44413165;2104445;3220;2052560
FR;0;2021-10-18;27233;41873;67442;133;71299;51448321;44455038;2171887;3353;2123859
FR;0;2021-10-19;26854;43082;76354;141;81577;51475175;44498120;2248241;3494;2205436
FR;0;2021-10-20;35088;52261;96868;179;101369;51510263;44550381;2345109;3673;2306805
FR;0;2021-10-21;25746;45145;83878;112;89053;51536009;44595526;2428987;3785;2395858
FR;0;2021-10-22;38131;62097;104822;199;112408;51574140;44657623;2533809;3984;2508266
FR;0;2021-10-23;26874;41041;45418;57;48580;51601014;44698664;2579227;4041;2556846
FR;0;2021-10-24;2901;4784;3676;6;3940;51603915;44703448;2582903;4047;2560786
FR;0;2021-10-25;25929;36248;82267;144;86555;51629844;44739696;2665170;4191;2647341
FR;0;2021-10-26;23620;34961;87172;166;92242;51653464;44774657;2752342;4357;2739583
FR;0;2021-10-27;29935;46387;108925;257;114563;51683399;44821044;2861267;4614;2854146
FR;0;2021-10-28;23268;34758;88627;153;94308;51706667;44855802;2949894;4767;2948454
FR;0;2021-10-29;31443;50984;117241;205;125161;51738110;44906786;3067135;4972;3073615
FR;0;2021-10-30;20375;33047;50302;78;53336;51758485;44939833;3117437;5050;3126951
FR;0;2021-10-31;2468;3795;3581;3;3871;51760953;44943628;3121018;5053;3130822
FR;0;2021-11-01;7777;4696;3187;3;3540;51768730;44948324;3124205;5056;3134362
FR;0;2021-11-02;24946;39971;93496;157;99400;51793676;44988295;3217701;5213;3233762
FR;0;2021-11-03;29473;47703;118800;218;125704;51823149;45035998;3336501;5431;3359466
FR;0;2021-11-04;23525;37409;107450;216;114256;51846674;45073407;3443951;5647;3473722
FR;0;2021-11-05;32118;52701;141542;233;151168;51878792;45126108;3585493;5880;3624890
FR;0;2021-11-06;21368;34484;64817;123;68179;51900160;45160592;3650310;6003;3693069
FR;0;2021-11-07;2359;4270;5162;6;5589;51902519;45164862;3655472;6009;3698658
FR;0;2021-11-08;20126;37801;127085;227;134101;51922645;45202663;3782557;6236;3832759
FR;0;2021-11-09;21971;44761;161568;342;172020;51944616;45247424;3944125;6578;4004779
FR;0;2021-11-10;31150;54706;186877;446;198542;51975766;45302130;4131002;7024;4203321
FR;0;2021-11-11;3930;6388;12897;28;13879;51979696;45308518;4143899;7052;4217200
FR;0;2021-11-12;28872;55108;183675;249;197188;52008568;45363626;4327574;7301;4414388
FR;0;2021-11-13;20198;32655;80654;118;86265;52028766;45396281;4408228;7419;4500653
FR;0;2021-11-14;2299;3994;7155;6;7881;52031065;45400275;4415383;7425;4508534
FR;0;2021-11-15;20151;38769;160713;312;171379;52051216;45439044;4576096;7737;4679913
FR;0;2021-11-16;23149;43932;200252;391;214752;52074365;45482976;4776348;8128;4894665
FR;0;2021-11-17;30190;50418;199740;407;212727;52104555;45533394;4976088;8535;5107392
FR;0;2021-11-18;23188;43863;191521;469;205305;52127743;45577257;5167609;9004;5312697
FR;0;2021-11-19;33486;61324;243071;548;261965;52161229;45638581;5410680;9552;5574662
FR;0;2021-11-20;25230;36648;102089;205;109619;52186459;45675229;5512769;9757;5684281
FR;0;2021-11-21;2611;4593;9631;18;10656;52189070;45679822;5522400;9775;5694937
FR;0;2021-11-22;22650;33243;180239;470;194674;52211720;45713065;5702639;10245;5889611
FR;0;2021-11-23;25415;45553;229234;547;247581;52237135;45758618;5931873;10792;6137192
FR;0;2021-11-24;31672;53696;224697;718;243052;52268807;45812314;6156570;11510;6380244
FR;0;2021-11-25;25291;48891;255764;740;277493;52294098;45861205;6412334;12250;6657737
FR;0;2021-11-26;33073;74631;379307;865;414451;52327171;45935836;6791641;13115;7072188
FR;0;2021-11-27;23175;49470;214810;390;236514;52350346;45985306;7006451;13505;7308702
FR;0;2021-11-28;3472;10602;56714;66;63342;52353818;45995908;7063165;13571;7372044
FR;0;2021-11-29;19300;54145;341326;864;371442;52373118;46050053;7404491;14435;7743486
FR;0;2021-11-30;24420;71933;457227;984;500569;52397538;46121986;7861718;15419;8244055
FR;0;2021-12-01;26052;75731;468903;1158;511058;52423590;46197717;8330621;16577;8755113
FR;0;2021-12-02;21766;71584;526926;1276;574598;52445356;46269301;8857547;17853;9329711
FR;0;2021-12-03;25333;92361;596178;1415;650842;52470689;46361662;9453725;19268;9980553
FR;0;2021-12-04;18251;60426;336119;690;369614;52488940;46422088;9789844;19958;10350167
FR;0;2021-12-05;4134;16295;95735;156;107064;52493074;46438383;9885579;20114;10457231
FR;0;2021-12-06;19164;73114;492965;1171;539747;52512238;46511497;10378544;21285;10996978
FR;0;2021-12-07;23212;91675;645160;1769;705992;52535450;46603172;11023704;23054;11702970
FR;0;2021-12-08;25221;92051;591379;1871;647263;52560671;46695223;11615083;24925;12350233
FR;0;2021-12-09;23887;94130;662849;2180;726042;52584558;46789353;12277932;27105;13076275
FR;0;2021-12-10;27079;110996;735824;2072;805861;52611637;46900349;13013756;29177;13882136
FR;0;2021-12-11;20194;75950;435083;984;480275;52631831;46976299;13448839;30161;14362411
FR;0;2021-12-12;5603;23218;142232;262;159217;52637434;46999517;13591071;30423;14521628
FR;0;2021-12-13;20980;91126;587434;1699;649100;52658414;47090643;14178505;32122;15170728
FR;0;2021-12-14;26988;118465;765282;2647;847247;52685402;47209108;14943787;34769;16017975
FR;0;2021-12-15;28040;114198;694089;2262;768796;52713442;47323306;15637876;37031;16786771
FR;0;2021-12-16;27821;115955;763774;2555;844199;52741263;47439261;16401650;39586;17630970
FR;0;2021-12-17;31417;128677;807636;2710;891846;52772680;47567938;17209286;42296;18522816
FR;0;2021-12-18;24893;81666;469869;1178;522129;52797573;47649604;17679155;43474;19044945
FR;0;2021-12-19;8738;28920;169329;378;191184;52806311;47678524;17848484;43852;19236129
FR;0;2021-12-20;31527;97404;591246;1787;658534;52837838;47775928;18439730;45639;19894663
FR;0;2021-12-21;39152;112186;682209;2391;759359;52876990;47888114;19121939;48030;20654022
FR;0;2021-12-22;39406;99430;575563;2166;641972;52916396;47987544;19697502;50196;21295994
FR;0;2021-12-23;33657;79625;440820;1648;494262;52950053;48067169;20138322;51844;21790256
FR;0;2021-12-24;10612;26057;110954;396;126649;52960665;48093226;20249276;52240;21916905
FR;0;2021-12-25;761;3494;7569;25;9044;52961426;48096720;20256845;52265;21925949
FR;0;2021-12-26;4695;11899;52062;139;60131;52966121;48108619;20308907;52404;21986080
FR;0;2021-12-27;30242;83758;453392;1365;509005;52996363;48192377;20762299;53769;22495085
FR;0;2021-12-28;38252;98861;564012;1766;632090;53034615;48291238;21326311;55535;23127175
FR;0;2021-12-29;39796;88332;501043;1685;560865;53074411;48379570;21827354;57220;23688040
FR;0;2021-12-30;35825;74815;420902;1519;471047;53110236;48454385;22248256;58739;24159087
FR;0;2021-12-31;11829;25083;116804;406;131581;53122065;48479468;22365060;59145;24290668
FR;0;2022-01-01;1185;3202;8492;36;9917;53123250;48482670;22373552;59181;24300585
FR;0;2022-01-02;6063;13006;58372;124;66925;53129313;48495676;22431924;59305;24367510
FR;0;2022-01-03;31526;87938;494590;1591;551234;53160839;48583614;22926514;60896;24918744
FR;0;2022-01-04;40507;110518;641210;2303;714101;53201346;48694132;23567724;63199;25632845
FR;0;2022-01-05;59559;102927;568946;1981;633920;53260905;48797059;24136670;65180;26266765
FR;0;2022-01-06;43759;109958;638780;2688;711206;53304664;48907017;24775450;67868;26977971
FR;0;2022-01-07;50402;122713;710800;2804;790179;53355066;49029730;25486250;70672;27768150
FR;0;2022-01-08;44894;80304;423743;1208;472806;53399960;49110034;25909993;71880;28240956
FR;0;2022-01-09;15591;26776;128527;299;145714;53415551;49136810;26038520;72179;28386670
FR;0;2022-01-10;34800;86216;469098;1808;521965;53450351;49223026;26507618;73987;28908635
FR;0;2022-01-11;41503;99709;548033;2306;608275;53491854;49322735;27055651;76293;29516910
FR;0;2022-01-12;59975;95139;452480;1964;504141;53551829;49417874;27508131;78257;30021051
FR;0;2022-01-13;37753;92028;487134;2080;540838;53589582;49509902;27995265;80337;30561889
FR;0;2022-01-14;42285;103183;568380;2283;628858;53631867;49613085;28563645;82620;31190747
FR;0;2022-01-15;39278;65778;340032;979;377499;53671145;49678863;28903677;83599;31568246
FR;0;2022-01-16;11380;19327;87355;215;99443;53682525;49698190;28991032;83814;31667689
FR;0;2022-01-17;24526;60001;320149;1380;354088;53707051;49758191;29311181;85194;32021777
FR;0;2022-01-18;28045;68298;360916;1796;397440;53735096;49826489;29672097;86990;32419217
FR;0;2022-01-19;42948;66911;281146;1448;310971;53778044;49893400;29953243;88438;32730188
FR;0;2022-01-20;23323;59274;298804;1737;328303;53801367;49952674;30252047;90175;33058491
FR;0;2022-01-21;27897;68723;366200;2077;401049;53829264;50021397;30618247;92252;33459540
FR;0;2022-01-22;27599;47747;218723;838;241706;53856863;50069144;30836970;93090;33701246
FR;0;2022-01-23;6694;13064;48627;171;55177;53863557;50082208;30885597;93261;33756423
FR;0;2022-01-24;16152;47074;217186;1133;239267;53879709;50129282;31102783;94394;33995690
FR;0;2022-01-25;18871;53991;242917;1547;266990;53898580;50183273;31345700;95941;34262680
FR;0;2022-01-26;28054;59385;209131;1292;229248;53926634;50242658;31554831;97233;34491928
FR;0;2022-01-27;16236;45523;207482;1266;225704;53942870;50288181;31762313;98499;34717632
FR;0;2022-01-28;21421;75754;289900;1573;321423;53964291;50363935;32052213;100072;35039055
FR;0;2022-01-29;18379;52856;184051;683;204548;53982670;50416791;32236264;100755;35243603
FR;0;2022-01-30;4462;14596;39111;121;45091;53987132;50431387;32275375;100876;35288694
FR;0;2022-01-31;11191;43816;148107;738;164767;53998323;50475203;32423482;101614;35453461
FR;0;2022-02-01;12581;47685;173988;1131;191243;54010904;50522888;32597470;102745;35644704
FR;0;2022-02-02;19647;65559;171375;1018;190012;54030551;50588447;32768845;103763;35834716
FR;0;2022-02-03;10860;43718;157412;972;173204;54041411;50632165;32926257;104735;36007920
FR;0;2022-02-04;14422;66210;239096;1260;264103;54055833;50698375;33165353;105995;36272023
FR;0;2022-02-05;12577;51464;153480;522;172312;54068410;50749839;33318833;106517;36444335
FR;0;2022-02-06;2701;12264;28856;99;33818;54071111;50762103;33347689;106616;36478153
FR;0;2022-02-07;9198;46529;156764;582;176271;54080309;50808632;33504453;107198;36654424
FR;0;2022-02-08;9503;42470;166510;863;184260;54089812;50851102;33670963;108061;36838684
FR;0;2022-02-09;14070;57467;172231;864;192875;54103882;50908569;33843194;108925;37031559
FR;0;2022-02-10;8193;37882;150062;872;166446;54112075;50946451;33993256;109797;37198005
FR;0;2022-02-11;10713;55263;218354;1094;242905;54122788;51001714;34211610;110891;37440910
FR;0;2022-02-12;8308;40824;134659;461;151665;54131096;51042538;34346269;111352;37592575
FR;0;2022-02-13;1881;8560;26528;81;30882;54132977;51051098;34372797;111433;37623457
FR;0;2022-02-14;6850;35016;148233;478;166224;54139827;51086114;34521030;111911;37789681
FR;0;2022-02-15;6806;35267;146785;749;162301;54146633;51121381;34667815;112660;37951982
FR;0;2022-02-16;9243;42323;132370;715;146535;54155876;51163704;34800185;113375;38098517
FR;0;2022-02-17;5320;23417;87176;582;94671;54161196;51187121;34887361;113957;38193188
FR;0;2022-02-18;6826;33053;119525;800;129150;54168022;51220174;35006886;114757;38322338
FR;0;2022-02-19;5313;24401;69976;369;77267;54173335;51244575;35076862;115126;38399605
FR;0;2022-02-20;1129;4596;12135;38;13905;54174464;51249171;35088997;115164;38413510
FR;0;2022-02-21;3966;17705;61860;351;67074;54178430;51266876;35150857;115515;38480584
FR;0;2022-02-22;4312;18400;60733;571;64347;54182742;51285276;35211590;116086;38544931
FR;0;2022-02-23;6482;26961;66376;591;71753;54189224;51312237;35277966;116677;38616684
FR;0;2022-02-24;3703;14912;50304;513;53091;54192927;51327149;35328270;117190;38669775
FR;0;2022-02-25;5139;23343;76199;799;79894;54198066;51350492;35404469;117989;38749669
FR;0;2022-02-26;3949;17448;47347;354;51410;54202015;51367940;35451816;118343;38801079
FR;0;2022-02-27;857;2975;8008;47;8915;54202872;51370915;35459824;118390;38809994
FR;0;2022-02-28;3033;11993;40384;350;42808;54205905;51382908;35500208;118740;38852802
FR;0;2022-03-01;2942;11973;43812;417;44420;54208847;51394881;35544020;119157;38897222
FR;0;2022-03-02;4985;17315;46893;433;48791;54213832;51412196;35590913;119590;38946013
FR;0;2022-03-03;2574;8641;29530;336;29615;54216406;51420837;35620443;119926;38975628
FR;0;2022-03-04;3120;12044;40085;641;39200;54219526;51432881;35660528;120567;39014828
FR;0;2022-03-05;2866;9168;24839;304;24983;54222392;51442049;35685367;120871;39039811
FR;0;2022-03-06;490;1361;3173;42;3407;54222882;51443410;35688540;120913;39043218
FR;0;2022-03-07;1869;5394;18246;309;17505;54224751;51448804;35706786;121222;39060723
FR;0;2022-03-08;1900;5759;19193;351;17648;54226651;51454563;35725979;121573;39078371
FR;0;2022-03-09;3393;10081;21786;398;20879;54230044;51464644;35747765;121971;39099250
FR;0;2022-03-10;1629;4842;16280;326;15080;54231673;51469486;35764045;122297;39114330
FR;0;2022-03-11;2293;7190;24262;535;22008;54233966;51476676;35788307;122832;39136338
FR;0;2022-03-12;2616;6664;17045;301;16381;54236582;51483340;35805352;123133;39152719
FR;0;2022-03-13;373;762;2206;143;2156;54236955;51484102;35807558;123276;39154875
FR;0;2022-03-14;1417;4010;14488;4402;13347;54238372;51488112;35822046;127678;39168222
FR;0;2022-03-15;1529;4176;15479;7529;13558;54239901;51492288;35837525;135207;39181780
FR;0;2022-03-16;2872;6806;18095;13115;16784;54242773;51499094;35855620;148322;39198564
FR;0;2022-03-17;1325;3475;12160;10756;10985;54244098;51502569;35867780;159078;39209549
FR;0;2022-03-18;2134;5341;19428;18207;17487;54246232;51507910;35887208;177285;39227036
FR;0;2022-03-19;2240;4594;12940;9378;12225;54248472;51512504;35900148;186663;39239261
FR;0;2022-03-20;277;663;1711;1055;1716;54248749;51513167;35901859;187718;39240977
FR;0;2022-03-21;1302;2954;11179;14813;10420;54250051;51516121;35913038;202531;39251397
FR;0;2022-03-22;1395;3391;12837;20433;11589;54251446;51519512;35925875;222964;39262986
FR;0;2022-03-23;2539;5576;14564;22960;13926;54253985;51525088;35940439;245924;39276912
FR;0;2022-03-24;1269;2705;10457;17299;9512;54255254;51527793;35950896;263223;39286424
FR;0;2022-03-25;1955;4542;17416;27516;15747;54257209;51532335;35968312;290739;39302171
FR;0;2022-03-26;2174;4100;11675;12561;11093;54259383;51536435;35979987;303300;39313264
FR;0;2022-03-27;343;655;1813;1432;1843;54259726;51537090;35981800;304732;39315107
FR;0;2022-03-28;1346;2739;10163;16975;9625;54261072;51539829;35991963;321707;39324732
FR;0;2022-03-29;1349;3052;12067;26428;11202;54262421;51542881;36004030;348135;39335934
FR;0;2022-03-30;2674;5052;14338;26070;13715;54265095;51547933;36018368;374205;39349649
