fra;vaccin;jour;n_dose1;n_dose2;n_dose3;n_dose4;n_complet;n_rappel;n_2_rappel;n_rappel_biv;n_3_rappel;n_cum_dose1;n_cum_dose2;n_cum_dose3;n_cum_dose4;n_cum_complet;n_cum_rappel;n_cum_2_rappel;n_cum_rappel_biv;n_cum_3_rappel
FR;1;2020-12-27;616;0;0;0;55;0;0;0;0;616;0;0;0;55;0;0;0;0
FR;1;2020-12-28;707;1;0;0;44;0;0;0;0;1323;1;0;0;99;0;0;0;0
FR;1;2020-12-29;389;0;0;0;19;0;0;0;0;1712;1;0;0;118;0;0;0;0
FR;1;2020-12-30;455;0;0;0;19;0;0;0;0;2167;1;0;0;137;0;0;0;0
FR;1;2020-12-31;450;1;0;0;21;0;0;0;0;2617;2;0;0;158;0;0;0;0
FR;1;2021-01-01;1193;2;0;0;66;0;0;0;0;3810;4;0;0;224;0;0;0;0
FR;1;2021-01-02;369;4;0;0;29;0;0;0;0;4179;8;0;0;253;0;0;0;0
FR;1;2021-01-03;418;0;0;0;23;0;0;0;0;4597;8;0;0;276;0;0;0;0
FR;1;2021-01-04;2145;5;0;0;51;0;0;0;0;6742;13;0;0;327;0;0;0;0
FR;1;2021-01-05;7777;6;0;0;128;0;0;0;0;14519;19;0;0;455;0;0;0;0
FR;1;2021-01-06;12479;23;0;0;128;0;0;0;0;26998;42;0;0;583;0;0;0;0
FR;1;2021-01-07;29480;24;0;0;159;0;0;0;0;56478;66;0;0;742;0;0;0;0
FR;1;2021-01-08;37170;35;0;0;204;0;0;0;0;93648;101;0;0;946;0;0;0;0
FR;1;2021-01-09;11220;9;0;0;77;0;0;0;0;104868;110;0;0;1023;0;0;0;0
FR;1;2021-01-10;6016;8;0;0;28;0;0;0;0;110884;118;0;0;1051;0;0;0;0
FR;1;2021-01-11;39956;39;0;0;232;0;0;0;0;150840;157;0;0;1283;0;0;0;0
FR;1;2021-01-12;62162;30;0;0;298;0;0;0;0;213002;187;0;0;1581;0;0;0;0
FR;1;2021-01-13;65147;62;0;0;433;0;0;0;0;278149;249;0;0;2014;0;0;0;0
FR;1;2021-01-14;81471;261;0;0;958;0;0;0;0;359620;510;0;0;2972;0;0;0;0
FR;1;2021-01-15;68638;101;0;0;528;0;0;0;0;428258;611;0;0;3500;0;0;0;0
FR;1;2021-01-16;19903;73;0;0;171;0;0;0;0;448161;684;0;0;3671;0;0;0;0
FR;1;2021-01-17;10909;54;0;0;130;0;0;0;0;459070;738;0;0;3801;0;0;0;0
FR;1;2021-01-18;82848;176;0;0;588;0;0;0;0;541918;914;0;0;4389;0;0;0;0
FR;1;2021-01-19;125935;209;0;0;838;0;0;0;0;667853;1123;0;0;5227;0;0;0;0
FR;1;2021-01-20;132438;190;0;0;779;0;0;0;0;800291;1313;0;0;6006;0;0;0;0
FR;1;2021-01-21;153085;196;0;0;896;0;0;0;0;953376;1509;0;0;6902;0;0;0;0
FR;1;2021-01-22;115971;239;0;0;775;0;0;0;0;1069347;1748;0;0;7677;0;0;0;0
FR;1;2021-01-23;36617;84;0;0;207;0;0;0;0;1105964;1832;0;0;7884;0;0;0;0
FR;1;2021-01-24;9589;128;0;0;187;0;0;0;0;1115553;1960;0;0;8071;0;0;0;0
FR;1;2021-01-25;74442;1453;0;0;1771;0;0;0;0;1189995;3413;0;0;9842;0;0;0;0
FR;1;2021-01-26;96471;3702;1;0;4143;0;0;0;0;1286466;7115;1;0;13985;0;0;0;0
FR;1;2021-01-27;103660;6440;0;0;7124;0;0;0;0;1390126;13555;1;0;21109;0;0;0;0
FR;1;2021-01-28;120627;16401;0;0;17190;0;0;0;0;1510753;29956;1;0;38299;0;0;0;0
FR;1;2021-01-29;88901;18795;0;0;19336;0;0;0;0;1599654;48751;1;0;57635;0;0;0;0
FR;1;2021-01-30;27995;4532;0;0;4656;0;0;0;0;1627649;53283;1;0;62291;0;0;0;0
FR;1;2021-01-31;5194;1898;0;0;1936;0;0;0;0;1632843;55181;1;0;64227;0;0;0;0
FR;1;2021-02-01;49752;23034;0;0;23276;0;0;0;0;1682595;78215;1;0;87503;0;0;0;0
FR;1;2021-02-02;67838;38185;0;0;38643;0;0;0;0;1750433;116400;1;0;126146;0;0;0;0
FR;1;2021-02-03;67104;40234;0;0;40669;0;0;0;0;1817537;156634;1;0;166815;0;0;0;0
FR;1;2021-02-04;77155;55112;0;0;55683;0;0;0;0;1894692;211746;1;0;222498;0;0;0;0
FR;1;2021-02-05;63435;48221;0;0;48626;0;0;0;0;1958127;259967;1;0;271124;0;0;0;0
FR;1;2021-02-06;19428;11419;0;0;11526;0;0;0;0;1977555;271386;1;0;282650;0;0;0;0
FR;1;2021-02-07;3669;6065;0;0;6092;0;0;0;0;1981224;277451;1;0;288742;0;0;0;0
FR;1;2021-02-08;36508;48766;0;0;49019;0;0;0;0;2017732;326217;1;0;337761;0;0;0;0
FR;1;2021-02-09;50827;78421;0;0;78947;0;0;0;0;2068559;404638;1;0;416708;0;0;0;0
FR;1;2021-02-10;52087;83431;0;0;83913;0;0;0;0;2120646;488069;1;0;500621;0;0;0;0
FR;1;2021-02-11;63396;105511;0;0;106420;0;0;0;0;2184042;593580;1;0;607041;0;0;0;0
FR;1;2021-02-12;55886;75809;0;0;76496;0;0;0;0;2239928;669389;1;0;683537;0;0;0;0
FR;1;2021-02-13;15470;19312;0;0;19424;0;0;0;0;2255398;688701;1;0;702961;0;0;0;0
FR;1;2021-02-14;3747;7322;0;0;7388;0;0;0;0;2259145;696023;1;0;710349;0;0;0;0
FR;1;2021-02-15;24175;73667;0;0;73924;0;0;0;0;2283320;769690;1;0;784273;0;0;0;0
FR;1;2021-02-16;32788;95522;0;0;95932;0;0;0;0;2316108;865212;1;0;880205;0;0;0;0
FR;1;2021-02-17;35139;102373;20;0;103030;0;0;0;0;2351247;967585;21;0;983235;0;0;0;0
FR;1;2021-02-18;49465;118544;0;0;119540;0;0;0;0;2400712;1086129;21;0;1102775;0;0;0;0
FR;1;2021-02-19;45400;87832;1;0;88777;0;0;0;0;2446112;1173961;22;0;1191552;0;0;0;0
FR;1;2021-02-20;13398;27027;0;0;27203;0;0;0;0;2459510;1200988;22;0;1218755;0;0;0;0
FR;1;2021-02-21;2471;5945;0;0;6013;0;0;0;0;2461981;1206933;22;0;1224768;0;0;0;0
FR;1;2021-02-22;24727;69389;2;0;69687;0;0;0;0;2486708;1276322;24;0;1294455;0;0;0;0
FR;1;2021-02-23;37441;81550;1;0;82253;0;0;0;0;2524149;1357872;25;0;1376708;0;0;0;0
FR;1;2021-02-24;40717;79373;1;0;80073;0;0;0;0;2564866;1437245;26;0;1456781;0;0;0;0
FR;1;2021-02-25;50175;87711;1;0;88808;0;0;0;0;2615041;1524956;27;0;1545589;0;0;0;0
FR;1;2021-02-26;47234;67561;1;0;68449;0;0;0;0;2662275;1592517;28;0;1614038;0;0;0;0
FR;1;2021-02-27;15691;21358;1;0;21570;0;0;0;0;2677966;1613875;29;0;1635608;0;0;0;0
FR;1;2021-02-28;3566;4104;2;0;4177;0;0;0;0;2681532;1617979;31;0;1639785;0;0;0;0
FR;1;2021-03-01;40231;50281;1;0;51017;0;0;0;0;2721763;1668260;32;0;1690802;0;0;0;0
FR;1;2021-03-02;55995;62421;3;0;63601;0;0;0;0;2777758;1730681;35;0;1754403;0;0;0;0
FR;1;2021-03-03;61271;60501;0;0;61938;0;0;0;0;2839029;1791182;35;0;1816341;0;0;0;0
FR;1;2021-03-04;73022;68393;3;0;70609;0;0;0;0;2912051;1859575;38;0;1886950;0;0;0;0
FR;1;2021-03-05;74786;58608;3;0;60508;0;0;0;0;2986837;1918183;41;0;1947458;0;0;0;0
FR;1;2021-03-06;82475;15734;2;0;17442;0;0;0;0;3069312;1933917;43;0;1964900;0;0;0;0
FR;1;2021-03-07;63734;3919;1;0;5463;0;0;0;0;3133046;1937836;44;0;1970363;0;0;0;0
FR;1;2021-03-08;60200;41136;2;0;42422;0;0;0;0;3193246;1978972;46;0;2012785;0;0;0;0
FR;1;2021-03-09;86015;47362;1;0;49361;0;0;0;0;3279261;2026334;47;0;2062146;0;0;0;0
FR;1;2021-03-10;90949;47741;5;0;50013;0;0;0;0;3370210;2074075;52;0;2112159;0;0;0;0
FR;1;2021-03-11;105107;54588;1;0;57665;0;0;0;0;3475317;2128663;53;0;2169824;0;0;0;0
FR;1;2021-03-12;104169;44877;1;0;47874;0;0;0;0;3579486;2173540;54;0;2217698;0;0;0;0
FR;1;2021-03-13;89225;12579;1;0;14796;0;0;0;0;3668711;2186119;55;0;2232494;0;0;0;0
FR;1;2021-03-14;44462;2658;1;0;3991;0;0;0;0;3713173;2188777;56;0;2236485;0;0;0;0
FR;1;2021-03-15;95538;27942;3;0;30293;0;0;0;0;3808711;2216719;59;0;2266778;0;0;0;0
FR;1;2021-03-16;123607;34033;5;0;37580;0;0;0;0;3932318;2250752;64;0;2304358;0;0;0;0
FR;1;2021-03-17;129327;33512;4;0;37566;0;0;0;0;4061645;2284264;68;0;2341924;0;0;0;0
FR;1;2021-03-18;142918;39154;5;0;43832;0;0;0;0;4204563;2323418;73;0;2385756;0;0;0;0
FR;1;2021-03-19;136282;32011;2;0;36603;0;0;0;0;4340845;2355429;75;0;2422359;0;0;0;0
FR;1;2021-03-20;76026;9747;1;0;11964;0;0;0;0;4416871;2365176;76;0;2434323;0;0;0;0
FR;1;2021-03-21;26522;1972;1;0;2961;0;0;0;0;4443393;2367148;77;0;2437284;0;0;0;0
FR;1;2021-03-22;114783;30211;2;0;34042;0;0;0;0;4558176;2397359;79;0;2471326;0;0;0;0
FR;1;2021-03-23;143063;38005;1;0;42796;0;0;0;0;4701239;2435364;80;0;2514122;0;0;0;0
FR;1;2021-03-24;142030;38401;0;0;43271;0;0;0;0;4843269;2473765;80;0;2557393;0;0;0;0
FR;1;2021-03-25;165045;39880;4;0;46044;0;0;0;0;5008314;2513645;84;0;2603437;0;0;0;0
FR;1;2021-03-26;166426;37407;5;1;44028;0;0;0;0;5174740;2551052;89;1;2647465;0;0;0;0
FR;1;2021-03-27;110909;15484;1;0;19495;0;0;0;0;5285649;2566536;90;1;2666960;0;0;0;0
FR;1;2021-03-28;42315;4431;3;0;5986;0;0;0;0;5327964;2570967;93;1;2672946;0;0;0;0
FR;1;2021-03-29;129853;48967;4;0;53634;0;0;0;0;5457817;2619934;97;1;2726580;0;0;0;0
FR;1;2021-03-30;167765;63828;5;0;70839;0;0;0;0;5625582;2683762;102;1;2797419;0;0;0;0
FR;1;2021-03-31;170974;68014;4;0;75540;0;0;0;0;5796556;2751776;106;1;2872959;0;0;0;0
FR;1;2021-04-01;194888;84122;10;0;93630;0;0;0;0;5991444;2835898;116;1;2966589;0;0;0;0
FR;1;2021-04-02;164477;86898;7;0;94722;0;0;0;0;6155921;2922796;123;1;3061311;0;0;0;0
FR;1;2021-04-03;88262;58202;6;0;61750;0;0;0;0;6244183;2980998;129;1;3123061;0;0;0;0
FR;1;2021-04-04;33666;17734;0;0;19234;0;0;0;0;6277849;2998732;129;1;3142295;0;0;0;0
FR;1;2021-04-05;46431;9566;11;0;11443;0;0;0;0;6324280;3008298;140;1;3153738;0;0;0;0
FR;1;2021-04-06;160352;105667;17;0;112154;0;0;0;0;6484632;3113965;157;1;3265892;0;0;0;0
FR;1;2021-04-07;197042;108093;16;0;116931;0;0;0;0;6681674;3222058;173;1;3382823;0;0;0;0
FR;1;2021-04-08;222192;114350;14;0;125709;0;0;0;0;6903866;3336408;187;1;3508532;0;0;0;0
FR;1;2021-04-09;214619;108046;21;0;118943;0;0;0;0;7118485;3444454;208;1;3627475;0;0;0;0
FR;1;2021-04-10;117211;73238;14;0;78385;0;0;0;0;7235696;3517692;222;1;3705860;0;0;0;0
FR;1;2021-04-11;40903;29892;6;0;31796;0;0;0;0;7276599;3547584;228;1;3737656;0;0;0;0
FR;1;2021-04-12;168507;104586;46;0;111835;0;0;0;0;7445106;3652170;274;1;3849491;0;0;0;0
FR;1;2021-04-13;203854;127765;97;1;137114;0;0;0;0;7648960;3779935;371;2;3986605;0;0;0;0
FR;1;2021-04-14;208685;123028;208;0;133260;0;0;0;0;7857645;3902963;579;2;4119865;0;0;0;0
FR;1;2021-04-15;221744;128241;313;0;139289;0;0;0;0;8079389;4031204;892;2;4259154;0;0;0;0
FR;1;2021-04-16;206111;125785;309;0;135455;0;0;0;0;8285500;4156989;1201;2;4394609;0;0;0;0
FR;1;2021-04-17;122112;67117;103;0;72179;0;0;0;0;8407612;4224106;1304;2;4466788;0;0;0;0
FR;1;2021-04-18;35980;21012;42;0;22720;0;0;0;0;8443592;4245118;1346;2;4489508;0;0;0;0
FR;1;2021-04-19;163783;121611;432;0;129161;0;0;0;0;8607375;4366729;1778;2;4618669;0;0;0;0
FR;1;2021-04-20;189490;149794;531;0;158923;0;0;0;0;8796865;4516523;2309;2;4777592;0;0;0;0
FR;1;2021-04-21;194062;147783;760;0;157314;0;0;0;0;8990927;4664306;3069;2;4934906;0;0;0;0
FR;1;2021-04-22;209085;164616;779;0;175848;0;0;0;0;9200012;4828922;3848;2;5110754;0;0;0;0
FR;1;2021-04-23;198999;158143;671;0;169164;0;0;0;0;9399011;4987065;4519;2;5279918;0;0;0;0
FR;1;2021-04-24;126354;95889;148;0;101958;0;0;0;0;9525365;5082954;4667;2;5381876;0;0;0;0
FR;1;2021-04-25;53641;30082;46;0;32839;0;0;0;0;9579006;5113036;4713;2;5414715;0;0;0;0
FR;1;2021-04-26;181174;140328;543;0;149048;0;0;0;0;9760180;5253364;5256;2;5563763;0;0;0;0
FR;1;2021-04-27;221405;162612;901;0;173988;0;0;0;0;9981585;5415976;6157;2;5737751;0;0;0;0
FR;1;2021-04-28;238355;156224;1314;1;168906;1;0;0;0;10219940;5572200;7471;3;5906657;1;0;0;0
FR;1;2021-04-29;270351;161674;1211;0;177281;0;0;0;0;10490291;5733874;8682;3;6083938;1;0;0;0
FR;1;2021-04-30;272029;149040;1074;0;165141;0;0;0;0;10762320;5882914;9756;3;6249079;1;0;0;0
FR;1;2021-05-01;141181;40614;173;0;48642;0;0;0;0;10903501;5923528;9929;3;6297721;1;0;0;0
FR;1;2021-05-02;81564;28240;81;0;32996;0;0;0;0;10985065;5951768;10010;3;6330717;1;0;0;0
FR;1;2021-05-03;250824;142088;803;0;155783;0;0;0;0;11235889;6093856;10813;3;6486500;1;0;0;0
FR;1;2021-05-04;265939;188044;1204;0;203617;0;0;0;0;11501828;6281900;12017;3;6690117;1;0;0;0
FR;1;2021-05-05;283955;186293;1268;0;202957;0;0;0;0;11785783;6468193;13285;3;6893074;1;0;0;0
FR;1;2021-05-06;310047;184595;1502;0;204349;0;0;0;0;12095830;6652788;14787;3;7097423;1;0;0;0
FR;1;2021-05-07;284152;196758;1127;0;214578;0;0;0;0;12379982;6849546;15914;3;7312001;1;0;0;0
FR;1;2021-05-08;191686;51614;285;0;62998;0;0;0;0;12571668;6901160;16199;3;7374999;1;0;0;0
FR;1;2021-05-09;114075;34214;236;0;41386;0;0;0;0;12685743;6935374;16435;3;7416385;1;0;0;0
FR;1;2021-05-10;258241;195095;1188;0;211091;0;0;0;0;12943984;7130469;17623;3;7627476;1;0;0;0
FR;1;2021-05-11;318945;211246;1465;0;231486;0;0;0;0;13262929;7341715;19088;3;7858962;1;0;0;0
FR;1;2021-05-12;356694;186098;1401;0;208404;0;0;0;0;13619623;7527813;20489;3;8067366;1;0;0;0
FR;1;2021-05-13;283472;47323;401;0;64247;0;0;0;0;13903095;7575136;20890;3;8131613;1;0;0;0
FR;1;2021-05-14;370543;128529;998;0;151949;0;0;0;0;14273638;7703665;21888;3;8283562;1;0;0;0
FR;1;2021-05-15;298126;66208;404;0;84916;0;0;0;0;14571764;7769873;22292;3;8368478;1;0;0;0
FR;1;2021-05-16;157795;15469;158;0;26037;0;0;0;0;14729559;7785342;22450;3;8394515;1;0;0;0
FR;1;2021-05-17;318957;116206;1441;0;138169;0;0;0;0;15048516;7901548;23891;3;8532684;1;0;0;0
FR;1;2021-05-18;383393;111697;1801;0;137648;0;0;0;0;15431909;8013245;25692;3;8670332;1;0;0;0
FR;1;2021-05-19;395316;101551;2185;0;128491;0;0;0;0;15827225;8114796;27877;3;8798823;1;0;0;0
FR;1;2021-05-20;421860;95616;2049;0;125084;0;0;0;0;16249085;8210412;29926;3;8923907;1;0;0;0
FR;1;2021-05-21;399845;97447;1765;0;125850;0;0;0;0;16648930;8307859;31691;3;9049757;1;0;0;0
FR;1;2021-05-22;275711;41922;604;0;60948;0;0;0;0;16924641;8349781;32295;3;9110705;1;0;0;0
FR;1;2021-05-23;123033;10969;224;0;20572;0;0;0;0;17047674;8360750;32519;3;9131277;1;0;0;0
FR;1;2021-05-24;244028;26265;569;0;43793;0;0;0;0;17291702;8387015;33088;3;9175070;1;0;0;0
FR;1;2021-05-25;366247;131472;2115;1;158407;0;0;0;0;17657949;8518487;35203;4;9333477;1;0;0;0
FR;1;2021-05-26;380855;127512;1996;0;155838;0;0;0;0;18038804;8645999;37199;4;9489315;1;0;0;0
FR;1;2021-05-27;406199;128335;1978;0;158819;0;0;0;0;18445003;8774334;39177;4;9648134;1;0;0;0
FR;1;2021-05-28;366079;145710;1702;0;174273;0;0;0;0;18811082;8920044;40879;4;9822407;1;0;0;0
FR;1;2021-05-29;253850;81137;527;0;100337;0;0;0;0;19064932;9001181;41406;4;9922744;1;0;0;0
FR;1;2021-05-30;100983;22599;158;0;30833;0;0;0;0;19165915;9023780;41564;4;9953577;1;0;0;0
FR;1;2021-05-31;314351;149254;1287;1;172514;1;0;0;0;19480266;9173034;42851;5;10126091;2;0;0;0
FR;1;2021-06-01;361702;166437;1733;1;194141;1;0;0;0;19841968;9339471;44584;6;10320232;3;0;0;0
FR;1;2021-06-02;365433;154507;1798;0;184051;0;0;0;0;20207401;9493978;46382;6;10504283;3;0;0;0
FR;1;2021-06-03;391494;147431;1654;0;178405;0;0;0;0;20598895;9641409;48036;6;10682688;3;0;0;0
FR;1;2021-06-04;364144;175894;1496;1;205186;1;0;0;0;20963039;9817303;49532;7;10887874;4;0;0;0
FR;1;2021-06-05;258533;112821;597;0;133185;0;0;0;0;21221572;9930124;50129;7;11021059;4;0;0;0
FR;1;2021-06-06;126832;37554;216;0;48193;0;0;0;0;21348404;9967678;50345;7;11069252;4;0;0;0
FR;1;2021-06-07;301132;207774;1368;0;233050;0;0;0;0;21649536;10175452;51713;7;11302302;4;0;0;0
FR;1;2021-06-08;330902;221003;1645;0;248968;0;0;0;0;21980438;10396455;53358;7;11551270;4;0;0;0
FR;1;2021-06-09;336656;210952;1614;0;239712;0;0;0;0;22317094;10607407;54972;7;11790982;4;0;0;0
FR;1;2021-06-10;343943;199523;1615;0;229271;0;0;0;0;22661037;10806930;56587;7;12020253;4;0;0;0
FR;1;2021-06-11;311941;234705;1300;1;262617;0;0;0;0;22972978;11041635;57887;8;12282870;4;0;0;0
FR;1;2021-06-12;244097;150608;438;0;172219;0;0;0;0;23217075;11192243;58325;8;12455089;4;0;0;0
FR;1;2021-06-13;100383;61036;188;0;70698;0;0;0;0;23317458;11253279;58513;8;12525787;4;0;0;0
FR;1;2021-06-14;207878;287588;1320;1;307396;0;0;0;0;23525336;11540867;59833;9;12833183;4;0;0;0
FR;1;2021-06-15;256906;281120;1400;1;304970;0;0;0;0;23782242;11821987;61233;10;13138153;4;0;0;0
FR;1;2021-06-16;273686;270704;1264;1;296140;0;0;0;0;24055928;12092691;62497;11;13434293;4;0;0;0
FR;1;2021-06-17;268255;245090;1241;1;271161;0;0;0;0;24324183;12337781;63738;12;13705454;4;0;0;0
FR;1;2021-06-18;260625;295196;1155;1;321024;0;0;0;0;24584808;12632977;64893;13;14026478;4;0;0;0
FR;1;2021-06-19;193468;209608;388;0;228270;0;0;0;0;24778276;12842585;65281;13;14254748;4;0;0;0
FR;1;2021-06-20;69724;89030;122;0;96871;0;0;0;0;24848000;12931615;65403;13;14351619;4;0;0;0
FR;1;2021-06-21;172399;319786;934;1;338497;1;0;0;0;25020399;13251401;66337;14;14690116;5;0;0;0
FR;1;2021-06-22;185898;348068;1102;10;369134;1;0;0;0;25206297;13599469;67439;24;15059250;6;0;0;0
FR;1;2021-06-23;204239;339643;1050;0;363541;0;0;0;0;25410536;13939112;68489;24;15422791;6;0;0;0
FR;1;2021-06-24;203554;282075;1176;0;306819;0;0;0;0;25614090;14221187;69665;24;15729610;6;0;0;0
FR;1;2021-06-25;182683;371699;1200;0;395704;0;0;0;0;25796773;14592886;70865;24;16125314;6;0;0;0
FR;1;2021-06-26;131414;278605;506;0;295981;0;0;0;0;25928187;14871491;71371;24;16421295;6;0;0;0
FR;1;2021-06-27;52421;122845;146;0;130383;0;0;0;0;25980608;14994336;71517;24;16551678;6;0;0;0
FR;1;2021-06-28;136681;368238;1066;0;386839;0;0;0;0;26117289;15362574;72583;24;16938517;6;0;0;0
FR;1;2021-06-29;154921;391151;1848;0;412247;0;0;0;0;26272210;15753725;74431;24;17350764;6;0;0;0
FR;1;2021-06-30;180076;381950;1668;4;406552;2;0;0;0;26452286;16135675;76099;28;17757316;8;0;0;0
FR;1;2021-07-01;201589;332505;1890;5;360582;0;0;0;0;26653875;16468180;77989;33;18117898;8;0;0;0
FR;1;2021-07-02;193891;367286;1765;5;395487;2;0;0;0;26847766;16835466;79754;38;18513385;10;0;0;0
FR;1;2021-07-03;124485;280408;704;3;299515;1;0;0;0;26972251;17115874;80458;41;18812900;11;0;0;0
FR;1;2021-07-04;53969;113728;244;0;122135;0;0;0;0;27026220;17229602;80702;41;18935035;11;0;0;0
FR;1;2021-07-05;153985;355769;1500;8;379110;0;0;0;0;27180205;17585371;82202;49;19314145;11;0;0;0
FR;1;2021-07-06;173532;382278;1603;45;408169;8;0;0;0;27353737;17967649;83805;94;19722314;19;0;0;0
FR;1;2021-07-07;190872;362299;1659;25;390639;2;0;0;0;27544609;18329948;85464;119;20112953;21;0;0;0
FR;1;2021-07-08;201594;322961;1827;20;353609;2;0;0;0;27746203;18652909;87291;139;20466562;23;0;0;0
FR;1;2021-07-09;189993;387759;1854;3;418164;1;0;0;0;27936196;19040668;89145;142;20884726;24;0;0;0
FR;1;2021-07-10;129965;281179;818;1;302604;1;0;0;0;28066161;19321847;89963;143;21187330;25;0;0;0
FR;1;2021-07-11;57688;102528;263;0;112411;0;0;0;0;28123849;19424375;90226;143;21299741;25;0;0;0
FR;1;2021-07-12;149931;416801;1588;4;442792;0;0;0;0;28273780;19841176;91814;147;21742533;25;0;0;0
FR;1;2021-07-13;234309;438991;1808;8;476178;0;0;0;0;28508089;20280167;93622;155;22218711;25;0;0;0
FR;1;2021-07-14;171931;151302;418;0;176933;0;0;0;0;28680020;20431469;94040;155;22395644;25;0;0;0
FR;1;2021-07-15;279707;424129;1859;1;467102;0;0;0;0;28959727;20855598;95899;156;22862746;25;0;0;0
FR;1;2021-07-16;290445;400527;1711;3;445167;1;0;0;0;29250172;21256125;97610;159;23307913;26;0;0;0
FR;1;2021-07-17;217360;281972;755;1;315442;0;0;0;0;29467532;21538097;98365;160;23623355;26;0;0;0
FR;1;2021-07-18;102030;107205;288;0;123093;0;0;0;0;29569562;21645302;98653;160;23746448;26;0;0;0
FR;1;2021-07-19;238250;378360;1498;3;414409;0;0;0;0;29807812;22023662;100151;163;24160857;26;0;0;0
FR;1;2021-07-20;305777;379724;1471;0;425546;0;0;0;0;30113589;22403386;101622;163;24586403;26;0;0;0
FR;1;2021-07-21;333309;352702;1413;4;404071;1;0;0;0;30446898;22756088;103035;167;24990474;27;0;0;0
FR;1;2021-07-22;364707;318525;1502;3;374938;2;0;0;0;30811605;23074613;104537;170;25365412;29;0;0;0
FR;1;2021-07-23;349411;342718;1589;4;398257;1;0;0;0;31161016;23417331;106126;174;25763669;30;0;0;0
FR;1;2021-07-24;238967;240734;697;1;278061;0;0;0;0;31399983;23658065;106823;175;26041730;30;0;0;0
FR;1;2021-07-25;112810;76011;223;0;93706;0;0;0;0;31512793;23734076;107046;175;26135436;30;0;0;0
FR;1;2021-07-26;299148;289266;1495;2;334978;1;0;0;0;31811941;24023342;108541;177;26470414;31;0;0;0
FR;1;2021-07-27;385863;267853;1459;4;324823;1;0;0;0;32197804;24291195;110000;181;26795237;32;0;0;0
FR;1;2021-07-28;390228;250914;1463;4;307201;1;0;0;0;32588032;24542109;111463;185;27102438;33;0;0;0
FR;1;2021-07-29;406160;227572;1541;2;284268;0;0;0;0;32994192;24769681;113004;187;27386706;33;0;0;0
FR;1;2021-07-30;370761;246486;1639;4;298322;1;0;0;0;33364953;25016167;114643;191;27685028;34;0;0;0
FR;1;2021-07-31;243394;165088;794;1;199410;0;0;0;0;33608347;25181255;115437;192;27884438;34;0;0;0
FR;1;2021-08-01;105608;47204;237;0;61198;0;0;0;0;33713955;25228459;115674;192;27945636;34;0;0;0
FR;1;2021-08-02;297437;212827;1480;2;250612;0;0;0;0;34011392;25441286;117154;194;28196248;34;0;0;0
FR;1;2021-08-03;331353;208674;1557;2;250643;1;0;0;0;34342745;25649960;118711;196;28446891;35;0;0;0
FR;1;2021-08-04;328059;183817;1440;5;223971;3;0;0;0;34670804;25833777;120151;201;28670862;38;0;0;0
FR;1;2021-08-05;301299;193083;1483;0;229378;0;0;0;0;34972103;26026860;121634;201;28900240;38;0;0;0
FR;1;2021-08-06;290999;224079;1560;3;261366;0;0;0;0;35263102;26250939;123194;204;29161606;38;0;0;0
FR;1;2021-08-07;182684;158762;655;5;181671;1;0;0;0;35445786;26409701;123849;209;29343277;39;0;0;0
FR;1;2021-08-08;68896;59101;253;0;67629;0;0;0;0;35514682;26468802;124102;209;29410906;39;0;0;0
FR;1;2021-08-09;222801;235147;1446;4;263855;2;0;0;0;35737483;26703949;125548;213;29674761;41;0;0;0
FR;1;2021-08-10;252763;239823;1492;2;271656;0;0;0;0;35990246;26943772;127040;215;29946417;41;0;0;0
FR;1;2021-08-11;236255;231715;1272;5;261227;0;0;0;0;36226501;27175487;128312;220;30207644;41;0;0;0
FR;1;2021-08-12;220804;239730;1491;3;267822;0;0;0;0;36447305;27415217;129803;223;30475466;41;0;0;0
FR;1;2021-08-13;201731;238487;1360;2;264029;2;0;0;0;36649036;27653704;131163;225;30739495;43;0;0;0
FR;1;2021-08-14;122876;174029;645;0;189533;0;0;0;0;36771912;27827733;131808;225;30929028;43;0;0;0
FR;1;2021-08-15;34711;46114;201;1;50332;0;0;0;0;36806623;27873847;132009;226;30979360;43;0;0;0
FR;1;2021-08-16;156967;289321;1424;0;309889;0;0;0;0;36963590;28163168;133433;226;31289249;43;0;0;0
FR;1;2021-08-17;171626;290952;1422;5;313353;0;0;0;0;37135216;28454120;134855;231;31602602;43;0;0;0
FR;1;2021-08-18;161449;286668;1394;6;307297;3;0;0;0;37296665;28740788;136249;237;31909899;46;0;0;0
FR;1;2021-08-19;148961;277409;1405;1;297251;0;0;0;0;37445626;29018197;137654;238;32207150;46;0;0;0
FR;1;2021-08-20;140532;308913;1535;2;328146;2;0;0;0;37586158;29327110;139189;240;32535296;48;0;0;0
FR;1;2021-08-21;84283;213208;589;0;224527;0;0;0;0;37670441;29540318;139778;240;32759823;48;0;0;0
FR;1;2021-08-22;28584;82692;233;0;86697;0;0;0;0;37699025;29623010;140011;240;32846520;48;0;0;0
FR;1;2021-08-23;118673;320938;1422;2;337675;0;0;0;0;37817698;29943948;141433;242;33184195;48;0;0;0
FR;1;2021-08-24;126686;319604;1604;5;337421;0;0;0;0;37944384;30263552;143037;247;33521616;48;0;0;0
FR;1;2021-08-25;121546;306416;1783;8;323590;2;0;0;0;38065930;30569968;144820;255;33845206;50;0;0;0
FR;1;2021-08-26;106644;286073;2164;10;302372;0;0;0;0;38172574;30856041;146984;265;34147578;50;0;0;0
FR;1;2021-08-27;107659;321593;2303;9;338854;1;0;0;0;38280233;31177634;149287;274;34486432;51;0;0;0
FR;1;2021-08-28;71029;220699;1102;0;231221;0;0;0;0;38351262;31398333;150389;274;34717653;51;0;0;0
FR;1;2021-08-29;24156;78203;469;1;82094;0;0;0;0;38375418;31476536;150858;275;34799747;51;0;0;0
FR;1;2021-08-30;96905;286272;4315;6;299757;4968;0;0;0;38472323;31762808;155173;281;35099504;5019;0;0;0
FR;1;2021-08-31;98132;276228;9295;15;289896;10064;2;0;0;38570455;32039036;164468;296;35389400;15083;2;0;0
FR;1;2021-09-01;112368;245287;21121;8;257671;22157;1;0;0;38682823;32284323;185589;304;35647071;37240;3;0;0
FR;1;2021-09-02;86758;197900;24536;18;208296;25520;0;0;0;38769581;32482223;210125;322;35855367;62760;3;0;0
FR;1;2021-09-03;82431;227483;26958;21;238922;28037;0;0;0;38852012;32709706;237083;343;36094289;90797;3;0;0
FR;1;2021-09-04;71630;189716;11141;11;199301;11712;7;0;0;38923642;32899422;248224;354;36293590;102509;10;0;0
FR;1;2021-09-05;18614;41144;4126;2;43850;4277;0;0;0;38942256;32940566;252350;356;36337440;106786;10;0;0
FR;1;2021-09-06;59825;151363;30182;15;158894;31205;2;0;0;39002081;33091929;282532;371;36496334;137991;12;0;0
FR;1;2021-09-07;57401;139623;30214;30;146740;31254;2;0;0;39059482;33231552;312746;401;36643074;169245;14;0;0
FR;1;2021-09-08;72356;173796;26926;22;182269;27967;4;0;0;39131838;33405348;339672;423;36825343;197212;18;0;0
FR;1;2021-09-09;54505;124422;28637;24;131180;29748;5;0;0;39186343;33529770;368309;447;36956523;226960;23;0;0
FR;1;2021-09-10;66223;152066;30452;24;161153;31693;5;0;0;39252566;33681836;398761;471;37117676;258653;28;0;0
FR;1;2021-09-11;52689;146637;9732;14;154129;10357;0;0;0;39305255;33828473;408493;485;37271805;269010;28;0;0
FR;1;2021-09-12;10799;29269;2490;1;30967;2660;2;0;0;39316054;33857742;410983;486;37302772;271670;30;0;0
FR;1;2021-09-13;51518;104400;38767;31;110932;40098;16;0;0;39367572;33962142;449750;517;37413704;311768;46;0;0
FR;1;2021-09-14;53343;96004;51291;67;102374;53288;41;0;0;39420915;34058146;501041;584;37516078;365056;87;0;0
FR;1;2021-09-15;60587;139223;50498;55;146391;47069;68;0;0;39481502;34197369;551539;639;37662469;412125;155;0;0
FR;1;2021-09-16;46646;81367;53354;70;86262;49611;61;0;0;39528148;34278736;604893;709;37748731;461736;216;0;0
FR;1;2021-09-17;53226;109327;45081;61;115661;42713;62;0;0;39581374;34388063;649974;770;37864392;504449;278;0;0
FR;1;2021-09-18;37887;118497;11796;19;124082;11279;19;0;0;39619261;34506560;661770;789;37988474;515728;297;0;0
FR;1;2021-09-19;6531;21025;2044;1;22129;1984;1;0;0;39625792;34527585;663814;790;38010603;517712;298;0;0
FR;1;2021-09-20;36544;74841;46231;65;78562;44198;30;0;0;39662336;34602426;710045;855;38089165;561910;328;0;0
FR;1;2021-09-21;34208;68098;56270;72;71134;52746;76;0;0;39696544;34670524;766315;927;38160299;614656;404;0;0
FR;1;2021-09-22;38849;118598;49884;76;123018;46936;39;0;0;39735393;34789122;816199;1003;38283317;661592;443;0;0
FR;1;2021-09-23;32039;62888;54515;85;65791;50922;76;0;0;39767432;34852010;870714;1088;38349108;712514;519;0;0
FR;1;2021-09-24;36804;90023;43677;89;94382;41957;57;0;0;39804236;34942033;914391;1177;38443490;754471;576;0;0
FR;1;2021-09-25;27655;96708;12307;27;101064;12186;19;0;0;39831891;35038741;926698;1204;38544554;766657;595;0;0
FR;1;2021-09-26;4390;15202;1777;5;16066;1700;4;0;0;39836281;35053943;928475;1209;38560620;768357;599;0;0
FR;1;2021-09-27;27356;60204;42914;89;63433;41644;79;0;1;39863637;35114147;971389;1298;38624053;810001;678;0;1
FR;1;2021-09-28;26914;49418;47207;76;52036;44494;40;0;0;39890551;35163565;1018596;1374;38676089;854495;718;0;1
FR;1;2021-09-29;35927;80254;47297;87;84640;45623;33;0;0;39926478;35243819;1065893;1461;38760729;900118;751;0;1
FR;1;2021-09-30;26078;46897;47527;80;49256;45476;52;0;0;39952556;35290716;1113420;1541;38809985;945594;803;0;1
FR;1;2021-10-01;47306;66911;44908;83;70793;44633;14;0;0;39999862;35357627;1158328;1624;38880778;990227;817;0;1
FR;1;2021-10-02;32383;62413;16114;32;67221;16325;6;0;0;40032245;35420040;1174442;1656;38947999;1006552;823;0;1
FR;1;2021-10-03;4343;8564;2043;3;9312;2039;4;0;0;40036588;35428604;1176485;1659;38957311;1008591;827;0;1
FR;1;2021-10-04;28983;44422;47114;79;46836;46982;31;0;0;40065571;35473026;1223599;1738;39004147;1055573;858;0;1
FR;1;2021-10-05;24576;41639;49894;116;43136;49351;47;0;0;40090147;35514665;1273493;1854;39047283;1104924;905;0;1
FR;1;2021-10-06;34659;61386;57510;101;64495;57264;25;0;0;40124806;35576051;1331003;1955;39111778;1162188;930;0;1
FR;1;2021-10-07;21082;39912;53052;74;41091;51997;32;0;0;40145888;35615963;1384055;2029;39152869;1214185;962;0;1
FR;1;2021-10-08;35672;59642;60411;83;62869;61169;28;0;0;40181560;35675605;1444466;2112;39215738;1275354;990;0;1
FR;1;2021-10-09;27466;48024;25498;29;52493;26028;10;0;0;40209026;35723629;1469964;2141;39268231;1301382;1000;0;1
FR;1;2021-10-10;3728;5810;2759;7;6289;2865;1;0;0;40212754;35729439;1472723;2148;39274520;1304247;1001;0;1
FR;1;2021-10-11;24858;38211;54589;88;40296;55266;47;0;0;40237612;35767650;1527312;2236;39314816;1359513;1048;0;1
FR;1;2021-10-12;23386;36586;58078;128;37086;59240;18;0;0;40260998;35804236;1585390;2364;39351902;1418753;1066;0;1
FR;1;2021-10-13;32974;47843;64177;125;50647;65704;22;0;1;40293972;35852079;1649567;2489;39402549;1484457;1088;0;2
FR;1;2021-10-14;21715;34766;53776;103;35674;54370;24;0;0;40315687;35886845;1703343;2592;39438223;1538827;1112;0;2
FR;1;2021-10-15;32755;48761;72338;165;50454;75035;22;0;0;40348442;35935606;1775681;2757;39488677;1613862;1134;0;2
FR;1;2021-10-16;26014;35284;34874;45;38300;36431;13;0;0;40374456;35970890;1810555;2802;39526977;1650293;1147;0;2
FR;1;2021-10-17;3161;4053;3418;2;4496;3319;3;0;0;40377617;35974943;1813973;2804;39531473;1653612;1150;0;2
FR;1;2021-10-18;24353;34875;66850;132;34913;69734;27;0;0;40401970;36009818;1880823;2936;39566386;1723346;1177;0;2
FR;1;2021-10-19;20724;35572;75677;135;33224;79609;40;0;0;40422694;36045390;1956500;3071;39599610;1802955;1217;0;2
FR;1;2021-10-20;29917;44201;96190;178;43277;99880;45;0;0;40452611;36089591;2052690;3249;39642887;1902835;1262;0;2
FR;1;2021-10-21;19804;35053;83200;107;31763;87064;29;0;0;40472415;36124644;2135890;3356;39674650;1989899;1291;0;2
FR;1;2021-10-22;29756;47760;103757;196;44555;109723;58;0;0;40502171;36172404;2239647;3552;39719205;2099622;1349;0;2
FR;1;2021-10-23;23055;35140;44875;57;36130;47385;11;0;0;40525226;36207544;2284522;3609;39755335;2147007;1360;0;2
FR;1;2021-10-24;2406;3842;3584;6;4042;3717;1;0;0;40527632;36211386;2288106;3615;39759377;2150724;1361;0;2
FR;1;2021-10-25;22504;30714;82031;143;29597;85839;36;0;0;40550136;36242100;2370137;3758;39788974;2236563;1397;0;2
FR;1;2021-10-26;19368;27644;86123;162;24738;90355;29;0;0;40569504;36269744;2456260;3920;39813712;2326918;1426;0;2
FR;1;2021-10-27;26224;39613;107826;252;37305;112741;45;0;0;40595728;36309357;2564086;4172;39851017;2439659;1471;0;2
FR;1;2021-10-28;18803;27109;86968;150;23483;91736;34;0;0;40614531;36336466;2651054;4322;39874500;2531395;1505;0;2
FR;1;2021-10-29;25936;40254;114844;202;35491;121680;49;0;0;40640467;36376720;2765898;4524;39909991;2653075;1554;0;2
FR;1;2021-10-30;17713;28718;49372;74;28303;51969;18;0;0;40658180;36405438;2815270;4598;39938294;2705044;1572;0;2
FR;1;2021-10-31;2088;3169;3452;2;3215;3686;2;0;0;40660268;36408607;2818722;4600;39941509;2708730;1574;0;2
FR;1;2021-11-01;8025;4274;3036;3;4358;3293;6;0;0;40668293;36412881;2821758;4603;39945867;2712023;1580;0;2
FR;1;2021-11-02;22917;33221;92416;156;29172;97873;39;0;1;40691210;36446102;2914174;4759;39975039;2809896;1619;0;3
FR;1;2021-11-03;26638;41548;117525;219;36997;123910;56;0;0;40717848;36487650;3031699;4978;40012036;2933806;1675;0;3
FR;1;2021-11-04;19629;30287;105825;213;24184;111969;42;0;0;40737477;36517937;3137524;5191;40036220;3045775;1717;0;3
FR;1;2021-11-05;27030;42297;138800;230;34177;147490;47;0;0;40764507;36560234;3276324;5421;40070397;3193265;1764;0;3
FR;1;2021-11-06;18865;29807;63501;123;27607;66521;24;0;0;40783372;36590041;3339825;5544;40098004;3259786;1788;0;3
FR;1;2021-11-07;1834;3267;4985;6;3024;5302;5;0;0;40785206;36593308;3344810;5550;40101028;3265088;1793;0;3
FR;1;2021-11-08;17881;32245;126019;224;25389;132656;47;0;0;40803087;36625553;3470829;5774;40126417;3397744;1840;0;3
FR;1;2021-11-09;19521;37602;159327;334;26128;169150;63;0;0;40822608;36663155;3630156;6108;40152545;3566894;1903;0;3
FR;1;2021-11-10;28893;49050;181928;441;39012;192547;82;0;0;40851501;36712205;3812084;6549;40191557;3759441;1985;0;3
FR;1;2021-11-11;4191;5930;12239;26;5106;13029;14;0;0;40855692;36718135;3824323;6575;40196663;3772470;1999;0;3
FR;1;2021-11-12;26025;46825;174849;244;35292;186550;76;0;0;40881717;36764960;3999172;6819;40231955;3959020;2075;0;3
FR;1;2021-11-13;18736;29143;76847;111;25370;81792;40;0;0;40900453;36794103;4076019;6930;40257325;4040812;2115;0;3
FR;1;2021-11-14;2051;3241;6827;5;2796;7358;6;0;0;40902504;36797344;4082846;6935;40260121;4048170;2121;0;3
FR;1;2021-11-15;18797;34710;156448;306;24617;166286;59;0;0;40921301;36832054;4239294;7241;40284738;4214456;2180;0;3
FR;1;2021-11-16;21369;37814;192163;380;23319;205080;99;0;1;40942670;36869868;4431457;7621;40308057;4419536;2279;0;4
FR;1;2021-11-17;28674;45551;193256;398;33025;205080;92;0;0;40971344;36915419;4624713;8019;40341082;4624616;2371;0;4
FR;1;2021-11-18;21147;39597;182541;459;25136;194669;85;0;0;40992491;36955016;4807254;8478;40366218;4819285;2456;0;4
FR;1;2021-11-19;30894;53320;230285;532;34816;246781;135;0;0;41023385;37008336;5037539;9010;40401034;5066066;2591;0;4
FR;1;2021-11-20;23775;33215;97001;202;26733;103656;40;0;0;41047160;37041551;5134540;9212;40427767;5169722;2631;0;4
FR;1;2021-11-21;2342;3907;9133;19;2956;9939;16;0;0;41049502;37045458;5143673;9231;40430723;5179661;2647;0;4
FR;1;2021-11-22;21426;30326;175933;467;16943;189481;79;0;0;41070928;37075784;5319606;9698;40447666;5369142;2726;0;4
FR;1;2021-11-23;24030;40973;221266;540;21321;238020;77;0;0;41094958;37116757;5540872;10238;40468987;5607162;2803;0;4
FR;1;2021-11-24;30298;49642;217402;701;31963;234585;67;0;0;41125256;37166399;5758274;10939;40500950;5841747;2870;0;4
FR;1;2021-11-25;23733;44044;244525;718;22073;264225;101;0;0;41148989;37210443;6002799;11657;40523023;6105972;2971;0;4
FR;1;2021-11-26;30618;66634;356842;836;33239;388626;154;0;0;41179607;37277077;6359641;12493;40556262;6494598;3125;0;4
FR;1;2021-11-27;21960;45263;202665;372;26150;222698;112;0;0;41201567;37322340;6562306;12865;40582412;6717296;3237;0;4
FR;1;2021-11-28;3180;9544;54803;63;3467;61016;37;0;0;41204747;37331884;6617109;12928;40585879;6778312;3274;0;4
FR;1;2021-11-29;17904;49468;326433;841;20775;354580;150;0;0;41222651;37381352;6943542;13769;40606654;7132892;3424;0;4
FR;1;2021-11-30;22790;64817;431195;952;23800;470841;266;0;0;41245441;37446169;7374737;14721;40630454;7603733;3690;0;4
FR;1;2021-12-01;25363;69039;442955;1131;28429;481821;271;0;0;41270804;37515208;7817692;15852;40658883;8085554;3961;0;4
FR;1;2021-12-02;20091;64300;489464;1230;18434;532970;274;0;0;41290895;37579508;8307156;17082;40677317;8618524;4235;0;4
FR;1;2021-12-03;22913;82304;542840;1310;30275;591856;308;0;0;41313808;37661812;8849996;18392;40707592;9210380;4543;0;4
FR;1;2021-12-04;16417;53783;299137;654;23209;328996;180;0;0;41330225;37715595;9149133;19046;40730801;9539376;4723;0;4
FR;1;2021-12-05;3635;13775;81548;143;4196;91046;85;0;0;41333860;37729370;9230681;19189;40734997;9630422;4808;0;4
FR;1;2021-12-06;25847;62421;415524;1066;22064;455252;356;0;0;41359707;37791791;9646205;20255;40757061;10085674;5164;0;4
FR;1;2021-12-07;20019;75456;523076;1536;24274;572737;372;0;0;41379726;37867247;10169281;21791;40781335;10658411;5536;0;4
FR;1;2021-12-08;21718;75487;458552;1545;30644;502211;378;0;0;41401444;37942734;10627833;23336;40811979;11160622;5914;0;4
FR;1;2021-12-09;19473;73942;493087;1624;24327;541102;398;0;0;41420917;38016676;11120920;24960;40836306;11701724;6312;0;4
FR;1;2021-12-10;23329;87515;547468;1585;32416;600107;392;0;1;41444246;38104191;11668388;26545;40868722;12301831;6704;0;5
FR;1;2021-12-11;16531;59083;302768;751;25944;335501;278;0;0;41460777;38163274;11971156;27296;40894666;12637332;6982;0;5
FR;1;2021-12-12;4397;15877;83240;179;5244;94045;96;0;0;41465174;38179151;12054396;27475;40899910;12731377;7078;0;5
FR;1;2021-12-13;15761;63400;367083;1094;23906;406369;236;0;0;41480935;38242551;12421479;28569;40923816;13137746;7314;0;5
FR;1;2021-12-14;20870;80115;464895;1748;28643;515354;506;0;1;41501805;38322666;12886374;30317;40952459;13653100;7820;0;6
FR;1;2021-12-15;21631;77293;409185;1309;33008;453258;311;0;1;41523436;38399959;13295559;31626;40985467;14106358;8131;0;7
FR;1;2021-12-16;20070;77053;451998;1577;27919;500739;324;0;0;41543506;38477012;13747557;33203;41013386;14607097;8455;0;7
FR;1;2021-12-17;22628;86369;480027;1737;34640;531050;372;0;0;41566134;38563381;14227584;34940;41048026;15138147;8827;0;7
FR;1;2021-12-18;17610;54551;257660;731;24686;288529;232;0;0;41583744;38617932;14485244;35671;41072712;15426676;9059;0;7
FR;1;2021-12-19;5563;16910;79205;194;5919;90680;117;0;0;41589307;38634842;14564449;35865;41078631;15517356;9176;0;7
FR;1;2021-12-20;20957;62876;316303;1082;26495;355335;286;0;0;41610264;38697718;14880752;36947;41105126;15872691;9462;0;7
FR;1;2021-12-21;26342;72862;372820;1422;30556;418146;338;0;0;41636606;38770580;15253572;38369;41135682;16290837;9800;0;7
FR;1;2021-12-22;24989;65649;310702;1217;29577;349627;361;0;1;41661595;38836229;15564274;39586;41165259;16640464;10161;0;8
FR;1;2021-12-23;21276;52110;241539;958;23344;273074;362;0;0;41682871;38888339;15805813;40544;41188603;16913538;10523;0;8
FR;1;2021-12-24;7130;18266;67172;258;9244;77063;154;0;1;41690001;38906605;15872985;40802;41197847;16990601;10677;0;9
FR;1;2021-12-25;509;2865;5595;15;1796;6540;55;0;0;41690510;38909470;15878580;40817;41199643;16997141;10732;0;9
FR;1;2021-12-26;2751;7568;26957;71;3492;31467;100;0;0;41693261;38917038;15905537;40888;41203135;17028608;10832;0;9
FR;1;2021-12-27;18312;53465;235147;705;25456;265805;365;0;0;41711573;38970503;16140684;41593;41228591;17294413;11197;0;9
FR;1;2021-12-28;23302;61878;292070;1026;26986;330242;595;0;1;41734875;39032381;16432754;42619;41255577;17624655;11792;0;10
FR;1;2021-12-29;22218;55374;255047;921;25258;288244;645;0;1;41757093;39087755;16687801;43540;41280835;17912899;12437;0;11
FR;1;2021-12-30;21240;46407;212184;857;22442;239633;718;0;0;41778333;39134162;16899985;44397;41303277;18152532;13155;0;11
FR;1;2021-12-31;7468;16536;61881;229;8715;70415;346;0;0;41785801;39150698;16961866;44626;41311992;18222947;13501;0;11
FR;1;2022-01-01;1167;2489;5668;30;1543;6577;73;0;0;41786968;39153187;16967534;44656;41313535;18229524;13574;0;11
FR;1;2022-01-02;3088;8074;28897;50;3671;33539;190;0;0;41790056;39161261;16996431;44706;41317206;18263063;13764;0;11
FR;1;2022-01-03;26779;54164;228287;790;27531;257748;964;0;1;41816835;39215425;17224718;45496;41344737;18520811;14728;0;12
FR;1;2022-01-04;26313;64977;299317;1241;29776;337363;1367;0;2;41843148;39280402;17524035;46737;41374513;18858174;16095;0;14
FR;1;2022-01-05;30565;64242;274927;1099;32511;310305;1264;0;0;41873713;39344644;17798962;47836;41407024;19168479;17359;0;14
FR;1;2022-01-06;26859;66191;306953;1404;29267;346625;1569;0;1;41900572;39410835;18105915;49240;41436291;19515104;18928;0;15
FR;1;2022-01-07;31580;74962;349878;1538;34388;394007;1822;0;1;41932152;39485797;18455793;50778;41470679;19909111;20750;0;16
FR;1;2022-01-08;23391;51356;222511;698;25571;251139;913;0;1;41955543;39537153;18678304;51476;41496250;20160250;21663;0;17
FR;1;2022-01-09;7092;17133;66035;163;8167;76142;336;0;0;41962635;39554286;18744339;51639;41504417;20236392;21999;0;17
FR;1;2022-01-10;21811;60579;236837;957;32915;267630;1258;0;1;41984446;39614865;18981176;52596;41537332;20504022;23257;0;18
FR;1;2022-01-11;26778;63431;282342;1280;31194;317858;1837;0;1;42011224;39678296;19263518;53876;41568526;20821880;25094;0;19
FR;1;2022-01-12;28966;62479;246302;1106;35041;278092;1686;0;3;42040190;39740775;19509820;54982;41603567;21099972;26780;0;22
FR;1;2022-01-13;24789;60150;262842;1253;30022;296162;1993;0;4;42064979;39800925;19772662;56235;41633589;21396134;28773;0;26
FR;1;2022-01-14;27971;66685;314050;1366;32106;351303;2475;0;1;42092950;39867610;20086712;57601;41665695;21747437;31248;0;27
FR;1;2022-01-15;19372;44407;199332;619;22464;223867;1363;0;1;42112322;39912017;20286044;58220;41688159;21971304;32611;0;28
FR;1;2022-01-16;5161;12956;51536;135;6020;59557;338;0;0;42117483;39924973;20337580;58355;41694179;22030861;32949;0;28
FR;1;2022-01-17;16884;39666;184861;783;20114;206841;1690;0;2;42134367;39964639;20522441;59138;41714293;22237702;34639;0;30
FR;1;2022-01-18;19461;45960;212457;1154;22989;237056;2456;0;1;42153828;40010599;20734898;60292;41737282;22474758;37095;0;31
FR;1;2022-01-19;20313;43943;176140;898;25467;197197;1977;0;4;42174141;40054542;20911038;61190;41762749;22671955;39072;0;35
FR;1;2022-01-20;16852;40561;183722;1147;20807;204767;2516;0;2;42190993;40095103;21094760;62337;41783556;22876722;41588;0;37
FR;1;2022-01-21;19920;47006;228983;1405;23885;253360;3106;0;1;42210913;40142109;21323743;63742;41807441;23130082;44694;0;38
FR;1;2022-01-22;13844;33332;144509;579;18433;161397;1404;0;2;42224757;40175441;21468252;64321;41825874;23291479;46098;0;40
FR;1;2022-01-23;3380;8764;33438;132;4576;38325;352;0;1;42228137;40184205;21501690;64453;41830450;23329804;46450;0;41
FR;1;2022-01-24;11817;32967;142241;718;17789;158277;2104;0;1;42239954;40217172;21643931;65171;41848239;23488081;48554;0;42
FR;1;2022-01-25;14214;38156;163433;1049;20281;181565;3182;0;1;42254168;40255328;21807364;66220;41868520;23669646;51736;0;43
FR;1;2022-01-26;14865;37721;150266;933;22635;166394;2515;0;1;42269033;40293049;21957630;67153;41891155;23836040;54251;0;44
FR;1;2022-01-27;12340;33334;143472;896;18500;158047;3230;0;3;42281373;40326383;22101102;68049;41909655;23994087;57481;0;47
FR;1;2022-01-28;16329;56904;198330;1144;32660;222390;4007;0;3;42297702;40383287;22299432;69193;41942315;24216477;61488;0;50
FR;1;2022-01-29;10270;35472;135213;525;19612;151541;1879;0;1;42307972;40418759;22434645;69718;41961927;24368018;63367;0;51
FR;1;2022-01-30;2484;9255;29687;86;4827;34449;434;0;1;42310456;40428014;22464332;69804;41966754;24402467;63801;0;52
FR;1;2022-01-31;8759;32463;104353;533;19471;117345;2340;0;3;42319215;40460477;22568685;70337;41986225;24519812;66141;0;55
FR;1;2022-02-01;11006;36446;127087;865;20631;141209;4321;0;1;42330221;40496923;22695772;71202;42006856;24661021;70462;0;56
FR;1;2022-02-02;12079;41573;130369;782;25263;145820;3774;0;9;42342300;40538496;22826141;71984;42032119;24806841;74236;0;65
FR;1;2022-02-03;9510;34051;117034;785;19117;130336;4284;0;4;42351810;40572547;22943175;72769;42051236;24937177;78520;0;69
FR;1;2022-02-04;11540;49617;172589;968;26908;192726;5479;0;5;42363350;40622164;23115764;73737;42078144;25129903;83999;0;74
FR;1;2022-02-05;8000;33921;117593;391;18171;133025;2414;0;3;42371350;40656085;23233357;74128;42096315;25262928;86413;0;77
FR;1;2022-02-06;1706;7995;22754;86;3873;26905;444;0;0;42373056;40664080;23256111;74214;42100188;25289833;86857;0;77
FR;1;2022-02-07;7365;35385;119113;460;18170;134971;3398;0;4;42380421;40699465;23375224;74674;42118358;25424804;90255;0;81
FR;1;2022-02-08;7770;31960;125672;696;14893;140662;4301;0;5;42388191;40731425;23500896;75370;42133251;25565466;94556;0;86
FR;1;2022-02-09;8706;36528;135266;702;17928;152510;3884;0;7;42396897;40767953;23636162;76072;42151179;25717976;98440;0;93
FR;1;2022-02-10;7027;30138;116383;677;13901;130171;4445;0;1;42403924;40798091;23752545;76749;42165080;25848147;102885;0;94
FR;1;2022-02-11;8662;41562;165150;878;18375;185374;5430;0;3;42412586;40839653;23917695;77627;42183455;26033521;108315;0;97
FR;1;2022-02-12;5346;27617;106714;379;12540;120899;2396;0;2;42417932;40867270;24024409;78006;42195995;26154420;110711;0;99
FR;1;2022-02-13;1269;5721;21721;66;2188;25339;402;0;3;42419201;40872991;24046130;78072;42198183;26179759;111113;0;102
FR;1;2022-02-14;5460;27229;118096;395;10645;133124;3385;0;4;42424661;40900220;24164226;78467;42208828;26312883;114498;0;106
FR;1;2022-02-15;5798;28869;118940;611;12218;132572;4882;0;1;42430459;40929089;24283166;79078;42221046;26445455;119380;0;107
FR;1;2022-02-16;5762;28495;110427;597;13762;123057;4153;0;3;42436221;40957584;24393593;79675;42234808;26568512;123533;0;110
FR;1;2022-02-17;4616;19745;73154;489;10126;80260;3999;0;3;42440837;40977329;24466747;80164;42244934;26648772;127532;0;113
FR;1;2022-02-18;5613;26800;99208;673;14171;108169;5519;0;2;42446450;41004129;24565955;80837;42259105;26756941;133051;0;115
FR;1;2022-02-19;3551;17178;59478;304;9571;66059;2266;0;0;42450001;41021307;24625433;81141;42268676;26823000;135317;0;115
FR;1;2022-02-20;793;3258;10706;36;1651;12333;360;0;1;42450794;41024565;24636139;81177;42270327;26835333;135677;0;116
FR;1;2022-02-21;3430;14599;52830;286;7919;57678;3126;0;2;42454224;41039164;24688969;81463;42278246;26893011;138803;0;118
FR;1;2022-02-22;3804;15549;51919;500;9046;55657;4070;0;1;42458028;41054713;24740888;81963;42287292;26948668;142873;0;119
FR;1;2022-02-23;4235;17828;57484;510;10748;62585;3569;0;3;42462263;41072541;24798372;82473;42298040;27011253;146442;0;122
FR;1;2022-02-24;3344;13144;43620;436;7838;46410;3658;0;2;42465607;41085685;24841992;82909;42305878;27057663;150100;0;124
FR;1;2022-02-25;4478;20131;64927;697;12249;68798;5768;0;4;42470085;41105816;24906919;83606;42318127;27126461;155868;0;128
FR;1;2022-02-26;2698;12806;41371;310;7653;45124;2494;0;2;42472783;41118622;24948290;83916;42325780;27171585;158362;0;130
FR;1;2022-02-27;644;2192;7131;42;1207;7994;433;0;0;42473427;41120814;24955421;83958;42326987;27179579;158795;0;130
FR;1;2022-02-28;2613;10500;34967;306;6080;37393;3124;0;0;42476040;41131314;24990388;84264;42333067;27216972;161919;0;130
FR;1;2022-03-01;3591;10762;38708;391;6365;39662;4550;0;4;42479631;41142076;25029096;84655;42339432;27256634;166469;0;134
FR;1;2022-03-02;3685;12205;41870;398;7472;43940;4110;0;1;42483316;41154281;25070966;85053;42346904;27300574;170579;0;135
FR;1;2022-03-03;2463;7990;26186;329;5245;26524;3380;0;1;42485779;41162271;25097152;85382;42352149;27327098;173959;0;136
FR;1;2022-03-04;2690;10545;35467;594;6976;34961;5280;0;3;42488469;41172816;25132619;85976;42359125;27362059;179239;0;139
FR;1;2022-03-05;1823;6369;21971;280;4207;22370;2571;0;1;42490292;41179185;25154590;86256;42363332;27384429;181810;0;140
FR;1;2022-03-06;359;959;2917;38;605;3120;327;0;0;42490651;41180144;25157507;86294;42363937;27387549;182137;0;140
FR;1;2022-03-07;1900;4724;16442;245;3046;15910;2831;0;4;42492551;41184868;25173949;86539;42366983;27403459;184968;0;144
FR;1;2022-03-08;1717;5259;17172;309;3670;16000;3472;0;3;42494268;41190127;25191121;86848;42370653;27419459;188440;0;147
FR;1;2022-03-09;1988;6716;19820;371;4791;19179;3423;0;4;42496256;41196843;25210941;87219;42375444;27438638;191863;0;151
FR;1;2022-03-10;1415;5017;15297;309;3668;14335;2944;0;2;42497671;41201860;25226238;87528;42379112;27452973;194807;0;153
FR;1;2022-03-11;1761;6410;21717;487;4445;19870;4739;0;1;42499432;41208270;25247955;88015;42383557;27472843;199546;0;154
FR;1;2022-03-12;1263;4653;15367;281;3094;14915;2687;0;2;42500695;41212923;25263322;88296;42386651;27487758;202233;0;156
FR;1;2022-03-13;257;613;2119;119;414;2065;468;0;0;42500952;41213536;25265441;88415;42387065;27489823;202701;0;156
FR;1;2022-03-14;1157;3679;13407;3882;2294;12528;6342;0;8;42502109;41217215;25278848;92297;42389359;27502351;209043;0;164
FR;1;2022-03-15;1409;5735;14665;6865;4319;13262;9847;0;8;42503518;41222950;25293513;99162;42393678;27515613;218890;0;172
FR;1;2022-03-16;1695;5090;17401;11521;3600;16465;14126;0;6;42505213;41228040;25310914;110683;42397278;27532078;233016;0;178
FR;1;2022-03-17;1178;3441;11733;9648;2366;10828;11732;0;8;42506391;41231481;25322647;120331;42399644;27542906;244748;0;186
FR;1;2022-03-18;1725;4930;17980;16508;3324;16419;19722;0;14;42508116;41236411;25340627;136839;42402968;27559325;264470;0;200
FR;1;2022-03-19;1126;3301;11891;8460;2277;11361;10142;0;6;42509242;41239712;25352518;145299;42405245;27570686;274612;0;206
FR;1;2022-03-20;224;561;1726;1015;363;1761;1224;0;2;42509466;41240273;25354244;146314;42405608;27572447;275836;0;208
FR;1;2022-03-21;1088;2768;11503;13462;1787;10854;15142;0;10;42510554;41243041;25365747;159776;42407395;27583301;290978;0;218
FR;1;2022-03-22;1282;3214;12264;18716;2155;11252;20619;0;5;42511836;41246255;25378011;178492;42409550;27594553;311597;0;223
FR;1;2022-03-23;1514;4360;16033;20111;2956;15714;21883;0;34;42513350;41250615;25394044;198603;42412506;27610267;333480;0;257
FR;1;2022-03-24;1120;2754;10405;16060;1910;9666;17565;0;15;42514470;41253369;25404449;214663;42414416;27619933;351045;0;272
FR;1;2022-03-25;1540;4363;16754;25315;2881;15406;27959;0;23;42516010;41257732;25421203;239978;42417297;27635339;379004;0;295
FR;1;2022-03-26;1110;3017;10856;11450;2065;10517;12862;0;20;42517120;41260749;25432059;251428;42419362;27645856;391866;0;315
FR;1;2022-03-27;236;546;1750;1383;334;1803;1594;0;1;42517356;41261295;25433809;252811;42419696;27647659;393460;0;316
FR;1;2022-03-28;1086;2490;9980;15885;1558;9602;17229;0;10;42518442;41263785;25443789;268696;42421254;27657261;410689;0;326
FR;1;2022-03-29;1141;2754;11561;25111;1603;10925;26508;0;30;42519583;41266539;25455350;293807;42422857;27668186;437197;0;356
FR;1;2022-03-30;1632;3667;14174;24233;2441;13714;25897;0;19;42521215;41270206;25469524;318040;42425298;27681900;463094;0;375
FR;1;2022-03-31;1281;3025;11701;22700;2052;11214;24021;0;40;42522496;41273231;25481225;340740;42427350;27693114;487115;0;415
FR;1;2022-04-01;2239;4025;18492;28534;2481;17362;30806;0;53;42524735;41277256;25499717;369274;42429831;27710476;517921;0;468
FR;1;2022-04-02;911;1894;8196;9240;1106;7959;10233;0;28;42525646;41279150;25507913;378514;42430937;27718435;528154;0;496
FR;1;2022-04-03;206;382;1433;1058;219;1435;1249;0;1;42525852;41279532;25509346;379572;42431156;27719870;529403;0;497
FR;1;2022-04-04;4193;2597;11380;17680;1685;10772;18899;0;30;42530045;41282129;25520726;397252;42432841;27730642;548302;0;527
FR;1;2022-04-05;2260;2721;13007;31222;1704;12033;32603;0;68;42532305;41284850;25533733;428474;42434545;27742675;580905;0;595
FR;1;2022-04-06;1891;3018;12205;23952;1926;11641;25250;0;62;42534196;41287868;25545938;452426;42436471;27754316;606155;0;657
FR;1;2022-04-07;1694;2754;12357;31112;1652;11825;32187;0;68;42535890;41290622;25558295;483538;42438123;27766141;638342;0;725
FR;1;2022-04-08;1847;3711;17571;40646;2098;16500;42699;0;76;42537737;41294333;25575866;524184;42440221;27782641;681041;0;801
FR;1;2022-04-09;827;2000;8406;12504;1078;8106;13502;0;26;42538564;41296333;25584272;536688;42441299;27790747;694543;0;827
FR;1;2022-04-10;201;654;1836;1855;419;1882;2075;0;6;42538765;41296987;25586108;538543;42441718;27792629;696618;0;833
FR;1;2022-04-11;1107;2258;10973;22371;1310;10688;23479;0;68;42539872;41299245;25597081;560914;42443028;27803317;720097;0;901
FR;1;2022-04-12;1352;2677;12827;38146;1591;12316;38897;0;119;42541224;41301922;25609908;599060;42444619;27815633;758994;0;1020
FR;1;2022-04-13;1282;2894;12278;30627;1790;12008;31399;0;85;42542506;41304816;25622186;629687;42446409;27827641;790393;0;1105
FR;1;2022-04-14;1232;2596;12118;33657;1599;12132;34094;0;87;42543738;41307412;25634304;663344;42448008;27839773;824487;0;1192
FR;1;2022-04-15;1503;3305;14409;33269;2121;13813;34672;0;107;42545241;41310717;25648713;696613;42450129;27853586;859159;0;1299
FR;1;2022-04-16;662;1410;5845;8003;767;5777;8757;0;31;42545903;41312127;25654558;704616;42450896;27859363;867916;0;1330
FR;1;2022-04-17;157;290;930;1121;177;975;1171;0;7;42546060;41312417;25655488;705737;42451073;27860338;869087;0;1337
FR;1;2022-04-18;169;484;2636;1002;299;2660;1187;0;5;42546229;41312901;25658124;706739;42451372;27862998;870274;0;1342
FR;1;2022-04-19;1259;2610;11788;27936;1500;11519;28791;0;69;42547488;41315511;25669912;734675;42452872;27874517;899065;0;1411
FR;1;2022-04-20;1359;2674;12180;26885;1678;12032;27710;0;82;42548847;41318185;25682092;761560;42454550;27886549;926775;0;1493
FR;1;2022-04-21;1244;2463;11553;33284;1511;11785;33621;0;107;42550091;41320648;25693645;794844;42456061;27898334;960396;0;1600
FR;1;2022-04-22;1527;3093;15217;35506;1927;14795;36704;0;120;42551618;41323741;25708862;830350;42457988;27913129;997100;0;1720
FR;1;2022-04-23;767;1588;6738;9894;925;6644;10578;0;30;42552385;41325329;25715600;840244;42458913;27919773;1007678;0;1750
FR;1;2022-04-24;196;378;1376;1523;242;1329;1748;0;7;42552581;41325707;25716976;841767;42459155;27921102;1009426;0;1757
FR;1;2022-04-25;1041;2132;9857;19735;1255;9757;20557;0;64;42553622;41327839;25726833;861502;42460410;27930859;1029983;0;1821
FR;1;2022-04-26;1351;2627;12608;36639;1608;12207;37227;0;163;42554973;41330466;25739441;898141;42462018;27943066;1067210;0;1984
FR;1;2022-04-27;1330;2408;10654;29290;1468;10790;29675;0;123;42556303;41332874;25750095;927431;42463486;27953856;1096885;0;2107
FR;1;2022-04-28;1284;2415;11565;34323;1521;11406;34473;0;127;42557587;41335289;25761660;961754;42465007;27965262;1131358;0;2234
FR;1;2022-04-29;1615;4296;14407;35563;3168;13859;36853;0;153;42559202;41339585;25776067;997317;42468175;27979121;1168211;0;2387
FR;1;2022-04-30;841;4267;6448;9173;3694;6292;9974;0;35;42560043;41343852;25782515;1006490;42471869;27985413;1178185;0;2422
FR;1;2022-05-01;178;288;832;951;190;826;1080;0;5;42560221;41344140;25783347;1007441;42472059;27986239;1179265;0;2427
FR;1;2022-05-02;2084;2617;10380;16953;1772;10305;17634;0;64;42562305;41346757;25793727;1024394;42473831;27996544;1196899;0;2491
FR;1;2022-05-03;1685;2879;12712;32915;1762;12604;33714;0;149;42563990;41349636;25806439;1057309;42475593;28009148;1230613;0;2640
FR;1;2022-05-04;1381;2746;11234;23826;1691;11394;24365;0;96;42565371;41352382;25817673;1081135;42477284;28020542;1254978;0;2736
FR;1;2022-05-05;1497;2735;12200;31862;1719;12123;32410;0;170;42566868;41355117;25829873;1112997;42479003;28032665;1287388;0;2906
FR;1;2022-05-06;1822;3238;14241;34940;1915;13825;36202;0;166;42568690;41358355;25844114;1147937;42480918;28046490;1323590;0;3072
FR;1;2022-05-07;860;1473;5979;9097;878;6013;9731;0;44;42569550;41359828;25850093;1157034;42481796;28052503;1333321;0;3116
FR;1;2022-05-08;190;329;1062;1472;221;1124;1548;0;8;42569740;41360157;25851155;1158506;42482017;28053627;1334869;0;3124
FR;1;2022-05-09;1167;2019;9251;19262;1159;9165;20035;0;93;42570907;41362176;25860406;1177768;42483176;28062792;1354904;0;3217
FR;1;2022-05-10;1510;3050;12616;37145;1961;12215;38043;0;177;42572417;41365226;25873022;1214913;42485137;28075007;1392947;0;3394
FR;1;2022-05-11;1440;2477;9912;26042;1695;9860;26559;0;138;42573857;41367703;25882934;1240955;42486832;28084867;1419506;0;3532
FR;1;2022-05-12;1325;2455;10526;33632;1546;10229;34275;0;188;42575182;41370158;25893460;1274587;42488378;28095096;1453781;0;3720
FR;1;2022-05-13;1618;2806;12770;35855;1684;12418;36950;0;149;42576800;41372964;25906230;1310442;42490062;28107514;1490731;0;3869
FR;1;2022-05-14;782;1324;5481;10217;809;5365;10732;0;51;42577582;41374288;25911711;1320659;42490871;28112879;1501463;0;3920
FR;1;2022-05-15;223;422;1182;1352;246;1252;1497;0;5;42577805;41374710;25912893;1322011;42491117;28114131;1502960;0;3925
FR;1;2022-05-16;971;1787;8079;20137;1005;8143;20550;0;117;42578776;41376497;25920972;1342148;42492122;28122274;1523510;0;4042
FR;1;2022-05-17;1296;2303;11125;36187;1386;10729;36973;0;172;42580072;41378800;25932097;1378335;42493508;28133003;1560483;0;4214
FR;1;2022-05-18;1312;2135;9041;25730;1367;8991;26289;0;99;42581384;41380935;25941138;1404065;42494875;28141994;1586772;0;4313
FR;1;2022-05-19;1204;2404;9856;33999;1413;9951;34202;0;150;42582588;41383339;25950994;1438064;42496288;28151945;1620974;0;4463
FR;1;2022-05-20;1563;2757;12532;37655;1720;12113;38515;0;151;42584151;41386096;25963526;1475719;42498008;28164058;1659489;0;4614
FR;1;2022-05-21;775;1387;5247;9374;879;5164;9944;0;37;42584926;41387483;25968773;1485093;42498887;28169222;1669433;0;4651
FR;1;2022-05-22;194;292;953;1397;204;952;1520;0;10;42585120;41387775;25969726;1486490;42499091;28170174;1670953;0;4661
FR;1;2022-05-23;972;1890;8372;19437;1177;8349;20054;0;79;42586092;41389665;25978098;1505927;42500268;28178523;1691007;0;4740
FR;1;2022-05-24;1288;2449;10727;37251;1441;10597;37824;0;173;42587380;41392114;25988825;1543178;42501709;28189120;1728831;0;4913
FR;1;2022-05-25;1272;2299;8793;23693;1424;8957;24055;0;111;42588652;41394413;25997618;1566871;42503133;28198077;1752886;0;5024
FR;1;2022-05-26;175;385;1584;1155;261;1579;1288;0;24;42588827;41394798;25999202;1568026;42503394;28199656;1754174;0;5048
FR;1;2022-05-27;1120;2192;8789;20457;1377;8537;21410;0;84;42589947;41396990;26007991;1588483;42504771;28208193;1775584;0;5132
FR;1;2022-05-28;486;1059;3692;6543;627;3729;6930;0;37;42590433;41398049;26011683;1595026;42505398;28211922;1782514;0;5169
FR;1;2022-05-29;121;257;707;896;149;718;1005;0;4;42590554;41398306;26012390;1595922;42505547;28212640;1783519;0;5173
FR;1;2022-05-30;832;1743;6559;18536;1044;6592;18990;0;85;42591386;41400049;26018949;1614458;42506591;28219232;1802509;0;5258
FR;1;2022-05-31;1266;2239;9248;34376;1370;9118;34976;0;159;42592652;41402288;26028197;1648834;42507961;28228350;1837485;0;5417
FR;1;2022-06-01;1332;2603;10439;23460;1750;10302;24307;0;116;42593984;41404891;26038636;1672294;42509711;28238652;1861792;0;5533
FR;1;2022-06-02;1228;2309;10663;34153;1447;10241;34986;0;162;42595212;41407200;26049299;1706447;42511158;28248893;1896778;0;5695
FR;1;2022-06-03;1446;2746;12736;37111;1737;12157;38287;0;157;42596658;41409946;26062035;1743558;42512895;28261050;1935065;0;5852
FR;1;2022-06-04;686;1262;4750;8677;759;4826;9167;0;62;42597344;41411208;26066785;1752235;42513654;28265876;1944232;0;5914
FR;1;2022-06-05;134;292;810;1049;150;834;1154;0;3;42597478;41411500;26067595;1753284;42513804;28266710;1945386;0;5917
FR;1;2022-06-06;822;1196;2028;1252;1018;2047;1427;0;9;42598300;41412696;26069623;1754536;42514822;28268757;1946813;0;5926
FR;1;2022-06-07;1262;2343;9184;34055;1439;8844;35154;0;143;42599562;41415039;26078807;1788591;42516261;28277601;1981967;0;6069
FR;1;2022-06-08;1138;2238;8681;27613;1401;8565;28484;0;107;42600700;41417277;26087488;1816204;42517662;28286166;2010451;0;6176
FR;1;2022-06-09;1075;2151;9984;37570;1282;9669;38337;0;148;42601775;41419428;26097472;1853774;42518944;28295835;2048788;0;6324
FR;1;2022-06-10;1336;2859;12423;43134;1823;12014;44363;0;200;42603111;41422287;26109895;1896908;42520767;28307849;2093151;0;6524
FR;1;2022-06-11;661;1450;5136;11085;797;5185;11614;0;50;42603772;41423737;26115031;1907993;42521564;28313034;2104765;0;6574
FR;1;2022-06-12;156;377;1019;1687;189;1076;1789;0;11;42603928;41424114;26116050;1909680;42521753;28314110;2106554;0;6585
FR;1;2022-06-13;946;1840;7014;22226;1135;6871;23067;0;84;42604874;41425954;26123064;1931906;42522888;28320981;2129621;0;6669
FR;1;2022-06-14;1117;2232;9840;42851;1311;9243;43943;0;186;42605991;41428186;26132904;1974757;42524199;28330224;2173564;0;6855
FR;1;2022-06-15;1093;2010;8786;29393;1361;8474;29941;0;169;42607084;41430196;26141690;2004150;42525560;28338698;2203505;0;7024
FR;1;2022-06-16;959;1840;9403;38509;1061;8881;39416;0;188;42608043;41432036;26151093;2042659;42526621;28347579;2242921;0;7212
FR;1;2022-06-17;1227;2568;11915;44864;1483;11381;46004;0;224;42609270;41434604;26163008;2087523;42528104;28358960;2288925;0;7436
FR;1;2022-06-18;563;1277;4319;10544;717;4258;11086;0;62;42609833;41435881;26167327;2098067;42528821;28363218;2300011;0;7498
FR;1;2022-06-19;137;325;1003;1543;173;1082;1609;0;12;42609970;41436206;26168330;2099610;42528994;28364300;2301620;0;7510
FR;1;2022-06-20;861;1706;8493;25049;1005;8157;25910;0;146;42610831;41437912;26176823;2124659;42529999;28372457;2327530;0;7656
FR;1;2022-06-21;1102;2139;9764;47759;1256;8855;49103;0;241;42611933;41440051;26186587;2172418;42531255;28381312;2376633;0;7897
FR;1;2022-06-22;1045;2069;8442;37161;1296;7963;38021;0;231;42612978;41442120;26195029;2209579;42532551;28389275;2414654;0;8128
FR;1;2022-06-23;1054;2180;10124;52816;1209;9408;53825;0;290;42614032;41444300;26205153;2262395;42533760;28398683;2468479;0;8418
FR;1;2022-06-24;1256;2719;12916;65969;1487;11700;67641;0;367;42615288;41447019;26218069;2328364;42535247;28410383;2536120;0;8785
FR;1;2022-06-25;685;1506;5931;18922;792;5713;19721;0;163;42615973;41448525;26224000;2347286;42536039;28416096;2555841;0;8948
FR;1;2022-06-26;167;406;1817;3494;191;1713;3730;0;34;42616140;41448931;26225817;2350780;42536230;28417809;2559571;0;8982
FR;1;2022-06-27;944;1777;9901;45979;942;9127;47114;0;300;42617084;41450708;26235718;2396759;42537172;28426936;2606685;0;9282
FR;1;2022-06-28;1215;2576;13844;86572;1381;12406;88261;0;569;42618299;41453284;26249562;2483331;42538553;28439342;2694946;0;9851
FR;1;2022-06-29;1242;2295;11481;67400;1259;10548;68447;0;487;42619541;41455579;26261043;2550731;42539812;28449890;2763393;0;10338
FR;1;2022-06-30;1290;2484;13518;89971;1435;11828;91769;0;645;42620831;41458063;26274561;2640702;42541247;28461718;2855162;0;10983
FR;1;2022-07-01;1658;3481;20315;109200;1991;17971;111596;0;859;42622489;41461544;26294876;2749902;42543238;28479689;2966758;0;11842
FR;1;2022-07-02;770;1527;8024;33775;751;7253;34802;0;315;42623259;41463071;26302900;2783677;42543989;28486942;3001560;0;12157
FR;1;2022-07-03;229;480;1943;6118;257;1759;6444;0;71;42623488;41463551;26304843;2789795;42544246;28488701;3008004;0;12228
FR;1;2022-07-04;1648;3177;13934;75414;2060;12360;77304;0;589;42625136;41466728;26318777;2865209;42546306;28501061;3085308;0;12817
FR;1;2022-07-05;1503;2856;17689;126369;1510;15146;128483;0;1060;42626639;41469584;26336466;2991578;42547816;28516207;3213791;0;13877
FR;1;2022-07-06;1375;2404;14888;93747;1382;12912;95183;0;815;42628014;41471988;26351354;3085325;42549198;28529119;3308974;0;14692
FR;1;2022-07-07;1442;2539;16937;119491;1407;14008;121586;0;1074;42629456;41474527;26368291;3204816;42550605;28543127;3430560;0;15766
FR;1;2022-07-08;1534;2823;19608;130003;1541;15971;132808;0;1220;42630990;41477350;26387899;3334819;42552146;28559098;3563368;0;16986
FR;1;2022-07-09;663;1281;7308;36020;699;6351;36809;0;392;42631653;41478631;26395207;3370839;42552845;28565449;3600177;0;17378
FR;1;2022-07-10;243;656;2240;6689;411;2032;7068;0;89;42631896;41479287;26397447;3377528;42553256;28567481;3607245;0;17467
FR;1;2022-07-11;1239;2243;14320;84452;1178;11942;86563;0;734;42633135;41481530;26411767;3461980;42554434;28579423;3693808;0;18201
FR;1;2022-07-12;1603;2804;19464;137424;1441;15902;139914;0;1485;42634738;41484334;26431231;3599404;42555875;28595325;3833722;0;19686
FR;1;2022-07-13;1460;2439;14790;89838;1316;12643;91523;0;1002;42636198;41486773;26446021;3689242;42557191;28607968;3925245;0;20688
FR;1;2022-07-14;162;350;1865;5290;195;1774;5437;0;74;42636360;41487123;26447886;3694532;42557386;28609742;3930682;0;20762
FR;1;2022-07-15;1266;2319;14362;80599;1206;12005;82603;0;960;42637626;41489442;26462248;3775131;42558592;28621747;4013285;0;21722
FR;1;2022-07-16;514;1063;5641;23949;555;4894;24590;0;302;42638140;41490505;26467889;3799080;42559147;28626641;4037875;0;22024
FR;1;2022-07-17;163;369;1656;4464;193;1501;4727;0;60;42638303;41490874;26469545;3803544;42559340;28628142;4042602;0;22084
FR;1;2022-07-18;975;2034;11301;59281;1145;9570;61006;0;715;42639278;41492908;26480846;3862825;42560485;28637712;4103608;0;22799
FR;1;2022-07-19;1233;2131;14694;99429;1195;11726;101426;0;1386;42640511;41495039;26495540;3962254;42561680;28649438;4205034;0;24185
FR;1;2022-07-20;1183;2007;12372;74374;1174;10283;75859;0;964;42641694;41497046;26507912;4036628;42562854;28659721;4280893;0;25149
FR;1;2022-07-21;1136;1954;12417;84546;1188;9993;85911;0;1211;42642830;41499000;26520329;4121174;42564042;28669714;4366804;0;26360
FR;1;2022-07-22;1272;2243;14102;85947;1255;11434;87686;0;1264;42644102;41501243;26534431;4207121;42565297;28681148;4454490;0;27624
FR;1;2022-07-23;548;1093;5236;21296;634;4610;21841;0;373;42644650;41502336;26539667;4228417;42565931;28685758;4476331;0;27997
FR;1;2022-07-24;148;306;1327;3700;153;1168;3925;0;65;42644798;41502642;26540994;4232117;42566084;28686926;4480256;0;28062
FR;1;2022-07-25;890;1632;9076;46123;982;7526;47496;0;680;42645688;41504274;26550070;4278240;42567066;28694452;4527752;0;28742
FR;1;2022-07-26;1136;1962;12681;81967;1119;10336;83581;0;1198;42646824;41506236;26562751;4360207;42568185;28704788;4611333;0;29940
FR;1;2022-07-27;1021;1730;9760;58521;1046;8139;59702;0;874;42647845;41507966;26572511;4418728;42569231;28712927;4671035;0;30814
FR;1;2022-07-28;982;1705;9857;61908;1113;7853;63135;0;967;42648827;41509671;26582368;4480636;42570344;28720780;4734170;0;31781
FR;1;2022-07-29;1113;1845;10460;62988;1171;8384;64302;0;1066;42649940;41511516;26592828;4543624;42571515;28729164;4798472;0;32847
FR;1;2022-07-30;395;726;3349;14491;442;2849;14851;0;279;42650335;41512242;26596177;4558115;42571957;28732013;4813323;0;33126
FR;1;2022-07-31;141;264;900;2335;159;766;2477;0;47;42650476;41512506;26597077;4560450;42572116;28732779;4815800;0;33173
FR;1;2022-08-01;863;1468;7257;28966;1083;6118;29959;0;519;42651339;41513974;26604334;4589416;42573199;28738897;4845759;0;33692
FR;1;2022-08-02;926;1486;8237;54037;999;6633;54687;0;1091;42652265;41515460;26612571;4643453;42574198;28745530;4900446;0;34783
FR;1;2022-08-03;738;1107;6156;37044;752;4938;37774;0;645;42653003;41516567;26618727;4680497;42574950;28750468;4938220;0;35428
FR;1;2022-08-04;651;1080;6262;41451;696;5057;42005;0;850;42653654;41517647;26624989;4721948;42575646;28755525;4980225;0;36278
FR;1;2022-08-05;742;1197;6766;43078;808;5436;43706;0;933;42654396;41518844;26631755;4765026;42576454;28760961;5023931;0;37211
FR;1;2022-08-06;277;462;1993;8999;302;1674;9191;0;218;42654673;41519306;26633748;4774025;42576756;28762635;5033122;0;37429
FR;1;2022-08-07;89;147;520;1557;103;436;1630;0;35;42654762;41519453;26634268;4775582;42576859;28763071;5034752;0;37464
FR;1;2022-08-08;568;1071;3806;21228;825;3140;21626;0;457;42655330;41520524;26638074;4796810;42577684;28766211;5056378;0;37921
FR;1;2022-08-09;667;1056;5682;38473;746;4557;38967;0;794;42655997;41521580;26643756;4835283;42578430;28770768;5095345;0;38715
FR;1;2022-08-10;566;1178;4434;26915;879;3635;27228;0;601;42656563;41522758;26648190;4862198;42579309;28774403;5122573;0;39316
FR;1;2022-08-11;564;917;4313;28210;629;3587;28538;0;634;42657127;41523675;26652503;4890408;42579938;28777990;5151111;0;39950
FR;1;2022-08-12;726;1040;4554;27170;717;3761;27582;0;668;42657853;41524715;26657057;4917578;42580655;28781751;5178693;0;40618
FR;1;2022-08-13;294;370;1248;5111;262;1066;5282;0;116;42658147;41525085;26658305;4922689;42580917;28782817;5183975;0;40734
FR;1;2022-08-14;67;115;277;871;96;236;941;0;24;42658214;41525200;26658582;4923560;42581013;28783053;5184916;0;40758
FR;1;2022-08-15;111;216;574;542;185;535;593;0;16;42658325;41525416;26659156;4924102;42581198;28783588;5185509;0;40774
FR;1;2022-08-16;549;953;3791;21488;712;3220;21689;0;582;42658874;41526369;26662947;4945590;42581910;28786808;5207198;0;41356
FR;1;2022-08-17;545;912;3769;22149;679;3195;22391;0;579;42659419;41527281;26666716;4967739;42582589;28790003;5229589;0;41935
FR;1;2022-08-18;562;896;3941;25451;697;3140;25673;0;630;42659981;41528177;26670657;4993190;42583286;28793143;5255262;0;42565
FR;1;2022-08-19;536;1049;4369;26547;748;3601;26855;0;732;42660517;41529226;26675026;5019737;42584034;28796744;5282117;0;43297
FR;1;2022-08-20;249;421;1290;5371;321;1107;5524;0;138;42660766;41529647;26676316;5025108;42584355;28797851;5287641;0;43435
FR;1;2022-08-21;84;112;287;990;77;253;1013;0;27;42660850;41529759;26676603;5026098;42584432;28798104;5288654;0;43462
FR;1;2022-08-22;511;899;3141;14956;673;2713;15232;0;411;42661361;41530658;26679744;5041054;42585105;28800817;5303886;0;43873
FR;1;2022-08-23;655;1063;4153;28322;747;3486;28402;0;830;42662016;41531721;26683897;5069376;42585852;28804303;5332288;0;44703
FR;1;2022-08-24;568;837;3402;19069;659;2772;19253;0;587;42662584;41532558;26687299;5088445;42586511;28807075;5351541;0;45290
FR;1;2022-08-25;566;933;3830;22919;652;3213;23148;0;655;42663150;41533491;26691129;5111364;42587163;28810288;5374689;0;45945
FR;1;2022-08-26;754;1137;4350;25157;811;3568;25532;0;745;42663904;41534628;26695479;5136521;42587974;28813856;5400221;0;46690
FR;1;2022-08-27;221;432;1324;5306;277;1191;5360;0;192;42664125;41535060;26696803;5141827;42588251;28815047;5405581;0;46882
FR;1;2022-08-28;113;147;298;899;106;280;948;0;33;42664238;41535207;26697101;5142726;42588357;28815327;5406529;0;46915
FR;1;2022-08-29;504;857;2976;14250;634;2516;14560;0;409;42664742;41536064;26700077;5156976;42588991;28817843;5421089;0;47324
FR;1;2022-08-30;744;1111;4626;27712;788;3776;28033;0;793;42665486;41537175;26704703;5184688;42589779;28821619;5449122;0;48117
FR;1;2022-08-31;586;835;3112;17238;613;2622;17500;0;483;42666072;41538010;26707815;5201926;42590392;28824241;5466622;0;48600
FR;1;2022-09-01;692;926;4333;21885;651;3693;22147;0;587;42666764;41538936;26712148;5223811;42591043;28827934;5488769;0;49187
FR;1;2022-09-02;803;1057;4885;27864;755;4082;28152;0;882;42667567;41539993;26717033;5251675;42591798;28832016;5516921;0;50069
FR;1;2022-09-03;319;509;1833;5876;348;1594;6105;0;174;42667886;41540502;26718866;5257551;42592146;28833610;5523026;0;50243
FR;1;2022-09-04;109;137;341;842;73;334;912;0;21;42667995;41540639;26719207;5258393;42592219;28833944;5523938;0;50264
FR;1;2022-09-05;687;846;3049;15698;669;2556;15981;0;499;42668682;41541485;26722256;5274091;42592888;28836500;5539919;0;50763
FR;1;2022-09-06;816;962;4571;31063;609;3711;31284;0;1002;42669498;41542447;26726827;5305154;42593497;28840211;5571203;0;51765
FR;1;2022-09-07;597;702;2921;16443;464;2424;16580;0;550;42670095;41543149;26729748;5321597;42593961;28842635;5587783;0;52315
FR;1;2022-09-08;581;793;3700;24222;540;3040;24303;0;796;42670676;41543942;26733448;5345819;42594501;28845675;5612086;0;53111
FR;1;2022-09-09;777;975;4308;26897;615;3597;27079;0;902;42671453;41544917;26737756;5372716;42595116;28849272;5639165;0;54013
FR;1;2022-09-10;346;565;1679;5589;395;1479;5781;0;203;42671799;41545482;26739435;5378305;42595511;28850751;5644946;0;54216
FR;1;2022-09-11;106;120;313;646;82;293;703;0;17;42671905;41545602;26739748;5378951;42595593;28851044;5645649;0;54233
FR;1;2022-09-12;480;606;2616;12954;427;2233;13234;0;462;42672385;41546208;26742364;5391905;42596020;28853277;5658883;0;54695
FR;1;2022-09-13;629;827;3868;25845;538;3382;25719;0;834;42673014;41547035;26746232;5417750;42596558;28856659;5684602;0;55529
FR;1;2022-09-14;617;722;2881;15695;506;2412;15931;0;537;42673631;41547757;26749113;5433445;42597064;28859071;5700533;0;56066
FR;1;2022-09-15;531;770;3342;23091;543;2847;23155;0;679;42674162;41548527;26752455;5456536;42597607;28861918;5723688;0;56745
FR;1;2022-09-16;725;944;4017;25347;628;3390;25548;0;891;42674887;41549471;26756472;5481883;42598235;28865308;5749236;0;57636
FR;1;2022-09-17;300;427;1397;5979;298;1222;6087;0;227;42675187;41549898;26757869;5487862;42598533;28866530;5755323;0;57863
FR;1;2022-09-18;99;126;310;923;103;278;979;0;33;42675286;41550024;26758179;5488785;42598636;28866808;5756302;0;57896
FR;1;2022-09-19;400;577;2140;12863;379;1835;13017;0;414;42675686;41550601;26760319;5501648;42599015;28868643;5769319;0;58310
FR;1;2022-09-20;563;834;3667;25830;582;3064;25870;0;854;42676249;41551435;26763986;5527478;42599597;28871707;5795189;0;59164
FR;1;2022-09-21;481;689;2628;15863;489;2256;15827;0;561;42676730;41552124;26766614;5543341;42600086;28873963;5811016;0;59725
FR;1;2022-09-22;546;772;3294;22967;511;2693;23155;0;744;42677276;41552896;26769908;5566308;42600597;28876656;5834171;0;60469
FR;1;2022-09-23;767;944;4353;28154;678;3633;28318;0;981;42678043;41553840;26774261;5594462;42601275;28880289;5862489;0;61450
FR;1;2022-09-24;353;539;1587;6694;379;1370;6867;0;300;42678396;41554379;26775848;5601156;42601654;28881659;5869356;0;61750
FR;1;2022-09-25;81;157;321;1072;110;293;1110;0;32;42678477;41554536;26776169;5602228;42601764;28881952;5870466;0;61782
FR;1;2022-09-26;383;652;2182;13073;429;1935;13167;0;412;42678860;41555188;26778351;5615301;42602193;28883887;5883633;0;62194
FR;1;2022-09-27;542;767;3458;25025;541;2794;25223;0;906;42679402;41555955;26781809;5640326;42602734;28886681;5908856;0;63100
FR;1;2022-09-28;525;720;2448;14971;507;2217;15060;0;597;42679927;41556675;26784257;5655297;42603241;28888898;5923916;0;63697
FR;1;2022-09-29;504;697;2997;20365;487;2522;20379;0;767;42680431;41557372;26787254;5675662;42603728;28891420;5944295;0;64464
FR;1;2022-09-30;694;992;3776;24429;699;3160;24677;0;970;42681125;41558364;26791030;5700091;42604427;28894580;5968972;0;65434
FR;1;2022-10-01;352;550;1904;5507;386;1658;5733;0;273;42681477;41558914;26792934;5705598;42604813;28896238;5974705;0;65707
FR;1;2022-10-02;56;120;204;568;82;204;589;0;29;42681533;41559034;26793138;5706166;42604895;28896442;5975294;0;65736
FR;1;2022-10-03;504;827;2225;10042;671;1985;10210;0;489;42682037;41559861;26795363;5716208;42605566;28898427;5985504;0;66225
FR;1;2022-10-04;596;736;2930;18922;504;2481;19010;0;1084;42682633;41560597;26798293;5735130;42606070;28900908;6004514;0;67309
FR;1;2022-10-05;459;725;2097;11113;498;1870;11242;0;723;42683092;41561322;26800390;5746243;42606568;28902778;6015756;0;68032
FR;1;2022-10-06;446;642;2496;15777;465;2061;15959;0;1062;42683538;41561964;26802886;5762020;42607033;28904839;6031715;0;69094
FR;1;2022-10-07;556;768;2693;16068;567;2310;16092;0;1161;42684094;41562732;26805579;5778088;42607600;28907149;6047807;0;70255
FR;1;2022-10-08;237;314;888;3171;247;776;3276;0;291;42684331;41563046;26806467;5781259;42607847;28907925;6051083;0;70546
FR;1;2022-10-09;76;87;151;461;77;135;487;0;51;42684407;41563133;26806618;5781720;42607924;28908060;6051570;0;70597
FR;1;2022-10-10;307;537;1323;4999;444;1240;5095;0;463;42684714;41563670;26807941;5786719;42608368;28909300;6056665;0;71060
FR;1;2022-10-11;324;454;1315;8086;339;1197;8187;0;757;42685038;41564124;26809256;5794805;42608707;28910497;6064852;0;71817
FR;1;2022-10-12;336;477;1076;5221;364;1073;5238;0;521;42685374;41564601;26810332;5800026;42609071;28911570;6070090;0;72338
FR;1;2022-10-13;331;445;1078;6099;354;935;6146;0;629;42685705;41565046;26811410;5806125;42609425;28912505;6076236;0;72967
FR;1;2022-10-14;410;549;1174;6710;464;1048;6778;0;676;42686115;41565595;26812584;5812835;42609889;28913553;6083014;0;73643
FR;1;2022-10-15;210;332;531;1860;284;514;1868;0;226;42686325;41565927;26813115;5814695;42610173;28914067;6084882;0;73869
FR;1;2022-10-16;47;66;111;296;47;118;315;0;48;42686372;41565993;26813226;5814991;42610220;28914185;6085197;0;73917
FR;1;2022-10-17;236;333;740;2653;265;696;2698;0;366;42686608;41566326;26813966;5817644;42610485;28914881;6087895;0;74283
FR;1;2022-10-18;263;319;954;4596;255;833;4698;0;866;42686871;41566645;26814920;5822240;42610740;28915714;6092593;0;75149
FR;1;2022-10-19;285;404;696;3185;337;665;3164;0;502;42687156;41567049;26815616;5825425;42611077;28916379;6095757;0;75651
FR;1;2022-10-20;286;349;902;4369;295;794;4404;0;771;42687442;41567398;26816518;5829794;42611372;28917173;6100161;0;76422
FR;1;2022-10-21;304;419;847;3806;370;743;3878;0;675;42687746;41567817;26817365;5833600;42611742;28917916;6104039;0;77097
FR;1;2022-10-22;135;183;306;1253;161;300;1218;0;210;42687881;41568000;26817671;5834853;42611903;28918216;6105257;0;77307
FR;1;2022-10-23;32;43;65;197;41;59;213;0;25;42687913;41568043;26817736;5835050;42611944;28918275;6105470;0;77332
FR;1;2022-10-24;272;236;479;1603;204;476;1660;0;306;42688185;41568279;26818215;5836653;42612148;28918751;6107130;0;77638
FR;1;2022-10-25;222;258;526;2651;227;447;2707;0;487;42688407;41568537;26818741;5839304;42612375;28919198;6109837;0;78125
FR;1;2022-10-26;235;249;393;1958;237;370;1965;0;438;42688642;41568786;26819134;5841262;42612612;28919568;6111802;0;78563
FR;1;2022-10-27;260;231;490;2167;203;509;2151;0;518;42688902;41569017;26819624;5843429;42612815;28920077;6113953;0;79081
FR;1;2022-10-28;312;329;533;2335;308;470;2402;0;478;42689214;41569346;26820157;5845764;42613123;28920547;6116355;0;79559
FR;1;2022-10-29;99;151;176;712;121;210;703;0;203;42689313;41569497;26820333;5846476;42613244;28920757;6117058;0;79762
FR;1;2022-10-30;38;46;62;184;38;56;189;0;38;42689351;41569543;26820395;5846660;42613282;28920813;6117247;0;79800
FR;1;2022-10-31;136;186;295;796;165;273;863;0;143;42689487;41569729;26820690;5847456;42613447;28921086;6118110;0;79943
FR;1;2022-11-01;54;131;767;115;113;767;134;0;19;42689541;41569860;26821457;5847571;42613560;28921853;6118244;0;79962
FR;1;2022-11-02;265;241;529;984;237;495;1047;0;356;42689806;41570101;26821986;5848555;42613797;28922348;6119291;0;80318
FR;1;2022-11-03;271;236;442;1379;221;403;1418;0;377;42690077;41570337;26822428;5849934;42614018;28922751;6120709;0;80695
FR;1;2022-11-04;232;261;424;1597;241;401;1637;0;438;42690309;41570598;26822852;5851531;42614259;28923152;6122346;0;81133
FR;1;2022-11-05;100;123;272;503;112;254;525;0;111;42690409;41570721;26823124;5852034;42614371;28923406;6122871;0;81244
FR;1;2022-11-06;36;46;32;131;45;35;129;0;33;42690445;41570767;26823156;5852165;42614416;28923441;6123000;0;81277
FR;1;2022-11-07;200;249;322;893;236;314;939;0;211;42690645;41571016;26823478;5853058;42614652;28923755;6123939;0;81488
FR;1;2022-11-08;209;255;471;1688;243;416;1717;0;524;42690854;41571271;26823949;5854746;42614895;28924171;6125656;0;82012
FR;1;2022-11-09;187;242;335;1104;230;301;1141;0;477;42691041;41571513;26824284;5855850;42615125;28924472;6126797;0;82489
FR;1;2022-11-10;213;324;432;1680;315;441;1668;0;605;42691254;41571837;26824716;5857530;42615440;28924913;6128465;0;83094
FR;1;2022-11-11;31;43;105;100;41;91;114;0;44;42691285;41571880;26824821;5857630;42615481;28925004;6128579;0;83138
FR;1;2022-11-12;93;146;257;375;133;256;390;0;101;42691378;41572026;26825078;5858005;42615614;28925260;6128969;0;83239
FR;1;2022-11-13;23;56;28;64;53;31;66;0;26;42691401;41572082;26825106;5858069;42615667;28925291;6129035;0;83265
FR;1;2022-11-14;171;183;264;768;171;268;838;0;235;42691572;41572265;26825370;5858837;42615838;28925559;6129873;0;83500
FR;1;2022-11-15;220;374;390;1299;373;368;1337;0;436;42691792;41572639;26825760;5860136;42616211;28925927;6131210;0;83936
FR;1;2022-11-16;191;256;335;983;250;349;1017;0;359;42691983;41572895;26826095;5861119;42616461;28926276;6132227;0;84295
FR;1;2022-11-17;168;203;296;1207;197;272;1211;0;387;42692151;41573098;26826391;5862326;42616658;28926548;6133438;0;84682
FR;1;2022-11-18;228;266;393;1314;258;382;1348;0;411;42692379;41573364;26826784;5863640;42616916;28926930;6134786;0;85093
FR;1;2022-11-19;120;114;248;441;113;213;474;0;102;42692499;41573478;26827032;5864081;42617029;28927143;6135260;0;85195
FR;1;2022-11-20;35;120;31;66;116;33;74;0;28;42692534;41573598;26827063;5864147;42617145;28927176;6135334;0;85223
FR;1;2022-11-21;175;170;270;640;143;286;677;0;211;42692709;41573768;26827333;5864787;42617288;28927462;6136011;0;85434
FR;1;2022-11-22;155;168;412;1155;151;396;1177;0;406;42692864;41573936;26827745;5865942;42617439;28927858;6137188;0;85840
FR;1;2022-11-23;178;182;245;762;166;246;785;0;241;42693042;41574118;26827990;5866704;42617605;28928104;6137973;0;86081
FR;1;2022-11-24;136;167;287;1203;148;299;1207;0;440;42693178;41574285;26828277;5867907;42617753;28928403;6139180;0;86521
FR;1;2022-11-25;208;241;426;1154;227;415;1186;0;392;42693386;41574526;26828703;5869061;42617980;28928818;6140366;0;86913
FR;1;2022-11-26;90;109;113;323;101;125;311;0;118;42693476;41574635;26828816;5869384;42618081;28928943;6140677;0;87031
FR;1;2022-11-27;21;37;19;72;27;31;78;0;49;42693497;41574672;26828835;5869456;42618108;28928974;6140755;0;87080
FR;1;2022-11-28;210;145;208;665;152;204;708;0;332;42693707;41574817;26829043;5870121;42618260;28929178;6141463;0;87412
FR;1;2022-11-29;171;141;269;1107;126;251;1119;0;458;42693878;41574958;26829312;5871228;42618386;28929429;6142582;0;87870
FR;1;2022-11-30;161;201;233;938;187;236;960;0;322;42694039;41575159;26829545;5872166;42618573;28929665;6143542;0;88192
FR;1;2022-12-01;163;157;713;1091;145;679;1139;0;379;42694202;41575316;26830258;5873257;42618718;28930344;6144681;0;88571
FR;1;2022-12-02;200;199;516;1185;194;512;1233;0;470;42694402;41575515;26830774;5874442;42618912;28930856;6145914;0;89041
FR;1;2022-12-03;102;108;261;532;96;239;529;0;180;42694504;41575623;26831035;5874974;42619008;28931095;6146443;0;89221
FR;1;2022-12-04;26;27;19;138;24;20;129;0;58;42694530;41575650;26831054;5875112;42619032;28931115;6146572;0;89279
FR;1;2022-12-05;143;149;300;867;146;294;899;0;316;42694673;41575799;26831354;5875979;42619178;28931409;6147471;0;89595
FR;1;2022-12-06;153;150;272;1448;137;276;1454;0;739;42694826;41575949;26831626;5877427;42619315;28931685;6148925;0;90334
FR;1;2022-12-07;154;157;250;1187;166;230;1203;0;576;42694980;41576106;26831876;5878614;42619481;28931915;6150128;0;90910
FR;1;2022-12-08;129;140;301;1756;132;258;1797;0;765;42695109;41576246;26832177;5880370;42619613;28932173;6151925;0;91675
FR;1;2022-12-09;202;195;352;1815;168;361;1835;0;721;42695311;41576441;26832529;5882185;42619781;28932534;6153760;0;92396
FR;1;2022-12-10;116;107;341;856;94;324;877;0;292;42695427;41576548;26832870;5883041;42619875;28932858;6154637;0;92688
FR;1;2022-12-11;31;30;32;218;27;30;200;0;62;42695458;41576578;26832902;5883259;42619902;28932888;6154837;0;92750
FR;1;2022-12-12;127;101;293;1099;97;281;1111;0;457;42695585;41576679;26833195;5884358;42619999;28933169;6155948;0;93207
FR;1;2022-12-13;122;122;288;1297;96;264;1310;0;618;42695707;41576801;26833483;5885655;42620095;28933433;6157258;0;93825
FR;1;2022-12-14;105;144;253;866;138;232;891;0;370;42695812;41576945;26833736;5886521;42620233;28933665;6158149;0;94195
FR;1;2022-12-15;137;161;448;1489;149;418;1515;0;692;42695949;41577106;26834184;5888010;42620382;28934083;6159664;0;94887
FR;1;2022-12-16;205;213;566;1342;217;550;1364;0;623;42696154;41577319;26834750;5889352;42620599;28934633;6161028;0;95510
FR;1;2022-12-17;88;91;223;467;80;218;475;0;204;42696242;41577410;26834973;5889819;42620679;28934851;6161503;0;95714
FR;1;2022-12-18;17;22;26;111;19;28;107;0;37;42696259;41577432;26834999;5889930;42620698;28934879;6161610;0;95751
FR;1;2022-12-19;151;128;248;791;136;219;834;0;381;42696410;41577560;26835247;5890721;42620834;28935098;6162444;0;96132
FR;1;2022-12-20;143;160;352;905;147;346;911;0;426;42696553;41577720;26835599;5891626;42620981;28935444;6163355;0;96558
FR;1;2022-12-21;136;106;213;638;116;179;646;0;388;42696689;41577826;26835812;5892264;42621097;28935623;6164001;0;96946
FR;1;2022-12-22;146;108;165;552;117;150;542;0;326;42696835;41577934;26835977;5892816;42621214;28935773;6164543;0;97272
FR;1;2022-12-23;128;153;453;419;136;444;425;0;182;42696963;41578087;26836430;5893235;42621350;28936217;6164968;0;97454
FR;1;2022-12-24;30;27;33;56;30;32;63;0;21;42696993;41578114;26836463;5893291;42621380;28936249;6165031;0;97475
FR;1;2022-12-25;4;10;20;12;11;14;15;0;11;42696997;41578124;26836483;5893303;42621391;28936263;6165046;0;97486
FR;1;2022-12-26;94;90;248;251;89;253;257;0;93;42697091;41578214;26836731;5893554;42621480;28936516;6165303;0;97579
FR;1;2022-12-27;117;159;309;387;150;315;402;0;180;42697208;41578373;26837040;5893941;42621630;28936831;6165705;0;97759
FR;1;2022-12-28;105;142;202;270;128;204;281;0;126;42697313;41578515;26837242;5894211;42621758;28937035;6165986;0;97885
FR;1;2022-12-29;105;102;154;282;102;153;303;0;114;42697418;41578617;26837396;5894493;42621860;28937188;6166289;0;97999
FR;1;2022-12-30;122;122;86;258;111;91;268;0;143;42697540;41578739;26837482;5894751;42621971;28937279;6166557;0;98142
FR;1;2022-12-31;38;34;28;74;39;25;74;0;25;42697578;41578773;26837510;5894825;42622010;28937304;6166631;0;98167
FR;1;2023-01-01;6;11;61;21;11;57;26;0;10;42697584;41578784;26837571;5894846;42622021;28937361;6166657;0;98177
FR;1;2023-01-02;91;112;664;169;119;645;191;0;64;42697675;41578896;26838235;5895015;42622140;28938006;6166848;0;98241
FR;1;2023-01-03;161;93;363;205;91;357;212;0;146;42697836;41578989;26838598;5895220;42622231;28938363;6167060;0;98387
FR;1;2023-01-04;92;85;244;198;86;245;208;0;192;42697928;41579074;26838842;5895418;42622317;28938608;6167268;0;98579
FR;1;2023-01-05;143;109;170;334;120;170;335;0;206;42698071;41579183;26839012;5895752;42622437;28938778;6167603;0;98785
FR;1;2023-01-06;197;139;222;325;142;208;350;0;230;42698268;41579322;26839234;5896077;42622579;28938986;6167953;0;99015
FR;1;2023-01-07;105;88;175;147;91;158;164;0;92;42698373;41579410;26839409;5896224;42622670;28939144;6168117;0;99107
FR;1;2023-01-08;26;18;29;59;17;25;63;0;24;42698399;41579428;26839438;5896283;42622687;28939169;6168180;0;99131
FR;1;2023-01-09;138;121;133;135;117;141;153;0;115;42698537;41579549;26839571;5896418;42622804;28939310;6168333;0;99246
FR;1;2023-01-10;115;115;271;263;115;275;264;0;192;42698652;41579664;26839842;5896681;42622919;28939585;6168597;0;99438
FR;1;2023-01-11;104;100;85;191;108;91;201;0;96;42698756;41579764;26839927;5896872;42623027;28939676;6168798;0;99534
FR;1;2023-01-12;122;109;210;240;104;210;265;0;166;42698878;41579873;26840137;5897112;42623131;28939886;6169063;0;99700
FR;1;2023-01-13;195;145;166;285;144;165;306;0;188;42699073;41580018;26840303;5897397;42623275;28940051;6169369;0;99888
FR;1;2023-01-14;89;63;161;104;65;171;103;0;62;42699162;41580081;26840464;5897501;42623340;28940222;6169472;0;99950
FR;1;2023-01-15;23;23;31;41;21;30;45;0;29;42699185;41580104;26840495;5897542;42623361;28940252;6169517;0;99979
FR;1;2023-01-16;111;102;310;155;96;314;133;0;100;42699296;41580206;26840805;5897697;42623457;28940566;6169650;0;100079
FR;1;2023-01-17;113;97;160;212;96;158;238;0;128;42699409;41580303;26840965;5897909;42623553;28940724;6169888;0;100207
FR;1;2023-01-18;99;87;93;143;86;89;183;0;121;42699508;41580390;26841058;5898052;42623639;28940813;6170071;0;100328
FR;1;2023-01-19;113;78;98;130;77;110;130;0;135;42699621;41580468;26841156;5898182;42623716;28940923;6170201;0;100463
FR;1;2023-01-20;166;141;161;272;142;189;261;0;201;42699787;41580609;26841317;5898454;42623858;28941112;6170462;0;100664
FR;1;2023-01-21;58;70;91;84;70;102;74;0;35;42699845;41580679;26841408;5898538;42623928;28941214;6170536;0;100699
FR;1;2023-01-22;10;8;12;21;6;8;25;0;14;42699855;41580687;26841420;5898559;42623934;28941222;6170561;0;100713
FR;1;2023-01-23;87;83;107;96;86;99;115;0;85;42699942;41580770;26841527;5898655;42624020;28941321;6170676;0;100798
FR;1;2023-01-24;121;74;71;122;87;69;131;0;183;42700063;41580844;26841598;5898777;42624107;28941390;6170807;0;100981
FR;1;2023-01-25;98;118;77;104;117;77;119;0;106;42700161;41580962;26841675;5898881;42624224;28941467;6170926;0;101087
FR;1;2023-01-26;105;104;61;152;93;66;173;0;107;42700266;41581066;26841736;5899033;42624317;28941533;6171099;0;101194
FR;1;2023-01-27;171;134;104;135;150;121;135;0;199;42700437;41581200;26841840;5899168;42624467;28941654;6171234;0;101393
FR;1;2023-01-28;73;74;55;40;77;52;48;0;28;42700510;41581274;26841895;5899208;42624544;28941706;6171282;0;101421
FR;1;2023-01-29;12;22;33;10;20;31;16;0;12;42700522;41581296;26841928;5899218;42624564;28941737;6171298;0;101433
FR;1;2023-01-30;144;107;64;72;109;70;80;0;51;42700666;41581403;26841992;5899290;42624673;28941807;6171378;0;101484
FR;1;2023-01-31;122;83;61;115;72;66;125;0;141;42700788;41581486;26842053;5899405;42624745;28941873;6171503;0;101625
FR;1;2023-02-01;117;132;338;102;130;334;127;0;77;42700905;41581618;26842391;5899507;42624875;28942207;6171630;0;101702
FR;1;2023-02-02;88;89;87;104;84;94;105;0;97;42700993;41581707;26842478;5899611;42624959;28942301;6171735;0;101799
FR;1;2023-02-03;154;142;129;98;142;135;104;0;93;42701147;41581849;26842607;5899709;42625101;28942436;6171839;0;101892
FR;1;2023-02-04;49;78;72;45;84;74;46;0;24;42701196;41581927;26842679;5899754;42625185;28942510;6171885;0;101916
FR;1;2023-02-05;6;8;18;6;7;21;7;0;8;42701202;41581935;26842697;5899760;42625192;28942531;6171892;0;101924
FR;1;2023-02-06;93;75;110;75;81;112;79;0;89;42701295;41582010;26842807;5899835;42625273;28942643;6171971;0;102013
FR;1;2023-02-07;89;75;91;74;76;86;93;0;110;42701384;41582085;26842898;5899909;42625349;28942729;6172064;0;102123
FR;1;2023-02-08;80;89;59;30;87;64;34;0;51;42701464;41582174;26842957;5899939;42625436;28942793;6172098;0;102174
FR;1;2023-02-09;64;64;76;58;74;75;66;0;79;42701528;41582238;26843033;5899997;42625510;28942868;6172164;0;102253
FR;1;2023-02-10;138;128;51;71;131;63;72;0;117;42701666;41582366;26843084;5900068;42625641;28942931;6172236;0;102370
FR;1;2023-02-11;44;49;78;25;46;87;27;0;11;42701710;41582415;26843162;5900093;42625687;28943018;6172263;0;102381
FR;1;2023-02-12;8;2;9;8;6;9;9;0;9;42701718;41582417;26843171;5900101;42625693;28943027;6172272;0;102390
FR;1;2023-02-13;76;95;37;35;97;44;32;0;31;42701794;41582512;26843208;5900136;42625790;28943071;6172304;0;102421
FR;1;2023-02-14;66;66;70;48;65;76;46;0;77;42701860;41582578;26843278;5900184;42625855;28943147;6172350;0;102498
FR;1;2023-02-15;72;92;68;52;101;73;60;0;81;42701932;41582670;26843346;5900236;42625956;28943220;6172410;0;102579
FR;1;2023-02-16;58;71;95;81;59;104;85;0;73;42701990;41582741;26843441;5900317;42626015;28943324;6172495;0;102652
FR;1;2023-02-17;101;119;156;61;123;161;69;0;46;42702091;41582860;26843597;5900378;42626138;28943485;6172564;0;102698
FR;1;2023-02-18;44;55;143;41;55;149;43;0;9;42702135;41582915;26843740;5900419;42626193;28943634;6172607;0;102707
FR;1;2023-02-19;14;0;5;4;3;4;4;0;5;42702149;41582915;26843745;5900423;42626196;28943638;6172611;0;102712
FR;1;2023-02-20;72;63;49;28;68;53;32;0;16;42702221;41582978;26843794;5900451;42626264;28943691;6172643;0;102728
FR;1;2023-02-21;63;74;54;49;78;57;47;0;38;42702284;41583052;26843848;5900500;42626342;28943748;6172690;0;102766
FR;1;2023-02-22;63;76;31;18;76;35;18;0;22;42702347;41583128;26843879;5900518;42626418;28943783;6172708;0;102788
FR;1;2023-02-23;50;77;47;33;74;57;30;0;54;42702397;41583205;26843926;5900551;42626492;28943840;6172738;0;102842
FR;1;2023-02-24;92;109;33;33;110;41;34;0;37;42702489;41583314;26843959;5900584;42626602;28943881;6172772;0;102879
FR;1;2023-02-25;40;47;67;22;54;67;24;0;25;42702529;41583361;26844026;5900606;42626656;28943948;6172796;0;102904
FR;1;2023-02-26;2;3;1;2;1;3;1;0;3;42702531;41583364;26844027;5900608;42626657;28943951;6172797;0;102907
FR;1;2023-02-27;86;75;58;34;75;66;32;0;19;42702617;41583439;26844085;5900642;42626732;28944017;6172829;0;102926
FR;1;2023-02-28;82;68;32;49;65;41;51;0;32;42702699;41583507;26844117;5900691;42626797;28944058;6172880;0;102958
FR;1;2023-03-01;65;78;176;51;77;172;64;0;42;42702764;41583585;26844293;5900742;42626874;28944230;6172944;0;103000
FR;1;2023-03-02;61;57;73;44;59;69;57;0;54;42702825;41583642;26844366;5900786;42626933;28944299;6173001;0;103054
FR;1;2023-03-03;96;103;51;50;102;50;53;0;44;42702921;41583745;26844417;5900836;42627035;28944349;6173054;0;103098
FR;1;2023-03-04;48;44;34;21;41;36;25;0;13;42702969;41583789;26844451;5900857;42627076;28944385;6173079;0;103111
FR;1;2023-03-05;4;2;1;0;3;1;1;0;0;42702973;41583791;26844452;5900857;42627079;28944386;6173080;0;103111
FR;1;2023-03-06;84;56;70;16;62;76;22;0;14;42703057;41583847;26844522;5900873;42627141;28944462;6173102;0;103125
FR;1;2023-03-07;51;69;37;40;66;35;50;0;71;42703108;41583916;26844559;5900913;42627207;28944497;6173152;0;103196
FR;1;2023-03-08;47;63;21;13;67;25;17;0;6;42703155;41583979;26844580;5900926;42627274;28944522;6173169;0;103202
FR;1;2023-03-09;35;51;37;21;47;40;30;0;27;42703190;41584030;26844617;5900947;42627321;28944562;6173199;0;103229
FR;1;2023-03-10;90;90;70;39;90;73;44;0;24;42703280;41584120;26844687;5900986;42627411;28944635;6173243;0;103253
FR;1;2023-03-11;45;36;17;4;30;23;7;0;6;42703325;41584156;26844704;5900990;42627441;28944658;6173250;0;103259
FR;1;2023-03-12;2;9;3;0;11;2;1;0;0;42703327;41584165;26844707;5900990;42627452;28944660;6173251;0;103259
FR;1;2023-03-13;42;49;21;14;45;29;13;0;18;42703369;41584214;26844728;5901004;42627497;28944689;6173264;0;103277
FR;1;2023-03-14;63;43;38;21;48;43;22;0;30;42703432;41584257;26844766;5901025;42627545;28944732;6173286;0;103307
FR;1;2023-03-15;39;51;29;12;51;38;12;0;19;42703471;41584308;26844795;5901037;42627596;28944770;6173298;0;103326
FR;1;2023-03-16;54;41;31;17;44;32;20;0;20;42703525;41584349;26844826;5901054;42627640;28944802;6173318;0;103346
FR;1;2023-03-17;106;79;32;22;95;33;28;0;31;42703631;41584428;26844858;5901076;42627735;28944835;6173346;0;103377
FR;1;2023-03-18;31;22;6;3;15;12;5;0;5;42703662;41584450;26844864;5901079;42627750;28944847;6173351;0;103382
FR;1;2023-03-19;6;1;0;2;2;0;3;0;0;42703668;41584451;26844864;5901081;42627752;28944847;6173354;0;103382
FR;1;2023-03-20;37;43;9;8;38;14;12;0;8;42703705;41584494;26844873;5901089;42627790;28944861;6173366;0;103390
FR;1;2023-03-21;71;50;14;10;56;17;13;0;26;42703776;41584544;26844887;5901099;42627846;28944878;6173379;0;103416
FR;1;2023-03-22;58;52;25;30;52;38;25;0;13;42703834;41584596;26844912;5901129;42627898;28944916;6173404;0;103429
FR;1;2023-03-23;55;38;20;17;41;22;18;0;33;42703889;41584634;26844932;5901146;42627939;28944938;6173422;0;103462
FR;1;2023-03-24;75;74;18;16;79;22;18;0;18;42703964;41584708;26844950;5901162;42628018;28944960;6173440;0;103480
FR;1;2023-03-25;40;38;11;7;36;14;10;0;5;42704004;41584746;26844961;5901169;42628054;28944974;6173450;0;103485
FR;1;2023-03-26;8;3;2;0;0;3;2;0;2;42704012;41584749;26844963;5901169;42628054;28944977;6173452;0;103487
FR;2;2020-12-27;0;0;0;0;0;0;0;0;0;0;0;0;0;0;0;0;0;0
FR;2;2020-12-28;0;0;0;0;0;0;0;0;0;0;0;0;0;0;0;0;0;0
FR;2;2020-12-29;0;0;0;0;0;0;0;0;0;0;0;0;0;0;0;0;0;0
FR;2;2020-12-30;0;0;0;0;0;0;0;0;0;0;0;0;0;0;0;0;0;0
FR;2;2020-12-31;0;0;0;0;0;0;0;0;0;0;0;0;0;0;0;0;0;0
FR;2;2021-01-01;0;0;0;0;0;0;0;0;0;0;0;0;0;0;0;0;0;0
FR;2;2021-01-02;0;0;0;0;0;0;0;0;0;0;0;0;0;0;0;0;0;0
FR;2;2021-01-03;0;0;0;0;0;0;0;0;0;0;0;0;0;0;0;0;0;0
FR;2;2021-01-04;0;0;0;0;0;0;0;0;0;0;0;0;0;0;0;0;0;0
FR;2;2021-01-05;0;0;0;0;0;0;0;0;0;0;0;0;0;0;0;0;0;0
FR;2;2021-01-06;0;0;0;0;0;0;0;0;0;0;0;0;0;0;0;0;0;0
FR;2;2021-01-07;0;0;0;0;0;0;0;0;0;0;0;0;0;0;0;0;0;0
FR;2;2021-01-08;0;0;0;0;0;0;0;0;0;0;0;0;0;0;0;0;0;0
FR;2;2021-01-09;0;0;0;0;0;0;0;0;0;0;0;0;0;0;0;0;0;0
FR;2;2021-01-10;0;0;0;0;0;0;0;0;0;0;0;0;0;0;0;0;0;0
FR;2;2021-01-11;0;0;0;0;0;0;0;0;0;0;0;0;0;0;0;0;0;0
FR;2;2021-01-12;0;0;0;0;0;0;0;0;0;0;0;0;0;0;0;0;0;0
FR;2;2021-01-13;0;0;0;0;0;0;0;0;0;0;0;0;0;0;0;0;0;0
FR;2;2021-01-14;1638;0;0;0;213;0;0;0;0;1638;0;0;0;213;0;0;0;0
FR;2;2021-01-15;398;0;0;0;28;0;0;0;0;2036;0;0;0;241;0;0;0;0
FR;2;2021-01-16;316;0;0;0;12;0;0;0;0;2352;0;0;0;253;0;0;0;0
FR;2;2021-01-17;84;0;0;0;7;0;0;0;0;2436;0;0;0;260;0;0;0;0
FR;2;2021-01-18;3075;3;0;0;27;0;0;0;0;5511;3;0;0;287;0;0;0;0
FR;2;2021-01-19;4681;2;0;0;31;0;0;0;0;10192;5;0;0;318;0;0;0;0
FR;2;2021-01-20;5138;6;0;0;58;0;0;0;0;15330;11;0;0;376;0;0;0;0
FR;2;2021-01-21;5345;9;0;0;55;0;0;0;0;20675;20;0;0;431;0;0;0;0
FR;2;2021-01-22;5119;19;0;0;70;0;0;0;0;25794;39;0;0;501;0;0;0;0
FR;2;2021-01-23;1875;2;0;0;16;0;0;0;0;27669;41;0;0;517;0;0;0;0
FR;2;2021-01-24;163;2;0;0;8;0;0;0;0;27832;43;0;0;525;0;0;0;0
FR;2;2021-01-25;3814;4;0;0;37;0;0;0;0;31646;47;0;0;562;0;0;0;0
FR;2;2021-01-26;3930;6;0;0;42;0;0;0;0;35576;53;0;0;604;0;0;0;0
FR;2;2021-01-27;3606;4;0;0;36;0;0;0;0;39182;57;0;0;640;0;0;0;0
FR;2;2021-01-28;3757;9;0;0;44;0;0;0;0;42939;66;0;0;684;0;0;0;0
FR;2;2021-01-29;3300;6;0;0;42;0;0;0;0;46239;72;0;0;726;0;0;0;0
FR;2;2021-01-30;1133;3;0;0;16;0;0;0;0;47372;75;0;0;742;0;0;0;0
FR;2;2021-01-31;46;2;0;0;9;0;0;0;0;47418;77;0;0;751;0;0;0;0
FR;2;2021-02-01;3408;13;0;0;44;0;0;0;0;50826;90;0;0;795;0;0;0;0
FR;2;2021-02-02;4496;19;0;0;53;0;0;0;0;55322;109;0;0;848;0;0;0;0
FR;2;2021-02-03;5223;11;0;0;82;0;0;0;0;60545;120;0;0;930;0;0;0;0
FR;2;2021-02-04;4941;11;0;0;36;0;0;0;0;65486;131;0;0;966;0;0;0;0
FR;2;2021-02-05;4817;17;0;0;50;0;0;0;0;70303;148;0;0;1016;0;0;0;0
FR;2;2021-02-06;2047;15;0;0;41;0;0;0;0;72350;163;0;0;1057;0;0;0;0
FR;2;2021-02-07;103;6;0;0;20;0;0;0;0;72453;169;0;0;1077;0;0;0;0
FR;2;2021-02-08;7559;26;0;0;85;0;0;0;0;80012;195;0;0;1162;0;0;0;0
FR;2;2021-02-09;8435;31;0;0;100;0;0;0;0;88447;226;0;0;1262;0;0;0;0
FR;2;2021-02-10;9349;63;0;0;183;0;0;0;0;97796;289;0;0;1445;0;0;0;0
FR;2;2021-02-11;10292;132;0;0;256;0;0;0;0;108088;421;0;0;1701;0;0;0;0
FR;2;2021-02-12;10059;276;0;0;430;0;0;0;0;118147;697;0;0;2131;0;0;0;0
FR;2;2021-02-13;3121;223;0;0;261;0;0;0;0;121268;920;0;0;2392;0;0;0;0
FR;2;2021-02-14;358;11;0;0;21;0;0;0;0;121626;931;0;0;2413;0;0;0;0
FR;2;2021-02-15;3460;3129;0;0;3176;0;0;0;0;125086;4060;0;0;5589;0;0;0;0
FR;2;2021-02-16;5076;4163;0;0;4236;0;0;0;0;130162;8223;0;0;9825;0;0;0;0
FR;2;2021-02-17;4259;4554;0;0;4631;0;0;0;0;134421;12777;0;0;14456;0;0;0;0
FR;2;2021-02-18;5406;5177;0;0;5247;0;0;0;0;139827;17954;0;0;19703;0;0;0;0
FR;2;2021-02-19;5329;4491;0;0;4592;0;0;0;0;145156;22445;0;0;24295;0;0;0;0
FR;2;2021-02-20;1872;1520;0;0;1537;0;0;0;0;147028;23965;0;0;25832;0;0;0;0
FR;2;2021-02-21;244;96;0;0;98;0;0;0;0;147272;24061;0;0;25930;0;0;0;0
FR;2;2021-02-22;3614;3782;0;0;3844;0;0;0;0;150886;27843;0;0;29774;0;0;0;0
FR;2;2021-02-23;4956;3740;0;0;3804;0;0;0;0;155842;31583;0;0;33578;0;0;0;0
FR;2;2021-02-24;5017;3558;0;0;3611;0;0;0;0;160859;35141;0;0;37189;0;0;0;0
FR;2;2021-02-25;5501;3495;0;0;3585;0;0;0;0;166360;38636;0;0;40774;0;0;0;0
FR;2;2021-02-26;4368;3179;0;0;3253;0;0;0;0;170728;41815;0;0;44027;0;0;0;0
FR;2;2021-02-27;1629;1067;0;0;1086;0;0;0;0;172357;42882;0;0;45113;0;0;0;0
FR;2;2021-02-28;179;17;0;0;28;0;0;0;0;172536;42899;0;0;45141;0;0;0;0
FR;2;2021-03-01;5193;3763;0;0;3852;0;0;0;0;177729;46662;0;0;48993;0;0;0;0
FR;2;2021-03-02;6542;4726;0;0;4827;0;0;0;0;184271;51388;0;0;53820;0;0;0;0
FR;2;2021-03-03;6544;4955;0;0;5096;0;0;0;0;190815;56343;0;0;58916;0;0;0;0
FR;2;2021-03-04;8412;4210;0;0;4396;0;0;0;0;199227;60553;0;0;63312;0;0;0;0
FR;2;2021-03-05;8037;4054;0;0;4237;0;0;0;0;207264;64607;0;0;67549;0;0;0;0
FR;2;2021-03-06;4790;1683;0;0;1783;0;0;0;0;212054;66290;0;0;69332;0;0;0;0
FR;2;2021-03-07;2373;32;0;0;76;0;0;0;0;214427;66322;0;0;69408;0;0;0;0
FR;2;2021-03-08;4166;8392;0;0;8549;0;0;0;0;218593;74714;0;0;77957;0;0;0;0
FR;2;2021-03-09;7494;8610;1;0;8868;0;0;0;0;226087;83324;1;0;86825;0;0;0;0
FR;2;2021-03-10;7108;9246;0;0;9473;0;0;0;0;233195;92570;1;0;96298;0;0;0;0
FR;2;2021-03-11;9379;9365;1;0;9685;0;0;0;0;242574;101935;2;0;105983;0;0;0;0
FR;2;2021-03-12;7988;8367;0;0;8669;0;0;0;0;250562;110302;2;0;114652;0;0;0;0
FR;2;2021-03-13;10057;2593;0;0;2914;0;0;0;0;260619;112895;2;0;117566;0;0;0;0
FR;2;2021-03-14;4841;380;0;0;539;0;0;0;0;265460;113275;2;0;118105;0;0;0;0
FR;2;2021-03-15;10919;3476;0;0;3765;0;0;0;0;276379;116751;2;0;121870;0;0;0;0
FR;2;2021-03-16;16770;4732;1;0;5282;0;0;0;0;293149;121483;3;0;127152;0;0;0;0
FR;2;2021-03-17;20242;3998;0;0;4672;0;0;0;0;313391;125481;3;0;131824;0;0;0;0
FR;2;2021-03-18;23375;5128;0;0;5957;0;0;0;0;336766;130609;3;0;137781;0;0;0;0
FR;2;2021-03-19;23316;4680;0;0;5442;0;0;0;0;360082;135289;3;0;143223;0;0;0;0
FR;2;2021-03-20;25452;1587;0;0;2344;0;0;0;0;385534;136876;3;0;145567;0;0;0;0
FR;2;2021-03-21;17674;153;0;0;731;0;0;0;0;403208;137029;3;0;146298;0;0;0;0
FR;2;2021-03-22;17791;3261;0;0;3930;0;0;0;0;420999;140290;3;0;150228;0;0;0;0
FR;2;2021-03-23;22707;4287;0;0;5141;0;0;0;0;443706;144577;3;0;155369;0;0;0;0
FR;2;2021-03-24;23964;5091;0;0;5928;0;0;0;0;467670;149668;3;0;161297;0;0;0;0
FR;2;2021-03-25;26762;5257;1;0;6454;0;0;0;0;494432;154925;4;0;167751;0;0;0;0
FR;2;2021-03-26;26992;4237;0;0;5383;0;0;0;0;521424;159162;4;0;173134;0;0;0;0
FR;2;2021-03-27;15923;1368;0;0;1898;0;0;0;0;537347;160530;4;0;175032;0;0;0;0
FR;2;2021-03-28;10563;136;0;0;428;0;0;0;0;547910;160666;4;0;175460;0;0;0;0
FR;2;2021-03-29;19004;4349;0;0;5049;0;0;0;0;566914;165015;4;0;180509;0;0;0;0
FR;2;2021-03-30;24597;6105;0;0;7045;0;0;0;0;591511;171120;4;0;187554;0;0;0;0
FR;2;2021-03-31;28562;5931;0;0;7223;0;0;0;0;620073;177051;4;0;194777;0;0;0;0
FR;2;2021-04-01;34559;8575;1;0;10268;0;0;0;0;654632;185626;5;0;205045;0;0;0;0
FR;2;2021-04-02;29992;7736;0;0;9164;0;0;0;0;684624;193362;5;0;214209;0;0;0;0
FR;2;2021-04-03;16959;4263;0;0;4945;0;0;0;0;701583;197625;5;0;219154;0;0;0;0
FR;2;2021-04-04;9309;1268;2;0;1676;0;0;0;0;710892;198893;7;0;220830;0;0;0;0
FR;2;2021-04-05;12448;797;0;0;1381;0;0;0;0;723340;199690;7;0;222211;0;0;0;0
FR;2;2021-04-06;27159;7358;0;0;8750;0;0;0;0;750499;207048;7;0;230961;0;0;0;0
FR;2;2021-04-07;30931;7070;1;0;8646;0;0;0;0;781430;214118;8;0;239607;0;0;0;0
FR;2;2021-04-08;36896;8591;1;0;10516;0;0;0;0;818326;222709;9;0;250123;0;0;0;0
FR;2;2021-04-09;33856;8390;28;0;10175;0;0;0;0;852182;231099;37;0;260298;0;0;0;0
FR;2;2021-04-10;19689;9270;1;0;10182;0;0;0;0;871871;240369;38;0;270480;0;0;0;0
FR;2;2021-04-11;7943;4240;1;0;4603;0;0;0;0;879814;244609;39;0;275083;0;0;0;0
FR;2;2021-04-12;17136;11028;0;0;11869;0;0;0;0;896950;255637;39;0;286952;0;0;0;0
FR;2;2021-04-13;19465;16038;1;0;17106;0;0;0;0;916415;271675;40;0;304058;0;0;0;0
FR;2;2021-04-14;18072;16445;7;0;17541;0;0;0;0;934487;288120;47;0;321599;0;0;0;0
FR;2;2021-04-15;22207;21886;27;0;23340;0;0;0;0;956694;310006;74;0;344939;0;0;0;0
FR;2;2021-04-16;20721;20645;45;0;21918;0;0;0;0;977415;330651;119;0;366857;0;0;0;0
FR;2;2021-04-17;13258;22495;5;0;23226;0;0;0;0;990673;353146;124;0;390083;0;0;0;0
FR;2;2021-04-18;5911;14398;6;0;14739;0;0;0;0;996584;367544;130;0;404822;0;0;0;0
FR;2;2021-04-19;16850;16395;24;0;17198;0;0;0;0;1013434;383939;154;0;422020;0;0;0;0
FR;2;2021-04-20;19328;21806;38;0;22868;0;0;0;0;1032762;405745;192;0;444888;0;0;0;0
FR;2;2021-04-21;20294;21899;76;0;23049;0;0;0;0;1053056;427644;268;0;467937;0;0;0;0
FR;2;2021-04-22;23824;24955;41;0;26367;0;0;0;0;1076880;452599;309;0;494304;0;0;0;0
FR;2;2021-04-23;24534;25499;76;0;27010;0;0;0;0;1101414;478098;385;0;521314;0;0;0;0
FR;2;2021-04-24;25305;15068;104;0;16506;0;0;0;0;1126719;493166;489;0;537820;0;0;0;0
FR;2;2021-04-25;9597;8622;5;0;9183;0;0;0;0;1136316;501788;494;0;547003;0;0;0;0
FR;2;2021-04-26;17169;17678;21;0;18564;0;0;0;0;1153485;519466;515;0;565567;0;0;0;0
FR;2;2021-04-27;19246;24098;40;0;25282;0;0;0;0;1172731;543564;555;0;590849;0;0;0;0
FR;2;2021-04-28;22343;26463;113;0;27864;0;0;0;0;1195074;570027;668;0;618713;0;0;0;0
FR;2;2021-04-29;25476;30496;70;0;32186;0;0;0;0;1220550;600523;738;0;650899;0;0;0;0
FR;2;2021-04-30;25540;27976;49;1;29626;0;0;0;0;1246090;628499;787;1;680525;0;0;0;0
FR;2;2021-05-01;14988;9853;6;0;10654;0;0;0;0;1261078;638352;793;1;691179;0;0;0;0
FR;2;2021-05-02;6642;9160;2;0;9506;0;0;0;0;1267720;647512;795;1;700685;0;0;0;0
FR;2;2021-05-03;20026;19126;40;0;20333;0;0;0;0;1287746;666638;835;1;721018;0;0;0;0
FR;2;2021-05-04;18288;29202;33;0;30348;0;0;0;0;1306034;695840;868;1;751366;0;0;0;0
FR;2;2021-05-05;18385;29524;48;0;30822;0;0;0;0;1324419;725364;916;1;782188;0;0;0;0
FR;2;2021-05-06;23553;35413;132;0;36986;0;0;0;0;1347972;760777;1048;1;819174;0;0;0;0
FR;2;2021-05-07;25349;33240;97;0;35097;0;0;0;0;1373321;794017;1145;1;854271;0;0;0;0
FR;2;2021-05-08;21343;10683;15;0;11770;0;0;0;0;1394664;804700;1160;1;866041;0;0;0;0
FR;2;2021-05-09;13170;7622;7;0;8297;0;0;0;0;1407834;812322;1167;1;874338;0;0;0;0
FR;2;2021-05-10;32947;21717;50;0;23574;0;0;0;0;1440781;834039;1217;1;897912;0;0;0;0
FR;2;2021-05-11;43616;20904;101;0;23529;0;0;0;0;1484397;854943;1318;1;921441;0;0;0;0
FR;2;2021-05-12;50070;19638;143;0;22519;0;0;0;0;1534467;874581;1461;1;943960;0;0;0;0
FR;2;2021-05-13;51301;5599;31;0;8467;0;0;0;0;1585768;880180;1492;1;952427;0;0;0;0
FR;2;2021-05-14;61361;12883;132;0;16537;0;0;0;0;1647129;893063;1624;1;968964;0;0;0;0
FR;2;2021-05-15;65938;7100;40;0;10650;0;0;0;0;1713067;900163;1664;1;979614;0;0;0;0
FR;2;2021-05-16;43588;2573;10;0;4944;0;0;0;0;1756655;902736;1674;1;984558;0;0;0;0
FR;2;2021-05-17;44756;12449;114;0;15356;0;0;0;0;1801411;915185;1788;1;999914;0;0;0;0
FR;2;2021-05-18;54650;12285;190;0;15968;0;0;0;0;1856061;927470;1978;1;1015882;0;0;0;0
FR;2;2021-05-19;57179;10459;281;0;14499;0;0;0;0;1913240;937929;2259;1;1030381;0;0;0;0
FR;2;2021-05-20;63451;10796;288;0;14892;0;0;0;0;1976691;948725;2547;1;1045273;0;0;0;0
FR;2;2021-05-21;64306;11604;230;0;16029;0;0;0;0;2040997;960329;2777;1;1061302;0;0;0;0
FR;2;2021-05-22;61488;4531;65;0;8501;0;0;0;0;2102485;964860;2842;1;1069803;0;0;0;0
FR;2;2021-05-23;37536;576;22;0;2913;0;0;0;0;2140021;965436;2864;1;1072716;0;0;0;0
FR;2;2021-05-24;17248;2052;35;0;3259;0;0;0;0;2157269;967488;2899;1;1075975;0;0;0;0
FR;2;2021-05-25;21121;12254;241;0;13855;0;0;0;0;2178390;979742;3140;1;1089830;0;0;0;0
FR;2;2021-05-26;19946;11539;230;0;13067;0;0;0;0;2198336;991281;3370;1;1102897;0;0;0;0
FR;2;2021-05-27;23001;12664;182;0;14402;0;0;0;0;2221337;1003945;3552;1;1117299;0;0;0;0
FR;2;2021-05-28;29397;15045;190;0;17225;0;0;0;0;2250734;1018990;3742;1;1134524;0;0;0;0
FR;2;2021-05-29;30425;8194;58;0;10103;0;0;0;0;2281159;1027184;3800;1;1144627;0;0;0;0
FR;2;2021-05-30;4648;1820;6;0;2155;0;0;0;0;2285807;1029004;3806;1;1146782;0;0;0;0
FR;2;2021-05-31;28590;18743;184;0;20822;0;0;0;0;2314397;1047747;3990;1;1167604;0;0;0;0
FR;2;2021-06-01;45744;19915;225;0;23151;0;0;0;0;2360141;1067662;4215;1;1190755;0;0;0;0
FR;2;2021-06-02;37483;19311;182;0;22317;0;0;0;0;2397624;1086973;4397;1;1213072;0;0;0;0
FR;2;2021-06-03;51282;23116;161;0;26969;0;0;0;0;2448906;1110089;4558;1;1240041;0;0;0;0
FR;2;2021-06-04;65518;24090;217;0;29056;0;0;0;0;2514424;1134179;4775;1;1269097;0;0;0;0
FR;2;2021-06-05;34607;24111;52;0;26966;0;0;0;0;2549031;1158290;4827;1;1296063;0;0;0;0
FR;2;2021-06-06;4958;6194;10;0;6613;0;0;0;0;2553989;1164484;4837;1;1302676;0;0;0;0
FR;2;2021-06-07;28177;23015;150;0;25430;0;0;0;0;2582166;1187499;4987;1;1328106;0;0;0;0
FR;2;2021-06-08;46379;22944;143;0;26910;0;0;0;0;2628545;1210443;5130;1;1355016;0;0;0;0
FR;2;2021-06-09;34297;20999;107;0;24131;0;0;0;0;2662842;1231442;5237;1;1379147;0;0;0;0
FR;2;2021-06-10;42644;19082;96;1;23004;0;0;0;0;2705486;1250524;5333;2;1402151;0;0;0;0
FR;2;2021-06-11;55305;25133;134;0;30232;0;0;0;0;2760791;1275657;5467;2;1432383;0;0;0;0
FR;2;2021-06-12;30566;19800;53;0;22654;0;0;0;0;2791357;1295457;5520;2;1455037;0;0;0;0
FR;2;2021-06-13;3334;9197;13;0;9586;0;0;0;0;2794691;1304654;5533;2;1464623;0;0;0;0
FR;2;2021-06-14;25304;24119;92;0;26699;0;0;0;0;2819995;1328773;5625;2;1491322;0;0;0;0
FR;2;2021-06-15;39049;22819;154;0;26567;0;0;0;0;2859044;1351592;5779;2;1517889;0;0;0;0
FR;2;2021-06-16;30168;21368;135;0;24522;0;0;0;0;2889212;1372960;5914;2;1542411;0;0;0;0
FR;2;2021-06-17;36913;25739;150;0;29601;0;0;0;0;2926125;1398699;6064;2;1572012;0;0;0;0
FR;2;2021-06-18;46860;28887;123;0;33589;0;0;0;0;2972985;1427586;6187;2;1605601;0;0;0;0
FR;2;2021-06-19;24527;24939;39;0;27713;0;0;0;0;2997512;1452525;6226;2;1633314;0;0;0;0
FR;2;2021-06-20;3745;10058;9;0;10557;0;0;0;0;3001257;1462583;6235;2;1643871;0;0;0;0
FR;2;2021-06-21;17538;42860;88;0;44872;0;0;0;0;3018795;1505443;6323;2;1688743;0;0;0;0
FR;2;2021-06-22;28366;49616;110;0;53044;0;0;0;0;3047161;1555059;6433;2;1741787;0;0;0;0
FR;2;2021-06-23;21790;49618;107;1;52467;1;0;0;0;3068951;1604677;6540;3;1794254;1;0;0;0
FR;2;2021-06-24;28380;50316;134;0;54047;0;0;0;0;3097331;1654993;6674;3;1848301;1;0;0;0
FR;2;2021-06-25;33402;60490;129;0;64879;0;0;0;0;3130733;1715483;6803;3;1913180;1;0;0;0
FR;2;2021-06-26;16395;59356;54;1;61748;0;0;0;0;3147128;1774839;6857;4;1974928;1;0;0;0
FR;2;2021-06-27;2566;29316;22;1;29898;0;0;0;0;3149694;1804155;6879;5;2004826;1;0;0;0
FR;2;2021-06-28;12641;54340;84;0;56316;0;0;0;0;3162335;1858495;6963;5;2061142;1;0;0;0
FR;2;2021-06-29;19857;59998;178;0;62941;0;0;0;0;3182192;1918493;7141;5;2124083;1;0;0;0
FR;2;2021-06-30;16337;58037;253;17;60722;0;0;0;0;3198529;1976530;7394;22;2184805;1;0;0;0
FR;2;2021-07-01;20497;59873;228;0;63200;0;0;0;0;3219026;2036403;7622;22;2248005;1;0;0;0
FR;2;2021-07-02;24083;62158;184;0;66372;0;0;0;0;3243109;2098561;7806;22;2314377;1;0;0;0
FR;2;2021-07-03;12123;57146;153;0;59485;0;0;0;0;3255232;2155707;7959;22;2373862;1;0;0;0
FR;2;2021-07-04;1961;23304;18;0;23871;0;0;0;0;3257193;2179011;7977;22;2397733;1;0;0;0
FR;2;2021-07-05;9179;29257;106;0;30893;0;0;0;0;3266372;2208268;8083;22;2428626;1;0;0;0
FR;2;2021-07-06;14584;36279;135;0;38958;0;0;0;0;3280956;2244547;8218;22;2467584;1;0;0;0
FR;2;2021-07-07;14420;33663;140;0;36417;0;0;0;0;3295376;2278210;8358;22;2504001;1;0;0;0
FR;2;2021-07-08;19723;40321;162;0;43978;0;0;0;0;3315099;2318531;8520;22;2547979;1;0;0;0
FR;2;2021-07-09;27105;54333;202;1;59483;0;0;0;0;3342204;2372864;8722;23;2607462;1;0;0;0
FR;2;2021-07-10;13388;33710;107;0;36394;0;0;0;0;3355592;2406574;8829;23;2643856;1;0;0;0
FR;2;2021-07-11;1812;4344;16;0;4772;0;0;0;0;3357404;2410918;8845;23;2648628;1;0;0;0
FR;2;2021-07-12;12971;37265;119;0;39921;0;0;0;0;3370375;2448183;8964;23;2688549;1;0;0;0
FR;2;2021-07-13;37120;53147;152;0;60283;0;0;0;0;3407495;2501330;9116;23;2748832;1;0;0;0
FR;2;2021-07-14;6628;3540;15;0;4888;0;0;0;0;3414123;2504870;9131;23;2753720;1;0;0;0
FR;2;2021-07-15;47244;47014;156;0;55212;0;0;0;0;3461367;2551884;9287;23;2808932;1;0;0;0
FR;2;2021-07-16;64320;55753;188;0;66737;0;0;0;0;3525687;2607637;9475;23;2875669;1;0;0;0
FR;2;2021-07-17;31603;23919;96;0;29376;0;0;0;0;3557290;2631556;9571;23;2905045;1;0;0;0
FR;2;2021-07-18;6091;4807;19;0;5953;0;0;0;0;3563381;2636363;9590;23;2910998;1;0;0;0
FR;2;2021-07-19;33007;28600;94;0;34213;0;0;0;0;3596388;2664963;9684;23;2945211;1;0;0;0
FR;2;2021-07-20;52000;44525;155;0;53161;0;0;0;0;3648388;2709488;9839;23;2998372;1;0;0;0
FR;2;2021-07-21;45257;34626;93;0;42131;0;0;0;0;3693645;2744114;9932;23;3040503;1;0;0;0
FR;2;2021-07-22;56280;41084;128;1;50358;0;0;0;0;3749925;2785198;10060;24;3090861;1;0;0;0
FR;2;2021-07-23;68304;48964;170;0;60256;0;0;0;0;3818229;2834162;10230;24;3151117;1;0;0;0
FR;2;2021-07-24;36178;21613;82;0;27471;0;0;0;0;3854407;2855775;10312;24;3178588;1;0;0;0
FR;2;2021-07-25;6751;2607;10;0;3865;0;0;0;0;3861158;2858382;10322;24;3182453;1;0;0;0
FR;2;2021-07-26;36320;22336;91;1;27839;0;0;0;0;3897478;2880718;10413;25;3210292;1;0;0;0
FR;2;2021-07-27;62391;34563;180;0;43709;0;0;0;0;3959869;2915281;10593;25;3254001;1;0;0;0
FR;2;2021-07-28;55327;26426;132;0;34514;0;0;0;0;4015196;2941707;10725;25;3288515;1;0;0;0
FR;2;2021-07-29;68481;32796;189;0;42477;0;0;0;0;4083677;2974503;10914;25;3330992;1;0;0;0
FR;2;2021-07-30;74468;37814;222;1;48607;0;0;0;0;4158145;3012317;11136;26;3379599;1;0;0;0
FR;2;2021-07-31;34778;16206;105;0;21404;0;0;0;0;4192923;3028523;11241;26;3401003;1;0;0;0
FR;2;2021-08-01;5416;2260;19;0;3123;0;0;0;0;4198339;3030783;11260;26;3404126;1;0;0;0
FR;2;2021-08-02;35896;16151;101;0;21053;0;0;0;0;4234235;3046934;11361;26;3425179;1;0;0;0
FR;2;2021-08-03;55988;28257;143;0;35460;0;0;0;0;4290223;3075191;11504;26;3460639;1;0;0;0
FR;2;2021-08-04;46639;20829;128;1;26937;0;0;0;0;4336862;3096020;11632;27;3487576;1;0;0;0
FR;2;2021-08-05;54641;31562;215;0;38738;0;0;0;0;4391503;3127582;11847;27;3526314;1;0;0;0
FR;2;2021-08-06;58098;42398;242;1;50227;0;0;0;0;4449601;3169980;12089;28;3576541;1;0;0;0
FR;2;2021-08-07;25152;17628;89;0;21318;0;0;0;0;4474753;3187608;12178;28;3597859;1;0;0;0
FR;2;2021-08-08;3840;3653;21;0;4311;0;0;0;0;4478593;3191261;12199;28;3602170;1;0;0;0
FR;2;2021-08-09;29308;21023;92;0;24850;0;0;0;0;4507901;3212284;12291;28;3627020;1;0;0;0
FR;2;2021-08-10;45013;33464;155;0;39226;0;0;0;0;4552914;3245748;12446;28;3666246;1;0;0;0
FR;2;2021-08-11;35277;25141;151;0;29742;0;0;0;0;4588191;3270889;12597;28;3695988;1;0;0;0
FR;2;2021-08-12;41905;35692;163;0;41229;0;0;0;0;4630096;3306581;12760;28;3737217;1;0;0;0
FR;2;2021-08-13;42608;37351;218;0;43037;0;0;0;0;4672704;3343932;12978;28;3780254;1;0;0;0
FR;2;2021-08-14;18524;22132;94;0;24763;0;0;0;0;4691228;3366064;13072;28;3805017;1;0;0;0
FR;2;2021-08-15;3865;3795;17;0;4382;0;0;0;0;4695093;3369859;13089;28;3809399;1;0;0;0
FR;2;2021-08-16;25094;27123;111;0;30445;0;0;0;0;4720187;3396982;13200;28;3839844;1;0;0;0
FR;2;2021-08-17;38269;43399;207;2;48384;0;0;0;0;4758456;3440381;13407;30;3888228;1;0;0;0
FR;2;2021-08-18;32254;36352;195;1;40695;0;0;0;0;4790710;3476733;13602;31;3928923;1;0;0;0
FR;2;2021-08-19;37435;46574;224;0;51777;0;0;0;0;4828145;3523307;13826;31;3980700;1;0;0;0
FR;2;2021-08-20;40568;55649;271;1;61575;0;0;0;0;4868713;3578956;14097;32;4042275;1;0;0;0
FR;2;2021-08-21;18120;24320;117;0;27112;0;0;0;0;4886833;3603276;14214;32;4069387;1;0;0;0
FR;2;2021-08-22;2909;4321;22;1;4853;1;0;0;0;4889742;3607597;14236;33;4074240;2;0;0;0
FR;2;2021-08-23;19249;35149;131;1;38038;0;0;0;0;4908991;3642746;14367;34;4112278;2;0;0;0
FR;2;2021-08-24;31952;56036;236;0;60693;0;0;0;0;4940943;3698782;14603;34;4172971;2;0;0;0
FR;2;2021-08-25;25934;43455;251;0;47404;0;0;0;0;4966877;3742237;14854;34;4220375;2;0;0;0
FR;2;2021-08-26;32362;55843;388;0;60582;0;0;0;0;4999239;3798080;15242;34;4280957;2;0;0;0
FR;2;2021-08-27;37004;65680;477;2;71406;0;0;0;0;5036243;3863760;15719;36;4352363;2;0;0;0
FR;2;2021-08-28;17819;28556;300;0;31617;0;0;0;0;5054062;3892316;16019;36;4383980;2;0;0;0
FR;2;2021-08-29;2656;5010;47;0;5621;0;0;0;0;5056718;3897326;16066;36;4389601;2;0;0;0
FR;2;2021-08-30;18418;37728;399;0;40149;756;0;0;0;5075136;3935054;16465;36;4429750;758;0;0;0
FR;2;2021-08-31;28077;57517;887;4;60948;1558;0;0;0;5103213;3992571;17352;40;4490698;2316;0;0;0
FR;2;2021-09-01;21594;39874;1309;0;42256;2128;0;0;0;5124807;4032445;18661;40;4532954;4444;0;0;0
FR;2;2021-09-02;25486;48669;1963;2;50944;3369;0;0;0;5150293;4081114;20624;42;4583898;7813;0;0;0
FR;2;2021-09-03;33414;64575;2988;3;67539;4886;1;0;0;5183707;4145689;23612;45;4651437;12699;1;0;0
FR;2;2021-09-04;16833;27766;1443;1;29557;2386;0;0;0;5200540;4173455;25055;46;4680994;15085;1;0;0
FR;2;2021-09-05;2265;3584;266;0;3940;412;0;0;0;5202805;4177039;25321;46;4684934;15497;1;0;0
FR;2;2021-09-06;14044;28693;1771;1;29759;2945;0;0;0;5216849;4205732;27092;47;4714693;18442;1;0;0
FR;2;2021-09-07;21111;41112;3022;13;42266;4944;0;0;0;5237960;4246844;30114;60;4756959;23386;1;0;0
FR;2;2021-09-08;17248;31920;2735;6;32738;4497;0;0;0;5255208;4278764;32849;66;4789697;27883;1;0;0
FR;2;2021-09-09;20982;40484;4437;3;41229;6842;0;0;0;5276190;4319248;37286;69;4830926;34725;1;0;0
FR;2;2021-09-10;28203;51314;5286;4;51884;8979;1;0;0;5304393;4370562;42572;73;4882810;43704;2;0;0
FR;2;2021-09-11;13655;22457;2405;5;23133;3987;0;0;0;5318048;4393019;44977;78;4905943;47691;2;0;0
FR;2;2021-09-12;1824;2773;292;0;2965;512;0;0;0;5319872;4395792;45269;78;4908908;48203;2;0;0
FR;2;2021-09-13;11659;21441;2474;4;21702;4051;0;0;0;5331531;4417233;47743;82;4930610;52254;2;0;0
FR;2;2021-09-14;18577;32720;5092;13;31679;9055;2;0;0;5350108;4449953;52835;95;4962289;61309;4;0;0
FR;2;2021-09-15;14917;28227;5168;3;26928;7748;9;0;0;5365025;4478180;58003;98;4989217;69057;13;0;0
FR;2;2021-09-16;16078;32798;6737;12;30179;10541;4;0;0;5381103;4510978;64740;110;5019396;79598;17;0;0
FR;2;2021-09-17;20916;47179;8782;10;42826;14631;6;0;0;5402019;4558157;73522;120;5062222;94229;23;0;0
FR;2;2021-09-18;9857;20960;3804;6;19596;6034;1;0;0;5411876;4579117;77326;126;5081818;100263;24;0;0
FR;2;2021-09-19;1166;2590;396;0;2533;631;0;0;0;5413042;4581707;77722;126;5084351;100894;24;0;0
FR;2;2021-09-20;7503;18703;3856;7;17026;6135;4;0;0;5420545;4600410;81578;133;5101377;107029;28;0;0
FR;2;2021-09-21;11215;29983;6495;5;26536;10744;3;0;0;5431760;4630393;88073;138;5127913;117773;31;0;0
FR;2;2021-09-22;9414;23546;5490;6;21194;8526;8;0;0;5441174;4653939;93563;144;5149107;126299;39;0;0
FR;2;2021-09-23;10730;28904;7881;10;24733;12646;10;0;0;5451904;4682843;101444;154;5173840;138945;49;0;0
FR;2;2021-09-24;15075;42945;10877;18;37280;17244;21;0;0;5466979;4725788;112321;172;5211120;156189;70;0;0
FR;2;2021-09-25;7258;18798;3965;9;17152;6120;3;0;0;5474237;4744586;116286;181;5228272;162309;73;0;0
FR;2;2021-09-26;1080;2544;495;0;2490;630;1;0;0;5475317;4747130;116781;181;5230762;162939;74;0;0
FR;2;2021-09-27;6311;16400;4287;8;14792;6533;2;0;0;5481628;4763530;121068;189;5245554;169472;76;0;0
FR;2;2021-09-28;9243;25572;7770;14;21721;12087;7;0;0;5490871;4789102;128838;203;5267275;181559;83;0;0
FR;2;2021-09-29;8081;20199;6067;25;17605;9261;8;0;0;5498952;4809301;134905;228;5284880;190820;91;0;0
FR;2;2021-09-30;9865;25837;9509;16;21638;14099;6;0;0;5508817;4835138;144414;244;5306518;204919;97;0;0
FR;2;2021-10-01;13978;35734;12921;25;30044;19328;9;0;0;5522795;4870872;157335;269;5336562;224247;106;0;0
FR;2;2021-10-02;6874;15933;4850;7;14227;7046;6;0;0;5529669;4886805;162185;276;5350789;231293;112;0;0
FR;2;2021-10-03;841;1909;492;1;1840;502;0;0;0;5530510;4888714;162677;277;5352629;231795;112;0;0
FR;2;2021-10-04;5826;13901;5516;5;12137;7854;6;0;0;5536336;4902615;168193;282;5364766;239649;118;0;0
FR;2;2021-10-05;9058;22570;11125;19;18530;15741;1;0;0;5545394;4925185;179318;301;5383296;255390;119;0;0
FR;2;2021-10-06;7785;17747;8243;11;15273;11091;4;0;0;5553179;4942932;187561;312;5398569;266481;123;0;0
FR;2;2021-10-07;9203;22213;12386;14;18005;16879;6;0;0;5562382;4965145;199947;326;5416574;283360;129;0;0
FR;2;2021-10-08;13432;32144;17349;28;26518;23609;11;0;0;5575814;4997289;217296;354;5443092;306969;140;0;0
FR;2;2021-10-09;6000;12847;6044;6;11381;7897;7;0;0;5581814;5010136;223340;360;5454473;314866;147;0;0
FR;2;2021-10-10;885;1592;436;2;1536;604;1;0;0;5582699;5011728;223776;362;5456009;315470;148;0;0
FR;2;2021-10-11;5607;11545;6455;17;9934;8828;3;0;0;5588306;5023273;230231;379;5465943;324298;151;0;0
FR;2;2021-10-12;8030;17789;12551;13;13920;16790;9;0;0;5596336;5041062;242782;392;5479863;341088;160;0;0
FR;2;2021-10-13;6947;14863;10256;12;11808;13659;7;0;0;5603283;5055925;253038;404;5491671;354747;167;0;0
FR;2;2021-10-14;8314;17940;14996;13;13558;19477;10;0;0;5611597;5073865;268034;417;5505229;374224;177;0;0
FR;2;2021-10-15;11856;26309;20902;26;19412;27981;4;0;0;5623453;5100174;288936;443;5524641;402205;181;0;0
FR;2;2021-10-16;5141;8732;1819;0;8173;3209;2;0;0;5628594;5108906;290755;443;5532814;405414;183;0;0
FR;2;2021-10-17;654;1149;185;0;1082;354;1;0;0;5629248;5110055;290940;443;5533896;405768;184;0;0
FR;2;2021-10-18;4564;7337;665;2;7243;1630;0;0;0;5633812;5117392;291605;445;5541139;407398;184;0;0
FR;2;2021-10-19;6239;9849;732;5;9656;2030;5;0;0;5640051;5127241;292337;450;5550795;409428;189;0;0
FR;2;2021-10-20;5170;8050;759;3;8172;1675;0;0;0;5645221;5135291;293096;453;5558967;411103;189;0;0
FR;2;2021-10-21;6090;9980;780;5;9837;2105;1;0;0;5651311;5145271;293876;458;5568804;413208;190;0;0
FR;2;2021-10-22;8452;14599;1151;4;14475;2891;2;0;0;5659763;5159870;295027;462;5583279;416099;192;0;0
FR;2;2021-10-23;3845;5994;587;0;6127;1235;3;0;0;5663608;5165864;295614;462;5589406;417334;195;0;0
FR;2;2021-10-24;494;882;101;0;900;204;0;0;0;5664102;5166746;295715;462;5590306;417538;195;0;0
FR;2;2021-10-25;3360;5343;307;1;5519;825;2;0;0;5667462;5172089;296022;463;5595825;418363;197;0;0
FR;2;2021-10-26;4177;7237;1133;4;7126;2022;5;0;0;5671639;5179326;297155;467;5602951;420385;202;0;0
FR;2;2021-10-27;3677;6587;1194;5;6448;1990;1;0;0;5675316;5185913;298349;472;5609399;422375;203;0;0
FR;2;2021-10-28;4597;7688;1737;3;7416;2746;1;0;0;5679913;5193601;300086;475;5616815;425121;204;0;0
FR;2;2021-10-29;5414;11082;2438;4;10692;3684;3;0;0;5685327;5204683;302524;479;5627507;428805;207;0;0
FR;2;2021-10-30;2749;4459;976;1;4454;1448;2;0;0;5688076;5209142;303500;480;5631961;430253;209;0;0
FR;2;2021-10-31;364;535;140;1;544;191;1;0;0;5688440;5209677;303640;481;5632505;430444;210;0;0
FR;2;2021-11-01;429;546;181;0;563;267;1;0;0;5688869;5210223;303821;481;5633068;430711;211;0;0
FR;2;2021-11-02;3294;6759;1184;0;6799;1771;5;0;0;5692163;5216982;305005;481;5639867;432482;216;0;0
FR;2;2021-11-03;3340;6226;1389;2;6311;1970;2;0;0;5695503;5223208;306394;483;5646178;434452;218;0;0
FR;2;2021-11-04;3987;7069;1769;4;7109;2495;3;0;0;5699490;5230277;308163;487;5653287;436947;221;0;0
FR;2;2021-11-05;5235;10502;2868;5;10215;3957;5;0;0;5704725;5240779;311031;492;5663502;440904;226;0;0
FR;2;2021-11-06;2597;4682;1407;0;4640;1824;2;0;0;5707322;5245461;312438;492;5668142;442728;228;0;0
FR;2;2021-11-07;506;862;221;0;869;291;2;0;0;5707828;5246323;312659;492;5669011;443019;230;0;0
FR;2;2021-11-08;2578;5348;1207;3;5268;1678;3;0;0;5710406;5251671;313866;495;5674279;444697;233;0;0
FR;2;2021-11-09;2749;6908;2402;5;6442;3182;2;0;0;5713155;5258579;316268;500;5680721;447879;235;0;0
FR;2;2021-11-10;2590;5669;5117;6;4761;6294;7;0;0;5715745;5264248;321385;506;5685482;454173;242;0;0
FR;2;2021-11-11;446;754;755;2;647;938;3;0;0;5716191;5265002;322140;508;5686129;455111;245;0;0
FR;2;2021-11-12;2953;8087;8982;8;6195;10933;9;0;0;5719144;5273089;331122;516;5692324;466044;254;0;0
FR;2;2021-11-13;1539;3373;3872;7;2722;4538;4;0;0;5720683;5276462;334994;523;5695046;470582;258;0;0
FR;2;2021-11-14;258;585;351;1;486;480;3;0;0;5720941;5277047;335345;524;5695532;471062;261;0;0
FR;2;2021-11-15;1621;3655;4449;8;2909;5329;16;0;0;5722562;5280702;339794;532;5698441;476391;277;0;0
FR;2;2021-11-16;2184;5878;8313;14;4155;10082;16;0;0;5724746;5286580;348107;546;5702596;486473;293;0;0
FR;2;2021-11-17;1740;4523;6634;8;3168;7852;5;0;0;5726486;5291103;354741;554;5705764;494325;298;0;0
FR;2;2021-11-18;2192;5920;9188;10;4018;11018;8;0;0;5728678;5297023;363929;564;5709782;505343;306;0;0
FR;2;2021-11-19;2701;7752;12981;19;4832;15480;12;0;0;5731379;5304775;376910;583;5714614;520823;318;0;0
FR;2;2021-11-20;1566;3333;5184;5;2351;6097;3;0;0;5732945;5308108;382094;588;5716965;526920;321;0;0
FR;2;2021-11-21;251;502;543;0;392;655;3;0;0;5733196;5308610;382637;588;5717357;527575;324;0;0
FR;2;2021-11-22;1278;2573;4485;5;1675;5398;9;0;0;5734474;5311183;387122;593;5719032;532973;333;0;0
FR;2;2021-11-23;1617;4276;8206;9;2536;9921;6;0;0;5736091;5315459;395328;602;5721568;542894;339;0;0
FR;2;2021-11-24;1421;3747;7486;14;2246;8736;9;0;0;5737512;5319206;402814;616;5723814;551630;348;0;0
FR;2;2021-11-25;1813;4863;11474;21;2682;13668;6;0;0;5739325;5324069;414288;637;5726496;565298;354;0;0
FR;2;2021-11-26;2541;7735;22676;31;3812;26091;14;0;0;5741866;5331804;436964;668;5730308;591389;368;0;0
FR;2;2021-11-27;1498;4144;12278;19;2127;14042;13;0;0;5743364;5335948;449242;687;5732435;605431;381;0;0
FR;2;2021-11-28;292;835;1976;3;477;2303;5;0;0;5743656;5336783;451218;690;5732912;607734;386;0;0
FR;2;2021-11-29;1449;4349;15099;23;2010;17269;25;0;0;5745105;5341132;466317;713;5734922;625003;411;0;0
FR;2;2021-11-30;1912;6655;26251;36;2638;30011;22;0;0;5747017;5347787;492568;749;5737560;655014;433;0;0
FR;2;2021-12-01;1916;6009;26210;31;2479;29519;20;0;0;5748933;5353796;518778;780;5740039;684533;453;0;0
FR;2;2021-12-02;1916;6780;37736;52;2112;41995;32;0;0;5750849;5360576;556514;832;5742151;726528;485;0;0
FR;2;2021-12-03;2558;10068;53644;111;3591;59392;30;0;0;5753407;5370644;610158;943;5745742;785920;515;0;0
FR;2;2021-12-04;1850;6275;37132;38;2185;40820;16;0;0;5755257;5376919;647290;981;5747927;826740;531;0;0
FR;2;2021-12-05;458;2242;14265;14;533;15990;7;0;0;5755715;5379161;661555;995;5748460;842730;538;0;0
FR;2;2021-12-06;2486;9850;77735;109;2700;84788;25;0;0;5758201;5389011;739290;1104;5751160;927518;563;0;0
FR;2;2021-12-07;3458;15287;122473;238;3742;133794;40;0;0;5761659;5404298;861763;1342;5754902;1061312;603;0;0
FR;2;2021-12-08;3725;15969;133225;330;3846;145414;54;0;0;5765384;5420267;994988;1672;5758748;1206726;657;0;0
FR;2;2021-12-09;4546;19627;170241;554;4168;185638;61;0;0;5769930;5439894;1165229;2226;5762916;1392364;718;0;0
FR;2;2021-12-10;4676;22806;188699;490;5012;206189;69;0;0;5774606;5462700;1353928;2716;5767928;1598553;787;0;0
FR;2;2021-12-11;3688;16621;132468;239;3663;144936;60;0;0;5778294;5479321;1486396;2955;5771591;1743489;847;0;0
FR;2;2021-12-12;1256;7119;59116;83;1015;65170;12;0;0;5779550;5486440;1545512;3038;5772606;1808659;859;0;0
FR;2;2021-12-13;5530;26812;220731;605;5224;243028;159;0;0;5785080;5513252;1766243;3643;5777830;2051687;1018;0;0
FR;2;2021-12-14;7019;37457;300806;909;6136;332277;190;0;0;5792099;5550709;2067049;4552;5783966;2383964;1208;0;0
FR;2;2021-12-15;6555;36214;285263;958;5866;315900;186;0;0;5798654;5586923;2352312;5510;5789832;2699864;1394;0;0
FR;2;2021-12-16;7765;37921;312177;982;6566;343816;186;0;0;5806419;5624844;2664489;6492;5796398;3043680;1580;0;0
FR;2;2021-12-17;8681;41189;327909;976;8019;360988;232;0;0;5815100;5666033;2992398;7468;5804417;3404668;1812;0;0
FR;2;2021-12-18;6514;26530;212374;448;4904;233676;120;0;0;5821614;5692563;3204772;7916;5809321;3638344;1932;0;0
FR;2;2021-12-19;2603;11403;90226;182;1655;100356;26;0;0;5824217;5703966;3294998;8098;5810976;3738700;1958;0;0
FR;2;2021-12-20;9548;33517;275258;707;6588;303404;209;0;0;5833765;5737483;3570256;8805;5817564;4042104;2167;0;0
FR;2;2021-12-21;11566;38270;309662;968;7370;341437;262;0;0;5845331;5775753;3879918;9773;5824934;4383541;2429;0;0
FR;2;2021-12-22;10461;32776;265146;952;6442;292502;316;0;1;5855792;5808529;4145064;10725;5831376;4676043;2745;0;1
FR;2;2021-12-23;9426;26618;199534;701;5874;221292;225;0;0;5865218;5835147;4344598;11426;5837250;4897335;2970;0;1
FR;2;2021-12-24;2783;7466;43866;140;2036;49561;78;0;0;5868001;5842613;4388464;11566;5839286;4946896;3048;0;1
FR;2;2021-12-25;201;671;2003;10;209;2478;15;0;0;5868202;5843284;4390467;11576;5839495;4949374;3063;0;1
FR;2;2021-12-26;1320;4215;25161;71;1052;28693;70;0;0;5869522;5847499;4415628;11647;5840547;4978067;3133;0;1
FR;2;2021-12-27;8076;29928;218436;659;6623;243387;294;0;0;5877598;5877427;4634064;12306;5847170;5221454;3427;0;1
FR;2;2021-12-28;9832;36287;272116;742;6982;302014;957;0;1;5887430;5913714;4906180;13048;5854152;5523468;4384;0;2
FR;2;2021-12-29;9498;32217;246150;765;6402;272695;1088;0;0;5896928;5945931;5152330;13813;5860554;5796163;5472;0;2
FR;2;2021-12-30;9464;28093;208838;663;5972;231478;1155;0;0;5906392;5974024;5361168;14476;5866526;6027641;6627;0;2
FR;2;2021-12-31;3011;8342;54991;176;2170;61234;392;0;0;5909403;5982366;5416159;14652;5868696;6088875;7019;0;2
FR;2;2022-01-01;231;693;2858;7;207;3353;29;0;0;5909634;5983059;5419017;14659;5868903;6092228;7048;0;2
FR;2;2022-01-02;1503;4853;29524;76;1165;33413;217;0;0;5911137;5987912;5448541;14735;5870068;6125641;7265;0;2
FR;2;2022-01-03;9606;35396;266544;806;8497;293922;1672;0;0;5920743;6023308;5715085;15541;5878565;6419563;8937;0;2
FR;2;2022-01-04;12856;45400;342102;1068;9971;377040;2458;0;1;5933599;6068708;6057187;16609;5888536;6796603;11395;0;3
FR;2;2022-01-05;11273;38630;294222;884;8635;323859;2154;0;2;5944872;6107338;6351409;17493;5897171;7120462;13549;0;5
FR;2;2022-01-06;13653;43490;331957;1298;9934;364769;2977;0;1;5958525;6150828;6683366;18791;5907105;7485231;16526;0;6
FR;2;2022-01-07;14224;47608;361123;1271;11229;396468;3159;0;0;5972749;6198436;7044489;20062;5918334;7881699;19685;0;6
FR;2;2022-01-08;7946;28136;201273;515;7209;221702;1528;0;2;5980695;6226572;7245762;20577;5925543;8103401;21213;0;8
FR;2;2022-01-09;2749;8948;62531;137;2070;69498;493;0;0;5983444;6235520;7308293;20714;5927613;8172899;21706;0;8
FR;2;2022-01-10;10100;31907;232510;859;8902;255085;2460;0;0;5993544;6267427;7540803;21573;5936515;8427984;24166;0;8
FR;2;2022-01-11;11466;36236;265945;1030;10056;290651;3380;0;1;6005010;6303663;7806748;22603;5946571;8718635;27546;0;9
FR;2;2022-01-12;8766;29783;206336;863;8714;226176;2798;0;5;6013776;6333446;8013084;23466;5955285;8944811;30344;0;14
FR;2;2022-01-13;9387;31334;224510;831;9038;244857;3463;0;4;6023163;6364780;8237594;24297;5964323;9189668;33807;0;18
FR;2;2022-01-14;9744;35576;254550;920;9842;277654;3979;0;1;6032907;6400356;8492144;25217;5974165;9467322;37786;0;19
FR;2;2022-01-15;5361;19443;140786;363;5320;153646;1929;0;0;6038268;6419799;8632930;25580;5979485;9620968;39715;0;19
FR;2;2022-01-16;1512;5457;35893;81;1619;39819;424;0;0;6039780;6425256;8668823;25661;5981104;9660787;40139;0;19
FR;2;2022-01-17;5546;19261;135421;601;6599;147261;2264;0;2;6045326;6444517;8804244;26262;5987703;9808048;42403;0;21
FR;2;2022-01-18;6422;21479;148647;647;7518;160470;3311;0;0;6051748;6465996;8952891;26909;5995221;9968518;45714;0;21
FR;2;2022-01-19;4398;16304;105112;552;6206;113702;2411;0;1;6056146;6482300;9058003;27461;6001427;10082220;48125;0;22
FR;2;2022-01-20;4873;17573;115304;603;7068;123695;3111;0;2;6061019;6499873;9173307;28064;6008495;10205915;51236;0;24
FR;2;2022-01-21;5198;20043;137356;679;7169;147776;3455;0;1;6066217;6519916;9310663;28743;6015664;10353691;54691;0;25
FR;2;2022-01-22;3033;10956;74264;260;3956;80338;1428;0;0;6069250;6530872;9384927;29003;6019620;10434029;56119;0;25
FR;2;2022-01-23;724;2707;15243;41;1055;16826;238;0;0;6069974;6533579;9400170;29044;6020675;10450855;56357;0;25
FR;2;2022-01-24;3292;12792;75084;431;5842;81019;1994;0;2;6073266;6546371;9475254;29475;6026517;10531874;58351;0;27
FR;2;2022-01-25;3575;14405;79636;496;6649;85462;2879;0;4;6076841;6560776;9554890;29971;6033166;10617336;61230;0;31
FR;2;2022-01-26;2515;10701;58986;363;5332;63034;1958;0;1;6079356;6571477;9613876;30334;6038498;10680370;63188;0;32
FR;2;2022-01-27;2684;11387;64185;391;5740;67971;2462;0;1;6082040;6582864;9678061;30725;6044238;10748341;65650;0;33
FR;2;2022-01-28;3551;18259;91730;430;8612;98908;3399;0;1;6085591;6601123;9769791;31155;6052850;10847249;69049;0;34
FR;2;2022-01-29;1896;9233;48856;164;4169;52929;1374;0;1;6087487;6610356;9818647;31319;6057019;10900178;70423;0;35
FR;2;2022-01-30;464;2208;9457;38;1052;10585;203;0;0;6087951;6612564;9828104;31357;6058071;10910763;70626;0;35
FR;2;2022-01-31;1891;9552;43834;209;4710;47322;1886;0;2;6089842;6622116;9871938;31566;6062781;10958085;72512;0;37
FR;2;2022-02-01;1916;10020;47030;279;4797;50080;2707;0;0;6091758;6632136;9918968;31845;6067578;11008165;75219;0;37
FR;2;2022-02-02;1614;8972;41124;250;4191;44148;2189;0;1;6093372;6641108;9960092;32095;6071769;11052313;77408;0;38
FR;2;2022-02-03;1732;8929;40526;205;4370;42910;2640;0;2;6095104;6650037;10000618;32300;6076139;11095223;80048;0;40
FR;2;2022-02-04;2151;15168;66649;299;7382;71317;3670;0;1;6097255;6665205;10067267;32599;6083521;11166540;83718;0;41
FR;2;2022-02-05;1360;8519;35948;132;4214;39222;1369;0;0;6098615;6673724;10103215;32731;6087735;11205762;85087;0;41
FR;2;2022-02-06;275;1761;6130;16;842;6899;217;0;0;6098890;6675485;10109345;32747;6088577;11212661;85304;0;41
FR;2;2022-02-07;1352;9544;37760;134;4535;41289;1888;0;2;6100242;6685029;10147105;32881;6093112;11253950;87192;0;43
FR;2;2022-02-08;1299;9833;40956;173;4645;43750;2741;0;1;6101541;6694862;10188061;33054;6097757;11297700;89933;0;44
FR;2;2022-02-09;1160;8841;37040;174;3804;40465;1901;0;2;6102701;6703703;10225101;33228;6101561;11338165;91834;0;46
FR;2;2022-02-10;1030;8001;33837;204;3605;36511;2051;0;1;6103731;6711704;10258938;33432;6105166;11374676;93885;0;47
FR;2;2022-02-11;1391;12086;53348;223;5282;57701;2888;0;0;6105122;6723790;10312286;33655;6110448;11432377;96773;0;47
FR;2;2022-02-12;753;6535;27989;86;2792;30808;1113;0;2;6105875;6730325;10340275;33741;6113240;11463185;97886;0;49
FR;2;2022-02-13;200;1340;4836;20;562;5577;141;0;0;6106075;6731665;10345111;33761;6113802;11468762;98027;0;49
FR;2;2022-02-14;836;6732;30274;91;2599;33233;1398;0;1;6106911;6738397;10375385;33852;6116401;11501995;99425;0;50
FR;2;2022-02-15;774;6473;28051;140;2801;29994;1965;0;2;6107685;6744870;10403436;33992;6119202;11531989;101390;0;52
FR;2;2022-02-16;657;5363;22069;124;2529;23635;1569;0;3;6108342;6750233;10425505;34116;6121731;11555624;102959;0;55
FR;2;2022-02-17;518;3786;14152;98;2131;14617;1406;0;2;6108860;6754019;10439657;34214;6123862;11570241;104365;0;57
FR;2;2022-02-18;723;5368;20443;134;3040;21130;1895;0;0;6109583;6759387;10460100;34348;6126902;11591371;106260;0;57
FR;2;2022-02-19;431;3061;10533;66;1699;11247;753;0;2;6110014;6762448;10470633;34414;6128601;11602618;107013;0;59
FR;2;2022-02-20;102;520;1463;3;314;1613;100;0;0;6110116;6762968;10472096;34417;6128915;11604231;107113;0;59
FR;2;2022-02-21;423;2685;9122;65;1569;9499;930;0;0;6110539;6765653;10481218;34482;6130484;11613730;108043;0;59
FR;2;2022-02-22;393;2568;8894;77;1622;8797;1180;0;0;6110932;6768221;10490112;34559;6132106;11622527;109223;0;59
FR;2;2022-02-23;432;2605;8992;82;1522;9269;1022;0;0;6111364;6770826;10499104;34641;6133628;11631796;110245;0;59
FR;2;2022-02-24;314;2039;6805;82;1251;6835;870;0;0;6111678;6772865;10505909;34723;6134879;11638631;111115;0;59
FR;2;2022-02-25;456;3210;11423;107;1979;11286;1560;0;3;6112134;6776075;10517332;34830;6136858;11649917;112675;0;62
FR;2;2022-02-26;297;1892;6038;49;1161;6345;587;0;1;6112431;6777967;10523370;34879;6138019;11656262;113262;0;63
FR;2;2022-02-27;76;313;907;5;214;950;98;0;0;6112507;6778280;10524277;34884;6138233;11657212;113360;0;63
FR;2;2022-02-28;332;1689;5525;53;1088;5531;733;0;0;6112839;6779969;10529802;34937;6139321;11662743;114093;0;63
FR;2;2022-03-01;279;1569;5484;46;952;5201;964;0;2;6113118;6781538;10535286;34983;6140273;11667944;115057;0;65
FR;2;2022-03-02;298;1446;5248;45;878;5092;815;0;1;6113416;6782984;10540534;35028;6141151;11673036;115872;0;66
FR;2;2022-03-03;226;1112;3709;42;721;3486;668;0;1;6113642;6784096;10544243;35070;6141872;11676522;116540;0;67
FR;2;2022-03-04;243;1469;4860;74;983;4506;950;0;1;6113885;6785565;10549103;35144;6142855;11681028;117490;0;68
FR;2;2022-03-05;174;906;2981;34;613;2725;561;0;0;6114059;6786471;10552084;35178;6143468;11683753;118051;0;68
FR;2;2022-03-06;42;188;280;5;110;320;52;0;0;6114101;6786659;10552364;35183;6143578;11684073;118103;0;68
FR;2;2022-03-07;157;659;1988;70;491;1778;472;0;0;6114258;6787318;10554352;35253;6144069;11685851;118575;0;68
FR;2;2022-03-08;144;670;2273;53;461;1908;619;0;0;6114402;6787988;10556625;35306;6144530;11687759;119194;0;68
FR;2;2022-03-09;156;709;2351;37;473;2052;617;0;0;6114558;6788697;10558976;35343;6145003;11689811;119811;0;68
FR;2;2022-03-10;123;603;1695;35;446;1470;456;0;1;6114681;6789300;10560671;35378;6145449;11691281;120267;0;69
FR;2;2022-03-11;172;757;2770;57;505;2369;737;0;1;6114853;6790057;10563441;35435;6145954;11693650;121004;0;70
FR;2;2022-03-12;149;485;1787;27;331;1557;450;0;0;6115002;6790542;10565228;35462;6146285;11695207;121454;0;70
FR;2;2022-03-13;25;75;203;30;45;204;69;0;0;6115027;6790617;10565431;35492;6146330;11695411;121523;0;70
FR;2;2022-03-14;129;470;1572;529;333;1301;951;0;0;6115156;6791087;10567003;36021;6146663;11696712;122474;0;70
FR;2;2022-03-15;139;441;1713;691;333;1333;1186;0;1;6115295;6791528;10568716;36712;6146996;11698045;123660;0;71
FR;2;2022-03-16;142;476;2013;1616;331;1593;2160;0;2;6115437;6792004;10570729;38328;6147327;11699638;125820;0;73
FR;2;2022-03-17;95;413;1412;1192;273;1148;1576;0;1;6115532;6792417;10572141;39520;6147600;11700786;127396;0;74
FR;2;2022-03-18;147;496;2025;1795;335;1668;2313;0;1;6115679;6792913;10574166;41315;6147935;11702454;129709;0;75
FR;2;2022-03-19;108;321;1210;941;219;1015;1259;0;0;6115787;6793234;10575376;42256;6148154;11703469;130968;0;75
FR;2;2022-03-20;13;77;191;59;39;168;115;0;0;6115800;6793311;10575567;42315;6148193;11703637;131083;0;75
FR;2;2022-03-21;98;307;1218;1483;181;1081;1760;0;1;6115898;6793618;10576785;43798;6148374;11704718;132843;0;76
FR;2;2022-03-22;118;391;1533;1830;244;1294;2219;0;0;6116016;6794009;10578318;45628;6148618;11706012;135062;0;76
FR;2;2022-03-23;137;362;1679;3032;232;1475;3374;0;6;6116153;6794371;10579997;48660;6148850;11707487;138436;0;82
FR;2;2022-03-24;117;293;1183;1548;186;1001;1814;0;8;6116270;6794664;10581180;50208;6149036;11708488;140250;0;90
FR;2;2022-03-25;119;361;1807;2451;238;1477;2837;0;8;6116389;6795025;10582987;52659;6149274;11709965;143087;0;98
FR;2;2022-03-26;79;247;1205;1222;138;953;1531;0;5;6116468;6795272;10584192;53881;6149412;11710918;144618;0;103
FR;2;2022-03-27;19;36;154;100;19;133;144;0;0;6116487;6795308;10584346;53981;6149431;11711051;144762;0;103
FR;2;2022-03-28;94;290;1139;1602;189;995;1835;0;6;6116581;6795598;10585485;55583;6149620;11712046;146597;0;109
FR;2;2022-03-29;108;258;1325;2467;167;1105;2760;0;4;6116689;6795856;10586810;58050;6149787;11713151;149357;0;113
FR;2;2022-03-30;91;312;1489;3185;163;1320;3422;0;2;6116780;6796168;10588299;61235;6149950;11714471;152779;0;115
FR;2;2022-03-31;104;284;1277;2332;171;1092;2616;0;3;6116884;6796452;10589576;63567;6150121;11715563;155395;0;118
FR;2;2022-04-01;123;324;1568;2349;164;1323;2667;0;7;6117007;6796776;10591144;65916;6150285;11716886;158062;0;125
FR;2;2022-04-02;81;161;845;891;83;737;1052;0;1;6117088;6796937;10591989;66807;6150368;11717623;159114;0;126
FR;2;2022-04-03;16;53;128;113;27;142;133;0;1;6117104;6796990;10592117;66920;6150395;11717765;159247;0;127
FR;2;2022-04-04;114;249;990;1447;151;799;1693;0;5;6117218;6797239;10593107;68367;6150546;11718564;160940;0;132
FR;2;2022-04-05;143;302;1322;2920;162;1150;3149;0;17;6117361;6797541;10594429;71287;6150708;11719714;164089;0;149
FR;2;2022-04-06;89;261;1308;2523;129;1131;2688;0;10;6117450;6797802;10595737;73810;6150837;11720845;166777;0;159
FR;2;2022-04-07;120;230;1303;2682;141;1042;2958;0;8;6117570;6798032;10597040;76492;6150978;11721887;169735;0;167
FR;2;2022-04-08;126;346;1636;3351;182;1328;3642;0;12;6117696;6798378;10598676;79843;6151160;11723215;173377;0;179
FR;2;2022-04-09;90;219;900;1046;144;732;1288;0;4;6117786;6798597;10599576;80889;6151304;11723947;174665;0;183
FR;2;2022-04-10;37;49;143;162;46;119;200;0;1;6117823;6798646;10599719;81051;6151350;11724066;174865;0;184
FR;2;2022-04-11;88;196;892;1560;122;782;1718;0;6;6117911;6798842;10600611;82611;6151472;11724848;176583;0;190
FR;2;2022-04-12;176;273;1183;2770;175;1062;2903;0;8;6118087;6799115;10601794;85381;6151647;11725910;179486;0;198
FR;2;2022-04-13;147;232;1125;2477;111;989;2671;0;11;6118234;6799347;10602919;87858;6151758;11726899;182157;0;209
FR;2;2022-04-14;115;227;1085;2677;114;919;2911;0;18;6118349;6799574;10604004;90535;6151872;11727818;185068;0;227
FR;2;2022-04-15;114;261;1221;2304;131;1078;2544;0;7;6118463;6799835;10605225;92839;6152003;11728896;187612;0;234
FR;2;2022-04-16;67;108;548;549;68;459;675;0;9;6118530;6799943;10605773;93388;6152071;11729355;188287;0;243
FR;2;2022-04-17;15;27;57;53;16;53;71;0;0;6118545;6799970;10605830;93441;6152087;11729408;188358;0;243
FR;2;2022-04-18;12;35;121;70;18;116;95;0;0;6118557;6800005;10605951;93511;6152105;11729524;188453;0;243
FR;2;2022-04-19;112;237;1120;1750;149;951;1934;0;9;6118669;6800242;10607071;95261;6152254;11730475;190387;0;252
FR;2;2022-04-20;95;243;1110;2172;127;934;2366;0;14;6118764;6800485;10608181;97433;6152381;11731409;192753;0;266
FR;2;2022-04-21;111;233;983;1912;125;838;2141;0;10;6118875;6800718;10609164;99345;6152506;11732247;194894;0;276
FR;2;2022-04-22;100;276;1242;2102;141;1023;2440;0;11;6118975;6800994;10610406;101447;6152647;11733270;197334;0;287
FR;2;2022-04-23;67;156;645;762;107;574;862;0;8;6119042;6801150;10611051;102209;6152754;11733844;198196;0;295
FR;2;2022-04-24;12;30;101;68;12;79;100;0;0;6119054;6801180;10611152;102277;6152766;11733923;198296;0;295
FR;2;2022-04-25;104;204;822;1329;103;711;1528;0;15;6119158;6801384;10611974;103606;6152869;11734634;199824;0;310
FR;2;2022-04-26;110;184;1041;2022;118;879;2219;0;18;6119268;6801568;10613015;105628;6152987;11735513;202043;0;328
FR;2;2022-04-27;98;181;860;1786;122;764;1808;0;7;6119366;6801749;10613875;107414;6153109;11736277;203851;0;335
FR;2;2022-04-28;93;214;949;1931;128;842;2087;0;12;6119459;6801963;10614824;109345;6153237;11737119;205938;0;347
FR;2;2022-04-29;81;282;1133;1697;131;1044;1876;0;11;6119540;6802245;10615957;111042;6153368;11738163;207814;0;358
FR;2;2022-04-30;66;127;471;540;80;430;628;0;9;6119606;6802372;10616428;111582;6153448;11738593;208442;0;367
FR;2;2022-05-01;24;24;84;49;20;85;61;0;1;6119630;6802396;10616512;111631;6153468;11738678;208503;0;368
FR;2;2022-05-02;115;232;763;1217;141;661;1375;0;5;6119745;6802628;10617275;112848;6153609;11739339;209878;0;373
FR;2;2022-05-03;152;233;999;1781;156;938;1895;0;14;6119897;6802861;10618274;114629;6153765;11740277;211773;0;387
FR;2;2022-05-04;90;226;926;1811;116;869;1822;0;13;6119987;6803087;10619200;116440;6153881;11741146;213595;0;400
FR;2;2022-05-05;127;198;856;1732;147;773;1848;0;10;6120114;6803285;10620056;118172;6154028;11741919;215443;0;410
FR;2;2022-05-06;133;246;1100;1855;139;1016;2052;0;16;6120247;6803531;10621156;120027;6154167;11742935;217495;0;426
FR;2;2022-05-07;40;99;470;504;61;406;593;0;4;6120287;6803630;10621626;120531;6154228;11743341;218088;0;430
FR;2;2022-05-08;48;54;107;71;41;102;101;0;0;6120335;6803684;10621733;120602;6154269;11743443;218189;0;430
FR;2;2022-05-09;101;174;654;986;103;604;1130;0;9;6120436;6803858;10622387;121588;6154372;11744047;219319;0;439
FR;2;2022-05-10;121;252;938;1841;155;893;1965;0;23;6120557;6804110;10623325;123429;6154527;11744940;221284;0;462
FR;2;2022-05-11;103;179;814;1879;117;793;1868;0;8;6120660;6804289;10624139;125308;6154644;11745733;223152;0;470
FR;2;2022-05-12;111;174;845;2096;116;803;2213;0;21;6120771;6804463;10624984;127404;6154760;11746536;225365;0;491
FR;2;2022-05-13;100;236;969;2097;122;900;2273;0;13;6120871;6804699;10625953;129501;6154882;11747436;227638;0;504
FR;2;2022-05-14;76;124;451;553;93;411;632;0;6;6120947;6804823;10626404;130054;6154975;11747847;228270;0;510
FR;2;2022-05-15;24;39;94;88;20;108;95;0;1;6120971;6804862;10626498;130142;6154995;11747955;228365;0;511
FR;2;2022-05-16;102;170;601;925;115;537;1037;0;11;6121073;6805032;10627099;131067;6155110;11748492;229402;0;522
FR;2;2022-05-17;95;184;690;1687;119;658;1739;0;8;6121168;6805216;10627789;132754;6155229;11749150;231141;0;530
FR;2;2022-05-18;80;181;643;1431;97;648;1486;0;10;6121248;6805397;10628432;134185;6155326;11749798;232627;0;540
FR;2;2022-05-19;73;161;709;1830;81;751;1816;0;12;6121321;6805558;10629141;136015;6155407;11750549;234443;0;552
FR;2;2022-05-20;107;181;874;1701;111;779;1849;0;17;6121428;6805739;10630015;137716;6155518;11751328;236292;0;569
FR;2;2022-05-21;48;96;398;517;71;339;581;0;8;6121476;6805835;10630413;138233;6155589;11751667;236873;0;577
FR;2;2022-05-22;8;23;69;37;18;57;56;0;0;6121484;6805858;10630482;138270;6155607;11751724;236929;0;577
FR;2;2022-05-23;86;133;498;931;100;469;967;0;7;6121570;6805991;10630980;139201;6155707;11752193;237896;0;584
FR;2;2022-05-24;87;164;627;1626;103;615;1680;0;17;6121657;6806155;10631607;140827;6155810;11752808;239576;0;601
FR;2;2022-05-25;72;146;539;1149;90;494;1260;0;5;6121729;6806301;10632146;141976;6155900;11753302;240836;0;606
FR;2;2022-05-26;12;31;77;45;13;85;56;0;1;6121741;6806332;10632223;142021;6155913;11753387;240892;0;607
FR;2;2022-05-27;44;124;456;818;68;438;893;0;9;6121785;6806456;10632679;142839;6155981;11753825;241785;0;616
FR;2;2022-05-28;28;60;221;244;29;221;266;0;1;6121813;6806516;10632900;143083;6156010;11754046;242051;0;617
FR;2;2022-05-29;13;34;43;25;22;51;28;0;0;6121826;6806550;10632943;143108;6156032;11754097;242079;0;617
FR;2;2022-05-30;65;109;425;755;60;410;806;0;6;6121891;6806659;10633368;143863;6156092;11754507;242885;0;623
FR;2;2022-05-31;76;135;564;1278;92;511;1304;0;12;6121967;6806794;10633932;145141;6156184;11755018;244189;0;635
FR;2;2022-06-01;59;160;564;1075;86;543;1170;0;6;6122026;6806954;10634496;146216;6156270;11755561;245359;0;641
FR;2;2022-06-02;92;178;626;1414;109;593;1520;0;12;6122118;6807132;10635122;147630;6156379;11756154;246879;0;653
FR;2;2022-06-03;71;157;668;1605;96;595;1694;0;19;6122189;6807289;10635790;149235;6156475;11756749;248573;0;672
FR;2;2022-06-04;69;93;283;434;66;269;476;0;11;6122258;6807382;10636073;149669;6156541;11757018;249049;0;683
FR;2;2022-06-05;12;17;63;58;16;47;75;0;1;6122270;6807399;10636136;149727;6156557;11757065;249124;0;684
FR;2;2022-06-06;12;40;93;76;29;92;81;0;4;6122282;6807439;10636229;149803;6156586;11757157;249205;0;688
FR;2;2022-06-07;99;222;667;1535;154;577;1661;0;10;6122381;6807661;10636896;151338;6156740;11757734;250866;0;698
FR;2;2022-06-08;70;119;476;1166;76;411;1262;0;5;6122451;6807780;10637372;152504;6156816;11758145;252128;0;703
FR;2;2022-06-09;93;166;613;1923;107;571;1927;0;18;6122544;6807946;10637985;154427;6156923;11758716;254055;0;721
FR;2;2022-06-10;93;168;650;1683;107;622;1774;0;23;6122637;6808114;10638635;156110;6157030;11759338;255829;0;744
FR;2;2022-06-11;44;85;287;529;42;258;583;0;5;6122681;6808199;10638922;156639;6157072;11759596;256412;0;749
FR;2;2022-06-12;18;38;58;78;27;60;78;0;0;6122699;6808237;10638980;156717;6157099;11759656;256490;0;749
FR;2;2022-06-13;39;121;395;953;63;379;1021;0;6;6122738;6808358;10639375;157670;6157162;11760035;257511;0;755
FR;2;2022-06-14;68;157;599;2088;101;537;2189;0;14;6122806;6808515;10639974;159758;6157263;11760572;259700;0;769
FR;2;2022-06-15;78;104;522;1504;84;444;1641;0;10;6122884;6808619;10640496;161262;6157347;11761016;261341;0;779
FR;2;2022-06-16;127;128;497;1411;123;424;1526;0;12;6123011;6808747;10640993;162673;6157470;11761440;262867;0;791
FR;2;2022-06-17;73;138;589;1817;88;516;1921;0;16;6123084;6808885;10641582;164490;6157558;11761956;264788;0;807
FR;2;2022-06-18;76;93;224;579;81;196;630;0;4;6123160;6808978;10641806;165069;6157639;11762152;265418;0;811
FR;2;2022-06-19;11;17;53;71;7;41;90;0;2;6123171;6808995;10641859;165140;6157646;11762193;265508;0;813
FR;2;2022-06-20;62;125;401;1028;72;392;1105;0;10;6123233;6809120;10642260;166168;6157718;11762585;266613;0;823
FR;2;2022-06-21;108;116;526;2127;105;455;2164;0;22;6123341;6809236;10642786;168295;6157823;11763040;268777;0;845
FR;2;2022-06-22;39;110;462;1889;57;415;1971;0;25;6123380;6809346;10643248;170184;6157880;11763455;270748;0;870
FR;2;2022-06-23;58;109;537;2282;68;452;2400;0;30;6123438;6809455;10643785;172466;6157948;11763907;273148;0;900
FR;2;2022-06-24;66;122;709;3199;65;571;3339;0;38;6123504;6809577;10644494;175665;6158013;11764478;276487;0;938
FR;2;2022-06-25;30;90;298;988;55;254;1041;0;13;6123534;6809667;10644792;176653;6158068;11764732;277528;0;951
FR;2;2022-06-26;30;27;131;194;29;97;236;0;5;6123564;6809694;10644923;176847;6158097;11764829;277764;0;956
FR;2;2022-06-27;79;137;582;2490;94;483;2623;0;39;6123643;6809831;10645505;179337;6158191;11765312;280387;0;995
FR;2;2022-06-28;110;140;812;4817;81;650;4894;0;54;6123753;6809971;10646317;184154;6158272;11765962;285281;0;1049
FR;2;2022-06-29;73;150;776;4436;80;637;4532;0;56;6123826;6810121;10647093;188590;6158352;11766599;289813;0;1105
FR;2;2022-06-30;72;133;834;5177;71;619;5398;0;79;6123898;6810254;10647927;193767;6158423;11767218;295211;0;1184
FR;2;2022-07-01;113;161;1152;6692;95;853;6944;0;92;6124011;6810415;10649079;200459;6158518;11768071;302155;0;1276
FR;2;2022-07-02;69;132;474;1977;82;392;2068;0;27;6124080;6810547;10649553;202436;6158600;11768463;304223;0;1303
FR;2;2022-07-03;23;30;147;334;21;131;357;0;8;6124103;6810577;10649700;202770;6158621;11768594;304580;0;1311
FR;2;2022-07-04;122;184;775;3785;113;612;3971;0;49;6124225;6810761;10650475;206555;6158734;11769206;308551;0;1360
FR;2;2022-07-05;119;187;1121;6818;121;828;6999;0;85;6124344;6810948;10651596;213373;6158855;11770034;315550;0;1445
FR;2;2022-07-06;92;152;951;5807;94;698;5933;0;84;6124436;6811100;10652547;219180;6158949;11770732;321483;0;1529
FR;2;2022-07-07;81;185;1021;6501;116;752;6732;0;101;6124517;6811285;10653568;225681;6159065;11771484;328215;0;1630
FR;2;2022-07-08;65;122;1095;7044;51;758;7235;0;123;6124582;6811407;10654663;232725;6159116;11772242;335450;0;1753
FR;2;2022-07-09;34;62;417;1869;31;299;1919;0;33;6124616;6811469;10655080;234594;6159147;11772541;337369;0;1786
FR;2;2022-07-10;7;17;97;315;8;83;327;0;5;6124623;6811486;10655177;234909;6159155;11772624;337696;0;1791
FR;2;2022-07-11;68;121;683;3826;76;541;3901;0;67;6124691;6811607;10655860;238735;6159231;11773165;341597;0;1858
FR;2;2022-07-12;102;180;1054;6517;107;809;6725;0;119;6124793;6811787;10656914;245252;6159338;11773974;348322;0;1977
FR;2;2022-07-13;65;127;879;4664;75;591;4830;0;78;6124858;6811914;10657793;249916;6159413;11774565;353152;0;2055
FR;2;2022-07-14;6;13;89;250;8;60;269;0;8;6124864;6811927;10657882;250166;6159421;11774625;353421;0;2063
FR;2;2022-07-15;61;129;739;3794;53;560;3960;0;75;6124925;6812056;10658621;253960;6159474;11775185;357381;0;2138
FR;2;2022-07-16;27;54;289;1031;30;242;1077;0;25;6124952;6812110;10658910;254991;6159504;11775427;358458;0;2163
FR;2;2022-07-17;5;12;78;201;6;67;207;0;6;6124957;6812122;10658988;255192;6159510;11775494;358665;0;2169
FR;2;2022-07-18;57;103;514;2510;61;385;2648;0;59;6125014;6812225;10659502;257702;6159571;11775879;361313;0;2228
FR;2;2022-07-19;66;133;770;4258;72;555;4447;0;72;6125080;6812358;10660272;261960;6159643;11776434;365760;0;2300
FR;2;2022-07-20;59;117;582;3179;68;430;3278;0;87;6125139;6812475;10660854;265139;6159711;11776864;369038;0;2387
FR;2;2022-07-21;60;110;673;3680;73;487;3797;0;105;6125199;6812585;10661527;268819;6159784;11777351;372835;0;2492
FR;2;2022-07-22;51;100;700;3550;48;507;3701;0;80;6125250;6812685;10662227;272369;6159832;11777858;376536;0;2572
FR;2;2022-07-23;38;97;290;1175;51;229;1228;0;37;6125288;6812782;10662517;273544;6159883;11778087;377764;0;2609
FR;2;2022-07-24;14;24;69;201;19;68;203;0;7;6125302;6812806;10662586;273745;6159902;11778155;377967;0;2616
FR;2;2022-07-25;50;71;405;1938;60;300;2000;0;56;6125352;6812877;10662991;275683;6159962;11778455;379967;0;2672
FR;2;2022-07-26;57;133;606;3423;67;476;3496;0;113;6125409;6813010;10663597;279106;6160029;11778931;383463;0;2785
FR;2;2022-07-27;42;81;457;2782;50;361;2801;0;89;6125451;6813091;10664054;281888;6160079;11779292;386264;0;2874
FR;2;2022-07-28;29;75;450;2487;36;357;2491;0;78;6125480;6813166;10664504;284375;6160115;11779649;388755;0;2952
FR;2;2022-07-29;68;88;535;2857;63;347;2978;0;73;6125548;6813254;10665039;287232;6160178;11779996;391733;0;3025
FR;2;2022-07-30;22;39;163;776;32;110;796;0;24;6125570;6813293;10665202;288008;6160210;11780106;392529;0;3049
FR;2;2022-07-31;6;13;27;104;12;21;110;0;2;6125576;6813306;10665229;288112;6160222;11780127;392639;0;3051
FR;2;2022-08-01;38;106;323;1261;73;260;1343;0;29;6125614;6813412;10665552;289373;6160295;11780387;393982;0;3080
FR;2;2022-08-02;49;75;325;2061;50;247;2097;0;78;6125663;6813487;10665877;291434;6160345;11780634;396079;0;3158
FR;2;2022-08-03;29;53;259;1611;25;187;1617;0;57;6125692;6813540;10666136;293045;6160370;11780821;397696;0;3215
FR;2;2022-08-04;40;65;306;1692;39;240;1701;0;66;6125732;6813605;10666442;294737;6160409;11781061;399397;0;3281
FR;2;2022-08-05;33;94;328;1881;67;236;1912;0;60;6125765;6813699;10666770;296618;6160476;11781297;401309;0;3341
FR;2;2022-08-06;22;41;106;365;29;82;372;0;10;6125787;6813740;10666876;296983;6160505;11781379;401681;0;3351
FR;2;2022-08-07;7;8;15;69;5;16;71;0;3;6125794;6813748;10666891;297052;6160510;11781395;401752;0;3354
FR;2;2022-08-08;19;35;220;877;22;148;915;0;33;6125813;6813783;10667111;297929;6160532;11781543;402667;0;3387
FR;2;2022-08-09;29;52;279;1474;41;238;1470;0;50;6125842;6813835;10667390;299403;6160573;11781781;404137;0;3437
FR;2;2022-08-10;16;22;213;1134;19;150;1155;0;46;6125858;6813857;10667603;300537;6160592;11781931;405292;0;3483
FR;2;2022-08-11;21;41;174;1038;26;117;1047;0;40;6125879;6813898;10667777;301575;6160618;11782048;406339;0;3523
FR;2;2022-08-12;36;50;184;1046;38;140;1069;0;35;6125915;6813948;10667961;302621;6160656;11782188;407408;0;3558
FR;2;2022-08-13;11;19;47;149;15;53;137;0;5;6125926;6813967;10668008;302770;6160671;11782241;407545;0;3563
FR;2;2022-08-14;1;2;12;52;1;11;54;0;1;6125927;6813969;10668020;302822;6160672;11782252;407599;0;3564
FR;2;2022-08-15;0;5;32;22;2;21;21;0;3;6125927;6813974;10668052;302844;6160674;11782273;407620;0;3567
FR;2;2022-08-16;27;33;144;681;34;120;678;0;33;6125954;6814007;10668196;303525;6160708;11782393;408298;0;3600
FR;2;2022-08-17;18;27;109;738;18;88;744;0;34;6125972;6814034;10668305;304263;6160726;11782481;409042;0;3634
FR;2;2022-08-18;14;30;160;836;14;107;852;0;42;6125986;6814064;10668465;305099;6160740;11782588;409894;0;3676
FR;2;2022-08-19;8;38;118;706;31;88;706;0;33;6125994;6814102;10668583;305805;6160771;11782676;410600;0;3709
FR;2;2022-08-20;6;26;61;197;16;52;201;0;8;6126000;6814128;10668644;306002;6160787;11782728;410801;0;3717
FR;2;2022-08-21;4;14;15;19;6;13;31;0;0;6126004;6814142;10668659;306021;6160793;11782741;410832;0;3717
FR;2;2022-08-22;11;25;116;395;17;73;451;0;13;6126015;6814167;10668775;306416;6160810;11782814;411283;0;3730
FR;2;2022-08-23;11;42;134;671;23;112;679;0;38;6126026;6814209;10668909;307087;6160833;11782926;411962;0;3768
FR;2;2022-08-24;11;28;87;466;21;80;472;0;18;6126037;6814237;10668996;307553;6160854;11783006;412434;0;3786
FR;2;2022-08-25;8;32;109;481;16;69;516;0;17;6126045;6814269;10669105;308034;6160870;11783075;412950;0;3803
FR;2;2022-08-26;16;46;117;720;36;91;713;0;32;6126061;6814315;10669222;308754;6160906;11783166;413663;0;3835
FR;2;2022-08-27;10;19;47;158;16;42;166;0;2;6126071;6814334;10669269;308912;6160922;11783208;413829;0;3837
FR;2;2022-08-28;1;5;5;15;1;7;16;0;1;6126072;6814339;10669274;308927;6160923;11783215;413845;0;3838
FR;2;2022-08-29;24;43;94;400;29;88;396;0;24;6126096;6814382;10669368;309327;6160952;11783303;414241;0;3862
FR;2;2022-08-30;31;54;154;791;34;119;798;0;29;6126127;6814436;10669522;310118;6160986;11783422;415039;0;3891
FR;2;2022-08-31;19;37;85;392;24;79;393;0;25;6126146;6814473;10669607;310510;6161010;11783501;415432;0;3916
FR;2;2022-09-01;19;43;139;600;25;122;609;0;36;6126165;6814516;10669746;311110;6161035;11783623;416041;0;3952
FR;2;2022-09-02;34;57;147;744;34;160;748;0;32;6126199;6814573;10669893;311854;6161069;11783783;416789;0;3984
FR;2;2022-09-03;17;20;83;205;11;67;213;0;7;6126216;6814593;10669976;312059;6161080;11783850;417002;0;3991
FR;2;2022-09-04;8;5;9;31;2;10;30;0;3;6126224;6814598;10669985;312090;6161082;11783860;417032;0;3994
FR;2;2022-09-05;29;32;126;367;24;98;397;0;24;6126253;6814630;10670111;312457;6161106;11783958;417429;0;4018
FR;2;2022-09-06;44;63;158;761;43;153;767;0;36;6126297;6814693;10670269;313218;6161149;11784111;418196;0;4054
FR;2;2022-09-07;21;22;74;375;18;49;387;0;22;6126318;6814715;10670343;313593;6161167;11784160;418583;0;4076
FR;2;2022-09-08;31;58;109;636;41;100;646;0;22;6126349;6814773;10670452;314229;6161208;11784260;419229;0;4098
FR;2;2022-09-09;18;24;126;754;21;74;747;0;46;6126367;6814797;10670578;314983;6161229;11784334;419976;0;4144
FR;2;2022-09-10;14;24;57;117;16;48;131;0;4;6126381;6814821;10670635;315100;6161245;11784382;420107;0;4148
FR;2;2022-09-11;12;5;11;11;3;13;13;0;0;6126393;6814826;10670646;315111;6161248;11784395;420120;0;4148
FR;2;2022-09-12;20;31;70;340;26;56;352;0;16;6126413;6814857;10670716;315451;6161274;11784451;420472;0;4164
FR;2;2022-09-13;15;34;125;670;13;99;674;0;40;6126428;6814891;10670841;316121;6161287;11784550;421146;0;4204
FR;2;2022-09-14;19;23;81;480;20;60;478;0;36;6126447;6814914;10670922;316601;6161307;11784610;421624;0;4240
FR;2;2022-09-15;23;44;126;486;26;102;493;0;47;6126470;6814958;10671048;317087;6161333;11784712;422117;0;4287
FR;2;2022-09-16;22;31;124;563;17;89;585;0;39;6126492;6814989;10671172;317650;6161350;11784801;422702;0;4326
FR;2;2022-09-17;6;20;56;160;15;52;147;0;13;6126498;6815009;10671228;317810;6161365;11784853;422849;0;4339
FR;2;2022-09-18;4;7;13;37;6;10;37;0;3;6126502;6815016;10671241;317847;6161371;11784863;422886;0;4342
FR;2;2022-09-19;26;24;114;353;16;87;381;0;22;6126528;6815040;10671355;318200;6161387;11784950;423267;0;4364
FR;2;2022-09-20;29;27;117;624;21;84;639;0;38;6126557;6815067;10671472;318824;6161408;11785034;423906;0;4402
FR;2;2022-09-21;15;30;100;393;15;78;418;0;22;6126572;6815097;10671572;319217;6161423;11785112;424324;0;4424
FR;2;2022-09-22;19;39;124;581;18;95;619;0;28;6126591;6815136;10671696;319798;6161441;11785207;424943;0;4452
FR;2;2022-09-23;21;38;135;555;22;111;570;0;39;6126612;6815174;10671831;320353;6161463;11785318;425513;0;4491
FR;2;2022-09-24;10;8;52;190;8;37;201;0;6;6126622;6815182;10671883;320543;6161471;11785355;425714;0;4497
FR;2;2022-09-25;9;11;15;29;11;12;33;0;5;6126631;6815193;10671898;320572;6161482;11785367;425747;0;4502
FR;2;2022-09-26;22;41;116;447;27;79;458;0;20;6126653;6815234;10672014;321019;6161509;11785446;426205;0;4522
FR;2;2022-09-27;30;46;162;906;35;108;861;0;52;6126683;6815280;10672176;321925;6161544;11785554;427066;0;4574
FR;2;2022-09-28;15;31;93;421;18;74;439;0;23;6126698;6815311;10672269;322346;6161562;11785628;427505;0;4597
FR;2;2022-09-29;26;48;115;618;23;110;630;0;33;6126724;6815359;10672384;322964;6161585;11785738;428135;0;4630
FR;2;2022-09-30;25;44;111;520;44;84;533;0;31;6126749;6815403;10672495;323484;6161629;11785822;428668;0;4661
FR;2;2022-10-01;11;20;51;128;20;36;129;0;8;6126760;6815423;10672546;323612;6161649;11785858;428797;0;4669
FR;2;2022-10-02;0;5;8;21;4;5;25;0;2;6126760;6815428;10672554;323633;6161653;11785863;428822;0;4671
FR;2;2022-10-03;22;35;85;291;30;69;306;0;22;6126782;6815463;10672639;323924;6161683;11785932;429128;0;4693
FR;2;2022-10-04;17;21;106;601;19;71;620;0;46;6126799;6815484;10672745;324525;6161702;11786003;429748;0;4739
FR;2;2022-10-05;20;31;75;491;26;67;488;0;54;6126819;6815515;10672820;325016;6161728;11786070;430236;0;4793
FR;2;2022-10-06;30;23;74;442;17;71;428;0;65;6126849;6815538;10672894;325458;6161745;11786141;430664;0;4858
FR;2;2022-10-07;21;30;86;499;27;66;503;0;42;6126870;6815568;10672980;325957;6161772;11786207;431167;0;4900
FR;2;2022-10-08;12;8;24;114;3;25;108;0;12;6126882;6815576;10673004;326071;6161775;11786232;431275;0;4912
FR;2;2022-10-09;1;8;15;17;6;11;22;0;5;6126883;6815584;10673019;326088;6161781;11786243;431297;0;4917
FR;2;2022-10-10;18;25;47;223;23;49;218;0;21;6126901;6815609;10673066;326311;6161804;11786292;431515;0;4938
FR;2;2022-10-11;16;15;48;253;11;39;241;0;52;6126917;6815624;10673114;326564;6161815;11786331;431756;0;4990
FR;2;2022-10-12;9;20;52;290;16;36;305;0;56;6126926;6815644;10673166;326854;6161831;11786367;432061;0;5046
FR;2;2022-10-13;11;14;48;271;9;48;261;0;26;6126937;6815658;10673214;327125;6161840;11786415;432322;0;5072
FR;2;2022-10-14;13;29;36;230;17;40;231;0;29;6126950;6815687;10673250;327355;6161857;11786455;432553;0;5101
FR;2;2022-10-15;4;12;22;111;6;17;113;0;15;6126954;6815699;10673272;327466;6161863;11786472;432666;0;5116
FR;2;2022-10-16;0;7;4;11;6;7;8;0;1;6126954;6815706;10673276;327477;6161869;11786479;432674;0;5117
FR;2;2022-10-17;15;19;31;121;18;26;131;0;29;6126969;6815725;10673307;327598;6161887;11786505;432805;0;5146
FR;2;2022-10-18;13;12;68;185;6;34;247;0;46;6126982;6815737;10673375;327783;6161893;11786539;433052;0;5192
FR;2;2022-10-19;8;17;38;184;12;31;222;0;52;6126990;6815754;10673413;327967;6161905;11786570;433274;0;5244
FR;2;2022-10-20;11;29;41;200;15;40;196;0;52;6127001;6815783;10673454;328167;6161920;11786610;433470;0;5296
FR;2;2022-10-21;6;15;60;233;6;53;222;0;31;6127007;6815798;10673514;328400;6161926;11786663;433692;0;5327
FR;2;2022-10-22;8;7;25;102;2;23;103;0;20;6127015;6815805;10673539;328502;6161928;11786686;433795;0;5347
FR;2;2022-10-23;0;3;1;5;3;0;6;0;2;6127015;6815808;10673540;328507;6161931;11786686;433801;0;5349
FR;2;2022-10-24;12;12;16;110;12;16;113;0;20;6127027;6815820;10673556;328617;6161943;11786702;433914;0;5369
FR;2;2022-10-25;12;7;23;138;6;15;145;0;51;6127039;6815827;10673579;328755;6161949;11786717;434059;0;5420
FR;2;2022-10-26;4;3;17;90;2;11;96;0;27;6127043;6815830;10673596;328845;6161951;11786728;434155;0;5447
FR;2;2022-10-27;7;10;18;88;10;20;71;0;27;6127050;6815840;10673614;328933;6161961;11786748;434226;0;5474
FR;2;2022-10-28;5;3;15;91;3;7;92;0;27;6127055;6815843;10673629;329024;6161964;11786755;434318;0;5501
FR;2;2022-10-29;7;8;18;33;6;14;37;0;8;6127062;6815851;10673647;329057;6161970;11786769;434355;0;5509
FR;2;2022-10-30;3;7;5;8;5;2;5;0;1;6127065;6815858;10673652;329065;6161975;11786771;434360;0;5510
FR;2;2022-10-31;2;8;6;49;6;10;48;0;11;6127067;6815866;10673658;329114;6161981;11786781;434408;0;5521
FR;2;2022-11-01;0;5;8;1;5;5;4;0;0;6127067;6815871;10673666;329115;6161986;11786786;434412;0;5521
FR;2;2022-11-02;6;5;12;44;5;12;45;0;11;6127073;6815876;10673678;329159;6161991;11786798;434457;0;5532
FR;2;2022-11-03;6;7;16;77;6;10;75;0;18;6127079;6815883;10673694;329236;6161997;11786808;434532;0;5550
FR;2;2022-11-04;7;12;15;85;10;14;93;0;10;6127086;6815895;10673709;329321;6162007;11786822;434625;0;5560
FR;2;2022-11-05;0;11;13;38;6;17;35;0;6;6127086;6815906;10673722;329359;6162013;11786839;434660;0;5566
FR;2;2022-11-06;0;2;2;1;0;4;0;0;2;6127086;6815908;10673724;329360;6162013;11786843;434660;0;5568
FR;2;2022-11-07;13;8;15;67;6;14;66;0;20;6127099;6815916;10673739;329427;6162019;11786857;434726;0;5588
FR;2;2022-11-08;13;8;18;58;6;14;65;0;27;6127112;6815924;10673757;329485;6162025;11786871;434791;0;5615
FR;2;2022-11-09;4;5;17;56;2;17;50;0;28;6127116;6815929;10673774;329541;6162027;11786888;434841;0;5643
FR;2;2022-11-10;7;10;17;74;7;14;76;0;14;6127123;6815939;10673791;329615;6162034;11786902;434917;0;5657
FR;2;2022-11-11;0;3;9;3;0;10;4;0;0;6127123;6815942;10673800;329618;6162034;11786912;434921;0;5657
FR;2;2022-11-12;2;5;7;19;4;7;19;0;4;6127125;6815947;10673807;329637;6162038;11786919;434940;0;5661
FR;2;2022-11-13;3;2;4;2;1;5;1;0;0;6127128;6815949;10673811;329639;6162039;11786924;434941;0;5661
FR;2;2022-11-14;7;6;13;29;3;10;33;0;7;6127135;6815955;10673824;329668;6162042;11786934;434974;0;5668
FR;2;2022-11-15;8;15;15;35;16;18;32;0;7;6127143;6815970;10673839;329703;6162058;11786952;435006;0;5675
FR;2;2022-11-16;3;6;4;45;6;4;46;0;18;6127146;6815976;10673843;329748;6162064;11786956;435052;0;5693
FR;2;2022-11-17;2;6;12;56;5;9;55;0;22;6127148;6815982;10673855;329804;6162069;11786965;435107;0;5715
FR;2;2022-11-18;3;4;7;41;4;6;44;0;10;6127151;6815986;10673862;329845;6162073;11786971;435151;0;5725
FR;2;2022-11-19;3;3;2;25;3;3;18;0;5;6127154;6815989;10673864;329870;6162076;11786974;435169;0;5730
FR;2;2022-11-20;0;2;6;9;2;6;10;0;26;6127154;6815991;10673870;329879;6162078;11786980;435179;0;5756
FR;2;2022-11-21;6;10;9;31;7;8;34;0;22;6127160;6816001;10673879;329910;6162085;11786988;435213;0;5778
FR;2;2022-11-22;8;8;20;65;6;21;70;0;71;6127168;6816009;10673899;329975;6162091;11787009;435283;0;5849
FR;2;2022-11-23;7;6;8;68;3;5;73;0;8;6127175;6816015;10673907;330043;6162094;11787014;435356;0;5857
FR;2;2022-11-24;2;2;11;50;2;7;57;0;10;6127177;6816017;10673918;330093;6162096;11787021;435413;0;5867
FR;2;2022-11-25;11;8;14;25;11;14;26;0;8;6127188;6816025;10673932;330118;6162107;11787035;435439;0;5875
FR;2;2022-11-26;1;5;4;8;4;7;6;0;0;6127189;6816030;10673936;330126;6162111;11787042;435445;0;5875
FR;2;2022-11-27;2;2;12;2;0;11;4;0;1;6127191;6816032;10673948;330128;6162111;11787053;435449;0;5876
FR;2;2022-11-28;0;2;8;35;1;6;37;0;5;6127191;6816034;10673956;330163;6162112;11787059;435486;0;5881
FR;2;2022-11-29;1;1;10;24;0;4;30;0;8;6127192;6816035;10673966;330187;6162112;11787063;435516;0;5889
FR;2;2022-11-30;2;2;10;47;1;11;44;0;21;6127194;6816037;10673976;330234;6162113;11787074;435560;0;5910
FR;2;2022-12-01;2;12;6;63;9;13;55;0;24;6127196;6816049;10673982;330297;6162122;11787087;435615;0;5934
FR;2;2022-12-02;1;2;12;51;2;10;51;0;27;6127197;6816051;10673994;330348;6162124;11787097;435666;0;5961
FR;2;2022-12-03;1;3;8;19;1;8;18;0;10;6127198;6816054;10674002;330367;6162125;11787105;435684;0;5971
FR;2;2022-12-04;0;0;0;4;0;0;4;0;2;6127198;6816054;10674002;330371;6162125;11787105;435688;0;5973
FR;2;2022-12-05;3;5;8;51;8;4;45;0;16;6127201;6816059;10674010;330422;6162133;11787109;435733;0;5989
FR;2;2022-12-06;3;4;14;45;3;6;48;0;17;6127204;6816063;10674024;330467;6162136;11787115;435781;0;6006
FR;2;2022-12-07;1;4;9;42;2;8;44;0;11;6127205;6816067;10674033;330509;6162138;11787123;435825;0;6017
FR;2;2022-12-08;0;2;11;44;0;6;49;0;16;6127205;6816069;10674044;330553;6162138;11787129;435874;0;6033
FR;2;2022-12-09;0;1;13;52;0;9;57;0;17;6127205;6816070;10674057;330605;6162138;11787138;435931;0;6050
FR;2;2022-12-10;0;2;15;50;0;6;52;0;9;6127205;6816072;10674072;330655;6162138;11787144;435983;0;6059
FR;2;2022-12-11;0;0;2;2;0;2;1;0;3;6127205;6816072;10674074;330657;6162138;11787146;435984;0;6062
FR;2;2022-12-12;1;0;6;37;0;6;36;0;11;6127206;6816072;10674080;330694;6162138;11787152;436020;0;6073
FR;2;2022-12-13;0;2;1;37;1;1;36;0;14;6127206;6816074;10674081;330731;6162139;11787153;436056;0;6087
FR;2;2022-12-14;0;5;8;26;5;3;31;0;14;6127206;6816079;10674089;330757;6162144;11787156;436087;0;6101
FR;2;2022-12-15;0;4;12;43;4;9;44;0;17;6127206;6816083;10674101;330800;6162148;11787165;436131;0;6118
FR;2;2022-12-16;2;4;27;56;3;20;62;0;16;6127208;6816087;10674128;330856;6162151;11787185;436193;0;6134
FR;2;2022-12-17;1;4;10;44;3;6;39;0;5;6127209;6816091;10674138;330900;6162154;11787191;436232;0;6139
FR;2;2022-12-18;1;0;0;0;0;0;0;0;1;6127210;6816091;10674138;330900;6162154;11787191;436232;0;6140
FR;2;2022-12-19;6;5;4;31;6;5;24;0;24;6127216;6816096;10674142;330931;6162160;11787196;436256;0;6164
FR;2;2022-12-20;0;3;6;37;1;7;38;0;24;6127216;6816099;10674148;330968;6162161;11787203;436294;0;6188
FR;2;2022-12-21;0;1;4;13;1;4;13;0;8;6127216;6816100;10674152;330981;6162162;11787207;436307;0;6196
FR;2;2022-12-22;0;5;17;32;2;6;45;0;10;6127216;6816105;10674169;331013;6162164;11787213;436352;0;6206
FR;2;2022-12-23;1;5;15;18;3;12;22;0;4;6127217;6816110;10674184;331031;6162167;11787225;436374;0;6210
FR;2;2022-12-24;0;0;1;1;0;1;1;0;0;6127217;6816110;10674185;331032;6162167;11787226;436375;0;6210
FR;2;2022-12-25;0;1;1;3;0;1;4;0;0;6127217;6816111;10674186;331035;6162167;11787227;436379;0;6210
FR;2;2022-12-26;0;0;7;11;0;5;11;0;3;6127217;6816111;10674193;331046;6162167;11787232;436390;0;6213
FR;2;2022-12-27;0;1;7;5;1;5;7;0;4;6127217;6816112;10674200;331051;6162168;11787237;436397;0;6217
FR;2;2022-12-28;0;2;4;13;2;3;14;0;5;6127217;6816114;10674204;331064;6162170;11787240;436411;0;6222
FR;2;2022-12-29;1;2;4;18;1;5;18;0;7;6127218;6816116;10674208;331082;6162171;11787245;436429;0;6229
FR;2;2022-12-30;1;0;2;8;0;2;7;0;1;6127219;6816116;10674210;331090;6162171;11787247;436436;0;6230
FR;2;2022-12-31;0;0;1;2;0;1;2;0;1;6127219;6816116;10674211;331092;6162171;11787248;436438;0;6231
FR;2;2023-01-01;0;0;0;0;0;0;0;0;0;6127219;6816116;10674211;331092;6162171;11787248;436438;0;6231
FR;2;2023-01-02;5;2;9;21;1;7;23;0;2;6127224;6816118;10674220;331113;6162172;11787255;436461;0;6233
FR;2;2023-01-03;1;0;6;13;0;7;11;0;6;6127225;6816118;10674226;331126;6162172;11787262;436472;0;6239
FR;2;2023-01-04;1;1;9;13;2;7;13;0;6;6127226;6816119;10674235;331139;6162174;11787269;436485;0;6245
FR;2;2023-01-05;0;2;7;6;2;4;7;0;3;6127226;6816121;10674242;331145;6162176;11787273;436492;0;6248
FR;2;2023-01-06;1;0;9;9;0;4;13;0;9;6127227;6816121;10674251;331154;6162176;11787277;436505;0;6257
FR;2;2023-01-07;0;0;4;10;0;4;8;0;5;6127227;6816121;10674255;331164;6162176;11787281;436513;0;6262
FR;2;2023-01-08;0;0;3;3;0;3;3;0;2;6127227;6816121;10674258;331167;6162176;11787284;436516;0;6264
FR;2;2023-01-09;0;2;8;9;2;3;13;0;5;6127227;6816123;10674266;331176;6162178;11787287;436529;0;6269
FR;2;2023-01-10;0;4;3;8;3;2;10;0;6;6127227;6816127;10674269;331184;6162181;11787289;436539;0;6275
FR;2;2023-01-11;3;0;4;7;0;3;9;0;3;6127230;6816127;10674273;331191;6162181;11787292;436548;0;6278
FR;2;2023-01-12;1;0;9;13;0;7;10;0;11;6127231;6816127;10674282;331204;6162181;11787299;436558;0;6289
FR;2;2023-01-13;0;1;4;7;1;2;10;0;3;6127231;6816128;10674286;331211;6162182;11787301;436568;0;6292
FR;2;2023-01-14;0;1;2;6;0;3;6;0;1;6127231;6816129;10674288;331217;6162182;11787304;436574;0;6293
FR;2;2023-01-15;0;0;0;0;0;0;0;0;0;6127231;6816129;10674288;331217;6162182;11787304;436574;0;6293
FR;2;2023-01-16;1;1;5;6;2;2;7;0;1;6127232;6816130;10674293;331223;6162184;11787306;436581;0;6294
FR;2;2023-01-17;1;0;5;4;0;5;3;0;0;6127233;6816130;10674298;331227;6162184;11787311;436584;0;6294
FR;2;2023-01-18;0;0;2;2;0;2;2;0;0;6127233;6816130;10674300;331229;6162184;11787313;436586;0;6294
FR;2;2023-01-19;0;0;1;6;0;1;6;0;6;6127233;6816130;10674301;331235;6162184;11787314;436592;0;6300
FR;2;2023-01-20;0;0;1;7;0;1;7;0;4;6127233;6816130;10674302;331242;6162184;11787315;436599;0;6304
FR;2;2023-01-21;0;0;0;3;0;0;0;0;0;6127233;6816130;10674302;331245;6162184;11787315;436599;0;6304
FR;2;2023-01-22;0;0;0;0;0;0;0;0;0;6127233;6816130;10674302;331245;6162184;11787315;436599;0;6304
FR;2;2023-01-23;0;0;3;3;0;2;3;0;1;6127233;6816130;10674305;331248;6162184;11787317;436602;0;6305
FR;2;2023-01-24;1;3;1;6;3;0;7;0;4;6127234;6816133;10674306;331254;6162187;11787317;436609;0;6309
FR;2;2023-01-25;1;0;0;6;1;0;6;0;0;6127235;6816133;10674306;331260;6162188;11787317;436615;0;6309
FR;2;2023-01-26;1;0;3;7;0;1;9;0;3;6127236;6816133;10674309;331267;6162188;11787318;436624;0;6312
FR;2;2023-01-27;0;2;3;3;1;2;3;0;2;6127236;6816135;10674312;331270;6162189;11787320;436627;0;6314
FR;2;2023-01-28;0;0;0;1;0;0;1;0;0;6127236;6816135;10674312;331271;6162189;11787320;436628;0;6314
FR;2;2023-01-29;0;0;1;0;0;0;1;0;0;6127236;6816135;10674313;331271;6162189;11787320;436629;0;6314
FR;2;2023-01-30;0;1;2;3;1;1;4;0;1;6127236;6816136;10674315;331274;6162190;11787321;436633;0;6315
FR;2;2023-01-31;1;0;3;2;0;2;3;0;0;6127237;6816136;10674318;331276;6162190;11787323;436636;0;6315
FR;2;2023-02-01;0;3;2;0;2;3;0;0;0;6127237;6816139;10674320;331276;6162192;11787326;436636;0;6315
FR;2;2023-02-02;0;1;3;4;1;3;6;0;4;6127237;6816140;10674323;331280;6162193;11787329;436642;0;6319
FR;2;2023-02-03;0;2;1;12;2;0;11;0;9;6127237;6816142;10674324;331292;6162195;11787329;436653;0;6328
FR;2;2023-02-04;0;1;1;0;0;2;0;0;0;6127237;6816143;10674325;331292;6162195;11787331;436653;0;6328
FR;2;2023-02-05;0;0;0;0;0;0;0;0;0;6127237;6816143;10674325;331292;6162195;11787331;436653;0;6328
FR;2;2023-02-06;0;3;2;2;2;3;2;0;0;6127237;6816146;10674327;331294;6162197;11787334;436655;0;6328
FR;2;2023-02-07;2;1;0;0;0;1;0;0;1;6127239;6816147;10674327;331294;6162197;11787335;436655;0;6329
FR;2;2023-02-08;0;0;3;2;0;2;4;0;1;6127239;6816147;10674330;331296;6162197;11787337;436659;0;6330
FR;2;2023-02-09;0;0;1;4;0;2;3;0;3;6127239;6816147;10674331;331300;6162197;11787339;436662;0;6333
FR;2;2023-02-10;0;0;1;3;0;1;2;0;6;6127239;6816147;10674332;331303;6162197;11787340;436664;0;6339
FR;2;2023-02-11;2;2;1;1;0;2;2;0;0;6127241;6816149;10674333;331304;6162197;11787342;436666;0;6339
FR;2;2023-02-12;0;0;0;0;0;0;0;0;0;6127241;6816149;10674333;331304;6162197;11787342;436666;0;6339
FR;2;2023-02-13;3;0;1;5;0;0;5;0;1;6127244;6816149;10674334;331309;6162197;11787342;436671;0;6340
FR;2;2023-02-14;1;1;1;1;1;0;2;0;0;6127245;6816150;10674335;331310;6162198;11787342;436673;0;6340
FR;2;2023-02-15;2;0;1;1;0;1;1;0;0;6127247;6816150;10674336;331311;6162198;11787343;436674;0;6340
FR;2;2023-02-16;0;1;1;1;1;1;1;0;2;6127247;6816151;10674337;331312;6162199;11787344;436675;0;6342
FR;2;2023-02-17;0;0;1;4;0;1;3;0;4;6127247;6816151;10674338;331316;6162199;11787345;436678;0;6346
FR;2;2023-02-18;0;0;4;1;0;4;0;0;1;6127247;6816151;10674342;331317;6162199;11787349;436678;0;6347
FR;2;2023-02-19;0;1;0;0;1;0;0;0;0;6127247;6816152;10674342;331317;6162200;11787349;436678;0;6347
FR;2;2023-02-20;1;0;0;1;0;0;1;0;2;6127248;6816152;10674342;331318;6162200;11787349;436679;0;6349
FR;2;2023-02-21;0;0;0;1;0;0;1;0;2;6127248;6816152;10674342;331319;6162200;11787349;436680;0;6351
FR;2;2023-02-22;1;0;0;3;0;0;3;0;0;6127249;6816152;10674342;331322;6162200;11787349;436683;0;6351
FR;2;2023-02-23;0;0;0;1;0;0;1;0;3;6127249;6816152;10674342;331323;6162200;11787349;436684;0;6354
FR;2;2023-02-24;1;0;1;2;0;0;3;0;0;6127250;6816152;10674343;331325;6162200;11787349;436687;0;6354
FR;2;2023-02-25;0;0;1;2;0;1;2;0;0;6127250;6816152;10674344;331327;6162200;11787350;436689;0;6354
FR;2;2023-02-26;0;0;0;0;0;0;0;0;0;6127250;6816152;10674344;331327;6162200;11787350;436689;0;6354
FR;2;2023-02-27;1;0;1;1;0;1;1;0;0;6127251;6816152;10674345;331328;6162200;11787351;436690;0;6354
FR;2;2023-02-28;0;0;0;0;0;0;0;0;2;6127251;6816152;10674345;331328;6162200;11787351;436690;0;6356
FR;2;2023-03-01;0;2;2;2;1;2;1;0;1;6127251;6816154;10674347;331330;6162201;11787353;436691;0;6357
FR;2;2023-03-02;0;2;2;1;2;1;1;0;1;6127251;6816156;10674349;331331;6162203;11787354;436692;0;6358
FR;2;2023-03-03;1;0;3;1;0;3;1;0;0;6127252;6816156;10674352;331332;6162203;11787357;436693;0;6358
FR;2;2023-03-04;0;0;1;0;0;1;0;0;0;6127252;6816156;10674353;331332;6162203;11787358;436693;0;6358
FR;2;2023-03-05;0;0;0;0;0;0;0;0;0;6127252;6816156;10674353;331332;6162203;11787358;436693;0;6358
FR;2;2023-03-06;0;0;1;0;0;1;0;0;2;6127252;6816156;10674354;331332;6162203;11787359;436693;0;6360
FR;2;2023-03-07;0;1;2;1;1;2;1;0;1;6127252;6816157;10674356;331333;6162204;11787361;436694;0;6361
FR;2;2023-03-08;0;0;0;0;0;0;0;0;2;6127252;6816157;10674356;331333;6162204;11787361;436694;0;6363
FR;2;2023-03-09;0;0;1;1;0;0;2;0;0;6127252;6816157;10674357;331334;6162204;11787361;436696;0;6363
FR;2;2023-03-10;0;0;1;0;0;1;0;0;0;6127252;6816157;10674358;331334;6162204;11787362;436696;0;6363
FR;2;2023-03-11;0;0;1;0;0;1;0;0;0;6127252;6816157;10674359;331334;6162204;11787363;436696;0;6363
FR;2;2023-03-12;0;0;0;0;0;0;0;0;0;6127252;6816157;10674359;331334;6162204;11787363;436696;0;6363
FR;2;2023-03-13;0;0;1;3;0;1;3;0;0;6127252;6816157;10674360;331337;6162204;11787364;436699;0;6363
FR;2;2023-03-14;1;0;0;0;0;0;0;0;0;6127253;6816157;10674360;331337;6162204;11787364;436699;0;6363
FR;2;2023-03-15;0;1;0;3;1;0;3;0;0;6127253;6816158;10674360;331340;6162205;11787364;436702;0;6363
FR;2;2023-03-16;0;0;0;0;0;0;1;0;0;6127253;6816158;10674360;331340;6162205;11787364;436703;0;6363
FR;2;2023-03-17;0;0;1;1;0;1;0;0;0;6127253;6816158;10674361;331341;6162205;11787365;436703;0;6363
FR;2;2023-03-18;0;0;0;0;0;0;0;0;1;6127253;6816158;10674361;331341;6162205;11787365;436703;0;6364
FR;2;2023-03-19;0;0;0;0;0;0;0;0;0;6127253;6816158;10674361;331341;6162205;11787365;436703;0;6364
FR;2;2023-03-20;0;0;1;0;0;1;0;0;0;6127253;6816158;10674362;331341;6162205;11787366;436703;0;6364
FR;2;2023-03-21;0;0;0;2;0;0;2;0;1;6127253;6816158;10674362;331343;6162205;11787366;436705;0;6365
FR;2;2023-03-22;0;0;0;0;0;0;0;0;1;6127253;6816158;10674362;331343;6162205;11787366;436705;0;6366
FR;2;2023-03-23;0;1;0;0;1;0;0;0;1;6127253;6816159;10674362;331343;6162206;11787366;436705;0;6367
FR;2;2023-03-24;0;1;0;2;1;0;2;0;2;6127253;6816160;10674362;331345;6162207;11787366;436707;0;6369
FR;2;2023-03-25;0;0;0;0;0;0;0;0;0;6127253;6816160;10674362;331345;6162207;11787366;436707;0;6369
FR;2;2023-03-26;0;0;1;0;0;1;0;0;0;6127253;6816160;10674363;331345;6162207;11787367;436707;0;6369
FR;3;2020-12-27;0;0;0;0;0;0;0;0;0;0;0;0;0;0;0;0;0;0
FR;3;2020-12-28;0;0;0;0;0;0;0;0;0;0;0;0;0;0;0;0;0;0
FR;3;2020-12-29;0;0;0;0;0;0;0;0;0;0;0;0;0;0;0;0;0;0
FR;3;2020-12-30;0;0;0;0;0;0;0;0;0;0;0;0;0;0;0;0;0;0
FR;3;2020-12-31;0;0;0;0;0;0;0;0;0;0;0;0;0;0;0;0;0;0
FR;3;2021-01-01;0;0;0;0;0;0;0;0;0;0;0;0;0;0;0;0;0;0
FR;3;2021-01-02;0;0;0;0;0;0;0;0;0;0;0;0;0;0;0;0;0;0
FR;3;2021-01-03;0;0;0;0;0;0;0;0;0;0;0;0;0;0;0;0;0;0
FR;3;2021-01-04;0;0;0;0;0;0;0;0;0;0;0;0;0;0;0;0;0;0
FR;3;2021-01-05;0;0;0;0;0;0;0;0;0;0;0;0;0;0;0;0;0;0
FR;3;2021-01-06;0;0;0;0;0;0;0;0;0;0;0;0;0;0;0;0;0;0
FR;3;2021-01-07;0;0;0;0;0;0;0;0;0;0;0;0;0;0;0;0;0;0
FR;3;2021-01-08;0;0;0;0;0;0;0;0;0;0;0;0;0;0;0;0;0;0
FR;3;2021-01-09;0;0;0;0;0;0;0;0;0;0;0;0;0;0;0;0;0;0
FR;3;2021-01-10;0;0;0;0;0;0;0;0;0;0;0;0;0;0;0;0;0;0
FR;3;2021-01-11;0;0;0;0;0;0;0;0;0;0;0;0;0;0;0;0;0;0
FR;3;2021-01-12;0;0;0;0;0;0;0;0;0;0;0;0;0;0;0;0;0;0
FR;3;2021-01-13;0;0;0;0;0;0;0;0;0;0;0;0;0;0;0;0;0;0
FR;3;2021-01-14;0;0;0;0;0;0;0;0;0;0;0;0;0;0;0;0;0;0
FR;3;2021-01-15;0;0;0;0;0;0;0;0;0;0;0;0;0;0;0;0;0;0
FR;3;2021-01-16;0;0;0;0;0;0;0;0;0;0;0;0;0;0;0;0;0;0
FR;3;2021-01-17;0;0;0;0;0;0;0;0;0;0;0;0;0;0;0;0;0;0
FR;3;2021-01-18;0;0;0;0;0;0;0;0;0;0;0;0;0;0;0;0;0;0
FR;3;2021-01-19;0;0;0;0;0;0;0;0;0;0;0;0;0;0;0;0;0;0
FR;3;2021-01-20;0;0;0;0;0;0;0;0;0;0;0;0;0;0;0;0;0;0
FR;3;2021-01-21;0;0;0;0;0;0;0;0;0;0;0;0;0;0;0;0;0;0
FR;3;2021-01-22;0;0;0;0;0;0;0;0;0;0;0;0;0;0;0;0;0;0
FR;3;2021-01-23;0;0;0;0;0;0;0;0;0;0;0;0;0;0;0;0;0;0
FR;3;2021-01-24;0;0;0;0;0;0;0;0;0;0;0;0;0;0;0;0;0;0
FR;3;2021-01-25;0;0;0;0;0;0;0;0;0;0;0;0;0;0;0;0;0;0
FR;3;2021-01-26;0;0;0;0;0;0;0;0;0;0;0;0;0;0;0;0;0;0
FR;3;2021-01-27;0;0;0;0;0;0;0;0;0;0;0;0;0;0;0;0;0;0
FR;3;2021-01-28;0;0;0;0;0;0;0;0;0;0;0;0;0;0;0;0;0;0
FR;3;2021-01-29;0;0;0;0;0;0;0;0;0;0;0;0;0;0;0;0;0;0
FR;3;2021-01-30;0;0;0;0;0;0;0;0;0;0;0;0;0;0;0;0;0;0
FR;3;2021-01-31;0;0;0;0;0;0;0;0;0;0;0;0;0;0;0;0;0;0
FR;3;2021-02-01;0;0;0;0;0;0;0;0;0;0;0;0;0;0;0;0;0;0
FR;3;2021-02-02;0;0;0;0;0;0;0;0;0;0;0;0;0;0;0;0;0;0
FR;3;2021-02-03;0;0;0;0;0;0;0;0;0;0;0;0;0;0;0;0;0;0
FR;3;2021-02-04;0;0;0;0;0;0;0;0;0;0;0;0;0;0;0;0;0;0
FR;3;2021-02-05;0;0;0;0;0;0;0;0;0;0;0;0;0;0;0;0;0;0
FR;3;2021-02-06;1477;0;0;0;106;0;0;0;0;1477;0;0;0;106;0;0;0;0
FR;3;2021-02-07;1423;2;0;0;87;0;0;0;0;2900;2;0;0;193;0;0;0;0
FR;3;2021-02-08;2789;1;0;0;177;0;0;0;0;5689;3;0;0;370;0;0;0;0
FR;3;2021-02-09;6786;0;0;0;502;0;0;0;0;12475;3;0;0;872;0;0;0;0
FR;3;2021-02-10;9612;0;0;0;695;0;0;0;0;22087;3;0;0;1567;0;0;0;0
FR;3;2021-02-11;13620;4;0;0;919;0;0;0;0;35707;7;0;0;2486;0;0;0;0
FR;3;2021-02-12;13410;0;0;0;907;0;0;0;0;49117;7;0;0;3393;0;0;0;0
FR;3;2021-02-13;3800;1;0;0;218;0;0;0;0;52917;8;0;0;3611;0;0;0;0
FR;3;2021-02-14;975;1;0;0;53;0;0;0;0;53892;9;0;0;3664;0;0;0;0
FR;3;2021-02-15;10497;2;0;0;719;0;0;0;0;64389;11;0;0;4383;0;0;0;0
FR;3;2021-02-16;12556;5;0;0;871;0;0;0;0;76945;16;0;0;5254;0;0;0;0
FR;3;2021-02-17;11159;1;0;0;716;0;0;0;0;88104;17;0;0;5970;0;0;0;0
FR;3;2021-02-18;14943;2;0;0;985;0;0;0;0;103047;19;0;0;6955;0;0;0;0
FR;3;2021-02-19;14364;1;0;0;846;0;0;0;0;117411;20;0;0;7801;0;0;0;0
FR;3;2021-02-20;3332;0;0;0;178;0;0;0;0;120743;20;0;0;7979;0;0;0;0
FR;3;2021-02-21;620;0;0;0;35;0;0;0;0;121363;20;0;0;8014;0;0;0;0
FR;3;2021-02-22;9171;1;0;0;654;0;0;0;0;130534;21;0;0;8668;0;0;0;0
FR;3;2021-02-23;11406;6;0;0;761;0;0;0;0;141940;27;0;0;9429;0;0;0;0
FR;3;2021-02-24;14305;1;0;0;829;0;0;0;0;156245;28;0;0;10258;0;0;0;0
FR;3;2021-02-25;44935;3;0;0;1814;0;0;0;0;201180;31;0;0;12072;0;0;0;0
FR;3;2021-02-26;61889;13;0;0;2201;0;0;0;0;263069;44;0;0;14273;0;0;0;0
FR;3;2021-02-27;34811;14;0;0;1028;0;0;0;0;297880;58;0;0;15301;0;0;0;0
FR;3;2021-02-28;2464;0;0;0;114;0;0;0;0;300344;58;0;0;15415;0;0;0;0
FR;3;2021-03-01;20521;21;0;0;1067;0;0;0;0;320865;79;0;0;16482;0;0;0;0
FR;3;2021-03-02;38878;25;0;0;1790;0;0;0;0;359743;104;0;0;18272;0;0;0;0
FR;3;2021-03-03;48750;18;0;0;2130;0;0;0;0;408493;122;0;0;20402;0;0;0;0
FR;3;2021-03-04;82228;25;0;0;3193;0;0;0;0;490721;147;0;0;23595;0;0;0;0
FR;3;2021-03-05;118139;42;0;0;4692;0;0;0;0;608860;189;0;0;28287;0;0;0;0
FR;3;2021-03-06;120727;65;1;0;3559;0;0;0;0;729587;254;1;0;31846;0;0;0;0
FR;3;2021-03-07;55186;23;0;0;1729;0;0;0;0;784773;277;1;0;33575;0;0;0;0
FR;3;2021-03-08;42814;29;0;0;2074;0;0;0;0;827587;306;1;0;35649;0;0;0;0
FR;3;2021-03-09;78978;51;0;0;3288;0;0;0;0;906565;357;1;0;38937;0;0;0;0
FR;3;2021-03-10;80985;67;0;0;3243;0;0;0;0;987550;424;1;0;42180;0;0;0;0
FR;3;2021-03-11;128447;66;0;0;4766;0;0;0;0;1115997;490;1;0;46946;0;0;0;0
FR;3;2021-03-12;182719;122;0;0;6279;0;0;0;0;1298716;612;1;0;53225;0;0;0;0
FR;3;2021-03-13;132162;91;0;0;3530;0;0;0;0;1430878;703;1;0;56755;0;0;0;0
FR;3;2021-03-14;14061;6;0;0;550;0;0;0;0;1444939;709;1;0;57305;0;0;0;0
FR;3;2021-03-15;52242;82;0;0;2097;0;0;0;0;1497181;791;1;0;59402;0;0;0;0
FR;3;2021-03-16;1221;51;0;0;105;0;0;0;0;1498402;842;1;0;59507;0;0;0;0
FR;3;2021-03-17;950;56;0;0;95;0;0;0;0;1499352;898;1;0;59602;0;0;0;0
FR;3;2021-03-18;1576;42;0;0;102;0;0;0;0;1500928;940;1;0;59704;0;0;0;0
FR;3;2021-03-19;70458;56;0;0;2060;0;0;0;0;1571386;996;1;0;61764;0;0;0;0
FR;3;2021-03-20;65241;51;0;0;1702;0;0;0;0;1636627;1047;1;0;63466;0;0;0;0
FR;3;2021-03-21;5761;8;0;0;199;0;0;0;0;1642388;1055;1;0;63665;0;0;0;0
FR;3;2021-03-22;37511;49;0;0;1052;0;0;0;0;1679899;1104;1;0;64717;0;0;0;0
FR;3;2021-03-23;84670;87;0;0;2288;0;0;0;0;1764569;1191;1;0;67005;0;0;0;0
FR;3;2021-03-24;90955;99;0;0;2491;0;0;0;0;1855524;1290;1;0;69496;0;0;0;0
FR;3;2021-03-25;150068;149;0;0;3792;0;0;0;0;2005592;1439;1;0;73288;0;0;0;0
FR;3;2021-03-26;165430;157;0;0;4148;0;0;0;0;2171022;1596;1;0;77436;0;0;0;0
FR;3;2021-03-27;68465;101;0;0;2004;0;0;0;0;2239487;1697;1;0;79440;0;0;0;0
FR;3;2021-03-28;6480;20;0;0;238;0;0;0;0;2245967;1717;1;0;79678;0;0;0;0
FR;3;2021-03-29;54171;82;0;0;1479;0;0;0;0;2300138;1799;1;0;81157;0;0;0;0
FR;3;2021-03-30;93185;103;0;0;2564;0;0;0;0;2393323;1902;1;0;83721;0;0;0;0
FR;3;2021-03-31;63546;110;0;0;1964;0;0;0;0;2456869;2012;1;0;85685;0;0;0;0
FR;3;2021-04-01;86136;115;0;0;2495;0;0;0;0;2543005;2127;1;0;88180;0;0;0;0
FR;3;2021-04-02;86915;187;0;0;2766;0;0;0;0;2629920;2314;1;0;90946;0;0;0;0
FR;3;2021-04-03;35876;133;0;0;1164;0;0;0;0;2665796;2447;1;0;92110;0;0;0;0
FR;3;2021-04-04;3577;19;0;0;164;0;0;0;0;2669373;2466;1;0;92274;0;0;0;0
FR;3;2021-04-05;4492;40;0;0;236;0;0;0;0;2673865;2506;1;0;92510;0;0;0;0
FR;3;2021-04-06;29762;104;0;0;1090;0;0;0;0;2703627;2610;1;0;93600;0;0;0;0
FR;3;2021-04-07;32350;113;0;0;1052;0;0;0;0;2735977;2723;1;0;94652;0;0;0;0
FR;3;2021-04-08;78826;273;0;0;2618;0;0;0;0;2814803;2996;1;0;97270;0;0;0;0
FR;3;2021-04-09;161764;454;0;0;5180;0;0;0;0;2976567;3450;1;0;102450;0;0;0;0
FR;3;2021-04-10;75765;364;0;0;2696;0;0;0;0;3052332;3814;1;0;105146;0;0;0;0
FR;3;2021-04-11;7316;47;0;0;306;0;0;0;0;3059648;3861;1;0;105452;0;0;0;0
FR;3;2021-04-12;51484;219;0;0;1738;0;0;0;0;3111132;4080;1;0;107190;0;0;0;0
FR;3;2021-04-13;86236;364;0;0;2911;0;0;0;0;3197368;4444;1;0;110101;0;0;0;0
FR;3;2021-04-14;67847;377;0;0;2429;0;0;0;0;3265215;4821;1;0;112530;0;0;0;0
FR;3;2021-04-15;93246;403;0;0;3441;0;0;0;0;3358461;5224;1;0;115971;0;0;0;0
FR;3;2021-04-16;112532;627;0;0;4342;0;0;0;0;3470993;5851;1;0;120313;0;0;0;0
FR;3;2021-04-17;53319;371;1;0;2277;0;0;0;0;3524312;6222;2;0;122590;0;0;0;0
FR;3;2021-04-18;9752;49;0;0;423;0;0;0;0;3534064;6271;2;0;123013;0;0;0;0
FR;3;2021-04-19;25117;287;0;0;1093;0;0;0;0;3559181;6558;2;0;124106;0;0;0;0
FR;3;2021-04-20;45676;438;0;0;1908;0;0;0;0;3604857;6996;2;0;126014;0;0;0;0
FR;3;2021-04-21;38988;552;0;0;1896;0;0;0;0;3643845;7548;2;0;127910;0;0;0;0
FR;3;2021-04-22;54723;875;0;0;2827;0;0;0;0;3698568;8423;2;0;130737;0;0;0;0
FR;3;2021-04-23;70493;1094;0;0;3696;0;0;0;0;3769061;9517;2;0;134433;0;0;0;0
FR;3;2021-04-24;37253;1101;0;0;2490;0;0;0;0;3806314;10618;2;0;136923;0;0;0;0
FR;3;2021-04-25;6213;158;0;0;446;0;0;0;0;3812527;10776;2;0;137369;0;0;0;0
FR;3;2021-04-26;19792;699;0;0;1434;0;0;0;0;3832319;11475;2;0;138803;0;0;0;0
FR;3;2021-04-27;34486;1336;0;0;2594;0;0;0;0;3866805;12811;2;0;141397;0;0;0;0
FR;3;2021-04-28;28971;2046;0;0;3163;0;0;0;0;3895776;14857;2;0;144560;0;0;0;0
FR;3;2021-04-29;45393;6124;0;0;7943;0;0;0;0;3941169;20981;2;0;152503;0;0;0;0
FR;3;2021-04-30;55465;9117;1;0;11512;0;0;0;0;3996634;30098;3;0;164015;0;0;0;0
FR;3;2021-05-01;9518;2064;0;0;2495;0;0;0;0;4006152;32162;3;0;166510;0;0;0;0
FR;3;2021-05-02;3081;465;0;0;610;0;0;0;0;4009233;32627;3;0;167120;0;0;0;0
FR;3;2021-05-03;13067;3940;0;0;4507;0;0;0;0;4022300;36567;3;0;171627;0;0;0;0
FR;3;2021-05-04;23123;8373;0;0;9440;0;0;0;0;4045423;44940;3;0;181067;0;0;0;0
FR;3;2021-05-05;18767;10833;0;0;11771;0;0;0;0;4064190;55773;3;0;192838;0;0;0;0
FR;3;2021-05-06;34632;21264;0;0;22814;0;0;0;0;4098822;77037;3;0;215652;0;0;0;0
FR;3;2021-05-07;44211;28901;0;0;31204;0;0;0;0;4143033;105938;3;0;246856;0;0;0;0
FR;3;2021-05-08;6786;9192;0;0;9558;0;0;0;0;4149819;115130;3;0;256414;0;0;0;0
FR;3;2021-05-09;1797;2666;0;0;2767;0;0;0;0;4151616;117796;3;0;259181;0;0;0;0
FR;3;2021-05-10;15001;12917;0;0;13610;0;0;0;0;4166617;130713;3;0;272791;0;0;0;0
FR;3;2021-05-11;27099;26275;0;0;27547;0;0;0;0;4193716;156988;3;0;300338;0;0;0;0
FR;3;2021-05-12;17273;28143;0;0;29081;0;0;0;0;4210989;185131;3;0;329419;0;0;0;0
FR;3;2021-05-13;2285;3510;0;0;3630;0;0;0;0;4213274;188641;3;0;333049;0;0;0;0
FR;3;2021-05-14;14521;26084;0;0;26865;0;0;0;0;4227795;214725;3;0;359914;0;0;0;0
FR;3;2021-05-15;7233;21086;0;0;21516;0;0;0;0;4235028;235811;3;0;381430;0;0;0;0
FR;3;2021-05-16;977;2646;0;0;2692;0;0;0;0;4236005;238457;3;0;384122;0;0;0;0
FR;3;2021-05-17;7967;20221;0;0;20665;0;0;0;0;4243972;258678;3;0;404787;0;0;0;0
FR;3;2021-05-18;13418;30158;0;0;30920;0;0;0;0;4257390;288836;3;0;435707;0;0;0;0
FR;3;2021-05-19;9277;30525;0;0;31119;0;0;0;0;4266667;319361;3;0;466826;0;0;0;0
FR;3;2021-05-20;12808;53829;3;0;54756;0;0;0;0;4279475;373190;6;0;521582;0;0;0;0
FR;3;2021-05-21;12771;66183;2;0;67114;0;0;0;0;4292246;439373;8;0;588696;0;0;0;0
FR;3;2021-05-22;4967;33780;1;0;34163;0;0;0;0;4297213;473153;9;0;622859;0;0;0;0
FR;3;2021-05-23;651;2664;0;0;2696;0;0;0;0;4297864;475817;9;0;625555;0;0;0;0
FR;3;2021-05-24;885;4784;0;0;4828;0;0;0;0;4298749;480601;9;0;630383;0;0;0;0
FR;3;2021-05-25;5314;46732;1;0;47136;0;0;0;0;4304063;527333;10;0;677519;0;0;0;0
FR;3;2021-05-26;4982;52190;1;0;52664;0;0;0;0;4309045;579523;11;0;730183;0;0;0;0
FR;3;2021-05-27;6338;79062;3;0;79673;0;0;0;0;4315383;658585;14;0;809856;0;0;0;0
FR;3;2021-05-28;7546;100335;2;0;101141;0;0;0;0;4322929;758920;16;0;910997;0;0;0;0
FR;3;2021-05-29;3350;61182;1;0;61564;0;0;0;0;4326279;820102;17;0;972561;0;0;0;0
FR;3;2021-05-30;551;8078;0;0;8127;0;0;0;0;4326830;828180;17;0;980688;0;0;0;0
FR;3;2021-05-31;2442;35484;3;0;35750;0;0;0;0;4329272;863664;20;0;1016438;0;0;0;0
FR;3;2021-06-01;3416;64904;10;0;65355;0;0;0;0;4332688;928568;30;0;1081793;0;0;0;0
FR;3;2021-06-02;2735;58932;6;0;59267;0;0;0;0;4335423;987500;36;0;1141060;0;0;0;0
FR;3;2021-06-03;3496;87201;10;0;87740;0;0;0;0;4338919;1074701;46;0;1228800;0;0;0;0
FR;3;2021-06-04;4125;105866;22;0;106531;0;0;0;0;4343044;1180567;68;0;1335331;0;0;0;0
FR;3;2021-06-05;1983;52607;4;0;52925;0;0;0;0;4345027;1233174;72;0;1388256;0;0;0;0
FR;3;2021-06-06;511;5268;1;0;5316;0;0;0;0;4345538;1238442;73;0;1393572;0;0;0;0
FR;3;2021-06-07;1487;30714;11;0;30895;0;0;0;0;4347025;1269156;84;0;1424467;0;0;0;0
FR;3;2021-06-08;2065;47426;18;0;47772;0;0;0;0;4349090;1316582;102;0;1472239;0;0;0;0
FR;3;2021-06-09;1796;41809;13;0;42114;0;0;0;0;4350886;1358391;115;0;1514353;0;0;0;0
FR;3;2021-06-10;2261;67659;17;0;68057;0;0;0;0;4353147;1426050;132;0;1582410;0;0;0;0
FR;3;2021-06-11;2492;96634;34;0;97110;0;0;0;0;4355639;1522684;166;0;1679520;0;0;0;0
FR;3;2021-06-12;1179;40558;6;0;40790;0;0;0;0;4356818;1563242;172;0;1720310;0;0;0;0
FR;3;2021-06-13;283;3606;3;0;3641;0;0;0;0;4357101;1566848;175;0;1723951;0;0;0;0
FR;3;2021-06-14;1051;42318;17;0;42487;0;0;0;0;4358152;1609166;192;0;1766438;0;0;0;0
FR;3;2021-06-15;1379;80350;20;0;80655;0;0;0;0;4359531;1689516;212;0;1847093;0;0;0;0
FR;3;2021-06-16;1263;65504;20;0;65777;0;0;0;0;4360794;1755020;232;0;1912870;0;0;0;0
FR;3;2021-06-17;1667;102293;41;0;102679;0;0;0;0;4362461;1857313;273;0;2015549;0;0;0;0
FR;3;2021-06-18;1873;118466;63;0;118936;0;0;0;0;4364334;1975779;336;0;2134485;0;0;0;0
FR;3;2021-06-19;804;39453;22;0;39648;0;0;0;0;4365138;2015232;358;0;2174133;0;0;0;0
FR;3;2021-06-20;162;3195;0;0;3224;0;0;0;0;4365300;2018427;358;0;2177357;0;0;0;0
FR;3;2021-06-21;775;39091;16;0;39249;0;0;0;0;4366075;2057518;374;0;2216606;0;0;0;0
FR;3;2021-06-22;1065;70094;52;0;70364;0;0;0;0;4367140;2127612;426;0;2286970;0;0;0;0
FR;3;2021-06-23;946;50834;39;0;51106;0;0;0;0;4368086;2178446;465;0;2338076;0;0;0;0
FR;3;2021-06-24;1314;77297;48;0;77670;0;0;0;0;4369400;2255743;513;0;2415746;0;0;0;0
FR;3;2021-06-25;1410;90855;73;0;91288;0;0;0;0;4370810;2346598;586;0;2507034;0;0;0;0
FR;3;2021-06-26;631;33112;29;0;33304;0;0;0;0;4371441;2379710;615;0;2540338;0;0;0;0
FR;3;2021-06-27;168;3779;1;0;3803;0;0;0;0;4371609;2383489;616;0;2544141;0;0;0;0
FR;3;2021-06-28;655;29931;27;0;30125;0;0;0;0;4372264;2413420;643;0;2574266;0;0;0;0
FR;3;2021-06-29;856;56653;95;0;56898;0;0;0;0;4373120;2470073;738;0;2631164;0;0;0;0
FR;3;2021-06-30;905;45215;93;0;45483;0;0;0;0;4374025;2515288;831;0;2676647;0;0;0;0
FR;3;2021-07-01;1164;66127;108;0;66476;0;0;0;0;4375189;2581415;939;0;2743123;0;0;0;0
FR;3;2021-07-02;1305;90528;170;0;91011;0;0;0;0;4376494;2671943;1109;0;2834134;0;0;0;0
FR;3;2021-07-03;602;31187;51;0;31388;0;0;0;0;4377096;2703130;1160;0;2865522;0;0;0;0
FR;3;2021-07-04;144;3967;3;0;3997;0;0;0;0;4377240;2707097;1163;0;2869519;0;0;0;0
FR;3;2021-07-05;613;33604;60;0;33805;0;0;0;0;4377853;2740701;1223;0;2903324;0;0;0;0
FR;3;2021-07-06;965;55935;88;0;56246;0;0;0;0;4378818;2796636;1311;0;2959570;0;0;0;0
FR;3;2021-07-07;874;42962;80;0;43260;0;0;0;0;4379692;2839598;1391;0;3002830;0;0;0;0
FR;3;2021-07-08;1127;60813;99;0;61223;0;0;0;0;4380819;2900411;1490;0;3064053;0;0;0;0
FR;3;2021-07-09;1261;68937;128;0;69402;0;0;0;0;4382080;2969348;1618;0;3133455;0;0;0;0
FR;3;2021-07-10;644;25021;59;0;25218;0;0;0;0;4382724;2994369;1677;0;3158673;0;0;0;0
FR;3;2021-07-11;132;3173;4;0;3198;0;0;0;0;4382856;2997542;1681;0;3161871;0;0;0;0
FR;3;2021-07-12;662;23599;59;0;23812;0;0;0;0;4383518;3021141;1740;0;3185683;0;0;0;0
FR;3;2021-07-13;1648;34426;90;0;34916;0;0;0;0;4385166;3055567;1830;0;3220599;0;0;0;0
FR;3;2021-07-14;272;2475;2;0;2532;0;0;0;0;4385438;3058042;1832;0;3223131;0;0;0;0
FR;3;2021-07-15;1941;30419;85;0;30994;0;0;0;0;4387379;3088461;1917;0;3254125;0;0;0;0
FR;3;2021-07-16;2520;38620;122;0;39354;0;0;0;0;4389899;3127081;2039;0;3293479;0;0;0;0
FR;3;2021-07-17;1051;13725;26;0;14033;0;0;0;0;4390950;3140806;2065;0;3307512;0;0;0;0
FR;3;2021-07-18;266;2549;3;0;2597;0;0;0;0;4391216;3143355;2068;0;3310109;0;0;0;0
FR;3;2021-07-19;1280;16885;38;0;17253;0;0;0;0;4392496;3160240;2106;0;3327362;0;0;0;0
FR;3;2021-07-20;1823;26929;98;0;27471;0;0;0;0;4394319;3187169;2204;0;3354833;0;0;0;0
FR;3;2021-07-21;1652;19475;44;0;19980;0;0;0;0;4395971;3206644;2248;0;3374813;0;0;0;0
FR;3;2021-07-22;1856;27645;83;0;28210;0;0;0;0;4397827;3234289;2331;0;3403023;0;0;0;0
FR;3;2021-07-23;2217;30211;117;0;30948;0;0;0;0;4400044;3264500;2448;0;3433971;0;0;0;0
FR;3;2021-07-24;828;6929;25;0;7152;0;0;0;0;4400872;3271429;2473;0;3441123;0;0;0;0
FR;3;2021-07-25;210;1287;1;0;1342;0;0;0;0;4401082;3272716;2474;0;3442465;0;0;0;0
FR;3;2021-07-26;933;10509;28;0;10817;0;0;0;0;4402015;3283225;2502;0;3453282;0;0;0;0
FR;3;2021-07-27;1171;16802;56;0;17165;0;0;0;0;4403186;3300027;2558;0;3470447;0;0;0;0
FR;3;2021-07-28;989;12000;40;0;12312;0;0;0;0;4404175;3312027;2598;0;3482759;0;0;0;0
FR;3;2021-07-29;1127;15681;63;0;16094;0;0;0;0;4405302;3327708;2661;0;3498853;0;0;0;0
FR;3;2021-07-30;1129;17990;79;0;18365;0;0;0;0;4406431;3345698;2740;0;3517218;0;0;0;0
FR;3;2021-07-31;407;3711;15;0;3837;0;0;0;0;4406838;3349409;2755;0;3521055;0;0;0;0
FR;3;2021-08-01;117;445;1;0;467;0;0;0;0;4406955;3349854;2756;0;3521522;0;0;0;0
FR;3;2021-08-02;424;5015;22;0;5136;0;0;0;0;4407379;3354869;2778;0;3526658;0;0;0;0
FR;3;2021-08-03;498;7466;27;0;7599;0;0;0;0;4407877;3362335;2805;0;3534257;0;0;0;0
FR;3;2021-08-04;440;4831;26;0;4976;0;0;0;0;4408317;3367166;2831;0;3539233;0;0;0;0
FR;3;2021-08-05;433;3654;13;0;3764;0;0;0;0;4408750;3370820;2844;0;3542997;0;0;0;0
FR;3;2021-08-06;456;4699;30;0;4800;0;0;0;0;4409206;3375519;2874;0;3547797;0;0;0;0
FR;3;2021-08-07;214;1900;11;0;1946;0;0;0;0;4409420;3377419;2885;0;3549743;0;0;0;0
FR;3;2021-08-08;251;423;2;0;456;0;0;0;0;4409671;3377842;2887;0;3550199;0;0;0;0
FR;3;2021-08-09;320;2376;11;0;2446;0;0;0;0;4409991;3380218;2898;0;3552645;0;0;0;0
FR;3;2021-08-10;369;3735;15;0;3823;0;0;0;0;4410360;3383953;2913;0;3556468;0;0;0;0
FR;3;2021-08-11;291;2639;15;0;2699;0;0;0;0;4410651;3386592;2928;0;3559167;0;0;0;0
FR;3;2021-08-12;279;2563;13;0;2651;0;0;0;0;4410930;3389155;2941;0;3561818;0;0;0;0
FR;3;2021-08-13;279;2255;16;0;2341;0;0;0;0;4411209;3391410;2957;0;3564159;0;0;0;0
FR;3;2021-08-14;172;874;1;0;905;0;0;0;0;4411381;3392284;2958;0;3565064;0;0;0;0
FR;3;2021-08-15;56;174;0;0;183;0;0;0;0;4411437;3392458;2958;0;3565247;0;0;0;0
FR;3;2021-08-16;126;1002;8;0;1041;0;0;0;0;4411563;3393460;2966;0;3566288;0;0;0;0
FR;3;2021-08-17;191;1430;8;0;1471;0;0;0;0;4411754;3394890;2974;0;3567759;0;0;0;0
FR;3;2021-08-18;204;1309;10;0;1351;0;0;0;0;4411958;3396199;2984;0;3569110;0;0;0;0
FR;3;2021-08-19;165;1373;10;0;1420;0;0;0;0;4412123;3397572;2994;0;3570530;0;0;0;0
FR;3;2021-08-20;167;1596;16;0;1658;0;0;0;0;4412290;3399168;3010;0;3572188;0;0;0;0
FR;3;2021-08-21;94;576;2;0;591;0;0;0;0;4412384;3399744;3012;0;3572779;0;0;0;0
FR;3;2021-08-22;42;192;1;0;195;0;0;0;0;4412426;3399936;3013;0;3572974;0;0;0;0
FR;3;2021-08-23;141;885;7;0;930;0;0;0;0;4412567;3400821;3020;0;3573904;0;0;0;0
FR;3;2021-08-24;125;924;10;0;956;0;0;0;0;4412692;3401745;3030;0;3574860;0;0;0;0
FR;3;2021-08-25;137;820;3;0;849;0;0;0;0;4412829;3402565;3033;0;3575709;0;0;0;0
FR;3;2021-08-26;172;824;9;0;872;0;0;0;0;4413001;3403389;3042;0;3576581;0;0;0;0
FR;3;2021-08-27;178;937;9;0;989;0;0;0;0;4413179;3404326;3051;0;3577570;0;0;0;0
FR;3;2021-08-28;101;373;4;0;390;0;0;0;0;4413280;3404699;3055;0;3577960;0;0;0;0
FR;3;2021-08-29;128;129;1;0;162;0;0;0;0;4413408;3404828;3056;0;3578122;0;0;0;0
FR;3;2021-08-30;100;560;0;0;469;108;0;0;0;4413508;3405388;3056;0;3578591;108;0;0;0
FR;3;2021-08-31;134;684;7;0;589;134;0;0;0;4413642;3406072;3063;0;3579180;242;0;0;0
FR;3;2021-09-01;122;459;5;0;381;106;0;0;0;4413764;3406531;3068;0;3579561;348;0;0;0
FR;3;2021-09-02;100;595;22;0;531;105;0;0;0;4413864;3407126;3090;0;3580092;453;0;0;0
FR;3;2021-09-03;116;552;17;0;477;116;0;0;0;4413980;3407678;3107;0;3580569;569;0;0;0
FR;3;2021-09-04;55;295;3;0;256;50;0;0;0;4414035;3407973;3110;0;3580825;619;0;0;0
FR;3;2021-09-05;52;65;5;0;55;25;0;0;0;4414087;3408038;3115;0;3580880;644;0;0;0
FR;3;2021-09-06;118;367;4;0;261;130;0;0;0;4414205;3408405;3119;0;3581141;774;0;0;0
FR;3;2021-09-07;125;431;14;0;347;116;0;0;0;4414330;3408836;3133;0;3581488;890;0;0;0
FR;3;2021-09-08;122;343;2;0;273;87;0;0;0;4414452;3409179;3135;0;3581761;977;0;0;0
FR;3;2021-09-09;94;377;8;0;297;103;0;0;0;4414546;3409556;3143;0;3582058;1080;0;0;0
FR;3;2021-09-10;101;402;3;0;332;93;0;0;0;4414647;3409958;3146;0;3582390;1173;0;0;0
FR;3;2021-09-11;78;232;4;0;177;65;0;0;0;4414725;3410190;3150;0;3582567;1238;0;0;0
FR;3;2021-09-12;37;48;1;0;37;16;0;0;0;4414762;3410238;3151;0;3582604;1254;0;0;0
FR;3;2021-09-13;78;298;7;0;215;102;1;0;0;4414840;3410536;3158;0;3582819;1356;1;0;0
FR;3;2021-09-14;75;272;6;0;192;94;0;0;0;4414915;3410808;3164;0;3583011;1450;1;0;0
FR;3;2021-09-15;64;252;3;0;257;6;0;0;0;4414979;3411060;3167;0;3583268;1456;1;0;0
FR;3;2021-09-16;65;320;6;0;331;6;0;0;0;4415044;3411380;3173;0;3583599;1462;1;0;0
FR;3;2021-09-17;52;327;3;0;339;6;0;0;0;4415096;3411707;3176;0;3583938;1468;1;0;0
FR;3;2021-09-18;37;172;1;0;176;1;0;0;0;4415133;3411879;3177;0;3584114;1469;1;0;0
FR;3;2021-09-19;29;31;2;0;34;1;0;0;0;4415162;3411910;3179;0;3584148;1470;1;0;0
FR;3;2021-09-20;82;188;0;0;196;1;0;0;0;4415244;3412098;3179;0;3584344;1471;1;0;0
FR;3;2021-09-21;60;273;7;0;277;8;0;0;0;4415304;3412371;3186;0;3584621;1479;1;0;0
FR;3;2021-09-22;67;229;6;0;242;7;0;0;0;4415371;3412600;3192;0;3584863;1486;1;0;0
FR;3;2021-09-23;37;257;11;0;261;7;0;0;0;4415408;3412857;3203;0;3585124;1493;1;0;0
FR;3;2021-09-24;29;315;12;0;313;18;0;0;0;4415437;3413172;3215;0;3585437;1511;1;0;0
FR;3;2021-09-25;31;144;3;0;150;3;0;0;0;4415468;3413316;3218;0;3585587;1514;1;0;0
FR;3;2021-09-26;16;57;1;0;59;1;0;0;0;4415484;3413373;3219;0;3585646;1515;1;0;0
FR;3;2021-09-27;49;282;3;0;285;5;0;0;0;4415533;3413655;3222;0;3585931;1520;1;0;0
FR;3;2021-09-28;49;245;6;0;253;8;0;0;0;4415582;3413900;3228;0;3586184;1528;1;0;0
FR;3;2021-09-29;40;218;10;0;222;15;0;0;0;4415622;3414118;3238;0;3586406;1543;1;0;0
FR;3;2021-09-30;40;200;8;0;204;11;0;0;0;4415662;3414318;3246;0;3586610;1554;1;0;0
FR;3;2021-10-01;23;159;6;0;161;8;0;0;0;4415685;3414477;3252;0;3586771;1562;1;0;0
FR;3;2021-10-02;17;88;0;0;89;0;0;0;0;4415702;3414565;3252;0;3586860;1562;1;0;0
FR;3;2021-10-03;19;19;1;0;19;2;0;0;0;4415721;3414584;3253;0;3586879;1564;1;0;0
FR;3;2021-10-04;33;157;4;0;162;4;0;0;0;4415754;3414741;3257;0;3587041;1568;1;0;0
FR;3;2021-10-05;17;148;10;0;153;12;0;0;0;4415771;3414889;3267;0;3587194;1580;1;0;0
FR;3;2021-10-06;34;144;9;0;152;10;0;0;0;4415805;3415033;3276;0;3587346;1590;1;0;0
FR;3;2021-10-07;20;132;6;0;130;6;0;0;0;4415825;3415165;3282;0;3587476;1596;1;0;0
FR;3;2021-10-08;25;136;10;0;141;9;0;0;0;4415850;3415301;3292;0;3587617;1605;1;0;0
FR;3;2021-10-09;17;72;1;0;73;1;0;0;0;4415867;3415373;3293;0;3587690;1606;1;0;0
FR;3;2021-10-10;13;17;2;0;16;3;0;0;0;4415880;3415390;3295;0;3587706;1609;1;0;0
FR;3;2021-10-11;17;116;4;0;121;5;0;0;0;4415897;3415506;3299;0;3587827;1614;1;0;0
FR;3;2021-10-12;22;99;6;0;99;6;0;0;0;4415919;3415605;3305;0;3587926;1620;1;0;0
FR;3;2021-10-13;25;114;9;0;121;7;0;0;0;4415944;3415719;3314;0;3588047;1627;1;0;0
FR;3;2021-10-14;19;138;3;0;139;4;0;0;0;4415963;3415857;3317;0;3588186;1631;1;0;0
FR;3;2021-10-15;23;140;8;0;139;13;0;0;0;4415986;3415997;3325;0;3588325;1644;1;0;0
FR;3;2021-10-16;13;66;6;0;65;8;0;0;0;4415999;3416063;3331;0;3588390;1652;1;0;0
FR;3;2021-10-17;13;24;0;0;26;0;0;0;0;4416012;3416087;3331;0;3588416;1652;1;0;0
FR;3;2021-10-18;18;112;2;0;117;2;0;0;0;4416030;3416199;3333;0;3588533;1654;1;0;0
FR;3;2021-10-19;18;112;19;0;113;21;0;0;0;4416048;3416311;3352;0;3588646;1675;1;0;0
FR;3;2021-10-20;27;125;6;0;127;7;0;0;0;4416075;3416436;3358;0;3588773;1682;1;0;0
FR;3;2021-10-21;28;120;17;0;120;13;0;0;0;4416103;3416556;3375;0;3588893;1695;1;0;0
FR;3;2021-10-22;25;103;18;0;102;21;0;0;0;4416128;3416659;3393;0;3588995;1716;1;0;0
FR;3;2021-10-23;17;53;3;0;53;2;0;0;0;4416145;3416712;3396;0;3589048;1718;1;0;0
FR;3;2021-10-24;7;36;0;0;34;0;0;0;0;4416152;3416748;3396;0;3589082;1718;1;0;0
FR;3;2021-10-25;27;141;7;0;145;7;0;0;0;4416179;3416889;3403;0;3589227;1725;1;0;0
FR;3;2021-10-26;25;96;22;0;93;19;0;0;0;4416204;3416985;3425;0;3589320;1744;1;0;0
FR;3;2021-10-27;19;91;9;0;93;9;0;0;0;4416223;3417076;3434;0;3589413;1753;1;0;0
FR;3;2021-10-28;23;114;33;0;111;36;0;0;0;4416246;3417190;3467;0;3589524;1789;1;0;0
FR;3;2021-10-29;12;98;64;0;92;54;0;0;0;4416258;3417288;3531;0;3589616;1843;1;0;0
FR;3;2021-10-30;11;62;11;1;62;10;0;0;0;4416269;3417350;3542;1;3589678;1853;1;0;0
FR;3;2021-10-31;8;25;1;0;25;1;0;0;0;4416277;3417375;3543;1;3589703;1854;1;0;0
FR;3;2021-11-01;11;22;2;0;23;1;0;0;0;4416288;3417397;3545;1;3589726;1855;1;0;0
FR;3;2021-11-02;11;100;10;0;100;12;0;0;0;4416299;3417497;3555;1;3589826;1867;1;0;0
FR;3;2021-11-03;22;105;10;0;113;10;0;0;0;4416321;3417602;3565;1;3589939;1877;1;0;0
FR;3;2021-11-04;20;88;6;0;93;5;0;0;0;4416341;3417690;3571;1;3590032;1882;1;0;0
FR;3;2021-11-05;19;119;9;1;125;6;1;0;0;4416360;3417809;3580;2;3590157;1888;2;0;0
FR;3;2021-11-06;11;54;3;0;56;3;0;0;0;4416371;3417863;3583;2;3590213;1891;2;0;0
FR;3;2021-11-07;6;23;1;0;24;1;0;0;0;4416377;3417886;3584;2;3590237;1892;2;0;0
FR;3;2021-11-08;12;124;7;0;129;5;0;0;0;4416389;3418010;3591;2;3590366;1897;2;0;0
FR;3;2021-11-09;15;123;6;0;125;6;0;0;0;4416404;3418133;3597;2;3590491;1903;2;0;0
FR;3;2021-11-10;15;130;15;0;128;16;0;0;0;4416419;3418263;3612;2;3590619;1919;2;0;0
FR;3;2021-11-11;12;49;3;0;51;3;0;0;0;4416431;3418312;3615;2;3590670;1922;2;0;0
FR;3;2021-11-12;15;126;6;0;128;5;0;0;0;4416446;3418438;3621;2;3590798;1927;2;0;0
FR;3;2021-11-13;7;66;9;0;61;10;0;0;0;4416453;3418504;3630;2;3590859;1937;2;0;0
FR;3;2021-11-14;3;24;1;0;24;1;0;0;0;4416456;3418528;3631;2;3590883;1938;2;0;0
FR;3;2021-11-15;7;161;11;0;158;12;0;0;0;4416463;3418689;3642;2;3591041;1950;2;0;0
FR;3;2021-11-16;9;125;11;0;120;10;0;0;0;4416472;3418814;3653;2;3591161;1960;2;0;0
FR;3;2021-11-17;8;134;11;0;135;8;0;0;0;4416480;3418948;3664;2;3591296;1968;2;0;0
FR;3;2021-11-18;16;131;10;0;132;11;0;0;0;4416496;3419079;3674;2;3591428;1979;2;0;0
FR;3;2021-11-19;12;178;23;0;173;28;0;0;0;4416508;3419257;3697;2;3591601;2007;2;0;0
FR;3;2021-11-20;6;101;6;0;102;6;0;0;0;4416514;3419358;3703;2;3591703;2013;2;0;0
FR;3;2021-11-21;3;25;4;0;24;4;0;0;0;4416517;3419383;3707;2;3591727;2017;2;0;0
FR;3;2021-11-22;11;185;11;0;185;11;0;0;0;4416528;3419568;3718;2;3591912;2028;2;0;0
FR;3;2021-11-23;9;181;16;0;179;15;0;0;0;4416537;3419749;3734;2;3592091;2043;2;0;0
FR;3;2021-11-24;11;180;9;0;172;17;0;0;0;4416548;3419929;3743;2;3592263;2060;2;0;0
FR;3;2021-11-25;12;197;11;0;196;11;0;0;0;4416560;3420126;3754;2;3592459;2071;2;0;0
FR;3;2021-11-26;10;251;35;0;250;33;1;0;0;4416570;3420377;3789;2;3592709;2104;3;0;0
FR;3;2021-11-27;8;124;20;0;123;21;0;0;0;4416578;3420501;3809;2;3592832;2125;3;0;0
FR;3;2021-11-28;3;56;7;0;57;7;0;0;0;4416581;3420557;3816;2;3592889;2132;3;0;0
FR;3;2021-11-29;5;214;22;0;209;23;1;0;0;4416586;3420771;3838;2;3593098;2155;4;0;0
FR;3;2021-11-30;9;282;31;0;281;33;1;0;0;4416595;3421053;3869;2;3593379;2188;5;0;0
FR;3;2021-12-01;30;316;38;0;314;40;2;0;0;4416625;3421369;3907;2;3593693;2228;7;0;0
FR;3;2021-12-02;9;338;33;0;334;36;0;0;0;4416634;3421707;3940;2;3594027;2264;7;0;0
FR;3;2021-12-03;6;364;37;0;360;38;0;0;0;4416640;3422071;3977;2;3594387;2302;7;0;0
FR;3;2021-12-04;3;201;26;0;197;28;0;0;0;4416643;3422272;4003;2;3594584;2330;7;0;0
FR;3;2021-12-05;1;61;5;0;61;5;0;0;0;4416644;3422333;4008;2;3594645;2335;7;0;0
FR;3;2021-12-06;7;351;14;0;350;15;0;0;0;4416651;3422684;4022;2;3594995;2350;7;0;0
FR;3;2021-12-07;6;411;20;0;405;24;1;0;0;4416657;3423095;4042;2;3595400;2374;8;0;0
FR;3;2021-12-08;8;375;29;0;367;30;1;0;0;4416665;3423470;4071;2;3595767;2404;9;0;0
FR;3;2021-12-09;3;424;17;0;411;22;1;0;0;4416668;3423894;4088;2;3596178;2426;10;0;0
FR;3;2021-12-10;10;443;29;0;440;25;0;0;0;4416678;3424337;4117;2;3596618;2451;10;0;0
FR;3;2021-12-11;4;299;10;0;296;9;2;0;0;4416682;3424636;4127;2;3596914;2460;12;0;0
FR;3;2021-12-12;1;96;3;0;96;3;0;0;0;4416683;3424732;4130;2;3597010;2463;12;0;0
FR;3;2021-12-13;2;432;19;0;426;21;0;0;0;4416685;3425164;4149;2;3597436;2484;12;0;0
FR;3;2021-12-14;8;551;18;0;539;21;1;0;0;4416693;3425715;4167;2;3597975;2505;13;0;0
FR;3;2021-12-15;10;523;17;0;510;21;0;0;0;4416703;3426238;4184;2;3598485;2526;13;0;0
FR;3;2021-12-16;10;529;19;0;523;18;3;0;0;4416713;3426767;4203;2;3599008;2544;16;0;0
FR;3;2021-12-17;5;593;18;0;589;19;0;0;0;4416718;3427360;4221;2;3599597;2563;16;0;0
FR;3;2021-12-18;5;344;4;0;338;5;1;0;0;4416723;3427704;4225;2;3599935;2568;17;0;0
FR;3;2021-12-19;3;176;2;0;174;2;0;0;0;4416726;3427880;4227;2;3600109;2570;17;0;0
FR;3;2021-12-20;10;567;23;0;561;28;0;0;0;4416736;3428447;4250;2;3600670;2598;17;0;0
FR;3;2021-12-21;5;660;10;0;652;13;2;0;0;4416741;3429107;4260;2;3601322;2611;19;0;0
FR;3;2021-12-22;10;614;9;0;608;10;1;0;0;4416751;3429721;4269;2;3601930;2621;20;0;0
FR;3;2021-12-23;4;539;8;0;537;8;0;0;0;4416755;3430260;4277;2;3602467;2629;20;0;0
FR;3;2021-12-24;2;233;3;0;228;6;0;0;0;4416757;3430493;4280;2;3602695;2635;20;0;0
FR;3;2021-12-25;0;24;0;0;24;0;0;0;0;4416757;3430517;4280;2;3602719;2635;20;0;0
FR;3;2021-12-26;0;87;1;0;87;1;0;0;0;4416757;3430604;4281;2;3602806;2636;20;0;0
FR;3;2021-12-27;7;456;17;0;453;20;1;0;0;4416764;3431060;4298;2;3603259;2656;21;0;0
FR;3;2021-12-28;3;573;6;0;572;5;0;0;0;4416767;3431633;4304;2;3603831;2661;21;0;0
FR;3;2021-12-29;5;488;14;0;483;16;0;0;0;4416772;3432121;4318;2;3604314;2677;21;0;0
FR;3;2021-12-30;3;517;7;0;510;10;2;0;0;4416775;3432638;4325;2;3604824;2687;23;0;0
FR;3;2021-12-31;0;182;5;0;178;7;0;0;0;4416775;3432820;4330;2;3605002;2694;23;0;0
FR;3;2022-01-01;0;26;0;0;24;2;0;0;0;4416775;3432846;4330;2;3605026;2696;23;0;0
FR;3;2022-01-02;0;76;0;0;76;0;0;0;0;4416775;3432922;4330;2;3605102;2696;23;0;0
FR;3;2022-01-03;5;489;17;0;479;21;3;0;0;4416780;3433411;4347;2;3605581;2717;26;0;0
FR;3;2022-01-04;7;536;9;0;535;8;0;0;0;4416787;3433947;4356;2;3606116;2725;26;0;0
FR;3;2022-01-05;5;487;10;0;479;14;1;0;0;4416792;3434434;4366;2;3606595;2739;27;0;0
FR;3;2022-01-06;6;464;9;0;459;10;1;0;0;4416798;3434898;4375;2;3607054;2749;28;0;0
FR;3;2022-01-07;2;490;11;0;484;13;1;0;1;4416800;3435388;4386;2;3607538;2762;29;0;1
FR;3;2022-01-08;6;251;4;0;248;5;0;0;0;4416806;3435639;4390;2;3607786;2767;29;0;1
FR;3;2022-01-09;0;116;0;0;116;0;0;0;0;4416806;3435755;4390;2;3607902;2767;29;0;1
FR;3;2022-01-10;2;421;12;0;419;12;0;0;0;4416808;3436176;4402;2;3608321;2779;29;0;1
FR;3;2022-01-11;3;456;1;0;455;1;0;0;0;4416811;3436632;4403;2;3608776;2780;29;0;1
FR;3;2022-01-12;4;393;9;0;390;10;2;0;0;4416815;3437025;4412;2;3609166;2790;31;0;1
FR;3;2022-01-13;3;382;11;0;380;12;1;0;0;4416818;3437407;4423;2;3609546;2802;32;0;1
FR;3;2022-01-14;4;420;10;0;414;13;1;0;0;4416822;3437827;4433;2;3609960;2815;33;0;1
FR;3;2022-01-15;0;275;2;0;271;3;0;0;0;4416822;3438102;4435;2;3610231;2818;33;0;1
FR;3;2022-01-16;1;108;1;0;106;1;1;0;0;4416823;3438210;4436;2;3610337;2819;34;0;1
FR;3;2022-01-17;2;318;8;0;315;9;1;0;0;4416825;3438528;4444;2;3610652;2828;35;0;1
FR;3;2022-01-18;2;359;1;0;355;2;1;0;0;4416827;3438887;4445;2;3611007;2830;36;0;1
FR;3;2022-01-19;2;322;5;0;316;10;0;0;0;4416829;3439209;4450;2;3611323;2840;36;0;1
FR;3;2022-01-20;1;351;5;0;350;3;2;0;0;4416830;3439560;4455;2;3611673;2843;38;0;1
FR;3;2022-01-21;4;337;5;0;331;7;2;0;0;4416834;3439897;4460;2;3612004;2850;40;0;1
FR;3;2022-01-22;2;218;1;0;214;2;3;0;0;4416836;3440115;4461;2;3612218;2852;43;0;1
FR;3;2022-01-23;0;77;0;0;75;1;1;0;0;4416836;3440192;4461;2;3612293;2853;44;0;1
FR;3;2022-01-24;3;316;1;0;308;6;2;0;0;4416839;3440508;4462;2;3612601;2859;46;0;1
FR;3;2022-01-25;0;171;0;0;168;0;1;0;0;4416839;3440679;4462;2;3612769;2859;47;0;1
FR;3;2022-01-26;0;77;0;0;77;0;0;0;0;4416839;3440756;4462;2;3612846;2859;47;0;1
FR;3;2022-01-27;0;52;0;0;52;0;0;0;0;4416839;3440808;4462;2;3612898;2859;47;0;1
FR;3;2022-01-28;0;115;0;0;114;0;0;0;0;4416839;3440923;4462;2;3613012;2859;47;0;1
FR;3;2022-01-29;0;97;0;0;97;0;0;0;0;4416839;3441020;4462;2;3613109;2859;47;0;1
FR;3;2022-01-30;0;50;0;0;50;0;0;0;0;4416839;3441070;4462;2;3613159;2859;47;0;1
FR;3;2022-01-31;0;91;0;0;91;0;0;0;0;4416839;3441161;4462;2;3613250;2859;47;0;1
FR;3;2022-02-01;0;98;0;0;96;1;0;0;0;4416839;3441259;4462;2;3613346;2860;47;0;1
FR;3;2022-02-02;0;85;0;0;83;0;0;0;0;4416839;3441344;4462;2;3613429;2860;47;0;1
FR;3;2022-02-03;0;91;0;0;89;0;0;0;0;4416839;3441435;4462;2;3613518;2860;47;0;1
FR;3;2022-02-04;0;113;0;0;110;0;1;0;0;4416839;3441548;4462;2;3613628;2860;48;0;1
FR;3;2022-02-05;0;70;0;0;70;0;0;0;0;4416839;3441618;4462;2;3613698;2860;48;0;1
FR;3;2022-02-06;0;10;0;0;10;0;0;0;0;4416839;3441628;4462;2;3613708;2860;48;0;1
FR;3;2022-02-07;0;75;0;0;75;0;0;0;0;4416839;3441703;4462;2;3613783;2860;48;0;1
FR;3;2022-02-08;0;0;0;0;0;0;0;0;0;4416839;3441703;4462;2;3613783;2860;48;0;1
FR;3;2022-02-09;0;0;0;0;0;0;0;0;0;4416839;3441703;4462;2;3613783;2860;48;0;1
FR;3;2022-02-10;0;0;0;0;0;0;0;0;0;4416839;3441703;4462;2;3613783;2860;48;0;1
FR;3;2022-02-11;0;0;0;0;0;0;0;0;0;4416839;3441703;4462;2;3613783;2860;48;0;1
FR;3;2022-02-12;0;0;0;0;0;0;0;0;0;4416839;3441703;4462;2;3613783;2860;48;0;1
FR;3;2022-02-13;0;0;0;0;0;0;0;0;0;4416839;3441703;4462;2;3613783;2860;48;0;1
FR;3;2022-02-14;0;0;0;0;0;0;0;0;0;4416839;3441703;4462;2;3613783;2860;48;0;1
FR;3;2022-02-15;0;0;0;0;0;0;0;0;0;4416839;3441703;4462;2;3613783;2860;48;0;1
FR;3;2022-02-16;0;0;0;0;0;0;0;0;0;4416839;3441703;4462;2;3613783;2860;48;0;1
FR;3;2022-02-17;0;0;0;0;0;0;0;0;0;4416839;3441703;4462;2;3613783;2860;48;0;1
FR;3;2022-02-18;0;0;0;0;0;0;0;0;0;4416839;3441703;4462;2;3613783;2860;48;0;1
FR;3;2022-02-19;0;0;0;0;0;0;0;0;0;4416839;3441703;4462;2;3613783;2860;48;0;1
FR;3;2022-02-20;0;0;0;0;0;0;0;0;0;4416839;3441703;4462;2;3613783;2860;48;0;1
FR;3;2022-02-21;2;0;0;0;0;0;0;0;0;4416841;3441703;4462;2;3613783;2860;48;0;1
FR;3;2022-02-22;0;0;0;0;0;0;0;0;0;4416841;3441703;4462;2;3613783;2860;48;0;1
FR;3;2022-02-23;0;0;0;0;0;0;0;0;0;4416841;3441703;4462;2;3613783;2860;48;0;1
FR;3;2022-02-24;0;0;0;0;0;0;0;0;0;4416841;3441703;4462;2;3613783;2860;48;0;1
FR;3;2022-02-25;0;0;0;0;0;0;0;0;0;4416841;3441703;4462;2;3613783;2860;48;0;1
FR;3;2022-02-26;0;0;0;0;0;0;0;0;0;4416841;3441703;4462;2;3613783;2860;48;0;1
FR;3;2022-02-27;0;0;0;0;0;0;0;0;0;4416841;3441703;4462;2;3613783;2860;48;0;1
FR;3;2022-02-28;1;0;0;0;0;0;0;0;0;4416842;3441703;4462;2;3613783;2860;48;0;1
FR;3;2022-03-01;1;0;0;0;0;0;0;0;0;4416843;3441703;4462;2;3613783;2860;48;0;1
FR;3;2022-03-02;0;0;0;0;0;0;0;0;0;4416843;3441703;4462;2;3613783;2860;48;0;1
FR;3;2022-03-03;0;0;0;0;0;0;0;0;0;4416843;3441703;4462;2;3613783;2860;48;0;1
FR;3;2022-03-04;0;0;0;0;0;0;0;0;0;4416843;3441703;4462;2;3613783;2860;48;0;1
FR;3;2022-03-05;0;0;0;0;0;0;0;0;0;4416843;3441703;4462;2;3613783;2860;48;0;1
FR;3;2022-03-06;1;0;0;0;0;0;0;0;0;4416844;3441703;4462;2;3613783;2860;48;0;1
FR;3;2022-03-07;0;0;0;0;0;0;0;0;0;4416844;3441703;4462;2;3613783;2860;48;0;1
FR;3;2022-03-08;1;0;0;0;0;0;0;0;0;4416845;3441703;4462;2;3613783;2860;48;0;1
FR;3;2022-03-09;0;0;0;0;0;0;0;0;0;4416845;3441703;4462;2;3613783;2860;48;0;1
FR;3;2022-03-10;0;0;0;0;0;0;0;0;0;4416845;3441703;4462;2;3613783;2860;48;0;1
FR;3;2022-03-11;0;0;0;0;0;0;0;0;0;4416845;3441703;4462;2;3613783;2860;48;0;1
FR;3;2022-03-12;0;0;0;0;0;0;0;0;0;4416845;3441703;4462;2;3613783;2860;48;0;1
FR;3;2022-03-13;0;0;0;0;0;0;0;0;0;4416845;3441703;4462;2;3613783;2860;48;0;1
FR;3;2022-03-14;0;0;0;0;0;0;0;0;0;4416845;3441703;4462;2;3613783;2860;48;0;1
FR;3;2022-03-15;0;0;0;0;0;0;0;0;0;4416845;3441703;4462;2;3613783;2860;48;0;1
FR;3;2022-03-16;0;0;0;0;0;0;0;0;0;4416845;3441703;4462;2;3613783;2860;48;0;1
FR;3;2022-03-17;0;0;0;0;0;0;0;0;0;4416845;3441703;4462;2;3613783;2860;48;0;1
FR;3;2022-03-18;0;0;0;0;0;0;0;0;0;4416845;3441703;4462;2;3613783;2860;48;0;1
FR;3;2022-03-19;0;0;0;0;0;0;0;0;0;4416845;3441703;4462;2;3613783;2860;48;0;1
FR;3;2022-03-20;1;0;0;0;0;0;0;0;0;4416846;3441703;4462;2;3613783;2860;48;0;1
FR;3;2022-03-21;0;0;0;0;0;0;0;0;0;4416846;3441703;4462;2;3613783;2860;48;0;1
FR;3;2022-03-22;0;0;0;0;0;0;0;0;0;4416846;3441703;4462;2;3613783;2860;48;0;1
FR;3;2022-03-23;1;0;0;0;0;0;0;0;0;4416847;3441703;4462;2;3613783;2860;48;0;1
FR;3;2022-03-24;0;0;0;0;0;0;0;0;0;4416847;3441703;4462;2;3613783;2860;48;0;1
FR;3;2022-03-25;1;0;0;0;0;0;0;0;0;4416848;3441703;4462;2;3613783;2860;48;0;1
FR;3;2022-03-26;0;0;0;0;0;0;0;0;0;4416848;3441703;4462;2;3613783;2860;48;0;1
FR;3;2022-03-27;0;0;0;0;0;0;0;0;0;4416848;3441703;4462;2;3613783;2860;48;0;1
FR;3;2022-03-28;0;0;0;0;0;0;0;0;0;4416848;3441703;4462;2;3613783;2860;48;0;1
FR;3;2022-03-29;0;0;0;0;0;0;0;0;0;4416848;3441703;4462;2;3613783;2860;48;0;1
FR;3;2022-03-30;0;0;0;0;0;0;0;0;0;4416848;3441703;4462;2;3613783;2860;48;0;1
FR;3;2022-03-31;0;0;0;0;0;0;0;0;0;4416848;3441703;4462;2;3613783;2860;48;0;1
FR;3;2022-04-01;0;0;0;0;0;0;0;0;0;4416848;3441703;4462;2;3613783;2860;48;0;1
FR;3;2022-04-02;0;0;0;0;0;0;0;0;0;4416848;3441703;4462;2;3613783;2860;48;0;1
FR;3;2022-04-03;0;0;0;0;0;0;0;0;0;4416848;3441703;4462;2;3613783;2860;48;0;1
FR;3;2022-04-04;0;0;0;0;0;0;0;0;0;4416848;3441703;4462;2;3613783;2860;48;0;1
FR;3;2022-04-05;0;0;0;0;0;0;0;0;0;4416848;3441703;4462;2;3613783;2860;48;0;1
FR;3;2022-04-06;0;0;0;0;0;0;0;0;0;4416848;3441703;4462;2;3613783;2860;48;0;1
FR;3;2022-04-07;0;0;0;0;0;0;0;0;0;4416848;3441703;4462;2;3613783;2860;48;0;1
FR;3;2022-04-08;0;0;0;0;0;0;0;0;0;4416848;3441703;4462;2;3613783;2860;48;0;1
FR;3;2022-04-09;0;0;0;0;0;0;0;0;0;4416848;3441703;4462;2;3613783;2860;48;0;1
FR;3;2022-04-10;0;0;0;0;0;0;0;0;0;4416848;3441703;4462;2;3613783;2860;48;0;1
FR;3;2022-04-11;0;0;0;0;0;0;0;0;0;4416848;3441703;4462;2;3613783;2860;48;0;1
FR;3;2022-04-12;0;0;0;0;0;0;0;0;0;4416848;3441703;4462;2;3613783;2860;48;0;1
FR;3;2022-04-13;0;0;0;0;0;0;0;0;0;4416848;3441703;4462;2;3613783;2860;48;0;1
FR;3;2022-04-14;0;0;0;0;0;0;0;0;0;4416848;3441703;4462;2;3613783;2860;48;0;1
FR;3;2022-04-15;1;0;0;0;0;0;0;0;0;4416849;3441703;4462;2;3613783;2860;48;0;1
FR;3;2022-04-16;0;0;0;0;0;0;0;0;0;4416849;3441703;4462;2;3613783;2860;48;0;1
FR;3;2022-04-17;0;0;0;0;0;0;0;0;0;4416849;3441703;4462;2;3613783;2860;48;0;1
FR;3;2022-04-18;0;0;0;0;0;0;0;0;0;4416849;3441703;4462;2;3613783;2860;48;0;1
FR;3;2022-04-19;0;0;0;0;0;0;0;0;0;4416849;3441703;4462;2;3613783;2860;48;0;1
FR;3;2022-04-20;0;0;0;0;0;0;0;0;0;4416849;3441703;4462;2;3613783;2860;48;0;1
FR;3;2022-04-21;0;0;0;0;0;0;0;0;0;4416849;3441703;4462;2;3613783;2860;48;0;1
FR;3;2022-04-22;0;0;0;0;0;0;0;0;0;4416849;3441703;4462;2;3613783;2860;48;0;1
FR;3;2022-04-23;0;0;0;0;0;0;0;0;0;4416849;3441703;4462;2;3613783;2860;48;0;1
FR;3;2022-04-24;0;0;0;0;0;0;0;0;0;4416849;3441703;4462;2;3613783;2860;48;0;1
FR;3;2022-04-25;0;0;0;0;0;0;0;0;0;4416849;3441703;4462;2;3613783;2860;48;0;1
FR;3;2022-04-26;0;0;0;0;0;0;0;0;0;4416849;3441703;4462;2;3613783;2860;48;0;1
FR;3;2022-04-27;0;0;0;0;0;0;0;0;0;4416849;3441703;4462;2;3613783;2860;48;0;1
FR;3;2022-04-28;0;0;0;0;0;0;0;0;0;4416849;3441703;4462;2;3613783;2860;48;0;1
FR;3;2022-04-29;0;0;0;0;0;0;0;0;0;4416849;3441703;4462;2;3613783;2860;48;0;1
FR;3;2022-04-30;0;0;0;0;0;0;0;0;0;4416849;3441703;4462;2;3613783;2860;48;0;1
FR;3;2022-05-01;0;0;0;0;0;0;0;0;0;4416849;3441703;4462;2;3613783;2860;48;0;1
FR;3;2022-05-02;0;0;0;0;0;0;0;0;0;4416849;3441703;4462;2;3613783;2860;48;0;1
FR;3;2022-05-03;0;0;0;0;0;0;0;0;0;4416849;3441703;4462;2;3613783;2860;48;0;1
FR;3;2022-05-04;0;0;0;0;0;0;0;0;0;4416849;3441703;4462;2;3613783;2860;48;0;1
FR;3;2022-05-05;0;0;0;0;0;0;0;0;0;4416849;3441703;4462;2;3613783;2860;48;0;1
FR;3;2022-05-06;0;0;0;0;0;0;0;0;0;4416849;3441703;4462;2;3613783;2860;48;0;1
FR;3;2022-05-07;0;0;0;0;0;0;0;0;0;4416849;3441703;4462;2;3613783;2860;48;0;1
FR;3;2022-05-08;0;0;0;0;0;0;0;0;0;4416849;3441703;4462;2;3613783;2860;48;0;1
FR;3;2022-05-09;0;0;0;0;0;0;0;0;0;4416849;3441703;4462;2;3613783;2860;48;0;1
FR;3;2022-05-10;0;0;0;0;0;0;0;0;0;4416849;3441703;4462;2;3613783;2860;48;0;1
FR;3;2022-05-11;0;0;0;0;0;0;0;0;0;4416849;3441703;4462;2;3613783;2860;48;0;1
FR;3;2022-05-12;0;0;0;0;0;0;0;0;0;4416849;3441703;4462;2;3613783;2860;48;0;1
FR;3;2022-05-13;0;0;0;0;0;0;0;0;0;4416849;3441703;4462;2;3613783;2860;48;0;1
FR;3;2022-05-14;1;0;0;0;0;0;0;0;0;4416850;3441703;4462;2;3613783;2860;48;0;1
FR;3;2022-05-15;0;0;0;0;0;0;0;0;0;4416850;3441703;4462;2;3613783;2860;48;0;1
FR;3;2022-05-16;0;0;0;0;0;0;0;0;0;4416850;3441703;4462;2;3613783;2860;48;0;1
FR;3;2022-05-17;0;0;0;0;0;0;0;0;0;4416850;3441703;4462;2;3613783;2860;48;0;1
FR;3;2022-05-18;0;0;0;0;0;0;0;0;0;4416850;3441703;4462;2;3613783;2860;48;0;1
FR;3;2022-05-19;0;0;0;0;0;0;0;0;0;4416850;3441703;4462;2;3613783;2860;48;0;1
FR;3;2022-05-20;0;0;0;0;0;0;0;0;0;4416850;3441703;4462;2;3613783;2860;48;0;1
FR;3;2022-05-21;0;0;0;0;0;0;0;0;0;4416850;3441703;4462;2;3613783;2860;48;0;1
FR;3;2022-05-22;0;0;0;0;0;0;0;0;0;4416850;3441703;4462;2;3613783;2860;48;0;1
FR;3;2022-05-23;0;0;0;0;0;0;0;0;0;4416850;3441703;4462;2;3613783;2860;48;0;1
FR;3;2022-05-24;0;0;0;0;0;0;0;0;0;4416850;3441703;4462;2;3613783;2860;48;0;1
FR;3;2022-05-25;0;0;0;0;0;0;0;0;0;4416850;3441703;4462;2;3613783;2860;48;0;1
FR;3;2022-05-26;0;0;0;0;0;0;0;0;0;4416850;3441703;4462;2;3613783;2860;48;0;1
FR;3;2022-05-27;0;0;0;0;0;0;0;0;0;4416850;3441703;4462;2;3613783;2860;48;0;1
FR;3;2022-05-28;0;0;0;0;0;0;0;0;0;4416850;3441703;4462;2;3613783;2860;48;0;1
FR;3;2022-05-29;0;0;0;0;0;0;0;0;0;4416850;3441703;4462;2;3613783;2860;48;0;1
FR;3;2022-05-30;0;0;0;0;0;0;0;0;0;4416850;3441703;4462;2;3613783;2860;48;0;1
FR;3;2022-05-31;0;0;0;0;0;0;0;0;0;4416850;3441703;4462;2;3613783;2860;48;0;1
FR;3;2022-06-01;0;0;0;0;0;0;0;0;0;4416850;3441703;4462;2;3613783;2860;48;0;1
FR;3;2022-06-02;0;0;0;0;0;0;0;0;0;4416850;3441703;4462;2;3613783;2860;48;0;1
FR;3;2022-06-03;0;0;0;0;0;0;0;0;0;4416850;3441703;4462;2;3613783;2860;48;0;1
FR;3;2022-06-04;0;0;0;0;0;0;0;0;0;4416850;3441703;4462;2;3613783;2860;48;0;1
FR;3;2022-06-05;0;0;0;0;0;0;0;0;0;4416850;3441703;4462;2;3613783;2860;48;0;1
FR;3;2022-06-06;0;0;0;0;0;0;0;0;0;4416850;3441703;4462;2;3613783;2860;48;0;1
FR;3;2022-06-07;0;0;0;0;0;0;0;0;0;4416850;3441703;4462;2;3613783;2860;48;0;1
FR;3;2022-06-08;0;0;0;0;0;0;0;0;0;4416850;3441703;4462;2;3613783;2860;48;0;1
FR;3;2022-06-09;0;0;0;0;0;0;0;0;0;4416850;3441703;4462;2;3613783;2860;48;0;1
FR;3;2022-06-10;0;0;0;0;0;0;0;0;0;4416850;3441703;4462;2;3613783;2860;48;0;1
FR;3;2022-06-11;0;0;0;0;0;0;0;0;0;4416850;3441703;4462;2;3613783;2860;48;0;1
FR;3;2022-06-12;0;0;0;0;0;0;0;0;0;4416850;3441703;4462;2;3613783;2860;48;0;1
FR;3;2022-06-13;1;0;0;0;0;0;0;0;0;4416851;3441703;4462;2;3613783;2860;48;0;1
FR;3;2022-06-14;0;0;0;0;0;0;0;0;0;4416851;3441703;4462;2;3613783;2860;48;0;1
FR;3;2022-06-15;0;0;0;0;0;0;0;0;0;4416851;3441703;4462;2;3613783;2860;48;0;1
FR;3;2022-06-16;0;0;0;0;0;0;0;0;0;4416851;3441703;4462;2;3613783;2860;48;0;1
FR;3;2022-06-17;0;0;0;0;0;0;0;0;0;4416851;3441703;4462;2;3613783;2860;48;0;1
FR;3;2022-06-18;0;0;0;0;0;0;0;0;0;4416851;3441703;4462;2;3613783;2860;48;0;1
FR;3;2022-06-19;0;0;0;0;0;0;0;0;0;4416851;3441703;4462;2;3613783;2860;48;0;1
FR;3;2022-06-20;0;0;0;0;0;0;0;0;0;4416851;3441703;4462;2;3613783;2860;48;0;1
FR;3;2022-06-21;0;0;0;0;0;0;0;0;0;4416851;3441703;4462;2;3613783;2860;48;0;1
FR;3;2022-06-22;0;0;0;0;0;0;0;0;0;4416851;3441703;4462;2;3613783;2860;48;0;1
FR;3;2022-06-23;0;0;0;0;0;0;0;0;0;4416851;3441703;4462;2;3613783;2860;48;0;1
FR;3;2022-06-24;0;0;0;0;0;0;0;0;0;4416851;3441703;4462;2;3613783;2860;48;0;1
FR;3;2022-06-25;0;0;0;0;0;0;0;0;0;4416851;3441703;4462;2;3613783;2860;48;0;1
FR;3;2022-06-26;0;0;0;0;0;0;0;0;0;4416851;3441703;4462;2;3613783;2860;48;0;1
FR;3;2022-06-27;0;0;0;0;0;0;0;0;0;4416851;3441703;4462;2;3613783;2860;48;0;1
FR;3;2022-06-28;0;0;0;0;0;0;0;0;0;4416851;3441703;4462;2;3613783;2860;48;0;1
FR;3;2022-06-29;1;0;0;0;0;0;0;0;0;4416852;3441703;4462;2;3613783;2860;48;0;1
FR;3;2022-06-30;0;0;0;0;0;0;0;0;0;4416852;3441703;4462;2;3613783;2860;48;0;1
FR;3;2022-07-01;0;0;0;0;0;0;0;0;0;4416852;3441703;4462;2;3613783;2860;48;0;1
FR;3;2022-07-02;0;0;0;0;0;0;0;0;0;4416852;3441703;4462;2;3613783;2860;48;0;1
FR;3;2022-07-03;0;0;0;0;0;0;0;0;0;4416852;3441703;4462;2;3613783;2860;48;0;1
FR;3;2022-07-04;0;0;0;0;0;0;0;0;0;4416852;3441703;4462;2;3613783;2860;48;0;1
FR;3;2022-07-05;0;0;0;0;0;0;0;0;0;4416852;3441703;4462;2;3613783;2860;48;0;1
FR;3;2022-07-06;0;0;0;0;0;0;0;0;0;4416852;3441703;4462;2;3613783;2860;48;0;1
FR;3;2022-07-07;0;0;0;0;0;0;0;0;0;4416852;3441703;4462;2;3613783;2860;48;0;1
FR;3;2022-07-08;0;0;0;0;0;0;0;0;0;4416852;3441703;4462;2;3613783;2860;48;0;1
FR;3;2022-07-09;0;0;0;0;0;0;0;0;0;4416852;3441703;4462;2;3613783;2860;48;0;1
FR;3;2022-07-10;0;0;0;0;0;0;0;0;0;4416852;3441703;4462;2;3613783;2860;48;0;1
FR;3;2022-07-11;0;0;0;0;0;0;0;0;0;4416852;3441703;4462;2;3613783;2860;48;0;1
FR;3;2022-07-12;0;0;0;0;0;0;0;0;0;4416852;3441703;4462;2;3613783;2860;48;0;1
FR;3;2022-07-13;0;0;0;0;0;0;0;0;0;4416852;3441703;4462;2;3613783;2860;48;0;1
FR;3;2022-07-14;0;0;0;0;0;0;0;0;0;4416852;3441703;4462;2;3613783;2860;48;0;1
FR;3;2022-07-15;0;0;0;0;0;0;0;0;0;4416852;3441703;4462;2;3613783;2860;48;0;1
FR;3;2022-07-16;0;0;0;0;0;0;0;0;0;4416852;3441703;4462;2;3613783;2860;48;0;1
FR;3;2022-07-17;0;0;0;0;0;0;0;0;0;4416852;3441703;4462;2;3613783;2860;48;0;1
FR;3;2022-07-18;0;0;0;0;0;0;0;0;0;4416852;3441703;4462;2;3613783;2860;48;0;1
FR;3;2022-07-19;0;0;0;0;0;0;0;0;0;4416852;3441703;4462;2;3613783;2860;48;0;1
FR;3;2022-07-20;0;0;0;0;0;0;0;0;0;4416852;3441703;4462;2;3613783;2860;48;0;1
FR;3;2022-07-21;0;0;0;0;0;0;0;0;0;4416852;3441703;4462;2;3613783;2860;48;0;1
FR;3;2022-07-22;0;0;0;0;0;0;0;0;0;4416852;3441703;4462;2;3613783;2860;48;0;1
FR;3;2022-07-23;0;0;0;0;0;0;0;0;0;4416852;3441703;4462;2;3613783;2860;48;0;1
FR;3;2022-07-24;0;0;0;0;0;0;0;0;0;4416852;3441703;4462;2;3613783;2860;48;0;1
FR;3;2022-07-25;0;0;0;0;0;0;0;0;0;4416852;3441703;4462;2;3613783;2860;48;0;1
FR;3;2022-07-26;0;0;0;0;0;0;0;0;0;4416852;3441703;4462;2;3613783;2860;48;0;1
FR;3;2022-07-27;0;0;0;0;0;0;0;0;0;4416852;3441703;4462;2;3613783;2860;48;0;1
FR;3;2022-07-28;0;0;0;0;0;0;0;0;0;4416852;3441703;4462;2;3613783;2860;48;0;1
FR;3;2022-07-29;0;0;0;0;0;0;0;0;0;4416852;3441703;4462;2;3613783;2860;48;0;1
FR;3;2022-07-30;0;0;0;0;0;0;0;0;0;4416852;3441703;4462;2;3613783;2860;48;0;1
FR;3;2022-07-31;0;0;0;0;0;0;0;0;0;4416852;3441703;4462;2;3613783;2860;48;0;1
FR;3;2022-08-01;0;0;0;0;0;0;0;0;0;4416852;3441703;4462;2;3613783;2860;48;0;1
FR;3;2022-08-02;0;0;0;0;0;0;0;0;0;4416852;3441703;4462;2;3613783;2860;48;0;1
FR;3;2022-08-03;0;0;0;0;0;0;0;0;0;4416852;3441703;4462;2;3613783;2860;48;0;1
FR;3;2022-08-04;0;0;0;0;0;0;0;0;0;4416852;3441703;4462;2;3613783;2860;48;0;1
FR;3;2022-08-05;0;0;0;0;0;0;0;0;0;4416852;3441703;4462;2;3613783;2860;48;0;1
FR;3;2022-08-06;0;0;0;0;0;0;0;0;0;4416852;3441703;4462;2;3613783;2860;48;0;1
FR;3;2022-08-07;0;0;0;0;0;0;0;0;0;4416852;3441703;4462;2;3613783;2860;48;0;1
FR;3;2022-08-08;0;0;0;0;0;0;0;0;0;4416852;3441703;4462;2;3613783;2860;48;0;1
FR;3;2022-08-09;0;0;0;0;0;0;0;0;0;4416852;3441703;4462;2;3613783;2860;48;0;1
FR;3;2022-08-10;0;0;0;0;0;0;0;0;0;4416852;3441703;4462;2;3613783;2860;48;0;1
FR;3;2022-08-11;0;0;0;0;0;0;0;0;0;4416852;3441703;4462;2;3613783;2860;48;0;1
FR;3;2022-08-12;0;0;0;0;0;0;0;0;0;4416852;3441703;4462;2;3613783;2860;48;0;1
FR;3;2022-08-13;0;0;0;0;0;0;0;0;0;4416852;3441703;4462;2;3613783;2860;48;0;1
FR;3;2022-08-14;0;0;0;0;0;0;0;0;0;4416852;3441703;4462;2;3613783;2860;48;0;1
FR;3;2022-08-15;0;0;0;0;0;0;0;0;0;4416852;3441703;4462;2;3613783;2860;48;0;1
FR;3;2022-08-16;0;0;0;0;0;0;0;0;0;4416852;3441703;4462;2;3613783;2860;48;0;1
FR;3;2022-08-17;0;0;0;0;0;0;0;0;0;4416852;3441703;4462;2;3613783;2860;48;0;1
FR;3;2022-08-18;0;0;0;0;0;0;0;0;0;4416852;3441703;4462;2;3613783;2860;48;0;1
FR;3;2022-08-19;0;0;0;0;0;0;0;0;0;4416852;3441703;4462;2;3613783;2860;48;0;1
FR;3;2022-08-20;0;0;0;0;0;0;0;0;0;4416852;3441703;4462;2;3613783;2860;48;0;1
FR;3;2022-08-21;0;0;0;0;0;0;0;0;0;4416852;3441703;4462;2;3613783;2860;48;0;1
FR;3;2022-08-22;0;0;0;0;0;0;0;0;0;4416852;3441703;4462;2;3613783;2860;48;0;1
FR;3;2022-08-23;0;0;0;0;0;0;0;0;0;4416852;3441703;4462;2;3613783;2860;48;0;1
FR;3;2022-08-24;0;0;0;0;0;0;0;0;0;4416852;3441703;4462;2;3613783;2860;48;0;1
FR;3;2022-08-25;0;0;0;0;0;0;0;0;0;4416852;3441703;4462;2;3613783;2860;48;0;1
FR;3;2022-08-26;0;0;0;0;0;0;0;0;0;4416852;3441703;4462;2;3613783;2860;48;0;1
FR;3;2022-08-27;0;0;0;0;0;0;0;0;0;4416852;3441703;4462;2;3613783;2860;48;0;1
FR;3;2022-08-28;0;0;0;0;0;0;0;0;0;4416852;3441703;4462;2;3613783;2860;48;0;1
FR;3;2022-08-29;0;0;0;0;0;0;0;0;0;4416852;3441703;4462;2;3613783;2860;48;0;1
FR;3;2022-08-30;0;0;0;0;0;0;0;0;0;4416852;3441703;4462;2;3613783;2860;48;0;1
FR;3;2022-08-31;0;0;0;0;0;0;0;0;0;4416852;3441703;4462;2;3613783;2860;48;0;1
FR;3;2022-09-01;0;0;0;0;0;0;0;0;0;4416852;3441703;4462;2;3613783;2860;48;0;1
FR;3;2022-09-02;0;0;0;0;0;0;0;0;0;4416852;3441703;4462;2;3613783;2860;48;0;1
FR;3;2022-09-03;0;0;0;0;0;0;0;0;0;4416852;3441703;4462;2;3613783;2860;48;0;1
FR;3;2022-09-04;0;0;0;0;0;0;0;0;0;4416852;3441703;4462;2;3613783;2860;48;0;1
FR;3;2022-09-05;0;0;0;0;0;0;0;0;0;4416852;3441703;4462;2;3613783;2860;48;0;1
FR;3;2022-09-06;0;0;0;0;0;0;0;0;0;4416852;3441703;4462;2;3613783;2860;48;0;1
FR;3;2022-09-07;0;0;0;0;0;0;0;0;0;4416852;3441703;4462;2;3613783;2860;48;0;1
FR;3;2022-09-08;0;0;0;0;0;0;0;0;0;4416852;3441703;4462;2;3613783;2860;48;0;1
FR;3;2022-09-09;0;0;0;0;0;0;0;0;0;4416852;3441703;4462;2;3613783;2860;48;0;1
FR;3;2022-09-10;0;0;0;0;0;0;0;0;0;4416852;3441703;4462;2;3613783;2860;48;0;1
FR;3;2022-09-11;0;0;0;0;0;0;0;0;0;4416852;3441703;4462;2;3613783;2860;48;0;1
FR;3;2022-09-12;0;0;0;0;0;0;0;0;0;4416852;3441703;4462;2;3613783;2860;48;0;1
FR;3;2022-09-13;0;0;0;0;0;0;0;0;0;4416852;3441703;4462;2;3613783;2860;48;0;1
FR;3;2022-09-14;0;0;0;0;0;0;0;0;0;4416852;3441703;4462;2;3613783;2860;48;0;1
FR;3;2022-09-15;0;0;0;0;0;0;0;0;0;4416852;3441703;4462;2;3613783;2860;48;0;1
FR;3;2022-09-16;0;0;0;0;0;0;0;0;0;4416852;3441703;4462;2;3613783;2860;48;0;1
FR;3;2022-09-17;0;0;0;0;0;0;0;0;0;4416852;3441703;4462;2;3613783;2860;48;0;1
FR;3;2022-09-18;0;0;0;0;0;0;0;0;0;4416852;3441703;4462;2;3613783;2860;48;0;1
FR;3;2022-09-19;0;0;0;0;0;0;0;0;0;4416852;3441703;4462;2;3613783;2860;48;0;1
FR;3;2022-09-20;0;0;0;0;0;0;0;0;0;4416852;3441703;4462;2;3613783;2860;48;0;1
FR;3;2022-09-21;0;0;0;0;0;0;0;0;0;4416852;3441703;4462;2;3613783;2860;48;0;1
FR;3;2022-09-22;0;0;0;0;0;0;0;0;0;4416852;3441703;4462;2;3613783;2860;48;0;1
FR;3;2022-09-23;0;0;0;0;0;0;0;0;0;4416852;3441703;4462;2;3613783;2860;48;0;1
FR;3;2022-09-24;0;0;0;0;0;0;0;0;0;4416852;3441703;4462;2;3613783;2860;48;0;1
FR;3;2022-09-25;0;0;0;0;0;0;0;0;0;4416852;3441703;4462;2;3613783;2860;48;0;1
FR;3;2022-09-26;0;0;0;0;0;0;0;0;0;4416852;3441703;4462;2;3613783;2860;48;0;1
FR;3;2022-09-27;0;0;0;0;0;0;0;0;0;4416852;3441703;4462;2;3613783;2860;48;0;1
FR;3;2022-09-28;0;0;0;0;0;0;0;0;0;4416852;3441703;4462;2;3613783;2860;48;0;1
FR;3;2022-09-29;0;0;0;0;0;0;0;0;0;4416852;3441703;4462;2;3613783;2860;48;0;1
FR;3;2022-09-30;0;0;0;0;0;0;0;0;0;4416852;3441703;4462;2;3613783;2860;48;0;1
FR;3;2022-10-01;0;0;0;0;0;0;0;0;0;4416852;3441703;4462;2;3613783;2860;48;0;1
FR;3;2022-10-02;0;0;0;0;0;0;0;0;0;4416852;3441703;4462;2;3613783;2860;48;0;1
FR;3;2022-10-03;0;0;0;0;0;0;0;0;0;4416852;3441703;4462;2;3613783;2860;48;0;1
FR;3;2022-10-04;0;0;0;0;0;0;0;0;0;4416852;3441703;4462;2;3613783;2860;48;0;1
FR;3;2022-10-05;0;0;0;0;0;0;0;0;0;4416852;3441703;4462;2;3613783;2860;48;0;1
FR;3;2022-10-06;0;0;0;0;0;0;0;0;0;4416852;3441703;4462;2;3613783;2860;48;0;1
FR;3;2022-10-07;0;0;0;0;0;0;0;0;0;4416852;3441703;4462;2;3613783;2860;48;0;1
FR;3;2022-10-08;0;0;0;0;0;0;0;0;0;4416852;3441703;4462;2;3613783;2860;48;0;1
FR;3;2022-10-09;0;0;0;0;0;0;0;0;0;4416852;3441703;4462;2;3613783;2860;48;0;1
FR;3;2022-10-10;0;0;0;0;0;0;0;0;0;4416852;3441703;4462;2;3613783;2860;48;0;1
FR;3;2022-10-11;0;0;0;0;0;0;0;0;0;4416852;3441703;4462;2;3613783;2860;48;0;1
FR;3;2022-10-12;0;0;0;0;0;0;0;0;0;4416852;3441703;4462;2;3613783;2860;48;0;1
FR;3;2022-10-13;0;0;0;0;0;0;0;0;0;4416852;3441703;4462;2;3613783;2860;48;0;1
FR;3;2022-10-14;0;0;0;0;0;0;0;0;0;4416852;3441703;4462;2;3613783;2860;48;0;1
FR;3;2022-10-15;0;0;0;0;0;0;0;0;0;4416852;3441703;4462;2;3613783;2860;48;0;1
FR;3;2022-10-16;0;0;0;0;0;0;0;0;0;4416852;3441703;4462;2;3613783;2860;48;0;1
FR;3;2022-10-17;0;0;0;0;0;0;0;0;0;4416852;3441703;4462;2;3613783;2860;48;0;1
FR;3;2022-10-18;0;0;0;0;0;0;0;0;0;4416852;3441703;4462;2;3613783;2860;48;0;1
FR;3;2022-10-19;0;0;0;0;0;0;0;0;0;4416852;3441703;4462;2;3613783;2860;48;0;1
FR;3;2022-10-20;0;0;0;0;0;0;0;0;0;4416852;3441703;4462;2;3613783;2860;48;0;1
FR;3;2022-10-21;0;0;0;0;0;0;0;0;0;4416852;3441703;4462;2;3613783;2860;48;0;1
FR;3;2022-10-22;0;0;0;0;0;0;0;0;0;4416852;3441703;4462;2;3613783;2860;48;0;1
FR;3;2022-10-23;0;0;0;0;0;0;0;0;0;4416852;3441703;4462;2;3613783;2860;48;0;1
FR;3;2022-10-24;0;0;0;0;0;0;0;0;0;4416852;3441703;4462;2;3613783;2860;48;0;1
FR;3;2022-10-25;0;0;0;0;0;0;0;0;0;4416852;3441703;4462;2;3613783;2860;48;0;1
FR;3;2022-10-26;0;0;0;0;0;0;0;0;0;4416852;3441703;4462;2;3613783;2860;48;0;1
FR;3;2022-10-27;0;0;0;0;0;0;0;0;0;4416852;3441703;4462;2;3613783;2860;48;0;1
FR;3;2022-10-28;0;0;0;0;0;0;0;0;0;4416852;3441703;4462;2;3613783;2860;48;0;1
FR;3;2022-10-29;0;0;0;0;0;0;0;0;0;4416852;3441703;4462;2;3613783;2860;48;0;1
FR;3;2022-10-30;0;0;0;0;0;0;0;0;0;4416852;3441703;4462;2;3613783;2860;48;0;1
FR;3;2022-10-31;0;0;0;0;0;0;0;0;0;4416852;3441703;4462;2;3613783;2860;48;0;1
FR;3;2022-11-01;0;0;0;0;0;0;0;0;0;4416852;3441703;4462;2;3613783;2860;48;0;1
FR;3;2022-11-02;0;0;0;0;0;0;0;0;0;4416852;3441703;4462;2;3613783;2860;48;0;1
FR;3;2022-11-03;0;0;0;0;0;0;0;0;0;4416852;3441703;4462;2;3613783;2860;48;0;1
FR;3;2022-11-04;0;0;0;0;0;0;0;0;0;4416852;3441703;4462;2;3613783;2860;48;0;1
FR;3;2022-11-05;0;0;0;0;0;0;0;0;0;4416852;3441703;4462;2;3613783;2860;48;0;1
FR;3;2022-11-06;0;0;0;0;0;0;0;0;0;4416852;3441703;4462;2;3613783;2860;48;0;1
FR;3;2022-11-07;0;0;0;0;0;0;0;0;0;4416852;3441703;4462;2;3613783;2860;48;0;1
FR;3;2022-11-08;1;0;0;0;0;0;0;0;0;4416853;3441703;4462;2;3613783;2860;48;0;1
FR;3;2022-11-09;0;0;0;0;0;0;0;0;0;4416853;3441703;4462;2;3613783;2860;48;0;1
FR;3;2022-11-10;0;0;0;0;0;0;0;0;0;4416853;3441703;4462;2;3613783;2860;48;0;1
FR;3;2022-11-11;0;0;0;0;0;0;0;0;0;4416853;3441703;4462;2;3613783;2860;48;0;1
FR;3;2022-11-12;0;0;0;0;0;0;0;0;0;4416853;3441703;4462;2;3613783;2860;48;0;1
FR;3;2022-11-13;0;0;0;0;0;0;0;0;0;4416853;3441703;4462;2;3613783;2860;48;0;1
FR;3;2022-11-14;0;0;0;0;0;0;0;0;0;4416853;3441703;4462;2;3613783;2860;48;0;1
FR;3;2022-11-15;0;0;0;0;0;0;0;0;0;4416853;3441703;4462;2;3613783;2860;48;0;1
FR;3;2022-11-16;0;0;0;0;0;0;0;0;0;4416853;3441703;4462;2;3613783;2860;48;0;1
FR;3;2022-11-17;0;0;0;0;0;0;0;0;0;4416853;3441703;4462;2;3613783;2860;48;0;1
FR;3;2022-11-18;0;0;0;0;0;0;0;0;0;4416853;3441703;4462;2;3613783;2860;48;0;1
FR;3;2022-11-19;0;0;0;0;0;0;0;0;0;4416853;3441703;4462;2;3613783;2860;48;0;1
FR;3;2022-11-20;0;0;0;0;0;0;0;0;0;4416853;3441703;4462;2;3613783;2860;48;0;1
FR;3;2022-11-21;0;0;0;0;0;0;0;0;0;4416853;3441703;4462;2;3613783;2860;48;0;1
FR;3;2022-11-22;0;0;0;0;0;0;0;0;0;4416853;3441703;4462;2;3613783;2860;48;0;1
FR;3;2022-11-23;0;0;0;0;0;0;0;0;0;4416853;3441703;4462;2;3613783;2860;48;0;1
FR;3;2022-11-24;0;0;0;0;0;0;0;0;0;4416853;3441703;4462;2;3613783;2860;48;0;1
FR;3;2022-11-25;0;0;0;0;0;0;0;0;0;4416853;3441703;4462;2;3613783;2860;48;0;1
FR;3;2022-11-26;0;0;0;0;0;0;0;0;0;4416853;3441703;4462;2;3613783;2860;48;0;1
FR;3;2022-11-27;0;0;0;0;0;0;0;0;0;4416853;3441703;4462;2;3613783;2860;48;0;1
FR;3;2022-11-28;0;0;0;0;0;0;0;0;0;4416853;3441703;4462;2;3613783;2860;48;0;1
FR;3;2022-11-29;0;0;0;0;0;0;0;0;0;4416853;3441703;4462;2;3613783;2860;48;0;1
FR;3;2022-11-30;0;0;0;0;0;0;0;0;0;4416853;3441703;4462;2;3613783;2860;48;0;1
FR;3;2022-12-01;0;0;0;0;0;0;0;0;0;4416853;3441703;4462;2;3613783;2860;48;0;1
FR;3;2022-12-02;0;0;0;0;0;0;0;0;0;4416853;3441703;4462;2;3613783;2860;48;0;1
FR;3;2022-12-03;0;0;0;0;0;0;0;0;0;4416853;3441703;4462;2;3613783;2860;48;0;1
FR;3;2022-12-04;0;0;0;0;0;0;0;0;0;4416853;3441703;4462;2;3613783;2860;48;0;1
FR;3;2022-12-05;0;0;0;0;0;0;0;0;0;4416853;3441703;4462;2;3613783;2860;48;0;1
FR;3;2022-12-06;0;0;0;0;0;0;0;0;0;4416853;3441703;4462;2;3613783;2860;48;0;1
FR;3;2022-12-07;0;0;0;0;0;0;0;0;0;4416853;3441703;4462;2;3613783;2860;48;0;1
FR;3;2022-12-08;0;0;0;0;0;0;0;0;0;4416853;3441703;4462;2;3613783;2860;48;0;1
FR;3;2022-12-09;0;0;0;0;0;0;0;0;0;4416853;3441703;4462;2;3613783;2860;48;0;1
FR;3;2022-12-10;0;0;0;0;0;0;0;0;0;4416853;3441703;4462;2;3613783;2860;48;0;1
FR;3;2022-12-11;0;0;0;0;0;0;0;0;0;4416853;3441703;4462;2;3613783;2860;48;0;1
FR;3;2022-12-12;0;0;0;0;0;0;0;0;0;4416853;3441703;4462;2;3613783;2860;48;0;1
FR;3;2022-12-13;0;0;0;0;0;0;0;0;0;4416853;3441703;4462;2;3613783;2860;48;0;1
FR;3;2022-12-14;0;0;0;0;0;0;0;0;0;4416853;3441703;4462;2;3613783;2860;48;0;1
FR;3;2022-12-15;0;0;0;0;0;0;0;0;0;4416853;3441703;4462;2;3613783;2860;48;0;1
FR;3;2022-12-16;0;0;0;0;0;0;0;0;0;4416853;3441703;4462;2;3613783;2860;48;0;1
FR;3;2022-12-17;0;0;0;0;0;0;0;0;0;4416853;3441703;4462;2;3613783;2860;48;0;1
FR;3;2022-12-18;0;0;0;0;0;0;0;0;0;4416853;3441703;4462;2;3613783;2860;48;0;1
FR;3;2022-12-19;0;0;0;0;0;0;0;0;0;4416853;3441703;4462;2;3613783;2860;48;0;1
FR;3;2022-12-20;0;0;0;0;0;0;0;0;0;4416853;3441703;4462;2;3613783;2860;48;0;1
FR;3;2022-12-21;0;0;0;0;0;0;0;0;0;4416853;3441703;4462;2;3613783;2860;48;0;1
FR;3;2022-12-22;0;0;0;0;0;0;0;0;0;4416853;3441703;4462;2;3613783;2860;48;0;1
FR;3;2022-12-23;0;0;0;0;0;0;0;0;0;4416853;3441703;4462;2;3613783;2860;48;0;1
FR;3;2022-12-24;0;0;0;0;0;0;0;0;0;4416853;3441703;4462;2;3613783;2860;48;0;1
FR;3;2022-12-25;0;0;0;0;0;0;0;0;0;4416853;3441703;4462;2;3613783;2860;48;0;1
FR;3;2022-12-26;0;0;0;0;0;0;0;0;0;4416853;3441703;4462;2;3613783;2860;48;0;1
FR;3;2022-12-27;0;0;0;0;0;0;0;0;0;4416853;3441703;4462;2;3613783;2860;48;0;1
FR;3;2022-12-28;0;0;0;0;0;0;0;0;0;4416853;3441703;4462;2;3613783;2860;48;0;1
FR;3;2022-12-29;0;0;0;0;0;0;0;0;0;4416853;3441703;4462;2;3613783;2860;48;0;1
FR;3;2022-12-30;0;0;0;0;0;0;0;0;0;4416853;3441703;4462;2;3613783;2860;48;0;1
FR;3;2022-12-31;0;0;0;0;0;0;0;0;0;4416853;3441703;4462;2;3613783;2860;48;0;1
FR;3;2023-01-01;0;0;0;0;0;0;0;0;0;4416853;3441703;4462;2;3613783;2860;48;0;1
FR;3;2023-01-02;0;0;0;0;0;0;0;0;0;4416853;3441703;4462;2;3613783;2860;48;0;1
FR;3;2023-01-03;0;0;0;0;0;0;0;0;0;4416853;3441703;4462;2;3613783;2860;48;0;1
FR;3;2023-01-04;0;0;0;0;0;0;0;0;0;4416853;3441703;4462;2;3613783;2860;48;0;1
FR;3;2023-01-05;0;0;0;0;0;0;0;0;0;4416853;3441703;4462;2;3613783;2860;48;0;1
FR;3;2023-01-06;0;0;0;0;0;0;0;0;0;4416853;3441703;4462;2;3613783;2860;48;0;1
FR;3;2023-01-07;0;0;0;0;0;0;0;0;0;4416853;3441703;4462;2;3613783;2860;48;0;1
FR;3;2023-01-08;0;0;0;0;0;0;0;0;0;4416853;3441703;4462;2;3613783;2860;48;0;1
FR;3;2023-01-09;0;0;0;0;0;0;0;0;0;4416853;3441703;4462;2;3613783;2860;48;0;1
FR;3;2023-01-10;0;0;0;0;0;0;0;0;0;4416853;3441703;4462;2;3613783;2860;48;0;1
FR;3;2023-01-11;0;0;0;0;0;0;0;0;0;4416853;3441703;4462;2;3613783;2860;48;0;1
FR;3;2023-01-12;0;0;0;0;0;0;0;0;0;4416853;3441703;4462;2;3613783;2860;48;0;1
FR;3;2023-01-13;0;0;0;0;0;0;0;0;0;4416853;3441703;4462;2;3613783;2860;48;0;1
FR;3;2023-01-14;0;0;0;0;0;0;0;0;0;4416853;3441703;4462;2;3613783;2860;48;0;1
FR;3;2023-01-15;0;0;0;0;0;0;0;0;0;4416853;3441703;4462;2;3613783;2860;48;0;1
FR;3;2023-01-16;0;0;0;0;0;0;0;0;0;4416853;3441703;4462;2;3613783;2860;48;0;1
FR;3;2023-01-17;0;0;0;0;0;0;0;0;0;4416853;3441703;4462;2;3613783;2860;48;0;1
FR;3;2023-01-18;0;0;0;0;0;0;0;0;0;4416853;3441703;4462;2;3613783;2860;48;0;1
FR;3;2023-01-19;0;0;0;0;0;0;0;0;0;4416853;3441703;4462;2;3613783;2860;48;0;1
FR;3;2023-01-20;0;0;0;0;0;0;0;0;0;4416853;3441703;4462;2;3613783;2860;48;0;1
FR;3;2023-01-21;0;0;0;0;0;0;0;0;0;4416853;3441703;4462;2;3613783;2860;48;0;1
FR;3;2023-01-22;0;0;0;0;0;0;0;0;0;4416853;3441703;4462;2;3613783;2860;48;0;1
FR;3;2023-01-23;0;0;0;0;0;0;0;0;0;4416853;3441703;4462;2;3613783;2860;48;0;1
FR;3;2023-01-24;0;0;0;0;0;0;0;0;0;4416853;3441703;4462;2;3613783;2860;48;0;1
FR;3;2023-01-25;1;0;0;0;0;0;0;0;0;4416854;3441703;4462;2;3613783;2860;48;0;1
FR;3;2023-01-26;0;0;0;0;0;0;0;0;0;4416854;3441703;4462;2;3613783;2860;48;0;1
FR;3;2023-01-27;0;0;0;0;0;0;0;0;0;4416854;3441703;4462;2;3613783;2860;48;0;1
FR;3;2023-01-28;0;0;0;0;0;0;0;0;0;4416854;3441703;4462;2;3613783;2860;48;0;1
FR;3;2023-01-29;0;0;0;0;0;0;0;0;0;4416854;3441703;4462;2;3613783;2860;48;0;1
FR;3;2023-01-30;0;0;0;0;0;0;0;0;0;4416854;3441703;4462;2;3613783;2860;48;0;1
FR;3;2023-01-31;0;0;0;0;0;0;0;0;0;4416854;3441703;4462;2;3613783;2860;48;0;1
FR;3;2023-02-01;0;0;0;0;0;0;0;0;0;4416854;3441703;4462;2;3613783;2860;48;0;1
FR;3;2023-02-02;0;0;0;0;0;0;0;0;0;4416854;3441703;4462;2;3613783;2860;48;0;1
FR;3;2023-02-03;0;0;0;0;0;0;0;0;0;4416854;3441703;4462;2;3613783;2860;48;0;1
FR;3;2023-02-04;0;0;0;0;0;0;0;0;0;4416854;3441703;4462;2;3613783;2860;48;0;1
FR;3;2023-02-05;0;0;0;0;0;0;0;0;0;4416854;3441703;4462;2;3613783;2860;48;0;1
FR;3;2023-02-06;0;0;0;0;0;0;0;0;0;4416854;3441703;4462;2;3613783;2860;48;0;1
FR;3;2023-02-07;0;0;0;0;0;0;0;0;0;4416854;3441703;4462;2;3613783;2860;48;0;1
FR;3;2023-02-08;0;0;0;0;0;0;0;0;0;4416854;3441703;4462;2;3613783;2860;48;0;1
FR;3;2023-02-09;0;0;0;0;0;0;0;0;0;4416854;3441703;4462;2;3613783;2860;48;0;1
FR;3;2023-02-10;0;0;0;0;0;0;0;0;0;4416854;3441703;4462;2;3613783;2860;48;0;1
FR;3;2023-02-11;0;0;0;0;0;0;0;0;0;4416854;3441703;4462;2;3613783;2860;48;0;1
FR;3;2023-02-12;0;0;0;0;0;0;0;0;0;4416854;3441703;4462;2;3613783;2860;48;0;1
FR;3;2023-02-13;0;0;0;0;0;0;0;0;0;4416854;3441703;4462;2;3613783;2860;48;0;1
FR;3;2023-02-14;0;0;0;0;0;0;0;0;0;4416854;3441703;4462;2;3613783;2860;48;0;1
FR;3;2023-02-15;0;0;0;0;0;0;0;0;0;4416854;3441703;4462;2;3613783;2860;48;0;1
FR;3;2023-02-16;0;0;0;0;0;0;0;0;0;4416854;3441703;4462;2;3613783;2860;48;0;1
FR;3;2023-02-17;0;0;0;0;0;0;0;0;0;4416854;3441703;4462;2;3613783;2860;48;0;1
FR;3;2023-02-18;0;0;0;0;0;0;0;0;0;4416854;3441703;4462;2;3613783;2860;48;0;1
FR;3;2023-02-19;0;0;0;0;0;0;0;0;0;4416854;3441703;4462;2;3613783;2860;48;0;1
FR;3;2023-02-20;0;0;0;0;0;0;0;0;0;4416854;3441703;4462;2;3613783;2860;48;0;1
FR;3;2023-02-21;0;0;0;0;0;0;0;0;0;4416854;3441703;4462;2;3613783;2860;48;0;1
FR;3;2023-02-22;0;0;0;0;0;0;0;0;0;4416854;3441703;4462;2;3613783;2860;48;0;1
FR;3;2023-02-23;0;0;0;0;0;0;0;0;0;4416854;3441703;4462;2;3613783;2860;48;0;1
FR;3;2023-02-24;0;0;0;0;0;0;0;0;0;4416854;3441703;4462;2;3613783;2860;48;0;1
FR;3;2023-02-25;0;0;0;0;0;0;0;0;0;4416854;3441703;4462;2;3613783;2860;48;0;1
FR;3;2023-02-26;0;0;0;0;0;0;0;0;0;4416854;3441703;4462;2;3613783;2860;48;0;1
FR;3;2023-02-27;0;0;0;0;0;0;0;0;0;4416854;3441703;4462;2;3613783;2860;48;0;1
FR;3;2023-02-28;0;0;0;0;0;0;0;0;0;4416854;3441703;4462;2;3613783;2860;48;0;1
FR;3;2023-03-01;0;0;0;0;0;0;0;0;0;4416854;3441703;4462;2;3613783;2860;48;0;1
FR;3;2023-03-02;0;0;0;0;0;0;0;0;0;4416854;3441703;4462;2;3613783;2860;48;0;1
FR;3;2023-03-03;0;0;0;0;0;0;0;0;0;4416854;3441703;4462;2;3613783;2860;48;0;1
FR;3;2023-03-04;0;0;0;0;0;0;0;0;0;4416854;3441703;4462;2;3613783;2860;48;0;1
FR;3;2023-03-05;0;0;0;0;0;0;0;0;0;4416854;3441703;4462;2;3613783;2860;48;0;1
FR;3;2023-03-06;0;0;0;0;0;0;0;0;0;4416854;3441703;4462;2;3613783;2860;48;0;1
FR;3;2023-03-07;0;0;0;0;0;0;0;0;0;4416854;3441703;4462;2;3613783;2860;48;0;1
FR;3;2023-03-08;0;0;0;0;0;0;0;0;0;4416854;3441703;4462;2;3613783;2860;48;0;1
FR;3;2023-03-09;0;0;0;0;0;0;0;0;0;4416854;3441703;4462;2;3613783;2860;48;0;1
FR;3;2023-03-10;0;0;0;0;0;0;0;0;0;4416854;3441703;4462;2;3613783;2860;48;0;1
FR;3;2023-03-11;0;0;0;0;0;0;0;0;0;4416854;3441703;4462;2;3613783;2860;48;0;1
FR;3;2023-03-12;0;0;0;0;0;0;0;0;0;4416854;3441703;4462;2;3613783;2860;48;0;1
FR;3;2023-03-13;0;0;0;0;0;0;0;0;0;4416854;3441703;4462;2;3613783;2860;48;0;1
FR;3;2023-03-14;0;0;0;0;0;0;0;0;0;4416854;3441703;4462;2;3613783;2860;48;0;1
FR;3;2023-03-15;0;0;0;0;0;0;0;0;0;4416854;3441703;4462;2;3613783;2860;48;0;1
FR;3;2023-03-16;0;0;0;0;0;0;0;0;0;4416854;3441703;4462;2;3613783;2860;48;0;1
FR;3;2023-03-17;0;0;0;0;0;0;0;0;0;4416854;3441703;4462;2;3613783;2860;48;0;1
FR;3;2023-03-18;0;0;0;0;0;0;0;0;0;4416854;3441703;4462;2;3613783;2860;48;0;1
FR;3;2023-03-19;0;0;0;0;0;0;0;0;0;4416854;3441703;4462;2;3613783;2860;48;0;1
FR;3;2023-03-20;0;0;0;0;0;0;0;0;0;4416854;3441703;4462;2;3613783;2860;48;0;1
FR;3;2023-03-21;0;0;0;0;0;0;0;0;0;4416854;3441703;4462;2;3613783;2860;48;0;1
FR;3;2023-03-22;0;0;0;0;0;0;0;0;0;4416854;3441703;4462;2;3613783;2860;48;0;1
FR;3;2023-03-23;0;0;0;0;0;0;0;0;0;4416854;3441703;4462;2;3613783;2860;48;0;1
FR;3;2023-03-24;0;0;0;0;0;0;0;0;0;4416854;3441703;4462;2;3613783;2860;48;0;1
FR;3;2023-03-25;0;0;0;0;0;0;0;0;0;4416854;3441703;4462;2;3613783;2860;48;0;1
FR;3;2023-03-26;0;0;0;0;0;0;0;0;0;4416854;3441703;4462;2;3613783;2860;48;0;1
FR;4;2020-12-27;0;0;0;0;0;0;0;0;0;0;0;0;0;0;0;0;0;0
FR;4;2020-12-28;0;0;0;0;0;0;0;0;0;0;0;0;0;0;0;0;0;0
FR;4;2020-12-29;0;0;0;0;0;0;0;0;0;0;0;0;0;0;0;0;0;0
FR;4;2020-12-30;0;0;0;0;0;0;0;0;0;0;0;0;0;0;0;0;0;0
FR;4;2020-12-31;0;0;0;0;0;0;0;0;0;0;0;0;0;0;0;0;0;0
FR;4;2021-01-01;0;0;0;0;0;0;0;0;0;0;0;0;0;0;0;0;0;0
FR;4;2021-01-02;0;0;0;0;0;0;0;0;0;0;0;0;0;0;0;0;0;0
FR;4;2021-01-03;0;0;0;0;0;0;0;0;0;0;0;0;0;0;0;0;0;0
FR;4;2021-01-04;0;0;0;0;0;0;0;0;0;0;0;0;0;0;0;0;0;0
FR;4;2021-01-05;0;0;0;0;0;0;0;0;0;0;0;0;0;0;0;0;0;0
FR;4;2021-01-06;0;0;0;0;0;0;0;0;0;0;0;0;0;0;0;0;0;0
FR;4;2021-01-07;0;0;0;0;0;0;0;0;0;0;0;0;0;0;0;0;0;0
FR;4;2021-01-08;0;0;0;0;0;0;0;0;0;0;0;0;0;0;0;0;0;0
FR;4;2021-01-09;0;0;0;0;0;0;0;0;0;0;0;0;0;0;0;0;0;0
FR;4;2021-01-10;0;0;0;0;0;0;0;0;0;0;0;0;0;0;0;0;0;0
FR;4;2021-01-11;0;0;0;0;0;0;0;0;0;0;0;0;0;0;0;0;0;0
FR;4;2021-01-12;0;0;0;0;0;0;0;0;0;0;0;0;0;0;0;0;0;0
FR;4;2021-01-13;0;0;0;0;0;0;0;0;0;0;0;0;0;0;0;0;0;0
FR;4;2021-01-14;0;0;0;0;0;0;0;0;0;0;0;0;0;0;0;0;0;0
FR;4;2021-01-15;0;0;0;0;0;0;0;0;0;0;0;0;0;0;0;0;0;0
FR;4;2021-01-16;0;0;0;0;0;0;0;0;0;0;0;0;0;0;0;0;0;0
FR;4;2021-01-17;0;0;0;0;0;0;0;0;0;0;0;0;0;0;0;0;0;0
FR;4;2021-01-18;0;0;0;0;0;0;0;0;0;0;0;0;0;0;0;0;0;0
FR;4;2021-01-19;0;0;0;0;0;0;0;0;0;0;0;0;0;0;0;0;0;0
FR;4;2021-01-20;0;0;0;0;0;0;0;0;0;0;0;0;0;0;0;0;0;0
FR;4;2021-01-21;0;0;0;0;0;0;0;0;0;0;0;0;0;0;0;0;0;0
FR;4;2021-01-22;0;0;0;0;0;0;0;0;0;0;0;0;0;0;0;0;0;0
FR;4;2021-01-23;0;0;0;0;0;0;0;0;0;0;0;0;0;0;0;0;0;0
FR;4;2021-01-24;0;0;0;0;0;0;0;0;0;0;0;0;0;0;0;0;0;0
FR;4;2021-01-25;0;0;0;0;0;0;0;0;0;0;0;0;0;0;0;0;0;0
FR;4;2021-01-26;0;0;0;0;0;0;0;0;0;0;0;0;0;0;0;0;0;0
FR;4;2021-01-27;0;0;0;0;0;0;0;0;0;0;0;0;0;0;0;0;0;0
FR;4;2021-01-28;0;0;0;0;0;0;0;0;0;0;0;0;0;0;0;0;0;0
FR;4;2021-01-29;0;0;0;0;0;0;0;0;0;0;0;0;0;0;0;0;0;0
FR;4;2021-01-30;0;0;0;0;0;0;0;0;0;0;0;0;0;0;0;0;0;0
FR;4;2021-01-31;0;0;0;0;0;0;0;0;0;0;0;0;0;0;0;0;0;0
FR;4;2021-02-01;0;0;0;0;0;0;0;0;0;0;0;0;0;0;0;0;0;0
FR;4;2021-02-02;0;0;0;0;0;0;0;0;0;0;0;0;0;0;0;0;0;0
FR;4;2021-02-03;0;0;0;0;0;0;0;0;0;0;0;0;0;0;0;0;0;0
FR;4;2021-02-04;0;0;0;0;0;0;0;0;0;0;0;0;0;0;0;0;0;0
FR;4;2021-02-05;0;0;0;0;0;0;0;0;0;0;0;0;0;0;0;0;0;0
FR;4;2021-02-06;0;0;0;0;0;0;0;0;0;0;0;0;0;0;0;0;0;0
FR;4;2021-02-07;0;0;0;0;0;0;0;0;0;0;0;0;0;0;0;0;0;0
FR;4;2021-02-08;0;0;0;0;0;0;0;0;0;0;0;0;0;0;0;0;0;0
FR;4;2021-02-09;0;0;0;0;0;0;0;0;0;0;0;0;0;0;0;0;0;0
FR;4;2021-02-10;0;0;0;0;0;0;0;0;0;0;0;0;0;0;0;0;0;0
FR;4;2021-02-11;0;0;0;0;0;0;0;0;0;0;0;0;0;0;0;0;0;0
FR;4;2021-02-12;0;0;0;0;0;0;0;0;0;0;0;0;0;0;0;0;0;0
FR;4;2021-02-13;0;0;0;0;0;0;0;0;0;0;0;0;0;0;0;0;0;0
FR;4;2021-02-14;0;0;0;0;0;0;0;0;0;0;0;0;0;0;0;0;0;0
FR;4;2021-02-15;0;0;0;0;0;0;0;0;0;0;0;0;0;0;0;0;0;0
FR;4;2021-02-16;0;0;0;0;0;0;0;0;0;0;0;0;0;0;0;0;0;0
FR;4;2021-02-17;0;0;0;0;0;0;0;0;0;0;0;0;0;0;0;0;0;0
FR;4;2021-02-18;0;0;0;0;0;0;0;0;0;0;0;0;0;0;0;0;0;0
FR;4;2021-02-19;0;0;0;0;0;0;0;0;0;0;0;0;0;0;0;0;0;0
FR;4;2021-02-20;0;0;0;0;0;0;0;0;0;0;0;0;0;0;0;0;0;0
FR;4;2021-02-21;0;0;0;0;0;0;0;0;0;0;0;0;0;0;0;0;0;0
FR;4;2021-02-22;0;0;0;0;0;0;0;0;0;0;0;0;0;0;0;0;0;0
FR;4;2021-02-23;0;0;0;0;0;0;0;0;0;0;0;0;0;0;0;0;0;0
FR;4;2021-02-24;0;0;0;0;0;0;0;0;0;0;0;0;0;0;0;0;0;0
FR;4;2021-02-25;0;0;0;0;0;0;0;0;0;0;0;0;0;0;0;0;0;0
FR;4;2021-02-26;0;0;0;0;0;0;0;0;0;0;0;0;0;0;0;0;0;0
FR;4;2021-02-27;0;0;0;0;0;0;0;0;0;0;0;0;0;0;0;0;0;0
FR;4;2021-02-28;0;0;0;0;0;0;0;0;0;0;0;0;0;0;0;0;0;0
FR;4;2021-03-01;0;0;0;0;0;0;0;0;0;0;0;0;0;0;0;0;0;0
FR;4;2021-03-02;0;0;0;0;0;0;0;0;0;0;0;0;0;0;0;0;0;0
FR;4;2021-03-03;0;0;0;0;0;0;0;0;0;0;0;0;0;0;0;0;0;0
FR;4;2021-03-04;0;0;0;0;0;0;0;0;0;0;0;0;0;0;0;0;0;0
FR;4;2021-03-05;0;0;0;0;0;0;0;0;0;0;0;0;0;0;0;0;0;0
FR;4;2021-03-06;0;0;0;0;0;0;0;0;0;0;0;0;0;0;0;0;0;0
FR;4;2021-03-07;0;0;0;0;0;0;0;0;0;0;0;0;0;0;0;0;0;0
FR;4;2021-03-08;0;0;0;0;0;0;0;0;0;0;0;0;0;0;0;0;0;0
FR;4;2021-03-09;0;0;0;0;0;0;0;0;0;0;0;0;0;0;0;0;0;0
FR;4;2021-03-10;0;0;0;0;0;0;0;0;0;0;0;0;0;0;0;0;0;0
FR;4;2021-03-11;0;0;0;0;0;0;0;0;0;0;0;0;0;0;0;0;0;0
FR;4;2021-03-12;0;0;0;0;0;0;0;0;0;0;0;0;0;0;0;0;0;0
FR;4;2021-03-13;0;0;0;0;0;0;0;0;0;0;0;0;0;0;0;0;0;0
FR;4;2021-03-14;0;0;0;0;0;0;0;0;0;0;0;0;0;0;0;0;0;0
FR;4;2021-03-15;0;0;0;0;0;0;0;0;0;0;0;0;0;0;0;0;0;0
FR;4;2021-03-16;0;0;0;0;0;0;0;0;0;0;0;0;0;0;0;0;0;0
FR;4;2021-03-17;0;0;0;0;0;0;0;0;0;0;0;0;0;0;0;0;0;0
FR;4;2021-03-18;0;0;0;0;0;0;0;0;0;0;0;0;0;0;0;0;0;0
FR;4;2021-03-19;0;0;0;0;0;0;0;0;0;0;0;0;0;0;0;0;0;0
FR;4;2021-03-20;0;0;0;0;0;0;0;0;0;0;0;0;0;0;0;0;0;0
FR;4;2021-03-21;0;0;0;0;0;0;0;0;0;0;0;0;0;0;0;0;0;0
FR;4;2021-03-22;0;0;0;0;0;0;0;0;0;0;0;0;0;0;0;0;0;0
FR;4;2021-03-23;0;0;0;0;0;0;0;0;0;0;0;0;0;0;0;0;0;0
FR;4;2021-03-24;0;0;0;0;0;0;0;0;0;0;0;0;0;0;0;0;0;0
FR;4;2021-03-25;0;0;0;0;0;0;0;0;0;0;0;0;0;0;0;0;0;0
FR;4;2021-03-26;0;0;0;0;0;0;0;0;0;0;0;0;0;0;0;0;0;0
FR;4;2021-03-27;0;0;0;0;0;0;0;0;0;0;0;0;0;0;0;0;0;0
FR;4;2021-03-28;0;0;0;0;0;0;0;0;0;0;0;0;0;0;0;0;0;0
FR;4;2021-03-29;0;0;0;0;0;0;0;0;0;0;0;0;0;0;0;0;0;0
FR;4;2021-03-30;0;0;0;0;0;0;0;0;0;0;0;0;0;0;0;0;0;0
FR;4;2021-03-31;0;0;0;0;0;0;0;0;0;0;0;0;0;0;0;0;0;0
FR;4;2021-04-01;0;0;0;0;0;0;0;0;0;0;0;0;0;0;0;0;0;0
FR;4;2021-04-02;0;0;0;0;0;0;0;0;0;0;0;0;0;0;0;0;0;0
FR;4;2021-04-03;0;0;0;0;0;0;0;0;0;0;0;0;0;0;0;0;0;0
FR;4;2021-04-04;0;0;0;0;0;0;0;0;0;0;0;0;0;0;0;0;0;0
FR;4;2021-04-05;0;0;0;0;0;0;0;0;0;0;0;0;0;0;0;0;0;0
FR;4;2021-04-06;0;0;0;0;0;0;0;0;0;0;0;0;0;0;0;0;0;0
FR;4;2021-04-07;0;0;0;0;0;0;0;0;0;0;0;0;0;0;0;0;0;0
FR;4;2021-04-08;0;0;0;0;0;0;0;0;0;0;0;0;0;0;0;0;0;0
FR;4;2021-04-09;0;0;0;0;0;0;0;0;0;0;0;0;0;0;0;0;0;0
FR;4;2021-04-10;0;0;0;0;0;0;0;0;0;0;0;0;0;0;0;0;0;0
FR;4;2021-04-11;0;0;0;0;0;0;0;0;0;0;0;0;0;0;0;0;0;0
FR;4;2021-04-12;0;0;0;0;0;0;0;0;0;0;0;0;0;0;0;0;0;0
FR;4;2021-04-13;0;0;0;0;0;0;0;0;0;0;0;0;0;0;0;0;0;0
FR;4;2021-04-14;0;0;0;0;0;0;0;0;0;0;0;0;0;0;0;0;0;0
FR;4;2021-04-15;0;0;0;0;0;0;0;0;0;0;0;0;0;0;0;0;0;0
FR;4;2021-04-16;0;0;0;0;0;0;0;0;0;0;0;0;0;0;0;0;0;0
FR;4;2021-04-17;0;0;0;0;0;0;0;0;0;0;0;0;0;0;0;0;0;0
FR;4;2021-04-18;0;0;0;0;0;0;0;0;0;0;0;0;0;0;0;0;0;0
FR;4;2021-04-19;0;0;0;0;0;0;0;0;0;0;0;0;0;0;0;0;0;0
FR;4;2021-04-20;0;0;0;0;0;0;0;0;0;0;0;0;0;0;0;0;0;0
FR;4;2021-04-21;0;0;0;0;0;0;0;0;0;0;0;0;0;0;0;0;0;0
FR;4;2021-04-22;0;0;0;0;0;0;0;0;0;0;0;0;0;0;0;0;0;0
FR;4;2021-04-23;3660;0;0;0;3622;0;0;0;0;3660;0;0;0;3622;0;0;0;0
FR;4;2021-04-24;1570;1;0;0;1559;0;0;0;0;5230;1;0;0;5181;0;0;0;0
FR;4;2021-04-25;125;0;0;0;125;0;0;0;0;5355;1;0;0;5306;0;0;0;0
FR;4;2021-04-26;2872;1;0;0;2861;0;0;0;0;8227;2;0;0;8167;0;0;0;0
FR;4;2021-04-27;9520;3;0;0;9501;0;0;0;0;17747;5;0;0;17668;0;0;0;0
FR;4;2021-04-28;9910;6;0;0;9885;0;0;0;0;27657;11;0;0;27553;0;0;0;0
FR;4;2021-04-29;15995;8;0;0;15979;0;0;0;0;43652;19;0;0;43532;0;0;0;0
FR;4;2021-04-30;19234;10;0;0;19205;0;0;0;0;62886;29;0;0;62737;0;0;0;0
FR;4;2021-05-01;1994;6;0;0;1992;0;0;0;0;64880;35;0;0;64729;0;0;0;0
FR;4;2021-05-02;484;0;0;0;482;0;0;0;0;65364;35;0;0;65211;0;0;0;0
FR;4;2021-05-03;5066;2;0;0;5059;0;0;0;0;70430;37;0;0;70270;0;0;0;0
FR;4;2021-05-04;8411;11;0;0;8400;0;0;0;0;78841;48;0;0;78670;0;0;0;0
FR;4;2021-05-05;6193;7;0;0;6188;0;0;0;0;85034;55;0;0;84858;0;0;0;0
FR;4;2021-05-06;11388;11;0;0;11385;0;0;0;0;96422;66;0;0;96243;0;0;0;0
FR;4;2021-05-07;19127;9;0;0;19088;0;0;0;0;115549;75;0;0;115331;0;0;0;0
FR;4;2021-05-08;2376;7;0;0;2380;0;0;0;0;117925;82;0;0;117711;0;0;0;0
FR;4;2021-05-09;692;3;0;0;693;0;0;0;0;118617;85;0;0;118404;0;0;0;0
FR;4;2021-05-10;7246;5;1;0;7243;0;0;0;0;125863;90;1;0;125647;0;0;0;0
FR;4;2021-05-11;14326;13;0;0;14306;0;0;0;0;140189;103;1;0;139953;0;0;0;0
FR;4;2021-05-12;10176;15;0;0;10179;0;0;0;0;150365;118;1;0;150132;0;0;0;0
FR;4;2021-05-13;1584;4;0;0;1585;0;0;0;0;151949;122;1;0;151717;0;0;0;0
FR;4;2021-05-14;7768;7;0;0;7763;0;0;0;0;159717;129;1;0;159480;0;0;0;0
FR;4;2021-05-15;3721;8;1;0;3720;0;0;0;0;163438;137;2;0;163200;0;0;0;0
FR;4;2021-05-16;417;1;0;0;417;0;0;0;0;163855;138;2;0;163617;0;0;0;0
FR;4;2021-05-17;4485;8;0;0;4484;0;0;0;0;168340;146;2;0;168101;0;0;0;0
FR;4;2021-05-18;8769;10;0;0;8769;0;0;0;0;177109;156;2;0;176870;0;0;0;0
FR;4;2021-05-19;5699;7;0;0;5701;0;0;0;0;182808;163;2;0;182571;0;0;0;0
FR;4;2021-05-20;9487;8;0;0;9479;0;0;0;0;192295;171;2;0;192050;0;0;0;0
FR;4;2021-05-21;12816;30;0;0;12823;0;0;0;0;205111;201;2;0;204873;0;0;0;0
FR;4;2021-05-22;5061;15;0;0;5068;0;0;0;0;210172;216;2;0;209941;0;0;0;0
FR;4;2021-05-23;498;4;0;0;501;0;0;0;0;210670;220;2;0;210442;0;0;0;0
FR;4;2021-05-24;1062;7;0;0;1066;0;0;0;0;211732;227;2;0;211508;0;0;0;0
FR;4;2021-05-25;7637;16;0;0;7643;0;0;0;0;219369;243;2;0;219151;0;0;0;0
FR;4;2021-05-26;7731;16;0;0;7739;0;0;0;0;227100;259;2;0;226890;0;0;0;0
FR;4;2021-05-27;14340;35;0;0;14349;0;0;0;0;241440;294;2;0;241239;0;0;0;0
FR;4;2021-05-28;26593;82;1;0;26634;0;0;0;0;268033;376;3;0;267873;0;0;0;0
FR;4;2021-05-29;11385;19;0;0;11385;0;0;0;0;279418;395;3;0;279258;0;0;0;0
FR;4;2021-05-30;974;7;0;0;973;0;0;0;0;280392;402;3;0;280231;0;0;0;0
FR;4;2021-05-31;12700;21;0;0;12700;0;0;0;0;293092;423;3;0;292931;0;0;0;0
FR;4;2021-06-01;20283;48;1;0;20301;0;0;0;0;313375;471;4;0;313232;0;0;0;0
FR;4;2021-06-02;14526;33;0;0;14538;0;0;0;0;327901;504;4;0;327770;0;0;0;0
FR;4;2021-06-03;19436;24;1;0;19434;0;0;0;0;347337;528;5;0;347204;0;0;0;0
FR;4;2021-06-04;22520;48;0;0;22538;0;0;0;0;369857;576;5;0;369742;0;0;0;0
FR;4;2021-06-05;9717;32;0;0;9721;0;0;0;0;379574;608;5;0;379463;0;0;0;0
FR;4;2021-06-06;1041;2;0;0;1037;0;0;0;0;380615;610;5;0;380500;0;0;0;0
FR;4;2021-06-07;9230;19;0;0;9238;0;0;0;0;389845;629;5;0;389738;0;0;0;0
FR;4;2021-06-08;14614;32;0;0;14626;0;0;0;0;404459;661;5;0;404364;0;0;0;0
FR;4;2021-06-09;12218;25;0;0;12226;0;0;0;0;416677;686;5;0;416590;0;0;0;0
FR;4;2021-06-10;15408;30;0;0;15416;0;0;0;0;432085;716;5;0;432006;0;0;0;0
FR;4;2021-06-11;16989;57;0;0;17016;0;0;0;0;449074;773;5;0;449022;0;0;0;0
FR;4;2021-06-12;7453;27;0;0;7478;0;0;0;0;456527;800;5;0;456500;0;0;0;0
FR;4;2021-06-13;908;3;0;0;910;0;0;0;0;457435;803;5;0;457410;0;0;0;0
FR;4;2021-06-14;6652;27;0;0;6662;0;0;0;0;464087;830;5;0;464072;0;0;0;0
FR;4;2021-06-15;10896;39;0;0;10913;0;0;0;0;474983;869;5;0;474985;0;0;0;0
FR;4;2021-06-16;8909;17;0;0;8917;0;0;0;0;483892;886;5;0;483902;0;0;0;0
FR;4;2021-06-17;10903;36;0;0;10915;0;0;0;0;494795;922;5;0;494817;0;0;0;0
FR;4;2021-06-18;12427;45;0;0;12454;0;0;0;0;507222;967;5;0;507271;0;0;0;0
FR;4;2021-06-19;5568;25;0;0;5588;0;0;0;0;512790;992;5;0;512859;0;0;0;0
FR;4;2021-06-20;828;5;0;0;832;0;0;0;0;513618;997;5;0;513691;0;0;0;0
FR;4;2021-06-21;5106;21;0;0;5106;0;0;0;0;518724;1018;5;0;518797;0;0;0;0
FR;4;2021-06-22;7914;29;2;0;7932;0;0;0;0;526638;1047;7;0;526729;0;0;0;0
FR;4;2021-06-23;7106;43;2;0;7133;0;0;0;0;533744;1090;9;0;533862;0;0;0;0
FR;4;2021-06-24;8657;46;1;0;8689;0;0;0;0;542401;1136;10;0;542551;0;0;0;0
FR;4;2021-06-25;10178;41;2;0;10210;0;0;0;0;552579;1177;12;0;552761;0;0;0;0
FR;4;2021-06-26;4854;21;0;0;4871;0;0;0;0;557433;1198;12;0;557632;0;0;0;0
FR;4;2021-06-27;769;4;0;0;771;0;0;0;0;558202;1202;12;0;558403;0;0;0;0
FR;4;2021-06-28;4835;16;1;0;4843;0;0;0;0;563037;1218;13;0;563246;0;0;0;0
FR;4;2021-06-29;7110;28;2;0;7119;0;0;0;0;570147;1246;15;0;570365;0;0;0;0
FR;4;2021-06-30;6728;40;2;0;6756;0;0;0;0;576875;1286;17;0;577121;0;0;0;0
FR;4;2021-07-01;8212;42;0;0;8234;0;0;0;0;585087;1328;17;0;585355;0;0;0;0
FR;4;2021-07-02;9430;53;1;0;9470;0;0;0;0;594517;1381;18;0;594825;0;0;0;0
FR;4;2021-07-03;4847;20;0;0;4862;0;0;0;0;599364;1401;18;0;599687;0;0;0;0
FR;4;2021-07-04;690;5;0;0;692;0;0;0;0;600054;1406;18;0;600379;0;0;0;0
FR;4;2021-07-05;4774;19;2;0;4785;0;0;0;0;604828;1425;20;0;605164;0;0;0;0
FR;4;2021-07-06;7729;29;4;0;7742;0;0;0;0;612557;1454;24;0;612906;0;0;0;0
FR;4;2021-07-07;7088;34;2;0;7100;0;0;0;0;619645;1488;26;0;620006;0;0;0;0
FR;4;2021-07-08;9235;40;2;0;9258;0;0;0;0;628880;1528;28;0;629264;0;0;0;0
FR;4;2021-07-09;10282;34;1;0;10305;0;0;0;0;639162;1562;29;0;639569;0;0;0;0
FR;4;2021-07-10;4639;14;2;0;4646;0;0;0;0;643801;1576;31;0;644215;0;0;0;0
FR;4;2021-07-11;586;4;1;0;584;0;0;0;0;644387;1580;32;0;644799;0;0;0;0
FR;4;2021-07-12;5878;29;0;0;5900;0;0;0;0;650265;1609;32;0;650699;0;0;0;0
FR;4;2021-07-13;14231;29;0;0;14249;0;0;0;0;664496;1638;32;0;664948;0;0;0;0
FR;4;2021-07-14;2291;15;0;0;2291;0;0;0;0;666787;1653;32;0;667239;0;0;0;0
FR;4;2021-07-15;18239;37;0;0;18256;0;0;0;0;685026;1690;32;0;685495;0;0;0;0
FR;4;2021-07-16;22838;71;2;0;22888;0;0;0;0;707864;1761;34;0;708383;0;0;0;0
FR;4;2021-07-17;9741;20;0;0;9749;0;0;0;0;717605;1781;34;0;718132;0;0;0;0
FR;4;2021-07-18;1359;5;0;0;1362;0;0;0;0;718964;1786;34;0;719494;0;0;0;0
FR;4;2021-07-19;12991;30;1;0;13016;0;0;0;0;731955;1816;35;0;732510;0;0;0;0
FR;4;2021-07-20;17343;26;1;0;17359;0;0;0;0;749298;1842;36;0;749869;0;0;0;0
FR;4;2021-07-21;15623;33;0;0;15643;0;0;0;0;764921;1875;36;0;765512;0;0;0;0
FR;4;2021-07-22;18247;45;2;0;18271;0;0;0;0;783168;1920;38;0;783783;0;0;0;0
FR;4;2021-07-23;20420;57;7;0;20453;0;0;0;0;803588;1977;45;0;804236;0;0;0;0
FR;4;2021-07-24;9290;34;0;0;9305;0;0;0;0;812878;2011;45;0;813541;0;0;0;0
FR;4;2021-07-25;1356;11;0;0;1358;0;0;0;0;814234;2022;45;0;814899;0;0;0;0
FR;4;2021-07-26;11050;23;0;0;11057;0;0;0;0;825284;2045;45;0;825956;0;0;0;0
FR;4;2021-07-27;14687;35;3;0;14707;0;0;0;0;839971;2080;48;0;840663;0;0;0;0
FR;4;2021-07-28;12937;26;2;0;12954;0;0;0;0;852908;2106;50;0;853617;0;0;0;0
FR;4;2021-07-29;14097;54;4;0;14139;0;0;0;0;867005;2160;54;0;867756;0;0;0;0
FR;4;2021-07-30;15502;46;2;0;15533;0;0;0;0;882507;2206;56;0;883289;0;0;0;0
FR;4;2021-07-31;6845;14;2;0;6855;0;0;0;0;889352;2220;58;0;890144;0;0;0;0
FR;4;2021-08-01;906;1;0;0;901;0;0;0;0;890258;2221;58;0;891045;0;0;0;0
FR;4;2021-08-02;7918;31;0;0;7919;0;0;0;0;898176;2252;58;0;898964;0;0;0;0
FR;4;2021-08-03;10805;31;2;0;10801;0;0;0;0;908981;2283;60;0;909765;0;0;0;0
FR;4;2021-08-04;9749;29;0;0;9748;0;0;0;0;918730;2312;60;0;919513;0;0;0;0
FR;4;2021-08-05;9831;42;0;0;9837;0;0;0;0;928561;2354;60;0;929350;0;0;0;0
FR;4;2021-08-06;10201;30;3;0;10198;0;0;0;0;938762;2384;63;0;939548;0;0;0;0
FR;4;2021-08-07;5100;30;1;0;5116;0;0;0;0;943862;2414;64;0;944664;0;0;0;0
FR;4;2021-08-08;1225;13;0;0;1228;0;0;0;0;945087;2427;64;0;945892;0;0;0;0
FR;4;2021-08-09;6350;31;0;0;6343;0;0;0;0;951437;2458;64;0;952235;0;0;0;0
FR;4;2021-08-10;8753;18;0;0;8724;0;0;0;0;960190;2476;64;0;960959;0;0;0;0
FR;4;2021-08-11;7945;34;4;0;7934;0;0;0;0;968135;2510;68;0;968893;0;0;0;0
FR;4;2021-08-12;8585;31;1;0;8573;0;0;0;0;976720;2541;69;0;977466;0;0;0;0
FR;4;2021-08-13;7561;25;0;1;7548;0;0;0;0;984281;2566;69;1;985014;0;0;0;0
FR;4;2021-08-14;3793;20;0;0;3777;0;0;0;0;988074;2586;69;1;988791;0;0;0;0
FR;4;2021-08-15;771;5;0;0;773;0;0;0;0;988845;2591;69;1;989564;0;0;0;0
FR;4;2021-08-16;4009;17;0;0;4004;0;0;0;0;992854;2608;69;1;993568;0;0;0;0
FR;4;2021-08-17;5634;17;1;0;5624;0;0;0;0;998488;2625;70;1;999192;0;0;0;0
FR;4;2021-08-18;5173;37;0;0;5190;0;0;0;0;1003661;2662;70;1;1004382;0;0;0;0
FR;4;2021-08-19;5488;34;3;0;5502;0;0;0;0;1009149;2696;73;1;1009884;0;0;0;0
FR;4;2021-08-20;5225;25;1;0;5235;0;0;0;0;1014374;2721;74;1;1015119;0;0;0;0
FR;4;2021-08-21;2311;23;1;0;2328;0;0;0;0;1016685;2744;75;1;1017447;0;0;0;0
FR;4;2021-08-22;414;2;0;0;415;0;0;0;0;1017099;2746;75;1;1017862;0;0;0;0
FR;4;2021-08-23;2936;21;1;0;2944;0;0;0;0;1020035;2767;76;1;1020806;0;0;0;0
FR;4;2021-08-24;3758;16;0;0;3761;0;0;0;0;1023793;2783;76;1;1024567;0;0;0;0
FR;4;2021-08-25;3545;25;1;0;3561;0;0;0;0;1027338;2808;77;1;1028128;0;0;0;0
FR;4;2021-08-26;3716;21;2;0;3728;0;0;0;0;1031054;2829;79;1;1031856;0;0;0;0
FR;4;2021-08-27;3617;31;2;0;3635;0;0;0;0;1034671;2860;81;1;1035491;0;0;0;0
FR;4;2021-08-28;1732;10;1;0;1737;0;0;0;0;1036403;2870;82;1;1037228;0;0;0;0
FR;4;2021-08-29;385;7;1;0;389;0;0;0;0;1036788;2877;83;1;1037617;0;0;0;0
FR;4;2021-08-30;2010;25;0;0;2018;16;0;0;0;1038798;2902;83;1;1039635;16;0;0;0
FR;4;2021-08-31;2487;21;0;0;2494;14;0;0;0;1041285;2923;83;1;1042129;30;0;0;0
FR;4;2021-09-01;2085;38;1;0;2096;22;0;0;0;1043370;2961;84;1;1044225;52;0;0;0
FR;4;2021-09-02;2309;31;4;0;2322;18;0;0;0;1045679;2992;88;1;1046547;70;0;0;0
FR;4;2021-09-03;2366;44;5;0;2375;36;0;0;0;1048045;3036;93;1;1048922;106;0;0;0
FR;4;2021-09-04;1374;18;0;0;1381;9;0;0;0;1049419;3054;93;1;1050303;115;0;0;0
FR;4;2021-09-05;434;2;0;0;434;2;0;0;0;1049853;3056;93;1;1050737;117;0;0;0
FR;4;2021-09-06;1713;62;0;0;1750;24;0;0;0;1051566;3118;93;1;1052487;141;0;0;0
FR;4;2021-09-07;1681;18;0;0;1690;8;0;0;0;1053247;3136;93;1;1054177;149;0;0;0
FR;4;2021-09-08;1286;26;3;0;1291;19;0;0;0;1054533;3162;96;1;1055468;168;0;0;0
FR;4;2021-09-09;1394;23;2;0;1404;9;0;0;0;1055927;3185;98;1;1056872;177;0;0;0
FR;4;2021-09-10;1521;31;2;0;1525;23;1;0;0;1057448;3216;100;1;1058397;200;1;0;0
FR;4;2021-09-11;746;11;0;0;749;3;0;0;0;1058194;3227;100;1;1059146;203;1;0;0
FR;4;2021-09-12;169;5;0;0;170;4;0;0;0;1058363;3232;100;1;1059316;207;1;0;0
FR;4;2021-09-13;1325;22;1;0;1328;16;0;0;0;1059688;3254;101;1;1060644;223;1;0;0
FR;4;2021-09-14;1507;9;2;0;1509;7;0;0;0;1061195;3263;103;1;1062153;230;1;0;0
FR;4;2021-09-15;1095;28;1;0;1098;25;0;0;0;1062290;3291;104;1;1063251;255;1;0;0
FR;4;2021-09-16;1106;22;2;0;1110;15;0;0;0;1063396;3313;106;1;1064361;270;1;0;0
FR;4;2021-09-17;898;21;1;0;905;12;0;0;0;1064294;3334;107;1;1065266;282;1;0;0
FR;4;2021-09-18;464;7;1;0;465;6;0;0;0;1064758;3341;108;1;1065731;288;1;0;0
FR;4;2021-09-19;182;3;0;0;183;2;0;0;0;1064940;3344;108;1;1065914;290;1;0;0
FR;4;2021-09-20;452;19;0;0;458;13;0;0;0;1065392;3363;108;1;1066372;303;1;0;0
FR;4;2021-09-21;434;11;0;0;436;7;0;0;0;1065826;3374;108;1;1066808;310;1;0;0
FR;4;2021-09-22;377;19;4;0;384;15;0;0;0;1066203;3393;112;1;1067192;325;1;0;0
FR;4;2021-09-23;488;15;1;0;489;14;0;0;0;1066691;3408;113;1;1067681;339;1;0;0
FR;4;2021-09-24;415;13;2;0;419;9;0;0;0;1067106;3421;115;1;1068100;348;1;0;0
FR;4;2021-09-25;281;10;1;0;282;5;0;0;0;1067387;3431;116;1;1068382;353;1;0;0
FR;4;2021-09-26;75;2;0;0;76;1;0;0;0;1067462;3433;116;1;1068458;354;1;0;0
FR;4;2021-09-27;270;10;1;0;271;8;0;0;0;1067732;3443;117;1;1068729;362;1;0;0
FR;4;2021-09-28;319;8;0;0;319;8;0;0;0;1068051;3451;117;1;1069048;370;1;0;0
FR;4;2021-09-29;378;19;1;0;380;13;0;0;0;1068429;3470;118;1;1069428;383;1;0;0
FR;4;2021-09-30;367;41;0;0;381;22;0;0;0;1068796;3511;118;1;1069809;405;1;0;0
FR;4;2021-10-01;411;56;0;0;413;50;0;0;0;1069207;3567;118;1;1070222;455;1;0;0
FR;4;2021-10-02;196;23;1;0;198;14;0;0;0;1069403;3590;119;1;1070420;469;1;0;0
FR;4;2021-10-03;86;1;0;0;87;0;0;0;0;1069489;3591;119;1;1070507;469;1;0;0
FR;4;2021-10-04;363;20;1;0;367;16;0;0;0;1069852;3611;120;1;1070874;485;1;0;0
FR;4;2021-10-05;286;19;2;0;288;15;0;0;0;1070138;3630;122;1;1071162;500;1;0;0
FR;4;2021-10-06;249;23;1;0;254;18;0;0;0;1070387;3653;123;1;1071416;518;1;0;0
FR;4;2021-10-07;268;25;2;0;273;13;0;0;0;1070655;3678;125;1;1071689;531;1;0;0
FR;4;2021-10-08;357;24;2;0;360;20;0;0;0;1071012;3702;127;1;1072049;551;1;0;0
FR;4;2021-10-09;194;6;6;0;195;7;0;0;0;1071206;3708;133;1;1072244;558;1;0;0
FR;4;2021-10-10;97;3;2;0;99;3;0;0;0;1071303;3711;135;1;1072343;561;1;0;0
FR;4;2021-10-11;252;15;1;0;253;14;0;0;0;1071555;3726;136;1;1072596;575;1;0;0
FR;4;2021-10-12;211;14;0;0;211;13;0;0;0;1071766;3740;136;1;1072807;588;1;0;0
FR;4;2021-10-13;221;28;1;0;224;25;0;0;0;1071987;3768;137;1;1073031;613;1;0;0
FR;4;2021-10-14;316;21;4;0;320;15;0;0;0;1072303;3789;141;1;1073351;628;1;0;0
FR;4;2021-10-15;324;24;5;0;325;25;0;0;0;1072627;3813;146;1;1073676;653;1;0;0
FR;4;2021-10-16;167;6;2;0;167;6;0;0;0;1072794;3819;148;1;1073843;659;1;0;0
FR;4;2021-10-17;70;2;0;0;71;1;0;0;0;1072864;3821;148;1;1073914;660;1;0;0
FR;4;2021-10-18;281;16;1;0;283;13;0;0;0;1073145;3837;149;1;1074197;673;1;0;0
FR;4;2021-10-19;216;14;2;0;216;15;0;0;0;1073361;3851;151;1;1074413;688;1;0;0
FR;4;2021-10-20;232;27;4;0;235;15;0;0;0;1073593;3878;155;1;1074648;703;1;0;0
FR;4;2021-10-21;244;18;0;0;246;14;0;0;0;1073837;3896;155;1;1074894;717;1;0;0
FR;4;2021-10-22;217;25;2;0;219;20;1;0;0;1074054;3921;157;1;1075113;737;2;0;0
FR;4;2021-10-23;117;16;1;0;118;15;0;0;0;1074171;3937;158;1;1075231;752;2;0;0
FR;4;2021-10-24;39;4;0;0;39;1;0;0;0;1074210;3941;158;1;1075270;753;2;0;0
FR;4;2021-10-25;218;7;2;0;218;9;0;0;0;1074428;3948;160;1;1075488;762;2;0;0
FR;4;2021-10-26;200;14;0;0;202;12;0;0;0;1074628;3962;160;1;1075690;774;2;0;0
FR;4;2021-10-27;196;12;4;0;196;12;2;0;0;1074824;3974;164;1;1075886;786;4;0;0
FR;4;2021-10-28;186;18;5;0;186;22;0;0;0;1075010;3992;169;1;1076072;808;4;0;0
FR;4;2021-10-29;227;18;2;0;228;16;0;0;0;1075237;4010;171;1;1076300;824;4;0;0
FR;4;2021-10-30;104;2;1;0;105;2;0;0;0;1075341;4012;172;1;1076405;826;4;0;0
FR;4;2021-10-31;59;3;2;0;60;3;0;0;0;1075400;4015;174;1;1076465;829;4;0;0
FR;4;2021-11-01;76;27;4;0;77;24;3;0;0;1075476;4042;178;1;1076542;853;7;0;0
FR;4;2021-11-02;164;21;2;0;165;21;0;0;0;1075640;4063;180;1;1076707;874;7;0;0
FR;4;2021-11-03;132;21;8;1;133;19;6;0;0;1075772;4084;188;2;1076840;893;13;0;0
FR;4;2021-11-04;187;15;1;0;188;12;1;0;0;1075959;4099;189;2;1077028;905;14;0;0
FR;4;2021-11-05;130;17;1;0;131;16;0;0;0;1076089;4116;190;2;1077159;921;14;0;0
FR;4;2021-11-06;82;6;1;0;82;6;0;0;0;1076171;4122;191;2;1077241;927;14;0;0
FR;4;2021-11-07;83;2;2;0;83;4;0;0;0;1076254;4124;193;2;1077324;931;14;0;0
FR;4;2021-11-08;162;20;1;0;163;20;0;0;0;1076416;4144;194;2;1077487;951;14;0;0
FR;4;2021-11-09;159;14;3;0;159;16;0;0;0;1076575;4158;197;2;1077646;967;14;0;0
FR;4;2021-11-10;121;30;7;0;121;33;2;0;0;1076696;4188;204;2;1077767;1000;16;0;0
FR;4;2021-11-11;100;10;1;0;100;11;0;0;0;1076796;4198;205;2;1077867;1011;16;0;0
FR;4;2021-11-12;107;19;2;0;108;18;1;0;0;1076903;4217;207;2;1077975;1029;17;0;0
FR;4;2021-11-13;74;15;2;0;75;14;0;0;0;1076977;4232;209;2;1078050;1043;17;0;0
FR;4;2021-11-14;55;5;4;0;56;8;0;0;0;1077032;4237;213;2;1078106;1051;17;0;0
FR;4;2021-11-15;99;26;2;0;101;24;2;0;0;1077131;4263;215;2;1078207;1075;19;0;0
FR;4;2021-11-16;112;14;3;0;112;17;0;0;0;1077243;4277;218;2;1078319;1092;19;0;0
FR;4;2021-11-17;122;30;4;0;122;30;1;0;0;1077365;4307;222;2;1078441;1122;20;0;0
FR;4;2021-11-18;103;34;14;0;105;43;1;0;0;1077468;4341;236;2;1078546;1165;21;0;0
FR;4;2021-11-19;89;21;3;0;89;22;1;0;0;1077557;4362;239;2;1078635;1187;22;0;0
FR;4;2021-11-20;78;8;1;0;78;8;0;0;0;1077635;4370;240;2;1078713;1195;22;0;0
FR;4;2021-11-21;69;7;2;0;69;9;0;0;0;1077704;4377;242;2;1078782;1204;22;0;0
FR;4;2021-11-22;109;28;9;0;110;33;2;0;0;1077813;4405;251;2;1078892;1237;24;0;0
FR;4;2021-11-23;78;31;6;0;79;29;2;0;0;1077891;4436;257;2;1078971;1266;26;0;0
FR;4;2021-11-24;91;23;12;0;93;25;4;0;0;1077982;4459;269;2;1079064;1291;30;0;0
FR;4;2021-11-25;96;28;19;0;97;35;5;0;0;1078078;4487;288;2;1079161;1326;35;0;0
FR;4;2021-11-26;86;43;12;0;90;45;3;0;0;1078164;4530;300;2;1079251;1371;38;0;0
FR;4;2021-11-27;42;22;15;0;42;25;10;0;0;1078206;4552;315;2;1079293;1396;48;0;0
FR;4;2021-11-28;53;8;0;0;54;7;0;0;0;1078259;4560;315;2;1079347;1403;48;0;0
FR;4;2021-11-29;90;31;16;0;90;40;2;0;0;1078349;4591;331;2;1079437;1443;50;0;0
FR;4;2021-11-30;77;37;13;0;77;42;2;0;0;1078426;4628;344;2;1079514;1485;52;0;0
FR;4;2021-12-01;88;60;19;0;88;67;11;0;0;1078514;4688;363;2;1079602;1552;63;0;0
FR;4;2021-12-02;114;48;21;0;118;56;3;0;0;1078628;4736;384;2;1079720;1608;66;0;0
FR;4;2021-12-03;105;36;15;0;105;44;4;0;0;1078733;4772;399;2;1079825;1652;70;0;0
FR;4;2021-12-04;73;31;18;0;75;44;1;0;0;1078806;4803;417;2;1079900;1696;71;0;0
FR;4;2021-12-05;64;7;1;0;65;7;0;0;0;1078870;4810;418;2;1079965;1703;71;0;0
FR;4;2021-12-06;112;46;20;0;112;60;3;0;0;1078982;4856;438;2;1080077;1763;74;0;0
FR;4;2021-12-07;85;37;9;0;88;36;3;0;0;1079067;4893;447;2;1080165;1799;77;0;0
FR;4;2021-12-08;73;31;17;0;75;38;7;0;0;1079140;4924;464;2;1080240;1837;84;0;0
FR;4;2021-12-09;65;32;10;1;65;39;3;0;0;1079205;4956;474;3;1080305;1876;87;0;0
FR;4;2021-12-10;64;64;20;0;65;68;10;0;0;1079269;5020;494;3;1080370;1944;97;0;0
FR;4;2021-12-11;30;34;7;0;30;34;3;0;0;1079299;5054;501;3;1080400;1978;100;0;0
FR;4;2021-12-12;30;12;3;0;30;15;0;0;0;1079329;5066;504;3;1080430;1993;100;0;0
FR;4;2021-12-13;78;40;14;0;80;49;2;0;0;1079407;5106;518;3;1080510;2042;102;0;0
FR;4;2021-12-14;61;43;18;0;62;55;2;0;0;1079468;5149;536;3;1080572;2097;104;0;0
FR;4;2021-12-15;68;65;29;0;68;86;6;0;0;1079536;5214;565;3;1080640;2183;110;0;0
FR;4;2021-12-16;35;45;18;0;36;58;3;0;0;1079571;5259;583;3;1080676;2241;113;0;0
FR;4;2021-12-17;39;55;11;0;39;59;6;0;0;1079610;5314;594;3;1080715;2300;119;0;0
FR;4;2021-12-18;49;31;3;0;50;33;0;0;0;1079659;5345;597;3;1080765;2333;119;0;0
FR;4;2021-12-19;16;4;1;0;17;4;0;0;0;1079675;5349;598;3;1080782;2337;119;0;0
FR;4;2021-12-20;45;38;10;0;46;41;6;0;0;1079720;5387;608;3;1080828;2378;125;0;0
FR;4;2021-12-21;31;32;17;0;33;39;5;0;0;1079751;5419;625;3;1080861;2417;130;0;0
FR;4;2021-12-22;37;39;10;0;38;39;7;0;0;1079788;5458;635;3;1080899;2456;137;0;0
FR;4;2021-12-23;40;45;8;0;40;49;2;0;0;1079828;5503;643;3;1080939;2505;139;0;0
FR;4;2021-12-24;24;28;10;0;26;31;4;0;0;1079852;5531;653;3;1080965;2536;143;0;0
FR;4;2021-12-25;7;3;3;0;7;4;2;0;0;1079859;5534;656;3;1080972;2540;145;0;0
FR;4;2021-12-26;5;3;1;0;6;2;0;0;0;1079864;5537;657;3;1080978;2542;145;0;0
FR;4;2021-12-27;31;41;9;0;32;43;4;0;0;1079895;5578;666;3;1081010;2585;149;0;0
FR;4;2021-12-28;27;28;7;0;29;29;4;0;0;1079922;5606;673;3;1081039;2614;153;0;0
FR;4;2021-12-29;56;25;11;0;57;30;5;0;0;1079978;5631;684;3;1081096;2644;158;0;0
FR;4;2021-12-30;48;19;12;0;51;22;5;0;0;1080026;5650;696;3;1081147;2666;163;0;0
FR;4;2021-12-31;20;6;8;0;21;11;2;0;0;1080046;5656;704;3;1081168;2677;165;0;0
FR;4;2022-01-01;6;4;5;0;6;7;1;0;0;1080052;5660;709;3;1081174;2684;166;0;0
FR;4;2022-01-02;43;5;16;0;43;20;1;0;0;1080095;5665;725;3;1081217;2704;167;0;0
FR;4;2022-01-03;45;55;25;1;47;65;10;0;0;1080140;5720;750;4;1081264;2769;177;0;0
FR;4;2022-01-04;40;28;16;0;41;33;8;0;0;1080180;5748;766;4;1081305;2802;185;0;0
FR;4;2022-01-05;52;24;19;0;58;27;9;0;0;1080232;5772;785;4;1081363;2829;194;0;0
FR;4;2022-01-06;52;24;24;0;52;40;8;0;0;1080284;5796;809;4;1081415;2869;202;0;0
FR;4;2022-01-07;31;20;16;0;33;21;12;0;0;1080315;5816;825;4;1081448;2890;214;0;0
FR;4;2022-01-08;13;6;10;0;14;12;3;0;0;1080328;5822;835;4;1081462;2902;217;0;0
FR;4;2022-01-09;20;2;3;0;21;4;0;0;0;1080348;5824;838;4;1081483;2906;217;0;0
FR;4;2022-01-10;52;22;19;0;52;36;4;0;0;1080400;5846;857;4;1081535;2942;221;0;0
FR;4;2022-01-11;30;31;12;0;34;35;1;0;0;1080430;5877;869;4;1081569;2977;222;0;0
FR;4;2022-01-12;35;21;13;0;37;23;9;0;0;1080465;5898;882;4;1081606;3000;231;0;0
FR;4;2022-01-13;55;20;27;0;56;38;8;0;0;1080520;5918;909;4;1081662;3038;239;0;0
FR;4;2022-01-14;25;32;13;0;26;35;7;0;0;1080545;5950;922;4;1081688;3073;246;0;0
FR;4;2022-01-15;15;6;8;0;16;12;1;0;0;1080560;5956;930;4;1081704;3085;247;0;0
FR;4;2022-01-16;13;9;14;0;13;22;1;0;0;1080573;5965;944;4;1081717;3107;248;0;0
FR;4;2022-01-17;27;20;15;0;27;29;5;0;0;1080600;5985;959;4;1081744;3136;253;0;0
FR;4;2022-01-18;17;14;10;0;17;21;3;0;0;1080617;5999;969;4;1081761;3157;256;0;0
FR;4;2022-01-19;33;23;13;0;33;34;1;0;0;1080650;6022;982;4;1081794;3191;257;0;0
FR;4;2022-01-20;34;34;13;0;36;39;5;0;0;1080684;6056;995;4;1081830;3230;262;0;0
FR;4;2022-01-21;13;12;20;1;13;17;15;0;1;1080697;6068;1015;5;1081843;3247;277;0;1
FR;4;2022-01-22;30;13;3;0;30;14;2;0;0;1080727;6081;1018;5;1081873;3261;279;0;1
FR;4;2022-01-23;8;2;7;0;8;9;0;0;0;1080735;6083;1025;5;1081881;3270;279;0;1
FR;4;2022-01-24;14;21;9;0;15;28;1;0;0;1080749;6104;1034;5;1081896;3298;280;0;1
FR;4;2022-01-25;22;32;10;1;23;38;3;0;0;1080771;6136;1044;6;1081919;3336;283;0;1
FR;4;2022-01-26;20;17;9;1;21;21;4;0;0;1080791;6153;1053;7;1081940;3357;287;0;1
FR;4;2022-01-27;22;19;8;0;23;25;1;0;0;1080813;6172;1061;7;1081963;3382;288;0;1
FR;4;2022-01-28;14;23;8;0;15;26;4;0;0;1080827;6195;1069;7;1081978;3408;292;0;1
FR;4;2022-01-29;17;6;5;0;17;10;0;0;0;1080844;6201;1074;7;1081995;3418;292;0;1
FR;4;2022-01-30;19;3;2;0;19;5;0;0;0;1080863;6204;1076;7;1082014;3423;292;0;1
FR;4;2022-01-31;22;28;8;0;22;32;2;0;0;1080885;6232;1084;7;1082036;3455;294;0;1
FR;4;2022-02-01;13;24;13;0;15;25;9;0;0;1080898;6256;1097;7;1082051;3480;303;0;1
FR;4;2022-02-02;19;12;14;2;20;20;7;0;0;1080917;6268;1111;9;1082071;3500;310;0;1
FR;4;2022-02-03;16;24;11;0;18;29;4;0;0;1080933;6292;1122;9;1082089;3529;314;0;1
FR;4;2022-02-04;7;5;7;0;7;9;3;0;0;1080940;6297;1129;9;1082096;3538;317;0;1
FR;4;2022-02-05;7;14;1;0;8;13;1;0;0;1080947;6311;1130;9;1082104;3551;318;0;1
FR;4;2022-02-06;8;4;4;0;8;7;1;0;0;1080955;6315;1134;9;1082112;3558;319;0;1
FR;4;2022-02-07;15;20;8;0;17;20;6;0;0;1080970;6335;1142;9;1082129;3578;325;0;1
FR;4;2022-02-08;20;21;13;1;22;22;10;0;0;1080990;6356;1155;10;1082151;3600;335;0;1
FR;4;2022-02-09;18;12;9;0;19;17;2;0;0;1081008;6368;1164;10;1082170;3617;337;0;1
FR;4;2022-02-10;23;23;10;0;24;25;7;0;0;1081031;6391;1174;10;1082194;3642;344;0;1
FR;4;2022-02-11;18;15;8;0;18;20;3;0;0;1081049;6406;1182;10;1082212;3662;347;0;1
FR;4;2022-02-12;24;6;3;0;26;7;0;0;0;1081073;6412;1185;10;1082238;3669;347;0;1
FR;4;2022-02-13;7;3;3;0;7;6;0;0;0;1081080;6415;1188;10;1082245;3675;347;0;1
FR;4;2022-02-14;21;10;10;0;21;16;4;0;0;1081101;6425;1198;10;1082266;3691;351;0;1
FR;4;2022-02-15;18;7;2;0;18;8;0;0;0;1081119;6432;1200;10;1082284;3699;351;0;1
FR;4;2022-02-16;17;10;11;0;17;17;3;0;0;1081136;6442;1211;10;1082301;3716;354;0;1
FR;4;2022-02-17;11;4;5;0;11;7;2;0;0;1081147;6446;1216;10;1082312;3723;356;0;1
FR;4;2022-02-18;16;15;8;0;16;21;2;0;0;1081163;6461;1224;10;1082328;3744;358;0;1
FR;4;2022-02-19;16;4;2;0;17;5;0;0;0;1081179;6465;1226;10;1082345;3749;358;0;1
FR;4;2022-02-20;8;3;0;0;9;2;0;0;0;1081187;6468;1226;10;1082354;3751;358;0;1
FR;4;2022-02-21;24;5;4;0;24;7;2;0;0;1081211;6473;1230;10;1082378;3758;360;0;1
FR;4;2022-02-22;8;5;10;0;9;10;4;0;0;1081219;6478;1240;10;1082387;3768;364;0;1
FR;4;2022-02-23;17;6;10;0;17;10;5;0;0;1081236;6484;1250;10;1082404;3778;369;0;1
FR;4;2022-02-24;11;5;4;0;11;7;2;0;0;1081247;6489;1254;10;1082415;3785;371;0;1
FR;4;2022-02-25;17;5;7;0;17;6;6;0;0;1081264;6494;1261;10;1082432;3791;377;0;1
FR;4;2022-02-26;27;3;1;0;27;4;0;0;0;1081291;6497;1262;10;1082459;3795;377;0;1
FR;4;2022-02-27;9;0;1;0;9;1;0;0;0;1081300;6497;1263;10;1082468;3796;377;0;1
FR;4;2022-02-28;18;3;2;0;19;3;1;0;0;1081318;6500;1265;10;1082487;3799;378;0;1
FR;4;2022-03-01;8;4;7;0;8;5;5;0;0;1081326;6504;1272;10;1082495;3804;383;0;1
FR;4;2022-03-02;16;3;5;0;17;6;1;0;0;1081342;6507;1277;10;1082512;3810;384;0;1
FR;4;2022-03-03;19;5;3;0;19;6;1;0;0;1081361;6512;1280;10;1082531;3816;385;0;1
FR;4;2022-03-04;7;8;2;1;7;6;3;0;0;1081368;6520;1282;11;1082538;3822;388;0;1
FR;4;2022-03-05;9;2;0;0;9;2;0;0;0;1081377;6522;1282;11;1082547;3824;388;0;1
FR;4;2022-03-06;4;0;1;0;4;1;0;0;0;1081381;6522;1283;11;1082551;3825;388;0;1
FR;4;2022-03-07;11;6;2;0;11;5;2;0;0;1081392;6528;1285;11;1082562;3830;390;0;1
FR;4;2022-03-08;15;3;0;0;15;3;0;0;0;1081407;6531;1285;11;1082577;3833;390;0;1
FR;4;2022-03-09;9;7;2;0;11;7;0;0;0;1081416;6538;1287;11;1082588;3840;390;0;1
FR;4;2022-03-10;6;1;6;0;6;3;4;0;0;1081422;6539;1293;11;1082594;3843;394;0;1
FR;4;2022-03-11;10;4;5;0;12;2;5;0;0;1081432;6543;1298;11;1082606;3845;399;0;1
FR;4;2022-03-12;10;2;0;0;11;0;0;0;0;1081442;6545;1298;11;1082617;3845;399;0;1
FR;4;2022-03-13;6;2;1;0;7;2;0;0;0;1081448;6547;1299;11;1082624;3847;399;0;1
FR;4;2022-03-14;4;3;1;0;5;3;0;0;0;1081452;6550;1300;11;1082629;3850;399;0;1
FR;4;2022-03-15;8;8;3;0;10;7;2;0;0;1081460;6558;1303;11;1082639;3857;401;0;1
FR;4;2022-03-16;7;3;4;0;7;4;3;0;0;1081467;6561;1307;11;1082646;3861;404;0;1
FR;4;2022-03-17;3;4;1;0;3;5;0;0;0;1081470;6565;1308;11;1082649;3866;404;0;1
FR;4;2022-03-18;9;3;0;0;9;3;0;0;0;1081479;6568;1308;11;1082658;3869;404;0;1
FR;4;2022-03-19;1;1;1;0;1;2;0;0;0;1081480;6569;1309;11;1082659;3871;404;0;1
FR;4;2022-03-20;3;1;2;0;3;2;1;0;0;1081483;6570;1311;11;1082662;3873;405;0;1
FR;4;2022-03-21;6;4;1;0;6;5;0;0;0;1081489;6574;1312;11;1082668;3878;405;0;1
FR;4;2022-03-22;4;2;2;0;4;3;1;0;0;1081493;6576;1314;11;1082672;3881;406;0;1
FR;4;2022-03-23;6;4;5;0;6;8;1;0;0;1081499;6580;1319;11;1082678;3889;407;0;1
FR;4;2022-03-24;2;5;3;1;2;7;2;0;0;1081501;6585;1322;12;1082680;3896;409;0;1
FR;4;2022-03-25;4;1;2;0;4;1;2;0;0;1081505;6586;1324;12;1082684;3897;411;0;1
FR;4;2022-03-26;5;5;0;0;5;5;0;0;0;1081510;6591;1324;12;1082689;3902;411;0;1
FR;4;2022-03-27;1;0;3;0;1;2;1;0;0;1081511;6591;1327;12;1082690;3904;412;0;1
FR;4;2022-03-28;6;1;3;0;7;3;0;0;0;1081517;6592;1330;12;1082697;3907;412;0;1
FR;4;2022-03-29;9;0;4;1;9;0;2;0;0;1081526;6592;1334;13;1082706;3907;414;0;1
FR;4;2022-03-30;3;4;0;0;3;4;0;0;0;1081529;6596;1334;13;1082709;3911;414;0;1
FR;4;2022-03-31;5;3;2;1;5;4;1;0;0;1081534;6599;1336;14;1082714;3915;415;0;1
FR;4;2022-04-01;15;3;5;0;15;6;2;0;0;1081549;6602;1341;14;1082729;3921;417;0;1
FR;4;2022-04-02;4;4;0;0;5;3;0;0;0;1081553;6606;1341;14;1082734;3924;417;0;1
FR;4;2022-04-03;0;1;0;0;0;1;0;0;0;1081553;6607;1341;14;1082734;3925;417;0;1
FR;4;2022-04-04;4;4;4;0;5;5;2;0;0;1081557;6611;1345;14;1082739;3930;419;0;1
FR;4;2022-04-05;4;3;3;1;5;3;3;0;0;1081561;6614;1348;15;1082744;3933;422;0;1
FR;4;2022-04-06;6;1;0;0;6;1;0;0;0;1081567;6615;1348;15;1082750;3934;422;0;1
FR;4;2022-04-07;3;2;3;2;3;5;0;0;0;1081570;6617;1351;17;1082753;3939;422;0;1
FR;4;2022-04-08;4;2;1;0;4;2;1;0;0;1081574;6619;1352;17;1082757;3941;423;0;1
FR;4;2022-04-09;0;0;1;1;0;1;1;0;0;1081574;6619;1353;18;1082757;3942;424;0;1
FR;4;2022-04-10;2;2;0;0;2;2;0;0;0;1081576;6621;1353;18;1082759;3944;424;0;1
FR;4;2022-04-11;4;3;4;0;4;5;2;0;0;1081580;6624;1357;18;1082763;3949;426;0;1
FR;4;2022-04-12;5;1;4;0;5;2;3;0;0;1081585;6625;1361;18;1082768;3951;429;0;1
FR;4;2022-04-13;5;8;2;1;5;10;1;0;0;1081590;6633;1363;19;1082773;3961;430;0;1
FR;4;2022-04-14;6;4;2;1;7;5;1;0;0;1081596;6637;1365;20;1082780;3966;431;0;1
FR;4;2022-04-15;7;9;1;0;7;10;0;0;0;1081603;6646;1366;20;1082787;3976;431;0;1
FR;4;2022-04-16;1;0;0;0;1;0;0;0;0;1081604;6646;1366;20;1082788;3976;431;0;1
FR;4;2022-04-17;3;2;1;0;3;3;0;0;0;1081607;6648;1367;20;1082791;3979;431;0;1
FR;4;2022-04-18;2;2;6;0;2;4;4;0;0;1081609;6650;1373;20;1082793;3983;435;0;1
FR;4;2022-04-19;3;0;1;0;3;0;1;0;0;1081612;6650;1374;20;1082796;3983;436;0;1
FR;4;2022-04-20;15;4;1;1;16;3;1;0;0;1081627;6654;1375;21;1082812;3986;437;0;1
FR;4;2022-04-21;7;1;0;0;7;1;0;0;0;1081634;6655;1375;21;1082819;3987;437;0;1
FR;4;2022-04-22;1;1;2;0;1;2;1;0;0;1081635;6656;1377;21;1082820;3989;438;0;1
FR;4;2022-04-23;2;3;3;0;2;6;0;0;0;1081637;6659;1380;21;1082822;3995;438;0;1
FR;4;2022-04-24;0;3;0;0;0;3;0;0;0;1081637;6662;1380;21;1082822;3998;438;0;1
FR;4;2022-04-25;3;5;3;0;3;8;0;0;0;1081640;6667;1383;21;1082825;4006;438;0;1
FR;4;2022-04-26;5;6;1;0;5;6;1;0;0;1081645;6673;1384;21;1082830;4012;439;0;1
FR;4;2022-04-27;4;1;1;2;5;1;2;0;0;1081649;6674;1385;23;1082835;4013;441;0;1
FR;4;2022-04-28;3;5;5;1;3;7;4;0;0;1081652;6679;1390;24;1082838;4020;445;0;1
FR;4;2022-04-29;6;3;0;0;6;2;0;0;0;1081658;6682;1390;24;1082844;4022;445;0;1
FR;4;2022-04-30;2;1;1;0;2;2;0;0;0;1081660;6683;1391;24;1082846;4024;445;0;1
FR;4;2022-05-01;0;0;0;0;0;0;0;0;0;1081660;6683;1391;24;1082846;4024;445;0;1
FR;4;2022-05-02;5;16;6;0;5;19;3;0;0;1081665;6699;1397;24;1082851;4043;448;0;1
FR;4;2022-05-03;2;6;2;0;2;7;1;0;0;1081667;6705;1399;24;1082853;4050;449;0;1
FR;4;2022-05-04;7;4;1;0;7;4;1;0;0;1081674;6709;1400;24;1082860;4054;450;0;1
FR;4;2022-05-05;5;2;1;1;6;1;2;0;0;1081679;6711;1401;25;1082866;4055;452;0;1
FR;4;2022-05-06;5;3;1;0;6;2;1;0;0;1081684;6714;1402;25;1082872;4057;453;0;1
FR;4;2022-05-07;0;1;0;0;0;1;0;0;0;1081684;6715;1402;25;1082872;4058;453;0;1
FR;4;2022-05-08;1;1;0;0;1;1;0;0;0;1081685;6716;1402;25;1082873;4059;453;0;1
FR;4;2022-05-09;5;1;0;1;5;1;1;0;0;1081690;6717;1402;26;1082878;4060;454;0;1
FR;4;2022-05-10;3;1;0;2;3;3;0;0;0;1081693;6718;1402;28;1082881;4063;454;0;1
FR;4;2022-05-11;4;2;4;0;4;5;1;0;0;1081697;6720;1406;28;1082885;4068;455;0;1
FR;4;2022-05-12;7;4;2;1;7;5;1;0;1;1081704;6724;1408;29;1082892;4073;456;0;2
FR;4;2022-05-13;1;0;2;0;1;2;0;0;0;1081705;6724;1410;29;1082893;4075;456;0;2
FR;4;2022-05-14;0;2;0;0;0;2;0;0;0;1081705;6726;1410;29;1082893;4077;456;0;2
FR;4;2022-05-15;2;2;0;0;4;0;0;0;0;1081707;6728;1410;29;1082897;4077;456;0;2
FR;4;2022-05-16;5;2;2;0;5;2;2;0;0;1081712;6730;1412;29;1082902;4079;458;0;2
FR;4;2022-05-17;5;1;2;0;5;3;0;0;0;1081717;6731;1414;29;1082907;4082;458;0;2
FR;4;2022-05-18;3;6;0;0;3;6;0;0;0;1081720;6737;1414;29;1082910;4088;458;0;2
FR;4;2022-05-19;2;3;3;0;2;5;1;0;0;1081722;6740;1417;29;1082912;4093;459;0;2
FR;4;2022-05-20;5;2;3;0;5;2;3;0;0;1081727;6742;1420;29;1082917;4095;462;0;2
FR;4;2022-05-21;2;0;1;0;2;1;0;0;0;1081729;6742;1421;29;1082919;4096;462;0;2
FR;4;2022-05-22;0;0;1;0;0;1;0;0;0;1081729;6742;1422;29;1082919;4097;462;0;2
FR;4;2022-05-23;0;0;2;0;0;0;2;0;0;1081729;6742;1424;29;1082919;4097;464;0;2
FR;4;2022-05-24;2;4;1;0;2;5;0;0;0;1081731;6746;1425;29;1082921;4102;464;0;2
FR;4;2022-05-25;1;4;1;0;3;3;0;0;0;1081732;6750;1426;29;1082924;4105;464;0;2
FR;4;2022-05-26;5;0;1;0;5;1;0;0;0;1081737;6750;1427;29;1082929;4106;464;0;2
FR;4;2022-05-27;0;2;1;1;0;3;1;0;0;1081737;6752;1428;30;1082929;4109;465;0;2
FR;4;2022-05-28;1;0;0;0;1;0;0;0;0;1081738;6752;1428;30;1082930;4109;465;0;2
FR;4;2022-05-29;1;0;1;0;1;1;0;0;0;1081739;6752;1429;30;1082931;4110;465;0;2
FR;4;2022-05-30;3;4;2;0;3;5;1;0;0;1081742;6756;1431;30;1082934;4115;466;0;2
FR;4;2022-05-31;2;1;0;0;2;1;0;0;0;1081744;6757;1431;30;1082936;4116;466;0;2
FR;4;2022-06-01;3;11;7;0;3;15;3;0;0;1081747;6768;1438;30;1082939;4131;469;0;2
FR;4;2022-06-02;6;7;3;0;6;7;2;0;0;1081753;6775;1441;30;1082945;4138;471;0;2
FR;4;2022-06-03;2;6;4;1;2;7;4;0;0;1081755;6781;1445;31;1082947;4145;475;0;2
FR;4;2022-06-04;0;1;1;1;0;1;2;0;0;1081755;6782;1446;32;1082947;4146;477;0;2
FR;4;2022-06-05;0;0;0;0;0;0;0;0;0;1081755;6782;1446;32;1082947;4146;477;0;2
FR;4;2022-06-06;8;0;3;0;8;2;1;0;0;1081763;6782;1449;32;1082955;4148;478;0;2
FR;4;2022-06-07;6;2;0;1;6;2;1;0;0;1081769;6784;1449;33;1082961;4150;479;0;2
FR;4;2022-06-08;0;5;3;0;1;7;0;0;0;1081769;6789;1452;33;1082962;4157;479;0;2
FR;4;2022-06-09;1;2;0;0;2;1;0;0;0;1081770;6791;1452;33;1082964;4158;479;0;2
FR;4;2022-06-10;4;0;3;0;4;1;2;0;0;1081774;6791;1455;33;1082968;4159;481;0;2
FR;4;2022-06-11;1;0;0;0;1;0;0;0;0;1081775;6791;1455;33;1082969;4159;481;0;2
FR;4;2022-06-12;4;0;1;0;4;1;0;0;0;1081779;6791;1456;33;1082973;4160;481;0;2
FR;4;2022-06-13;6;2;3;0;7;2;1;0;0;1081785;6793;1459;33;1082980;4162;482;0;2
FR;4;2022-06-14;4;3;0;0;5;2;0;0;0;1081789;6796;1459;33;1082985;4164;482;0;2
FR;4;2022-06-15;9;3;4;0;9;3;4;0;0;1081798;6799;1463;33;1082994;4167;486;0;2
FR;4;2022-06-16;2;3;1;1;3;2;1;0;1;1081800;6802;1464;34;1082997;4169;487;0;3
FR;4;2022-06-17;6;1;0;0;6;1;0;0;0;1081806;6803;1464;34;1083003;4170;487;0;3
FR;4;2022-06-18;0;0;0;0;0;0;0;0;0;1081806;6803;1464;34;1083003;4170;487;0;3
FR;4;2022-06-19;3;0;0;0;3;0;0;0;0;1081809;6803;1464;34;1083006;4170;487;0;3
FR;4;2022-06-20;6;2;2;1;6;3;2;0;0;1081815;6805;1466;35;1083012;4173;489;0;3
FR;4;2022-06-21;5;2;4;1;6;4;2;0;0;1081820;6807;1470;36;1083018;4177;491;0;3
FR;4;2022-06-22;3;2;1;3;4;2;1;0;0;1081823;6809;1471;39;1083022;4179;492;0;3
FR;4;2022-06-23;3;3;3;0;3;5;1;0;0;1081826;6812;1474;39;1083025;4184;493;0;3
FR;4;2022-06-24;3;0;2;0;3;0;2;0;0;1081829;6812;1476;39;1083028;4184;495;0;3
FR;4;2022-06-25;3;0;1;1;3;1;1;0;0;1081832;6812;1477;40;1083031;4185;496;0;3
FR;4;2022-06-26;0;0;2;0;0;2;0;0;0;1081832;6812;1479;40;1083031;4187;496;0;3
FR;4;2022-06-27;2;2;1;3;2;3;3;0;0;1081834;6814;1480;43;1083033;4190;499;0;3
FR;4;2022-06-28;0;4;2;1;0;5;2;0;0;1081834;6818;1482;44;1083033;4195;501;0;3
FR;4;2022-06-29;1;2;0;0;1;2;0;0;0;1081835;6820;1482;44;1083034;4197;501;0;3
FR;4;2022-06-30;2;0;0;0;2;0;0;0;0;1081837;6820;1482;44;1083036;4197;501;0;3
FR;4;2022-07-01;2;4;8;0;2;4;8;0;0;1081839;6824;1490;44;1083038;4201;509;0;3
FR;4;2022-07-02;0;1;0;0;1;0;0;0;0;1081839;6825;1490;44;1083039;4201;509;0;3
FR;4;2022-07-03;0;0;0;0;0;0;0;0;0;1081839;6825;1490;44;1083039;4201;509;0;3
FR;4;2022-07-04;4;1;0;0;4;1;0;0;0;1081843;6826;1490;44;1083043;4202;509;0;3
FR;4;2022-07-05;3;1;3;0;3;3;1;0;0;1081846;6827;1493;44;1083046;4205;510;0;3
FR;4;2022-07-06;5;0;1;1;5;0;1;0;1;1081851;6827;1494;45;1083051;4205;511;0;4
FR;4;2022-07-07;2;1;2;1;2;1;3;0;0;1081853;6828;1496;46;1083053;4206;514;0;4
FR;4;2022-07-08;4;1;0;0;4;1;0;0;0;1081857;6829;1496;46;1083057;4207;514;0;4
FR;4;2022-07-09;2;2;1;0;2;3;0;0;0;1081859;6831;1497;46;1083059;4210;514;0;4
FR;4;2022-07-10;2;0;1;0;2;0;0;0;0;1081861;6831;1498;46;1083061;4210;514;0;4
FR;4;2022-07-11;3;0;2;0;3;0;1;0;0;1081864;6831;1500;46;1083064;4210;515;0;4
FR;4;2022-07-12;0;0;2;0;0;2;0;0;0;1081864;6831;1502;46;1083064;4212;515;0;4
FR;4;2022-07-13;3;2;3;1;3;2;4;0;0;1081867;6833;1505;47;1083067;4214;519;0;4
FR;4;2022-07-14;6;0;1;0;6;0;1;0;0;1081873;6833;1506;47;1083073;4214;520;0;4
FR;4;2022-07-15;11;2;0;0;11;2;0;0;0;1081884;6835;1506;47;1083084;4216;520;0;4
FR;4;2022-07-16;5;0;0;2;5;0;2;0;0;1081889;6835;1506;49;1083089;4216;522;0;4
FR;4;2022-07-17;1;0;1;1;1;0;2;0;0;1081890;6835;1507;50;1083090;4216;524;0;4
FR;4;2022-07-18;3;3;2;0;3;3;2;0;0;1081893;6838;1509;50;1083093;4219;526;0;4
FR;4;2022-07-19;5;0;1;0;5;1;0;0;0;1081898;6838;1510;50;1083098;4220;526;0;4
FR;4;2022-07-20;12;1;1;0;13;1;0;0;0;1081910;6839;1511;50;1083111;4221;526;0;4
FR;4;2022-07-21;2;3;1;0;2;3;1;0;0;1081912;6842;1512;50;1083113;4224;527;0;4
FR;4;2022-07-22;5;1;3;0;5;2;2;0;0;1081917;6843;1515;50;1083118;4226;529;0;4
FR;4;2022-07-23;1;2;0;0;1;1;0;0;0;1081918;6845;1515;50;1083119;4227;529;0;4
FR;4;2022-07-24;1;0;0;0;1;0;0;0;0;1081919;6845;1515;50;1083120;4227;529;0;4
FR;4;2022-07-25;7;0;2;0;7;2;0;0;0;1081926;6845;1517;50;1083127;4229;529;0;4
FR;4;2022-07-26;2;0;0;0;2;0;0;0;0;1081928;6845;1517;50;1083129;4229;529;0;4
FR;4;2022-07-27;3;1;0;0;3;0;0;0;0;1081931;6846;1517;50;1083132;4229;529;0;4
FR;4;2022-07-28;13;0;0;0;13;0;0;0;0;1081944;6846;1517;50;1083145;4229;529;0;4
FR;4;2022-07-29;3;0;2;0;3;1;1;0;0;1081947;6846;1519;50;1083148;4230;530;0;4
FR;4;2022-07-30;5;0;2;0;5;0;2;0;0;1081952;6846;1521;50;1083153;4230;532;0;4
FR;4;2022-07-31;0;0;0;0;0;0;0;0;0;1081952;6846;1521;50;1083153;4230;532;0;4
FR;4;2022-08-01;4;0;3;0;4;2;1;0;0;1081956;6846;1524;50;1083157;4232;533;0;4
FR;4;2022-08-02;6;0;0;0;6;0;0;0;0;1081962;6846;1524;50;1083163;4232;533;0;4
FR;4;2022-08-03;2;2;1;0;2;2;1;0;0;1081964;6848;1525;50;1083165;4234;534;0;4
FR;4;2022-08-04;5;2;0;1;5;2;1;0;0;1081969;6850;1525;51;1083170;4236;535;0;4
FR;4;2022-08-05;3;1;1;0;3;1;1;0;0;1081972;6851;1526;51;1083173;4237;536;0;4
FR;4;2022-08-06;2;0;0;0;2;0;0;0;0;1081974;6851;1526;51;1083175;4237;536;0;4
FR;4;2022-08-07;5;0;0;0;5;0;0;0;0;1081979;6851;1526;51;1083180;4237;536;0;4
FR;4;2022-08-08;2;0;1;1;2;1;1;0;0;1081981;6851;1527;52;1083182;4238;537;0;4
FR;4;2022-08-09;1;1;2;2;1;2;3;0;0;1081982;6852;1529;54;1083183;4240;540;0;4
FR;4;2022-08-10;6;1;1;0;7;1;0;0;0;1081988;6853;1530;54;1083190;4241;540;0;4
FR;4;2022-08-11;2;0;1;0;2;1;0;0;0;1081990;6853;1531;54;1083192;4242;540;0;4
FR;4;2022-08-12;4;0;1;0;4;0;1;0;0;1081994;6853;1532;54;1083196;4242;541;0;4
FR;4;2022-08-13;1;0;0;0;1;0;0;0;0;1081995;6853;1532;54;1083197;4242;541;0;4
FR;4;2022-08-14;1;0;0;0;1;0;0;0;0;1081996;6853;1532;54;1083198;4242;541;0;4
FR;4;2022-08-15;1;2;3;0;1;2;3;0;0;1081997;6855;1535;54;1083199;4244;544;0;4
FR;4;2022-08-16;0;0;1;0;0;1;0;0;0;1081997;6855;1536;54;1083199;4245;544;0;4
FR;4;2022-08-17;3;0;0;0;3;0;0;0;0;1082000;6855;1536;54;1083202;4245;544;0;4
FR;4;2022-08-18;5;0;0;0;5;0;0;0;0;1082005;6855;1536;54;1083207;4245;544;0;4
FR;4;2022-08-19;5;0;0;0;5;0;0;0;0;1082010;6855;1536;54;1083212;4245;544;0;4
FR;4;2022-08-20;3;1;0;0;4;0;0;0;0;1082013;6856;1536;54;1083216;4245;544;0;4
FR;4;2022-08-21;1;0;0;0;1;0;0;0;0;1082014;6856;1536;54;1083217;4245;544;0;4
FR;4;2022-08-22;3;9;0;0;3;9;0;0;0;1082017;6865;1536;54;1083220;4254;544;0;4
FR;4;2022-08-23;3;3;3;0;3;4;2;0;0;1082020;6868;1539;54;1083223;4258;546;0;4
FR;4;2022-08-24;6;0;0;1;6;0;1;0;0;1082026;6868;1539;55;1083229;4258;547;0;4
FR;4;2022-08-25;1;3;2;0;1;4;1;0;0;1082027;6871;1541;55;1083230;4262;548;0;4
FR;4;2022-08-26;2;0;0;1;2;0;1;0;0;1082029;6871;1541;56;1083232;4262;549;0;4
FR;4;2022-08-27;1;0;0;0;1;0;0;0;0;1082030;6871;1541;56;1083233;4262;549;0;4
FR;4;2022-08-28;0;1;0;0;0;0;0;0;0;1082030;6872;1541;56;1083233;4262;549;0;4
FR;4;2022-08-29;8;0;0;0;8;0;0;0;0;1082038;6872;1541;56;1083241;4262;549;0;4
FR;4;2022-08-30;5;1;0;0;5;1;0;0;0;1082043;6873;1541;56;1083246;4263;549;0;4
FR;4;2022-08-31;2;1;0;0;2;1;0;0;0;1082045;6874;1541;56;1083248;4264;549;0;4
FR;4;2022-09-01;4;8;2;0;5;7;2;0;0;1082049;6882;1543;56;1083253;4271;551;0;4
FR;4;2022-09-02;2;2;1;0;3;2;0;0;0;1082051;6884;1544;56;1083256;4273;551;0;4
FR;4;2022-09-03;3;0;0;0;3;0;0;0;0;1082054;6884;1544;56;1083259;4273;551;0;4
FR;4;2022-09-04;1;0;0;0;1;0;0;0;0;1082055;6884;1544;56;1083260;4273;551;0;4
FR;4;2022-09-05;4;2;0;0;4;2;0;0;0;1082059;6886;1544;56;1083264;4275;551;0;4
FR;4;2022-09-06;1;0;0;0;1;0;0;0;0;1082060;6886;1544;56;1083265;4275;551;0;4
FR;4;2022-09-07;2;0;1;1;2;1;1;0;0;1082062;6886;1545;57;1083267;4276;552;0;4
FR;4;2022-09-08;3;0;0;0;3;0;0;0;0;1082065;6886;1545;57;1083270;4276;552;0;4
FR;4;2022-09-09;2;2;0;0;2;2;0;0;0;1082067;6888;1545;57;1083272;4278;552;0;4
FR;4;2022-09-10;0;1;0;3;0;2;2;0;0;1082067;6889;1545;60;1083272;4280;554;0;4
FR;4;2022-09-11;2;0;0;0;2;0;0;0;0;1082069;6889;1545;60;1083274;4280;554;0;4
FR;4;2022-09-12;1;1;1;0;1;1;1;0;0;1082070;6890;1546;60;1083275;4281;555;0;4
FR;4;2022-09-13;1;0;0;0;1;0;0;0;0;1082071;6890;1546;60;1083276;4281;555;0;4
FR;4;2022-09-14;4;0;0;0;4;0;0;0;0;1082075;6890;1546;60;1083280;4281;555;0;4
FR;4;2022-09-15;4;0;0;0;4;0;0;0;0;1082079;6890;1546;60;1083284;4281;555;0;4
FR;4;2022-09-16;1;0;0;0;1;0;0;0;0;1082080;6890;1546;60;1083285;4281;555;0;4
FR;4;2022-09-17;2;0;0;0;2;0;0;0;0;1082082;6890;1546;60;1083287;4281;555;0;4
FR;4;2022-09-18;0;1;0;0;0;1;0;0;0;1082082;6891;1546;60;1083287;4282;555;0;4
FR;4;2022-09-19;3;0;2;0;3;2;0;0;0;1082085;6891;1548;60;1083290;4284;555;0;4
FR;4;2022-09-20;4;0;0;0;4;0;0;0;0;1082089;6891;1548;60;1083294;4284;555;0;4
FR;4;2022-09-21;2;1;0;0;2;1;0;0;0;1082091;6892;1548;60;1083296;4285;555;0;4
FR;4;2022-09-22;2;1;0;0;2;1;0;0;0;1082093;6893;1548;60;1083298;4286;555;0;4
FR;4;2022-09-23;2;3;0;0;3;2;0;0;0;1082095;6896;1548;60;1083301;4288;555;0;4
FR;4;2022-09-24;1;0;0;0;1;0;0;0;0;1082096;6896;1548;60;1083302;4288;555;0;4
FR;4;2022-09-25;0;0;0;0;0;0;0;0;0;1082096;6896;1548;60;1083302;4288;555;0;4
FR;4;2022-09-26;2;0;1;0;2;0;1;0;0;1082098;6896;1549;60;1083304;4288;556;0;4
FR;4;2022-09-27;1;0;1;1;1;0;2;0;0;1082099;6896;1550;61;1083305;4288;558;0;4
FR;4;2022-09-28;3;0;2;0;3;2;0;0;0;1082102;6896;1552;61;1083308;4290;558;0;4
FR;4;2022-09-29;3;0;1;1;3;1;1;0;0;1082105;6896;1553;62;1083311;4291;559;0;4
FR;4;2022-09-30;1;1;0;0;1;1;0;0;0;1082106;6897;1553;62;1083312;4292;559;0;4
FR;4;2022-10-01;1;1;0;0;2;0;0;0;0;1082107;6898;1553;62;1083314;4292;559;0;4
FR;4;2022-10-02;0;1;0;0;0;1;0;0;0;1082107;6899;1553;62;1083314;4293;559;0;4
FR;4;2022-10-03;2;3;1;1;3;3;1;0;0;1082109;6902;1554;63;1083317;4296;560;0;4
FR;4;2022-10-04;3;0;0;0;3;0;0;0;0;1082112;6902;1554;63;1083320;4296;560;0;4
FR;4;2022-10-05;0;1;0;0;0;1;0;0;0;1082112;6903;1554;63;1083320;4297;560;0;4
FR;4;2022-10-06;2;0;0;0;2;0;0;0;0;1082114;6903;1554;63;1083322;4297;560;0;4
FR;4;2022-10-07;3;1;1;0;3;1;1;0;0;1082117;6904;1555;63;1083325;4298;561;0;4
FR;4;2022-10-08;4;1;0;0;4;0;0;0;0;1082121;6905;1555;63;1083329;4298;561;0;4
FR;4;2022-10-09;0;0;0;0;0;0;0;0;0;1082121;6905;1555;63;1083329;4298;561;0;4
FR;4;2022-10-10;5;0;2;3;5;2;1;0;2;1082126;6905;1557;66;1083334;4300;562;0;6
FR;4;2022-10-11;2;2;0;0;2;1;0;0;0;1082128;6907;1557;66;1083336;4301;562;0;6
FR;4;2022-10-12;1;0;0;0;1;0;0;0;0;1082129;6907;1557;66;1083337;4301;562;0;6
FR;4;2022-10-13;5;0;0;0;5;0;0;0;0;1082134;6907;1557;66;1083342;4301;562;0;6
FR;4;2022-10-14;1;0;0;0;1;0;0;0;0;1082135;6907;1557;66;1083343;4301;562;0;6
FR;4;2022-10-15;1;2;0;0;1;2;0;0;0;1082136;6909;1557;66;1083344;4303;562;0;6
FR;4;2022-10-16;0;0;0;0;0;0;0;0;0;1082136;6909;1557;66;1083344;4303;562;0;6
FR;4;2022-10-17;2;0;1;0;2;1;0;0;0;1082138;6909;1558;66;1083346;4304;562;0;6
FR;4;2022-10-18;1;0;0;1;1;0;1;0;0;1082139;6909;1558;67;1083347;4304;563;0;6
FR;4;2022-10-19;1;0;0;2;1;0;2;0;3;1082140;6909;1558;69;1083348;4304;565;0;9
FR;4;2022-10-20;4;1;0;0;4;1;0;0;0;1082144;6910;1558;69;1083352;4305;565;0;9
FR;4;2022-10-21;3;1;0;0;3;1;0;0;0;1082147;6911;1558;69;1083355;4306;565;0;9
FR;4;2022-10-22;1;0;0;0;1;0;0;0;0;1082148;6911;1558;69;1083356;4306;565;0;9
FR;4;2022-10-23;0;0;0;0;0;0;0;0;0;1082148;6911;1558;69;1083356;4306;565;0;9
FR;4;2022-10-24;3;0;0;0;3;0;0;0;0;1082151;6911;1558;69;1083359;4306;565;0;9
FR;4;2022-10-25;3;0;0;0;3;0;0;0;0;1082154;6911;1558;69;1083362;4306;565;0;9
FR;4;2022-10-26;2;1;0;0;2;1;0;0;0;1082156;6912;1558;69;1083364;4307;565;0;9
FR;4;2022-10-27;3;1;1;0;3;0;1;0;0;1082159;6913;1559;69;1083367;4307;566;0;9
FR;4;2022-10-28;0;0;0;0;0;0;0;0;0;1082159;6913;1559;69;1083367;4307;566;0;9
FR;4;2022-10-29;1;0;0;3;1;0;3;0;3;1082160;6913;1559;72;1083368;4307;569;0;12
FR;4;2022-10-30;1;0;0;0;1;0;0;0;0;1082161;6913;1559;72;1083369;4307;569;0;12
FR;4;2022-10-31;1;0;0;0;1;0;0;0;0;1082162;6913;1559;72;1083370;4307;569;0;12
FR;4;2022-11-01;1;6;0;0;1;6;0;0;0;1082163;6919;1559;72;1083371;4313;569;0;12
FR;4;2022-11-02;0;0;2;2;0;1;3;0;0;1082163;6919;1561;74;1083371;4314;572;0;12
FR;4;2022-11-03;1;0;0;0;1;0;0;0;0;1082164;6919;1561;74;1083372;4314;572;0;12
FR;4;2022-11-04;4;1;0;0;4;0;0;0;0;1082168;6920;1561;74;1083376;4314;572;0;12
FR;4;2022-11-05;0;0;0;0;0;0;0;0;0;1082168;6920;1561;74;1083376;4314;572;0;12
FR;4;2022-11-06;2;0;0;0;2;0;0;0;0;1082170;6920;1561;74;1083378;4314;572;0;12
FR;4;2022-11-07;2;0;0;0;2;0;0;0;0;1082172;6920;1561;74;1083380;4314;572;0;12
FR;4;2022-11-08;7;0;0;0;7;0;0;0;0;1082179;6920;1561;74;1083387;4314;572;0;12
FR;4;2022-11-09;0;0;0;0;0;0;0;0;0;1082179;6920;1561;74;1083387;4314;572;0;12
FR;4;2022-11-10;1;0;1;0;1;1;0;0;0;1082180;6920;1562;74;1083388;4315;572;0;12
FR;4;2022-11-11;1;0;0;0;1;0;0;0;0;1082181;6920;1562;74;1083389;4315;572;0;12
FR;4;2022-11-12;3;1;0;0;3;1;0;0;0;1082184;6921;1562;74;1083392;4316;572;0;12
FR;4;2022-11-13;2;0;0;0;2;0;0;0;0;1082186;6921;1562;74;1083394;4316;572;0;12
FR;4;2022-11-14;0;0;0;0;0;0;0;0;0;1082186;6921;1562;74;1083394;4316;572;0;12
FR;4;2022-11-15;3;1;0;0;3;1;0;0;0;1082189;6922;1562;74;1083397;4317;572;0;12
FR;4;2022-11-16;1;1;1;0;1;1;1;0;0;1082190;6923;1563;74;1083398;4318;573;0;12
FR;4;2022-11-17;0;2;0;0;0;2;0;0;0;1082190;6925;1563;74;1083398;4320;573;0;12
FR;4;2022-11-18;5;0;1;0;5;0;1;0;0;1082195;6925;1564;74;1083403;4320;574;0;12
FR;4;2022-11-19;0;0;0;0;0;0;0;0;0;1082195;6925;1564;74;1083403;4320;574;0;12
FR;4;2022-11-20;0;0;0;1;0;0;0;0;1;1082195;6925;1564;75;1083403;4320;574;0;13
FR;4;2022-11-21;0;0;0;0;0;0;0;0;0;1082195;6925;1564;75;1083403;4320;574;0;13
FR;4;2022-11-22;0;1;1;0;0;2;0;0;0;1082195;6926;1565;75;1083403;4322;574;0;13
FR;4;2022-11-23;1;0;0;0;1;0;0;0;1;1082196;6926;1565;75;1083404;4322;574;0;14
FR;4;2022-11-24;0;2;0;0;0;2;0;0;0;1082196;6928;1565;75;1083404;4324;574;0;14
FR;4;2022-11-25;3;4;0;0;3;4;0;0;0;1082199;6932;1565;75;1083407;4328;574;0;14
FR;4;2022-11-26;1;0;0;0;1;0;0;0;0;1082200;6932;1565;75;1083408;4328;574;0;14
FR;4;2022-11-27;0;0;0;0;0;0;0;0;0;1082200;6932;1565;75;1083408;4328;574;0;14
FR;4;2022-11-28;3;0;0;0;3;0;0;0;0;1082203;6932;1565;75;1083411;4328;574;0;14
FR;4;2022-11-29;3;0;0;0;3;0;0;0;0;1082206;6932;1565;75;1083414;4328;574;0;14
FR;4;2022-11-30;0;0;0;0;0;0;0;0;0;1082206;6932;1565;75;1083414;4328;574;0;14
FR;4;2022-12-01;1;2;2;0;2;2;1;0;0;1082207;6934;1567;75;1083416;4330;575;0;14
FR;4;2022-12-02;6;1;0;1;6;1;0;0;1;1082213;6935;1567;76;1083422;4331;575;0;15
FR;4;2022-12-03;1;0;0;0;1;0;0;0;0;1082214;6935;1567;76;1083423;4331;575;0;15
FR;4;2022-12-04;0;0;0;0;0;0;0;0;0;1082214;6935;1567;76;1083423;4331;575;0;15
FR;4;2022-12-05;2;1;0;0;2;1;0;0;0;1082216;6936;1567;76;1083425;4332;575;0;15
FR;4;2022-12-06;2;0;0;0;2;0;0;0;0;1082218;6936;1567;76;1083427;4332;575;0;15
FR;4;2022-12-07;2;3;1;0;2;4;0;0;0;1082220;6939;1568;76;1083429;4336;575;0;15
FR;4;2022-12-08;1;0;0;0;1;0;0;0;0;1082221;6939;1568;76;1083430;4336;575;0;15
FR;4;2022-12-09;2;0;1;0;2;0;1;0;0;1082223;6939;1569;76;1083432;4336;576;0;15
FR;4;2022-12-10;1;0;0;0;1;0;0;0;0;1082224;6939;1569;76;1083433;4336;576;0;15
FR;4;2022-12-11;0;0;0;0;0;0;0;0;0;1082224;6939;1569;76;1083433;4336;576;0;15
FR;4;2022-12-12;2;1;0;5;2;1;5;0;0;1082226;6940;1569;81;1083435;4337;581;0;15
FR;4;2022-12-13;1;0;0;0;1;0;0;0;0;1082227;6940;1569;81;1083436;4337;581;0;15
FR;4;2022-12-14;0;0;0;0;0;0;0;0;0;1082227;6940;1569;81;1083436;4337;581;0;15
FR;4;2022-12-15;1;1;0;0;1;1;0;0;0;1082228;6941;1569;81;1083437;4338;581;0;15
FR;4;2022-12-16;2;0;0;0;2;0;0;0;0;1082230;6941;1569;81;1083439;4338;581;0;15
FR;4;2022-12-17;0;0;1;0;0;0;1;0;0;1082230;6941;1570;81;1083439;4338;582;0;15
FR;4;2022-12-18;1;0;0;0;1;0;0;0;0;1082231;6941;1570;81;1083440;4338;582;0;15
FR;4;2022-12-19;1;0;0;0;1;0;0;0;0;1082232;6941;1570;81;1083441;4338;582;0;15
FR;4;2022-12-20;4;2;0;0;5;1;0;0;0;1082236;6943;1570;81;1083446;4339;582;0;15
FR;4;2022-12-21;4;0;0;0;4;0;0;0;0;1082240;6943;1570;81;1083450;4339;582;0;15
FR;4;2022-12-22;2;1;0;0;2;1;0;0;0;1082242;6944;1570;81;1083452;4340;582;0;15
FR;4;2022-12-23;3;0;0;0;3;0;0;0;0;1082245;6944;1570;81;1083455;4340;582;0;15
FR;4;2022-12-24;0;0;1;0;0;1;0;0;0;1082245;6944;1571;81;1083455;4341;582;0;15
FR;4;2022-12-25;0;0;0;0;0;0;0;0;0;1082245;6944;1571;81;1083455;4341;582;0;15
FR;4;2022-12-26;1;2;0;0;1;1;0;0;0;1082246;6946;1571;81;1083456;4342;582;0;15
FR;4;2022-12-27;1;1;0;0;1;1;0;0;0;1082247;6947;1571;81;1083457;4343;582;0;15
FR;4;2022-12-28;0;0;0;0;0;0;0;0;0;1082247;6947;1571;81;1083457;4343;582;0;15
FR;4;2022-12-29;0;1;0;0;1;0;0;0;0;1082247;6948;1571;81;1083458;4343;582;0;15
FR;4;2022-12-30;1;0;0;0;1;0;0;0;0;1082248;6948;1571;81;1083459;4343;582;0;15
FR;4;2022-12-31;0;0;0;0;0;0;0;0;0;1082248;6948;1571;81;1083459;4343;582;0;15
FR;4;2023-01-01;0;0;0;0;0;0;0;0;0;1082248;6948;1571;81;1083459;4343;582;0;15
FR;4;2023-01-02;2;0;2;0;2;1;1;0;0;1082250;6948;1573;81;1083461;4344;583;0;15
FR;4;2023-01-03;1;1;0;0;1;1;0;0;0;1082251;6949;1573;81;1083462;4345;583;0;15
FR;4;2023-01-04;0;0;0;0;0;0;0;0;0;1082251;6949;1573;81;1083462;4345;583;0;15
FR;4;2023-01-05;0;0;0;0;0;0;0;0;0;1082251;6949;1573;81;1083462;4345;583;0;15
FR;4;2023-01-06;1;1;3;0;1;4;0;0;0;1082252;6950;1576;81;1083463;4349;583;0;15
FR;4;2023-01-07;1;0;0;0;1;0;0;0;0;1082253;6950;1576;81;1083464;4349;583;0;15
FR;4;2023-01-08;1;0;0;0;1;0;0;0;0;1082254;6950;1576;81;1083465;4349;583;0;15
FR;4;2023-01-09;1;0;0;0;1;0;0;0;0;1082255;6950;1576;81;1083466;4349;583;0;15
FR;4;2023-01-10;2;0;0;0;2;0;0;0;0;1082257;6950;1576;81;1083468;4349;583;0;15
FR;4;2023-01-11;0;0;0;0;0;0;0;0;0;1082257;6950;1576;81;1083468;4349;583;0;15
FR;4;2023-01-12;2;2;0;0;2;2;0;0;0;1082259;6952;1576;81;1083470;4351;583;0;15
FR;4;2023-01-13;3;0;2;0;3;0;2;0;0;1082262;6952;1578;81;1083473;4351;585;0;15
FR;4;2023-01-14;0;0;1;0;0;0;1;0;0;1082262;6952;1579;81;1083473;4351;586;0;15
FR;4;2023-01-15;0;0;0;0;0;0;0;0;0;1082262;6952;1579;81;1083473;4351;586;0;15
FR;4;2023-01-16;2;0;0;0;2;0;0;0;0;1082264;6952;1579;81;1083475;4351;586;0;15
FR;4;2023-01-17;2;0;0;0;2;0;0;0;0;1082266;6952;1579;81;1083477;4351;586;0;15
FR;4;2023-01-18;3;0;0;0;3;0;0;0;0;1082269;6952;1579;81;1083480;4351;586;0;15
FR;4;2023-01-19;1;0;0;2;1;0;0;0;0;1082270;6952;1579;83;1083481;4351;586;0;15
FR;4;2023-01-20;0;0;0;0;0;0;0;0;0;1082270;6952;1579;83;1083481;4351;586;0;15
FR;4;2023-01-21;0;0;0;0;0;0;0;0;0;1082270;6952;1579;83;1083481;4351;586;0;15
FR;4;2023-01-22;0;0;0;0;0;0;0;0;0;1082270;6952;1579;83;1083481;4351;586;0;15
FR;4;2023-01-23;1;0;0;0;1;0;0;0;0;1082271;6952;1579;83;1083482;4351;586;0;15
FR;4;2023-01-24;2;1;0;0;2;1;0;0;0;1082273;6953;1579;83;1083484;4352;586;0;15
FR;4;2023-01-25;6;0;0;0;6;0;0;0;0;1082279;6953;1579;83;1083490;4352;586;0;15
FR;4;2023-01-26;0;0;0;0;0;0;0;0;0;1082279;6953;1579;83;1083490;4352;586;0;15
FR;4;2023-01-27;0;0;0;0;0;0;0;0;0;1082279;6953;1579;83;1083490;4352;586;0;15
FR;4;2023-01-28;0;0;0;0;0;0;0;0;0;1082279;6953;1579;83;1083490;4352;586;0;15
FR;4;2023-01-29;0;0;0;0;0;0;0;0;0;1082279;6953;1579;83;1083490;4352;586;0;15
FR;4;2023-01-30;0;0;0;0;0;0;0;0;0;1082279;6953;1579;83;1083490;4352;586;0;15
FR;4;2023-01-31;0;0;0;0;0;0;0;0;0;1082279;6953;1579;83;1083490;4352;586;0;15
FR;4;2023-02-01;0;0;0;0;0;0;0;0;0;1082279;6953;1579;83;1083490;4352;586;0;15
FR;4;2023-02-02;2;2;2;1;2;3;1;0;0;1082281;6955;1581;84;1083492;4355;587;0;15
FR;4;2023-02-03;0;0;0;0;0;0;0;0;0;1082281;6955;1581;84;1083492;4355;587;0;15
FR;4;2023-02-04;1;0;0;0;1;0;0;0;0;1082282;6955;1581;84;1083493;4355;587;0;15
FR;4;2023-02-05;0;0;0;0;0;0;0;0;0;1082282;6955;1581;84;1083493;4355;587;0;15
FR;4;2023-02-06;1;0;0;0;1;0;0;0;0;1082283;6955;1581;84;1083494;4355;587;0;15
FR;4;2023-02-07;2;0;0;0;2;0;0;0;0;1082285;6955;1581;84;1083496;4355;587;0;15
FR;4;2023-02-08;2;1;0;0;2;0;0;0;0;1082287;6956;1581;84;1083498;4355;587;0;15
FR;4;2023-02-09;1;1;0;0;1;1;0;0;0;1082288;6957;1581;84;1083499;4356;587;0;15
FR;4;2023-02-10;4;1;0;0;4;0;0;0;0;1082292;6958;1581;84;1083503;4356;587;0;15
FR;4;2023-02-11;1;0;0;0;1;0;0;0;0;1082293;6958;1581;84;1083504;4356;587;0;15
FR;4;2023-02-12;0;0;0;0;0;0;0;0;0;1082293;6958;1581;84;1083504;4356;587;0;15
FR;4;2023-02-13;2;0;0;0;2;0;0;0;0;1082295;6958;1581;84;1083506;4356;587;0;15
FR;4;2023-02-14;0;2;0;0;2;0;0;0;0;1082295;6960;1581;84;1083508;4356;587;0;15
FR;4;2023-02-15;2;0;0;0;2;0;0;0;0;1082297;6960;1581;84;1083510;4356;587;0;15
FR;4;2023-02-16;1;1;0;0;1;1;0;0;0;1082298;6961;1581;84;1083511;4357;587;0;15
FR;4;2023-02-17;1;0;0;0;1;0;0;0;0;1082299;6961;1581;84;1083512;4357;587;0;15
FR;4;2023-02-18;0;2;0;0;0;2;0;0;0;1082299;6963;1581;84;1083512;4359;587;0;15
FR;4;2023-02-19;0;0;0;0;0;0;0;0;0;1082299;6963;1581;84;1083512;4359;587;0;15
FR;4;2023-02-20;1;0;0;0;1;0;0;0;0;1082300;6963;1581;84;1083513;4359;587;0;15
FR;4;2023-02-21;2;0;0;0;2;0;0;0;0;1082302;6963;1581;84;1083515;4359;587;0;15
FR;4;2023-02-22;0;0;0;0;0;0;0;0;0;1082302;6963;1581;84;1083515;4359;587;0;15
FR;4;2023-02-23;0;0;0;0;0;0;0;0;0;1082302;6963;1581;84;1083515;4359;587;0;15
FR;4;2023-02-24;1;0;0;0;1;0;0;0;0;1082303;6963;1581;84;1083516;4359;587;0;15
FR;4;2023-02-25;2;1;0;0;2;1;0;0;0;1082305;6964;1581;84;1083518;4360;587;0;15
FR;4;2023-02-26;0;0;0;0;0;0;0;0;0;1082305;6964;1581;84;1083518;4360;587;0;15
FR;4;2023-02-27;0;0;0;0;0;0;0;0;0;1082305;6964;1581;84;1083518;4360;587;0;15
FR;4;2023-02-28;0;0;0;0;0;0;0;0;0;1082305;6964;1581;84;1083518;4360;587;0;15
FR;4;2023-03-01;1;0;0;0;1;0;0;0;0;1082306;6964;1581;84;1083519;4360;587;0;15
FR;4;2023-03-02;1;1;2;0;1;1;2;0;0;1082307;6965;1583;84;1083520;4361;589;0;15
FR;4;2023-03-03;0;0;0;0;0;0;0;0;0;1082307;6965;1583;84;1083520;4361;589;0;15
FR;4;2023-03-04;0;0;0;0;0;0;0;0;0;1082307;6965;1583;84;1083520;4361;589;0;15
FR;4;2023-03-05;0;0;0;0;0;0;0;0;0;1082307;6965;1583;84;1083520;4361;589;0;15
FR;4;2023-03-06;0;0;0;0;0;0;0;0;0;1082307;6965;1583;84;1083520;4361;589;0;15
FR;4;2023-03-07;0;0;0;0;0;0;0;0;0;1082307;6965;1583;84;1083520;4361;589;0;15
FR;4;2023-03-08;0;0;0;0;0;0;0;0;0;1082307;6965;1583;84;1083520;4361;589;0;15
FR;4;2023-03-09;0;0;0;0;0;0;0;0;0;1082307;6965;1583;84;1083520;4361;589;0;15
FR;4;2023-03-10;1;0;1;0;1;0;1;0;0;1082308;6965;1584;84;1083521;4361;590;0;15
FR;4;2023-03-11;0;0;0;0;0;0;0;0;0;1082308;6965;1584;84;1083521;4361;590;0;15
FR;4;2023-03-12;0;0;0;0;0;0;0;0;0;1082308;6965;1584;84;1083521;4361;590;0;15
FR;4;2023-03-13;0;0;0;0;0;0;0;0;0;1082308;6965;1584;84;1083521;4361;590;0;15
FR;4;2023-03-14;0;0;0;0;0;0;0;0;0;1082308;6965;1584;84;1083521;4361;590;0;15
FR;4;2023-03-15;1;0;0;0;1;0;0;0;0;1082309;6965;1584;84;1083522;4361;590;0;15
FR;4;2023-03-16;1;0;0;0;1;0;0;0;0;1082310;6965;1584;84;1083523;4361;590;0;15
FR;4;2023-03-17;1;0;0;0;1;0;0;0;0;1082311;6965;1584;84;1083524;4361;590;0;15
FR;4;2023-03-18;0;0;0;0;0;0;0;0;0;1082311;6965;1584;84;1083524;4361;590;0;15
FR;4;2023-03-19;0;0;0;0;0;0;0;0;0;1082311;6965;1584;84;1083524;4361;590;0;15
FR;4;2023-03-20;0;0;0;0;0;0;0;0;0;1082311;6965;1584;84;1083524;4361;590;0;15
FR;4;2023-03-21;1;0;0;0;1;0;0;0;0;1082312;6965;1584;84;1083525;4361;590;0;15
FR;4;2023-03-22;0;0;0;0;0;0;0;0;0;1082312;6965;1584;84;1083525;4361;590;0;15
FR;4;2023-03-23;0;0;0;0;0;0;0;0;0;1082312;6965;1584;84;1083525;4361;590;0;15
FR;4;2023-03-24;0;0;0;0;0;0;0;0;0;1082312;6965;1584;84;1083525;4361;590;0;15
FR;4;2023-03-25;0;0;0;0;0;0;0;0;0;1082312;6965;1584;84;1083525;4361;590;0;15
FR;4;2023-03-26;0;0;0;0;0;0;0;0;0;1082312;6965;1584;84;1083525;4361;590;0;15
FR;5;2020-12-27;0;0;0;0;0;0;0;0;0;0;0;0;0;0;0;0;0;0
FR;5;2020-12-28;0;0;0;0;0;0;0;0;0;0;0;0;0;0;0;0;0;0
FR;5;2020-12-29;0;0;0;0;0;0;0;0;0;0;0;0;0;0;0;0;0;0
FR;5;2020-12-30;0;0;0;0;0;0;0;0;0;0;0;0;0;0;0;0;0;0
FR;5;2020-12-31;0;0;0;0;0;0;0;0;0;0;0;0;0;0;0;0;0;0
FR;5;2021-01-01;0;0;0;0;0;0;0;0;0;0;0;0;0;0;0;0;0;0
FR;5;2021-01-02;0;0;0;0;0;0;0;0;0;0;0;0;0;0;0;0;0;0
FR;5;2021-01-03;0;0;0;0;0;0;0;0;0;0;0;0;0;0;0;0;0;0
FR;5;2021-01-04;0;0;0;0;0;0;0;0;0;0;0;0;0;0;0;0;0;0
FR;5;2021-01-05;0;0;0;0;0;0;0;0;0;0;0;0;0;0;0;0;0;0
FR;5;2021-01-06;0;0;0;0;0;0;0;0;0;0;0;0;0;0;0;0;0;0
FR;5;2021-01-07;0;0;0;0;0;0;0;0;0;0;0;0;0;0;0;0;0;0
FR;5;2021-01-08;0;0;0;0;0;0;0;0;0;0;0;0;0;0;0;0;0;0
FR;5;2021-01-09;0;0;0;0;0;0;0;0;0;0;0;0;0;0;0;0;0;0
FR;5;2021-01-10;0;0;0;0;0;0;0;0;0;0;0;0;0;0;0;0;0;0
FR;5;2021-01-11;0;0;0;0;0;0;0;0;0;0;0;0;0;0;0;0;0;0
FR;5;2021-01-12;0;0;0;0;0;0;0;0;0;0;0;0;0;0;0;0;0;0
FR;5;2021-01-13;0;0;0;0;0;0;0;0;0;0;0;0;0;0;0;0;0;0
FR;5;2021-01-14;0;0;0;0;0;0;0;0;0;0;0;0;0;0;0;0;0;0
FR;5;2021-01-15;0;0;0;0;0;0;0;0;0;0;0;0;0;0;0;0;0;0
FR;5;2021-01-16;0;0;0;0;0;0;0;0;0;0;0;0;0;0;0;0;0;0
FR;5;2021-01-17;0;0;0;0;0;0;0;0;0;0;0;0;0;0;0;0;0;0
FR;5;2021-01-18;0;0;0;0;0;0;0;0;0;0;0;0;0;0;0;0;0;0
FR;5;2021-01-19;0;0;0;0;0;0;0;0;0;0;0;0;0;0;0;0;0;0
FR;5;2021-01-20;0;0;0;0;0;0;0;0;0;0;0;0;0;0;0;0;0;0
FR;5;2021-01-21;0;0;0;0;0;0;0;0;0;0;0;0;0;0;0;0;0;0
FR;5;2021-01-22;0;0;0;0;0;0;0;0;0;0;0;0;0;0;0;0;0;0
FR;5;2021-01-23;0;0;0;0;0;0;0;0;0;0;0;0;0;0;0;0;0;0
FR;5;2021-01-24;0;0;0;0;0;0;0;0;0;0;0;0;0;0;0;0;0;0
FR;5;2021-01-25;0;0;0;0;0;0;0;0;0;0;0;0;0;0;0;0;0;0
FR;5;2021-01-26;0;0;0;0;0;0;0;0;0;0;0;0;0;0;0;0;0;0
FR;5;2021-01-27;0;0;0;0;0;0;0;0;0;0;0;0;0;0;0;0;0;0
FR;5;2021-01-28;0;0;0;0;0;0;0;0;0;0;0;0;0;0;0;0;0;0
FR;5;2021-01-29;0;0;0;0;0;0;0;0;0;0;0;0;0;0;0;0;0;0
FR;5;2021-01-30;0;0;0;0;0;0;0;0;0;0;0;0;0;0;0;0;0;0
FR;5;2021-01-31;0;0;0;0;0;0;0;0;0;0;0;0;0;0;0;0;0;0
FR;5;2021-02-01;0;0;0;0;0;0;0;0;0;0;0;0;0;0;0;0;0;0
FR;5;2021-02-02;0;0;0;0;0;0;0;0;0;0;0;0;0;0;0;0;0;0
FR;5;2021-02-03;0;0;0;0;0;0;0;0;0;0;0;0;0;0;0;0;0;0
FR;5;2021-02-04;0;0;0;0;0;0;0;0;0;0;0;0;0;0;0;0;0;0
FR;5;2021-02-05;0;0;0;0;0;0;0;0;0;0;0;0;0;0;0;0;0;0
FR;5;2021-02-06;0;0;0;0;0;0;0;0;0;0;0;0;0;0;0;0;0;0
FR;5;2021-02-07;0;0;0;0;0;0;0;0;0;0;0;0;0;0;0;0;0;0
FR;5;2021-02-08;0;0;0;0;0;0;0;0;0;0;0;0;0;0;0;0;0;0
FR;5;2021-02-09;0;0;0;0;0;0;0;0;0;0;0;0;0;0;0;0;0;0
FR;5;2021-02-10;0;0;0;0;0;0;0;0;0;0;0;0;0;0;0;0;0;0
FR;5;2021-02-11;0;0;0;0;0;0;0;0;0;0;0;0;0;0;0;0;0;0
FR;5;2021-02-12;0;0;0;0;0;0;0;0;0;0;0;0;0;0;0;0;0;0
FR;5;2021-02-13;0;0;0;0;0;0;0;0;0;0;0;0;0;0;0;0;0;0
FR;5;2021-02-14;0;0;0;0;0;0;0;0;0;0;0;0;0;0;0;0;0;0
FR;5;2021-02-15;0;0;0;0;0;0;0;0;0;0;0;0;0;0;0;0;0;0
FR;5;2021-02-16;0;0;0;0;0;0;0;0;0;0;0;0;0;0;0;0;0;0
FR;5;2021-02-17;0;0;0;0;0;0;0;0;0;0;0;0;0;0;0;0;0;0
FR;5;2021-02-18;0;0;0;0;0;0;0;0;0;0;0;0;0;0;0;0;0;0
FR;5;2021-02-19;0;0;0;0;0;0;0;0;0;0;0;0;0;0;0;0;0;0
FR;5;2021-02-20;0;0;0;0;0;0;0;0;0;0;0;0;0;0;0;0;0;0
FR;5;2021-02-21;0;0;0;0;0;0;0;0;0;0;0;0;0;0;0;0;0;0
FR;5;2021-02-22;0;0;0;0;0;0;0;0;0;0;0;0;0;0;0;0;0;0
FR;5;2021-02-23;0;0;0;0;0;0;0;0;0;0;0;0;0;0;0;0;0;0
FR;5;2021-02-24;0;0;0;0;0;0;0;0;0;0;0;0;0;0;0;0;0;0
FR;5;2021-02-25;0;0;0;0;0;0;0;0;0;0;0;0;0;0;0;0;0;0
FR;5;2021-02-26;0;0;0;0;0;0;0;0;0;0;0;0;0;0;0;0;0;0
FR;5;2021-02-27;0;0;0;0;0;0;0;0;0;0;0;0;0;0;0;0;0;0
FR;5;2021-02-28;0;0;0;0;0;0;0;0;0;0;0;0;0;0;0;0;0;0
FR;5;2021-03-01;0;0;0;0;0;0;0;0;0;0;0;0;0;0;0;0;0;0
FR;5;2021-03-02;0;0;0;0;0;0;0;0;0;0;0;0;0;0;0;0;0;0
FR;5;2021-03-03;0;0;0;0;0;0;0;0;0;0;0;0;0;0;0;0;0;0
FR;5;2021-03-04;0;0;0;0;0;0;0;0;0;0;0;0;0;0;0;0;0;0
FR;5;2021-03-05;0;0;0;0;0;0;0;0;0;0;0;0;0;0;0;0;0;0
FR;5;2021-03-06;0;0;0;0;0;0;0;0;0;0;0;0;0;0;0;0;0;0
FR;5;2021-03-07;0;0;0;0;0;0;0;0;0;0;0;0;0;0;0;0;0;0
FR;5;2021-03-08;0;0;0;0;0;0;0;0;0;0;0;0;0;0;0;0;0;0
FR;5;2021-03-09;0;0;0;0;0;0;0;0;0;0;0;0;0;0;0;0;0;0
FR;5;2021-03-10;0;0;0;0;0;0;0;0;0;0;0;0;0;0;0;0;0;0
FR;5;2021-03-11;0;0;0;0;0;0;0;0;0;0;0;0;0;0;0;0;0;0
FR;5;2021-03-12;0;0;0;0;0;0;0;0;0;0;0;0;0;0;0;0;0;0
FR;5;2021-03-13;0;0;0;0;0;0;0;0;0;0;0;0;0;0;0;0;0;0
FR;5;2021-03-14;0;0;0;0;0;0;0;0;0;0;0;0;0;0;0;0;0;0
FR;5;2021-03-15;0;0;0;0;0;0;0;0;0;0;0;0;0;0;0;0;0;0
FR;5;2021-03-16;0;0;0;0;0;0;0;0;0;0;0;0;0;0;0;0;0;0
FR;5;2021-03-17;0;0;0;0;0;0;0;0;0;0;0;0;0;0;0;0;0;0
FR;5;2021-03-18;0;0;0;0;0;0;0;0;0;0;0;0;0;0;0;0;0;0
FR;5;2021-03-19;0;0;0;0;0;0;0;0;0;0;0;0;0;0;0;0;0;0
FR;5;2021-03-20;0;0;0;0;0;0;0;0;0;0;0;0;0;0;0;0;0;0
FR;5;2021-03-21;0;0;0;0;0;0;0;0;0;0;0;0;0;0;0;0;0;0
FR;5;2021-03-22;0;0;0;0;0;0;0;0;0;0;0;0;0;0;0;0;0;0
FR;5;2021-03-23;0;0;0;0;0;0;0;0;0;0;0;0;0;0;0;0;0;0
FR;5;2021-03-24;0;0;0;0;0;0;0;0;0;0;0;0;0;0;0;0;0;0
FR;5;2021-03-25;0;0;0;0;0;0;0;0;0;0;0;0;0;0;0;0;0;0
FR;5;2021-03-26;0;0;0;0;0;0;0;0;0;0;0;0;0;0;0;0;0;0
FR;5;2021-03-27;0;0;0;0;0;0;0;0;0;0;0;0;0;0;0;0;0;0
FR;5;2021-03-28;0;0;0;0;0;0;0;0;0;0;0;0;0;0;0;0;0;0
FR;5;2021-03-29;0;0;0;0;0;0;0;0;0;0;0;0;0;0;0;0;0;0
FR;5;2021-03-30;0;0;0;0;0;0;0;0;0;0;0;0;0;0;0;0;0;0
FR;5;2021-03-31;0;0;0;0;0;0;0;0;0;0;0;0;0;0;0;0;0;0
FR;5;2021-04-01;0;0;0;0;0;0;0;0;0;0;0;0;0;0;0;0;0;0
FR;5;2021-04-02;0;0;0;0;0;0;0;0;0;0;0;0;0;0;0;0;0;0
FR;5;2021-04-03;0;0;0;0;0;0;0;0;0;0;0;0;0;0;0;0;0;0
FR;5;2021-04-04;0;0;0;0;0;0;0;0;0;0;0;0;0;0;0;0;0;0
FR;5;2021-04-05;0;0;0;0;0;0;0;0;0;0;0;0;0;0;0;0;0;0
FR;5;2021-04-06;0;0;0;0;0;0;0;0;0;0;0;0;0;0;0;0;0;0
FR;5;2021-04-07;0;0;0;0;0;0;0;0;0;0;0;0;0;0;0;0;0;0
FR;5;2021-04-08;0;0;0;0;0;0;0;0;0;0;0;0;0;0;0;0;0;0
FR;5;2021-04-09;0;0;0;0;0;0;0;0;0;0;0;0;0;0;0;0;0;0
FR;5;2021-04-10;0;0;0;0;0;0;0;0;0;0;0;0;0;0;0;0;0;0
FR;5;2021-04-11;0;0;0;0;0;0;0;0;0;0;0;0;0;0;0;0;0;0
FR;5;2021-04-12;0;0;0;0;0;0;0;0;0;0;0;0;0;0;0;0;0;0
FR;5;2021-04-13;0;0;0;0;0;0;0;0;0;0;0;0;0;0;0;0;0;0
FR;5;2021-04-14;0;0;0;0;0;0;0;0;0;0;0;0;0;0;0;0;0;0
FR;5;2021-04-15;0;0;0;0;0;0;0;0;0;0;0;0;0;0;0;0;0;0
FR;5;2021-04-16;0;0;0;0;0;0;0;0;0;0;0;0;0;0;0;0;0;0
FR;5;2021-04-17;0;0;0;0;0;0;0;0;0;0;0;0;0;0;0;0;0;0
FR;5;2021-04-18;0;0;0;0;0;0;0;0;0;0;0;0;0;0;0;0;0;0
FR;5;2021-04-19;0;0;0;0;0;0;0;0;0;0;0;0;0;0;0;0;0;0
FR;5;2021-04-20;0;0;0;0;0;0;0;0;0;0;0;0;0;0;0;0;0;0
FR;5;2021-04-21;0;0;0;0;0;0;0;0;0;0;0;0;0;0;0;0;0;0
FR;5;2021-04-22;0;0;0;0;0;0;0;0;0;0;0;0;0;0;0;0;0;0
FR;5;2021-04-23;0;0;0;0;0;0;0;0;0;0;0;0;0;0;0;0;0;0
FR;5;2021-04-24;0;0;0;0;0;0;0;0;0;0;0;0;0;0;0;0;0;0
FR;5;2021-04-25;0;0;0;0;0;0;0;0;0;0;0;0;0;0;0;0;0;0
FR;5;2021-04-26;0;0;0;0;0;0;0;0;0;0;0;0;0;0;0;0;0;0
FR;5;2021-04-27;0;0;0;0;0;0;0;0;0;0;0;0;0;0;0;0;0;0
FR;5;2021-04-28;0;0;0;0;0;0;0;0;0;0;0;0;0;0;0;0;0;0
FR;5;2021-04-29;0;0;0;0;0;0;0;0;0;0;0;0;0;0;0;0;0;0
FR;5;2021-04-30;0;0;0;0;0;0;0;0;0;0;0;0;0;0;0;0;0;0
FR;5;2021-05-01;0;0;0;0;0;0;0;0;0;0;0;0;0;0;0;0;0;0
FR;5;2021-05-02;0;0;0;0;0;0;0;0;0;0;0;0;0;0;0;0;0;0
FR;5;2021-05-03;0;0;0;0;0;0;0;0;0;0;0;0;0;0;0;0;0;0
FR;5;2021-05-04;0;0;0;0;0;0;0;0;0;0;0;0;0;0;0;0;0;0
FR;5;2021-05-05;0;0;0;0;0;0;0;0;0;0;0;0;0;0;0;0;0;0
FR;5;2021-05-06;0;0;0;0;0;0;0;0;0;0;0;0;0;0;0;0;0;0
FR;5;2021-05-07;0;0;0;0;0;0;0;0;0;0;0;0;0;0;0;0;0;0
FR;5;2021-05-08;0;0;0;0;0;0;0;0;0;0;0;0;0;0;0;0;0;0
FR;5;2021-05-09;0;0;0;0;0;0;0;0;0;0;0;0;0;0;0;0;0;0
FR;5;2021-05-10;0;0;0;0;0;0;0;0;0;0;0;0;0;0;0;0;0;0
FR;5;2021-05-11;0;0;0;0;0;0;0;0;0;0;0;0;0;0;0;0;0;0
FR;5;2021-05-12;0;0;0;0;0;0;0;0;0;0;0;0;0;0;0;0;0;0
FR;5;2021-05-13;0;0;0;0;0;0;0;0;0;0;0;0;0;0;0;0;0;0
FR;5;2021-05-14;0;0;0;0;0;0;0;0;0;0;0;0;0;0;0;0;0;0
FR;5;2021-05-15;0;0;0;0;0;0;0;0;0;0;0;0;0;0;0;0;0;0
FR;5;2021-05-16;0;0;0;0;0;0;0;0;0;0;0;0;0;0;0;0;0;0
FR;5;2021-05-17;0;0;0;0;0;0;0;0;0;0;0;0;0;0;0;0;0;0
FR;5;2021-05-18;0;0;0;0;0;0;0;0;0;0;0;0;0;0;0;0;0;0
FR;5;2021-05-19;0;0;0;0;0;0;0;0;0;0;0;0;0;0;0;0;0;0
FR;5;2021-05-20;0;0;0;0;0;0;0;0;0;0;0;0;0;0;0;0;0;0
FR;5;2021-05-21;0;0;0;0;0;0;0;0;0;0;0;0;0;0;0;0;0;0
FR;5;2021-05-22;0;0;0;0;0;0;0;0;0;0;0;0;0;0;0;0;0;0
FR;5;2021-05-23;0;0;0;0;0;0;0;0;0;0;0;0;0;0;0;0;0;0
FR;5;2021-05-24;0;0;0;0;0;0;0;0;0;0;0;0;0;0;0;0;0;0
FR;5;2021-05-25;0;0;0;0;0;0;0;0;0;0;0;0;0;0;0;0;0;0
FR;5;2021-05-26;0;0;0;0;0;0;0;0;0;0;0;0;0;0;0;0;0;0
FR;5;2021-05-27;0;0;0;0;0;0;0;0;0;0;0;0;0;0;0;0;0;0
FR;5;2021-05-28;0;0;0;0;0;0;0;0;0;0;0;0;0;0;0;0;0;0
FR;5;2021-05-29;0;0;0;0;0;0;0;0;0;0;0;0;0;0;0;0;0;0
FR;5;2021-05-30;0;0;0;0;0;0;0;0;0;0;0;0;0;0;0;0;0;0
FR;5;2021-05-31;0;0;0;0;0;0;0;0;0;0;0;0;0;0;0;0;0;0
FR;5;2021-06-01;0;0;0;0;0;0;0;0;0;0;0;0;0;0;0;0;0;0
FR;5;2021-06-02;0;0;0;0;0;0;0;0;0;0;0;0;0;0;0;0;0;0
FR;5;2021-06-03;0;0;0;0;0;0;0;0;0;0;0;0;0;0;0;0;0;0
FR;5;2021-06-04;0;0;0;0;0;0;0;0;0;0;0;0;0;0;0;0;0;0
FR;5;2021-06-05;0;0;0;0;0;0;0;0;0;0;0;0;0;0;0;0;0;0
FR;5;2021-06-06;0;0;0;0;0;0;0;0;0;0;0;0;0;0;0;0;0;0
FR;5;2021-06-07;0;0;0;0;0;0;0;0;0;0;0;0;0;0;0;0;0;0
FR;5;2021-06-08;0;0;0;0;0;0;0;0;0;0;0;0;0;0;0;0;0;0
FR;5;2021-06-09;0;0;0;0;0;0;0;0;0;0;0;0;0;0;0;0;0;0
FR;5;2021-06-10;0;0;0;0;0;0;0;0;0;0;0;0;0;0;0;0;0;0
FR;5;2021-06-11;0;0;0;0;0;0;0;0;0;0;0;0;0;0;0;0;0;0
FR;5;2021-06-12;0;0;0;0;0;0;0;0;0;0;0;0;0;0;0;0;0;0
FR;5;2021-06-13;0;0;0;0;0;0;0;0;0;0;0;0;0;0;0;0;0;0
FR;5;2021-06-14;0;0;0;0;0;0;0;0;0;0;0;0;0;0;0;0;0;0
FR;5;2021-06-15;0;0;0;0;0;0;0;0;0;0;0;0;0;0;0;0;0;0
FR;5;2021-06-16;0;0;0;0;0;0;0;0;0;0;0;0;0;0;0;0;0;0
FR;5;2021-06-17;0;0;0;0;0;0;0;0;0;0;0;0;0;0;0;0;0;0
FR;5;2021-06-18;0;0;0;0;0;0;0;0;0;0;0;0;0;0;0;0;0;0
FR;5;2021-06-19;0;0;0;0;0;0;0;0;0;0;0;0;0;0;0;0;0;0
FR;5;2021-06-20;0;0;0;0;0;0;0;0;0;0;0;0;0;0;0;0;0;0
FR;5;2021-06-21;0;0;0;0;0;0;0;0;0;0;0;0;0;0;0;0;0;0
FR;5;2021-06-22;0;0;0;0;0;0;0;0;0;0;0;0;0;0;0;0;0;0
FR;5;2021-06-23;0;0;0;0;0;0;0;0;0;0;0;0;0;0;0;0;0;0
FR;5;2021-06-24;0;0;0;0;0;0;0;0;0;0;0;0;0;0;0;0;0;0
FR;5;2021-06-25;0;0;0;0;0;0;0;0;0;0;0;0;0;0;0;0;0;0
FR;5;2021-06-26;0;0;0;0;0;0;0;0;0;0;0;0;0;0;0;0;0;0
FR;5;2021-06-27;0;0;0;0;0;0;0;0;0;0;0;0;0;0;0;0;0;0
FR;5;2021-06-28;0;0;0;0;0;0;0;0;0;0;0;0;0;0;0;0;0;0
FR;5;2021-06-29;0;0;0;0;0;0;0;0;0;0;0;0;0;0;0;0;0;0
FR;5;2021-06-30;0;0;0;0;0;0;0;0;0;0;0;0;0;0;0;0;0;0
FR;5;2021-07-01;0;0;0;0;0;0;0;0;0;0;0;0;0;0;0;0;0;0
FR;5;2021-07-02;0;0;0;0;0;0;0;0;0;0;0;0;0;0;0;0;0;0
FR;5;2021-07-03;0;0;0;0;0;0;0;0;0;0;0;0;0;0;0;0;0;0
FR;5;2021-07-04;0;0;0;0;0;0;0;0;0;0;0;0;0;0;0;0;0;0
FR;5;2021-07-05;0;0;0;0;0;0;0;0;0;0;0;0;0;0;0;0;0;0
FR;5;2021-07-06;0;0;0;0;0;0;0;0;0;0;0;0;0;0;0;0;0;0
FR;5;2021-07-07;0;0;0;0;0;0;0;0;0;0;0;0;0;0;0;0;0;0
FR;5;2021-07-08;0;0;0;0;0;0;0;0;0;0;0;0;0;0;0;0;0;0
FR;5;2021-07-09;0;0;0;0;0;0;0;0;0;0;0;0;0;0;0;0;0;0
FR;5;2021-07-10;0;0;0;0;0;0;0;0;0;0;0;0;0;0;0;0;0;0
FR;5;2021-07-11;0;0;0;0;0;0;0;0;0;0;0;0;0;0;0;0;0;0
FR;5;2021-07-12;0;0;0;0;0;0;0;0;0;0;0;0;0;0;0;0;0;0
FR;5;2021-07-13;0;0;0;0;0;0;0;0;0;0;0;0;0;0;0;0;0;0
FR;5;2021-07-14;0;0;0;0;0;0;0;0;0;0;0;0;0;0;0;0;0;0
FR;5;2021-07-15;0;0;0;0;0;0;0;0;0;0;0;0;0;0;0;0;0;0
FR;5;2021-07-16;0;0;0;0;0;0;0;0;0;0;0;0;0;0;0;0;0;0
FR;5;2021-07-17;0;0;0;0;0;0;0;0;0;0;0;0;0;0;0;0;0;0
FR;5;2021-07-18;0;0;0;0;0;0;0;0;0;0;0;0;0;0;0;0;0;0
FR;5;2021-07-19;0;0;0;0;0;0;0;0;0;0;0;0;0;0;0;0;0;0
FR;5;2021-07-20;0;0;0;0;0;0;0;0;0;0;0;0;0;0;0;0;0;0
FR;5;2021-07-21;0;0;0;0;0;0;0;0;0;0;0;0;0;0;0;0;0;0
FR;5;2021-07-22;0;0;0;0;0;0;0;0;0;0;0;0;0;0;0;0;0;0
FR;5;2021-07-23;0;0;0;0;0;0;0;0;0;0;0;0;0;0;0;0;0;0
FR;5;2021-07-24;0;0;0;0;0;0;0;0;0;0;0;0;0;0;0;0;0;0
FR;5;2021-07-25;0;0;0;0;0;0;0;0;0;0;0;0;0;0;0;0;0;0
FR;5;2021-07-26;0;0;0;0;0;0;0;0;0;0;0;0;0;0;0;0;0;0
FR;5;2021-07-27;0;0;0;0;0;0;0;0;0;0;0;0;0;0;0;0;0;0
FR;5;2021-07-28;0;0;0;0;0;0;0;0;0;0;0;0;0;0;0;0;0;0
FR;5;2021-07-29;0;0;0;0;0;0;0;0;0;0;0;0;0;0;0;0;0;0
FR;5;2021-07-30;0;0;0;0;0;0;0;0;0;0;0;0;0;0;0;0;0;0
FR;5;2021-07-31;0;0;0;0;0;0;0;0;0;0;0;0;0;0;0;0;0;0
FR;5;2021-08-01;0;0;0;0;0;0;0;0;0;0;0;0;0;0;0;0;0;0
FR;5;2021-08-02;0;0;0;0;0;0;0;0;0;0;0;0;0;0;0;0;0;0
FR;5;2021-08-03;0;0;0;0;0;0;0;0;0;0;0;0;0;0;0;0;0;0
FR;5;2021-08-04;0;0;0;0;0;0;0;0;0;0;0;0;0;0;0;0;0;0
FR;5;2021-08-05;0;0;0;0;0;0;0;0;0;0;0;0;0;0;0;0;0;0
FR;5;2021-08-06;0;0;0;0;0;0;0;0;0;0;0;0;0;0;0;0;0;0
FR;5;2021-08-07;0;0;0;0;0;0;0;0;0;0;0;0;0;0;0;0;0;0
FR;5;2021-08-08;0;0;0;0;0;0;0;0;0;0;0;0;0;0;0;0;0;0
FR;5;2021-08-09;0;0;0;0;0;0;0;0;0;0;0;0;0;0;0;0;0;0
FR;5;2021-08-10;0;0;0;0;0;0;0;0;0;0;0;0;0;0;0;0;0;0
FR;5;2021-08-11;0;0;0;0;0;0;0;0;0;0;0;0;0;0;0;0;0;0
FR;5;2021-08-12;0;0;0;0;0;0;0;0;0;0;0;0;0;0;0;0;0;0
FR;5;2021-08-13;0;0;0;0;0;0;0;0;0;0;0;0;0;0;0;0;0;0
FR;5;2021-08-14;0;0;0;0;0;0;0;0;0;0;0;0;0;0;0;0;0;0
FR;5;2021-08-15;0;0;0;0;0;0;0;0;0;0;0;0;0;0;0;0;0;0
FR;5;2021-08-16;0;0;0;0;0;0;0;0;0;0;0;0;0;0;0;0;0;0
FR;5;2021-08-17;0;0;0;0;0;0;0;0;0;0;0;0;0;0;0;0;0;0
FR;5;2021-08-18;0;0;0;0;0;0;0;0;0;0;0;0;0;0;0;0;0;0
FR;5;2021-08-19;0;0;0;0;0;0;0;0;0;0;0;0;0;0;0;0;0;0
FR;5;2021-08-20;0;0;0;0;0;0;0;0;0;0;0;0;0;0;0;0;0;0
FR;5;2021-08-21;0;0;0;0;0;0;0;0;0;0;0;0;0;0;0;0;0;0
FR;5;2021-08-22;0;0;0;0;0;0;0;0;0;0;0;0;0;0;0;0;0;0
FR;5;2021-08-23;0;0;0;0;0;0;0;0;0;0;0;0;0;0;0;0;0;0
FR;5;2021-08-24;0;0;0;0;0;0;0;0;0;0;0;0;0;0;0;0;0;0
FR;5;2021-08-25;0;0;0;0;0;0;0;0;0;0;0;0;0;0;0;0;0;0
FR;5;2021-08-26;0;0;0;0;0;0;0;0;0;0;0;0;0;0;0;0;0;0
FR;5;2021-08-27;0;0;0;0;0;0;0;0;0;0;0;0;0;0;0;0;0;0
FR;5;2021-08-28;0;0;0;0;0;0;0;0;0;0;0;0;0;0;0;0;0;0
FR;5;2021-08-29;0;0;0;0;0;0;0;0;0;0;0;0;0;0;0;0;0;0
FR;5;2021-08-30;0;0;0;0;0;0;0;0;0;0;0;0;0;0;0;0;0;0
FR;5;2021-08-31;0;0;0;0;0;0;0;0;0;0;0;0;0;0;0;0;0;0
FR;5;2021-09-01;0;0;0;0;0;0;0;0;0;0;0;0;0;0;0;0;0;0
FR;5;2021-09-02;0;0;0;0;0;0;0;0;0;0;0;0;0;0;0;0;0;0
FR;5;2021-09-03;0;0;0;0;0;0;0;0;0;0;0;0;0;0;0;0;0;0
FR;5;2021-09-04;0;0;0;0;0;0;0;0;0;0;0;0;0;0;0;0;0;0
FR;5;2021-09-05;0;0;0;0;0;0;0;0;0;0;0;0;0;0;0;0;0;0
FR;5;2021-09-06;0;0;0;0;0;0;0;0;0;0;0;0;0;0;0;0;0;0
FR;5;2021-09-07;0;0;0;0;0;0;0;0;0;0;0;0;0;0;0;0;0;0
FR;5;2021-09-08;0;0;0;0;0;0;0;0;0;0;0;0;0;0;0;0;0;0
FR;5;2021-09-09;0;0;0;0;0;0;0;0;0;0;0;0;0;0;0;0;0;0
FR;5;2021-09-10;0;0;0;0;0;0;0;0;0;0;0;0;0;0;0;0;0;0
FR;5;2021-09-11;0;0;0;0;0;0;0;0;0;0;0;0;0;0;0;0;0;0
FR;5;2021-09-12;0;0;0;0;0;0;0;0;0;0;0;0;0;0;0;0;0;0
FR;5;2021-09-13;0;0;0;0;0;0;0;0;0;0;0;0;0;0;0;0;0;0
FR;5;2021-09-14;0;0;0;0;0;0;0;0;0;0;0;0;0;0;0;0;0;0
FR;5;2021-09-15;0;0;0;0;0;0;0;0;0;0;0;0;0;0;0;0;0;0
FR;5;2021-09-16;0;0;0;0;0;0;0;0;0;0;0;0;0;0;0;0;0;0
FR;5;2021-09-17;0;0;0;0;0;0;0;0;0;0;0;0;0;0;0;0;0;0
FR;5;2021-09-18;0;0;0;0;0;0;0;0;0;0;0;0;0;0;0;0;0;0
FR;5;2021-09-19;0;0;0;0;0;0;0;0;0;0;0;0;0;0;0;0;0;0
FR;5;2021-09-20;0;0;0;0;0;0;0;0;0;0;0;0;0;0;0;0;0;0
FR;5;2021-09-21;0;0;0;0;0;0;0;0;0;0;0;0;0;0;0;0;0;0
FR;5;2021-09-22;0;0;0;0;0;0;0;0;0;0;0;0;0;0;0;0;0;0
FR;5;2021-09-23;0;0;0;0;0;0;0;0;0;0;0;0;0;0;0;0;0;0
FR;5;2021-09-24;0;0;0;0;0;0;0;0;0;0;0;0;0;0;0;0;0;0
FR;5;2021-09-25;0;0;0;0;0;0;0;0;0;0;0;0;0;0;0;0;0;0
FR;5;2021-09-26;0;0;0;0;0;0;0;0;0;0;0;0;0;0;0;0;0;0
FR;5;2021-09-27;0;0;0;0;0;0;0;0;0;0;0;0;0;0;0;0;0;0
FR;5;2021-09-28;0;0;0;0;0;0;0;0;0;0;0;0;0;0;0;0;0;0
FR;5;2021-09-29;0;0;0;0;0;0;0;0;0;0;0;0;0;0;0;0;0;0
FR;5;2021-09-30;0;0;0;0;0;0;0;0;0;0;0;0;0;0;0;0;0;0
FR;5;2021-10-01;0;0;0;0;0;0;0;0;0;0;0;0;0;0;0;0;0;0
FR;5;2021-10-02;0;0;0;0;0;0;0;0;0;0;0;0;0;0;0;0;0;0
FR;5;2021-10-03;0;0;0;0;0;0;0;0;0;0;0;0;0;0;0;0;0;0
FR;5;2021-10-04;0;0;0;0;0;0;0;0;0;0;0;0;0;0;0;0;0;0
FR;5;2021-10-05;0;0;0;0;0;0;0;0;0;0;0;0;0;0;0;0;0;0
FR;5;2021-10-06;0;0;0;0;0;0;0;0;0;0;0;0;0;0;0;0;0;0
FR;5;2021-10-07;0;0;0;0;0;0;0;0;0;0;0;0;0;0;0;0;0;0
FR;5;2021-10-08;0;0;0;0;0;0;0;0;0;0;0;0;0;0;0;0;0;0
FR;5;2021-10-09;0;0;0;0;0;0;0;0;0;0;0;0;0;0;0;0;0;0
FR;5;2021-10-10;0;0;0;0;0;0;0;0;0;0;0;0;0;0;0;0;0;0
FR;5;2021-10-11;0;0;0;0;0;0;0;0;0;0;0;0;0;0;0;0;0;0
FR;5;2021-10-12;0;0;0;0;0;0;0;0;0;0;0;0;0;0;0;0;0;0
FR;5;2021-10-13;0;0;0;0;0;0;0;0;0;0;0;0;0;0;0;0;0;0
FR;5;2021-10-14;0;0;0;0;0;0;0;0;0;0;0;0;0;0;0;0;0;0
FR;5;2021-10-15;0;0;0;0;0;0;0;0;0;0;0;0;0;0;0;0;0;0
FR;5;2021-10-16;0;0;0;0;0;0;0;0;0;0;0;0;0;0;0;0;0;0
FR;5;2021-10-17;0;0;0;0;0;0;0;0;0;0;0;0;0;0;0;0;0;0
FR;5;2021-10-18;0;0;0;0;0;0;0;0;0;0;0;0;0;0;0;0;0;0
FR;5;2021-10-19;0;0;0;0;0;0;0;0;0;0;0;0;0;0;0;0;0;0
FR;5;2021-10-20;0;0;0;0;0;0;0;0;0;0;0;0;0;0;0;0;0;0
FR;5;2021-10-21;0;0;0;0;0;0;0;0;0;0;0;0;0;0;0;0;0;0
FR;5;2021-10-22;0;0;0;0;0;0;0;0;0;0;0;0;0;0;0;0;0;0
FR;5;2021-10-23;0;0;0;0;0;0;0;0;0;0;0;0;0;0;0;0;0;0
FR;5;2021-10-24;0;0;0;0;0;0;0;0;0;0;0;0;0;0;0;0;0;0
FR;5;2021-10-25;0;0;0;0;0;0;0;0;0;0;0;0;0;0;0;0;0;0
FR;5;2021-10-26;0;0;0;0;0;0;0;0;0;0;0;0;0;0;0;0;0;0
FR;5;2021-10-27;0;0;0;0;0;0;0;0;0;0;0;0;0;0;0;0;0;0
FR;5;2021-10-28;0;0;0;0;0;0;0;0;0;0;0;0;0;0;0;0;0;0
FR;5;2021-10-29;0;0;0;0;0;0;0;0;0;0;0;0;0;0;0;0;0;0
FR;5;2021-10-30;0;0;0;0;0;0;0;0;0;0;0;0;0;0;0;0;0;0
FR;5;2021-10-31;0;0;0;0;0;0;0;0;0;0;0;0;0;0;0;0;0;0
FR;5;2021-11-01;0;0;0;0;0;0;0;0;0;0;0;0;0;0;0;0;0;0
FR;5;2021-11-02;0;0;0;0;0;0;0;0;0;0;0;0;0;0;0;0;0;0
FR;5;2021-11-03;0;0;0;0;0;0;0;0;0;0;0;0;0;0;0;0;0;0
FR;5;2021-11-04;0;0;0;0;0;0;0;0;0;0;0;0;0;0;0;0;0;0
FR;5;2021-11-05;0;0;0;0;0;0;0;0;0;0;0;0;0;0;0;0;0;0
FR;5;2021-11-06;0;0;0;0;0;0;0;0;0;0;0;0;0;0;0;0;0;0
FR;5;2021-11-07;0;0;0;0;0;0;0;0;0;0;0;0;0;0;0;0;0;0
FR;5;2021-11-08;0;0;0;0;0;0;0;0;0;0;0;0;0;0;0;0;0;0
FR;5;2021-11-09;0;0;0;0;0;0;0;0;0;0;0;0;0;0;0;0;0;0
FR;5;2021-11-10;0;0;0;0;0;0;0;0;0;0;0;0;0;0;0;0;0;0
FR;5;2021-11-11;0;0;0;0;0;0;0;0;0;0;0;0;0;0;0;0;0;0
FR;5;2021-11-12;0;0;0;0;0;0;0;0;0;0;0;0;0;0;0;0;0;0
FR;5;2021-11-13;0;0;0;0;0;0;0;0;0;0;0;0;0;0;0;0;0;0
FR;5;2021-11-14;0;0;0;0;0;0;0;0;0;0;0;0;0;0;0;0;0;0
FR;5;2021-11-15;0;0;0;0;0;0;0;0;0;0;0;0;0;0;0;0;0;0
FR;5;2021-11-16;0;0;0;0;0;0;0;0;0;0;0;0;0;0;0;0;0;0
FR;5;2021-11-17;0;0;0;0;0;0;0;0;0;0;0;0;0;0;0;0;0;0
FR;5;2021-11-18;0;0;0;0;0;0;0;0;0;0;0;0;0;0;0;0;0;0
FR;5;2021-11-19;0;0;0;0;0;0;0;0;0;0;0;0;0;0;0;0;0;0
FR;5;2021-11-20;0;0;0;0;0;0;0;0;0;0;0;0;0;0;0;0;0;0
FR;5;2021-11-21;0;0;0;0;0;0;0;0;0;0;0;0;0;0;0;0;0;0
FR;5;2021-11-22;0;0;0;0;0;0;0;0;0;0;0;0;0;0;0;0;0;0
FR;5;2021-11-23;0;0;0;0;0;0;0;0;0;0;0;0;0;0;0;0;0;0
FR;5;2021-11-24;0;0;0;0;0;0;0;0;0;0;0;0;0;0;0;0;0;0
FR;5;2021-11-25;0;0;0;0;0;0;0;0;0;0;0;0;0;0;0;0;0;0
FR;5;2021-11-26;0;0;0;0;0;0;0;0;0;0;0;0;0;0;0;0;0;0
FR;5;2021-11-27;0;0;0;0;0;0;0;0;0;0;0;0;0;0;0;0;0;0
FR;5;2021-11-28;0;0;0;0;0;0;0;0;0;0;0;0;0;0;0;0;0;0
FR;5;2021-11-29;0;0;0;0;0;0;0;0;0;0;0;0;0;0;0;0;0;0
FR;5;2021-11-30;0;0;0;0;0;0;0;0;0;0;0;0;0;0;0;0;0;0
FR;5;2021-12-01;0;0;0;0;0;0;0;0;0;0;0;0;0;0;0;0;0;0
FR;5;2021-12-02;0;0;0;0;0;0;0;0;0;0;0;0;0;0;0;0;0;0
FR;5;2021-12-03;0;0;0;0;0;0;0;0;0;0;0;0;0;0;0;0;0;0
FR;5;2021-12-04;0;0;0;0;0;0;0;0;0;0;0;0;0;0;0;0;0;0
FR;5;2021-12-05;0;0;0;0;0;0;0;0;0;0;0;0;0;0;0;0;0;0
FR;5;2021-12-06;0;0;0;0;0;0;0;0;0;0;0;0;0;0;0;0;0;0
FR;5;2021-12-07;0;0;0;0;0;0;0;0;0;0;0;0;0;0;0;0;0;0
FR;5;2021-12-08;0;0;0;0;0;0;0;0;0;0;0;0;0;0;0;0;0;0
FR;5;2021-12-09;0;0;0;0;0;0;0;0;0;0;0;0;0;0;0;0;0;0
FR;5;2021-12-10;0;0;0;0;0;0;0;0;0;0;0;0;0;0;0;0;0;0
FR;5;2021-12-11;0;0;0;0;0;0;0;0;0;0;0;0;0;0;0;0;0;0
FR;5;2021-12-12;0;0;0;0;0;0;0;0;0;0;0;0;0;0;0;0;0;0
FR;5;2021-12-13;0;0;0;0;0;0;0;0;0;0;0;0;0;0;0;0;0;0
FR;5;2021-12-14;33;45;77;0;27;88;1;0;0;33;45;77;0;27;88;1;0;0
FR;5;2021-12-15;196;44;37;0;42;49;0;0;0;229;89;114;0;69;137;1;0;0
FR;5;2021-12-16;181;21;44;0;38;48;0;0;0;410;110;158;0;107;185;1;0;0
FR;5;2021-12-17;313;16;72;0;34;74;2;0;0;723;126;230;0;141;259;3;0;0
FR;5;2021-12-18;766;24;22;0;67;29;0;0;0;1489;150;252;0;208;288;3;0;0
FR;5;2021-12-19;585;15;15;0;67;17;0;0;0;2074;165;267;0;275;305;3;0;0
FR;5;2021-12-20;1225;31;34;0;134;37;2;0;0;3299;196;301;0;409;342;5;0;0
FR;5;2021-12-21;1535;22;54;1;141;60;0;0;0;4834;218;355;1;550;402;5;0;0
FR;5;2021-12-22;4069;40;37;0;420;46;2;0;0;8903;258;392;1;970;448;7;0;0
FR;5;2021-12-23;3043;16;21;0;305;25;0;0;0;11946;274;413;1;1275;473;7;0;0
FR;5;2021-12-24;761;18;9;0;103;14;0;0;0;12707;292;422;1;1378;487;7;0;0
FR;5;2021-12-25;61;5;2;0;9;3;0;0;0;12768;297;424;1;1387;490;7;0;0
FR;5;2021-12-26;623;6;3;0;101;4;0;0;0;13391;303;427;1;1488;494;7;0;0
FR;5;2021-12-27;4085;25;21;0;458;23;1;0;0;17476;328;448;1;1946;517;8;0;0
FR;5;2021-12-28;5204;23;41;1;513;43;2;0;0;22680;351;489;2;2459;560;10;0;0
FR;5;2021-12-29;8105;34;66;1;886;69;0;0;0;30785;385;555;3;3345;629;10;0;0
FR;5;2021-12-30;5173;18;33;0;525;39;0;0;0;35958;403;588;3;3870;668;10;0;0
FR;5;2021-12-31;1554;8;10;0;182;11;0;0;0;37512;411;598;3;4052;679;10;0;0
FR;5;2022-01-01;186;2;2;0;24;3;0;0;0;37698;413;600;3;4076;682;10;0;0
FR;5;2022-01-02;1489;1;1;0;152;1;0;0;0;39187;414;601;3;4228;683;10;0;0
FR;5;2022-01-03;3068;36;34;0;322;33;1;0;0;42255;450;635;3;4550;716;11;0;0
FR;5;2022-01-04;3034;39;33;0;321;42;3;0;0;45289;489;668;3;4871;758;14;0;0
FR;5;2022-01-05;19324;203;97;1;2114;108;0;0;0;64613;692;765;4;6985;866;14;0;0
FR;5;2022-01-06;3748;134;122;0;507;142;2;0;0;68361;826;887;4;7492;1008;16;0;0
FR;5;2022-01-07;5006;202;48;2;704;56;1;0;0;73367;1028;935;6;8196;1064;17;0;0
FR;5;2022-01-08;13659;514;45;0;2003;52;0;0;0;87026;1542;980;6;10199;1116;17;0;0
FR;5;2022-01-09;5754;399;15;0;1112;20;1;0;0;92780;1941;995;6;11311;1136;18;0;0
FR;5;2022-01-10;3455;326;25;0;734;29;0;0;0;96235;2267;1020;6;12045;1165;18;0;0
FR;5;2022-01-11;3671;283;38;0;661;41;1;0;0;99906;2550;1058;6;12706;1206;19;0;0
FR;5;2022-01-12;22650;3005;89;0;5297;112;2;0;0;122556;5555;1147;6;18003;1318;21;0;0
FR;5;2022-01-13;4039;623;29;0;1051;31;2;0;0;126595;6178;1176;6;19054;1349;23;0;0
FR;5;2022-01-14;4843;583;45;0;1115;52;1;0;0;131438;6761;1221;6;20169;1401;24;0;0
FR;5;2022-01-15;14686;1747;38;3;3376;49;3;0;0;146124;8508;1259;9;23545;1450;27;0;0
FR;5;2022-01-16;4728;666;3;0;1261;5;0;0;0;150852;9174;1262;9;24806;1455;27;0;0
FR;5;2022-01-17;2297;718;26;0;986;29;0;0;0;153149;9892;1288;9;25792;1484;27;0;0
FR;5;2022-01-18;2431;870;30;0;1141;40;0;0;0;155580;10762;1318;9;26933;1524;27;0;0
FR;5;2022-01-19;18484;6423;74;2;8366;142;3;0;0;174064;17185;1392;11;35299;1666;30;0;0
FR;5;2022-01-20;1920;1067;25;0;1295;34;2;0;0;175984;18252;1417;11;36594;1700;32;0;0
FR;5;2022-01-21;3077;1372;47;1;1677;59;2;0;0;179061;19624;1464;12;38271;1759;34;0;0
FR;5;2022-01-22;10720;3454;33;1;4671;43;1;0;0;189781;23078;1497;13;42942;1802;35;0;0
FR;5;2022-01-23;2629;1415;6;0;1789;10;0;0;0;192410;24493;1503;13;44731;1812;35;0;0
FR;5;2022-01-24;1161;1340;19;0;1446;23;1;0;0;193571;25833;1522;13;46177;1835;36;0;0
FR;5;2022-01-25;1220;1549;20;2;1683;31;3;0;0;194791;27382;1542;15;47860;1866;39;0;0
FR;5;2022-01-26;10748;12032;50;1;13300;89;1;0;1;205539;39414;1592;16;61160;1955;40;0;1
FR;5;2022-01-27;1291;1693;10;0;1838;17;0;0;0;206830;41107;1602;16;62998;1972;40;0;1
FR;5;2022-01-28;1698;3346;16;0;3566;19;1;0;0;208528;44453;1618;16;66564;1991;41;0;1
FR;5;2022-01-29;6241;8041;68;0;8855;96;2;0;0;214769;52494;1686;16;75419;2087;43;0;1
FR;5;2022-01-30;1509;2950;5;0;3185;18;0;0;0;216278;55444;1691;16;78604;2105;43;0;1
FR;5;2022-01-31;589;1773;23;0;1837;24;3;0;0;216867;57217;1714;16;80441;2129;46;0;1
FR;5;2022-02-01;712;1706;10;0;1791;15;0;0;0;217579;58923;1724;16;82232;2144;46;0;1
FR;5;2022-02-02;6959;15655;52;0;16603;94;0;0;0;224538;74578;1776;16;98835;2238;46;0;1
FR;5;2022-02-03;492;1691;14;0;1748;13;5;0;0;225030;76269;1790;16;100583;2251;51;0;1
FR;5;2022-02-04;945;3002;19;0;3123;31;0;0;0;225975;79271;1809;16;103706;2282;51;0;1
FR;5;2022-02-05;3536;8919;23;0;9517;37;0;0;0;229511;88190;1832;16;113223;2319;51;0;1
FR;5;2022-02-06;737;2398;10;0;2556;19;0;0;0;230248;90588;1842;16;115779;2338;51;0;1
FR;5;2022-02-07;884;1596;23;0;1715;25;2;0;0;231132;92184;1865;16;117494;2363;53;0;1
FR;5;2022-02-08;725;1287;18;0;1407;20;2;0;0;231857;93471;1883;16;118901;2383;55;0;1
FR;5;2022-02-09;4544;12880;44;0;13608;76;1;0;0;236401;106351;1927;16;132509;2459;56;0;1
FR;5;2022-02-10;646;1059;14;0;1166;15;0;0;0;237047;107410;1941;16;133675;2474;56;0;1
FR;5;2022-02-11;793;2032;16;0;2163;21;1;0;0;237840;109442;1957;16;135838;2495;57;0;1
FR;5;2022-02-12;2286;6812;33;0;7279;53;0;0;0;240126;116254;1990;16;143117;2548;57;0;1
FR;5;2022-02-13;464;1541;8;0;1654;8;1;0;0;240590;117795;1998;16;144771;2556;58;0;1
FR;5;2022-02-14;678;1288;10;0;1407;13;1;0;0;241268;119083;2008;16;146178;2569;59;0;1
FR;5;2022-02-15;482;886;9;0;968;14;1;0;0;241750;119969;2017;16;147146;2583;60;0;1
FR;5;2022-02-16;2980;9124;41;1;9676;58;2;0;0;244730;129093;2058;17;156822;2641;62;0;1
FR;5;2022-02-17;436;809;6;0;876;7;1;0;0;245166;129902;2064;17;157698;2648;63;0;1
FR;5;2022-02-18;649;1408;13;0;1535;17;0;0;0;245815;131310;2077;17;159233;2665;63;0;1
FR;5;2022-02-19;1373;4315;16;0;4623;28;0;0;0;247188;135625;2093;17;163856;2693;63;0;1
FR;5;2022-02-20;247;879;6;0;941;8;0;0;0;247435;136504;2099;17;164797;2701;63;0;1
FR;5;2022-02-21;221;607;2;0;661;4;1;0;0;247656;137111;2101;17;165458;2705;64;0;1
FR;5;2022-02-22;262;545;17;0;591;17;1;0;0;247918;137656;2118;17;166049;2722;65;0;1
FR;5;2022-02-23;1909;6926;23;1;7346;43;0;0;0;249827;144582;2141;18;173395;2765;65;0;1
FR;5;2022-02-24;182;374;6;1;421;7;1;0;0;250009;144956;2147;19;173816;2772;66;0;1
FR;5;2022-02-25;336;951;13;0;1028;12;2;0;0;250345;145907;2160;19;174844;2784;68;0;1
FR;5;2022-02-26;972;3071;11;0;3333;15;2;0;0;251317;148978;2171;19;178177;2799;70;0;1
FR;5;2022-02-27;151;506;0;0;549;3;0;0;0;251468;149484;2171;19;178726;2802;70;0;1
FR;5;2022-02-28;162;369;1;0;408;1;0;0;0;251630;149853;2172;19;179134;2803;70;0;1
FR;5;2022-03-01;130;280;6;0;315;7;1;0;0;251760;150133;2178;19;179449;2810;71;0;1
FR;5;2022-03-02;1242;4156;28;3;4497;40;3;0;0;253002;154289;2206;22;183946;2850;74;0;1
FR;5;2022-03-03;121;251;5;0;271;10;1;0;0;253123;154540;2211;22;184217;2860;75;0;1
FR;5;2022-03-04;197;488;13;0;538;14;2;0;0;253320;155028;2224;22;184755;2874;77;0;1
FR;5;2022-03-05;677;1990;8;0;2243;16;2;0;0;253997;157018;2232;22;186998;2890;79;0;1
FR;5;2022-03-06;108;260;0;0;310;0;0;0;0;254105;157278;2232;22;187308;2890;79;0;1
FR;5;2022-03-07;71;228;5;0;254;3;2;0;0;254176;157506;2237;22;187562;2893;81;0;1
FR;5;2022-03-08;46;134;7;1;141;8;3;0;0;254222;157640;2244;23;187703;2901;84;0;1
FR;5;2022-03-09;910;3078;24;0;3407;36;0;0;0;255132;160718;2268;23;191110;2937;84;0;1
FR;5;2022-03-10;82;202;9;0;215;13;3;0;0;255214;160920;2277;23;191325;2950;87;0;1
FR;5;2022-03-11;148;369;13;1;426;15;0;0;0;255362;161289;2290;24;191751;2965;87;0;1
FR;5;2022-03-12;758;1613;13;1;1976;30;0;0;0;256120;162902;2303;25;193727;2995;87;0;1
FR;5;2022-03-13;78;102;0;0;135;0;0;0;0;256198;163004;2303;25;193862;2995;87;0;1
FR;5;2022-03-14;69;119;7;1;139;7;1;0;0;256267;163123;2310;26;194001;3002;88;0;1
FR;5;2022-03-15;83;99;4;0;119;7;1;0;0;256350;163222;2314;26;194120;3009;89;0;1
FR;5;2022-03-16;882;1827;15;3;2227;36;7;0;0;257232;165049;2329;29;196347;3045;96;0;1
FR;5;2022-03-17;68;123;8;4;151;10;4;0;0;257300;165172;2337;33;196498;3055;100;0;1
FR;5;2022-03-18;172;318;13;4;391;18;4;0;0;257472;165490;2350;37;196889;3073;104;0;1
FR;5;2022-03-19;752;1163;12;5;1555;33;8;0;0;258224;166653;2362;42;198444;3106;112;0;1
FR;5;2022-03-20;45;93;1;0;119;1;0;0;0;258269;166746;2363;42;198563;3107;112;0;1
FR;5;2022-03-21;71;120;10;6;136;15;8;0;0;258340;166866;2373;48;198699;3122;120;0;1
FR;5;2022-03-22;56;119;8;7;143;9;6;0;0;258396;166985;2381;55;198842;3131;126;0;1
FR;5;2022-03-23;805;1461;14;8;1878;36;9;0;0;259201;168446;2395;63;200720;3167;135;0;1
FR;5;2022-03-24;71;93;8;7;118;7;10;0;0;259272;168539;2403;70;200838;3174;145;0;1
FR;5;2022-03-25;222;293;14;8;388;18;9;0;0;259494;168832;2417;78;201226;3192;154;0;1
FR;5;2022-03-26;707;853;12;5;1273;26;6;0;1;260201;169685;2429;83;202499;3218;160;0;2
FR;5;2022-03-27;75;81;0;0;124;3;0;0;0;260276;169766;2429;83;202623;3221;160;0;2
FR;5;2022-03-28;81;93;1;2;132;3;2;0;0;260357;169859;2430;85;202755;3224;162;0;2
FR;5;2022-03-29;71;82;10;4;113;12;5;0;0;260428;169941;2440;89;202868;3236;167;0;2
FR;5;2022-03-30;823;1116;16;13;1604;29;14;0;0;261251;171057;2456;102;204472;3265;181;0;2
FR;5;2022-03-31;102;125;1;4;173;6;4;0;0;261353;171182;2457;106;204645;3271;185;0;2
FR;5;2022-04-01;114;86;7;12;135;11;12;0;1;261467;171268;2464;118;204780;3282;197;0;3
FR;5;2022-04-02;330;349;3;3;535;15;4;0;0;261797;171617;2467;121;205315;3297;201;0;3
FR;5;2022-04-03;54;59;1;0;88;1;0;0;0;261851;171676;2468;121;205403;3298;201;0;3
FR;5;2022-04-04;40;57;4;1;70;8;2;0;0;261891;171733;2472;122;205473;3306;203;0;3
FR;5;2022-04-05;53;60;6;6;75;9;5;0;0;261944;171793;2478;128;205548;3315;208;0;3
FR;5;2022-04-06;421;439;7;14;678;16;14;0;0;262365;172232;2485;142;206226;3331;222;0;3
FR;5;2022-04-07;45;69;5;7;89;7;10;0;0;262410;172301;2490;149;206315;3338;232;0;3
FR;5;2022-04-08;134;112;12;13;175;14;15;0;0;262544;172413;2502;162;206490;3352;247;0;3
FR;5;2022-04-09;311;324;2;5;511;17;5;0;0;262855;172737;2504;167;207001;3369;252;0;3
FR;5;2022-04-10;44;31;2;0;61;2;1;0;0;262899;172768;2506;167;207062;3371;253;0;3
FR;5;2022-04-11;50;60;3;2;78;4;3;0;0;262949;172828;2509;169;207140;3375;256;0;3
FR;5;2022-04-12;59;54;3;3;78;5;3;0;0;263008;172882;2512;172;207218;3380;259;0;3
FR;5;2022-04-13;382;413;3;8;606;16;8;0;0;263390;173295;2515;180;207824;3396;267;0;3
FR;5;2022-04-14;48;53;5;5;70;9;3;0;0;263438;173348;2520;185;207894;3405;270;0;3
FR;5;2022-04-15;91;111;4;4;152;5;6;0;0;263529;173459;2524;189;208046;3410;276;0;3
FR;5;2022-04-16;188;184;2;1;265;13;1;0;0;263717;173643;2526;190;208311;3423;277;0;3
FR;5;2022-04-17;12;11;1;0;17;1;0;0;0;263729;173654;2527;190;208328;3424;277;0;3
FR;5;2022-04-18;9;10;2;0;11;3;1;0;0;263738;173664;2529;190;208339;3427;278;0;3
FR;5;2022-04-19;75;71;6;1;96;6;4;0;0;263813;173735;2535;191;208435;3433;282;0;3
FR;5;2022-04-20;361;349;9;6;521;12;7;0;0;264174;174084;2544;197;208956;3445;289;0;3
FR;5;2022-04-21;42;64;9;10;71;12;14;0;0;264216;174148;2553;207;209027;3457;303;0;3
FR;5;2022-04-22;113;96;5;4;144;5;5;0;0;264329;174244;2558;211;209171;3462;308;0;3
FR;5;2022-04-23;209;193;4;2;284;11;3;0;0;264538;174437;2562;213;209455;3473;311;0;3
FR;5;2022-04-24;37;35;0;0;50;3;0;0;0;264575;174472;2562;213;209505;3476;311;0;3
FR;5;2022-04-25;69;65;1;1;102;4;1;0;0;264644;174537;2563;214;209607;3480;312;0;3
FR;5;2022-04-26;60;63;2;1;85;5;1;0;0;264704;174600;2565;215;209692;3485;313;0;3
FR;5;2022-04-27;335;316;3;7;463;14;8;0;0;265039;174916;2568;222;210155;3499;321;0;3
FR;5;2022-04-28;81;54;4;5;81;8;7;0;0;265120;174970;2572;227;210236;3507;328;0;3
FR;5;2022-04-29;117;84;5;19;118;12;17;0;0;265237;175054;2577;246;210354;3519;345;0;3
FR;5;2022-04-30;183;114;2;3;184;10;4;0;0;265420;175168;2579;249;210538;3529;349;0;3
FR;5;2022-05-01;11;7;0;0;11;0;0;0;0;265431;175175;2579;249;210549;3529;349;0;3
FR;5;2022-05-02;52;28;4;5;48;2;7;0;0;265483;175203;2583;254;210597;3531;356;0;3
FR;5;2022-05-03;87;57;2;4;84;11;4;0;0;265570;175260;2585;258;210681;3542;360;0;3
FR;5;2022-05-04;278;205;1;2;324;7;2;0;0;265848;175465;2586;260;211005;3549;362;0;3
FR;5;2022-05-05;62;32;3;4;46;5;4;0;0;265910;175497;2589;264;211051;3554;366;0;3
FR;5;2022-05-06;105;65;2;3;106;5;3;0;0;266015;175562;2591;267;211157;3559;369;0;3
FR;5;2022-05-07;171;117;2;10;180;13;7;0;0;266186;175679;2593;277;211337;3572;376;0;3
FR;5;2022-05-08;8;8;0;0;9;2;0;0;0;266194;175687;2593;277;211346;3574;376;0;3
FR;5;2022-05-09;44;34;15;3;51;16;4;0;0;266238;175721;2608;280;211397;3590;380;0;3
FR;5;2022-05-10;54;49;3;4;67;5;5;0;0;266292;175770;2611;284;211464;3595;385;0;3
FR;5;2022-05-11;327;237;12;7;344;21;11;0;0;266619;176007;2623;291;211808;3616;396;0;3
FR;5;2022-05-12;46;34;2;2;47;2;3;0;0;266665;176041;2625;293;211855;3618;399;0;3
FR;5;2022-05-13;109;83;3;8;120;8;7;0;0;266774;176124;2628;301;211975;3626;406;0;3
FR;5;2022-05-14;209;131;0;1;212;8;0;0;0;266983;176255;2628;302;212187;3634;406;0;3
FR;5;2022-05-15;22;9;2;0;18;1;1;0;0;267005;176264;2630;302;212205;3635;407;0;3
FR;5;2022-05-16;52;34;4;5;53;4;5;0;0;267057;176298;2634;307;212258;3639;412;0;3
FR;5;2022-05-17;72;40;5;0;68;2;3;0;0;267129;176338;2639;307;212326;3641;415;0;3
FR;5;2022-05-18;289;215;4;4;330;8;6;0;0;267418;176553;2643;311;212656;3649;421;0;3
FR;5;2022-05-19;45;35;5;3;42;3;4;0;0;267463;176588;2648;314;212698;3652;425;0;3
FR;5;2022-05-20;76;63;3;10;92;1;11;0;0;267539;176651;2651;324;212790;3653;436;0;3
FR;5;2022-05-21;242;166;2;3;268;17;1;0;0;267781;176817;2653;327;213058;3670;437;0;3
FR;5;2022-05-22;20;14;2;5;20;2;6;0;0;267801;176831;2655;332;213078;3672;443;0;3
FR;5;2022-05-23;42;31;4;3;42;6;3;0;0;267843;176862;2659;335;213120;3678;446;0;3
FR;5;2022-05-24;47;45;3;2;60;5;2;0;0;267890;176907;2662;337;213180;3683;448;0;3
FR;5;2022-05-25;329;258;4;1;386;16;1;0;0;268219;177165;2666;338;213566;3699;449;0;3
FR;5;2022-05-26;17;5;0;1;9;2;0;0;1;268236;177170;2666;339;213575;3701;449;0;4
FR;5;2022-05-27;99;54;4;4;89;9;3;0;0;268335;177224;2670;343;213664;3710;452;0;4
FR;5;2022-05-28;100;78;5;3;106;10;3;0;0;268435;177302;2675;346;213770;3720;455;0;4
FR;5;2022-05-29;14;14;1;0;18;2;0;0;0;268449;177316;2676;346;213788;3722;455;0;4
FR;5;2022-05-30;56;41;2;1;54;2;2;0;0;268505;177357;2678;347;213842;3724;457;0;4
FR;5;2022-05-31;57;43;1;8;62;1;8;0;0;268562;177400;2679;355;213904;3725;465;0;4
FR;5;2022-06-01;257;241;9;2;300;25;5;0;0;268819;177641;2688;357;214204;3750;470;0;4
FR;5;2022-06-02;63;61;5;0;73;9;1;0;0;268882;177702;2693;357;214277;3759;471;0;4
FR;5;2022-06-03;82;71;4;5;88;10;6;0;0;268964;177773;2697;362;214365;3769;477;0;4
FR;5;2022-06-04;157;109;2;1;187;9;1;0;0;269121;177882;2699;363;214552;3778;478;0;4
FR;5;2022-06-05;18;11;0;0;21;1;0;0;0;269139;177893;2699;363;214573;3779;478;0;4
FR;5;2022-06-06;16;12;0;1;15;0;1;0;0;269155;177905;2699;364;214588;3779;479;0;4
FR;5;2022-06-07;50;56;1;1;76;2;1;0;0;269205;177961;2700;365;214664;3781;480;0;4
FR;5;2022-06-08;283;225;3;4;332;17;2;0;0;269488;178186;2703;369;214996;3798;482;0;4
FR;5;2022-06-09;52;41;6;3;57;7;2;0;1;269540;178227;2709;372;215053;3805;484;0;5
FR;5;2022-06-10;81;72;1;1;105;6;1;0;0;269621;178299;2710;373;215158;3811;485;0;5
FR;5;2022-06-11;173;141;3;3;202;10;4;0;0;269794;178440;2713;376;215360;3821;489;0;5
FR;5;2022-06-12;17;16;0;0;19;2;0;0;0;269811;178456;2713;376;215379;3823;489;0;5
FR;5;2022-06-13;56;47;9;3;70;10;6;0;0;269867;178503;2722;379;215449;3833;495;0;5
FR;5;2022-06-14;59;56;1;4;64;6;4;0;0;269926;178559;2723;383;215513;3839;499;0;5
FR;5;2022-06-15;266;260;5;2;363;27;1;0;0;270192;178819;2728;385;215876;3866;500;0;5
FR;5;2022-06-16;47;30;5;2;44;5;2;0;0;270239;178849;2733;387;215920;3871;502;0;5
FR;5;2022-06-17;100;67;5;5;102;10;5;0;0;270339;178916;2738;392;216022;3881;507;0;5
FR;5;2022-06-18;146;95;10;2;152;26;2;0;1;270485;179011;2748;394;216174;3907;509;0;6
FR;5;2022-06-19;26;15;0;1;18;4;1;0;0;270511;179026;2748;395;216192;3911;510;0;6
FR;5;2022-06-20;56;50;8;0;62;11;2;0;0;270567;179076;2756;395;216254;3922;512;0;6
FR;5;2022-06-21;53;73;5;3;91;7;5;0;1;270620;179149;2761;398;216345;3929;517;0;7
FR;5;2022-06-22;224;248;7;9;348;33;10;0;0;270844;179397;2768;407;216693;3962;527;0;7
FR;5;2022-06-23;50;38;2;5;43;6;6;0;0;270894;179435;2770;412;216736;3968;533;0;7
FR;5;2022-06-24;91;70;12;5;101;16;8;0;0;270985;179505;2782;417;216837;3984;541;0;7
FR;5;2022-06-25;154;124;3;7;185;14;8;0;1;271139;179629;2785;424;217022;3998;549;0;8
FR;5;2022-06-26;26;19;2;0;29;5;0;0;0;271165;179648;2787;424;217051;4003;549;0;8
FR;5;2022-06-27;57;60;5;7;78;11;9;0;0;271222;179708;2792;431;217129;4014;558;0;8
FR;5;2022-06-28;70;49;8;2;69;14;5;0;0;271292;179757;2800;433;217198;4028;563;0;8
FR;5;2022-06-29;297;268;9;21;390;34;23;0;0;271589;180025;2809;454;217588;4062;586;0;8
FR;5;2022-06-30;89;57;10;12;89;17;11;0;0;271678;180082;2819;466;217677;4079;597;0;8
FR;5;2022-07-01;127;65;7;11;118;12;11;0;2;271805;180147;2826;477;217795;4091;608;0;10
FR;5;2022-07-02;191;132;4;0;210;22;0;0;0;271996;180279;2830;477;218005;4113;608;0;10
FR;5;2022-07-03;30;25;1;0;36;4;0;0;0;272026;180304;2831;477;218041;4117;608;0;10
FR;5;2022-07-04;103;65;2;5;102;7;5;0;1;272129;180369;2833;482;218143;4124;613;0;11
FR;5;2022-07-05;104;72;3;8;107;13;8;0;1;272233;180441;2836;490;218250;4137;621;0;12
FR;5;2022-07-06;277;168;9;36;289;27;36;0;0;272510;180609;2845;526;218539;4164;657;0;12
FR;5;2022-07-07;88;69;6;9;89;13;11;0;0;272598;180678;2851;535;218628;4177;668;0;12
FR;5;2022-07-08;152;120;7;14;146;25;13;0;1;272750;180798;2858;549;218774;4202;681;0;13
FR;5;2022-07-09;116;68;1;8;100;10;8;0;0;272866;180866;2859;557;218874;4212;689;0;13
FR;5;2022-07-10;15;6;0;0;10;1;0;0;0;272881;180872;2859;557;218884;4213;689;0;13
FR;5;2022-07-11;92;72;10;2;98;19;3;0;0;272973;180944;2869;559;218982;4232;692;0;13
FR;5;2022-07-12;67;63;5;10;81;7;12;0;0;273040;181007;2874;569;219063;4239;704;0;13
FR;5;2022-07-13;169;118;10;19;196;16;23;0;0;273209;181125;2884;588;219259;4255;727;0;13
FR;5;2022-07-14;8;4;0;0;7;0;0;0;0;273217;181129;2884;588;219266;4255;727;0;13
FR;5;2022-07-15;74;66;5;14;86;15;15;0;0;273291;181195;2889;602;219352;4270;742;0;13
FR;5;2022-07-16;54;44;3;0;71;3;2;0;0;273345;181239;2892;602;219423;4273;744;0;13
FR;5;2022-07-17;10;7;3;0;10;2;2;0;0;273355;181246;2895;602;219433;4275;746;0;13
FR;5;2022-07-18;60;47;0;4;70;4;3;0;0;273415;181293;2895;606;219503;4279;749;0;13
FR;5;2022-07-19;63;42;5;3;63;7;4;0;0;273478;181335;2900;609;219566;4286;753;0;13
FR;5;2022-07-20;119;106;4;11;141;14;9;0;0;273597;181441;2904;620;219707;4300;762;0;13
FR;5;2022-07-21;38;43;2;10;52;5;10;0;0;273635;181484;2906;630;219759;4305;772;0;13
FR;5;2022-07-22;48;69;11;13;75;23;11;0;1;273683;181553;2917;643;219834;4328;783;0;14
FR;5;2022-07-23;59;78;2;1;95;11;2;0;0;273742;181631;2919;644;219929;4339;785;0;14
FR;5;2022-07-24;11;9;3;1;12;3;1;0;0;273753;181640;2922;645;219941;4342;786;0;14
FR;5;2022-07-25;53;48;2;7;57;8;8;0;0;273806;181688;2924;652;219998;4350;794;0;14
FR;5;2022-07-26;58;52;5;41;70;6;44;0;0;273864;181740;2929;693;220068;4356;838;0;14
FR;5;2022-07-27;106;118;4;4;161;13;4;0;0;273970;181858;2933;697;220229;4369;842;0;14
FR;5;2022-07-28;39;35;2;2;47;6;1;0;0;274009;181893;2935;699;220276;4375;843;0;14
FR;5;2022-07-29;56;74;3;14;90;8;10;0;0;274065;181967;2938;713;220366;4383;853;0;14
FR;5;2022-07-30;55;53;5;1;76;7;2;0;0;274120;182020;2943;714;220442;4390;855;0;14
FR;5;2022-07-31;7;11;1;0;13;1;0;0;0;274127;182031;2944;714;220455;4391;855;0;14
FR;5;2022-08-01;39;53;1;2;64;6;2;0;0;274166;182084;2945;716;220519;4397;857;0;14
FR;5;2022-08-02;32;43;8;7;47;8;7;0;1;274198;182127;2953;723;220566;4405;864;0;15
FR;5;2022-08-03;54;51;4;10;70;9;8;0;0;274252;182178;2957;733;220636;4414;872;0;15
FR;5;2022-08-04;20;18;1;6;22;1;6;0;0;274272;182196;2958;739;220658;4415;878;0;15
FR;5;2022-08-05;35;26;3;3;39;3;3;0;0;274307;182222;2961;742;220697;4418;881;0;15
FR;5;2022-08-06;23;26;1;0;31;1;0;0;0;274330;182248;2962;742;220728;4419;881;0;15
FR;5;2022-08-07;2;2;1;0;1;1;1;0;0;274332;182250;2963;742;220729;4420;882;0;15
FR;5;2022-08-08;26;19;1;2;24;2;1;0;0;274358;182269;2964;744;220753;4422;883;0;15
FR;5;2022-08-09;26;28;3;3;35;3;3;0;0;274384;182297;2967;747;220788;4425;886;0;15
FR;5;2022-08-10;47;47;2;0;56;5;0;0;0;274431;182344;2969;747;220844;4430;886;0;15
FR;5;2022-08-11;19;36;2;2;42;5;2;0;0;274450;182380;2971;749;220886;4435;888;0;15
FR;5;2022-08-12;27;28;2;0;39;2;0;0;0;274477;182408;2973;749;220925;4437;888;0;15
FR;5;2022-08-13;16;18;0;0;24;0;0;0;0;274493;182426;2973;749;220949;4437;888;0;15
FR;5;2022-08-14;2;3;0;0;4;0;0;0;0;274495;182429;2973;749;220953;4437;888;0;15
FR;5;2022-08-15;2;5;0;0;5;0;0;0;0;274497;182434;2973;749;220958;4437;888;0;15
FR;5;2022-08-16;33;26;3;0;28;6;0;0;0;274530;182460;2976;749;220986;4443;888;0;15
FR;5;2022-08-17;52;55;2;1;72;1;1;0;0;274582;182515;2978;750;221058;4444;889;0;15
FR;5;2022-08-18;26;18;8;17;25;10;16;0;0;274608;182533;2986;767;221083;4454;905;0;15
FR;5;2022-08-19;26;34;1;2;43;2;2;0;0;274634;182567;2987;769;221126;4456;907;0;15
FR;5;2022-08-20;25;27;2;1;33;4;2;0;0;274659;182594;2989;770;221159;4460;909;0;15
FR;5;2022-08-21;7;4;1;0;7;1;0;0;0;274666;182598;2990;770;221166;4461;909;0;15
FR;5;2022-08-22;39;26;1;6;42;2;5;0;1;274705;182624;2991;776;221208;4463;914;0;16
FR;5;2022-08-23;27;26;1;1;32;2;1;0;0;274732;182650;2992;777;221240;4465;915;0;16
FR;5;2022-08-24;50;43;0;0;62;0;0;0;0;274782;182693;2992;777;221302;4465;915;0;16
FR;5;2022-08-25;27;26;3;1;31;2;0;0;1;274809;182719;2995;778;221333;4467;915;0;17
FR;5;2022-08-26;48;39;7;2;58;5;4;0;0;274857;182758;3002;780;221391;4472;919;0;17
FR;5;2022-08-27;46;28;1;0;46;3;1;0;0;274903;182786;3003;780;221437;4475;920;0;17
FR;5;2022-08-28;5;7;0;0;7;0;0;0;0;274908;182793;3003;780;221444;4475;920;0;17
FR;5;2022-08-29;58;44;1;1;66;4;1;0;0;274966;182837;3004;781;221510;4479;921;0;17
FR;5;2022-08-30;45;23;12;29;40;10;30;0;1;275011;182860;3016;810;221550;4489;951;0;18
FR;5;2022-08-31;53;47;6;1;58;11;1;0;0;275064;182907;3022;811;221608;4500;952;0;18
FR;5;2022-09-01;16;8;1;4;13;1;4;0;0;275080;182915;3023;815;221621;4501;956;0;18
FR;5;2022-09-02;42;23;8;2;35;9;3;0;0;275122;182938;3031;817;221656;4510;959;0;18
FR;5;2022-09-03;69;37;2;0;58;2;0;0;0;275191;182975;3033;817;221714;4512;959;0;18
FR;5;2022-09-04;12;7;1;0;8;3;0;0;0;275203;182982;3034;817;221722;4515;959;0;18
FR;5;2022-09-05;7;4;1;0;4;1;0;0;0;275210;182986;3035;817;221726;4516;959;0;18
FR;5;2022-09-06;23;14;3;15;17;2;14;0;2;275233;183000;3038;832;221743;4518;973;0;20
FR;5;2022-09-07;79;53;1;1;76;3;1;0;0;275312;183053;3039;833;221819;4521;974;0;20
FR;5;2022-09-08;10;4;0;4;7;0;4;0;0;275322;183057;3039;837;221826;4521;978;0;20
FR;5;2022-09-09;40;11;9;2;14;10;3;0;0;275362;183068;3048;839;221840;4531;981;0;20
FR;5;2022-09-10;40;45;1;1;50;8;1;0;0;275402;183113;3049;840;221890;4539;982;0;20
FR;5;2022-09-11;3;3;0;0;3;1;0;0;0;275405;183116;3049;840;221893;4540;982;0;20
FR;5;2022-09-12;7;5;2;2;7;2;2;0;0;275412;183121;3051;842;221900;4542;984;0;20
FR;5;2022-09-13;9;6;0;1;4;3;1;0;0;275421;183127;3051;843;221904;4545;985;0;20
FR;5;2022-09-14;52;47;4;6;55;9;5;0;0;275473;183174;3055;849;221959;4554;990;0;20
FR;5;2022-09-15;11;13;2;3;11;5;3;0;0;275484;183187;3057;852;221970;4559;993;0;20
FR;5;2022-09-16;25;33;1;4;38;3;3;0;0;275509;183220;3058;856;222008;4562;996;0;20
FR;5;2022-09-17;60;43;1;1;51;5;1;0;0;275569;183263;3059;857;222059;4567;997;0;20
FR;5;2022-09-18;9;6;0;1;10;1;0;0;0;275578;183269;3059;858;222069;4568;997;0;20
FR;5;2022-09-19;22;17;2;1;20;5;2;0;0;275600;183286;3061;859;222089;4573;999;0;20
FR;5;2022-09-20;15;11;3;3;15;1;4;0;0;275615;183297;3064;862;222104;4574;1003;0;20
FR;5;2022-09-21;68;45;9;0;65;13;0;0;0;275683;183342;3073;862;222169;4587;1003;0;20
FR;5;2022-09-22;12;6;4;24;6;4;23;0;1;275695;183348;3077;886;222175;4591;1026;0;21
FR;5;2022-09-23;20;25;2;3;23;8;3;0;0;275715;183373;3079;889;222198;4599;1029;0;21
FR;5;2022-09-24;44;51;1;8;65;5;8;0;0;275759;183424;3080;897;222263;4604;1037;0;21
FR;5;2022-09-25;6;12;0;0;13;1;0;0;0;275765;183436;3080;897;222276;4605;1037;0;21
FR;5;2022-09-26;15;7;0;2;12;0;1;0;1;275780;183443;3080;899;222288;4605;1038;0;22
FR;5;2022-09-27;7;12;4;9;14;4;9;0;1;275787;183455;3084;908;222302;4609;1047;0;23
FR;5;2022-09-28;65;66;5;0;90;7;0;0;0;275852;183521;3089;908;222392;4616;1047;0;23
FR;5;2022-09-29;17;9;1;0;15;1;1;0;1;275869;183530;3090;908;222407;4617;1048;0;24
FR;5;2022-09-30;28;46;2;2;53;4;3;0;0;275897;183576;3092;910;222460;4621;1051;0;24
FR;5;2022-10-01;40;35;5;5;48;8;7;0;0;275937;183611;3097;915;222508;4629;1058;0;24
FR;5;2022-10-02;1;9;1;0;10;1;0;0;0;275938;183620;3098;915;222518;4630;1058;0;24
FR;5;2022-10-03;7;6;3;0;5;4;0;0;0;275945;183626;3101;915;222523;4634;1058;0;24
FR;5;2022-10-04;11;8;1;3;11;2;3;0;0;275956;183634;3102;918;222534;4636;1061;0;24
FR;5;2022-10-05;57;62;2;2;79;13;2;0;0;276013;183696;3104;920;222613;4649;1063;0;24
FR;5;2022-10-06;12;10;1;4;15;2;4;0;0;276025;183706;3105;924;222628;4651;1067;0;24
FR;5;2022-10-07;21;31;1;0;34;5;0;0;0;276046;183737;3106;924;222662;4656;1067;0;24
FR;5;2022-10-08;33;51;1;0;54;7;0;0;0;276079;183788;3107;924;222716;4663;1067;0;24
FR;5;2022-10-09;7;10;0;0;11;1;0;0;0;276086;183798;3107;924;222727;4664;1067;0;24
FR;5;2022-10-10;14;6;0;1;8;1;1;0;0;276100;183804;3107;925;222735;4665;1068;0;24
FR;5;2022-10-11;6;13;2;1;14;2;2;0;0;276106;183817;3109;926;222749;4667;1070;0;24
FR;5;2022-10-12;39;57;3;2;69;8;2;0;0;276145;183874;3112;928;222818;4675;1072;0;24
FR;5;2022-10-13;11;16;2;0;18;4;0;0;0;276156;183890;3114;928;222836;4679;1072;0;24
FR;5;2022-10-14;21;21;1;0;20;5;0;0;0;276177;183911;3115;928;222856;4684;1072;0;24
FR;5;2022-10-15;19;26;10;0;25;11;2;0;0;276196;183937;3125;928;222881;4695;1074;0;24
FR;5;2022-10-16;3;1;0;0;1;1;0;0;0;276199;183938;3125;928;222882;4696;1074;0;24
FR;5;2022-10-17;8;8;2;1;8;3;1;0;2;276207;183946;3127;929;222890;4699;1075;0;26
FR;5;2022-10-18;6;7;0;2;8;0;2;0;0;276213;183953;3127;931;222898;4699;1077;0;26
FR;5;2022-10-19;38;43;8;0;52;11;0;0;1;276251;183996;3135;931;222950;4710;1077;0;27
FR;5;2022-10-20;18;15;2;1;16;3;1;0;0;276269;184011;3137;932;222966;4713;1078;0;27
FR;5;2022-10-21;22;15;6;0;19;8;1;0;2;276291;184026;3143;932;222985;4721;1079;0;29
FR;5;2022-10-22;35;29;2;12;32;5;12;0;0;276326;184055;3145;944;223017;4726;1091;0;29
FR;5;2022-10-23;9;3;0;0;4;0;0;0;0;276335;184058;3145;944;223021;4726;1091;0;29
FR;5;2022-10-24;14;7;6;7;9;9;8;0;0;276349;184065;3151;951;223030;4735;1099;0;29
FR;5;2022-10-25;13;9;6;3;9;8;3;0;2;276362;184074;3157;954;223039;4743;1102;0;31
FR;5;2022-10-26;34;22;6;0;29;10;0;0;0;276396;184096;3163;954;223068;4753;1102;0;31
FR;5;2022-10-27;16;4;4;0;11;4;0;0;0;276412;184100;3167;954;223079;4757;1102;0;31
FR;5;2022-10-28;19;13;5;3;14;6;4;0;0;276431;184113;3172;957;223093;4763;1106;0;31
FR;5;2022-10-29;21;13;0;0;17;3;0;0;0;276452;184126;3172;957;223110;4766;1106;0;31
FR;5;2022-10-30;1;4;2;0;4;3;0;0;0;276453;184130;3174;957;223114;4769;1106;0;31
FR;5;2022-10-31;14;11;2;1;12;3;1;0;0;276467;184141;3176;958;223126;4772;1107;0;31
FR;5;2022-11-01;3;3;0;1;3;0;1;0;0;276470;184144;3176;959;223129;4772;1108;0;31
FR;5;2022-11-02;23;17;5;4;23;5;5;0;0;276493;184161;3181;963;223152;4777;1113;0;31
FR;5;2022-11-03;22;4;1;1;11;1;1;0;0;276515;184165;3182;964;223163;4778;1114;0;31
FR;5;2022-11-04;19;18;1;0;18;2;0;0;0;276534;184183;3183;964;223181;4780;1114;0;31
FR;5;2022-11-05;25;16;1;0;21;1;0;0;0;276559;184199;3184;964;223202;4781;1114;0;31
FR;5;2022-11-06;1;7;0;0;7;0;0;0;0;276560;184206;3184;964;223209;4781;1114;0;31
FR;5;2022-11-07;9;3;3;0;3;3;0;0;0;276569;184209;3187;964;223212;4784;1114;0;31
FR;5;2022-11-08;12;7;1;2;8;1;1;0;0;276581;184216;3188;966;223220;4785;1115;0;31
FR;5;2022-11-09;30;29;6;1;32;6;1;0;0;276611;184245;3194;967;223252;4791;1116;0;31
FR;5;2022-11-10;11;16;1;0;17;1;0;0;0;276622;184261;3195;967;223269;4792;1116;0;31
FR;5;2022-11-11;2;4;0;1;6;0;1;0;0;276624;184265;3195;968;223275;4792;1117;0;31
FR;5;2022-11-12;19;10;5;9;18;6;9;0;2;276643;184275;3200;977;223293;4798;1126;0;33
FR;5;2022-11-13;2;2;0;1;2;0;1;0;0;276645;184277;3200;978;223295;4798;1127;0;33
FR;5;2022-11-14;8;11;0;1;10;3;0;0;0;276653;184288;3200;979;223305;4801;1127;0;33
FR;5;2022-11-15;8;6;4;3;6;4;3;0;0;276661;184294;3204;982;223311;4805;1130;0;33
FR;5;2022-11-16;29;28;2;1;33;5;0;0;0;276690;184322;3206;983;223344;4810;1130;0;33
FR;5;2022-11-17;6;15;4;0;15;5;0;0;0;276696;184337;3210;983;223359;4815;1130;0;33
FR;5;2022-11-18;16;17;7;0;19;9;0;0;0;276712;184354;3217;983;223378;4824;1130;0;33
FR;5;2022-11-19;18;27;2;0;28;6;0;0;0;276730;184381;3219;983;223406;4830;1130;0;33
FR;5;2022-11-20;6;3;0;0;5;0;0;0;0;276736;184384;3219;983;223411;4830;1130;0;33
FR;5;2022-11-21;8;5;0;2;4;2;1;0;0;276744;184389;3219;985;223415;4832;1131;0;33
FR;5;2022-11-22;9;3;0;1;4;0;1;0;0;276753;184392;3219;986;223419;4832;1132;0;33
FR;5;2022-11-23;34;25;6;1;27;13;0;0;0;276787;184417;3225;987;223446;4845;1132;0;33
FR;5;2022-11-24;3;7;2;0;8;1;1;0;0;276790;184424;3227;987;223454;4846;1133;0;33
FR;5;2022-11-25;15;20;2;0;25;3;0;0;1;276805;184444;3229;987;223479;4849;1133;0;34
FR;5;2022-11-26;22;19;4;0;20;8;0;0;0;276827;184463;3233;987;223499;4857;1133;0;34
FR;5;2022-11-27;7;0;1;0;3;1;0;0;0;276834;184463;3234;987;223502;4858;1133;0;34
FR;5;2022-11-28;7;15;3;0;15;5;0;0;0;276841;184478;3237;987;223517;4863;1133;0;34
FR;5;2022-11-29;10;9;1;0;11;3;0;0;1;276851;184487;3238;987;223528;4866;1133;0;35
FR;5;2022-11-30;35;48;12;0;56;17;1;0;0;276886;184535;3250;987;223584;4883;1134;0;35
FR;5;2022-12-01;5;10;2;0;10;3;0;0;0;276891;184545;3252;987;223594;4886;1134;0;35
FR;5;2022-12-02;1;5;2;1;4;3;1;0;0;276892;184550;3254;988;223598;4889;1135;0;35
FR;5;2022-12-03;3;3;8;1;5;8;1;0;0;276895;184553;3262;989;223603;4897;1136;0;35
FR;5;2022-12-04;3;2;1;0;2;2;0;0;0;276898;184555;3263;989;223605;4899;1136;0;35
FR;5;2022-12-05;1;1;0;0;0;1;0;0;0;276899;184556;3263;989;223605;4900;1136;0;35
FR;5;2022-12-06;5;1;0;0;1;0;0;0;1;276904;184557;3263;989;223606;4900;1136;0;36
FR;5;2022-12-07;5;8;1;0;8;1;0;0;0;276909;184565;3264;989;223614;4901;1136;0;36
FR;5;2022-12-08;2;2;0;0;2;0;0;0;0;276911;184567;3264;989;223616;4901;1136;0;36
FR;5;2022-12-09;3;8;0;0;6;2;0;0;0;276914;184575;3264;989;223622;4903;1136;0;36
FR;5;2022-12-10;4;7;2;1;8;2;1;0;0;276918;184582;3266;990;223630;4905;1137;0;36
FR;5;2022-12-11;2;0;0;0;0;0;0;0;0;276920;184582;3266;990;223630;4905;1137;0;36
FR;5;2022-12-12;0;0;0;0;0;0;0;0;0;276920;184582;3266;990;223630;4905;1137;0;36
FR;5;2022-12-13;2;3;0;0;4;1;0;0;0;276922;184585;3266;990;223634;4906;1137;0;36
FR;5;2022-12-14;2;2;0;9;2;1;8;0;3;276924;184587;3266;999;223636;4907;1145;0;39
FR;5;2022-12-15;0;2;0;0;2;0;0;0;0;276924;184589;3266;999;223638;4907;1145;0;39
FR;5;2022-12-16;3;2;2;0;3;3;0;0;0;276927;184591;3268;999;223641;4910;1145;0;39
FR;5;2022-12-17;3;3;3;0;3;2;1;0;0;276930;184594;3271;999;223644;4912;1146;0;39
FR;5;2022-12-18;3;0;0;1;0;0;1;0;1;276933;184594;3271;1000;223644;4912;1147;0;40
FR;5;2022-12-19;1;0;0;2;0;0;2;0;0;276934;184594;3271;1002;223644;4912;1149;0;40
FR;5;2022-12-20;0;1;3;0;1;3;0;0;0;276934;184595;3274;1002;223645;4915;1149;0;40
FR;5;2022-12-21;2;4;0;0;4;0;0;0;0;276936;184599;3274;1002;223649;4915;1149;0;40
FR;5;2022-12-22;2;2;0;0;2;0;0;0;0;276938;184601;3274;1002;223651;4915;1149;0;40
FR;5;2022-12-23;3;1;1;0;1;1;0;0;0;276941;184602;3275;1002;223652;4916;1149;0;40
FR;5;2022-12-24;0;1;0;0;1;0;0;0;0;276941;184603;3275;1002;223653;4916;1149;0;40
FR;5;2022-12-25;0;1;2;0;0;3;0;0;0;276941;184604;3277;1002;223653;4919;1149;0;40
FR;5;2022-12-26;2;2;0;0;2;0;0;0;0;276943;184606;3277;1002;223655;4919;1149;0;40
FR;5;2022-12-27;0;3;0;0;3;0;0;0;0;276943;184609;3277;1002;223658;4919;1149;0;40
FR;5;2022-12-28;5;3;3;0;3;3;2;0;0;276948;184612;3280;1002;223661;4922;1151;0;40
FR;5;2022-12-29;3;2;2;0;3;2;0;0;0;276951;184614;3282;1002;223664;4924;1151;0;40
FR;5;2022-12-30;3;2;1;0;2;1;0;0;0;276954;184616;3283;1002;223666;4925;1151;0;40
FR;5;2022-12-31;0;0;0;0;0;0;0;0;0;276954;184616;3283;1002;223666;4925;1151;0;40
FR;5;2023-01-01;0;0;0;0;0;0;0;0;0;276954;184616;3283;1002;223666;4925;1151;0;40
FR;5;2023-01-02;1;1;1;0;1;1;0;0;0;276955;184617;3284;1002;223667;4926;1151;0;40
FR;5;2023-01-03;3;1;0;0;2;0;0;0;0;276958;184618;3284;1002;223669;4926;1151;0;40
FR;5;2023-01-04;6;1;1;0;2;1;0;0;0;276964;184619;3285;1002;223671;4927;1151;0;40
FR;5;2023-01-05;0;3;0;0;3;0;0;0;0;276964;184622;3285;1002;223674;4927;1151;0;40
FR;5;2023-01-06;2;1;1;0;1;1;0;0;0;276966;184623;3286;1002;223675;4928;1151;0;40
FR;5;2023-01-07;5;1;1;0;1;2;0;0;0;276971;184624;3287;1002;223676;4930;1151;0;40
FR;5;2023-01-08;2;2;0;0;2;0;0;0;0;276973;184626;3287;1002;223678;4930;1151;0;40
FR;5;2023-01-09;4;0;1;0;1;1;0;0;0;276977;184626;3288;1002;223679;4931;1151;0;40
FR;5;2023-01-10;3;1;0;0;2;0;0;0;0;276980;184627;3288;1002;223681;4931;1151;0;40
FR;5;2023-01-11;7;5;2;0;4;3;0;0;0;276987;184632;3290;1002;223685;4934;1151;0;40
FR;5;2023-01-12;14;6;4;0;6;6;0;0;0;277001;184638;3294;1002;223691;4940;1151;0;40
FR;5;2023-01-13;55;16;15;0;31;17;0;0;0;277056;184654;3309;1002;223722;4957;1151;0;40
FR;5;2023-01-14;56;34;13;1;34;20;2;0;0;277112;184688;3322;1003;223756;4977;1153;0;40
FR;5;2023-01-15;13;9;0;0;5;4;0;0;0;277125;184697;3322;1003;223761;4981;1153;0;40
FR;5;2023-01-16;13;8;3;0;8;3;0;0;0;277138;184705;3325;1003;223769;4984;1153;0;40
FR;5;2023-01-17;12;8;3;0;4;7;0;0;0;277150;184713;3328;1003;223773;4991;1153;0;40
FR;5;2023-01-18;71;35;21;2;46;25;2;0;0;277221;184748;3349;1005;223819;5016;1155;0;40
FR;5;2023-01-19;13;6;8;0;5;10;1;0;0;277234;184754;3357;1005;223824;5026;1156;0;40
FR;5;2023-01-20;27;17;13;0;17;18;0;0;2;277261;184771;3370;1005;223841;5044;1156;0;42
FR;5;2023-01-21;34;23;18;1;31;21;1;0;0;277295;184794;3388;1006;223872;5065;1157;0;42
FR;5;2023-01-22;6;4;2;0;4;3;0;0;0;277301;184798;3390;1006;223876;5068;1157;0;42
FR;5;2023-01-23;6;5;3;0;3;5;0;0;0;277307;184803;3393;1006;223879;5073;1157;0;42
FR;5;2023-01-24;16;3;3;0;6;4;0;0;0;277323;184806;3396;1006;223885;5077;1157;0;42
FR;5;2023-01-25;33;31;12;2;27;23;2;0;0;277356;184837;3408;1008;223912;5100;1159;0;42
FR;5;2023-01-26;6;5;4;0;6;4;0;0;0;277362;184842;3412;1008;223918;5104;1159;0;42
FR;5;2023-01-27;18;13;8;0;17;8;1;0;0;277380;184855;3420;1008;223935;5112;1160;0;42
FR;5;2023-01-28;21;8;4;3;11;6;3;0;0;277401;184863;3424;1011;223946;5118;1163;0;42
FR;5;2023-01-29;0;3;0;0;2;1;0;0;0;277401;184866;3424;1011;223948;5119;1163;0;42
FR;5;2023-01-30;7;5;3;0;4;6;0;0;0;277408;184871;3427;1011;223952;5125;1163;0;42
FR;5;2023-01-31;3;7;2;0;5;4;0;0;0;277411;184878;3429;1011;223957;5129;1163;0;42
FR;5;2023-02-01;18;18;7;1;19;8;1;0;0;277429;184896;3436;1012;223976;5137;1164;0;42
FR;5;2023-02-02;7;8;1;0;7;2;0;0;0;277436;184904;3437;1012;223983;5139;1164;0;42
FR;5;2023-02-03;15;23;6;0;24;9;0;0;0;277451;184927;3443;1012;224007;5148;1164;0;42
FR;5;2023-02-04;15;23;5;0;25;6;0;0;0;277466;184950;3448;1012;224032;5154;1164;0;42
FR;5;2023-02-05;1;2;0;1;2;1;0;0;0;277467;184952;3448;1013;224034;5155;1164;0;42
FR;5;2023-02-06;11;11;7;0;12;7;0;0;0;277478;184963;3455;1013;224046;5162;1164;0;42
FR;5;2023-02-07;6;11;2;0;10;4;0;0;0;277484;184974;3457;1013;224056;5166;1164;0;42
FR;5;2023-02-08;29;34;8;0;38;10;0;0;0;277513;185008;3465;1013;224094;5176;1164;0;42
FR;5;2023-02-09;15;7;5;0;8;5;0;0;0;277528;185015;3470;1013;224102;5181;1164;0;42
FR;5;2023-02-10;11;22;5;0;24;7;0;0;0;277539;185037;3475;1013;224126;5188;1164;0;42
FR;5;2023-02-11;12;11;3;1;15;4;0;0;0;277551;185048;3478;1014;224141;5192;1164;0;42
FR;5;2023-02-12;3;7;1;0;8;1;0;0;0;277554;185055;3479;1014;224149;5193;1164;0;42
FR;5;2023-02-13;4;6;6;0;5;7;0;0;0;277558;185061;3485;1014;224154;5200;1164;0;42
FR;5;2023-02-14;11;8;2;0;9;3;0;0;0;277569;185069;3487;1014;224163;5203;1164;0;42
FR;5;2023-02-15;27;25;4;0;27;5;0;0;0;277596;185094;3491;1014;224190;5208;1164;0;42
FR;5;2023-02-16;8;4;3;0;8;3;0;0;0;277604;185098;3494;1014;224198;5211;1164;0;42
FR;5;2023-02-17;9;5;9;0;6;9;0;0;0;277613;185103;3503;1014;224204;5220;1164;0;42
FR;5;2023-02-18;9;14;3;1;16;3;1;0;0;277622;185117;3506;1015;224220;5223;1165;0;42
FR;5;2023-02-19;0;1;0;0;1;0;0;0;0;277622;185118;3506;1015;224221;5223;1165;0;42
FR;5;2023-02-20;6;6;4;0;6;5;0;0;0;277628;185124;3510;1015;224227;5228;1165;0;42
FR;5;2023-02-21;4;6;5;0;7;5;0;0;0;277632;185130;3515;1015;224234;5233;1165;0;42
FR;5;2023-02-22;10;16;5;0;15;5;1;0;0;277642;185146;3520;1015;224249;5238;1166;0;42
FR;5;2023-02-23;5;5;2;0;5;2;0;0;0;277647;185151;3522;1015;224254;5240;1166;0;42
FR;5;2023-02-24;17;22;1;0;21;3;0;0;0;277664;185173;3523;1015;224275;5243;1166;0;42
FR;5;2023-02-25;11;9;0;0;9;0;0;0;0;277675;185182;3523;1015;224284;5243;1166;0;42
FR;5;2023-02-26;1;1;0;0;1;0;0;0;0;277676;185183;3523;1015;224285;5243;1166;0;42
FR;5;2023-02-27;7;5;2;0;5;2;0;0;0;277683;185188;3525;1015;224290;5245;1166;0;42
FR;5;2023-02-28;4;8;2;0;8;4;0;0;0;277687;185196;3527;1015;224298;5249;1166;0;42
FR;5;2023-03-01;12;25;1;0;23;3;1;0;0;277699;185221;3528;1015;224321;5252;1167;0;42
FR;5;2023-03-02;6;13;3;0;12;5;0;0;0;277705;185234;3531;1015;224333;5257;1167;0;42
FR;5;2023-03-03;9;4;3;0;8;3;1;0;0;277714;185238;3534;1015;224341;5260;1168;0;42
FR;5;2023-03-04;6;17;7;0;16;8;0;0;0;277720;185255;3541;1015;224357;5268;1168;0;42
FR;5;2023-03-05;3;3;0;0;3;0;0;0;0;277723;185258;3541;1015;224360;5268;1168;0;42
FR;5;2023-03-06;2;8;1;0;6;3;0;0;0;277725;185266;3542;1015;224366;5271;1168;0;42
FR;5;2023-03-07;2;8;2;0;8;2;0;0;0;277727;185274;3544;1015;224374;5273;1168;0;42
FR;5;2023-03-08;9;21;1;0;22;1;0;0;0;277736;185295;3545;1015;224396;5274;1168;0;42
FR;5;2023-03-09;1;6;0;0;5;1;0;0;0;277737;185301;3545;1015;224401;5275;1168;0;42
FR;5;2023-03-10;3;6;2;1;7;2;1;0;0;277740;185307;3547;1016;224408;5277;1169;0;42
FR;5;2023-03-11;5;2;0;0;4;0;0;0;0;277745;185309;3547;1016;224412;5277;1169;0;42
FR;5;2023-03-12;0;1;0;0;1;0;0;0;0;277745;185310;3547;1016;224413;5277;1169;0;42
FR;5;2023-03-13;2;2;0;0;4;0;0;0;0;277747;185312;3547;1016;224417;5277;1169;0;42
FR;5;2023-03-14;6;1;1;1;5;1;1;0;0;277753;185313;3548;1017;224422;5278;1170;0;42
FR;5;2023-03-15;7;8;2;0;12;3;0;0;0;277760;185321;3550;1017;224434;5281;1170;0;42
FR;5;2023-03-16;2;6;0;0;6;0;0;0;0;277762;185327;3550;1017;224440;5281;1170;0;42
FR;5;2023-03-17;14;15;3;0;13;4;1;0;0;277776;185342;3553;1017;224453;5285;1171;0;42
FR;5;2023-03-18;4;9;0;0;9;1;0;0;0;277780;185351;3553;1017;224462;5286;1171;0;42
FR;5;2023-03-19;0;0;0;0;0;0;0;0;0;277780;185351;3553;1017;224462;5286;1171;0;42
FR;5;2023-03-20;3;6;0;0;7;0;0;0;0;277783;185357;3553;1017;224469;5286;1171;0;42
FR;5;2023-03-21;2;7;2;2;7;2;2;0;0;277785;185364;3555;1019;224476;5288;1173;0;42
FR;5;2023-03-22;7;19;3;0;17;4;0;0;0;277792;185383;3558;1019;224493;5292;1173;0;42
FR;5;2023-03-23;2;5;1;0;5;1;0;0;0;277794;185388;3559;1019;224498;5293;1173;0;42
FR;5;2023-03-24;5;9;1;0;9;3;0;0;0;277799;185397;3560;1019;224507;5296;1173;0;42
FR;5;2023-03-25;3;8;1;0;8;1;0;0;0;277802;185405;3561;1019;224515;5297;1173;0;42
FR;5;2023-03-26;0;0;0;0;0;0;0;0;0;277802;185405;3561;1019;224515;5297;1173;0;42
FR;6;2020-12-27;0;0;0;0;0;0;0;0;0;0;0;0;0;0;0;0;0;0
FR;6;2020-12-28;0;0;0;0;0;0;0;0;0;0;0;0;0;0;0;0;0;0
FR;6;2020-12-29;0;0;0;0;0;0;0;0;0;0;0;0;0;0;0;0;0;0
FR;6;2020-12-30;0;0;0;0;0;0;0;0;0;0;0;0;0;0;0;0;0;0
FR;6;2020-12-31;0;0;0;0;0;0;0;0;0;0;0;0;0;0;0;0;0;0
FR;6;2021-01-01;0;0;0;0;0;0;0;0;0;0;0;0;0;0;0;0;0;0
FR;6;2021-01-02;0;0;0;0;0;0;0;0;0;0;0;0;0;0;0;0;0;0
FR;6;2021-01-03;0;0;0;0;0;0;0;0;0;0;0;0;0;0;0;0;0;0
FR;6;2021-01-04;0;0;0;0;0;0;0;0;0;0;0;0;0;0;0;0;0;0
FR;6;2021-01-05;0;0;0;0;0;0;0;0;0;0;0;0;0;0;0;0;0;0
FR;6;2021-01-06;0;0;0;0;0;0;0;0;0;0;0;0;0;0;0;0;0;0
FR;6;2021-01-07;0;0;0;0;0;0;0;0;0;0;0;0;0;0;0;0;0;0
FR;6;2021-01-08;0;0;0;0;0;0;0;0;0;0;0;0;0;0;0;0;0;0
FR;6;2021-01-09;0;0;0;0;0;0;0;0;0;0;0;0;0;0;0;0;0;0
FR;6;2021-01-10;0;0;0;0;0;0;0;0;0;0;0;0;0;0;0;0;0;0
FR;6;2021-01-11;0;0;0;0;0;0;0;0;0;0;0;0;0;0;0;0;0;0
FR;6;2021-01-12;0;0;0;0;0;0;0;0;0;0;0;0;0;0;0;0;0;0
FR;6;2021-01-13;0;0;0;0;0;0;0;0;0;0;0;0;0;0;0;0;0;0
FR;6;2021-01-14;0;0;0;0;0;0;0;0;0;0;0;0;0;0;0;0;0;0
FR;6;2021-01-15;0;0;0;0;0;0;0;0;0;0;0;0;0;0;0;0;0;0
FR;6;2021-01-16;0;0;0;0;0;0;0;0;0;0;0;0;0;0;0;0;0;0
FR;6;2021-01-17;0;0;0;0;0;0;0;0;0;0;0;0;0;0;0;0;0;0
FR;6;2021-01-18;0;0;0;0;0;0;0;0;0;0;0;0;0;0;0;0;0;0
FR;6;2021-01-19;0;0;0;0;0;0;0;0;0;0;0;0;0;0;0;0;0;0
FR;6;2021-01-20;0;0;0;0;0;0;0;0;0;0;0;0;0;0;0;0;0;0
FR;6;2021-01-21;0;0;0;0;0;0;0;0;0;0;0;0;0;0;0;0;0;0
FR;6;2021-01-22;0;0;0;0;0;0;0;0;0;0;0;0;0;0;0;0;0;0
FR;6;2021-01-23;0;0;0;0;0;0;0;0;0;0;0;0;0;0;0;0;0;0
FR;6;2021-01-24;0;0;0;0;0;0;0;0;0;0;0;0;0;0;0;0;0;0
FR;6;2021-01-25;0;0;0;0;0;0;0;0;0;0;0;0;0;0;0;0;0;0
FR;6;2021-01-26;0;0;0;0;0;0;0;0;0;0;0;0;0;0;0;0;0;0
FR;6;2021-01-27;0;0;0;0;0;0;0;0;0;0;0;0;0;0;0;0;0;0
FR;6;2021-01-28;0;0;0;0;0;0;0;0;0;0;0;0;0;0;0;0;0;0
FR;6;2021-01-29;0;0;0;0;0;0;0;0;0;0;0;0;0;0;0;0;0;0
FR;6;2021-01-30;0;0;0;0;0;0;0;0;0;0;0;0;0;0;0;0;0;0
FR;6;2021-01-31;0;0;0;0;0;0;0;0;0;0;0;0;0;0;0;0;0;0
FR;6;2021-02-01;0;0;0;0;0;0;0;0;0;0;0;0;0;0;0;0;0;0
FR;6;2021-02-02;0;0;0;0;0;0;0;0;0;0;0;0;0;0;0;0;0;0
FR;6;2021-02-03;0;0;0;0;0;0;0;0;0;0;0;0;0;0;0;0;0;0
FR;6;2021-02-04;0;0;0;0;0;0;0;0;0;0;0;0;0;0;0;0;0;0
FR;6;2021-02-05;0;0;0;0;0;0;0;0;0;0;0;0;0;0;0;0;0;0
FR;6;2021-02-06;0;0;0;0;0;0;0;0;0;0;0;0;0;0;0;0;0;0
FR;6;2021-02-07;0;0;0;0;0;0;0;0;0;0;0;0;0;0;0;0;0;0
FR;6;2021-02-08;0;0;0;0;0;0;0;0;0;0;0;0;0;0;0;0;0;0
FR;6;2021-02-09;0;0;0;0;0;0;0;0;0;0;0;0;0;0;0;0;0;0
FR;6;2021-02-10;0;0;0;0;0;0;0;0;0;0;0;0;0;0;0;0;0;0
FR;6;2021-02-11;0;0;0;0;0;0;0;0;0;0;0;0;0;0;0;0;0;0
FR;6;2021-02-12;0;0;0;0;0;0;0;0;0;0;0;0;0;0;0;0;0;0
FR;6;2021-02-13;0;0;0;0;0;0;0;0;0;0;0;0;0;0;0;0;0;0
FR;6;2021-02-14;0;0;0;0;0;0;0;0;0;0;0;0;0;0;0;0;0;0
FR;6;2021-02-15;0;0;0;0;0;0;0;0;0;0;0;0;0;0;0;0;0;0
FR;6;2021-02-16;0;0;0;0;0;0;0;0;0;0;0;0;0;0;0;0;0;0
FR;6;2021-02-17;0;0;0;0;0;0;0;0;0;0;0;0;0;0;0;0;0;0
FR;6;2021-02-18;0;0;0;0;0;0;0;0;0;0;0;0;0;0;0;0;0;0
FR;6;2021-02-19;0;0;0;0;0;0;0;0;0;0;0;0;0;0;0;0;0;0
FR;6;2021-02-20;0;0;0;0;0;0;0;0;0;0;0;0;0;0;0;0;0;0
FR;6;2021-02-21;0;0;0;0;0;0;0;0;0;0;0;0;0;0;0;0;0;0
FR;6;2021-02-22;0;0;0;0;0;0;0;0;0;0;0;0;0;0;0;0;0;0
FR;6;2021-02-23;0;0;0;0;0;0;0;0;0;0;0;0;0;0;0;0;0;0
FR;6;2021-02-24;0;0;0;0;0;0;0;0;0;0;0;0;0;0;0;0;0;0
FR;6;2021-02-25;0;0;0;0;0;0;0;0;0;0;0;0;0;0;0;0;0;0
FR;6;2021-02-26;0;0;0;0;0;0;0;0;0;0;0;0;0;0;0;0;0;0
FR;6;2021-02-27;0;0;0;0;0;0;0;0;0;0;0;0;0;0;0;0;0;0
FR;6;2021-02-28;0;0;0;0;0;0;0;0;0;0;0;0;0;0;0;0;0;0
FR;6;2021-03-01;0;0;0;0;0;0;0;0;0;0;0;0;0;0;0;0;0;0
FR;6;2021-03-02;0;0;0;0;0;0;0;0;0;0;0;0;0;0;0;0;0;0
FR;6;2021-03-03;0;0;0;0;0;0;0;0;0;0;0;0;0;0;0;0;0;0
FR;6;2021-03-04;0;0;0;0;0;0;0;0;0;0;0;0;0;0;0;0;0;0
FR;6;2021-03-05;0;0;0;0;0;0;0;0;0;0;0;0;0;0;0;0;0;0
FR;6;2021-03-06;0;0;0;0;0;0;0;0;0;0;0;0;0;0;0;0;0;0
FR;6;2021-03-07;0;0;0;0;0;0;0;0;0;0;0;0;0;0;0;0;0;0
FR;6;2021-03-08;0;0;0;0;0;0;0;0;0;0;0;0;0;0;0;0;0;0
FR;6;2021-03-09;0;0;0;0;0;0;0;0;0;0;0;0;0;0;0;0;0;0
FR;6;2021-03-10;0;0;0;0;0;0;0;0;0;0;0;0;0;0;0;0;0;0
FR;6;2021-03-11;0;0;0;0;0;0;0;0;0;0;0;0;0;0;0;0;0;0
FR;6;2021-03-12;0;0;0;0;0;0;0;0;0;0;0;0;0;0;0;0;0;0
FR;6;2021-03-13;0;0;0;0;0;0;0;0;0;0;0;0;0;0;0;0;0;0
FR;6;2021-03-14;0;0;0;0;0;0;0;0;0;0;0;0;0;0;0;0;0;0
FR;6;2021-03-15;0;0;0;0;0;0;0;0;0;0;0;0;0;0;0;0;0;0
FR;6;2021-03-16;0;0;0;0;0;0;0;0;0;0;0;0;0;0;0;0;0;0
FR;6;2021-03-17;0;0;0;0;0;0;0;0;0;0;0;0;0;0;0;0;0;0
FR;6;2021-03-18;0;0;0;0;0;0;0;0;0;0;0;0;0;0;0;0;0;0
FR;6;2021-03-19;0;0;0;0;0;0;0;0;0;0;0;0;0;0;0;0;0;0
FR;6;2021-03-20;0;0;0;0;0;0;0;0;0;0;0;0;0;0;0;0;0;0
FR;6;2021-03-21;0;0;0;0;0;0;0;0;0;0;0;0;0;0;0;0;0;0
FR;6;2021-03-22;0;0;0;0;0;0;0;0;0;0;0;0;0;0;0;0;0;0
FR;6;2021-03-23;0;0;0;0;0;0;0;0;0;0;0;0;0;0;0;0;0;0
FR;6;2021-03-24;0;0;0;0;0;0;0;0;0;0;0;0;0;0;0;0;0;0
FR;6;2021-03-25;0;0;0;0;0;0;0;0;0;0;0;0;0;0;0;0;0;0
FR;6;2021-03-26;0;0;0;0;0;0;0;0;0;0;0;0;0;0;0;0;0;0
FR;6;2021-03-27;0;0;0;0;0;0;0;0;0;0;0;0;0;0;0;0;0;0
FR;6;2021-03-28;0;0;0;0;0;0;0;0;0;0;0;0;0;0;0;0;0;0
FR;6;2021-03-29;0;0;0;0;0;0;0;0;0;0;0;0;0;0;0;0;0;0
FR;6;2021-03-30;0;0;0;0;0;0;0;0;0;0;0;0;0;0;0;0;0;0
FR;6;2021-03-31;0;0;0;0;0;0;0;0;0;0;0;0;0;0;0;0;0;0
FR;6;2021-04-01;0;0;0;0;0;0;0;0;0;0;0;0;0;0;0;0;0;0
FR;6;2021-04-02;0;0;0;0;0;0;0;0;0;0;0;0;0;0;0;0;0;0
FR;6;2021-04-03;0;0;0;0;0;0;0;0;0;0;0;0;0;0;0;0;0;0
FR;6;2021-04-04;0;0;0;0;0;0;0;0;0;0;0;0;0;0;0;0;0;0
FR;6;2021-04-05;0;0;0;0;0;0;0;0;0;0;0;0;0;0;0;0;0;0
FR;6;2021-04-06;0;0;0;0;0;0;0;0;0;0;0;0;0;0;0;0;0;0
FR;6;2021-04-07;0;0;0;0;0;0;0;0;0;0;0;0;0;0;0;0;0;0
FR;6;2021-04-08;0;0;0;0;0;0;0;0;0;0;0;0;0;0;0;0;0;0
FR;6;2021-04-09;0;0;0;0;0;0;0;0;0;0;0;0;0;0;0;0;0;0
FR;6;2021-04-10;0;0;0;0;0;0;0;0;0;0;0;0;0;0;0;0;0;0
FR;6;2021-04-11;0;0;0;0;0;0;0;0;0;0;0;0;0;0;0;0;0;0
FR;6;2021-04-12;0;0;0;0;0;0;0;0;0;0;0;0;0;0;0;0;0;0
FR;6;2021-04-13;0;0;0;0;0;0;0;0;0;0;0;0;0;0;0;0;0;0
FR;6;2021-04-14;0;0;0;0;0;0;0;0;0;0;0;0;0;0;0;0;0;0
FR;6;2021-04-15;0;0;0;0;0;0;0;0;0;0;0;0;0;0;0;0;0;0
FR;6;2021-04-16;0;0;0;0;0;0;0;0;0;0;0;0;0;0;0;0;0;0
FR;6;2021-04-17;0;0;0;0;0;0;0;0;0;0;0;0;0;0;0;0;0;0
FR;6;2021-04-18;0;0;0;0;0;0;0;0;0;0;0;0;0;0;0;0;0;0
FR;6;2021-04-19;0;0;0;0;0;0;0;0;0;0;0;0;0;0;0;0;0;0
FR;6;2021-04-20;0;0;0;0;0;0;0;0;0;0;0;0;0;0;0;0;0;0
FR;6;2021-04-21;0;0;0;0;0;0;0;0;0;0;0;0;0;0;0;0;0;0
FR;6;2021-04-22;0;0;0;0;0;0;0;0;0;0;0;0;0;0;0;0;0;0
FR;6;2021-04-23;0;0;0;0;0;0;0;0;0;0;0;0;0;0;0;0;0;0
FR;6;2021-04-24;0;0;0;0;0;0;0;0;0;0;0;0;0;0;0;0;0;0
FR;6;2021-04-25;0;0;0;0;0;0;0;0;0;0;0;0;0;0;0;0;0;0
FR;6;2021-04-26;0;0;0;0;0;0;0;0;0;0;0;0;0;0;0;0;0;0
FR;6;2021-04-27;0;0;0;0;0;0;0;0;0;0;0;0;0;0;0;0;0;0
FR;6;2021-04-28;0;0;0;0;0;0;0;0;0;0;0;0;0;0;0;0;0;0
FR;6;2021-04-29;0;0;0;0;0;0;0;0;0;0;0;0;0;0;0;0;0;0
FR;6;2021-04-30;0;0;0;0;0;0;0;0;0;0;0;0;0;0;0;0;0;0
FR;6;2021-05-01;0;0;0;0;0;0;0;0;0;0;0;0;0;0;0;0;0;0
FR;6;2021-05-02;0;0;0;0;0;0;0;0;0;0;0;0;0;0;0;0;0;0
FR;6;2021-05-03;0;0;0;0;0;0;0;0;0;0;0;0;0;0;0;0;0;0
FR;6;2021-05-04;0;0;0;0;0;0;0;0;0;0;0;0;0;0;0;0;0;0
FR;6;2021-05-05;0;0;0;0;0;0;0;0;0;0;0;0;0;0;0;0;0;0
FR;6;2021-05-06;0;0;0;0;0;0;0;0;0;0;0;0;0;0;0;0;0;0
FR;6;2021-05-07;0;0;0;0;0;0;0;0;0;0;0;0;0;0;0;0;0;0
FR;6;2021-05-08;0;0;0;0;0;0;0;0;0;0;0;0;0;0;0;0;0;0
FR;6;2021-05-09;0;0;0;0;0;0;0;0;0;0;0;0;0;0;0;0;0;0
FR;6;2021-05-10;0;0;0;0;0;0;0;0;0;0;0;0;0;0;0;0;0;0
FR;6;2021-05-11;0;0;0;0;0;0;0;0;0;0;0;0;0;0;0;0;0;0
FR;6;2021-05-12;0;0;0;0;0;0;0;0;0;0;0;0;0;0;0;0;0;0
FR;6;2021-05-13;0;0;0;0;0;0;0;0;0;0;0;0;0;0;0;0;0;0
FR;6;2021-05-14;0;0;0;0;0;0;0;0;0;0;0;0;0;0;0;0;0;0
FR;6;2021-05-15;0;0;0;0;0;0;0;0;0;0;0;0;0;0;0;0;0;0
FR;6;2021-05-16;0;0;0;0;0;0;0;0;0;0;0;0;0;0;0;0;0;0
FR;6;2021-05-17;0;0;0;0;0;0;0;0;0;0;0;0;0;0;0;0;0;0
FR;6;2021-05-18;0;0;0;0;0;0;0;0;0;0;0;0;0;0;0;0;0;0
FR;6;2021-05-19;0;0;0;0;0;0;0;0;0;0;0;0;0;0;0;0;0;0
FR;6;2021-05-20;0;0;0;0;0;0;0;0;0;0;0;0;0;0;0;0;0;0
FR;6;2021-05-21;0;0;0;0;0;0;0;0;0;0;0;0;0;0;0;0;0;0
FR;6;2021-05-22;0;0;0;0;0;0;0;0;0;0;0;0;0;0;0;0;0;0
FR;6;2021-05-23;0;0;0;0;0;0;0;0;0;0;0;0;0;0;0;0;0;0
FR;6;2021-05-24;0;0;0;0;0;0;0;0;0;0;0;0;0;0;0;0;0;0
FR;6;2021-05-25;0;0;0;0;0;0;0;0;0;0;0;0;0;0;0;0;0;0
FR;6;2021-05-26;0;0;0;0;0;0;0;0;0;0;0;0;0;0;0;0;0;0
FR;6;2021-05-27;0;0;0;0;0;0;0;0;0;0;0;0;0;0;0;0;0;0
FR;6;2021-05-28;0;0;0;0;0;0;0;0;0;0;0;0;0;0;0;0;0;0
FR;6;2021-05-29;0;0;0;0;0;0;0;0;0;0;0;0;0;0;0;0;0;0
FR;6;2021-05-30;0;0;0;0;0;0;0;0;0;0;0;0;0;0;0;0;0;0
FR;6;2021-05-31;0;0;0;0;0;0;0;0;0;0;0;0;0;0;0;0;0;0
FR;6;2021-06-01;0;0;0;0;0;0;0;0;0;0;0;0;0;0;0;0;0;0
FR;6;2021-06-02;0;0;0;0;0;0;0;0;0;0;0;0;0;0;0;0;0;0
FR;6;2021-06-03;0;0;0;0;0;0;0;0;0;0;0;0;0;0;0;0;0;0
FR;6;2021-06-04;0;0;0;0;0;0;0;0;0;0;0;0;0;0;0;0;0;0
FR;6;2021-06-05;0;0;0;0;0;0;0;0;0;0;0;0;0;0;0;0;0;0
FR;6;2021-06-06;0;0;0;0;0;0;0;0;0;0;0;0;0;0;0;0;0;0
FR;6;2021-06-07;0;0;0;0;0;0;0;0;0;0;0;0;0;0;0;0;0;0
FR;6;2021-06-08;0;0;0;0;0;0;0;0;0;0;0;0;0;0;0;0;0;0
FR;6;2021-06-09;0;0;0;0;0;0;0;0;0;0;0;0;0;0;0;0;0;0
FR;6;2021-06-10;0;0;0;0;0;0;0;0;0;0;0;0;0;0;0;0;0;0
FR;6;2021-06-11;0;0;0;0;0;0;0;0;0;0;0;0;0;0;0;0;0;0
FR;6;2021-06-12;0;0;0;0;0;0;0;0;0;0;0;0;0;0;0;0;0;0
FR;6;2021-06-13;0;0;0;0;0;0;0;0;0;0;0;0;0;0;0;0;0;0
FR;6;2021-06-14;0;0;0;0;0;0;0;0;0;0;0;0;0;0;0;0;0;0
FR;6;2021-06-15;0;0;0;0;0;0;0;0;0;0;0;0;0;0;0;0;0;0
FR;6;2021-06-16;0;0;0;0;0;0;0;0;0;0;0;0;0;0;0;0;0;0
FR;6;2021-06-17;0;0;0;0;0;0;0;0;0;0;0;0;0;0;0;0;0;0
FR;6;2021-06-18;0;0;0;0;0;0;0;0;0;0;0;0;0;0;0;0;0;0
FR;6;2021-06-19;0;0;0;0;0;0;0;0;0;0;0;0;0;0;0;0;0;0
FR;6;2021-06-20;0;0;0;0;0;0;0;0;0;0;0;0;0;0;0;0;0;0
FR;6;2021-06-21;0;0;0;0;0;0;0;0;0;0;0;0;0;0;0;0;0;0
FR;6;2021-06-22;0;0;0;0;0;0;0;0;0;0;0;0;0;0;0;0;0;0
FR;6;2021-06-23;0;0;0;0;0;0;0;0;0;0;0;0;0;0;0;0;0;0
FR;6;2021-06-24;0;0;0;0;0;0;0;0;0;0;0;0;0;0;0;0;0;0
FR;6;2021-06-25;0;0;0;0;0;0;0;0;0;0;0;0;0;0;0;0;0;0
FR;6;2021-06-26;0;0;0;0;0;0;0;0;0;0;0;0;0;0;0;0;0;0
FR;6;2021-06-27;0;0;0;0;0;0;0;0;0;0;0;0;0;0;0;0;0;0
FR;6;2021-06-28;0;0;0;0;0;0;0;0;0;0;0;0;0;0;0;0;0;0
FR;6;2021-06-29;0;0;0;0;0;0;0;0;0;0;0;0;0;0;0;0;0;0
FR;6;2021-06-30;0;0;0;0;0;0;0;0;0;0;0;0;0;0;0;0;0;0
FR;6;2021-07-01;0;0;0;0;0;0;0;0;0;0;0;0;0;0;0;0;0;0
FR;6;2021-07-02;0;0;0;0;0;0;0;0;0;0;0;0;0;0;0;0;0;0
FR;6;2021-07-03;0;0;0;0;0;0;0;0;0;0;0;0;0;0;0;0;0;0
FR;6;2021-07-04;0;0;0;0;0;0;0;0;0;0;0;0;0;0;0;0;0;0
FR;6;2021-07-05;0;0;0;0;0;0;0;0;0;0;0;0;0;0;0;0;0;0
FR;6;2021-07-06;0;0;0;0;0;0;0;0;0;0;0;0;0;0;0;0;0;0
FR;6;2021-07-07;0;0;0;0;0;0;0;0;0;0;0;0;0;0;0;0;0;0
FR;6;2021-07-08;0;0;0;0;0;0;0;0;0;0;0;0;0;0;0;0;0;0
FR;6;2021-07-09;0;0;0;0;0;0;0;0;0;0;0;0;0;0;0;0;0;0
FR;6;2021-07-10;0;0;0;0;0;0;0;0;0;0;0;0;0;0;0;0;0;0
FR;6;2021-07-11;0;0;0;0;0;0;0;0;0;0;0;0;0;0;0;0;0;0
FR;6;2021-07-12;0;0;0;0;0;0;0;0;0;0;0;0;0;0;0;0;0;0
FR;6;2021-07-13;0;0;0;0;0;0;0;0;0;0;0;0;0;0;0;0;0;0
FR;6;2021-07-14;0;0;0;0;0;0;0;0;0;0;0;0;0;0;0;0;0;0
FR;6;2021-07-15;0;0;0;0;0;0;0;0;0;0;0;0;0;0;0;0;0;0
FR;6;2021-07-16;0;0;0;0;0;0;0;0;0;0;0;0;0;0;0;0;0;0
FR;6;2021-07-17;0;0;0;0;0;0;0;0;0;0;0;0;0;0;0;0;0;0
FR;6;2021-07-18;0;0;0;0;0;0;0;0;0;0;0;0;0;0;0;0;0;0
FR;6;2021-07-19;0;0;0;0;0;0;0;0;0;0;0;0;0;0;0;0;0;0
FR;6;2021-07-20;0;0;0;0;0;0;0;0;0;0;0;0;0;0;0;0;0;0
FR;6;2021-07-21;0;0;0;0;0;0;0;0;0;0;0;0;0;0;0;0;0;0
FR;6;2021-07-22;0;0;0;0;0;0;0;0;0;0;0;0;0;0;0;0;0;0
FR;6;2021-07-23;0;0;0;0;0;0;0;0;0;0;0;0;0;0;0;0;0;0
FR;6;2021-07-24;0;0;0;0;0;0;0;0;0;0;0;0;0;0;0;0;0;0
FR;6;2021-07-25;0;0;0;0;0;0;0;0;0;0;0;0;0;0;0;0;0;0
FR;6;2021-07-26;0;0;0;0;0;0;0;0;0;0;0;0;0;0;0;0;0;0
FR;6;2021-07-27;0;0;0;0;0;0;0;0;0;0;0;0;0;0;0;0;0;0
FR;6;2021-07-28;0;0;0;0;0;0;0;0;0;0;0;0;0;0;0;0;0;0
FR;6;2021-07-29;0;0;0;0;0;0;0;0;0;0;0;0;0;0;0;0;0;0
FR;6;2021-07-30;0;0;0;0;0;0;0;0;0;0;0;0;0;0;0;0;0;0
FR;6;2021-07-31;0;0;0;0;0;0;0;0;0;0;0;0;0;0;0;0;0;0
FR;6;2021-08-01;0;0;0;0;0;0;0;0;0;0;0;0;0;0;0;0;0;0
FR;6;2021-08-02;0;0;0;0;0;0;0;0;0;0;0;0;0;0;0;0;0;0
FR;6;2021-08-03;0;0;0;0;0;0;0;0;0;0;0;0;0;0;0;0;0;0
FR;6;2021-08-04;0;0;0;0;0;0;0;0;0;0;0;0;0;0;0;0;0;0
FR;6;2021-08-05;0;0;0;0;0;0;0;0;0;0;0;0;0;0;0;0;0;0
FR;6;2021-08-06;0;0;0;0;0;0;0;0;0;0;0;0;0;0;0;0;0;0
FR;6;2021-08-07;0;0;0;0;0;0;0;0;0;0;0;0;0;0;0;0;0;0
FR;6;2021-08-08;0;0;0;0;0;0;0;0;0;0;0;0;0;0;0;0;0;0
FR;6;2021-08-09;0;0;0;0;0;0;0;0;0;0;0;0;0;0;0;0;0;0
FR;6;2021-08-10;0;0;0;0;0;0;0;0;0;0;0;0;0;0;0;0;0;0
FR;6;2021-08-11;0;0;0;0;0;0;0;0;0;0;0;0;0;0;0;0;0;0
FR;6;2021-08-12;0;0;0;0;0;0;0;0;0;0;0;0;0;0;0;0;0;0
FR;6;2021-08-13;0;0;0;0;0;0;0;0;0;0;0;0;0;0;0;0;0;0
FR;6;2021-08-14;0;0;0;0;0;0;0;0;0;0;0;0;0;0;0;0;0;0
FR;6;2021-08-15;0;0;0;0;0;0;0;0;0;0;0;0;0;0;0;0;0;0
FR;6;2021-08-16;0;0;0;0;0;0;0;0;0;0;0;0;0;0;0;0;0;0
FR;6;2021-08-17;0;0;0;0;0;0;0;0;0;0;0;0;0;0;0;0;0;0
FR;6;2021-08-18;0;0;0;0;0;0;0;0;0;0;0;0;0;0;0;0;0;0
FR;6;2021-08-19;0;0;0;0;0;0;0;0;0;0;0;0;0;0;0;0;0;0
FR;6;2021-08-20;0;0;0;0;0;0;0;0;0;0;0;0;0;0;0;0;0;0
FR;6;2021-08-21;0;0;0;0;0;0;0;0;0;0;0;0;0;0;0;0;0;0
FR;6;2021-08-22;0;0;0;0;0;0;0;0;0;0;0;0;0;0;0;0;0;0
FR;6;2021-08-23;0;0;0;0;0;0;0;0;0;0;0;0;0;0;0;0;0;0
FR;6;2021-08-24;0;0;0;0;0;0;0;0;0;0;0;0;0;0;0;0;0;0
FR;6;2021-08-25;0;0;0;0;0;0;0;0;0;0;0;0;0;0;0;0;0;0
FR;6;2021-08-26;0;0;0;0;0;0;0;0;0;0;0;0;0;0;0;0;0;0
FR;6;2021-08-27;0;0;0;0;0;0;0;0;0;0;0;0;0;0;0;0;0;0
FR;6;2021-08-28;0;0;0;0;0;0;0;0;0;0;0;0;0;0;0;0;0;0
FR;6;2021-08-29;0;0;0;0;0;0;0;0;0;0;0;0;0;0;0;0;0;0
FR;6;2021-08-30;0;0;0;0;0;0;0;0;0;0;0;0;0;0;0;0;0;0
FR;6;2021-08-31;0;0;0;0;0;0;0;0;0;0;0;0;0;0;0;0;0;0
FR;6;2021-09-01;0;0;0;0;0;0;0;0;0;0;0;0;0;0;0;0;0;0
FR;6;2021-09-02;0;0;0;0;0;0;0;0;0;0;0;0;0;0;0;0;0;0
FR;6;2021-09-03;0;0;0;0;0;0;0;0;0;0;0;0;0;0;0;0;0;0
FR;6;2021-09-04;0;0;0;0;0;0;0;0;0;0;0;0;0;0;0;0;0;0
FR;6;2021-09-05;0;0;0;0;0;0;0;0;0;0;0;0;0;0;0;0;0;0
FR;6;2021-09-06;0;0;0;0;0;0;0;0;0;0;0;0;0;0;0;0;0;0
FR;6;2021-09-07;0;0;0;0;0;0;0;0;0;0;0;0;0;0;0;0;0;0
FR;6;2021-09-08;0;0;0;0;0;0;0;0;0;0;0;0;0;0;0;0;0;0
FR;6;2021-09-09;0;0;0;0;0;0;0;0;0;0;0;0;0;0;0;0;0;0
FR;6;2021-09-10;0;0;0;0;0;0;0;0;0;0;0;0;0;0;0;0;0;0
FR;6;2021-09-11;0;0;0;0;0;0;0;0;0;0;0;0;0;0;0;0;0;0
FR;6;2021-09-12;0;0;0;0;0;0;0;0;0;0;0;0;0;0;0;0;0;0
FR;6;2021-09-13;0;0;0;0;0;0;0;0;0;0;0;0;0;0;0;0;0;0
FR;6;2021-09-14;0;0;0;0;0;0;0;0;0;0;0;0;0;0;0;0;0;0
FR;6;2021-09-15;0;0;0;0;0;0;0;0;0;0;0;0;0;0;0;0;0;0
FR;6;2021-09-16;0;0;0;0;0;0;0;0;0;0;0;0;0;0;0;0;0;0
FR;6;2021-09-17;0;0;0;0;0;0;0;0;0;0;0;0;0;0;0;0;0;0
FR;6;2021-09-18;0;0;0;0;0;0;0;0;0;0;0;0;0;0;0;0;0;0
FR;6;2021-09-19;0;0;0;0;0;0;0;0;0;0;0;0;0;0;0;0;0;0
FR;6;2021-09-20;0;0;0;0;0;0;0;0;0;0;0;0;0;0;0;0;0;0
FR;6;2021-09-21;0;0;0;0;0;0;0;0;0;0;0;0;0;0;0;0;0;0
FR;6;2021-09-22;0;0;0;0;0;0;0;0;0;0;0;0;0;0;0;0;0;0
FR;6;2021-09-23;0;0;0;0;0;0;0;0;0;0;0;0;0;0;0;0;0;0
FR;6;2021-09-24;0;0;0;0;0;0;0;0;0;0;0;0;0;0;0;0;0;0
FR;6;2021-09-25;0;0;0;0;0;0;0;0;0;0;0;0;0;0;0;0;0;0
FR;6;2021-09-26;0;0;0;0;0;0;0;0;0;0;0;0;0;0;0;0;0;0
FR;6;2021-09-27;0;0;0;0;0;0;0;0;0;0;0;0;0;0;0;0;0;0
FR;6;2021-09-28;0;0;0;0;0;0;0;0;0;0;0;0;0;0;0;0;0;0
FR;6;2021-09-29;0;0;0;0;0;0;0;0;0;0;0;0;0;0;0;0;0;0
FR;6;2021-09-30;0;0;0;0;0;0;0;0;0;0;0;0;0;0;0;0;0;0
FR;6;2021-10-01;0;0;0;0;0;0;0;0;0;0;0;0;0;0;0;0;0;0
FR;6;2021-10-02;0;0;0;0;0;0;0;0;0;0;0;0;0;0;0;0;0;0
FR;6;2021-10-03;0;0;0;0;0;0;0;0;0;0;0;0;0;0;0;0;0;0
FR;6;2021-10-04;0;0;0;0;0;0;0;0;0;0;0;0;0;0;0;0;0;0
FR;6;2021-10-05;0;0;0;0;0;0;0;0;0;0;0;0;0;0;0;0;0;0
FR;6;2021-10-06;0;0;0;0;0;0;0;0;0;0;0;0;0;0;0;0;0;0
FR;6;2021-10-07;0;0;0;0;0;0;0;0;0;0;0;0;0;0;0;0;0;0
FR;6;2021-10-08;0;0;0;0;0;0;0;0;0;0;0;0;0;0;0;0;0;0
FR;6;2021-10-09;0;0;0;0;0;0;0;0;0;0;0;0;0;0;0;0;0;0
FR;6;2021-10-10;0;0;0;0;0;0;0;0;0;0;0;0;0;0;0;0;0;0
FR;6;2021-10-11;0;0;0;0;0;0;0;0;0;0;0;0;0;0;0;0;0;0
FR;6;2021-10-12;0;0;0;0;0;0;0;0;0;0;0;0;0;0;0;0;0;0
FR;6;2021-10-13;0;0;0;0;0;0;0;0;0;0;0;0;0;0;0;0;0;0
FR;6;2021-10-14;0;0;0;0;0;0;0;0;0;0;0;0;0;0;0;0;0;0
FR;6;2021-10-15;0;0;0;0;0;0;0;0;0;0;0;0;0;0;0;0;0;0
FR;6;2021-10-16;0;0;0;0;0;0;0;0;0;0;0;0;0;0;0;0;0;0
FR;6;2021-10-17;0;0;0;0;0;0;0;0;0;0;0;0;0;0;0;0;0;0
FR;6;2021-10-18;0;0;0;0;0;0;0;0;0;0;0;0;0;0;0;0;0;0
FR;6;2021-10-19;0;0;0;0;0;0;0;0;0;0;0;0;0;0;0;0;0;0
FR;6;2021-10-20;0;0;0;0;0;0;0;0;0;0;0;0;0;0;0;0;0;0
FR;6;2021-10-21;0;0;0;0;0;0;0;0;0;0;0;0;0;0;0;0;0;0
FR;6;2021-10-22;0;0;0;0;0;0;0;0;0;0;0;0;0;0;0;0;0;0
FR;6;2021-10-23;0;0;0;0;0;0;0;0;0;0;0;0;0;0;0;0;0;0
FR;6;2021-10-24;0;0;0;0;0;0;0;0;0;0;0;0;0;0;0;0;0;0
FR;6;2021-10-25;0;0;0;0;0;0;0;0;0;0;0;0;0;0;0;0;0;0
FR;6;2021-10-26;0;0;0;0;0;0;0;0;0;0;0;0;0;0;0;0;0;0
FR;6;2021-10-27;0;0;0;0;0;0;0;0;0;0;0;0;0;0;0;0;0;0
FR;6;2021-10-28;0;0;0;0;0;0;0;0;0;0;0;0;0;0;0;0;0;0
FR;6;2021-10-29;0;0;0;0;0;0;0;0;0;0;0;0;0;0;0;0;0;0
FR;6;2021-10-30;0;0;0;0;0;0;0;0;0;0;0;0;0;0;0;0;0;0
FR;6;2021-10-31;0;0;0;0;0;0;0;0;0;0;0;0;0;0;0;0;0;0
FR;6;2021-11-01;0;0;0;0;0;0;0;0;0;0;0;0;0;0;0;0;0;0
FR;6;2021-11-02;0;0;0;0;0;0;0;0;0;0;0;0;0;0;0;0;0;0
FR;6;2021-11-03;0;0;0;0;0;0;0;0;0;0;0;0;0;0;0;0;0;0
FR;6;2021-11-04;0;0;0;0;0;0;0;0;0;0;0;0;0;0;0;0;0;0
FR;6;2021-11-05;0;0;0;0;0;0;0;0;0;0;0;0;0;0;0;0;0;0
FR;6;2021-11-06;0;0;0;0;0;0;0;0;0;0;0;0;0;0;0;0;0;0
FR;6;2021-11-07;0;0;0;0;0;0;0;0;0;0;0;0;0;0;0;0;0;0
FR;6;2021-11-08;0;0;0;0;0;0;0;0;0;0;0;0;0;0;0;0;0;0
FR;6;2021-11-09;0;0;0;0;0;0;0;0;0;0;0;0;0;0;0;0;0;0
FR;6;2021-11-10;0;0;0;0;0;0;0;0;0;0;0;0;0;0;0;0;0;0
FR;6;2021-11-11;0;0;0;0;0;0;0;0;0;0;0;0;0;0;0;0;0;0
FR;6;2021-11-12;0;0;0;0;0;0;0;0;0;0;0;0;0;0;0;0;0;0
FR;6;2021-11-13;0;0;0;0;0;0;0;0;0;0;0;0;0;0;0;0;0;0
FR;6;2021-11-14;0;0;0;0;0;0;0;0;0;0;0;0;0;0;0;0;0;0
FR;6;2021-11-15;0;0;0;0;0;0;0;0;0;0;0;0;0;0;0;0;0;0
FR;6;2021-11-16;0;0;0;0;0;0;0;0;0;0;0;0;0;0;0;0;0;0
FR;6;2021-11-17;0;0;0;0;0;0;0;0;0;0;0;0;0;0;0;0;0;0
FR;6;2021-11-18;0;0;0;0;0;0;0;0;0;0;0;0;0;0;0;0;0;0
FR;6;2021-11-19;0;0;0;0;0;0;0;0;0;0;0;0;0;0;0;0;0;0
FR;6;2021-11-20;0;0;0;0;0;0;0;0;0;0;0;0;0;0;0;0;0;0
FR;6;2021-11-21;0;0;0;0;0;0;0;0;0;0;0;0;0;0;0;0;0;0
FR;6;2021-11-22;0;0;0;0;0;0;0;0;0;0;0;0;0;0;0;0;0;0
FR;6;2021-11-23;0;0;0;0;0;0;0;0;0;0;0;0;0;0;0;0;0;0
FR;6;2021-11-24;0;0;0;0;0;0;0;0;0;0;0;0;0;0;0;0;0;0
FR;6;2021-11-25;0;0;0;0;0;0;0;0;0;0;0;0;0;0;0;0;0;0
FR;6;2021-11-26;0;0;0;0;0;0;0;0;0;0;0;0;0;0;0;0;0;0
FR;6;2021-11-27;0;0;0;0;0;0;0;0;0;0;0;0;0;0;0;0;0;0
FR;6;2021-11-28;0;0;0;0;0;0;0;0;0;0;0;0;0;0;0;0;0;0
FR;6;2021-11-29;0;0;0;0;0;0;0;0;0;0;0;0;0;0;0;0;0;0
FR;6;2021-11-30;0;0;0;0;0;0;0;0;0;0;0;0;0;0;0;0;0;0
FR;6;2021-12-01;0;0;0;0;0;0;0;0;0;0;0;0;0;0;0;0;0;0
FR;6;2021-12-02;0;0;0;0;0;0;0;0;0;0;0;0;0;0;0;0;0;0
FR;6;2021-12-03;0;0;0;0;0;0;0;0;0;0;0;0;0;0;0;0;0;0
FR;6;2021-12-04;0;0;0;0;0;0;0;0;0;0;0;0;0;0;0;0;0;0
FR;6;2021-12-05;0;0;0;0;0;0;0;0;0;0;0;0;0;0;0;0;0;0
FR;6;2021-12-06;0;0;0;0;0;0;0;0;0;0;0;0;0;0;0;0;0;0
FR;6;2021-12-07;0;0;0;0;0;0;0;0;0;0;0;0;0;0;0;0;0;0
FR;6;2021-12-08;0;0;0;0;0;0;0;0;0;0;0;0;0;0;0;0;0;0
FR;6;2021-12-09;0;0;0;0;0;0;0;0;0;0;0;0;0;0;0;0;0;0
FR;6;2021-12-10;0;0;0;0;0;0;0;0;0;0;0;0;0;0;0;0;0;0
FR;6;2021-12-11;0;0;0;0;0;0;0;0;0;0;0;0;0;0;0;0;0;0
FR;6;2021-12-12;0;0;0;0;0;0;0;0;0;0;0;0;0;0;0;0;0;0
FR;6;2021-12-13;0;0;0;0;0;0;0;0;0;0;0;0;0;0;0;0;0;0
FR;6;2021-12-14;0;0;0;0;0;0;0;0;0;0;0;0;0;0;0;0;0;0
FR;6;2021-12-15;0;0;0;0;0;0;0;0;0;0;0;0;0;0;0;0;0;0
FR;6;2021-12-16;0;0;0;0;0;0;0;0;0;0;0;0;0;0;0;0;0;0
FR;6;2021-12-17;0;0;0;0;0;0;0;0;0;0;0;0;0;0;0;0;0;0
FR;6;2021-12-18;0;0;0;0;0;0;0;0;0;0;0;0;0;0;0;0;0;0
FR;6;2021-12-19;0;0;0;0;0;0;0;0;0;0;0;0;0;0;0;0;0;0
FR;6;2021-12-20;0;0;0;0;0;0;0;0;0;0;0;0;0;0;0;0;0;0
FR;6;2021-12-21;0;0;0;0;0;0;0;0;0;0;0;0;0;0;0;0;0;0
FR;6;2021-12-22;0;0;0;0;0;0;0;0;0;0;0;0;0;0;0;0;0;0
FR;6;2021-12-23;0;0;0;0;0;0;0;0;0;0;0;0;0;0;0;0;0;0
FR;6;2021-12-24;0;0;0;0;0;0;0;0;0;0;0;0;0;0;0;0;0;0
FR;6;2021-12-25;0;0;0;0;0;0;0;0;0;0;0;0;0;0;0;0;0;0
FR;6;2021-12-26;0;0;0;0;0;0;0;0;0;0;0;0;0;0;0;0;0;0
FR;6;2021-12-27;0;0;0;0;0;0;0;0;0;0;0;0;0;0;0;0;0;0
FR;6;2021-12-28;0;0;0;0;0;0;0;0;0;0;0;0;0;0;0;0;0;0
FR;6;2021-12-29;0;0;0;0;0;0;0;0;0;0;0;0;0;0;0;0;0;0
FR;6;2021-12-30;0;0;0;0;0;0;0;0;0;0;0;0;0;0;0;0;0;0
FR;6;2021-12-31;0;0;0;0;0;0;0;0;0;0;0;0;0;0;0;0;0;0
FR;6;2022-01-01;0;0;0;0;0;0;0;0;0;0;0;0;0;0;0;0;0;0
FR;6;2022-01-02;0;0;0;0;0;0;0;0;0;0;0;0;0;0;0;0;0;0
FR;6;2022-01-03;0;0;0;0;0;0;0;0;0;0;0;0;0;0;0;0;0;0
FR;6;2022-01-04;0;0;0;0;0;0;0;0;0;0;0;0;0;0;0;0;0;0
FR;6;2022-01-05;0;0;0;0;0;0;0;0;0;0;0;0;0;0;0;0;0;0
FR;6;2022-01-06;0;0;0;0;0;0;0;0;0;0;0;0;0;0;0;0;0;0
FR;6;2022-01-07;0;0;0;0;0;0;0;0;0;0;0;0;0;0;0;0;0;0
FR;6;2022-01-08;0;0;0;0;0;0;0;0;0;0;0;0;0;0;0;0;0;0
FR;6;2022-01-09;0;0;0;0;0;0;0;0;0;0;0;0;0;0;0;0;0;0
FR;6;2022-01-10;0;0;0;0;0;0;0;0;0;0;0;0;0;0;0;0;0;0
FR;6;2022-01-11;0;0;0;0;0;0;0;0;0;0;0;0;0;0;0;0;0;0
FR;6;2022-01-12;0;0;0;0;0;0;0;0;0;0;0;0;0;0;0;0;0;0
FR;6;2022-01-13;0;0;0;0;0;0;0;0;0;0;0;0;0;0;0;0;0;0
FR;6;2022-01-14;0;0;0;0;0;0;0;0;0;0;0;0;0;0;0;0;0;0
FR;6;2022-01-15;0;0;0;0;0;0;0;0;0;0;0;0;0;0;0;0;0;0
FR;6;2022-01-16;0;0;0;0;0;0;0;0;0;0;0;0;0;0;0;0;0;0
FR;6;2022-01-17;0;0;0;0;0;0;0;0;0;0;0;0;0;0;0;0;0;0
FR;6;2022-01-18;0;0;0;0;0;0;0;0;0;0;0;0;0;0;0;0;0;0
FR;6;2022-01-19;0;0;0;0;0;0;0;0;0;0;0;0;0;0;0;0;0;0
FR;6;2022-01-20;0;0;0;0;0;0;0;0;0;0;0;0;0;0;0;0;0;0
FR;6;2022-01-21;0;0;0;0;0;0;0;0;0;0;0;0;0;0;0;0;0;0
FR;6;2022-01-22;0;0;0;0;0;0;0;0;0;0;0;0;0;0;0;0;0;0
FR;6;2022-01-23;0;0;0;0;0;0;0;0;0;0;0;0;0;0;0;0;0;0
FR;6;2022-01-24;0;0;0;0;0;0;0;0;0;0;0;0;0;0;0;0;0;0
FR;6;2022-01-25;0;0;0;0;0;0;0;0;0;0;0;0;0;0;0;0;0;0
FR;6;2022-01-26;0;0;0;0;0;0;0;0;0;0;0;0;0;0;0;0;0;0
FR;6;2022-01-27;0;0;0;0;0;0;0;0;0;0;0;0;0;0;0;0;0;0
FR;6;2022-01-28;0;0;0;0;0;0;0;0;0;0;0;0;0;0;0;0;0;0
FR;6;2022-01-29;0;0;0;0;0;0;0;0;0;0;0;0;0;0;0;0;0;0
FR;6;2022-01-30;0;0;0;0;0;0;0;0;0;0;0;0;0;0;0;0;0;0
FR;6;2022-01-31;0;0;0;0;0;0;0;0;0;0;0;0;0;0;0;0;0;0
FR;6;2022-02-01;0;0;0;0;0;0;0;0;0;0;0;0;0;0;0;0;0;0
FR;6;2022-02-02;0;0;0;0;0;0;0;0;0;0;0;0;0;0;0;0;0;0
FR;6;2022-02-03;0;0;0;0;0;0;0;0;0;0;0;0;0;0;0;0;0;0
FR;6;2022-02-04;0;0;0;0;0;0;0;0;0;0;0;0;0;0;0;0;0;0
FR;6;2022-02-05;0;0;0;0;0;0;0;0;0;0;0;0;0;0;0;0;0;0
FR;6;2022-02-06;0;0;0;0;0;0;0;0;0;0;0;0;0;0;0;0;0;0
FR;6;2022-02-07;0;0;0;0;0;0;0;0;0;0;0;0;0;0;0;0;0;0
FR;6;2022-02-08;0;0;0;0;0;0;0;0;0;0;0;0;0;0;0;0;0;0
FR;6;2022-02-09;0;0;0;0;0;0;0;0;0;0;0;0;0;0;0;0;0;0
FR;6;2022-02-10;0;0;0;0;0;0;0;0;0;0;0;0;0;0;0;0;0;0
FR;6;2022-02-11;0;0;0;0;0;0;0;0;0;0;0;0;0;0;0;0;0;0
FR;6;2022-02-12;0;0;0;0;0;0;0;0;0;0;0;0;0;0;0;0;0;0
FR;6;2022-02-13;0;0;0;0;0;0;0;0;0;0;0;0;0;0;0;0;0;0
FR;6;2022-02-14;0;0;0;0;0;0;0;0;0;0;0;0;0;0;0;0;0;0
FR;6;2022-02-15;0;0;0;0;0;0;0;0;0;0;0;0;0;0;0;0;0;0
FR;6;2022-02-16;0;0;0;0;0;0;0;0;0;0;0;0;0;0;0;0;0;0
FR;6;2022-02-17;0;0;0;0;0;0;0;0;0;0;0;0;0;0;0;0;0;0
FR;6;2022-02-18;0;0;0;0;0;0;0;0;0;0;0;0;0;0;0;0;0;0
FR;6;2022-02-19;0;0;0;0;0;0;0;0;0;0;0;0;0;0;0;0;0;0
FR;6;2022-02-20;0;0;0;0;0;0;0;0;0;0;0;0;0;0;0;0;0;0
FR;6;2022-02-21;0;0;0;0;0;0;0;0;0;0;0;0;0;0;0;0;0;0
FR;6;2022-02-22;0;0;0;0;0;0;0;0;0;0;0;0;0;0;0;0;0;0
FR;6;2022-02-23;0;0;0;0;0;0;0;0;0;0;0;0;0;0;0;0;0;0
FR;6;2022-02-24;0;0;0;0;0;0;0;0;0;0;0;0;0;0;0;0;0;0
FR;6;2022-02-25;0;0;0;0;0;0;0;0;0;0;0;0;0;0;0;0;0;0
FR;6;2022-02-26;1;0;0;0;0;0;0;0;0;1;0;0;0;0;0;0;0;0
FR;6;2022-02-27;1;0;0;0;1;0;0;0;0;2;0;0;0;1;0;0;0;0
FR;6;2022-02-28;0;0;0;0;0;0;0;0;0;2;0;0;0;1;0;0;0;0
FR;6;2022-03-01;3;0;0;0;0;0;0;0;0;5;0;0;0;1;0;0;0;0
FR;6;2022-03-02;97;9;2;0;15;7;0;0;0;102;9;2;0;16;7;0;0;0
FR;6;2022-03-03;0;0;0;0;0;0;0;0;0;102;9;2;0;16;7;0;0;0
FR;6;2022-03-04;92;4;0;0;8;4;0;0;0;194;13;2;0;24;11;0;0;0
FR;6;2022-03-05;391;23;2;0;60;14;0;0;0;585;36;4;0;84;25;0;0;0
FR;6;2022-03-06;7;1;0;0;2;0;0;0;0;592;37;4;0;86;25;0;0;0
FR;6;2022-03-07;337;19;0;0;51;13;0;0;0;929;56;4;0;137;38;0;0;0
FR;6;2022-03-08;230;14;0;0;47;5;0;0;0;1159;70;4;0;184;43;0;0;0
FR;6;2022-03-09;519;29;2;0;84;21;1;0;0;1678;99;6;0;268;64;1;0;0
FR;6;2022-03-10;206;19;0;1;54;12;1;0;0;1884;118;6;1;322;76;2;0;0
FR;6;2022-03-11;331;22;6;0;53;21;0;0;0;2215;140;12;1;375;97;2;0;0
FR;6;2022-03-12;518;25;1;0;83;20;0;0;0;2733;165;13;1;458;117;2;0;0
FR;6;2022-03-13;40;2;0;0;2;1;0;0;0;2773;167;13;1;460;118;2;0;0
FR;6;2022-03-14;201;4;2;0;39;3;1;0;0;2974;171;15;1;499;121;3;0;0
FR;6;2022-03-15;112;11;2;0;28;9;0;0;0;3086;182;17;1;527;130;3;0;0
FR;6;2022-03-16;310;17;2;1;49;15;1;0;0;3396;199;19;2;576;145;4;0;0
FR;6;2022-03-17;117;6;1;2;14;4;2;0;0;3513;205;20;4;590;149;6;0;0
FR;6;2022-03-18;215;10;0;0;40;6;0;0;0;3728;215;20;4;630;155;6;0;0
FR;6;2022-03-19;307;19;2;0;90;9;0;0;0;4035;234;22;4;720;164;6;0;0
FR;6;2022-03-20;15;5;0;0;5;1;0;0;0;4050;239;22;4;725;165;6;0;0
FR;6;2022-03-21;132;23;1;0;47;4;0;0;0;4182;262;23;4;772;169;6;0;0
FR;6;2022-03-22;97;15;0;0;34;4;0;0;0;4279;277;23;4;806;173;6;0;0
FR;6;2022-03-23;226;108;3;0;154;14;1;0;0;4505;385;26;4;960;187;7;0;0
FR;6;2022-03-24;100;15;1;3;32;4;3;0;0;4605;400;27;7;992;191;10;0;0
FR;6;2022-03-25;203;141;2;1;179;15;2;0;0;4808;541;29;8;1171;206;12;0;0
FR;6;2022-03-26;331;295;7;1;385;19;1;0;0;5139;836;36;9;1556;225;13;0;0
FR;6;2022-03-27;32;30;1;0;37;1;1;0;0;5171;866;37;9;1593;226;14;0;0
FR;6;2022-03-28;201;208;8;1;234;17;3;0;0;5372;1074;45;10;1827;243;17;0;0
FR;6;2022-03-29;124;189;12;2;206;12;9;0;0;5496;1263;57;12;2033;255;26;0;0
FR;6;2022-03-30;305;476;10;2;548;22;6;0;0;5801;1739;67;14;2581;277;32;0;0
FR;6;2022-03-31;123;140;10;0;160;14;5;0;0;5924;1879;77;14;2741;291;37;0;0
FR;6;2022-04-01;195;150;11;2;178;23;3;0;0;6119;2029;88;16;2919;314;40;0;0
FR;6;2022-04-02;206;241;9;1;280;13;8;0;0;6325;2270;97;17;3199;327;48;0;0
FR;6;2022-04-03;17;21;0;0;26;1;0;0;0;6342;2291;97;17;3225;328;48;0;0
FR;6;2022-04-04;137;114;6;1;131;9;5;0;0;6479;2405;103;18;3356;337;53;0;0
FR;6;2022-04-05;146;88;15;1;105;11;8;0;0;6625;2493;118;19;3461;348;61;0;0
FR;6;2022-04-06;204;245;22;26;291;27;33;0;0;6829;2738;140;45;3752;375;94;0;0
FR;6;2022-04-07;127;96;15;9;115;17;14;0;0;6956;2834;155;54;3867;392;108;0;0
FR;6;2022-04-08;199;171;16;3;214;17;9;0;1;7155;3005;171;57;4081;409;117;0;1
FR;6;2022-04-09;145;139;6;12;171;13;4;0;0;7300;3144;177;69;4252;422;121;0;1
FR;6;2022-04-10;11;20;3;0;26;1;3;0;0;7311;3164;180;69;4278;423;124;0;1
FR;6;2022-04-11;101;106;4;0;129;5;3;0;0;7412;3270;184;69;4407;428;127;0;1
FR;6;2022-04-12;136;75;5;8;114;10;10;0;0;7548;3345;189;77;4521;438;137;0;1
FR;6;2022-04-13;162;175;7;5;208;13;8;0;0;7710;3520;196;82;4729;451;145;0;1
FR;6;2022-04-14;100;103;5;10;121;8;10;0;0;7810;3623;201;92;4850;459;155;0;1
FR;6;2022-04-15;158;149;11;7;167;19;14;0;1;7968;3772;212;99;5017;478;169;0;2
FR;6;2022-04-16;127;132;5;0;162;14;2;0;0;8095;3904;217;99;5179;492;171;0;2
FR;6;2022-04-17;8;9;4;0;10;4;0;0;0;8103;3913;221;99;5189;496;171;0;2
FR;6;2022-04-18;8;15;3;0;14;4;0;0;0;8111;3928;224;99;5203;500;171;0;2
FR;6;2022-04-19;97;112;4;3;130;3;7;0;0;8208;4040;228;102;5333;503;178;0;2
FR;6;2022-04-20;177;227;8;7;269;15;3;0;0;8385;4267;236;109;5602;518;181;0;2
FR;6;2022-04-21;111;93;8;4;110;11;7;0;0;8496;4360;244;113;5712;529;188;0;2
FR;6;2022-04-22;139;160;13;12;189;13;13;0;0;8635;4520;257;125;5901;542;201;0;2
FR;6;2022-04-23;106;129;1;1;161;7;1;0;0;8741;4649;258;126;6062;549;202;0;2
FR;6;2022-04-24;5;21;1;0;22;0;1;0;0;8746;4670;259;126;6084;549;203;0;2
FR;6;2022-04-25;90;128;3;8;150;11;9;0;0;8836;4798;262;134;6234;560;212;0;2
FR;6;2022-04-26;101;128;19;2;151;17;13;0;0;8937;4926;281;136;6385;577;225;0;2
FR;6;2022-04-27;197;159;21;1;222;27;11;0;1;9134;5085;302;137;6607;604;236;0;3
FR;6;2022-04-28;109;87;7;1;123;8;7;0;0;9243;5172;309;138;6730;612;243;0;3
FR;6;2022-04-29;191;169;16;2;215;20;6;0;0;9434;5341;325;140;6945;632;249;0;3
FR;6;2022-04-30;133;125;7;1;168;24;2;0;0;9567;5466;332;141;7113;656;251;0;3
FR;6;2022-05-01;7;6;0;0;8;0;0;0;0;9574;5472;332;141;7121;656;251;0;3
FR;6;2022-05-02;94;65;3;4;88;3;4;0;0;9668;5537;335;145;7209;659;255;0;3
FR;6;2022-05-03;136;93;11;2;125;7;9;0;0;9804;5630;346;147;7334;666;264;0;3
FR;6;2022-05-04;167;118;25;12;161;29;12;0;1;9971;5748;371;159;7495;695;276;0;4
FR;6;2022-05-05;101;70;8;3;97;12;6;0;0;10072;5818;379;162;7592;707;282;0;4
FR;6;2022-05-06;152;110;10;9;155;16;11;0;0;10224;5928;389;171;7747;723;293;0;4
FR;6;2022-05-07;139;93;13;3;136;23;8;0;0;10363;6021;402;174;7883;746;301;0;4
FR;6;2022-05-08;20;8;6;5;16;7;5;0;0;10383;6029;408;179;7899;753;306;0;4
FR;6;2022-05-09;86;78;9;7;95;13;6;0;0;10469;6107;417;186;7994;766;312;0;4
FR;6;2022-05-10;112;80;15;7;110;12;13;0;0;10581;6187;432;193;8104;778;325;0;4
FR;6;2022-05-11;130;124;11;14;163;20;6;0;0;10711;6311;443;207;8267;798;331;0;4
FR;6;2022-05-12;105;76;7;5;96;15;6;0;1;10816;6387;450;212;8363;813;337;0;5
FR;6;2022-05-13;155;97;17;21;137;22;16;0;0;10971;6484;467;233;8500;835;353;0;5
FR;6;2022-05-14;81;60;6;7;84;15;2;0;0;11052;6544;473;240;8584;850;355;0;5
FR;6;2022-05-15;12;7;0;0;14;0;0;0;0;11064;6551;473;240;8598;850;355;0;5
FR;6;2022-05-16;65;54;6;2;69;12;3;0;0;11129;6605;479;242;8667;862;358;0;5
FR;6;2022-05-17;123;77;5;7;92;11;8;0;0;11252;6682;484;249;8759;873;366;0;5
FR;6;2022-05-18;131;116;5;1;158;14;3;0;0;11383;6798;489;250;8917;887;369;0;5
FR;6;2022-05-19;124;57;6;8;96;9;8;0;0;11507;6855;495;258;9013;896;377;0;5
FR;6;2022-05-20;125;115;13;3;151;18;10;0;0;11632;6970;508;261;9164;914;387;0;5
FR;6;2022-05-21;92;69;14;3;93;12;8;0;0;11724;7039;522;264;9257;926;395;0;5
FR;6;2022-05-22;19;12;5;0;21;4;1;0;0;11743;7051;527;264;9278;930;396;0;5
FR;6;2022-05-23;77;72;4;2;90;7;2;0;0;11820;7123;531;266;9368;937;398;0;5
FR;6;2022-05-24;117;98;8;2;131;16;4;0;0;11937;7221;539;268;9499;953;402;0;5
FR;6;2022-05-25;140;129;6;3;171;11;6;0;0;12077;7350;545;271;9670;964;408;0;5
FR;6;2022-05-26;7;9;3;0;5;9;0;0;0;12084;7359;548;271;9675;973;408;0;5
FR;6;2022-05-27;127;105;15;11;136;18;18;0;1;12211;7464;563;282;9811;991;426;0;6
FR;6;2022-05-28;54;75;1;5;89;8;5;0;0;12265;7539;564;287;9900;999;431;0;6
FR;6;2022-05-29;8;10;0;0;10;1;0;0;0;12273;7549;564;287;9910;1000;431;0;6
FR;6;2022-05-30;70;70;7;4;86;4;9;0;0;12343;7619;571;291;9996;1004;440;0;6
FR;6;2022-05-31;87;102;10;2;121;14;7;0;0;12430;7721;581;293;10117;1018;447;0;6
FR;6;2022-06-01;97;89;10;1;111;11;6;0;0;12527;7810;591;294;10228;1029;453;0;6
FR;6;2022-06-02;91;60;6;3;80;9;6;0;0;12618;7870;597;297;10308;1038;459;0;6
FR;6;2022-06-03;126;102;13;7;128;21;8;0;0;12744;7972;610;304;10436;1059;467;0;6
FR;6;2022-06-04;63;51;10;0;64;12;3;0;0;12807;8023;620;304;10500;1071;470;0;6
FR;6;2022-06-05;16;15;2;1;18;4;1;0;0;12823;8038;622;305;10518;1075;471;0;6
FR;6;2022-06-06;9;6;0;0;8;0;0;0;0;12832;8044;622;305;10526;1075;471;0;6
FR;6;2022-06-07;79;90;3;4;117;8;6;0;0;12911;8134;625;309;10643;1083;477;0;6
FR;6;2022-06-08;92;110;13;5;130;20;6;0;0;13003;8244;638;314;10773;1103;483;0;6
FR;6;2022-06-09;75;81;15;3;106;15;8;0;0;13078;8325;653;317;10879;1118;491;0;6
FR;6;2022-06-10;116;93;26;10;120;22;13;0;0;13194;8418;679;327;10999;1140;504;0;6
FR;6;2022-06-11;83;62;6;10;82;12;11;0;0;13277;8480;685;337;11081;1152;515;0;6
FR;6;2022-06-12;6;14;1;0;16;2;0;0;0;13283;8494;686;337;11097;1154;515;0;6
FR;6;2022-06-13;74;59;18;1;68;7;4;0;0;13357;8553;704;338;11165;1161;519;0;6
FR;6;2022-06-14;98;100;8;5;116;16;8;0;0;13455;8653;712;343;11281;1177;527;0;6
FR;6;2022-06-15;80;86;7;8;114;15;10;0;0;13535;8739;719;351;11395;1192;537;0;6
FR;6;2022-06-16;53;40;11;7;45;14;6;0;0;13588;8779;730;358;11440;1206;543;0;6
FR;6;2022-06-17;86;85;3;13;109;11;5;0;0;13674;8864;733;371;11549;1217;548;0;6
FR;6;2022-06-18;71;62;13;0;88;21;1;0;0;13745;8926;746;371;11637;1238;549;0;6
FR;6;2022-06-19;6;6;3;0;7;4;1;0;0;13751;8932;749;371;11644;1242;550;0;6
FR;6;2022-06-20;42;41;4;1;55;6;1;0;0;13793;8973;753;372;11699;1248;551;0;6
FR;6;2022-06-21;59;73;10;7;83;17;7;0;0;13852;9046;763;379;11782;1265;558;0;6
FR;6;2022-06-22;86;85;8;2;98;17;3;0;0;13938;9131;771;381;11880;1282;561;0;6
FR;6;2022-06-23;64;39;13;7;41;15;10;0;0;14002;9170;784;388;11921;1297;571;0;6
FR;6;2022-06-24;77;85;7;14;95;20;16;0;0;14079;9255;791;402;12016;1317;587;0;6
FR;6;2022-06-25;67;61;4;3;77;8;5;0;0;14146;9316;795;405;12093;1325;592;0;6
FR;6;2022-06-26;6;7;1;0;10;1;0;0;0;14152;9323;796;405;12103;1326;592;0;6
FR;6;2022-06-27;51;50;4;9;62;12;7;0;0;14203;9373;800;414;12165;1338;599;0;6
FR;6;2022-06-28;68;47;6;3;53;15;5;0;0;14271;9420;806;417;12218;1353;604;0;6
FR;6;2022-06-29;98;117;26;37;115;19;35;0;5;14369;9537;832;454;12333;1372;639;0;11
FR;6;2022-06-30;84;60;33;10;61;12;7;0;0;14453;9597;865;464;12394;1384;646;0;11
FR;6;2022-07-01;115;94;25;33;102;18;27;0;1;14568;9691;890;497;12496;1402;673;0;12
FR;6;2022-07-02;58;67;26;2;64;37;6;0;0;14626;9758;916;499;12560;1439;679;0;12
FR;6;2022-07-03;11;4;4;3;5;4;3;0;0;14637;9762;920;502;12565;1443;682;0;12
FR;6;2022-07-04;61;43;3;23;55;13;20;0;0;14698;9805;923;525;12620;1456;702;0;12
FR;6;2022-07-05;65;53;19;67;60;27;63;0;0;14763;9858;942;592;12680;1483;765;0;12
FR;6;2022-07-06;94;64;7;11;78;12;17;0;0;14857;9922;949;603;12758;1495;782;0;12
FR;6;2022-07-07;99;79;42;37;99;14;34;0;4;14956;10001;991;640;12857;1509;816;0;16
FR;6;2022-07-08;139;87;42;27;115;10;25;0;3;15095;10088;1033;667;12972;1519;841;0;19
FR;6;2022-07-09;53;51;16;29;51;27;33;0;1;15148;10139;1049;696;13023;1546;874;0;20
FR;6;2022-07-10;3;7;8;0;9;9;0;0;0;15151;10146;1057;696;13032;1555;874;0;20
FR;6;2022-07-11;54;44;5;4;47;12;4;0;0;15205;10190;1062;700;13079;1567;878;0;20
FR;6;2022-07-12;70;72;12;23;87;12;27;0;0;15275;10262;1074;723;13166;1579;905;0;20
FR;6;2022-07-13;84;65;14;21;71;25;22;0;0;15359;10327;1088;744;13237;1604;927;0;20
FR;6;2022-07-14;4;3;1;0;4;1;0;0;0;15363;10330;1089;744;13241;1605;927;0;20
FR;6;2022-07-15;74;59;9;57;85;16;45;0;0;15437;10389;1098;801;13326;1621;972;0;20
FR;6;2022-07-16;27;31;17;0;37;17;3;0;0;15464;10420;1115;801;13363;1638;975;0;20
FR;6;2022-07-17;3;7;0;0;8;0;0;0;0;15467;10427;1115;801;13371;1638;975;0;20
FR;6;2022-07-18;37;62;11;14;60;15;14;0;6;15504;10489;1126;815;13431;1653;989;0;26
FR;6;2022-07-19;54;48;4;19;60;6;21;0;1;15558;10537;1130;834;13491;1659;1010;0;27
FR;6;2022-07-20;53;70;7;22;75;11;27;0;0;15611;10607;1137;856;13566;1670;1037;0;27
FR;6;2022-07-21;51;61;4;7;56;11;9;0;0;15662;10668;1141;863;13622;1681;1046;0;27
FR;6;2022-07-22;55;74;7;26;82;8;16;0;2;15717;10742;1148;889;13704;1689;1062;0;29
FR;6;2022-07-23;38;40;6;10;40;6;9;0;1;15755;10782;1154;899;13744;1695;1071;0;30
FR;6;2022-07-24;11;14;1;3;19;3;3;0;0;15766;10796;1155;902;13763;1698;1074;0;30
FR;6;2022-07-25;60;44;8;12;41;9;13;0;1;15826;10840;1163;914;13804;1707;1087;0;31
FR;6;2022-07-26;47;64;14;6;62;10;13;0;0;15873;10904;1177;920;13866;1717;1100;0;31
FR;6;2022-07-27;54;78;15;11;80;18;15;0;8;15927;10982;1192;931;13946;1735;1115;0;39
FR;6;2022-07-28;30;48;4;6;50;8;7;0;1;15957;11030;1196;937;13996;1743;1122;0;40
FR;6;2022-07-29;43;71;10;38;60;24;36;0;1;16000;11101;1206;975;14056;1767;1158;0;41
FR;6;2022-07-30;26;48;4;15;49;7;15;0;0;16026;11149;1210;990;14105;1774;1173;0;41
FR;6;2022-07-31;0;1;1;0;1;0;1;0;0;16026;11150;1211;990;14106;1774;1174;0;41
FR;6;2022-08-01;39;36;14;8;32;10;6;0;1;16065;11186;1225;998;14138;1784;1180;0;42
FR;6;2022-08-02;37;46;10;14;52;6;16;0;0;16102;11232;1235;1012;14190;1790;1196;0;42
FR;6;2022-08-03;29;52;7;16;53;11;19;0;0;16131;11284;1242;1028;14243;1801;1215;0;42
FR;6;2022-08-04;25;21;4;9;20;6;10;0;1;16156;11305;1246;1037;14263;1807;1225;0;43
FR;6;2022-08-05;43;45;1;7;54;5;7;0;0;16199;11350;1247;1044;14317;1812;1232;0;43
FR;6;2022-08-06;17;27;1;3;33;2;4;0;0;16216;11377;1248;1047;14350;1814;1236;0;43
FR;6;2022-08-07;1;2;0;0;2;0;0;0;0;16217;11379;1248;1047;14352;1814;1236;0;43
FR;6;2022-08-08;24;33;1;0;40;1;0;0;0;16241;11412;1249;1047;14392;1815;1236;0;43
FR;6;2022-08-09;22;30;6;3;29;3;3;0;0;16263;11442;1255;1050;14421;1818;1239;0;43
FR;6;2022-08-10;32;36;5;9;38;5;9;0;5;16295;11478;1260;1059;14459;1823;1248;0;48
FR;6;2022-08-11;32;33;1;1;40;1;0;0;1;16327;11511;1261;1060;14499;1824;1248;0;49
FR;6;2022-08-12;50;44;6;2;50;15;3;0;1;16377;11555;1267;1062;14549;1839;1251;0;50
FR;6;2022-08-13;9;20;0;0;22;1;0;0;0;16386;11575;1267;1062;14571;1840;1251;0;50
FR;6;2022-08-14;3;1;0;0;2;0;0;0;0;16389;11576;1267;1062;14573;1840;1251;0;50
FR;6;2022-08-15;2;3;1;0;4;0;1;0;0;16391;11579;1268;1062;14577;1840;1252;0;50
FR;6;2022-08-16;35;66;21;7;66;7;2;0;0;16426;11645;1289;1069;14643;1847;1254;0;50
FR;6;2022-08-17;32;44;10;9;41;10;6;0;7;16458;11689;1299;1078;14684;1857;1260;0;57
FR;6;2022-08-18;29;55;14;4;61;4;0;0;1;16487;11744;1313;1082;14745;1861;1260;0;58
FR;6;2022-08-19;30;45;5;4;47;3;2;0;1;16517;11789;1318;1086;14792;1864;1262;0;59
FR;6;2022-08-20;26;28;3;0;27;8;1;0;0;16543;11817;1321;1086;14819;1872;1263;0;59
FR;6;2022-08-21;1;5;2;0;5;0;0;0;0;16544;11822;1323;1086;14824;1872;1263;0;59
FR;6;2022-08-22;20;42;15;1;45;0;0;0;0;16564;11864;1338;1087;14869;1872;1263;0;59
FR;6;2022-08-23;34;45;6;7;47;6;4;0;2;16598;11909;1344;1094;14916;1878;1267;0;61
FR;6;2022-08-24;34;30;6;3;36;6;2;0;3;16632;11939;1350;1097;14952;1884;1269;0;64
FR;6;2022-08-25;25;27;1;1;29;5;1;0;0;16657;11966;1351;1098;14981;1889;1270;0;64
FR;6;2022-08-26;38;44;4;4;51;7;7;0;0;16695;12010;1355;1102;15032;1896;1277;0;64
FR;6;2022-08-27;19;21;7;3;22;8;4;0;0;16714;12031;1362;1105;15054;1904;1281;0;64
FR;6;2022-08-28;6;3;0;6;3;1;1;0;4;16720;12034;1362;1111;15057;1905;1282;0;68
FR;6;2022-08-29;26;22;2;6;29;3;6;0;0;16746;12056;1364;1117;15086;1908;1288;0;68
FR;6;2022-08-30;28;35;4;12;33;8;13;0;0;16774;12091;1368;1129;15119;1916;1301;0;68
FR;6;2022-08-31;35;38;2;11;46;3;12;0;0;16809;12129;1370;1140;15165;1919;1313;0;68
FR;6;2022-09-01;17;11;5;1;13;4;3;0;0;16826;12140;1375;1141;15178;1923;1316;0;68
FR;6;2022-09-02;19;14;2;1;13;3;2;0;0;16845;12154;1377;1142;15191;1926;1318;0;68
FR;6;2022-09-03;10;3;1;5;4;2;5;0;0;16855;12157;1378;1147;15195;1928;1323;0;68
FR;6;2022-09-04;4;1;0;0;1;0;0;0;0;16859;12158;1378;1147;15196;1928;1323;0;68
FR;6;2022-09-05;8;7;0;0;10;0;0;0;0;16867;12165;1378;1147;15206;1928;1323;0;68
FR;6;2022-09-06;7;9;7;12;8;6;15;0;0;16874;12174;1385;1159;15214;1934;1338;0;68
FR;6;2022-09-07;3;8;1;0;8;1;0;0;0;16877;12182;1386;1159;15222;1935;1338;0;68
FR;6;2022-09-08;6;4;0;2;3;1;2;0;0;16883;12186;1386;1161;15225;1936;1340;0;68
FR;6;2022-09-09;7;9;2;7;9;3;8;0;0;16890;12195;1388;1168;15234;1939;1348;0;68
FR;6;2022-09-10;3;4;1;0;3;1;1;0;0;16893;12199;1389;1168;15237;1940;1349;0;68
FR;6;2022-09-11;1;3;0;0;3;0;0;0;0;16894;12202;1389;1168;15240;1940;1349;0;68
FR;6;2022-09-12;10;4;1;0;3;3;0;0;0;16904;12206;1390;1168;15243;1943;1349;0;68
FR;6;2022-09-13;7;2;3;0;2;2;2;0;0;16911;12208;1393;1168;15245;1945;1351;0;68
FR;6;2022-09-14;9;8;2;0;7;4;0;0;0;16920;12216;1395;1168;15252;1949;1351;0;68
FR;6;2022-09-15;8;13;5;5;9;9;3;0;2;16928;12229;1400;1173;15261;1958;1354;0;70
FR;6;2022-09-16;25;39;1;1;47;4;1;0;2;16953;12268;1401;1174;15308;1962;1355;0;72
FR;6;2022-09-17;24;22;0;6;24;5;3;0;2;16977;12290;1401;1180;15332;1967;1358;0;74
FR;6;2022-09-18;5;4;0;0;4;1;0;0;0;16982;12294;1401;1180;15336;1968;1358;0;74
FR;6;2022-09-19;30;30;2;1;32;5;1;0;0;17012;12324;1403;1181;15368;1973;1359;0;74
FR;6;2022-09-20;34;25;1;4;30;6;2;0;1;17046;12349;1404;1185;15398;1979;1361;0;75
FR;6;2022-09-21;21;9;3;3;7;7;5;0;3;17067;12358;1407;1188;15405;1986;1366;0;78
FR;6;2022-09-22;19;28;1;22;32;3;21;0;1;17086;12386;1408;1210;15437;1989;1387;0;79
FR;6;2022-09-23;28;41;5;9;47;9;2;0;0;17114;12427;1413;1219;15484;1998;1389;0;79
FR;6;2022-09-24;16;16;4;2;21;6;2;0;0;17130;12443;1417;1221;15505;2004;1391;0;79
FR;6;2022-09-25;3;14;0;0;14;1;0;0;0;17133;12457;1417;1221;15519;2005;1391;0;79
FR;6;2022-09-26;16;13;0;18;12;5;18;0;2;17149;12470;1417;1239;15531;2010;1409;0;81
FR;6;2022-09-27;32;19;2;3;23;4;4;0;0;17181;12489;1419;1242;15554;2014;1413;0;81
FR;6;2022-09-28;27;10;9;11;16;5;17;0;2;17208;12499;1428;1253;15570;2019;1430;0;83
FR;6;2022-09-29;13;13;10;34;16;6;33;0;7;17221;12512;1438;1287;15586;2025;1463;0;90
FR;6;2022-09-30;34;24;5;6;33;5;3;0;0;17255;12536;1443;1293;15619;2030;1466;0;90
FR;6;2022-10-01;17;12;5;8;9;8;8;0;2;17272;12548;1448;1301;15628;2038;1474;0;92
FR;6;2022-10-02;4;0;0;0;1;0;0;0;0;17276;12548;1448;1301;15629;2038;1474;0;92
FR;6;2022-10-03;11;10;3;5;11;4;6;0;0;17287;12558;1451;1306;15640;2042;1480;0;92
FR;6;2022-10-04;19;17;4;28;21;3;30;0;3;17306;12575;1455;1334;15661;2045;1510;0;95
FR;6;2022-10-05;11;12;3;2;9;7;4;0;0;17317;12587;1458;1336;15670;2052;1514;0;95
FR;6;2022-10-06;19;13;4;6;17;2;10;0;0;17336;12600;1462;1342;15687;2054;1524;0;95
FR;6;2022-10-07;27;26;5;24;24;11;16;0;5;17363;12626;1467;1366;15711;2065;1540;0;100
FR;6;2022-10-08;18;13;0;0;16;0;0;0;0;17381;12639;1467;1366;15727;2065;1540;0;100
FR;6;2022-10-09;7;3;4;27;3;4;30;0;6;17388;12642;1471;1393;15730;2069;1570;0;106
FR;6;2022-10-10;15;14;1;16;16;6;13;0;0;17403;12656;1472;1409;15746;2075;1583;0;106
FR;6;2022-10-11;21;23;3;11;22;8;13;0;3;17424;12679;1475;1420;15768;2083;1596;0;109
FR;6;2022-10-12;20;16;7;19;18;3;24;0;7;17444;12695;1482;1439;15786;2086;1620;0;116
FR;6;2022-10-13;28;15;2;36;23;0;38;0;6;17472;12710;1484;1475;15809;2086;1658;0;122
FR;6;2022-10-14;29;23;5;49;23;11;45;0;13;17501;12733;1489;1524;15832;2097;1703;0;135
FR;6;2022-10-15;13;9;0;22;8;4;21;0;6;17514;12742;1489;1546;15840;2101;1724;0;141
FR;6;2022-10-16;4;5;0;6;2;3;6;0;0;17518;12747;1489;1552;15842;2104;1730;0;141
FR;6;2022-10-17;14;14;2;10;14;1;12;0;2;17532;12761;1491;1562;15856;2105;1742;0;143
FR;6;2022-10-18;12;19;9;26;19;4;18;0;11;17544;12780;1500;1588;15875;2109;1760;0;154
FR;6;2022-10-19;10;20;6;16;20;5;19;0;5;17554;12800;1506;1604;15895;2114;1779;0;159
FR;6;2022-10-20;16;15;12;57;18;5;67;0;13;17570;12815;1518;1661;15913;2119;1846;0;172
FR;6;2022-10-21;16;21;9;34;22;11;37;0;10;17586;12836;1527;1695;15935;2130;1883;0;182
FR;6;2022-10-22;19;14;1;4;17;3;4;0;0;17605;12850;1528;1699;15952;2133;1887;0;182
FR;6;2022-10-23;3;3;1;0;4;0;1;0;0;17608;12853;1529;1699;15956;2133;1888;0;182
FR;6;2022-10-24;12;14;2;7;14;6;5;0;2;17620;12867;1531;1706;15970;2139;1893;0;184
FR;6;2022-10-25;20;13;6;17;16;7;19;0;4;17640;12880;1537;1723;15986;2146;1912;0;188
FR;6;2022-10-26;17;9;4;13;12;4;15;0;5;17657;12889;1541;1736;15998;2150;1927;0;193
FR;6;2022-10-27;20;7;8;37;10;6;36;0;14;17677;12896;1549;1773;16008;2156;1963;0;207
FR;6;2022-10-28;21;27;3;4;28;6;5;0;1;17698;12923;1552;1777;16036;2162;1968;0;208
FR;6;2022-10-29;7;11;5;11;10;6;14;0;12;17705;12934;1557;1788;16046;2168;1982;0;220
FR;6;2022-10-30;2;5;0;0;5;0;0;0;0;17707;12939;1557;1788;16051;2168;1982;0;220
FR;6;2022-10-31;20;14;2;13;17;4;12;0;3;17727;12953;1559;1801;16068;2172;1994;0;223
FR;6;2022-11-01;2;1;1;0;1;1;0;0;0;17729;12954;1560;1801;16069;2173;1994;0;223
FR;6;2022-11-02;15;25;9;21;26;11;19;0;12;17744;12979;1569;1822;16095;2184;2013;0;235
FR;6;2022-11-03;17;17;11;39;20;8;43;0;9;17761;12996;1580;1861;16115;2192;2056;0;244
FR;6;2022-11-04;19;22;9;16;27;5;16;0;10;17780;13018;1589;1877;16142;2197;2072;0;254
FR;6;2022-11-05;9;16;2;4;17;4;6;0;0;17789;13034;1591;1881;16159;2201;2078;0;254
FR;6;2022-11-06;5;1;0;0;1;0;0;0;0;17794;13035;1591;1881;16160;2201;2078;0;254
FR;6;2022-11-07;18;10;6;17;12;4;18;0;11;17812;13045;1597;1898;16172;2205;2096;0;265
FR;6;2022-11-08;18;10;2;3;8;5;5;0;4;17830;13055;1599;1901;16180;2210;2101;0;269
FR;6;2022-11-09;16;22;1;6;21;4;5;0;4;17846;13077;1600;1907;16201;2214;2106;0;273
FR;6;2022-11-10;10;10;4;12;8;5;11;0;10;17856;13087;1604;1919;16209;2219;2117;0;283
FR;6;2022-11-11;4;1;0;0;1;1;0;0;0;17860;13088;1604;1919;16210;2220;2117;0;283
FR;6;2022-11-12;4;11;1;7;11;2;5;0;9;17864;13099;1605;1926;16221;2222;2122;0;292
FR;6;2022-11-13;1;1;0;1;1;0;1;0;0;17865;13100;1605;1927;16222;2222;2123;0;292
FR;6;2022-11-14;13;10;7;32;14;8;33;0;14;17878;13110;1612;1959;16236;2230;2156;0;306
FR;6;2022-11-15;7;18;1;11;16;4;7;0;2;17885;13128;1613;1970;16252;2234;2163;0;308
FR;6;2022-11-16;16;15;9;32;16;3;42;0;9;17901;13143;1622;2002;16268;2237;2205;0;317
FR;6;2022-11-17;10;8;1;29;8;2;28;0;5;17911;13151;1623;2031;16276;2239;2233;0;322
FR;6;2022-11-18;19;12;5;23;17;4;25;0;7;17930;13163;1628;2054;16293;2243;2258;0;329
FR;6;2022-11-19;5;13;0;2;11;3;2;0;1;17935;13176;1628;2056;16304;2246;2260;0;330
FR;6;2022-11-20;2;1;2;0;1;2;0;0;0;17937;13177;1630;2056;16305;2248;2260;0;330
FR;6;2022-11-21;22;13;1;14;14;6;11;0;3;17959;13190;1631;2070;16319;2254;2271;0;333
FR;6;2022-11-22;14;9;0;4;11;1;3;0;1;17973;13199;1631;2074;16330;2255;2274;0;334
FR;6;2022-11-23;14;15;15;23;17;9;31;0;8;17987;13214;1646;2097;16347;2264;2305;0;342
FR;6;2022-11-24;14;17;1;13;19;5;12;0;7;18001;13231;1647;2110;16366;2269;2317;0;349
FR;6;2022-11-25;23;15;5;50;15;5;47;0;5;18024;13246;1652;2160;16381;2274;2364;0;354
FR;6;2022-11-26;9;5;2;4;3;2;5;0;1;18033;13251;1654;2164;16384;2276;2369;0;355
FR;6;2022-11-27;1;4;0;0;4;0;0;0;0;18034;13255;1654;2164;16388;2276;2369;0;355
FR;6;2022-11-28;9;11;6;22;11;3;24;0;11;18043;13266;1660;2186;16399;2279;2393;0;366
FR;6;2022-11-29;15;10;1;12;14;1;8;0;7;18058;13276;1661;2198;16413;2280;2401;0;373
FR;6;2022-11-30;18;20;8;23;19;12;22;0;8;18076;13296;1669;2221;16432;2292;2423;0;381
FR;6;2022-12-01;12;9;7;20;11;4;24;0;9;18088;13305;1676;2241;16443;2296;2447;0;390
FR;6;2022-12-02;17;9;12;36;12;8;42;0;1;18105;13314;1688;2277;16455;2304;2489;0;391
FR;6;2022-12-03;13;3;13;20;6;5;28;0;13;18118;13317;1701;2297;16461;2309;2517;0;404
FR;6;2022-12-04;3;1;0;2;1;0;2;0;0;18121;13318;1701;2299;16462;2309;2519;0;404
FR;6;2022-12-05;11;10;7;16;10;4;19;0;8;18132;13328;1708;2315;16472;2313;2538;0;412
FR;6;2022-12-06;10;19;3;30;12;11;28;0;3;18142;13347;1711;2345;16484;2324;2566;0;415
FR;6;2022-12-07;17;8;10;56;10;8;57;0;30;18159;13355;1721;2401;16494;2332;2623;0;445
FR;6;2022-12-08;9;13;8;19;11;7;21;0;13;18168;13368;1729;2420;16505;2339;2644;0;458
FR;6;2022-12-09;15;9;5;29;12;4;30;0;6;18183;13377;1734;2449;16517;2343;2674;0;464
FR;6;2022-12-10;12;9;6;9;7;4;14;0;7;18195;13386;1740;2458;16524;2347;2688;0;471
FR;6;2022-12-11;4;2;1;0;2;1;0;0;0;18199;13388;1741;2458;16526;2348;2688;0;471
FR;6;2022-12-12;17;10;8;36;14;9;33;0;17;18216;13398;1749;2494;16540;2357;2721;0;488
FR;6;2022-12-13;17;21;12;66;16;18;65;0;14;18233;13419;1761;2560;16556;2375;2786;0;502
FR;6;2022-12-14;14;13;8;53;11;12;53;0;14;18247;13432;1769;2613;16567;2387;2839;0;516
FR;6;2022-12-15;12;15;14;38;13;9;44;0;9;18259;13447;1783;2651;16580;2396;2883;0;525
FR;6;2022-12-16;18;14;15;39;15;14;39;0;13;18277;13461;1798;2690;16595;2410;2922;0;538
FR;6;2022-12-17;11;10;15;28;9;15;29;0;8;18288;13471;1813;2718;16604;2425;2951;0;546
FR;6;2022-12-18;7;4;0;2;5;0;2;0;0;18295;13475;1813;2720;16609;2425;2953;0;546
FR;6;2022-12-19;12;8;9;29;8;12;29;0;15;18307;13483;1822;2749;16617;2437;2982;0;561
FR;6;2022-12-20;17;23;11;23;17;19;22;0;21;18324;13506;1833;2772;16634;2456;3004;0;582
FR;6;2022-12-21;23;16;9;19;13;13;17;0;5;18347;13522;1842;2791;16647;2469;3021;0;587
FR;6;2022-12-22;13;14;9;21;15;13;18;0;11;18360;13536;1851;2812;16662;2482;3039;0;598
FR;6;2022-12-23;10;19;12;7;14;18;7;0;3;18370;13555;1863;2819;16676;2500;3046;0;601
FR;6;2022-12-24;4;5;3;1;5;2;2;0;1;18374;13560;1866;2820;16681;2502;3048;0;602
FR;6;2022-12-25;0;0;0;0;0;0;0;0;0;18374;13560;1866;2820;16681;2502;3048;0;602
FR;6;2022-12-26;8;12;12;11;10;18;11;0;3;18382;13572;1878;2831;16691;2520;3059;0;605
FR;6;2022-12-27;16;13;15;8;11;19;8;0;0;18398;13585;1893;2839;16702;2539;3067;0;605
FR;6;2022-12-28;15;19;6;8;19;9;9;0;4;18413;13604;1899;2847;16721;2548;3076;0;609
FR;6;2022-12-29;15;12;7;8;10;9;9;0;7;18428;13616;1906;2855;16731;2557;3085;0;616
FR;6;2022-12-30;20;19;13;8;20;13;11;0;4;18448;13635;1919;2863;16751;2570;3096;0;620
FR;6;2022-12-31;5;2;6;1;4;7;1;0;1;18453;13637;1925;2864;16755;2577;3097;0;621
FR;6;2023-01-01;2;1;0;3;0;3;0;0;1;18455;13638;1925;2867;16755;2580;3097;0;622
FR;6;2023-01-02;9;14;2;3;10;7;3;0;0;18464;13652;1927;2870;16765;2587;3100;0;622
FR;6;2023-01-03;8;17;9;21;17;9;21;0;7;18472;13669;1936;2891;16782;2596;3121;0;629
FR;6;2023-01-04;9;10;4;10;9;8;6;0;14;18481;13679;1940;2901;16791;2604;3127;0;643
FR;6;2023-01-05;11;11;6;23;10;3;26;0;8;18492;13690;1946;2924;16801;2607;3153;0;651
FR;6;2023-01-06;16;24;15;30;21;17;29;0;15;18508;13714;1961;2954;16822;2624;3182;0;666
FR;6;2023-01-07;9;19;4;1;10;13;3;0;1;18517;13733;1965;2955;16832;2637;3185;0;667
FR;6;2023-01-08;2;7;4;11;6;4;11;0;3;18519;13740;1969;2966;16838;2641;3196;0;670
FR;6;2023-01-09;16;10;5;35;8;8;34;0;17;18535;13750;1974;3001;16846;2649;3230;0;687
FR;6;2023-01-10;13;15;13;23;13;10;26;0;9;18548;13765;1987;3024;16859;2659;3256;0;696
FR;6;2023-01-11;15;14;5;16;18;6;14;0;12;18563;13779;1992;3040;16877;2665;3270;0;708
FR;6;2023-01-12;7;13;2;5;10;3;5;0;12;18570;13792;1994;3045;16887;2668;3275;0;720
FR;6;2023-01-13;19;14;18;43;14;20;43;0;31;18589;13806;2012;3088;16901;2688;3318;0;751
FR;6;2023-01-14;20;8;6;2;9;9;2;0;0;18609;13814;2018;3090;16910;2697;3320;0;751
FR;6;2023-01-15;0;0;1;3;0;1;3;0;0;18609;13814;2019;3093;16910;2698;3323;0;751
FR;6;2023-01-16;22;12;2;1;10;6;3;0;2;18631;13826;2021;3094;16920;2704;3326;0;753
FR;6;2023-01-17;8;17;12;8;17;11;14;0;5;18639;13843;2033;3102;16937;2715;3340;0;758
FR;6;2023-01-18;22;15;9;7;17;10;8;0;1;18661;13858;2042;3109;16954;2725;3348;0;759
FR;6;2023-01-19;9;9;14;9;11;12;13;0;7;18670;13867;2056;3118;16965;2737;3361;0;766
FR;6;2023-01-20;17;13;9;32;15;7;34;0;27;18687;13880;2065;3150;16980;2744;3395;0;793
FR;6;2023-01-21;12;7;5;2;6;8;3;0;1;18699;13887;2070;3152;16986;2752;3398;0;794
FR;6;2023-01-22;0;0;1;1;0;1;1;0;0;18699;13887;2071;3153;16986;2753;3399;0;794
FR;6;2023-01-23;9;9;5;11;8;5;11;0;3;18708;13896;2076;3164;16994;2758;3410;0;797
FR;6;2023-01-24;14;15;15;13;15;14;18;0;6;18722;13911;2091;3177;17009;2772;3428;0;803
FR;6;2023-01-25;15;7;5;3;6;6;4;0;4;18737;13918;2096;3180;17015;2778;3432;0;807
FR;6;2023-01-26;13;15;3;11;12;8;13;0;9;18750;13933;2099;3191;17027;2786;3445;0;816
FR;6;2023-01-27;21;17;7;34;22;7;29;0;29;18771;13950;2106;3225;17049;2793;3474;0;845
FR;6;2023-01-28;15;15;7;4;17;6;5;0;1;18786;13965;2113;3229;17066;2799;3479;0;846
FR;6;2023-01-29;1;4;0;0;3;1;0;0;0;18787;13969;2113;3229;17069;2800;3479;0;846
FR;6;2023-01-30;2;15;8;4;15;8;3;0;8;18789;13984;2121;3233;17084;2808;3482;0;854
FR;6;2023-01-31;9;8;5;8;8;5;8;0;5;18798;13992;2126;3241;17092;2813;3490;0;859
FR;6;2023-02-01;20;18;4;4;17;4;8;0;4;18818;14010;2130;3245;17109;2817;3498;0;863
FR;6;2023-02-02;8;10;9;1;10;10;1;0;1;18826;14020;2139;3246;17119;2827;3499;0;864
FR;6;2023-02-03;16;15;11;18;16;11;19;0;13;18842;14035;2150;3264;17135;2838;3518;0;877
FR;6;2023-02-04;6;9;9;7;11;9;8;0;2;18848;14044;2159;3271;17146;2847;3526;0;879
FR;6;2023-02-05;0;0;0;4;0;0;4;0;0;18848;14044;2159;3275;17146;2847;3530;0;879
FR;6;2023-02-06;10;16;1;4;15;5;4;0;0;18858;14060;2160;3279;17161;2852;3534;0;879
FR;6;2023-02-07;8;9;4;8;9;7;7;0;3;18866;14069;2164;3287;17170;2859;3541;0;882
FR;6;2023-02-08;7;3;3;2;2;6;1;0;1;18873;14072;2167;3289;17172;2865;3542;0;883
FR;6;2023-02-09;6;11;1;6;8;8;2;0;2;18879;14083;2168;3295;17180;2873;3544;0;885
FR;6;2023-02-10;13;21;6;12;15;15;11;0;2;18892;14104;2174;3307;17195;2888;3555;0;887
FR;6;2023-02-11;12;8;7;4;9;3;9;0;5;18904;14112;2181;3311;17204;2891;3564;0;892
FR;6;2023-02-12;0;1;0;0;1;0;0;0;0;18904;14113;2181;3311;17205;2891;3564;0;892
FR;6;2023-02-13;5;6;0;0;6;1;0;0;0;18909;14119;2181;3311;17211;2892;3564;0;892
FR;6;2023-02-14;12;13;3;15;15;4;14;0;0;18921;14132;2184;3326;17226;2896;3578;0;892
FR;6;2023-02-15;8;11;3;2;11;2;2;0;4;18929;14143;2187;3328;17237;2898;3580;0;896
FR;6;2023-02-16;17;8;1;3;18;1;3;0;4;18946;14151;2188;3331;17255;2899;3583;0;900
FR;6;2023-02-17;9;15;3;9;12;8;9;0;5;18955;14166;2191;3340;17267;2907;3592;0;905
FR;6;2023-02-18;10;6;1;1;7;1;1;0;0;18965;14172;2192;3341;17274;2908;3593;0;905
FR;6;2023-02-19;0;0;0;0;0;0;0;0;0;18965;14172;2192;3341;17274;2908;3593;0;905
FR;6;2023-02-20;10;8;3;2;9;5;1;0;0;18975;14180;2195;3343;17283;2913;3594;0;905
FR;6;2023-02-21;9;8;8;5;6;7;8;0;1;18984;14188;2203;3348;17289;2920;3602;0;906
FR;6;2023-02-22;4;13;1;3;13;3;3;0;5;18988;14201;2204;3351;17302;2923;3605;0;911
FR;6;2023-02-23;7;11;6;2;10;6;4;0;1;18995;14212;2210;3353;17312;2929;3609;0;912
FR;6;2023-02-24;9;13;5;21;14;5;19;0;15;19004;14225;2215;3374;17326;2934;3628;0;927
FR;6;2023-02-25;4;5;1;1;6;1;1;0;0;19008;14230;2216;3375;17332;2935;3629;0;927
FR;6;2023-02-26;0;1;0;0;0;1;0;0;0;19008;14231;2216;3375;17332;2936;3629;0;927
FR;6;2023-02-27;10;8;3;1;3;9;0;0;2;19018;14239;2219;3376;17335;2945;3629;0;929
FR;6;2023-02-28;3;8;4;4;9;3;6;0;0;19021;14247;2223;3380;17344;2948;3635;0;929
FR;6;2023-03-01;6;10;3;2;10;4;2;0;0;19027;14257;2226;3382;17354;2952;3637;0;929
FR;6;2023-03-02;8;7;1;3;7;3;2;0;5;19035;14264;2227;3385;17361;2955;3639;0;934
FR;6;2023-03-03;14;12;5;7;11;9;6;0;7;19049;14276;2232;3392;17372;2964;3645;0;941
FR;6;2023-03-04;8;14;1;0;13;3;0;0;0;19057;14290;2233;3392;17385;2967;3645;0;941
FR;6;2023-03-05;4;0;0;0;0;0;0;0;0;19061;14290;2233;3392;17385;2967;3645;0;941
FR;6;2023-03-06;8;12;0;1;11;2;0;0;1;19069;14302;2233;3393;17396;2969;3645;0;942
FR;6;2023-03-07;4;5;0;1;4;2;0;0;5;19073;14307;2233;3394;17400;2971;3645;0;947
FR;6;2023-03-08;3;7;2;0;7;2;0;0;0;19076;14314;2235;3394;17407;2973;3645;0;947
FR;6;2023-03-09;7;6;0;1;6;2;1;0;0;19083;14320;2235;3395;17413;2975;3646;0;947
FR;6;2023-03-10;9;9;2;9;9;2;9;0;9;19092;14329;2237;3404;17422;2977;3655;0;956
FR;6;2023-03-11;13;12;2;0;12;2;2;0;0;19105;14341;2239;3404;17434;2979;3657;0;956
FR;6;2023-03-12;2;0;0;0;1;0;0;0;0;19107;14341;2239;3404;17435;2979;3657;0;956
FR;6;2023-03-13;7;12;4;1;13;2;1;0;2;19114;14353;2243;3405;17448;2981;3658;0;958
FR;6;2023-03-14;5;12;2;0;8;6;0;0;0;19119;14365;2245;3405;17456;2987;3658;0;958
FR;6;2023-03-15;6;4;2;3;5;3;3;0;1;19125;14369;2247;3408;17461;2990;3661;0;959
FR;6;2023-03-16;9;5;2;0;5;3;0;0;0;19134;14374;2249;3408;17466;2993;3661;0;959
FR;6;2023-03-17;10;12;5;5;8;8;5;0;3;19144;14386;2254;3413;17474;3001;3666;0;962
FR;6;2023-03-18;6;2;2;0;3;2;0;0;0;19150;14388;2256;3413;17477;3003;3666;0;962
FR;6;2023-03-19;0;0;1;0;0;0;0;0;0;19150;14388;2257;3413;17477;3003;3666;0;962
FR;6;2023-03-20;2;6;3;7;5;4;5;0;4;19152;14394;2260;3420;17482;3007;3671;0;966
FR;6;2023-03-21;2;1;5;2;1;3;4;0;0;19154;14395;2265;3422;17483;3010;3675;0;966
FR;6;2023-03-22;1;4;2;0;4;2;0;0;3;19155;14399;2267;3422;17487;3012;3675;0;969
FR;6;2023-03-23;3;4;3;2;5;3;2;0;0;19158;14403;2270;3424;17492;3015;3677;0;969
FR;6;2023-03-24;3;9;6;0;9;7;0;0;0;19161;14412;2276;3424;17501;3022;3677;0;969
FR;6;2023-03-25;7;7;0;0;8;0;0;0;0;19168;14419;2276;3424;17509;3022;3677;0;969
FR;6;2023-03-26;0;0;0;0;0;0;0;0;0;19168;14419;2276;3424;17509;3022;3677;0;969
FR;8;2020-12-27;0;0;0;0;0;0;0;0;0;0;0;0;0;0;0;0;0;0
FR;8;2020-12-28;0;0;0;0;0;0;0;0;0;0;0;0;0;0;0;0;0;0
FR;8;2020-12-29;0;0;0;0;0;0;0;0;0;0;0;0;0;0;0;0;0;0
FR;8;2020-12-30;0;0;0;0;0;0;0;0;0;0;0;0;0;0;0;0;0;0
FR;8;2020-12-31;0;0;0;0;0;0;0;0;0;0;0;0;0;0;0;0;0;0
FR;8;2021-01-01;0;0;0;0;0;0;0;0;0;0;0;0;0;0;0;0;0;0
FR;8;2021-01-02;0;0;0;0;0;0;0;0;0;0;0;0;0;0;0;0;0;0
FR;8;2021-01-03;0;0;0;0;0;0;0;0;0;0;0;0;0;0;0;0;0;0
FR;8;2021-01-04;0;0;0;0;0;0;0;0;0;0;0;0;0;0;0;0;0;0
FR;8;2021-01-05;0;0;0;0;0;0;0;0;0;0;0;0;0;0;0;0;0;0
FR;8;2021-01-06;0;0;0;0;0;0;0;0;0;0;0;0;0;0;0;0;0;0
FR;8;2021-01-07;0;0;0;0;0;0;0;0;0;0;0;0;0;0;0;0;0;0
FR;8;2021-01-08;0;0;0;0;0;0;0;0;0;0;0;0;0;0;0;0;0;0
FR;8;2021-01-09;0;0;0;0;0;0;0;0;0;0;0;0;0;0;0;0;0;0
FR;8;2021-01-10;0;0;0;0;0;0;0;0;0;0;0;0;0;0;0;0;0;0
FR;8;2021-01-11;0;0;0;0;0;0;0;0;0;0;0;0;0;0;0;0;0;0
FR;8;2021-01-12;0;0;0;0;0;0;0;0;0;0;0;0;0;0;0;0;0;0
FR;8;2021-01-13;0;0;0;0;0;0;0;0;0;0;0;0;0;0;0;0;0;0
FR;8;2021-01-14;0;0;0;0;0;0;0;0;0;0;0;0;0;0;0;0;0;0
FR;8;2021-01-15;0;0;0;0;0;0;0;0;0;0;0;0;0;0;0;0;0;0
FR;8;2021-01-16;0;0;0;0;0;0;0;0;0;0;0;0;0;0;0;0;0;0
FR;8;2021-01-17;0;0;0;0;0;0;0;0;0;0;0;0;0;0;0;0;0;0
FR;8;2021-01-18;0;0;0;0;0;0;0;0;0;0;0;0;0;0;0;0;0;0
FR;8;2021-01-19;0;0;0;0;0;0;0;0;0;0;0;0;0;0;0;0;0;0
FR;8;2021-01-20;0;0;0;0;0;0;0;0;0;0;0;0;0;0;0;0;0;0
FR;8;2021-01-21;0;0;0;0;0;0;0;0;0;0;0;0;0;0;0;0;0;0
FR;8;2021-01-22;0;0;0;0;0;0;0;0;0;0;0;0;0;0;0;0;0;0
FR;8;2021-01-23;0;0;0;0;0;0;0;0;0;0;0;0;0;0;0;0;0;0
FR;8;2021-01-24;0;0;0;0;0;0;0;0;0;0;0;0;0;0;0;0;0;0
FR;8;2021-01-25;0;0;0;0;0;0;0;0;0;0;0;0;0;0;0;0;0;0
FR;8;2021-01-26;0;0;0;0;0;0;0;0;0;0;0;0;0;0;0;0;0;0
FR;8;2021-01-27;0;0;0;0;0;0;0;0;0;0;0;0;0;0;0;0;0;0
FR;8;2021-01-28;0;0;0;0;0;0;0;0;0;0;0;0;0;0;0;0;0;0
FR;8;2021-01-29;0;0;0;0;0;0;0;0;0;0;0;0;0;0;0;0;0;0
FR;8;2021-01-30;0;0;0;0;0;0;0;0;0;0;0;0;0;0;0;0;0;0
FR;8;2021-01-31;0;0;0;0;0;0;0;0;0;0;0;0;0;0;0;0;0;0
FR;8;2021-02-01;0;0;0;0;0;0;0;0;0;0;0;0;0;0;0;0;0;0
FR;8;2021-02-02;0;0;0;0;0;0;0;0;0;0;0;0;0;0;0;0;0;0
FR;8;2021-02-03;0;0;0;0;0;0;0;0;0;0;0;0;0;0;0;0;0;0
FR;8;2021-02-04;0;0;0;0;0;0;0;0;0;0;0;0;0;0;0;0;0;0
FR;8;2021-02-05;0;0;0;0;0;0;0;0;0;0;0;0;0;0;0;0;0;0
FR;8;2021-02-06;0;0;0;0;0;0;0;0;0;0;0;0;0;0;0;0;0;0
FR;8;2021-02-07;0;0;0;0;0;0;0;0;0;0;0;0;0;0;0;0;0;0
FR;8;2021-02-08;0;0;0;0;0;0;0;0;0;0;0;0;0;0;0;0;0;0
FR;8;2021-02-09;0;0;0;0;0;0;0;0;0;0;0;0;0;0;0;0;0;0
FR;8;2021-02-10;0;0;0;0;0;0;0;0;0;0;0;0;0;0;0;0;0;0
FR;8;2021-02-11;0;0;0;0;0;0;0;0;0;0;0;0;0;0;0;0;0;0
FR;8;2021-02-12;0;0;0;0;0;0;0;0;0;0;0;0;0;0;0;0;0;0
FR;8;2021-02-13;0;0;0;0;0;0;0;0;0;0;0;0;0;0;0;0;0;0
FR;8;2021-02-14;0;0;0;0;0;0;0;0;0;0;0;0;0;0;0;0;0;0
FR;8;2021-02-15;0;0;0;0;0;0;0;0;0;0;0;0;0;0;0;0;0;0
FR;8;2021-02-16;0;0;0;0;0;0;0;0;0;0;0;0;0;0;0;0;0;0
FR;8;2021-02-17;0;0;0;0;0;0;0;0;0;0;0;0;0;0;0;0;0;0
FR;8;2021-02-18;0;0;0;0;0;0;0;0;0;0;0;0;0;0;0;0;0;0
FR;8;2021-02-19;0;0;0;0;0;0;0;0;0;0;0;0;0;0;0;0;0;0
FR;8;2021-02-20;0;0;0;0;0;0;0;0;0;0;0;0;0;0;0;0;0;0
FR;8;2021-02-21;0;0;0;0;0;0;0;0;0;0;0;0;0;0;0;0;0;0
FR;8;2021-02-22;0;0;0;0;0;0;0;0;0;0;0;0;0;0;0;0;0;0
FR;8;2021-02-23;0;0;0;0;0;0;0;0;0;0;0;0;0;0;0;0;0;0
FR;8;2021-02-24;0;0;0;0;0;0;0;0;0;0;0;0;0;0;0;0;0;0
FR;8;2021-02-25;0;0;0;0;0;0;0;0;0;0;0;0;0;0;0;0;0;0
FR;8;2021-02-26;0;0;0;0;0;0;0;0;0;0;0;0;0;0;0;0;0;0
FR;8;2021-02-27;0;0;0;0;0;0;0;0;0;0;0;0;0;0;0;0;0;0
FR;8;2021-02-28;0;0;0;0;0;0;0;0;0;0;0;0;0;0;0;0;0;0
FR;8;2021-03-01;0;0;0;0;0;0;0;0;0;0;0;0;0;0;0;0;0;0
FR;8;2021-03-02;0;0;0;0;0;0;0;0;0;0;0;0;0;0;0;0;0;0
FR;8;2021-03-03;0;0;0;0;0;0;0;0;0;0;0;0;0;0;0;0;0;0
FR;8;2021-03-04;0;0;0;0;0;0;0;0;0;0;0;0;0;0;0;0;0;0
FR;8;2021-03-05;0;0;0;0;0;0;0;0;0;0;0;0;0;0;0;0;0;0
FR;8;2021-03-06;0;0;0;0;0;0;0;0;0;0;0;0;0;0;0;0;0;0
FR;8;2021-03-07;0;0;0;0;0;0;0;0;0;0;0;0;0;0;0;0;0;0
FR;8;2021-03-08;0;0;0;0;0;0;0;0;0;0;0;0;0;0;0;0;0;0
FR;8;2021-03-09;0;0;0;0;0;0;0;0;0;0;0;0;0;0;0;0;0;0
FR;8;2021-03-10;0;0;0;0;0;0;0;0;0;0;0;0;0;0;0;0;0;0
FR;8;2021-03-11;0;0;0;0;0;0;0;0;0;0;0;0;0;0;0;0;0;0
FR;8;2021-03-12;0;0;0;0;0;0;0;0;0;0;0;0;0;0;0;0;0;0
FR;8;2021-03-13;0;0;0;0;0;0;0;0;0;0;0;0;0;0;0;0;0;0
FR;8;2021-03-14;0;0;0;0;0;0;0;0;0;0;0;0;0;0;0;0;0;0
FR;8;2021-03-15;0;0;0;0;0;0;0;0;0;0;0;0;0;0;0;0;0;0
FR;8;2021-03-16;0;0;0;0;0;0;0;0;0;0;0;0;0;0;0;0;0;0
FR;8;2021-03-17;0;0;0;0;0;0;0;0;0;0;0;0;0;0;0;0;0;0
FR;8;2021-03-18;0;0;0;0;0;0;0;0;0;0;0;0;0;0;0;0;0;0
FR;8;2021-03-19;0;0;0;0;0;0;0;0;0;0;0;0;0;0;0;0;0;0
FR;8;2021-03-20;0;0;0;0;0;0;0;0;0;0;0;0;0;0;0;0;0;0
FR;8;2021-03-21;0;0;0;0;0;0;0;0;0;0;0;0;0;0;0;0;0;0
FR;8;2021-03-22;0;0;0;0;0;0;0;0;0;0;0;0;0;0;0;0;0;0
FR;8;2021-03-23;0;0;0;0;0;0;0;0;0;0;0;0;0;0;0;0;0;0
FR;8;2021-03-24;0;0;0;0;0;0;0;0;0;0;0;0;0;0;0;0;0;0
FR;8;2021-03-25;0;0;0;0;0;0;0;0;0;0;0;0;0;0;0;0;0;0
FR;8;2021-03-26;0;0;0;0;0;0;0;0;0;0;0;0;0;0;0;0;0;0
FR;8;2021-03-27;0;0;0;0;0;0;0;0;0;0;0;0;0;0;0;0;0;0
FR;8;2021-03-28;0;0;0;0;0;0;0;0;0;0;0;0;0;0;0;0;0;0
FR;8;2021-03-29;0;0;0;0;0;0;0;0;0;0;0;0;0;0;0;0;0;0
FR;8;2021-03-30;0;0;0;0;0;0;0;0;0;0;0;0;0;0;0;0;0;0
FR;8;2021-03-31;0;0;0;0;0;0;0;0;0;0;0;0;0;0;0;0;0;0
FR;8;2021-04-01;0;0;0;0;0;0;0;0;0;0;0;0;0;0;0;0;0;0
FR;8;2021-04-02;0;0;0;0;0;0;0;0;0;0;0;0;0;0;0;0;0;0
FR;8;2021-04-03;0;0;0;0;0;0;0;0;0;0;0;0;0;0;0;0;0;0
FR;8;2021-04-04;0;0;0;0;0;0;0;0;0;0;0;0;0;0;0;0;0;0
FR;8;2021-04-05;0;0;0;0;0;0;0;0;0;0;0;0;0;0;0;0;0;0
FR;8;2021-04-06;0;0;0;0;0;0;0;0;0;0;0;0;0;0;0;0;0;0
FR;8;2021-04-07;0;0;0;0;0;0;0;0;0;0;0;0;0;0;0;0;0;0
FR;8;2021-04-08;0;0;0;0;0;0;0;0;0;0;0;0;0;0;0;0;0;0
FR;8;2021-04-09;0;0;0;0;0;0;0;0;0;0;0;0;0;0;0;0;0;0
FR;8;2021-04-10;0;0;0;0;0;0;0;0;0;0;0;0;0;0;0;0;0;0
FR;8;2021-04-11;0;0;0;0;0;0;0;0;0;0;0;0;0;0;0;0;0;0
FR;8;2021-04-12;0;0;0;0;0;0;0;0;0;0;0;0;0;0;0;0;0;0
FR;8;2021-04-13;0;0;0;0;0;0;0;0;0;0;0;0;0;0;0;0;0;0
FR;8;2021-04-14;0;0;0;0;0;0;0;0;0;0;0;0;0;0;0;0;0;0
FR;8;2021-04-15;0;0;0;0;0;0;0;0;0;0;0;0;0;0;0;0;0;0
FR;8;2021-04-16;0;0;0;0;0;0;0;0;0;0;0;0;0;0;0;0;0;0
FR;8;2021-04-17;0;0;0;0;0;0;0;0;0;0;0;0;0;0;0;0;0;0
FR;8;2021-04-18;0;0;0;0;0;0;0;0;0;0;0;0;0;0;0;0;0;0
FR;8;2021-04-19;0;0;0;0;0;0;0;0;0;0;0;0;0;0;0;0;0;0
FR;8;2021-04-20;0;0;0;0;0;0;0;0;0;0;0;0;0;0;0;0;0;0
FR;8;2021-04-21;0;0;0;0;0;0;0;0;0;0;0;0;0;0;0;0;0;0
FR;8;2021-04-22;0;0;0;0;0;0;0;0;0;0;0;0;0;0;0;0;0;0
FR;8;2021-04-23;0;0;0;0;0;0;0;0;0;0;0;0;0;0;0;0;0;0
FR;8;2021-04-24;0;0;0;0;0;0;0;0;0;0;0;0;0;0;0;0;0;0
FR;8;2021-04-25;0;0;0;0;0;0;0;0;0;0;0;0;0;0;0;0;0;0
FR;8;2021-04-26;0;0;0;0;0;0;0;0;0;0;0;0;0;0;0;0;0;0
FR;8;2021-04-27;0;0;0;0;0;0;0;0;0;0;0;0;0;0;0;0;0;0
FR;8;2021-04-28;0;0;0;0;0;0;0;0;0;0;0;0;0;0;0;0;0;0
FR;8;2021-04-29;0;0;0;0;0;0;0;0;0;0;0;0;0;0;0;0;0;0
FR;8;2021-04-30;0;0;0;0;0;0;0;0;0;0;0;0;0;0;0;0;0;0
FR;8;2021-05-01;0;0;0;0;0;0;0;0;0;0;0;0;0;0;0;0;0;0
FR;8;2021-05-02;0;0;0;0;0;0;0;0;0;0;0;0;0;0;0;0;0;0
FR;8;2021-05-03;0;0;0;0;0;0;0;0;0;0;0;0;0;0;0;0;0;0
FR;8;2021-05-04;0;0;0;0;0;0;0;0;0;0;0;0;0;0;0;0;0;0
FR;8;2021-05-05;0;0;0;0;0;0;0;0;0;0;0;0;0;0;0;0;0;0
FR;8;2021-05-06;0;0;0;0;0;0;0;0;0;0;0;0;0;0;0;0;0;0
FR;8;2021-05-07;0;0;0;0;0;0;0;0;0;0;0;0;0;0;0;0;0;0
FR;8;2021-05-08;0;0;0;0;0;0;0;0;0;0;0;0;0;0;0;0;0;0
FR;8;2021-05-09;0;0;0;0;0;0;0;0;0;0;0;0;0;0;0;0;0;0
FR;8;2021-05-10;0;0;0;0;0;0;0;0;0;0;0;0;0;0;0;0;0;0
FR;8;2021-05-11;0;0;0;0;0;0;0;0;0;0;0;0;0;0;0;0;0;0
FR;8;2021-05-12;0;0;0;0;0;0;0;0;0;0;0;0;0;0;0;0;0;0
FR;8;2021-05-13;0;0;0;0;0;0;0;0;0;0;0;0;0;0;0;0;0;0
FR;8;2021-05-14;0;0;0;0;0;0;0;0;0;0;0;0;0;0;0;0;0;0
FR;8;2021-05-15;0;0;0;0;0;0;0;0;0;0;0;0;0;0;0;0;0;0
FR;8;2021-05-16;0;0;0;0;0;0;0;0;0;0;0;0;0;0;0;0;0;0
FR;8;2021-05-17;0;0;0;0;0;0;0;0;0;0;0;0;0;0;0;0;0;0
FR;8;2021-05-18;0;0;0;0;0;0;0;0;0;0;0;0;0;0;0;0;0;0
FR;8;2021-05-19;0;0;0;0;0;0;0;0;0;0;0;0;0;0;0;0;0;0
FR;8;2021-05-20;0;0;0;0;0;0;0;0;0;0;0;0;0;0;0;0;0;0
FR;8;2021-05-21;0;0;0;0;0;0;0;0;0;0;0;0;0;0;0;0;0;0
FR;8;2021-05-22;0;0;0;0;0;0;0;0;0;0;0;0;0;0;0;0;0;0
FR;8;2021-05-23;0;0;0;0;0;0;0;0;0;0;0;0;0;0;0;0;0;0
FR;8;2021-05-24;0;0;0;0;0;0;0;0;0;0;0;0;0;0;0;0;0;0
FR;8;2021-05-25;0;0;0;0;0;0;0;0;0;0;0;0;0;0;0;0;0;0
FR;8;2021-05-26;0;0;0;0;0;0;0;0;0;0;0;0;0;0;0;0;0;0
FR;8;2021-05-27;0;0;0;0;0;0;0;0;0;0;0;0;0;0;0;0;0;0
FR;8;2021-05-28;0;0;0;0;0;0;0;0;0;0;0;0;0;0;0;0;0;0
FR;8;2021-05-29;0;0;0;0;0;0;0;0;0;0;0;0;0;0;0;0;0;0
FR;8;2021-05-30;0;0;0;0;0;0;0;0;0;0;0;0;0;0;0;0;0;0
FR;8;2021-05-31;0;0;0;0;0;0;0;0;0;0;0;0;0;0;0;0;0;0
FR;8;2021-06-01;0;0;0;0;0;0;0;0;0;0;0;0;0;0;0;0;0;0
FR;8;2021-06-02;0;0;0;0;0;0;0;0;0;0;0;0;0;0;0;0;0;0
FR;8;2021-06-03;0;0;0;0;0;0;0;0;0;0;0;0;0;0;0;0;0;0
FR;8;2021-06-04;0;0;0;0;0;0;0;0;0;0;0;0;0;0;0;0;0;0
FR;8;2021-06-05;0;0;0;0;0;0;0;0;0;0;0;0;0;0;0;0;0;0
FR;8;2021-06-06;0;0;0;0;0;0;0;0;0;0;0;0;0;0;0;0;0;0
FR;8;2021-06-07;0;0;0;0;0;0;0;0;0;0;0;0;0;0;0;0;0;0
FR;8;2021-06-08;0;0;0;0;0;0;0;0;0;0;0;0;0;0;0;0;0;0
FR;8;2021-06-09;0;0;0;0;0;0;0;0;0;0;0;0;0;0;0;0;0;0
FR;8;2021-06-10;0;0;0;0;0;0;0;0;0;0;0;0;0;0;0;0;0;0
FR;8;2021-06-11;0;0;0;0;0;0;0;0;0;0;0;0;0;0;0;0;0;0
FR;8;2021-06-12;0;0;0;0;0;0;0;0;0;0;0;0;0;0;0;0;0;0
FR;8;2021-06-13;0;0;0;0;0;0;0;0;0;0;0;0;0;0;0;0;0;0
FR;8;2021-06-14;0;0;0;0;0;0;0;0;0;0;0;0;0;0;0;0;0;0
FR;8;2021-06-15;0;0;0;0;0;0;0;0;0;0;0;0;0;0;0;0;0;0
FR;8;2021-06-16;0;0;0;0;0;0;0;0;0;0;0;0;0;0;0;0;0;0
FR;8;2021-06-17;0;0;0;0;0;0;0;0;0;0;0;0;0;0;0;0;0;0
FR;8;2021-06-18;0;0;0;0;0;0;0;0;0;0;0;0;0;0;0;0;0;0
FR;8;2021-06-19;0;0;0;0;0;0;0;0;0;0;0;0;0;0;0;0;0;0
FR;8;2021-06-20;0;0;0;0;0;0;0;0;0;0;0;0;0;0;0;0;0;0
FR;8;2021-06-21;0;0;0;0;0;0;0;0;0;0;0;0;0;0;0;0;0;0
FR;8;2021-06-22;0;0;0;0;0;0;0;0;0;0;0;0;0;0;0;0;0;0
FR;8;2021-06-23;0;0;0;0;0;0;0;0;0;0;0;0;0;0;0;0;0;0
FR;8;2021-06-24;0;0;0;0;0;0;0;0;0;0;0;0;0;0;0;0;0;0
FR;8;2021-06-25;0;0;0;0;0;0;0;0;0;0;0;0;0;0;0;0;0;0
FR;8;2021-06-26;0;0;0;0;0;0;0;0;0;0;0;0;0;0;0;0;0;0
FR;8;2021-06-27;0;0;0;0;0;0;0;0;0;0;0;0;0;0;0;0;0;0
FR;8;2021-06-28;0;0;0;0;0;0;0;0;0;0;0;0;0;0;0;0;0;0
FR;8;2021-06-29;0;0;0;0;0;0;0;0;0;0;0;0;0;0;0;0;0;0
FR;8;2021-06-30;0;0;0;0;0;0;0;0;0;0;0;0;0;0;0;0;0;0
FR;8;2021-07-01;0;0;0;0;0;0;0;0;0;0;0;0;0;0;0;0;0;0
FR;8;2021-07-02;0;0;0;0;0;0;0;0;0;0;0;0;0;0;0;0;0;0
FR;8;2021-07-03;0;0;0;0;0;0;0;0;0;0;0;0;0;0;0;0;0;0
FR;8;2021-07-04;0;0;0;0;0;0;0;0;0;0;0;0;0;0;0;0;0;0
FR;8;2021-07-05;0;0;0;0;0;0;0;0;0;0;0;0;0;0;0;0;0;0
FR;8;2021-07-06;0;0;0;0;0;0;0;0;0;0;0;0;0;0;0;0;0;0
FR;8;2021-07-07;0;0;0;0;0;0;0;0;0;0;0;0;0;0;0;0;0;0
FR;8;2021-07-08;0;0;0;0;0;0;0;0;0;0;0;0;0;0;0;0;0;0
FR;8;2021-07-09;0;0;0;0;0;0;0;0;0;0;0;0;0;0;0;0;0;0
FR;8;2021-07-10;0;0;0;0;0;0;0;0;0;0;0;0;0;0;0;0;0;0
FR;8;2021-07-11;0;0;0;0;0;0;0;0;0;0;0;0;0;0;0;0;0;0
FR;8;2021-07-12;0;0;0;0;0;0;0;0;0;0;0;0;0;0;0;0;0;0
FR;8;2021-07-13;0;0;0;0;0;0;0;0;0;0;0;0;0;0;0;0;0;0
FR;8;2021-07-14;0;0;0;0;0;0;0;0;0;0;0;0;0;0;0;0;0;0
FR;8;2021-07-15;0;0;0;0;0;0;0;0;0;0;0;0;0;0;0;0;0;0
FR;8;2021-07-16;0;0;0;0;0;0;0;0;0;0;0;0;0;0;0;0;0;0
FR;8;2021-07-17;0;0;0;0;0;0;0;0;0;0;0;0;0;0;0;0;0;0
FR;8;2021-07-18;0;0;0;0;0;0;0;0;0;0;0;0;0;0;0;0;0;0
FR;8;2021-07-19;0;0;0;0;0;0;0;0;0;0;0;0;0;0;0;0;0;0
FR;8;2021-07-20;0;0;0;0;0;0;0;0;0;0;0;0;0;0;0;0;0;0
FR;8;2021-07-21;0;0;0;0;0;0;0;0;0;0;0;0;0;0;0;0;0;0
FR;8;2021-07-22;0;0;0;0;0;0;0;0;0;0;0;0;0;0;0;0;0;0
FR;8;2021-07-23;0;0;0;0;0;0;0;0;0;0;0;0;0;0;0;0;0;0
FR;8;2021-07-24;0;0;0;0;0;0;0;0;0;0;0;0;0;0;0;0;0;0
FR;8;2021-07-25;0;0;0;0;0;0;0;0;0;0;0;0;0;0;0;0;0;0
FR;8;2021-07-26;0;0;0;0;0;0;0;0;0;0;0;0;0;0;0;0;0;0
FR;8;2021-07-27;0;0;0;0;0;0;0;0;0;0;0;0;0;0;0;0;0;0
FR;8;2021-07-28;0;0;0;0;0;0;0;0;0;0;0;0;0;0;0;0;0;0
FR;8;2021-07-29;0;0;0;0;0;0;0;0;0;0;0;0;0;0;0;0;0;0
FR;8;2021-07-30;0;0;0;0;0;0;0;0;0;0;0;0;0;0;0;0;0;0
FR;8;2021-07-31;0;0;0;0;0;0;0;0;0;0;0;0;0;0;0;0;0;0
FR;8;2021-08-01;0;0;0;0;0;0;0;0;0;0;0;0;0;0;0;0;0;0
FR;8;2021-08-02;0;0;0;0;0;0;0;0;0;0;0;0;0;0;0;0;0;0
FR;8;2021-08-03;0;0;0;0;0;0;0;0;0;0;0;0;0;0;0;0;0;0
FR;8;2021-08-04;0;0;0;0;0;0;0;0;0;0;0;0;0;0;0;0;0;0
FR;8;2021-08-05;0;0;0;0;0;0;0;0;0;0;0;0;0;0;0;0;0;0
FR;8;2021-08-06;0;0;0;0;0;0;0;0;0;0;0;0;0;0;0;0;0;0
FR;8;2021-08-07;0;0;0;0;0;0;0;0;0;0;0;0;0;0;0;0;0;0
FR;8;2021-08-08;0;0;0;0;0;0;0;0;0;0;0;0;0;0;0;0;0;0
FR;8;2021-08-09;0;0;0;0;0;0;0;0;0;0;0;0;0;0;0;0;0;0
FR;8;2021-08-10;0;0;0;0;0;0;0;0;0;0;0;0;0;0;0;0;0;0
FR;8;2021-08-11;0;0;0;0;0;0;0;0;0;0;0;0;0;0;0;0;0;0
FR;8;2021-08-12;0;0;0;0;0;0;0;0;0;0;0;0;0;0;0;0;0;0
FR;8;2021-08-13;0;0;0;0;0;0;0;0;0;0;0;0;0;0;0;0;0;0
FR;8;2021-08-14;0;0;0;0;0;0;0;0;0;0;0;0;0;0;0;0;0;0
FR;8;2021-08-15;0;0;0;0;0;0;0;0;0;0;0;0;0;0;0;0;0;0
FR;8;2021-08-16;0;0;0;0;0;0;0;0;0;0;0;0;0;0;0;0;0;0
FR;8;2021-08-17;0;0;0;0;0;0;0;0;0;0;0;0;0;0;0;0;0;0
FR;8;2021-08-18;0;0;0;0;0;0;0;0;0;0;0;0;0;0;0;0;0;0
FR;8;2021-08-19;0;0;0;0;0;0;0;0;0;0;0;0;0;0;0;0;0;0
FR;8;2021-08-20;0;0;0;0;0;0;0;0;0;0;0;0;0;0;0;0;0;0
FR;8;2021-08-21;0;0;0;0;0;0;0;0;0;0;0;0;0;0;0;0;0;0
FR;8;2021-08-22;0;0;0;0;0;0;0;0;0;0;0;0;0;0;0;0;0;0
FR;8;2021-08-23;0;0;0;0;0;0;0;0;0;0;0;0;0;0;0;0;0;0
FR;8;2021-08-24;0;0;0;0;0;0;0;0;0;0;0;0;0;0;0;0;0;0
FR;8;2021-08-25;0;0;0;0;0;0;0;0;0;0;0;0;0;0;0;0;0;0
FR;8;2021-08-26;0;0;0;0;0;0;0;0;0;0;0;0;0;0;0;0;0;0
FR;8;2021-08-27;0;0;0;0;0;0;0;0;0;0;0;0;0;0;0;0;0;0
FR;8;2021-08-28;0;0;0;0;0;0;0;0;0;0;0;0;0;0;0;0;0;0
FR;8;2021-08-29;0;0;0;0;0;0;0;0;0;0;0;0;0;0;0;0;0;0
FR;8;2021-08-30;0;0;0;0;0;0;0;0;0;0;0;0;0;0;0;0;0;0
FR;8;2021-08-31;0;0;0;0;0;0;0;0;0;0;0;0;0;0;0;0;0;0
FR;8;2021-09-01;0;0;0;0;0;0;0;0;0;0;0;0;0;0;0;0;0;0
FR;8;2021-09-02;0;0;0;0;0;0;0;0;0;0;0;0;0;0;0;0;0;0
FR;8;2021-09-03;0;0;0;0;0;0;0;0;0;0;0;0;0;0;0;0;0;0
FR;8;2021-09-04;0;0;0;0;0;0;0;0;0;0;0;0;0;0;0;0;0;0
FR;8;2021-09-05;0;0;0;0;0;0;0;0;0;0;0;0;0;0;0;0;0;0
FR;8;2021-09-06;0;0;0;0;0;0;0;0;0;0;0;0;0;0;0;0;0;0
FR;8;2021-09-07;0;0;0;0;0;0;0;0;0;0;0;0;0;0;0;0;0;0
FR;8;2021-09-08;0;0;0;0;0;0;0;0;0;0;0;0;0;0;0;0;0;0
FR;8;2021-09-09;0;0;0;0;0;0;0;0;0;0;0;0;0;0;0;0;0;0
FR;8;2021-09-10;0;0;0;0;0;0;0;0;0;0;0;0;0;0;0;0;0;0
FR;8;2021-09-11;0;0;0;0;0;0;0;0;0;0;0;0;0;0;0;0;0;0
FR;8;2021-09-12;0;0;0;0;0;0;0;0;0;0;0;0;0;0;0;0;0;0
FR;8;2021-09-13;0;0;0;0;0;0;0;0;0;0;0;0;0;0;0;0;0;0
FR;8;2021-09-14;0;0;0;0;0;0;0;0;0;0;0;0;0;0;0;0;0;0
FR;8;2021-09-15;0;0;0;0;0;0;0;0;0;0;0;0;0;0;0;0;0;0
FR;8;2021-09-16;0;0;0;0;0;0;0;0;0;0;0;0;0;0;0;0;0;0
FR;8;2021-09-17;0;0;0;0;0;0;0;0;0;0;0;0;0;0;0;0;0;0
FR;8;2021-09-18;0;0;0;0;0;0;0;0;0;0;0;0;0;0;0;0;0;0
FR;8;2021-09-19;0;0;0;0;0;0;0;0;0;0;0;0;0;0;0;0;0;0
FR;8;2021-09-20;0;0;0;0;0;0;0;0;0;0;0;0;0;0;0;0;0;0
FR;8;2021-09-21;0;0;0;0;0;0;0;0;0;0;0;0;0;0;0;0;0;0
FR;8;2021-09-22;0;0;0;0;0;0;0;0;0;0;0;0;0;0;0;0;0;0
FR;8;2021-09-23;0;0;0;0;0;0;0;0;0;0;0;0;0;0;0;0;0;0
FR;8;2021-09-24;0;0;0;0;0;0;0;0;0;0;0;0;0;0;0;0;0;0
FR;8;2021-09-25;0;0;0;0;0;0;0;0;0;0;0;0;0;0;0;0;0;0
FR;8;2021-09-26;0;0;0;0;0;0;0;0;0;0;0;0;0;0;0;0;0;0
FR;8;2021-09-27;0;0;0;0;0;0;0;0;0;0;0;0;0;0;0;0;0;0
FR;8;2021-09-28;0;0;0;0;0;0;0;0;0;0;0;0;0;0;0;0;0;0
FR;8;2021-09-29;0;0;0;0;0;0;0;0;0;0;0;0;0;0;0;0;0;0
FR;8;2021-09-30;0;0;0;0;0;0;0;0;0;0;0;0;0;0;0;0;0;0
FR;8;2021-10-01;0;0;0;0;0;0;0;0;0;0;0;0;0;0;0;0;0;0
FR;8;2021-10-02;0;0;0;0;0;0;0;0;0;0;0;0;0;0;0;0;0;0
FR;8;2021-10-03;0;0;0;0;0;0;0;0;0;0;0;0;0;0;0;0;0;0
FR;8;2021-10-04;0;0;0;0;0;0;0;0;0;0;0;0;0;0;0;0;0;0
FR;8;2021-10-05;0;0;0;0;0;0;0;0;0;0;0;0;0;0;0;0;0;0
FR;8;2021-10-06;0;0;0;0;0;0;0;0;0;0;0;0;0;0;0;0;0;0
FR;8;2021-10-07;0;0;0;0;0;0;0;0;0;0;0;0;0;0;0;0;0;0
FR;8;2021-10-08;0;0;0;0;0;0;0;0;0;0;0;0;0;0;0;0;0;0
FR;8;2021-10-09;0;0;0;0;0;0;0;0;0;0;0;0;0;0;0;0;0;0
FR;8;2021-10-10;0;0;0;0;0;0;0;0;0;0;0;0;0;0;0;0;0;0
FR;8;2021-10-11;0;0;0;0;0;0;0;0;0;0;0;0;0;0;0;0;0;0
FR;8;2021-10-12;0;0;0;0;0;0;0;0;0;0;0;0;0;0;0;0;0;0
FR;8;2021-10-13;0;0;0;0;0;0;0;0;0;0;0;0;0;0;0;0;0;0
FR;8;2021-10-14;0;0;0;0;0;0;0;0;0;0;0;0;0;0;0;0;0;0
FR;8;2021-10-15;0;0;0;0;0;0;0;0;0;0;0;0;0;0;0;0;0;0
FR;8;2021-10-16;0;0;0;0;0;0;0;0;0;0;0;0;0;0;0;0;0;0
FR;8;2021-10-17;0;0;0;0;0;0;0;0;0;0;0;0;0;0;0;0;0;0
FR;8;2021-10-18;0;0;0;0;0;0;0;0;0;0;0;0;0;0;0;0;0;0
FR;8;2021-10-19;0;0;0;0;0;0;0;0;0;0;0;0;0;0;0;0;0;0
FR;8;2021-10-20;0;0;0;0;0;0;0;0;0;0;0;0;0;0;0;0;0;0
FR;8;2021-10-21;0;0;0;0;0;0;0;0;0;0;0;0;0;0;0;0;0;0
FR;8;2021-10-22;0;0;0;0;0;0;0;0;0;0;0;0;0;0;0;0;0;0
FR;8;2021-10-23;0;0;0;0;0;0;0;0;0;0;0;0;0;0;0;0;0;0
FR;8;2021-10-24;0;0;0;0;0;0;0;0;0;0;0;0;0;0;0;0;0;0
FR;8;2021-10-25;0;0;0;0;0;0;0;0;0;0;0;0;0;0;0;0;0;0
FR;8;2021-10-26;0;0;0;0;0;0;0;0;0;0;0;0;0;0;0;0;0;0
FR;8;2021-10-27;0;0;0;0;0;0;0;0;0;0;0;0;0;0;0;0;0;0
FR;8;2021-10-28;0;0;0;0;0;0;0;0;0;0;0;0;0;0;0;0;0;0
FR;8;2021-10-29;0;0;0;0;0;0;0;0;0;0;0;0;0;0;0;0;0;0
FR;8;2021-10-30;0;0;0;0;0;0;0;0;0;0;0;0;0;0;0;0;0;0
FR;8;2021-10-31;0;0;0;0;0;0;0;0;0;0;0;0;0;0;0;0;0;0
FR;8;2021-11-01;0;0;0;0;0;0;0;0;0;0;0;0;0;0;0;0;0;0
FR;8;2021-11-02;0;0;0;0;0;0;0;0;0;0;0;0;0;0;0;0;0;0
FR;8;2021-11-03;0;0;0;0;0;0;0;0;0;0;0;0;0;0;0;0;0;0
FR;8;2021-11-04;0;0;0;0;0;0;0;0;0;0;0;0;0;0;0;0;0;0
FR;8;2021-11-05;0;0;0;0;0;0;0;0;0;0;0;0;0;0;0;0;0;0
FR;8;2021-11-06;0;0;0;0;0;0;0;0;0;0;0;0;0;0;0;0;0;0
FR;8;2021-11-07;0;0;0;0;0;0;0;0;0;0;0;0;0;0;0;0;0;0
FR;8;2021-11-08;0;0;0;0;0;0;0;0;0;0;0;0;0;0;0;0;0;0
FR;8;2021-11-09;0;0;0;0;0;0;0;0;0;0;0;0;0;0;0;0;0;0
FR;8;2021-11-10;0;0;0;0;0;0;0;0;0;0;0;0;0;0;0;0;0;0
FR;8;2021-11-11;0;0;0;0;0;0;0;0;0;0;0;0;0;0;0;0;0;0
FR;8;2021-11-12;0;0;0;0;0;0;0;0;0;0;0;0;0;0;0;0;0;0
FR;8;2021-11-13;0;0;0;0;0;0;0;0;0;0;0;0;0;0;0;0;0;0
FR;8;2021-11-14;0;0;0;0;0;0;0;0;0;0;0;0;0;0;0;0;0;0
FR;8;2021-11-15;0;0;0;0;0;0;0;0;0;0;0;0;0;0;0;0;0;0
FR;8;2021-11-16;0;0;0;0;0;0;0;0;0;0;0;0;0;0;0;0;0;0
FR;8;2021-11-17;0;0;0;0;0;0;0;0;0;0;0;0;0;0;0;0;0;0
FR;8;2021-11-18;0;0;0;0;0;0;0;0;0;0;0;0;0;0;0;0;0;0
FR;8;2021-11-19;0;0;0;0;0;0;0;0;0;0;0;0;0;0;0;0;0;0
FR;8;2021-11-20;0;0;0;0;0;0;0;0;0;0;0;0;0;0;0;0;0;0
FR;8;2021-11-21;0;0;0;0;0;0;0;0;0;0;0;0;0;0;0;0;0;0
FR;8;2021-11-22;0;0;0;0;0;0;0;0;0;0;0;0;0;0;0;0;0;0
FR;8;2021-11-23;0;0;0;0;0;0;0;0;0;0;0;0;0;0;0;0;0;0
FR;8;2021-11-24;0;0;0;0;0;0;0;0;0;0;0;0;0;0;0;0;0;0
FR;8;2021-11-25;0;0;0;0;0;0;0;0;0;0;0;0;0;0;0;0;0;0
FR;8;2021-11-26;0;0;0;0;0;0;0;0;0;0;0;0;0;0;0;0;0;0
FR;8;2021-11-27;0;0;0;0;0;0;0;0;0;0;0;0;0;0;0;0;0;0
FR;8;2021-11-28;0;0;0;0;0;0;0;0;0;0;0;0;0;0;0;0;0;0
FR;8;2021-11-29;0;0;0;0;0;0;0;0;0;0;0;0;0;0;0;0;0;0
FR;8;2021-11-30;0;0;0;0;0;0;0;0;0;0;0;0;0;0;0;0;0;0
FR;8;2021-12-01;0;0;0;0;0;0;0;0;0;0;0;0;0;0;0;0;0;0
FR;8;2021-12-02;0;0;0;0;0;0;0;0;0;0;0;0;0;0;0;0;0;0
FR;8;2021-12-03;0;0;0;0;0;0;0;0;0;0;0;0;0;0;0;0;0;0
FR;8;2021-12-04;0;0;0;0;0;0;0;0;0;0;0;0;0;0;0;0;0;0
FR;8;2021-12-05;0;0;0;0;0;0;0;0;0;0;0;0;0;0;0;0;0;0
FR;8;2021-12-06;0;0;0;0;0;0;0;0;0;0;0;0;0;0;0;0;0;0
FR;8;2021-12-07;0;0;0;0;0;0;0;0;0;0;0;0;0;0;0;0;0;0
FR;8;2021-12-08;0;0;0;0;0;0;0;0;0;0;0;0;0;0;0;0;0;0
FR;8;2021-12-09;0;0;0;0;0;0;0;0;0;0;0;0;0;0;0;0;0;0
FR;8;2021-12-10;0;0;0;0;0;0;0;0;0;0;0;0;0;0;0;0;0;0
FR;8;2021-12-11;0;0;0;0;0;0;0;0;0;0;0;0;0;0;0;0;0;0
FR;8;2021-12-12;0;0;0;0;0;0;0;0;0;0;0;0;0;0;0;0;0;0
FR;8;2021-12-13;0;0;0;0;0;0;0;0;0;0;0;0;0;0;0;0;0;0
FR;8;2021-12-14;0;0;0;0;0;0;0;0;0;0;0;0;0;0;0;0;0;0
FR;8;2021-12-15;0;0;0;0;0;0;0;0;0;0;0;0;0;0;0;0;0;0
FR;8;2021-12-16;0;0;0;0;0;0;0;0;0;0;0;0;0;0;0;0;0;0
FR;8;2021-12-17;0;0;0;0;0;0;0;0;0;0;0;0;0;0;0;0;0;0
FR;8;2021-12-18;0;0;0;0;0;0;0;0;0;0;0;0;0;0;0;0;0;0
FR;8;2021-12-19;0;0;0;0;0;0;0;0;0;0;0;0;0;0;0;0;0;0
FR;8;2021-12-20;0;0;0;0;0;0;0;0;0;0;0;0;0;0;0;0;0;0
FR;8;2021-12-21;0;0;0;0;0;0;0;0;0;0;0;0;0;0;0;0;0;0
FR;8;2021-12-22;0;0;0;0;0;0;0;0;0;0;0;0;0;0;0;0;0;0
FR;8;2021-12-23;0;0;0;0;0;0;0;0;0;0;0;0;0;0;0;0;0;0
FR;8;2021-12-24;0;0;0;0;0;0;0;0;0;0;0;0;0;0;0;0;0;0
FR;8;2021-12-25;0;0;0;0;0;0;0;0;0;0;0;0;0;0;0;0;0;0
FR;8;2021-12-26;0;0;0;0;0;0;0;0;0;0;0;0;0;0;0;0;0;0
FR;8;2021-12-27;0;0;0;0;0;0;0;0;0;0;0;0;0;0;0;0;0;0
FR;8;2021-12-28;0;0;0;0;0;0;0;0;0;0;0;0;0;0;0;0;0;0
FR;8;2021-12-29;0;0;0;0;0;0;0;0;0;0;0;0;0;0;0;0;0;0
FR;8;2021-12-30;0;0;0;0;0;0;0;0;0;0;0;0;0;0;0;0;0;0
FR;8;2021-12-31;0;0;0;0;0;0;0;0;0;0;0;0;0;0;0;0;0;0
FR;8;2022-01-01;0;0;0;0;0;0;0;0;0;0;0;0;0;0;0;0;0;0
FR;8;2022-01-02;0;0;0;0;0;0;0;0;0;0;0;0;0;0;0;0;0;0
FR;8;2022-01-03;0;0;0;0;0;0;0;0;0;0;0;0;0;0;0;0;0;0
FR;8;2022-01-04;0;0;0;0;0;0;0;0;0;0;0;0;0;0;0;0;0;0
FR;8;2022-01-05;0;0;0;0;0;0;0;0;0;0;0;0;0;0;0;0;0;0
FR;8;2022-01-06;0;0;0;0;0;0;0;0;0;0;0;0;0;0;0;0;0;0
FR;8;2022-01-07;0;0;0;0;0;0;0;0;0;0;0;0;0;0;0;0;0;0
FR;8;2022-01-08;0;0;0;0;0;0;0;0;0;0;0;0;0;0;0;0;0;0
FR;8;2022-01-09;0;0;0;0;0;0;0;0;0;0;0;0;0;0;0;0;0;0
FR;8;2022-01-10;0;0;0;0;0;0;0;0;0;0;0;0;0;0;0;0;0;0
FR;8;2022-01-11;0;0;0;0;0;0;0;0;0;0;0;0;0;0;0;0;0;0
FR;8;2022-01-12;0;0;0;0;0;0;0;0;0;0;0;0;0;0;0;0;0;0
FR;8;2022-01-13;0;0;0;0;0;0;0;0;0;0;0;0;0;0;0;0;0;0
FR;8;2022-01-14;0;0;0;0;0;0;0;0;0;0;0;0;0;0;0;0;0;0
FR;8;2022-01-15;0;0;0;0;0;0;0;0;0;0;0;0;0;0;0;0;0;0
FR;8;2022-01-16;0;0;0;0;0;0;0;0;0;0;0;0;0;0;0;0;0;0
FR;8;2022-01-17;0;0;0;0;0;0;0;0;0;0;0;0;0;0;0;0;0;0
FR;8;2022-01-18;0;0;0;0;0;0;0;0;0;0;0;0;0;0;0;0;0;0
FR;8;2022-01-19;0;0;0;0;0;0;0;0;0;0;0;0;0;0;0;0;0;0
FR;8;2022-01-20;0;0;0;0;0;0;0;0;0;0;0;0;0;0;0;0;0;0
FR;8;2022-01-21;0;0;0;0;0;0;0;0;0;0;0;0;0;0;0;0;0;0
FR;8;2022-01-22;0;0;0;0;0;0;0;0;0;0;0;0;0;0;0;0;0;0
FR;8;2022-01-23;0;0;0;0;0;0;0;0;0;0;0;0;0;0;0;0;0;0
FR;8;2022-01-24;0;0;0;0;0;0;0;0;0;0;0;0;0;0;0;0;0;0
FR;8;2022-01-25;0;0;0;0;0;0;0;0;0;0;0;0;0;0;0;0;0;0
FR;8;2022-01-26;0;0;0;0;0;0;0;0;0;0;0;0;0;0;0;0;0;0
FR;8;2022-01-27;0;0;0;0;0;0;0;0;0;0;0;0;0;0;0;0;0;0
FR;8;2022-01-28;0;0;0;0;0;0;0;0;0;0;0;0;0;0;0;0;0;0
FR;8;2022-01-29;0;0;0;0;0;0;0;0;0;0;0;0;0;0;0;0;0;0
FR;8;2022-01-30;0;0;0;0;0;0;0;0;0;0;0;0;0;0;0;0;0;0
FR;8;2022-01-31;0;0;0;0;0;0;0;0;0;0;0;0;0;0;0;0;0;0
FR;8;2022-02-01;0;0;0;0;0;0;0;0;0;0;0;0;0;0;0;0;0;0
FR;8;2022-02-02;0;0;0;0;0;0;0;0;0;0;0;0;0;0;0;0;0;0
FR;8;2022-02-03;0;0;0;0;0;0;0;0;0;0;0;0;0;0;0;0;0;0
FR;8;2022-02-04;0;0;0;0;0;0;0;0;0;0;0;0;0;0;0;0;0;0
FR;8;2022-02-05;0;0;0;0;0;0;0;0;0;0;0;0;0;0;0;0;0;0
FR;8;2022-02-06;0;0;0;0;0;0;0;0;0;0;0;0;0;0;0;0;0;0
FR;8;2022-02-07;0;0;0;0;0;0;0;0;0;0;0;0;0;0;0;0;0;0
FR;8;2022-02-08;0;0;0;0;0;0;0;0;0;0;0;0;0;0;0;0;0;0
FR;8;2022-02-09;0;0;0;0;0;0;0;0;0;0;0;0;0;0;0;0;0;0
FR;8;2022-02-10;0;0;0;0;0;0;0;0;0;0;0;0;0;0;0;0;0;0
FR;8;2022-02-11;0;0;0;0;0;0;0;0;0;0;0;0;0;0;0;0;0;0
FR;8;2022-02-12;0;0;0;0;0;0;0;0;0;0;0;0;0;0;0;0;0;0
FR;8;2022-02-13;0;0;0;0;0;0;0;0;0;0;0;0;0;0;0;0;0;0
FR;8;2022-02-14;0;0;0;0;0;0;0;0;0;0;0;0;0;0;0;0;0;0
FR;8;2022-02-15;0;0;0;0;0;0;0;0;0;0;0;0;0;0;0;0;0;0
FR;8;2022-02-16;0;0;0;0;0;0;0;0;0;0;0;0;0;0;0;0;0;0
FR;8;2022-02-17;0;0;0;0;0;0;0;0;0;0;0;0;0;0;0;0;0;0
FR;8;2022-02-18;0;0;0;0;0;0;0;0;0;0;0;0;0;0;0;0;0;0
FR;8;2022-02-19;0;0;0;0;0;0;0;0;0;0;0;0;0;0;0;0;0;0
FR;8;2022-02-20;0;0;0;0;0;0;0;0;0;0;0;0;0;0;0;0;0;0
FR;8;2022-02-21;0;0;0;0;0;0;0;0;0;0;0;0;0;0;0;0;0;0
FR;8;2022-02-22;0;0;0;0;0;0;0;0;0;0;0;0;0;0;0;0;0;0
FR;8;2022-02-23;0;0;0;0;0;0;0;0;0;0;0;0;0;0;0;0;0;0
FR;8;2022-02-24;0;0;0;0;0;0;0;0;0;0;0;0;0;0;0;0;0;0
FR;8;2022-02-25;0;0;0;0;0;0;0;0;0;0;0;0;0;0;0;0;0;0
FR;8;2022-02-26;0;0;0;0;0;0;0;0;0;0;0;0;0;0;0;0;0;0
FR;8;2022-02-27;0;0;0;0;0;0;0;0;0;0;0;0;0;0;0;0;0;0
FR;8;2022-02-28;0;0;0;0;0;0;0;0;0;0;0;0;0;0;0;0;0;0
FR;8;2022-03-01;0;0;0;0;0;0;0;0;0;0;0;0;0;0;0;0;0;0
FR;8;2022-03-02;0;0;0;0;0;0;0;0;0;0;0;0;0;0;0;0;0;0
FR;8;2022-03-03;0;0;0;0;0;0;0;0;0;0;0;0;0;0;0;0;0;0
FR;8;2022-03-04;0;0;0;0;0;0;0;0;0;0;0;0;0;0;0;0;0;0
FR;8;2022-03-05;0;0;0;0;0;0;0;0;0;0;0;0;0;0;0;0;0;0
FR;8;2022-03-06;0;0;0;0;0;0;0;0;0;0;0;0;0;0;0;0;0;0
FR;8;2022-03-07;0;0;0;0;0;0;0;0;0;0;0;0;0;0;0;0;0;0
FR;8;2022-03-08;0;0;0;0;0;0;0;0;0;0;0;0;0;0;0;0;0;0
FR;8;2022-03-09;0;0;0;0;0;0;0;0;0;0;0;0;0;0;0;0;0;0
FR;8;2022-03-10;0;0;0;0;0;0;0;0;0;0;0;0;0;0;0;0;0;0
FR;8;2022-03-11;0;0;0;0;0;0;0;0;0;0;0;0;0;0;0;0;0;0
FR;8;2022-03-12;0;0;0;0;0;0;0;0;0;0;0;0;0;0;0;0;0;0
FR;8;2022-03-13;0;0;0;0;0;0;0;0;0;0;0;0;0;0;0;0;0;0
FR;8;2022-03-14;0;0;0;0;0;0;0;0;0;0;0;0;0;0;0;0;0;0
FR;8;2022-03-15;0;0;0;0;0;0;0;0;0;0;0;0;0;0;0;0;0;0
FR;8;2022-03-16;0;0;0;0;0;0;0;0;0;0;0;0;0;0;0;0;0;0
FR;8;2022-03-17;0;0;0;0;0;0;0;0;0;0;0;0;0;0;0;0;0;0
FR;8;2022-03-18;0;0;0;0;0;0;0;0;0;0;0;0;0;0;0;0;0;0
FR;8;2022-03-19;0;0;0;0;0;0;0;0;0;0;0;0;0;0;0;0;0;0
FR;8;2022-03-20;0;0;0;0;0;0;0;0;0;0;0;0;0;0;0;0;0;0
FR;8;2022-03-21;0;0;0;0;0;0;0;0;0;0;0;0;0;0;0;0;0;0
FR;8;2022-03-22;0;0;0;0;0;0;0;0;0;0;0;0;0;0;0;0;0;0
FR;8;2022-03-23;0;0;0;0;0;0;0;0;0;0;0;0;0;0;0;0;0;0
FR;8;2022-03-24;0;0;0;0;0;0;0;0;0;0;0;0;0;0;0;0;0;0
FR;8;2022-03-25;0;0;0;0;0;0;0;0;0;0;0;0;0;0;0;0;0;0
FR;8;2022-03-26;0;0;0;0;0;0;0;0;0;0;0;0;0;0;0;0;0;0
FR;8;2022-03-27;0;0;0;0;0;0;0;0;0;0;0;0;0;0;0;0;0;0
FR;8;2022-03-28;0;0;0;0;0;0;0;0;0;0;0;0;0;0;0;0;0;0
FR;8;2022-03-29;0;0;0;0;0;0;0;0;0;0;0;0;0;0;0;0;0;0
FR;8;2022-03-30;0;0;0;0;0;0;0;0;0;0;0;0;0;0;0;0;0;0
FR;8;2022-03-31;0;0;0;0;0;0;0;0;0;0;0;0;0;0;0;0;0;0
FR;8;2022-04-01;0;0;0;0;0;0;0;0;0;0;0;0;0;0;0;0;0;0
FR;8;2022-04-02;0;0;0;0;0;0;0;0;0;0;0;0;0;0;0;0;0;0
FR;8;2022-04-03;0;0;0;0;0;0;0;0;0;0;0;0;0;0;0;0;0;0
FR;8;2022-04-04;0;0;0;0;0;0;0;0;0;0;0;0;0;0;0;0;0;0
FR;8;2022-04-05;0;0;0;0;0;0;0;0;0;0;0;0;0;0;0;0;0;0
FR;8;2022-04-06;0;0;0;0;0;0;0;0;0;0;0;0;0;0;0;0;0;0
FR;8;2022-04-07;0;0;0;0;0;0;0;0;0;0;0;0;0;0;0;0;0;0
FR;8;2022-04-08;0;0;0;0;0;0;0;0;0;0;0;0;0;0;0;0;0;0
FR;8;2022-04-09;0;0;0;0;0;0;0;0;0;0;0;0;0;0;0;0;0;0
FR;8;2022-04-10;0;0;0;0;0;0;0;0;0;0;0;0;0;0;0;0;0;0
FR;8;2022-04-11;0;0;0;0;0;0;0;0;0;0;0;0;0;0;0;0;0;0
FR;8;2022-04-12;0;0;0;0;0;0;0;0;0;0;0;0;0;0;0;0;0;0
FR;8;2022-04-13;0;0;0;0;0;0;0;0;0;0;0;0;0;0;0;0;0;0
FR;8;2022-04-14;0;0;0;0;0;0;0;0;0;0;0;0;0;0;0;0;0;0
FR;8;2022-04-15;0;0;0;0;0;0;0;0;0;0;0;0;0;0;0;0;0;0
FR;8;2022-04-16;0;0;0;0;0;0;0;0;0;0;0;0;0;0;0;0;0;0
FR;8;2022-04-17;0;0;0;0;0;0;0;0;0;0;0;0;0;0;0;0;0;0
FR;8;2022-04-18;0;0;0;0;0;0;0;0;0;0;0;0;0;0;0;0;0;0
FR;8;2022-04-19;0;0;0;0;0;0;0;0;0;0;0;0;0;0;0;0;0;0
FR;8;2022-04-20;0;0;0;0;0;0;0;0;0;0;0;0;0;0;0;0;0;0
FR;8;2022-04-21;0;0;0;0;0;0;0;0;0;0;0;0;0;0;0;0;0;0
FR;8;2022-04-22;0;0;0;0;0;0;0;0;0;0;0;0;0;0;0;0;0;0
FR;8;2022-04-23;0;0;0;0;0;0;0;0;0;0;0;0;0;0;0;0;0;0
FR;8;2022-04-24;0;0;0;0;0;0;0;0;0;0;0;0;0;0;0;0;0;0
FR;8;2022-04-25;0;0;0;0;0;0;0;0;0;0;0;0;0;0;0;0;0;0
FR;8;2022-04-26;0;0;0;0;0;0;0;0;0;0;0;0;0;0;0;0;0;0
FR;8;2022-04-27;0;0;0;0;0;0;0;0;0;0;0;0;0;0;0;0;0;0
FR;8;2022-04-28;0;0;0;0;0;0;0;0;0;0;0;0;0;0;0;0;0;0
FR;8;2022-04-29;0;0;0;0;0;0;0;0;0;0;0;0;0;0;0;0;0;0
FR;8;2022-04-30;0;0;0;0;0;0;0;0;0;0;0;0;0;0;0;0;0;0
FR;8;2022-05-01;0;0;0;0;0;0;0;0;0;0;0;0;0;0;0;0;0;0
FR;8;2022-05-02;0;0;0;0;0;0;0;0;0;0;0;0;0;0;0;0;0;0
FR;8;2022-05-03;0;0;0;0;0;0;0;0;0;0;0;0;0;0;0;0;0;0
FR;8;2022-05-04;0;0;0;0;0;0;0;0;0;0;0;0;0;0;0;0;0;0
FR;8;2022-05-05;0;0;0;0;0;0;0;0;0;0;0;0;0;0;0;0;0;0
FR;8;2022-05-06;0;0;0;0;0;0;0;0;0;0;0;0;0;0;0;0;0;0
FR;8;2022-05-07;0;0;0;0;0;0;0;0;0;0;0;0;0;0;0;0;0;0
FR;8;2022-05-08;0;0;0;0;0;0;0;0;0;0;0;0;0;0;0;0;0;0
FR;8;2022-05-09;0;0;0;0;0;0;0;0;0;0;0;0;0;0;0;0;0;0
FR;8;2022-05-10;0;0;0;0;0;0;0;0;0;0;0;0;0;0;0;0;0;0
FR;8;2022-05-11;0;0;0;0;0;0;0;0;0;0;0;0;0;0;0;0;0;0
FR;8;2022-05-12;0;0;0;0;0;0;0;0;0;0;0;0;0;0;0;0;0;0
FR;8;2022-05-13;0;0;0;0;0;0;0;0;0;0;0;0;0;0;0;0;0;0
FR;8;2022-05-14;0;0;0;0;0;0;0;0;0;0;0;0;0;0;0;0;0;0
FR;8;2022-05-15;0;0;0;0;0;0;0;0;0;0;0;0;0;0;0;0;0;0
FR;8;2022-05-16;0;0;0;0;0;0;0;0;0;0;0;0;0;0;0;0;0;0
FR;8;2022-05-17;0;0;0;0;0;0;0;0;0;0;0;0;0;0;0;0;0;0
FR;8;2022-05-18;0;0;0;0;0;0;0;0;0;0;0;0;0;0;0;0;0;0
FR;8;2022-05-19;0;0;0;0;0;0;0;0;0;0;0;0;0;0;0;0;0;0
FR;8;2022-05-20;0;0;0;0;0;0;0;0;0;0;0;0;0;0;0;0;0;0
FR;8;2022-05-21;0;0;0;0;0;0;0;0;0;0;0;0;0;0;0;0;0;0
FR;8;2022-05-22;0;0;0;0;0;0;0;0;0;0;0;0;0;0;0;0;0;0
FR;8;2022-05-23;0;0;0;0;0;0;0;0;0;0;0;0;0;0;0;0;0;0
FR;8;2022-05-24;0;0;0;0;0;0;0;0;0;0;0;0;0;0;0;0;0;0
FR;8;2022-05-25;0;0;0;0;0;0;0;0;0;0;0;0;0;0;0;0;0;0
FR;8;2022-05-26;0;0;0;0;0;0;0;0;0;0;0;0;0;0;0;0;0;0
FR;8;2022-05-27;0;0;0;0;0;0;0;0;0;0;0;0;0;0;0;0;0;0
FR;8;2022-05-28;0;0;0;0;0;0;0;0;0;0;0;0;0;0;0;0;0;0
FR;8;2022-05-29;0;0;0;0;0;0;0;0;0;0;0;0;0;0;0;0;0;0
FR;8;2022-05-30;0;0;0;0;0;0;0;0;0;0;0;0;0;0;0;0;0;0
FR;8;2022-05-31;0;0;0;0;0;0;0;0;0;0;0;0;0;0;0;0;0;0
FR;8;2022-06-01;0;0;0;0;0;0;0;0;0;0;0;0;0;0;0;0;0;0
FR;8;2022-06-02;0;0;0;0;0;0;0;0;0;0;0;0;0;0;0;0;0;0
FR;8;2022-06-03;0;0;0;0;0;0;0;0;0;0;0;0;0;0;0;0;0;0
FR;8;2022-06-04;0;0;0;0;0;0;0;0;0;0;0;0;0;0;0;0;0;0
FR;8;2022-06-05;0;0;0;0;0;0;0;0;0;0;0;0;0;0;0;0;0;0
FR;8;2022-06-06;0;0;0;0;0;0;0;0;0;0;0;0;0;0;0;0;0;0
FR;8;2022-06-07;0;0;0;0;0;0;0;0;0;0;0;0;0;0;0;0;0;0
FR;8;2022-06-08;0;0;0;0;0;0;0;0;0;0;0;0;0;0;0;0;0;0
FR;8;2022-06-09;0;0;0;0;0;0;0;0;0;0;0;0;0;0;0;0;0;0
FR;8;2022-06-10;0;0;0;0;0;0;0;0;0;0;0;0;0;0;0;0;0;0
FR;8;2022-06-11;0;0;0;0;0;0;0;0;0;0;0;0;0;0;0;0;0;0
FR;8;2022-06-12;0;0;0;0;0;0;0;0;0;0;0;0;0;0;0;0;0;0
FR;8;2022-06-13;0;0;0;0;0;0;0;0;0;0;0;0;0;0;0;0;0;0
FR;8;2022-06-14;0;0;0;0;0;0;0;0;0;0;0;0;0;0;0;0;0;0
FR;8;2022-06-15;0;0;0;0;0;0;0;0;0;0;0;0;0;0;0;0;0;0
FR;8;2022-06-16;0;0;0;0;0;0;0;0;0;0;0;0;0;0;0;0;0;0
FR;8;2022-06-17;0;0;0;0;0;0;0;0;0;0;0;0;0;0;0;0;0;0
FR;8;2022-06-18;0;0;0;0;0;0;0;0;0;0;0;0;0;0;0;0;0;0
FR;8;2022-06-19;0;0;0;0;0;0;0;0;0;0;0;0;0;0;0;0;0;0
FR;8;2022-06-20;0;0;0;0;0;0;0;0;0;0;0;0;0;0;0;0;0;0
FR;8;2022-06-21;0;0;0;0;0;0;0;0;0;0;0;0;0;0;0;0;0;0
FR;8;2022-06-22;0;0;0;0;0;0;0;0;0;0;0;0;0;0;0;0;0;0
FR;8;2022-06-23;0;0;0;0;0;0;0;0;0;0;0;0;0;0;0;0;0;0
FR;8;2022-06-24;0;0;0;0;0;0;0;0;0;0;0;0;0;0;0;0;0;0
FR;8;2022-06-25;0;0;0;0;0;0;0;0;0;0;0;0;0;0;0;0;0;0
FR;8;2022-06-26;0;0;0;0;0;0;0;0;0;0;0;0;0;0;0;0;0;0
FR;8;2022-06-27;0;0;0;0;0;0;0;0;0;0;0;0;0;0;0;0;0;0
FR;8;2022-06-28;0;0;0;0;0;0;0;0;0;0;0;0;0;0;0;0;0;0
FR;8;2022-06-29;0;0;0;0;0;0;0;0;0;0;0;0;0;0;0;0;0;0
FR;8;2022-06-30;0;0;0;0;0;0;0;0;0;0;0;0;0;0;0;0;0;0
FR;8;2022-07-01;0;0;0;0;0;0;0;0;0;0;0;0;0;0;0;0;0;0
FR;8;2022-07-02;0;0;0;0;0;0;0;0;0;0;0;0;0;0;0;0;0;0
FR;8;2022-07-03;0;0;0;0;0;0;0;0;0;0;0;0;0;0;0;0;0;0
FR;8;2022-07-04;0;0;0;0;0;0;0;0;0;0;0;0;0;0;0;0;0;0
FR;8;2022-07-05;0;0;0;0;0;0;0;0;0;0;0;0;0;0;0;0;0;0
FR;8;2022-07-06;0;0;0;0;0;0;0;0;0;0;0;0;0;0;0;0;0;0
FR;8;2022-07-07;0;0;0;0;0;0;0;0;0;0;0;0;0;0;0;0;0;0
FR;8;2022-07-08;0;0;0;0;0;0;0;0;0;0;0;0;0;0;0;0;0;0
FR;8;2022-07-09;0;0;0;0;0;0;0;0;0;0;0;0;0;0;0;0;0;0
FR;8;2022-07-10;0;0;0;0;0;0;0;0;0;0;0;0;0;0;0;0;0;0
FR;8;2022-07-11;0;0;0;0;0;0;0;0;0;0;0;0;0;0;0;0;0;0
FR;8;2022-07-12;0;0;0;0;0;0;0;0;0;0;0;0;0;0;0;0;0;0
FR;8;2022-07-13;0;0;0;0;0;0;0;0;0;0;0;0;0;0;0;0;0;0
FR;8;2022-07-14;0;0;0;0;0;0;0;0;0;0;0;0;0;0;0;0;0;0
FR;8;2022-07-15;0;0;0;0;0;0;0;0;0;0;0;0;0;0;0;0;0;0
FR;8;2022-07-16;0;0;0;0;0;0;0;0;0;0;0;0;0;0;0;0;0;0
FR;8;2022-07-17;0;0;0;0;0;0;0;0;0;0;0;0;0;0;0;0;0;0
FR;8;2022-07-18;0;0;0;0;0;0;0;0;0;0;0;0;0;0;0;0;0;0
FR;8;2022-07-19;0;0;0;0;0;0;0;0;0;0;0;0;0;0;0;0;0;0
FR;8;2022-07-20;0;0;0;0;0;0;0;0;0;0;0;0;0;0;0;0;0;0
FR;8;2022-07-21;0;0;0;0;0;0;0;0;0;0;0;0;0;0;0;0;0;0
FR;8;2022-07-22;0;0;0;0;0;0;0;0;0;0;0;0;0;0;0;0;0;0
FR;8;2022-07-23;0;0;0;0;0;0;0;0;0;0;0;0;0;0;0;0;0;0
FR;8;2022-07-24;0;0;0;0;0;0;0;0;0;0;0;0;0;0;0;0;0;0
FR;8;2022-07-25;0;0;0;0;0;0;0;0;0;0;0;0;0;0;0;0;0;0
FR;8;2022-07-26;0;0;0;0;0;0;0;0;0;0;0;0;0;0;0;0;0;0
FR;8;2022-07-27;0;0;0;0;0;0;0;0;0;0;0;0;0;0;0;0;0;0
FR;8;2022-07-28;0;0;0;0;0;0;0;0;0;0;0;0;0;0;0;0;0;0
FR;8;2022-07-29;0;0;0;0;0;0;0;0;0;0;0;0;0;0;0;0;0;0
FR;8;2022-07-30;0;0;0;0;0;0;0;0;0;0;0;0;0;0;0;0;0;0
FR;8;2022-07-31;0;0;0;0;0;0;0;0;0;0;0;0;0;0;0;0;0;0
FR;8;2022-08-01;0;0;0;0;0;0;0;0;0;0;0;0;0;0;0;0;0;0
FR;8;2022-08-02;0;0;0;0;0;0;0;0;0;0;0;0;0;0;0;0;0;0
FR;8;2022-08-03;0;0;0;0;0;0;0;0;0;0;0;0;0;0;0;0;0;0
FR;8;2022-08-04;0;0;0;0;0;0;0;0;0;0;0;0;0;0;0;0;0;0
FR;8;2022-08-05;0;0;0;0;0;0;0;0;0;0;0;0;0;0;0;0;0;0
FR;8;2022-08-06;0;0;0;0;0;0;0;0;0;0;0;0;0;0;0;0;0;0
FR;8;2022-08-07;0;0;0;0;0;0;0;0;0;0;0;0;0;0;0;0;0;0
FR;8;2022-08-08;0;0;0;0;0;0;0;0;0;0;0;0;0;0;0;0;0;0
FR;8;2022-08-09;0;0;0;0;0;0;0;0;0;0;0;0;0;0;0;0;0;0
FR;8;2022-08-10;0;0;0;0;0;0;0;0;0;0;0;0;0;0;0;0;0;0
FR;8;2022-08-11;0;0;0;0;0;0;0;0;0;0;0;0;0;0;0;0;0;0
FR;8;2022-08-12;0;0;0;0;0;0;0;0;0;0;0;0;0;0;0;0;0;0
FR;8;2022-08-13;0;0;0;0;0;0;0;0;0;0;0;0;0;0;0;0;0;0
FR;8;2022-08-14;0;0;0;0;0;0;0;0;0;0;0;0;0;0;0;0;0;0
FR;8;2022-08-15;0;0;0;0;0;0;0;0;0;0;0;0;0;0;0;0;0;0
FR;8;2022-08-16;0;0;0;0;0;0;0;0;0;0;0;0;0;0;0;0;0;0
FR;8;2022-08-17;0;0;0;0;0;0;0;0;0;0;0;0;0;0;0;0;0;0
FR;8;2022-08-18;0;0;0;0;0;0;0;0;0;0;0;0;0;0;0;0;0;0
FR;8;2022-08-19;0;0;0;0;0;0;0;0;0;0;0;0;0;0;0;0;0;0
FR;8;2022-08-20;0;0;0;0;0;0;0;0;0;0;0;0;0;0;0;0;0;0
FR;8;2022-08-21;0;0;0;0;0;0;0;0;0;0;0;0;0;0;0;0;0;0
FR;8;2022-08-22;0;0;0;0;0;0;0;0;0;0;0;0;0;0;0;0;0;0
FR;8;2022-08-23;0;0;0;0;0;0;0;0;0;0;0;0;0;0;0;0;0;0
FR;8;2022-08-24;0;0;0;0;0;0;0;0;0;0;0;0;0;0;0;0;0;0
FR;8;2022-08-25;0;0;0;0;0;0;0;0;0;0;0;0;0;0;0;0;0;0
FR;8;2022-08-26;0;0;0;0;0;0;0;0;0;0;0;0;0;0;0;0;0;0
FR;8;2022-08-27;0;0;0;0;0;0;0;0;0;0;0;0;0;0;0;0;0;0
FR;8;2022-08-28;0;0;0;0;0;0;0;0;0;0;0;0;0;0;0;0;0;0
FR;8;2022-08-29;0;0;0;0;0;0;0;0;0;0;0;0;0;0;0;0;0;0
FR;8;2022-08-30;0;0;0;0;0;0;0;0;0;0;0;0;0;0;0;0;0;0
FR;8;2022-08-31;0;0;0;0;0;0;0;0;0;0;0;0;0;0;0;0;0;0
FR;8;2022-09-01;0;0;0;0;0;0;0;0;0;0;0;0;0;0;0;0;0;0
FR;8;2022-09-02;0;0;0;0;0;0;0;0;0;0;0;0;0;0;0;0;0;0
FR;8;2022-09-03;0;0;0;0;0;0;0;0;0;0;0;0;0;0;0;0;0;0
FR;8;2022-09-04;0;0;0;0;0;0;0;0;0;0;0;0;0;0;0;0;0;0
FR;8;2022-09-05;0;0;0;0;0;0;0;0;0;0;0;0;0;0;0;0;0;0
FR;8;2022-09-06;0;0;0;0;0;0;0;0;0;0;0;0;0;0;0;0;0;0
FR;8;2022-09-07;0;0;0;0;0;0;0;0;0;0;0;0;0;0;0;0;0;0
FR;8;2022-09-08;0;0;0;0;0;0;0;0;0;0;0;0;0;0;0;0;0;0
FR;8;2022-09-09;0;0;0;0;0;0;0;0;0;0;0;0;0;0;0;0;0;0
FR;8;2022-09-10;0;0;0;0;0;0;0;0;0;0;0;0;0;0;0;0;0;0
FR;8;2022-09-11;0;0;0;0;0;0;0;0;0;0;0;0;0;0;0;0;0;0
FR;8;2022-09-12;0;0;0;0;0;0;0;0;0;0;0;0;0;0;0;0;0;0
FR;8;2022-09-13;0;0;0;0;0;0;0;0;0;0;0;0;0;0;0;0;0;0
FR;8;2022-09-14;0;0;0;0;0;0;0;0;0;0;0;0;0;0;0;0;0;0
FR;8;2022-09-15;0;0;0;0;0;0;0;0;0;0;0;0;0;0;0;0;0;0
FR;8;2022-09-16;0;0;0;0;0;0;0;0;0;0;0;0;0;0;0;0;0;0
FR;8;2022-09-17;0;0;0;0;0;0;0;0;0;0;0;0;0;0;0;0;0;0
FR;8;2022-09-18;0;0;0;0;0;0;0;0;0;0;0;0;0;0;0;0;0;0
FR;8;2022-09-19;0;0;0;0;0;0;0;0;0;0;0;0;0;0;0;0;0;0
FR;8;2022-09-20;0;0;0;0;0;0;0;0;0;0;0;0;0;0;0;0;0;0
FR;8;2022-09-21;0;0;0;0;0;0;0;0;0;0;0;0;0;0;0;0;0;0
FR;8;2022-09-22;0;0;0;0;0;0;0;0;0;0;0;0;0;0;0;0;0;0
FR;8;2022-09-23;0;0;0;0;0;0;0;0;0;0;0;0;0;0;0;0;0;0
FR;8;2022-09-24;0;0;0;0;0;0;0;0;0;0;0;0;0;0;0;0;0;0
FR;8;2022-09-25;0;0;0;0;0;0;0;0;0;0;0;0;0;0;0;0;0;0
FR;8;2022-09-26;0;0;0;0;0;0;0;0;0;0;0;0;0;0;0;0;0;0
FR;8;2022-09-27;0;0;0;0;0;0;0;0;0;0;0;0;0;0;0;0;0;0
FR;8;2022-09-28;0;0;0;0;0;0;0;0;0;0;0;0;0;0;0;0;0;0
FR;8;2022-09-29;0;0;0;0;0;0;0;0;0;0;0;0;0;0;0;0;0;0
FR;8;2022-09-30;0;0;0;0;0;0;0;0;0;0;0;0;0;0;0;0;0;0
FR;8;2022-10-01;0;0;0;0;0;0;0;0;0;0;0;0;0;0;0;0;0;0
FR;8;2022-10-02;0;0;0;0;0;0;0;0;0;0;0;0;0;0;0;0;0;0
FR;8;2022-10-03;0;0;0;0;0;0;0;0;0;0;0;0;0;0;0;0;0;0
FR;8;2022-10-04;0;0;0;0;0;0;0;0;0;0;0;0;0;0;0;0;0;0
FR;8;2022-10-05;0;0;0;0;0;0;0;0;0;0;0;0;0;0;0;0;0;0
FR;8;2022-10-06;10;17;113;861;8;83;866;1059;110;10;17;113;861;8;83;866;1059;110
FR;8;2022-10-07;73;102;842;8012;63;699;8066;9845;1073;83;119;955;8873;71;782;8932;10904;1183
FR;8;2022-10-08;36;115;610;4057;50;516;4109;5310;676;119;234;1565;12930;121;1298;13041;16214;1859
FR;8;2022-10-09;17;22;145;885;13;132;913;1234;185;136;256;1710;13815;134;1430;13954;17448;2044
FR;8;2022-10-10;120;192;1348;12724;106;1029;12965;16269;2253;256;448;3058;26539;240;2459;26919;33717;4297
FR;8;2022-10-11;183;264;2476;26927;136;2012;27198;33964;4717;439;712;5534;53466;376;4471;54117;67681;9014
FR;8;2022-10-12;158;258;1831;18236;152;1441;18472;23472;3535;597;970;7365;71702;528;5912;72589;91153;12549
FR;8;2022-10-13;208;281;2512;28077;178;1905;28441;35580;5206;805;1251;9877;99779;706;7817;101030;126733;17755
FR;8;2022-10-14;257;419;3271;36246;241;2556;36671;45576;6307;1062;1670;13148;136025;947;10373;137701;172309;24062
FR;8;2022-10-15;102;182;1203;8806;79;1002;8932;11783;1829;1164;1852;14351;144831;1026;11375;146633;184092;25891
FR;8;2022-10-16;34;54;248;1522;26;215;1557;2179;402;1198;1906;14599;146353;1052;11590;148190;186271;26293
FR;8;2022-10-17;158;311;2101;21800;174;1627;22109;28294;4536;1356;2217;16700;168153;1226;13217;170299;214565;30829
FR;8;2022-10-18;269;349;3356;37859;226;2654;38242;50784;9815;1625;2566;20056;206012;1452;15871;208541;265349;40644
FR;8;2022-10-19;200;313;2631;28300;182;2187;28619;38729;7862;1825;2879;22687;234312;1634;18058;237160;304078;48506
FR;8;2022-10-20;256;368;3577;41204;228;2653;41812;55705;11155;2081;3247;26264;275516;1862;20711;278972;359783;59661
FR;8;2022-10-21;325;489;4461;49420;276;3475;50018;66301;12711;2406;3736;30725;324936;2138;24186;328990;426084;72372
FR;8;2022-10-22;126;168;1230;10663;111;927;10850;14745;2949;2532;3904;31955;335599;2249;25113;339840;440829;75321
FR;8;2022-10-23;50;53;266;1761;48;197;1840;2609;571;2582;3957;32221;337360;2297;25310;341680;443438;75892
FR;8;2022-10-24;231;311;2475;24044;174;2074;24342;33551;7084;2813;4268;34696;361404;2471;27384;366022;476989;82976
FR;8;2022-10-25;307;415;4081;43458;257;3135;44057;61295;14000;3120;4683;38777;404862;2728;30519;410079;538284;96976
FR;8;2022-10-26;226;343;2885;28761;186;2381;29040;41471;9962;3346;5026;41662;433623;2914;32900;439119;579755;106938
FR;8;2022-10-27;276;415;3329;36200;243;2635;36676;51255;11879;3622;5441;44991;469823;3157;35535;475795;631010;118817
FR;8;2022-10-28;328;466;3829;39476;258;2864;40200;55130;11997;3950;5907;48820;509299;3415;38399;515995;686140;130814
FR;8;2022-10-29;113;165;1074;8230;94;803;8374;11861;2667;4063;6072;49894;517529;3509;39202;524369;698001;133481
FR;8;2022-10-30;40;53;210;1348;38;180;1394;2063;485;4103;6125;50104;518877;3547;39382;525763;700064;133966
FR;8;2022-10-31;196;259;1663;14538;144;1276;14803;21202;5105;4299;6384;51767;533415;3691;40658;540566;721266;139071
FR;8;2022-11-01;33;41;137;961;23;171;976;1623;473;4332;6425;51904;534376;3714;40829;541542;722889;139544
FR;8;2022-11-02;197;369;2377;23315;204;1981;23709;35058;9301;4529;6794;54281;557691;3918;42810;565251;757947;148845
FR;8;2022-11-03;311;418;3487;36969;258;2604;37612;54689;14374;4840;7212;57768;594660;4176;45414;602863;812636;163219
FR;8;2022-11-04;355;496;3783;40210;260;2976;40732;57998;14179;5195;7708;61551;634870;4436;48390;643595;870634;177398
FR;8;2022-11-05;113;185;1103;8767;119;850;8934;12889;3070;5308;7893;62654;643637;4555;49240;652529;883523;180468
FR;8;2022-11-06;45;56;224;1408;38;205;1441;2249;593;5353;7949;62878;645045;4593;49445;653970;885772;181061
FR;8;2022-11-07;231;280;2324;24843;207;1799;25432;37629;10330;5584;8229;65202;669888;4800;51244;679402;923401;191391
FR;8;2022-11-08;345;505;4340;48400;305;3266;49379;71627;18820;5929;8734;69542;718288;5105;54510;728781;995028;210211
FR;8;2022-11-09;263;369;2878;29178;211;2262;29863;44459;12250;6192;9103;72420;747466;5316;56772;758644;1039487;222461
FR;8;2022-11-10;367;537;3957;40285;306;3025;41199;60570;16206;6559;9640;76377;787751;5622;59797;799843;1100057;238667
FR;8;2022-11-11;39;62;243;1479;33;204;1525;2675;933;6598;9702;76620;789230;5655;60001;801368;1102732;239600
FR;8;2022-11-12;85;165;881;6433;79;687;6636;9894;2552;6683;9867;77501;795663;5734;60688;808004;1112626;242152
FR;8;2022-11-13;36;54;213;1109;35;173;1161;1923;583;6719;9921;77714;796772;5769;60861;809165;1114549;242735
FR;8;2022-11-14;231;307;2241;22449;168;1725;22999;35093;10294;6950;10228;79955;819221;5937;62586;832164;1149642;253029
FR;8;2022-11-15;344;427;3766;42357;261;2871;43264;64805;18536;7294;10655;83721;861578;6198;65457;875428;1214447;271565
FR;8;2022-11-16;302;350;2621;26548;219;2158;27021;41759;12495;7596;11005;86342;888126;6417;67615;902449;1256206;284060
FR;8;2022-11-17;371;430;3386;36871;292;2617;37451;56654;16487;7967;11435;89728;924997;6709;70232;939900;1312860;300547
FR;8;2022-11-18;343;466;4073;42322;287;2977;43175;63680;17424;8310;11901;93801;967319;6996;73209;983075;1376540;317971
FR;8;2022-11-19;121;180;1199;8974;118;844;9156;13833;3795;8431;12081;95000;976293;7114;74053;992231;1390373;321766
FR;8;2022-11-20;35;51;260;1585;35;217;1653;2663;788;8466;12132;95260;977878;7149;74270;993884;1393036;322554
FR;8;2022-11-21;217;303;2078;20108;178;1601;20640;32129;9821;8683;12435;97338;997986;7327;75871;1014524;1425165;332375
FR;8;2022-11-22;336;407;3472;37562;250;2671;38076;58165;17307;9019;12842;100810;1035548;7577;78542;1052600;1483330;349682
FR;8;2022-11-23;230;324;2412;24438;188;2015;24865;39211;12249;9249;13166;103222;1059986;7765;80557;1077465;1522541;361931
FR;8;2022-11-24;347;391;3373;34907;237;2581;35596;55342;17066;9596;13557;106595;1094893;8002;83138;1113061;1577883;378997
FR;8;2022-11-25;309;426;3633;37739;288;2625;38537;57851;16565;9905;13983;110228;1132632;8290;85763;1151598;1635734;395562
FR;8;2022-11-26;172;194;1177;8819;126;898;8976;13689;3784;10077;14177;111405;1141451;8416;86661;1160574;1649423;399346
FR;8;2022-11-27;45;43;227;1545;37;180;1561;2472;721;10122;14220;111632;1142996;8453;86841;1162135;1651895;400067
FR;8;2022-11-28;183;301;2308;23375;172;1703;24039;37316;11500;10305;14521;113940;1166371;8625;88544;1186174;1689211;411567
FR;8;2022-11-29;293;428;3978;44080;217;2943;44766;69133;21301;10598;14949;117918;1210451;8842;91487;1230940;1758344;432868
FR;8;2022-11-30;283;410;3376;34885;227;2544;35650;54718;16406;10881;15359;121294;1245336;9069;94031;1266590;1813062;449274
FR;8;2022-12-01;334;476;4474;49357;274;3129;50132;77677;24253;11215;15835;125768;1294693;9343;97160;1316722;1890739;473527
FR;8;2022-12-02;408;518;5437;58442;304;3740;59620;89799;26250;11623;16353;131205;1353135;9647;100900;1376342;1980538;499777
FR;8;2022-12-03;177;216;1917;16859;108;1325;17271;25839;7207;11800;16569;133122;1369994;9755;102225;1393613;2006377;506984
FR;8;2022-12-04;53;90;489;4056;59;404;4116;6288;1756;11853;16659;133611;1374050;9814;102629;1397729;2012665;508740
FR;8;2022-12-05;285;403;3846;42348;247;2514;43271;66876;20942;12138;17062;137457;1416398;10061;105143;1441000;2079541;529682
FR;8;2022-12-06;426;546;6296;74320;305;4212;75737;117926;37731;12564;17608;143753;1490718;10366;109355;1516737;2197467;567413
FR;8;2022-12-07;362;436;4906;55022;265;3242;56107;87680;28136;12926;18044;148659;1545740;10631;112597;1572844;2285147;595549
FR;8;2022-12-08;453;534;6444;75443;292;4194;77026;120465;38984;13379;18578;155103;1621183;10923;116791;1649870;2405612;634533
FR;8;2022-12-09;546;603;8018;90894;356;5210;92661;142984;44846;13925;19181;163121;1712077;11279;122001;1742531;2548596;679379
FR;8;2022-12-10;264;301;3339;31717;168;2089;32562;48736;13994;14189;19482;166460;1743794;11447;124090;1775093;2597332;693373
FR;8;2022-12-11;90;104;937;7865;66;644;8083;11892;3145;14279;19586;167397;1751659;11513;124734;1783176;2609224;696518
FR;8;2022-12-12;355;462;5854;64337;254;3727;65847;103357;33585;14634;20048;173251;1815996;11767;128461;1849023;2712581;730103
FR;8;2022-12-13;531;605;8427;99082;351;5193;101510;160102;53066;15165;20653;181678;1915078;12118;133654;1950533;2872683;783169
FR;8;2022-12-14;455;533;6360;70049;306;4209;71615;113462;37368;15620;21186;188038;1985127;12424;137863;2022148;2986145;820537
FR;8;2022-12-15;491;650;8153;91723;366;5132;93936;149223;49814;16111;21836;196191;2076850;12790;142995;2116084;3135368;870351
FR;8;2022-12-16;582;709;8868;100287;386;5703;102415;161888;53395;16693;22545;205059;2177137;13176;148698;2218499;3297256;923746
FR;8;2022-12-17;233;308;3145;30057;189;2004;30828;46767;13830;16926;22853;208204;2207194;13365;150702;2249327;3344023;937576
FR;8;2022-12-18;63;94;732;5974;49;499;6122;9296;2646;16989;22947;208936;2213168;13414;151201;2255449;3353319;940222
FR;8;2022-12-19;399;453;5344;53758;265;3367;55322;87745;28874;17388;23400;214280;2266926;13679;154568;2310771;3441064;969096
FR;8;2022-12-20;555;581;7345;76570;348;4753;78667;127099;43351;17943;23981;221625;2343496;14027;159321;2389438;3568163;1012447
FR;8;2022-12-21;423;481;4965;48778;287;3316;50065;81685;28106;18366;24462;226590;2392274;14314;162637;2439503;3649848;1040553
FR;8;2022-12-22;462;524;4585;44267;313;3185;45489;74764;25935;18828;24986;231175;2436541;14627;165822;2484992;3724612;1066488
FR;8;2022-12-23;318;389;2884;25015;252;2076;25675;42267;14399;19146;25375;234059;2461556;14879;167898;2510667;3766879;1080887
FR;8;2022-12-24;70;70;395;2551;41;295;2665;4151;1174;19216;25445;234454;2464107;14920;168193;2513332;3771030;1082061
FR;8;2022-12-25;29;29;106;546;22;83;567;913;260;19245;25474;234560;2464653;14942;168276;2513899;3771943;1082321
FR;8;2022-12-26;243;275;2158;16064;176;1500;16687;26763;8481;19488;25749;236718;2480717;15118;169776;2530586;3798706;1090802
FR;8;2022-12-27;392;453;3771;32404;263;2532;33496;55286;19111;19880;26202;240489;2513121;15381;172308;2564082;3853992;1109913
FR;8;2022-12-28;343;342;2941;24657;191;2055;25245;41735;14315;20223;26544;243430;2537778;15572;174363;2589327;3895727;1124228
FR;8;2022-12-29;299;406;3158;25511;225;2186;26463;43968;15189;20522;26950;246588;2563289;15797;176549;2615790;3939695;1139417
FR;8;2022-12-30;296;343;2444;18666;215;1702;19307;31705;10588;20818;27293;249032;2581955;16012;178251;2635097;3971400;1150005
FR;8;2022-12-31;92;117;453;2959;75;364;3102;4755;1269;20910;27410;249485;2584914;16087;178615;2638199;3976155;1151274
FR;8;2023-01-01;17;30;112;661;14;85;684;995;225;20927;27440;249597;2585575;16101;178700;2638883;3977150;1151499
FR;8;2023-01-02;267;404;2261;18205;236;1607;18667;32013;11654;21194;27844;251858;2603780;16337;180307;2657550;4009163;1163153
FR;8;2023-01-03;465;541;4248;42801;319;2912;43716;80832;33881;21659;28385;256106;2646581;16656;183219;2701266;4089995;1197034
FR;8;2023-01-04;409;473;3492;29979;291;2422;30736;58260;24915;22068;28858;259598;2676560;16947;185641;2732002;4148255;1221949
FR;8;2023-01-05;504;597;4369;41803;400;2932;42698;81978;36027;22572;29455;263967;2718363;17347;188573;2774700;4230233;1257976
FR;8;2023-01-06;512;670;5102;46726;406;3340;47740;89671;38260;23084;30125;269069;2765089;17753;191913;2822440;4319904;1296236
FR;8;2023-01-07;216;289;1703;12296;180;1198;12610;22343;8435;23300;30414;270772;2777385;17933;193111;2835050;4342247;1304671
FR;8;2023-01-08;68;105;443;2744;64;312;2839;5094;1926;23368;30519;271215;2780129;17997;193423;2837889;4347341;1306597
FR;8;2023-01-09;399;477;2617;21454;309;1840;22025;44542;20457;23767;30996;273832;2801583;18306;195263;2859914;4391883;1327054
FR;8;2023-01-10;461;619;4341;40158;384;3059;40921;84990;40627;24228;31615;278173;2841741;18690;198322;2900835;4476873;1367681
FR;8;2023-01-11;345;457;2944;24111;286;2109;24619;51460;24440;24573;32072;281117;2865852;18976;200431;2925454;4528333;1392121
FR;8;2023-01-12;409;539;3655;33151;330;2571;33774;70744;34031;24982;32611;284772;2899003;19306;203002;2959228;4599077;1426152
FR;8;2023-01-13;446;588;4044;34872;338;2858;35465;72825;34123;25428;33199;288816;2933875;19644;205860;2994693;4671902;1460275
FR;8;2023-01-14;178;228;1337;8857;123;953;9039;17175;7103;25606;33427;290153;2942732;19767;206813;3003732;4689077;1467378
FR;8;2023-01-15;63;87;329;1475;53;244;1581;3172;1335;25669;33514;290482;2944207;19820;207057;3005313;4692249;1468713
FR;8;2023-01-16;266;335;1997;15745;196;1431;16007;35192;17551;25935;33849;292479;2959952;20016;208488;3021320;4727441;1486264
FR;8;2023-01-17;360;451;3246;28163;280;2318;28669;64499;33105;26295;34300;295725;2988115;20296;210806;3049989;4791940;1519369
FR;8;2023-01-18;264;406;2186;16821;246;1664;17062;38320;19339;26559;34706;297911;3004936;20542;212470;3067051;4830260;1538708
FR;8;2023-01-19;354;413;2664;22296;251;1945;22647;51199;26235;26913;35119;300575;3027232;20793;214415;3089698;4881459;1564943
FR;8;2023-01-20;403;505;3174;24783;305;2340;25263;56531;28548;27316;35624;303749;3052015;21098;216755;3114961;4937990;1593491
FR;8;2023-01-21;147;189;1002;6113;102;731;6239;12893;5826;27463;35813;304751;3058128;21200;217486;3121200;4950883;1599317
FR;8;2023-01-22;31;51;155;833;22;137;878;1879;844;27494;35864;304906;3058961;21222;217623;3122078;4952762;1600161
FR;8;2023-01-23;213;297;1587;10610;161;1159;10828;26649;14414;27707;36161;306493;3069571;21383;218782;3132906;4979411;1614575
FR;8;2023-01-24;304;415;2405;19963;247;1792;20231;49841;27400;28011;36576;308898;3089534;21630;220574;3153137;5029252;1641975
FR;8;2023-01-25;238;375;1797;12089;228;1322;12490;29954;15876;28249;36951;310695;3101623;21858;221896;3165627;5059206;1657851
FR;8;2023-01-26;299;379;2212;16477;258;1633;16751;41471;22701;28548;37330;312907;3118100;22116;223529;3182378;5100677;1680552
FR;8;2023-01-27;311;486;2457;17843;292;1840;18077;44098;23757;28859;37816;315364;3135943;22408;225369;3200455;5144775;1704309
FR;8;2023-01-28;125;186;766;4327;123;599;4442;9719;4589;28984;38002;316130;3140270;22531;225968;3204897;5154494;1708898
FR;8;2023-01-29;26;43;86;438;28;67;470;1058;513;29010;38045;316216;3140708;22559;226035;3205367;5155552;1709411
FR;8;2023-01-30;207;313;1222;7952;185;1008;8114;20425;11054;29217;38358;317438;3148660;22744;227043;3213481;5175977;1720465
FR;8;2023-01-31;270;379;1909;13582;231;1416;13802;36191;20682;29487;38737;319347;3162242;22975;228459;3227283;5212168;1741147
FR;8;2023-02-01;245;343;1328;8012;222;1086;8133;21670;12173;29732;39080;320675;3170254;23197;229545;3235416;5233838;1753320
FR;8;2023-02-02;255;383;1564;11413;231;1273;11634;30956;17688;29987;39463;322239;3181667;23428;230818;3247050;5264794;1771008
FR;8;2023-02-03;279;446;1844;12101;284;1433;12284;32922;18825;30266;39909;324083;3193768;23712;232251;3259334;5297716;1789833
FR;8;2023-02-04;116;157;568;2953;108;460;2995;7181;3655;30382;40066;324651;3196721;23820;232711;3262329;5304897;1793488
FR;8;2023-02-05;10;53;65;224;31;60;239;571;264;30392;40119;324716;3196945;23851;232771;3262568;5305468;1793752
FR;8;2023-02-06;183;241;935;5158;169;700;5339;14974;8703;30575;40360;325651;3202103;24020;233471;3267907;5320442;1802455
FR;8;2023-02-07;234;385;1452;9394;259;1177;9532;27496;16379;30809;40745;327103;3211497;24279;234648;3277439;5347938;1818834
FR;8;2023-02-08;172;244;1017;5821;167;804;5966;16483;9432;30981;40989;328120;3217318;24446;235452;3283405;5364421;1828266
FR;8;2023-02-09;236;380;1170;7513;242;981;7698;22146;13139;31217;41369;329290;3224831;24688;236433;3291103;5386567;1841405
FR;8;2023-02-10;275;360;1394;7949;243;1154;8081;23108;13491;31492;41729;330684;3232780;24931;237587;3299184;5409675;1854896
FR;8;2023-02-11;87;145;469;2012;100;402;2088;5220;2661;31579;41874;331153;3234792;25031;237989;3301272;5414895;1857557
FR;8;2023-02-12;26;31;50;163;25;44;184;424;189;31605;41905;331203;3234955;25056;238033;3301456;5415319;1857746
FR;8;2023-02-13;129;204;667;3148;125;604;3243;9263;5279;31734;42109;331870;3238103;25181;238637;3304699;5424582;1863025
FR;8;2023-02-14;186;261;1061;5676;158;885;5828;17060;10050;31920;42370;332931;3243779;25339;239522;3310527;5441642;1873075
FR;8;2023-02-15;161;248;841;3871;141;719;4044;11795;6830;32081;42618;333772;3247650;25480;240241;3314571;5453437;1879905
FR;8;2023-02-16;168;303;994;4883;171;846;5041;14560;8423;32249;42921;334766;3252533;25651;241087;3319612;5467997;1888328
FR;8;2023-02-17;225;313;1099;5193;219;938;5418;15909;9295;32474;43234;335865;3257726;25870;242025;3325030;5483906;1897623
FR;8;2023-02-18;92;130;394;1488;85;311;1562;3893;1964;32566;43364;336259;3259214;25955;242336;3326592;5487799;1899587
FR;8;2023-02-19;22;36;43;132;31;35;134;332;159;32588;43400;336302;3259346;25986;242371;3326726;5488131;1899746
FR;8;2023-02-20;139;254;629;2655;158;584;2769;8110;4611;32727;43654;336931;3262001;26144;242955;3329495;5496241;1904357
FR;8;2023-02-21;173;306;958;4278;162;831;4466;13481;7907;32900;43960;337889;3266279;26306;243786;3333961;5509722;1912264
FR;8;2023-02-22;154;253;658;2762;168;618;2796;8586;5005;33054;44213;338547;3269041;26474;244404;3336757;5518308;1917269
FR;8;2023-02-23;149;259;822;3767;153;729;3944;11797;6845;33203;44472;339369;3272808;26627;245133;3340701;5530105;1924114
FR;8;2023-02-24;156;308;950;4092;190;822;4276;12362;7025;33359;44780;340319;3276900;26817;245955;3344977;5542467;1931139
FR;8;2023-02-25;56;98;343;1057;65;274;1111;2931;1488;33415;44878;340662;3277957;26882;246229;3346088;5545398;1932627
FR;8;2023-02-26;14;21;31;95;22;28;108;249;106;33429;44899;340693;3278052;26904;246257;3346196;5545647;1932733
FR;8;2023-02-27;89;218;502;1821;149;477;1888;6206;3705;33518;45117;341195;3279873;27053;246734;3348084;5551853;1936438
FR;8;2023-02-28;154;253;753;3324;148;715;3452;11555;7094;33672;45370;341948;3283197;27201;247449;3351536;5563408;1943532
FR;8;2023-03-01;124;192;511;1821;144;454;1969;6192;3622;33796;45562;342459;3285018;27345;247903;3353505;5569600;1947154
FR;8;2023-03-02;125;214;706;2755;129;598;2949;9666;5889;33921;45776;343165;3287773;27474;248501;3356454;5579266;1953043
FR;8;2023-03-03;180;320;889;3391;213;786;3516;11171;6558;34101;46096;344054;3291164;27687;249287;3359970;5590437;1959601
FR;8;2023-03-04;57;132;298;972;80;282;978;2611;1292;34158;46228;344352;3292136;27767;249569;3360948;5593048;1960893
FR;8;2023-03-05;12;18;20;47;14;24;47;180;98;34170;46246;344372;3292183;27781;249593;3360995;5593228;1960991
FR;8;2023-03-06;116;175;404;1300;101;385;1358;4376;2496;34286;46421;344776;3293483;27882;249978;3362353;5597604;1963487
FR;8;2023-03-07;116;207;556;2146;124;513;2220;7484;4561;34402;46628;345332;3295629;28006;250491;3364573;5605088;1968048
FR;8;2023-03-08;88;172;439;1310;105;390;1378;4648;2727;34490;46800;345771;3296939;28111;250881;3365951;5609736;1970775
FR;8;2023-03-09;116;197;545;1846;118;511;1909;6648;4058;34606;46997;346316;3298785;28229;251392;3367860;5616384;1974833
FR;8;2023-03-10;195;321;754;2376;201;678;2497;8448;5034;34801;47318;347070;3301161;28430;252070;3370357;5624832;1979867
FR;8;2023-03-11;52;106;263;725;72;226;761;2124;1085;34853;47424;347333;3301886;28502;252296;3371118;5626956;1980952
FR;8;2023-03-12;6;10;23;59;8;22;60;169;83;34859;47434;347356;3301945;28510;252318;3371178;5627125;1981035
FR;8;2023-03-13;77;133;375;952;85;332;1028;3270;1822;34936;47567;347731;3302897;28595;252650;3372206;5630395;1982857
FR;8;2023-03-14;108;207;550;1693;124;532;1769;6252;3745;35044;47774;348281;3304590;28719;253182;3373975;5636647;1986602
FR;8;2023-03-15;102;158;398;1056;113;355;1133;3894;2267;35146;47932;348679;3305646;28832;253537;3375108;5640541;1988869
FR;8;2023-03-16;99;186;495;1461;117;455;1537;5400;3223;35245;48118;349174;3307107;28949;253992;3376645;5645941;1992092
FR;8;2023-03-17;137;209;632;1807;125;547;1953;6694;3951;35382;48327;349806;3308914;29074;254539;3378598;5652635;1996043
FR;8;2023-03-18;72;105;243;521;64;232;571;1785;921;35454;48432;350049;3309435;29138;254771;3379169;5654420;1996964
FR;8;2023-03-19;3;15;20;39;15;12;42;100;44;35457;48447;350069;3309474;29153;254783;3379211;5654520;1997008
FR;8;2023-03-20;83;167;392;890;92;391;969;3419;1928;35540;48614;350461;3310364;29245;255174;3380180;5657939;1998936
FR;8;2023-03-21;123;193;556;1444;112;531;1590;5867;3505;35663;48807;351017;3311808;29357;255705;3381770;5663806;2002441
FR;8;2023-03-22;114;152;388;892;102;357;999;3469;1991;35777;48959;351405;3312700;29459;256062;3382769;5667275;2004432
FR;8;2023-03-23;82;156;495;1223;84;442;1313;4628;2675;35859;49115;351900;3313923;29543;256504;3384082;5671903;2007107
FR;8;2023-03-24;130;241;652;1510;139;594;1671;5873;3358;35989;49356;352552;3315433;29682;257098;3385753;5677776;2010465
FR;8;2023-03-25;50;83;244;468;59;215;515;1519;728;36039;49439;352796;3315901;29741;257313;3386268;5679295;2011193
FR;8;2023-03-26;5;5;12;24;5;8;28;58;20;36044;49444;352808;3315925;29746;257321;3386296;5679353;2011213
FR;9;2020-12-27;0;0;0;0;0;0;0;0;0;0;0;0;0;0;0;0;0;0
FR;9;2020-12-28;0;0;0;0;0;0;0;0;0;0;0;0;0;0;0;0;0;0
FR;9;2020-12-29;0;0;0;0;0;0;0;0;0;0;0;0;0;0;0;0;0;0
FR;9;2020-12-30;0;0;0;0;0;0;0;0;0;0;0;0;0;0;0;0;0;0
FR;9;2020-12-31;0;0;0;0;0;0;0;0;0;0;0;0;0;0;0;0;0;0
FR;9;2021-01-01;0;0;0;0;0;0;0;0;0;0;0;0;0;0;0;0;0;0
FR;9;2021-01-02;0;0;0;0;0;0;0;0;0;0;0;0;0;0;0;0;0;0
FR;9;2021-01-03;0;0;0;0;0;0;0;0;0;0;0;0;0;0;0;0;0;0
FR;9;2021-01-04;0;0;0;0;0;0;0;0;0;0;0;0;0;0;0;0;0;0
FR;9;2021-01-05;0;0;0;0;0;0;0;0;0;0;0;0;0;0;0;0;0;0
FR;9;2021-01-06;0;0;0;0;0;0;0;0;0;0;0;0;0;0;0;0;0;0
FR;9;2021-01-07;0;0;0;0;0;0;0;0;0;0;0;0;0;0;0;0;0;0
FR;9;2021-01-08;0;0;0;0;0;0;0;0;0;0;0;0;0;0;0;0;0;0
FR;9;2021-01-09;0;0;0;0;0;0;0;0;0;0;0;0;0;0;0;0;0;0
FR;9;2021-01-10;0;0;0;0;0;0;0;0;0;0;0;0;0;0;0;0;0;0
FR;9;2021-01-11;0;0;0;0;0;0;0;0;0;0;0;0;0;0;0;0;0;0
FR;9;2021-01-12;0;0;0;0;0;0;0;0;0;0;0;0;0;0;0;0;0;0
FR;9;2021-01-13;0;0;0;0;0;0;0;0;0;0;0;0;0;0;0;0;0;0
FR;9;2021-01-14;0;0;0;0;0;0;0;0;0;0;0;0;0;0;0;0;0;0
FR;9;2021-01-15;0;0;0;0;0;0;0;0;0;0;0;0;0;0;0;0;0;0
FR;9;2021-01-16;0;0;0;0;0;0;0;0;0;0;0;0;0;0;0;0;0;0
FR;9;2021-01-17;0;0;0;0;0;0;0;0;0;0;0;0;0;0;0;0;0;0
FR;9;2021-01-18;0;0;0;0;0;0;0;0;0;0;0;0;0;0;0;0;0;0
FR;9;2021-01-19;0;0;0;0;0;0;0;0;0;0;0;0;0;0;0;0;0;0
FR;9;2021-01-20;0;0;0;0;0;0;0;0;0;0;0;0;0;0;0;0;0;0
FR;9;2021-01-21;0;0;0;0;0;0;0;0;0;0;0;0;0;0;0;0;0;0
FR;9;2021-01-22;0;0;0;0;0;0;0;0;0;0;0;0;0;0;0;0;0;0
FR;9;2021-01-23;0;0;0;0;0;0;0;0;0;0;0;0;0;0;0;0;0;0
FR;9;2021-01-24;0;0;0;0;0;0;0;0;0;0;0;0;0;0;0;0;0;0
FR;9;2021-01-25;0;0;0;0;0;0;0;0;0;0;0;0;0;0;0;0;0;0
FR;9;2021-01-26;0;0;0;0;0;0;0;0;0;0;0;0;0;0;0;0;0;0
FR;9;2021-01-27;0;0;0;0;0;0;0;0;0;0;0;0;0;0;0;0;0;0
FR;9;2021-01-28;0;0;0;0;0;0;0;0;0;0;0;0;0;0;0;0;0;0
FR;9;2021-01-29;0;0;0;0;0;0;0;0;0;0;0;0;0;0;0;0;0;0
FR;9;2021-01-30;0;0;0;0;0;0;0;0;0;0;0;0;0;0;0;0;0;0
FR;9;2021-01-31;0;0;0;0;0;0;0;0;0;0;0;0;0;0;0;0;0;0
FR;9;2021-02-01;0;0;0;0;0;0;0;0;0;0;0;0;0;0;0;0;0;0
FR;9;2021-02-02;0;0;0;0;0;0;0;0;0;0;0;0;0;0;0;0;0;0
FR;9;2021-02-03;0;0;0;0;0;0;0;0;0;0;0;0;0;0;0;0;0;0
FR;9;2021-02-04;0;0;0;0;0;0;0;0;0;0;0;0;0;0;0;0;0;0
FR;9;2021-02-05;0;0;0;0;0;0;0;0;0;0;0;0;0;0;0;0;0;0
FR;9;2021-02-06;0;0;0;0;0;0;0;0;0;0;0;0;0;0;0;0;0;0
FR;9;2021-02-07;0;0;0;0;0;0;0;0;0;0;0;0;0;0;0;0;0;0
FR;9;2021-02-08;0;0;0;0;0;0;0;0;0;0;0;0;0;0;0;0;0;0
FR;9;2021-02-09;0;0;0;0;0;0;0;0;0;0;0;0;0;0;0;0;0;0
FR;9;2021-02-10;0;0;0;0;0;0;0;0;0;0;0;0;0;0;0;0;0;0
FR;9;2021-02-11;0;0;0;0;0;0;0;0;0;0;0;0;0;0;0;0;0;0
FR;9;2021-02-12;0;0;0;0;0;0;0;0;0;0;0;0;0;0;0;0;0;0
FR;9;2021-02-13;0;0;0;0;0;0;0;0;0;0;0;0;0;0;0;0;0;0
FR;9;2021-02-14;0;0;0;0;0;0;0;0;0;0;0;0;0;0;0;0;0;0
FR;9;2021-02-15;0;0;0;0;0;0;0;0;0;0;0;0;0;0;0;0;0;0
FR;9;2021-02-16;0;0;0;0;0;0;0;0;0;0;0;0;0;0;0;0;0;0
FR;9;2021-02-17;0;0;0;0;0;0;0;0;0;0;0;0;0;0;0;0;0;0
FR;9;2021-02-18;0;0;0;0;0;0;0;0;0;0;0;0;0;0;0;0;0;0
FR;9;2021-02-19;0;0;0;0;0;0;0;0;0;0;0;0;0;0;0;0;0;0
FR;9;2021-02-20;0;0;0;0;0;0;0;0;0;0;0;0;0;0;0;0;0;0
FR;9;2021-02-21;0;0;0;0;0;0;0;0;0;0;0;0;0;0;0;0;0;0
FR;9;2021-02-22;0;0;0;0;0;0;0;0;0;0;0;0;0;0;0;0;0;0
FR;9;2021-02-23;0;0;0;0;0;0;0;0;0;0;0;0;0;0;0;0;0;0
FR;9;2021-02-24;0;0;0;0;0;0;0;0;0;0;0;0;0;0;0;0;0;0
FR;9;2021-02-25;0;0;0;0;0;0;0;0;0;0;0;0;0;0;0;0;0;0
FR;9;2021-02-26;0;0;0;0;0;0;0;0;0;0;0;0;0;0;0;0;0;0
FR;9;2021-02-27;0;0;0;0;0;0;0;0;0;0;0;0;0;0;0;0;0;0
FR;9;2021-02-28;0;0;0;0;0;0;0;0;0;0;0;0;0;0;0;0;0;0
FR;9;2021-03-01;0;0;0;0;0;0;0;0;0;0;0;0;0;0;0;0;0;0
FR;9;2021-03-02;0;0;0;0;0;0;0;0;0;0;0;0;0;0;0;0;0;0
FR;9;2021-03-03;0;0;0;0;0;0;0;0;0;0;0;0;0;0;0;0;0;0
FR;9;2021-03-04;0;0;0;0;0;0;0;0;0;0;0;0;0;0;0;0;0;0
FR;9;2021-03-05;0;0;0;0;0;0;0;0;0;0;0;0;0;0;0;0;0;0
FR;9;2021-03-06;0;0;0;0;0;0;0;0;0;0;0;0;0;0;0;0;0;0
FR;9;2021-03-07;0;0;0;0;0;0;0;0;0;0;0;0;0;0;0;0;0;0
FR;9;2021-03-08;0;0;0;0;0;0;0;0;0;0;0;0;0;0;0;0;0;0
FR;9;2021-03-09;0;0;0;0;0;0;0;0;0;0;0;0;0;0;0;0;0;0
FR;9;2021-03-10;0;0;0;0;0;0;0;0;0;0;0;0;0;0;0;0;0;0
FR;9;2021-03-11;0;0;0;0;0;0;0;0;0;0;0;0;0;0;0;0;0;0
FR;9;2021-03-12;0;0;0;0;0;0;0;0;0;0;0;0;0;0;0;0;0;0
FR;9;2021-03-13;0;0;0;0;0;0;0;0;0;0;0;0;0;0;0;0;0;0
FR;9;2021-03-14;0;0;0;0;0;0;0;0;0;0;0;0;0;0;0;0;0;0
FR;9;2021-03-15;0;0;0;0;0;0;0;0;0;0;0;0;0;0;0;0;0;0
FR;9;2021-03-16;0;0;0;0;0;0;0;0;0;0;0;0;0;0;0;0;0;0
FR;9;2021-03-17;0;0;0;0;0;0;0;0;0;0;0;0;0;0;0;0;0;0
FR;9;2021-03-18;0;0;0;0;0;0;0;0;0;0;0;0;0;0;0;0;0;0
FR;9;2021-03-19;0;0;0;0;0;0;0;0;0;0;0;0;0;0;0;0;0;0
FR;9;2021-03-20;0;0;0;0;0;0;0;0;0;0;0;0;0;0;0;0;0;0
FR;9;2021-03-21;0;0;0;0;0;0;0;0;0;0;0;0;0;0;0;0;0;0
FR;9;2021-03-22;0;0;0;0;0;0;0;0;0;0;0;0;0;0;0;0;0;0
FR;9;2021-03-23;0;0;0;0;0;0;0;0;0;0;0;0;0;0;0;0;0;0
FR;9;2021-03-24;0;0;0;0;0;0;0;0;0;0;0;0;0;0;0;0;0;0
FR;9;2021-03-25;0;0;0;0;0;0;0;0;0;0;0;0;0;0;0;0;0;0
FR;9;2021-03-26;0;0;0;0;0;0;0;0;0;0;0;0;0;0;0;0;0;0
FR;9;2021-03-27;0;0;0;0;0;0;0;0;0;0;0;0;0;0;0;0;0;0
FR;9;2021-03-28;0;0;0;0;0;0;0;0;0;0;0;0;0;0;0;0;0;0
FR;9;2021-03-29;0;0;0;0;0;0;0;0;0;0;0;0;0;0;0;0;0;0
FR;9;2021-03-30;0;0;0;0;0;0;0;0;0;0;0;0;0;0;0;0;0;0
FR;9;2021-03-31;0;0;0;0;0;0;0;0;0;0;0;0;0;0;0;0;0;0
FR;9;2021-04-01;0;0;0;0;0;0;0;0;0;0;0;0;0;0;0;0;0;0
FR;9;2021-04-02;0;0;0;0;0;0;0;0;0;0;0;0;0;0;0;0;0;0
FR;9;2021-04-03;0;0;0;0;0;0;0;0;0;0;0;0;0;0;0;0;0;0
FR;9;2021-04-04;0;0;0;0;0;0;0;0;0;0;0;0;0;0;0;0;0;0
FR;9;2021-04-05;0;0;0;0;0;0;0;0;0;0;0;0;0;0;0;0;0;0
FR;9;2021-04-06;0;0;0;0;0;0;0;0;0;0;0;0;0;0;0;0;0;0
FR;9;2021-04-07;0;0;0;0;0;0;0;0;0;0;0;0;0;0;0;0;0;0
FR;9;2021-04-08;0;0;0;0;0;0;0;0;0;0;0;0;0;0;0;0;0;0
FR;9;2021-04-09;0;0;0;0;0;0;0;0;0;0;0;0;0;0;0;0;0;0
FR;9;2021-04-10;0;0;0;0;0;0;0;0;0;0;0;0;0;0;0;0;0;0
FR;9;2021-04-11;0;0;0;0;0;0;0;0;0;0;0;0;0;0;0;0;0;0
FR;9;2021-04-12;0;0;0;0;0;0;0;0;0;0;0;0;0;0;0;0;0;0
FR;9;2021-04-13;0;0;0;0;0;0;0;0;0;0;0;0;0;0;0;0;0;0
FR;9;2021-04-14;0;0;0;0;0;0;0;0;0;0;0;0;0;0;0;0;0;0
FR;9;2021-04-15;0;0;0;0;0;0;0;0;0;0;0;0;0;0;0;0;0;0
FR;9;2021-04-16;0;0;0;0;0;0;0;0;0;0;0;0;0;0;0;0;0;0
FR;9;2021-04-17;0;0;0;0;0;0;0;0;0;0;0;0;0;0;0;0;0;0
FR;9;2021-04-18;0;0;0;0;0;0;0;0;0;0;0;0;0;0;0;0;0;0
FR;9;2021-04-19;0;0;0;0;0;0;0;0;0;0;0;0;0;0;0;0;0;0
FR;9;2021-04-20;0;0;0;0;0;0;0;0;0;0;0;0;0;0;0;0;0;0
FR;9;2021-04-21;0;0;0;0;0;0;0;0;0;0;0;0;0;0;0;0;0;0
FR;9;2021-04-22;0;0;0;0;0;0;0;0;0;0;0;0;0;0;0;0;0;0
FR;9;2021-04-23;0;0;0;0;0;0;0;0;0;0;0;0;0;0;0;0;0;0
FR;9;2021-04-24;0;0;0;0;0;0;0;0;0;0;0;0;0;0;0;0;0;0
FR;9;2021-04-25;0;0;0;0;0;0;0;0;0;0;0;0;0;0;0;0;0;0
FR;9;2021-04-26;0;0;0;0;0;0;0;0;0;0;0;0;0;0;0;0;0;0
FR;9;2021-04-27;0;0;0;0;0;0;0;0;0;0;0;0;0;0;0;0;0;0
FR;9;2021-04-28;0;0;0;0;0;0;0;0;0;0;0;0;0;0;0;0;0;0
FR;9;2021-04-29;0;0;0;0;0;0;0;0;0;0;0;0;0;0;0;0;0;0
FR;9;2021-04-30;0;0;0;0;0;0;0;0;0;0;0;0;0;0;0;0;0;0
FR;9;2021-05-01;0;0;0;0;0;0;0;0;0;0;0;0;0;0;0;0;0;0
FR;9;2021-05-02;0;0;0;0;0;0;0;0;0;0;0;0;0;0;0;0;0;0
FR;9;2021-05-03;0;0;0;0;0;0;0;0;0;0;0;0;0;0;0;0;0;0
FR;9;2021-05-04;0;0;0;0;0;0;0;0;0;0;0;0;0;0;0;0;0;0
FR;9;2021-05-05;0;0;0;0;0;0;0;0;0;0;0;0;0;0;0;0;0;0
FR;9;2021-05-06;0;0;0;0;0;0;0;0;0;0;0;0;0;0;0;0;0;0
FR;9;2021-05-07;0;0;0;0;0;0;0;0;0;0;0;0;0;0;0;0;0;0
FR;9;2021-05-08;0;0;0;0;0;0;0;0;0;0;0;0;0;0;0;0;0;0
FR;9;2021-05-09;0;0;0;0;0;0;0;0;0;0;0;0;0;0;0;0;0;0
FR;9;2021-05-10;0;0;0;0;0;0;0;0;0;0;0;0;0;0;0;0;0;0
FR;9;2021-05-11;0;0;0;0;0;0;0;0;0;0;0;0;0;0;0;0;0;0
FR;9;2021-05-12;0;0;0;0;0;0;0;0;0;0;0;0;0;0;0;0;0;0
FR;9;2021-05-13;0;0;0;0;0;0;0;0;0;0;0;0;0;0;0;0;0;0
FR;9;2021-05-14;0;0;0;0;0;0;0;0;0;0;0;0;0;0;0;0;0;0
FR;9;2021-05-15;0;0;0;0;0;0;0;0;0;0;0;0;0;0;0;0;0;0
FR;9;2021-05-16;0;0;0;0;0;0;0;0;0;0;0;0;0;0;0;0;0;0
FR;9;2021-05-17;0;0;0;0;0;0;0;0;0;0;0;0;0;0;0;0;0;0
FR;9;2021-05-18;0;0;0;0;0;0;0;0;0;0;0;0;0;0;0;0;0;0
FR;9;2021-05-19;0;0;0;0;0;0;0;0;0;0;0;0;0;0;0;0;0;0
FR;9;2021-05-20;0;0;0;0;0;0;0;0;0;0;0;0;0;0;0;0;0;0
FR;9;2021-05-21;0;0;0;0;0;0;0;0;0;0;0;0;0;0;0;0;0;0
FR;9;2021-05-22;0;0;0;0;0;0;0;0;0;0;0;0;0;0;0;0;0;0
FR;9;2021-05-23;0;0;0;0;0;0;0;0;0;0;0;0;0;0;0;0;0;0
FR;9;2021-05-24;0;0;0;0;0;0;0;0;0;0;0;0;0;0;0;0;0;0
FR;9;2021-05-25;0;0;0;0;0;0;0;0;0;0;0;0;0;0;0;0;0;0
FR;9;2021-05-26;0;0;0;0;0;0;0;0;0;0;0;0;0;0;0;0;0;0
FR;9;2021-05-27;0;0;0;0;0;0;0;0;0;0;0;0;0;0;0;0;0;0
FR;9;2021-05-28;0;0;0;0;0;0;0;0;0;0;0;0;0;0;0;0;0;0
FR;9;2021-05-29;0;0;0;0;0;0;0;0;0;0;0;0;0;0;0;0;0;0
FR;9;2021-05-30;0;0;0;0;0;0;0;0;0;0;0;0;0;0;0;0;0;0
FR;9;2021-05-31;0;0;0;0;0;0;0;0;0;0;0;0;0;0;0;0;0;0
FR;9;2021-06-01;0;0;0;0;0;0;0;0;0;0;0;0;0;0;0;0;0;0
FR;9;2021-06-02;0;0;0;0;0;0;0;0;0;0;0;0;0;0;0;0;0;0
FR;9;2021-06-03;0;0;0;0;0;0;0;0;0;0;0;0;0;0;0;0;0;0
FR;9;2021-06-04;0;0;0;0;0;0;0;0;0;0;0;0;0;0;0;0;0;0
FR;9;2021-06-05;0;0;0;0;0;0;0;0;0;0;0;0;0;0;0;0;0;0
FR;9;2021-06-06;0;0;0;0;0;0;0;0;0;0;0;0;0;0;0;0;0;0
FR;9;2021-06-07;0;0;0;0;0;0;0;0;0;0;0;0;0;0;0;0;0;0
FR;9;2021-06-08;0;0;0;0;0;0;0;0;0;0;0;0;0;0;0;0;0;0
FR;9;2021-06-09;0;0;0;0;0;0;0;0;0;0;0;0;0;0;0;0;0;0
FR;9;2021-06-10;0;0;0;0;0;0;0;0;0;0;0;0;0;0;0;0;0;0
FR;9;2021-06-11;0;0;0;0;0;0;0;0;0;0;0;0;0;0;0;0;0;0
FR;9;2021-06-12;0;0;0;0;0;0;0;0;0;0;0;0;0;0;0;0;0;0
FR;9;2021-06-13;0;0;0;0;0;0;0;0;0;0;0;0;0;0;0;0;0;0
FR;9;2021-06-14;0;0;0;0;0;0;0;0;0;0;0;0;0;0;0;0;0;0
FR;9;2021-06-15;0;0;0;0;0;0;0;0;0;0;0;0;0;0;0;0;0;0
FR;9;2021-06-16;0;0;0;0;0;0;0;0;0;0;0;0;0;0;0;0;0;0
FR;9;2021-06-17;0;0;0;0;0;0;0;0;0;0;0;0;0;0;0;0;0;0
FR;9;2021-06-18;0;0;0;0;0;0;0;0;0;0;0;0;0;0;0;0;0;0
FR;9;2021-06-19;0;0;0;0;0;0;0;0;0;0;0;0;0;0;0;0;0;0
FR;9;2021-06-20;0;0;0;0;0;0;0;0;0;0;0;0;0;0;0;0;0;0
FR;9;2021-06-21;0;0;0;0;0;0;0;0;0;0;0;0;0;0;0;0;0;0
FR;9;2021-06-22;0;0;0;0;0;0;0;0;0;0;0;0;0;0;0;0;0;0
FR;9;2021-06-23;0;0;0;0;0;0;0;0;0;0;0;0;0;0;0;0;0;0
FR;9;2021-06-24;0;0;0;0;0;0;0;0;0;0;0;0;0;0;0;0;0;0
FR;9;2021-06-25;0;0;0;0;0;0;0;0;0;0;0;0;0;0;0;0;0;0
FR;9;2021-06-26;0;0;0;0;0;0;0;0;0;0;0;0;0;0;0;0;0;0
FR;9;2021-06-27;0;0;0;0;0;0;0;0;0;0;0;0;0;0;0;0;0;0
FR;9;2021-06-28;0;0;0;0;0;0;0;0;0;0;0;0;0;0;0;0;0;0
FR;9;2021-06-29;0;0;0;0;0;0;0;0;0;0;0;0;0;0;0;0;0;0
FR;9;2021-06-30;0;0;0;0;0;0;0;0;0;0;0;0;0;0;0;0;0;0
FR;9;2021-07-01;0;0;0;0;0;0;0;0;0;0;0;0;0;0;0;0;0;0
FR;9;2021-07-02;0;0;0;0;0;0;0;0;0;0;0;0;0;0;0;0;0;0
FR;9;2021-07-03;0;0;0;0;0;0;0;0;0;0;0;0;0;0;0;0;0;0
FR;9;2021-07-04;0;0;0;0;0;0;0;0;0;0;0;0;0;0;0;0;0;0
FR;9;2021-07-05;0;0;0;0;0;0;0;0;0;0;0;0;0;0;0;0;0;0
FR;9;2021-07-06;0;0;0;0;0;0;0;0;0;0;0;0;0;0;0;0;0;0
FR;9;2021-07-07;0;0;0;0;0;0;0;0;0;0;0;0;0;0;0;0;0;0
FR;9;2021-07-08;0;0;0;0;0;0;0;0;0;0;0;0;0;0;0;0;0;0
FR;9;2021-07-09;0;0;0;0;0;0;0;0;0;0;0;0;0;0;0;0;0;0
FR;9;2021-07-10;0;0;0;0;0;0;0;0;0;0;0;0;0;0;0;0;0;0
FR;9;2021-07-11;0;0;0;0;0;0;0;0;0;0;0;0;0;0;0;0;0;0
FR;9;2021-07-12;0;0;0;0;0;0;0;0;0;0;0;0;0;0;0;0;0;0
FR;9;2021-07-13;0;0;0;0;0;0;0;0;0;0;0;0;0;0;0;0;0;0
FR;9;2021-07-14;0;0;0;0;0;0;0;0;0;0;0;0;0;0;0;0;0;0
FR;9;2021-07-15;0;0;0;0;0;0;0;0;0;0;0;0;0;0;0;0;0;0
FR;9;2021-07-16;0;0;0;0;0;0;0;0;0;0;0;0;0;0;0;0;0;0
FR;9;2021-07-17;0;0;0;0;0;0;0;0;0;0;0;0;0;0;0;0;0;0
FR;9;2021-07-18;0;0;0;0;0;0;0;0;0;0;0;0;0;0;0;0;0;0
FR;9;2021-07-19;0;0;0;0;0;0;0;0;0;0;0;0;0;0;0;0;0;0
FR;9;2021-07-20;0;0;0;0;0;0;0;0;0;0;0;0;0;0;0;0;0;0
FR;9;2021-07-21;0;0;0;0;0;0;0;0;0;0;0;0;0;0;0;0;0;0
FR;9;2021-07-22;0;0;0;0;0;0;0;0;0;0;0;0;0;0;0;0;0;0
FR;9;2021-07-23;0;0;0;0;0;0;0;0;0;0;0;0;0;0;0;0;0;0
FR;9;2021-07-24;0;0;0;0;0;0;0;0;0;0;0;0;0;0;0;0;0;0
FR;9;2021-07-25;0;0;0;0;0;0;0;0;0;0;0;0;0;0;0;0;0;0
FR;9;2021-07-26;0;0;0;0;0;0;0;0;0;0;0;0;0;0;0;0;0;0
FR;9;2021-07-27;0;0;0;0;0;0;0;0;0;0;0;0;0;0;0;0;0;0
FR;9;2021-07-28;0;0;0;0;0;0;0;0;0;0;0;0;0;0;0;0;0;0
FR;9;2021-07-29;0;0;0;0;0;0;0;0;0;0;0;0;0;0;0;0;0;0
FR;9;2021-07-30;0;0;0;0;0;0;0;0;0;0;0;0;0;0;0;0;0;0
FR;9;2021-07-31;0;0;0;0;0;0;0;0;0;0;0;0;0;0;0;0;0;0
FR;9;2021-08-01;0;0;0;0;0;0;0;0;0;0;0;0;0;0;0;0;0;0
FR;9;2021-08-02;0;0;0;0;0;0;0;0;0;0;0;0;0;0;0;0;0;0
FR;9;2021-08-03;0;0;0;0;0;0;0;0;0;0;0;0;0;0;0;0;0;0
FR;9;2021-08-04;0;0;0;0;0;0;0;0;0;0;0;0;0;0;0;0;0;0
FR;9;2021-08-05;0;0;0;0;0;0;0;0;0;0;0;0;0;0;0;0;0;0
FR;9;2021-08-06;0;0;0;0;0;0;0;0;0;0;0;0;0;0;0;0;0;0
FR;9;2021-08-07;0;0;0;0;0;0;0;0;0;0;0;0;0;0;0;0;0;0
FR;9;2021-08-08;0;0;0;0;0;0;0;0;0;0;0;0;0;0;0;0;0;0
FR;9;2021-08-09;0;0;0;0;0;0;0;0;0;0;0;0;0;0;0;0;0;0
FR;9;2021-08-10;0;0;0;0;0;0;0;0;0;0;0;0;0;0;0;0;0;0
FR;9;2021-08-11;0;0;0;0;0;0;0;0;0;0;0;0;0;0;0;0;0;0
FR;9;2021-08-12;0;0;0;0;0;0;0;0;0;0;0;0;0;0;0;0;0;0
FR;9;2021-08-13;0;0;0;0;0;0;0;0;0;0;0;0;0;0;0;0;0;0
FR;9;2021-08-14;0;0;0;0;0;0;0;0;0;0;0;0;0;0;0;0;0;0
FR;9;2021-08-15;0;0;0;0;0;0;0;0;0;0;0;0;0;0;0;0;0;0
FR;9;2021-08-16;0;0;0;0;0;0;0;0;0;0;0;0;0;0;0;0;0;0
FR;9;2021-08-17;0;0;0;0;0;0;0;0;0;0;0;0;0;0;0;0;0;0
FR;9;2021-08-18;0;0;0;0;0;0;0;0;0;0;0;0;0;0;0;0;0;0
FR;9;2021-08-19;0;0;0;0;0;0;0;0;0;0;0;0;0;0;0;0;0;0
FR;9;2021-08-20;0;0;0;0;0;0;0;0;0;0;0;0;0;0;0;0;0;0
FR;9;2021-08-21;0;0;0;0;0;0;0;0;0;0;0;0;0;0;0;0;0;0
FR;9;2021-08-22;0;0;0;0;0;0;0;0;0;0;0;0;0;0;0;0;0;0
FR;9;2021-08-23;0;0;0;0;0;0;0;0;0;0;0;0;0;0;0;0;0;0
FR;9;2021-08-24;0;0;0;0;0;0;0;0;0;0;0;0;0;0;0;0;0;0
FR;9;2021-08-25;0;0;0;0;0;0;0;0;0;0;0;0;0;0;0;0;0;0
FR;9;2021-08-26;0;0;0;0;0;0;0;0;0;0;0;0;0;0;0;0;0;0
FR;9;2021-08-27;0;0;0;0;0;0;0;0;0;0;0;0;0;0;0;0;0;0
FR;9;2021-08-28;0;0;0;0;0;0;0;0;0;0;0;0;0;0;0;0;0;0
FR;9;2021-08-29;0;0;0;0;0;0;0;0;0;0;0;0;0;0;0;0;0;0
FR;9;2021-08-30;0;0;0;0;0;0;0;0;0;0;0;0;0;0;0;0;0;0
FR;9;2021-08-31;0;0;0;0;0;0;0;0;0;0;0;0;0;0;0;0;0;0
FR;9;2021-09-01;0;0;0;0;0;0;0;0;0;0;0;0;0;0;0;0;0;0
FR;9;2021-09-02;0;0;0;0;0;0;0;0;0;0;0;0;0;0;0;0;0;0
FR;9;2021-09-03;0;0;0;0;0;0;0;0;0;0;0;0;0;0;0;0;0;0
FR;9;2021-09-04;0;0;0;0;0;0;0;0;0;0;0;0;0;0;0;0;0;0
FR;9;2021-09-05;0;0;0;0;0;0;0;0;0;0;0;0;0;0;0;0;0;0
FR;9;2021-09-06;0;0;0;0;0;0;0;0;0;0;0;0;0;0;0;0;0;0
FR;9;2021-09-07;0;0;0;0;0;0;0;0;0;0;0;0;0;0;0;0;0;0
FR;9;2021-09-08;0;0;0;0;0;0;0;0;0;0;0;0;0;0;0;0;0;0
FR;9;2021-09-09;0;0;0;0;0;0;0;0;0;0;0;0;0;0;0;0;0;0
FR;9;2021-09-10;0;0;0;0;0;0;0;0;0;0;0;0;0;0;0;0;0;0
FR;9;2021-09-11;0;0;0;0;0;0;0;0;0;0;0;0;0;0;0;0;0;0
FR;9;2021-09-12;0;0;0;0;0;0;0;0;0;0;0;0;0;0;0;0;0;0
FR;9;2021-09-13;0;0;0;0;0;0;0;0;0;0;0;0;0;0;0;0;0;0
FR;9;2021-09-14;0;0;0;0;0;0;0;0;0;0;0;0;0;0;0;0;0;0
FR;9;2021-09-15;0;0;0;0;0;0;0;0;0;0;0;0;0;0;0;0;0;0
FR;9;2021-09-16;0;0;0;0;0;0;0;0;0;0;0;0;0;0;0;0;0;0
FR;9;2021-09-17;0;0;0;0;0;0;0;0;0;0;0;0;0;0;0;0;0;0
FR;9;2021-09-18;0;0;0;0;0;0;0;0;0;0;0;0;0;0;0;0;0;0
FR;9;2021-09-19;0;0;0;0;0;0;0;0;0;0;0;0;0;0;0;0;0;0
FR;9;2021-09-20;0;0;0;0;0;0;0;0;0;0;0;0;0;0;0;0;0;0
FR;9;2021-09-21;0;0;0;0;0;0;0;0;0;0;0;0;0;0;0;0;0;0
FR;9;2021-09-22;0;0;0;0;0;0;0;0;0;0;0;0;0;0;0;0;0;0
FR;9;2021-09-23;0;0;0;0;0;0;0;0;0;0;0;0;0;0;0;0;0;0
FR;9;2021-09-24;0;0;0;0;0;0;0;0;0;0;0;0;0;0;0;0;0;0
FR;9;2021-09-25;0;0;0;0;0;0;0;0;0;0;0;0;0;0;0;0;0;0
FR;9;2021-09-26;0;0;0;0;0;0;0;0;0;0;0;0;0;0;0;0;0;0
FR;9;2021-09-27;0;0;0;0;0;0;0;0;0;0;0;0;0;0;0;0;0;0
FR;9;2021-09-28;0;0;0;0;0;0;0;0;0;0;0;0;0;0;0;0;0;0
FR;9;2021-09-29;0;0;0;0;0;0;0;0;0;0;0;0;0;0;0;0;0;0
FR;9;2021-09-30;0;0;0;0;0;0;0;0;0;0;0;0;0;0;0;0;0;0
FR;9;2021-10-01;0;0;0;0;0;0;0;0;0;0;0;0;0;0;0;0;0;0
FR;9;2021-10-02;0;0;0;0;0;0;0;0;0;0;0;0;0;0;0;0;0;0
FR;9;2021-10-03;0;0;0;0;0;0;0;0;0;0;0;0;0;0;0;0;0;0
FR;9;2021-10-04;0;0;0;0;0;0;0;0;0;0;0;0;0;0;0;0;0;0
FR;9;2021-10-05;0;0;0;0;0;0;0;0;0;0;0;0;0;0;0;0;0;0
FR;9;2021-10-06;0;0;0;0;0;0;0;0;0;0;0;0;0;0;0;0;0;0
FR;9;2021-10-07;0;0;0;0;0;0;0;0;0;0;0;0;0;0;0;0;0;0
FR;9;2021-10-08;0;0;0;0;0;0;0;0;0;0;0;0;0;0;0;0;0;0
FR;9;2021-10-09;0;0;0;0;0;0;0;0;0;0;0;0;0;0;0;0;0;0
FR;9;2021-10-10;0;0;0;0;0;0;0;0;0;0;0;0;0;0;0;0;0;0
FR;9;2021-10-11;0;0;0;0;0;0;0;0;0;0;0;0;0;0;0;0;0;0
FR;9;2021-10-12;0;0;0;0;0;0;0;0;0;0;0;0;0;0;0;0;0;0
FR;9;2021-10-13;0;0;0;0;0;0;0;0;0;0;0;0;0;0;0;0;0;0
FR;9;2021-10-14;0;0;0;0;0;0;0;0;0;0;0;0;0;0;0;0;0;0
FR;9;2021-10-15;0;0;0;0;0;0;0;0;0;0;0;0;0;0;0;0;0;0
FR;9;2021-10-16;0;0;0;0;0;0;0;0;0;0;0;0;0;0;0;0;0;0
FR;9;2021-10-17;0;0;0;0;0;0;0;0;0;0;0;0;0;0;0;0;0;0
FR;9;2021-10-18;0;0;0;0;0;0;0;0;0;0;0;0;0;0;0;0;0;0
FR;9;2021-10-19;0;0;0;0;0;0;0;0;0;0;0;0;0;0;0;0;0;0
FR;9;2021-10-20;0;0;0;0;0;0;0;0;0;0;0;0;0;0;0;0;0;0
FR;9;2021-10-21;0;0;0;0;0;0;0;0;0;0;0;0;0;0;0;0;0;0
FR;9;2021-10-22;0;0;0;0;0;0;0;0;0;0;0;0;0;0;0;0;0;0
FR;9;2021-10-23;0;0;0;0;0;0;0;0;0;0;0;0;0;0;0;0;0;0
FR;9;2021-10-24;0;0;0;0;0;0;0;0;0;0;0;0;0;0;0;0;0;0
FR;9;2021-10-25;0;0;0;0;0;0;0;0;0;0;0;0;0;0;0;0;0;0
FR;9;2021-10-26;0;0;0;0;0;0;0;0;0;0;0;0;0;0;0;0;0;0
FR;9;2021-10-27;0;0;0;0;0;0;0;0;0;0;0;0;0;0;0;0;0;0
FR;9;2021-10-28;0;0;0;0;0;0;0;0;0;0;0;0;0;0;0;0;0;0
FR;9;2021-10-29;0;0;0;0;0;0;0;0;0;0;0;0;0;0;0;0;0;0
FR;9;2021-10-30;0;0;0;0;0;0;0;0;0;0;0;0;0;0;0;0;0;0
FR;9;2021-10-31;0;0;0;0;0;0;0;0;0;0;0;0;0;0;0;0;0;0
FR;9;2021-11-01;0;0;0;0;0;0;0;0;0;0;0;0;0;0;0;0;0;0
FR;9;2021-11-02;0;0;0;0;0;0;0;0;0;0;0;0;0;0;0;0;0;0
FR;9;2021-11-03;0;0;0;0;0;0;0;0;0;0;0;0;0;0;0;0;0;0
FR;9;2021-11-04;0;0;0;0;0;0;0;0;0;0;0;0;0;0;0;0;0;0
FR;9;2021-11-05;0;0;0;0;0;0;0;0;0;0;0;0;0;0;0;0;0;0
FR;9;2021-11-06;0;0;0;0;0;0;0;0;0;0;0;0;0;0;0;0;0;0
FR;9;2021-11-07;0;0;0;0;0;0;0;0;0;0;0;0;0;0;0;0;0;0
FR;9;2021-11-08;0;0;0;0;0;0;0;0;0;0;0;0;0;0;0;0;0;0
FR;9;2021-11-09;0;0;0;0;0;0;0;0;0;0;0;0;0;0;0;0;0;0
FR;9;2021-11-10;0;0;0;0;0;0;0;0;0;0;0;0;0;0;0;0;0;0
FR;9;2021-11-11;0;0;0;0;0;0;0;0;0;0;0;0;0;0;0;0;0;0
FR;9;2021-11-12;0;0;0;0;0;0;0;0;0;0;0;0;0;0;0;0;0;0
FR;9;2021-11-13;0;0;0;0;0;0;0;0;0;0;0;0;0;0;0;0;0;0
FR;9;2021-11-14;0;0;0;0;0;0;0;0;0;0;0;0;0;0;0;0;0;0
FR;9;2021-11-15;0;0;0;0;0;0;0;0;0;0;0;0;0;0;0;0;0;0
FR;9;2021-11-16;0;0;0;0;0;0;0;0;0;0;0;0;0;0;0;0;0;0
FR;9;2021-11-17;0;0;0;0;0;0;0;0;0;0;0;0;0;0;0;0;0;0
FR;9;2021-11-18;0;0;0;0;0;0;0;0;0;0;0;0;0;0;0;0;0;0
FR;9;2021-11-19;0;0;0;0;0;0;0;0;0;0;0;0;0;0;0;0;0;0
FR;9;2021-11-20;0;0;0;0;0;0;0;0;0;0;0;0;0;0;0;0;0;0
FR;9;2021-11-21;0;0;0;0;0;0;0;0;0;0;0;0;0;0;0;0;0;0
FR;9;2021-11-22;0;0;0;0;0;0;0;0;0;0;0;0;0;0;0;0;0;0
FR;9;2021-11-23;0;0;0;0;0;0;0;0;0;0;0;0;0;0;0;0;0;0
FR;9;2021-11-24;0;0;0;0;0;0;0;0;0;0;0;0;0;0;0;0;0;0
FR;9;2021-11-25;0;0;0;0;0;0;0;0;0;0;0;0;0;0;0;0;0;0
FR;9;2021-11-26;0;0;0;0;0;0;0;0;0;0;0;0;0;0;0;0;0;0
FR;9;2021-11-27;0;0;0;0;0;0;0;0;0;0;0;0;0;0;0;0;0;0
FR;9;2021-11-28;0;0;0;0;0;0;0;0;0;0;0;0;0;0;0;0;0;0
FR;9;2021-11-29;0;0;0;0;0;0;0;0;0;0;0;0;0;0;0;0;0;0
FR;9;2021-11-30;0;0;0;0;0;0;0;0;0;0;0;0;0;0;0;0;0;0
FR;9;2021-12-01;0;0;0;0;0;0;0;0;0;0;0;0;0;0;0;0;0;0
FR;9;2021-12-02;0;0;0;0;0;0;0;0;0;0;0;0;0;0;0;0;0;0
FR;9;2021-12-03;0;0;0;0;0;0;0;0;0;0;0;0;0;0;0;0;0;0
FR;9;2021-12-04;0;0;0;0;0;0;0;0;0;0;0;0;0;0;0;0;0;0
FR;9;2021-12-05;0;0;0;0;0;0;0;0;0;0;0;0;0;0;0;0;0;0
FR;9;2021-12-06;0;0;0;0;0;0;0;0;0;0;0;0;0;0;0;0;0;0
FR;9;2021-12-07;0;0;0;0;0;0;0;0;0;0;0;0;0;0;0;0;0;0
FR;9;2021-12-08;0;0;0;0;0;0;0;0;0;0;0;0;0;0;0;0;0;0
FR;9;2021-12-09;0;0;0;0;0;0;0;0;0;0;0;0;0;0;0;0;0;0
FR;9;2021-12-10;0;0;0;0;0;0;0;0;0;0;0;0;0;0;0;0;0;0
FR;9;2021-12-11;0;0;0;0;0;0;0;0;0;0;0;0;0;0;0;0;0;0
FR;9;2021-12-12;0;0;0;0;0;0;0;0;0;0;0;0;0;0;0;0;0;0
FR;9;2021-12-13;0;0;0;0;0;0;0;0;0;0;0;0;0;0;0;0;0;0
FR;9;2021-12-14;0;0;0;0;0;0;0;0;0;0;0;0;0;0;0;0;0;0
FR;9;2021-12-15;0;0;0;0;0;0;0;0;0;0;0;0;0;0;0;0;0;0
FR;9;2021-12-16;0;0;0;0;0;0;0;0;0;0;0;0;0;0;0;0;0;0
FR;9;2021-12-17;0;0;0;0;0;0;0;0;0;0;0;0;0;0;0;0;0;0
FR;9;2021-12-18;0;0;0;0;0;0;0;0;0;0;0;0;0;0;0;0;0;0
FR;9;2021-12-19;0;0;0;0;0;0;0;0;0;0;0;0;0;0;0;0;0;0
FR;9;2021-12-20;0;0;0;0;0;0;0;0;0;0;0;0;0;0;0;0;0;0
FR;9;2021-12-21;0;0;0;0;0;0;0;0;0;0;0;0;0;0;0;0;0;0
FR;9;2021-12-22;0;0;0;0;0;0;0;0;0;0;0;0;0;0;0;0;0;0
FR;9;2021-12-23;0;0;0;0;0;0;0;0;0;0;0;0;0;0;0;0;0;0
FR;9;2021-12-24;0;0;0;0;0;0;0;0;0;0;0;0;0;0;0;0;0;0
FR;9;2021-12-25;0;0;0;0;0;0;0;0;0;0;0;0;0;0;0;0;0;0
FR;9;2021-12-26;0;0;0;0;0;0;0;0;0;0;0;0;0;0;0;0;0;0
FR;9;2021-12-27;0;0;0;0;0;0;0;0;0;0;0;0;0;0;0;0;0;0
FR;9;2021-12-28;0;0;0;0;0;0;0;0;0;0;0;0;0;0;0;0;0;0
FR;9;2021-12-29;0;0;0;0;0;0;0;0;0;0;0;0;0;0;0;0;0;0
FR;9;2021-12-30;0;0;0;0;0;0;0;0;0;0;0;0;0;0;0;0;0;0
FR;9;2021-12-31;0;0;0;0;0;0;0;0;0;0;0;0;0;0;0;0;0;0
FR;9;2022-01-01;0;0;0;0;0;0;0;0;0;0;0;0;0;0;0;0;0;0
FR;9;2022-01-02;0;0;0;0;0;0;0;0;0;0;0;0;0;0;0;0;0;0
FR;9;2022-01-03;0;0;0;0;0;0;0;0;0;0;0;0;0;0;0;0;0;0
FR;9;2022-01-04;0;0;0;0;0;0;0;0;0;0;0;0;0;0;0;0;0;0
FR;9;2022-01-05;0;0;0;0;0;0;0;0;0;0;0;0;0;0;0;0;0;0
FR;9;2022-01-06;0;0;0;0;0;0;0;0;0;0;0;0;0;0;0;0;0;0
FR;9;2022-01-07;0;0;0;0;0;0;0;0;0;0;0;0;0;0;0;0;0;0
FR;9;2022-01-08;0;0;0;0;0;0;0;0;0;0;0;0;0;0;0;0;0;0
FR;9;2022-01-09;0;0;0;0;0;0;0;0;0;0;0;0;0;0;0;0;0;0
FR;9;2022-01-10;0;0;0;0;0;0;0;0;0;0;0;0;0;0;0;0;0;0
FR;9;2022-01-11;0;0;0;0;0;0;0;0;0;0;0;0;0;0;0;0;0;0
FR;9;2022-01-12;0;0;0;0;0;0;0;0;0;0;0;0;0;0;0;0;0;0
FR;9;2022-01-13;0;0;0;0;0;0;0;0;0;0;0;0;0;0;0;0;0;0
FR;9;2022-01-14;0;0;0;0;0;0;0;0;0;0;0;0;0;0;0;0;0;0
FR;9;2022-01-15;0;0;0;0;0;0;0;0;0;0;0;0;0;0;0;0;0;0
FR;9;2022-01-16;0;0;0;0;0;0;0;0;0;0;0;0;0;0;0;0;0;0
FR;9;2022-01-17;0;0;0;0;0;0;0;0;0;0;0;0;0;0;0;0;0;0
FR;9;2022-01-18;0;0;0;0;0;0;0;0;0;0;0;0;0;0;0;0;0;0
FR;9;2022-01-19;0;0;0;0;0;0;0;0;0;0;0;0;0;0;0;0;0;0
FR;9;2022-01-20;0;0;0;0;0;0;0;0;0;0;0;0;0;0;0;0;0;0
FR;9;2022-01-21;0;0;0;0;0;0;0;0;0;0;0;0;0;0;0;0;0;0
FR;9;2022-01-22;0;0;0;0;0;0;0;0;0;0;0;0;0;0;0;0;0;0
FR;9;2022-01-23;0;0;0;0;0;0;0;0;0;0;0;0;0;0;0;0;0;0
FR;9;2022-01-24;0;0;0;0;0;0;0;0;0;0;0;0;0;0;0;0;0;0
FR;9;2022-01-25;0;0;0;0;0;0;0;0;0;0;0;0;0;0;0;0;0;0
FR;9;2022-01-26;0;0;0;0;0;0;0;0;0;0;0;0;0;0;0;0;0;0
FR;9;2022-01-27;0;0;0;0;0;0;0;0;0;0;0;0;0;0;0;0;0;0
FR;9;2022-01-28;0;0;0;0;0;0;0;0;0;0;0;0;0;0;0;0;0;0
FR;9;2022-01-29;0;0;0;0;0;0;0;0;0;0;0;0;0;0;0;0;0;0
FR;9;2022-01-30;0;0;0;0;0;0;0;0;0;0;0;0;0;0;0;0;0;0
FR;9;2022-01-31;0;0;0;0;0;0;0;0;0;0;0;0;0;0;0;0;0;0
FR;9;2022-02-01;0;0;0;0;0;0;0;0;0;0;0;0;0;0;0;0;0;0
FR;9;2022-02-02;0;0;0;0;0;0;0;0;0;0;0;0;0;0;0;0;0;0
FR;9;2022-02-03;0;0;0;0;0;0;0;0;0;0;0;0;0;0;0;0;0;0
FR;9;2022-02-04;0;0;0;0;0;0;0;0;0;0;0;0;0;0;0;0;0;0
FR;9;2022-02-05;0;0;0;0;0;0;0;0;0;0;0;0;0;0;0;0;0;0
FR;9;2022-02-06;0;0;0;0;0;0;0;0;0;0;0;0;0;0;0;0;0;0
FR;9;2022-02-07;0;0;0;0;0;0;0;0;0;0;0;0;0;0;0;0;0;0
FR;9;2022-02-08;0;0;0;0;0;0;0;0;0;0;0;0;0;0;0;0;0;0
FR;9;2022-02-09;0;0;0;0;0;0;0;0;0;0;0;0;0;0;0;0;0;0
FR;9;2022-02-10;0;0;0;0;0;0;0;0;0;0;0;0;0;0;0;0;0;0
FR;9;2022-02-11;0;0;0;0;0;0;0;0;0;0;0;0;0;0;0;0;0;0
FR;9;2022-02-12;0;0;0;0;0;0;0;0;0;0;0;0;0;0;0;0;0;0
FR;9;2022-02-13;0;0;0;0;0;0;0;0;0;0;0;0;0;0;0;0;0;0
FR;9;2022-02-14;0;0;0;0;0;0;0;0;0;0;0;0;0;0;0;0;0;0
FR;9;2022-02-15;0;0;0;0;0;0;0;0;0;0;0;0;0;0;0;0;0;0
FR;9;2022-02-16;0;0;0;0;0;0;0;0;0;0;0;0;0;0;0;0;0;0
FR;9;2022-02-17;0;0;0;0;0;0;0;0;0;0;0;0;0;0;0;0;0;0
FR;9;2022-02-18;0;0;0;0;0;0;0;0;0;0;0;0;0;0;0;0;0;0
FR;9;2022-02-19;0;0;0;0;0;0;0;0;0;0;0;0;0;0;0;0;0;0
FR;9;2022-02-20;0;0;0;0;0;0;0;0;0;0;0;0;0;0;0;0;0;0
FR;9;2022-02-21;0;0;0;0;0;0;0;0;0;0;0;0;0;0;0;0;0;0
FR;9;2022-02-22;0;0;0;0;0;0;0;0;0;0;0;0;0;0;0;0;0;0
FR;9;2022-02-23;0;0;0;0;0;0;0;0;0;0;0;0;0;0;0;0;0;0
FR;9;2022-02-24;0;0;0;0;0;0;0;0;0;0;0;0;0;0;0;0;0;0
FR;9;2022-02-25;0;0;0;0;0;0;0;0;0;0;0;0;0;0;0;0;0;0
FR;9;2022-02-26;0;0;0;0;0;0;0;0;0;0;0;0;0;0;0;0;0;0
FR;9;2022-02-27;0;0;0;0;0;0;0;0;0;0;0;0;0;0;0;0;0;0
FR;9;2022-02-28;0;0;0;0;0;0;0;0;0;0;0;0;0;0;0;0;0;0
FR;9;2022-03-01;0;0;0;0;0;0;0;0;0;0;0;0;0;0;0;0;0;0
FR;9;2022-03-02;0;0;0;0;0;0;0;0;0;0;0;0;0;0;0;0;0;0
FR;9;2022-03-03;0;0;0;0;0;0;0;0;0;0;0;0;0;0;0;0;0;0
FR;9;2022-03-04;0;0;0;0;0;0;0;0;0;0;0;0;0;0;0;0;0;0
FR;9;2022-03-05;0;0;0;0;0;0;0;0;0;0;0;0;0;0;0;0;0;0
FR;9;2022-03-06;0;0;0;0;0;0;0;0;0;0;0;0;0;0;0;0;0;0
FR;9;2022-03-07;0;0;0;0;0;0;0;0;0;0;0;0;0;0;0;0;0;0
FR;9;2022-03-08;0;0;0;0;0;0;0;0;0;0;0;0;0;0;0;0;0;0
FR;9;2022-03-09;0;0;0;0;0;0;0;0;0;0;0;0;0;0;0;0;0;0
FR;9;2022-03-10;0;0;0;0;0;0;0;0;0;0;0;0;0;0;0;0;0;0
FR;9;2022-03-11;0;0;0;0;0;0;0;0;0;0;0;0;0;0;0;0;0;0
FR;9;2022-03-12;0;0;0;0;0;0;0;0;0;0;0;0;0;0;0;0;0;0
FR;9;2022-03-13;0;0;0;0;0;0;0;0;0;0;0;0;0;0;0;0;0;0
FR;9;2022-03-14;0;0;0;0;0;0;0;0;0;0;0;0;0;0;0;0;0;0
FR;9;2022-03-15;0;0;0;0;0;0;0;0;0;0;0;0;0;0;0;0;0;0
FR;9;2022-03-16;0;0;0;0;0;0;0;0;0;0;0;0;0;0;0;0;0;0
FR;9;2022-03-17;0;0;0;0;0;0;0;0;0;0;0;0;0;0;0;0;0;0
FR;9;2022-03-18;0;0;0;0;0;0;0;0;0;0;0;0;0;0;0;0;0;0
FR;9;2022-03-19;0;0;0;0;0;0;0;0;0;0;0;0;0;0;0;0;0;0
FR;9;2022-03-20;0;0;0;0;0;0;0;0;0;0;0;0;0;0;0;0;0;0
FR;9;2022-03-21;0;0;0;0;0;0;0;0;0;0;0;0;0;0;0;0;0;0
FR;9;2022-03-22;0;0;0;0;0;0;0;0;0;0;0;0;0;0;0;0;0;0
FR;9;2022-03-23;0;0;0;0;0;0;0;0;0;0;0;0;0;0;0;0;0;0
FR;9;2022-03-24;0;0;0;0;0;0;0;0;0;0;0;0;0;0;0;0;0;0
FR;9;2022-03-25;0;0;0;0;0;0;0;0;0;0;0;0;0;0;0;0;0;0
FR;9;2022-03-26;0;0;0;0;0;0;0;0;0;0;0;0;0;0;0;0;0;0
FR;9;2022-03-27;0;0;0;0;0;0;0;0;0;0;0;0;0;0;0;0;0;0
FR;9;2022-03-28;0;0;0;0;0;0;0;0;0;0;0;0;0;0;0;0;0;0
FR;9;2022-03-29;0;0;0;0;0;0;0;0;0;0;0;0;0;0;0;0;0;0
FR;9;2022-03-30;0;0;0;0;0;0;0;0;0;0;0;0;0;0;0;0;0;0
FR;9;2022-03-31;0;0;0;0;0;0;0;0;0;0;0;0;0;0;0;0;0;0
FR;9;2022-04-01;0;0;0;0;0;0;0;0;0;0;0;0;0;0;0;0;0;0
FR;9;2022-04-02;0;0;0;0;0;0;0;0;0;0;0;0;0;0;0;0;0;0
FR;9;2022-04-03;0;0;0;0;0;0;0;0;0;0;0;0;0;0;0;0;0;0
FR;9;2022-04-04;0;0;0;0;0;0;0;0;0;0;0;0;0;0;0;0;0;0
FR;9;2022-04-05;0;0;0;0;0;0;0;0;0;0;0;0;0;0;0;0;0;0
FR;9;2022-04-06;0;0;0;0;0;0;0;0;0;0;0;0;0;0;0;0;0;0
FR;9;2022-04-07;0;0;0;0;0;0;0;0;0;0;0;0;0;0;0;0;0;0
FR;9;2022-04-08;0;0;0;0;0;0;0;0;0;0;0;0;0;0;0;0;0;0
FR;9;2022-04-09;0;0;0;0;0;0;0;0;0;0;0;0;0;0;0;0;0;0
FR;9;2022-04-10;0;0;0;0;0;0;0;0;0;0;0;0;0;0;0;0;0;0
FR;9;2022-04-11;0;0;0;0;0;0;0;0;0;0;0;0;0;0;0;0;0;0
FR;9;2022-04-12;0;0;0;0;0;0;0;0;0;0;0;0;0;0;0;0;0;0
FR;9;2022-04-13;0;0;0;0;0;0;0;0;0;0;0;0;0;0;0;0;0;0
FR;9;2022-04-14;0;0;0;0;0;0;0;0;0;0;0;0;0;0;0;0;0;0
FR;9;2022-04-15;0;0;0;0;0;0;0;0;0;0;0;0;0;0;0;0;0;0
FR;9;2022-04-16;0;0;0;0;0;0;0;0;0;0;0;0;0;0;0;0;0;0
FR;9;2022-04-17;0;0;0;0;0;0;0;0;0;0;0;0;0;0;0;0;0;0
FR;9;2022-04-18;0;0;0;0;0;0;0;0;0;0;0;0;0;0;0;0;0;0
FR;9;2022-04-19;0;0;0;0;0;0;0;0;0;0;0;0;0;0;0;0;0;0
FR;9;2022-04-20;0;0;0;0;0;0;0;0;0;0;0;0;0;0;0;0;0;0
FR;9;2022-04-21;0;0;0;0;0;0;0;0;0;0;0;0;0;0;0;0;0;0
FR;9;2022-04-22;0;0;0;0;0;0;0;0;0;0;0;0;0;0;0;0;0;0
FR;9;2022-04-23;0;0;0;0;0;0;0;0;0;0;0;0;0;0;0;0;0;0
FR;9;2022-04-24;0;0;0;0;0;0;0;0;0;0;0;0;0;0;0;0;0;0
FR;9;2022-04-25;0;0;0;0;0;0;0;0;0;0;0;0;0;0;0;0;0;0
FR;9;2022-04-26;0;0;0;0;0;0;0;0;0;0;0;0;0;0;0;0;0;0
FR;9;2022-04-27;0;0;0;0;0;0;0;0;0;0;0;0;0;0;0;0;0;0
FR;9;2022-04-28;0;0;0;0;0;0;0;0;0;0;0;0;0;0;0;0;0;0
FR;9;2022-04-29;0;0;0;0;0;0;0;0;0;0;0;0;0;0;0;0;0;0
FR;9;2022-04-30;0;0;0;0;0;0;0;0;0;0;0;0;0;0;0;0;0;0
FR;9;2022-05-01;0;0;0;0;0;0;0;0;0;0;0;0;0;0;0;0;0;0
FR;9;2022-05-02;0;0;0;0;0;0;0;0;0;0;0;0;0;0;0;0;0;0
FR;9;2022-05-03;0;0;0;0;0;0;0;0;0;0;0;0;0;0;0;0;0;0
FR;9;2022-05-04;0;0;0;0;0;0;0;0;0;0;0;0;0;0;0;0;0;0
FR;9;2022-05-05;0;0;0;0;0;0;0;0;0;0;0;0;0;0;0;0;0;0
FR;9;2022-05-06;0;0;0;0;0;0;0;0;0;0;0;0;0;0;0;0;0;0
FR;9;2022-05-07;0;0;0;0;0;0;0;0;0;0;0;0;0;0;0;0;0;0
FR;9;2022-05-08;0;0;0;0;0;0;0;0;0;0;0;0;0;0;0;0;0;0
FR;9;2022-05-09;0;0;0;0;0;0;0;0;0;0;0;0;0;0;0;0;0;0
FR;9;2022-05-10;0;0;0;0;0;0;0;0;0;0;0;0;0;0;0;0;0;0
FR;9;2022-05-11;0;0;0;0;0;0;0;0;0;0;0;0;0;0;0;0;0;0
FR;9;2022-05-12;0;0;0;0;0;0;0;0;0;0;0;0;0;0;0;0;0;0
FR;9;2022-05-13;0;0;0;0;0;0;0;0;0;0;0;0;0;0;0;0;0;0
FR;9;2022-05-14;0;0;0;0;0;0;0;0;0;0;0;0;0;0;0;0;0;0
FR;9;2022-05-15;0;0;0;0;0;0;0;0;0;0;0;0;0;0;0;0;0;0
FR;9;2022-05-16;0;0;0;0;0;0;0;0;0;0;0;0;0;0;0;0;0;0
FR;9;2022-05-17;0;0;0;0;0;0;0;0;0;0;0;0;0;0;0;0;0;0
FR;9;2022-05-18;0;0;0;0;0;0;0;0;0;0;0;0;0;0;0;0;0;0
FR;9;2022-05-19;0;0;0;0;0;0;0;0;0;0;0;0;0;0;0;0;0;0
FR;9;2022-05-20;0;0;0;0;0;0;0;0;0;0;0;0;0;0;0;0;0;0
FR;9;2022-05-21;0;0;0;0;0;0;0;0;0;0;0;0;0;0;0;0;0;0
FR;9;2022-05-22;0;0;0;0;0;0;0;0;0;0;0;0;0;0;0;0;0;0
FR;9;2022-05-23;0;0;0;0;0;0;0;0;0;0;0;0;0;0;0;0;0;0
FR;9;2022-05-24;0;0;0;0;0;0;0;0;0;0;0;0;0;0;0;0;0;0
FR;9;2022-05-25;0;0;0;0;0;0;0;0;0;0;0;0;0;0;0;0;0;0
FR;9;2022-05-26;0;0;0;0;0;0;0;0;0;0;0;0;0;0;0;0;0;0
FR;9;2022-05-27;0;0;0;0;0;0;0;0;0;0;0;0;0;0;0;0;0;0
FR;9;2022-05-28;0;0;0;0;0;0;0;0;0;0;0;0;0;0;0;0;0;0
FR;9;2022-05-29;0;0;0;0;0;0;0;0;0;0;0;0;0;0;0;0;0;0
FR;9;2022-05-30;0;0;0;0;0;0;0;0;0;0;0;0;0;0;0;0;0;0
FR;9;2022-05-31;0;0;0;0;0;0;0;0;0;0;0;0;0;0;0;0;0;0
FR;9;2022-06-01;0;0;0;0;0;0;0;0;0;0;0;0;0;0;0;0;0;0
FR;9;2022-06-02;0;0;0;0;0;0;0;0;0;0;0;0;0;0;0;0;0;0
FR;9;2022-06-03;0;0;0;0;0;0;0;0;0;0;0;0;0;0;0;0;0;0
FR;9;2022-06-04;0;0;0;0;0;0;0;0;0;0;0;0;0;0;0;0;0;0
FR;9;2022-06-05;0;0;0;0;0;0;0;0;0;0;0;0;0;0;0;0;0;0
FR;9;2022-06-06;0;0;0;0;0;0;0;0;0;0;0;0;0;0;0;0;0;0
FR;9;2022-06-07;0;0;0;0;0;0;0;0;0;0;0;0;0;0;0;0;0;0
FR;9;2022-06-08;0;0;0;0;0;0;0;0;0;0;0;0;0;0;0;0;0;0
FR;9;2022-06-09;0;0;0;0;0;0;0;0;0;0;0;0;0;0;0;0;0;0
FR;9;2022-06-10;0;0;0;0;0;0;0;0;0;0;0;0;0;0;0;0;0;0
FR;9;2022-06-11;0;0;0;0;0;0;0;0;0;0;0;0;0;0;0;0;0;0
FR;9;2022-06-12;0;0;0;0;0;0;0;0;0;0;0;0;0;0;0;0;0;0
FR;9;2022-06-13;0;0;0;0;0;0;0;0;0;0;0;0;0;0;0;0;0;0
FR;9;2022-06-14;0;0;0;0;0;0;0;0;0;0;0;0;0;0;0;0;0;0
FR;9;2022-06-15;0;0;0;0;0;0;0;0;0;0;0;0;0;0;0;0;0;0
FR;9;2022-06-16;0;0;0;0;0;0;0;0;0;0;0;0;0;0;0;0;0;0
FR;9;2022-06-17;0;0;0;0;0;0;0;0;0;0;0;0;0;0;0;0;0;0
FR;9;2022-06-18;0;0;0;0;0;0;0;0;0;0;0;0;0;0;0;0;0;0
FR;9;2022-06-19;0;0;0;0;0;0;0;0;0;0;0;0;0;0;0;0;0;0
FR;9;2022-06-20;0;0;0;0;0;0;0;0;0;0;0;0;0;0;0;0;0;0
FR;9;2022-06-21;0;0;0;0;0;0;0;0;0;0;0;0;0;0;0;0;0;0
FR;9;2022-06-22;0;0;0;0;0;0;0;0;0;0;0;0;0;0;0;0;0;0
FR;9;2022-06-23;0;0;0;0;0;0;0;0;0;0;0;0;0;0;0;0;0;0
FR;9;2022-06-24;0;0;0;0;0;0;0;0;0;0;0;0;0;0;0;0;0;0
FR;9;2022-06-25;0;0;0;0;0;0;0;0;0;0;0;0;0;0;0;0;0;0
FR;9;2022-06-26;0;0;0;0;0;0;0;0;0;0;0;0;0;0;0;0;0;0
FR;9;2022-06-27;0;0;0;0;0;0;0;0;0;0;0;0;0;0;0;0;0;0
FR;9;2022-06-28;0;0;0;0;0;0;0;0;0;0;0;0;0;0;0;0;0;0
FR;9;2022-06-29;0;0;0;0;0;0;0;0;0;0;0;0;0;0;0;0;0;0
FR;9;2022-06-30;0;0;0;0;0;0;0;0;0;0;0;0;0;0;0;0;0;0
FR;9;2022-07-01;0;0;0;0;0;0;0;0;0;0;0;0;0;0;0;0;0;0
FR;9;2022-07-02;0;0;0;0;0;0;0;0;0;0;0;0;0;0;0;0;0;0
FR;9;2022-07-03;0;0;0;0;0;0;0;0;0;0;0;0;0;0;0;0;0;0
FR;9;2022-07-04;0;0;0;0;0;0;0;0;0;0;0;0;0;0;0;0;0;0
FR;9;2022-07-05;0;0;0;0;0;0;0;0;0;0;0;0;0;0;0;0;0;0
FR;9;2022-07-06;0;0;0;0;0;0;0;0;0;0;0;0;0;0;0;0;0;0
FR;9;2022-07-07;0;0;0;0;0;0;0;0;0;0;0;0;0;0;0;0;0;0
FR;9;2022-07-08;0;0;0;0;0;0;0;0;0;0;0;0;0;0;0;0;0;0
FR;9;2022-07-09;0;0;0;0;0;0;0;0;0;0;0;0;0;0;0;0;0;0
FR;9;2022-07-10;0;0;0;0;0;0;0;0;0;0;0;0;0;0;0;0;0;0
FR;9;2022-07-11;0;0;0;0;0;0;0;0;0;0;0;0;0;0;0;0;0;0
FR;9;2022-07-12;0;0;0;0;0;0;0;0;0;0;0;0;0;0;0;0;0;0
FR;9;2022-07-13;0;0;0;0;0;0;0;0;0;0;0;0;0;0;0;0;0;0
FR;9;2022-07-14;0;0;0;0;0;0;0;0;0;0;0;0;0;0;0;0;0;0
FR;9;2022-07-15;0;0;0;0;0;0;0;0;0;0;0;0;0;0;0;0;0;0
FR;9;2022-07-16;0;0;0;0;0;0;0;0;0;0;0;0;0;0;0;0;0;0
FR;9;2022-07-17;0;0;0;0;0;0;0;0;0;0;0;0;0;0;0;0;0;0
FR;9;2022-07-18;0;0;0;0;0;0;0;0;0;0;0;0;0;0;0;0;0;0
FR;9;2022-07-19;0;0;0;0;0;0;0;0;0;0;0;0;0;0;0;0;0;0
FR;9;2022-07-20;0;0;0;0;0;0;0;0;0;0;0;0;0;0;0;0;0;0
FR;9;2022-07-21;0;0;0;0;0;0;0;0;0;0;0;0;0;0;0;0;0;0
FR;9;2022-07-22;0;0;0;0;0;0;0;0;0;0;0;0;0;0;0;0;0;0
FR;9;2022-07-23;0;0;0;0;0;0;0;0;0;0;0;0;0;0;0;0;0;0
FR;9;2022-07-24;0;0;0;0;0;0;0;0;0;0;0;0;0;0;0;0;0;0
FR;9;2022-07-25;0;0;0;0;0;0;0;0;0;0;0;0;0;0;0;0;0;0
FR;9;2022-07-26;0;0;0;0;0;0;0;0;0;0;0;0;0;0;0;0;0;0
FR;9;2022-07-27;0;0;0;0;0;0;0;0;0;0;0;0;0;0;0;0;0;0
FR;9;2022-07-28;0;0;0;0;0;0;0;0;0;0;0;0;0;0;0;0;0;0
FR;9;2022-07-29;0;0;0;0;0;0;0;0;0;0;0;0;0;0;0;0;0;0
FR;9;2022-07-30;0;0;0;0;0;0;0;0;0;0;0;0;0;0;0;0;0;0
FR;9;2022-07-31;0;0;0;0;0;0;0;0;0;0;0;0;0;0;0;0;0;0
FR;9;2022-08-01;0;0;0;0;0;0;0;0;0;0;0;0;0;0;0;0;0;0
FR;9;2022-08-02;0;0;0;0;0;0;0;0;0;0;0;0;0;0;0;0;0;0
FR;9;2022-08-03;0;0;0;0;0;0;0;0;0;0;0;0;0;0;0;0;0;0
FR;9;2022-08-04;0;0;0;0;0;0;0;0;0;0;0;0;0;0;0;0;0;0
FR;9;2022-08-05;0;0;0;0;0;0;0;0;0;0;0;0;0;0;0;0;0;0
FR;9;2022-08-06;0;0;0;0;0;0;0;0;0;0;0;0;0;0;0;0;0;0
FR;9;2022-08-07;0;0;0;0;0;0;0;0;0;0;0;0;0;0;0;0;0;0
FR;9;2022-08-08;0;0;0;0;0;0;0;0;0;0;0;0;0;0;0;0;0;0
FR;9;2022-08-09;0;0;0;0;0;0;0;0;0;0;0;0;0;0;0;0;0;0
FR;9;2022-08-10;0;0;0;0;0;0;0;0;0;0;0;0;0;0;0;0;0;0
FR;9;2022-08-11;0;0;0;0;0;0;0;0;0;0;0;0;0;0;0;0;0;0
FR;9;2022-08-12;0;0;0;0;0;0;0;0;0;0;0;0;0;0;0;0;0;0
FR;9;2022-08-13;0;0;0;0;0;0;0;0;0;0;0;0;0;0;0;0;0;0
FR;9;2022-08-14;0;0;0;0;0;0;0;0;0;0;0;0;0;0;0;0;0;0
FR;9;2022-08-15;0;0;0;0;0;0;0;0;0;0;0;0;0;0;0;0;0;0
FR;9;2022-08-16;0;0;0;0;0;0;0;0;0;0;0;0;0;0;0;0;0;0
FR;9;2022-08-17;0;0;0;0;0;0;0;0;0;0;0;0;0;0;0;0;0;0
FR;9;2022-08-18;0;0;0;0;0;0;0;0;0;0;0;0;0;0;0;0;0;0
FR;9;2022-08-19;0;0;0;0;0;0;0;0;0;0;0;0;0;0;0;0;0;0
FR;9;2022-08-20;0;0;0;0;0;0;0;0;0;0;0;0;0;0;0;0;0;0
FR;9;2022-08-21;0;0;0;0;0;0;0;0;0;0;0;0;0;0;0;0;0;0
FR;9;2022-08-22;0;0;0;0;0;0;0;0;0;0;0;0;0;0;0;0;0;0
FR;9;2022-08-23;0;0;0;0;0;0;0;0;0;0;0;0;0;0;0;0;0;0
FR;9;2022-08-24;0;0;0;0;0;0;0;0;0;0;0;0;0;0;0;0;0;0
FR;9;2022-08-25;0;0;0;0;0;0;0;0;0;0;0;0;0;0;0;0;0;0
FR;9;2022-08-26;0;0;0;0;0;0;0;0;0;0;0;0;0;0;0;0;0;0
FR;9;2022-08-27;0;0;0;0;0;0;0;0;0;0;0;0;0;0;0;0;0;0
FR;9;2022-08-28;0;0;0;0;0;0;0;0;0;0;0;0;0;0;0;0;0;0
FR;9;2022-08-29;0;0;0;0;0;0;0;0;0;0;0;0;0;0;0;0;0;0
FR;9;2022-08-30;0;0;0;0;0;0;0;0;0;0;0;0;0;0;0;0;0;0
FR;9;2022-08-31;0;0;0;0;0;0;0;0;0;0;0;0;0;0;0;0;0;0
FR;9;2022-09-01;0;0;0;0;0;0;0;0;0;0;0;0;0;0;0;0;0;0
FR;9;2022-09-02;0;0;0;0;0;0;0;0;0;0;0;0;0;0;0;0;0;0
FR;9;2022-09-03;0;0;0;0;0;0;0;0;0;0;0;0;0;0;0;0;0;0
FR;9;2022-09-04;0;0;0;0;0;0;0;0;0;0;0;0;0;0;0;0;0;0
FR;9;2022-09-05;0;0;0;0;0;0;0;0;0;0;0;0;0;0;0;0;0;0
FR;9;2022-09-06;0;0;0;0;0;0;0;0;0;0;0;0;0;0;0;0;0;0
FR;9;2022-09-07;0;0;0;0;0;0;0;0;0;0;0;0;0;0;0;0;0;0
FR;9;2022-09-08;0;0;0;0;0;0;0;0;0;0;0;0;0;0;0;0;0;0
FR;9;2022-09-09;0;0;0;0;0;0;0;0;0;0;0;0;0;0;0;0;0;0
FR;9;2022-09-10;0;0;0;0;0;0;0;0;0;0;0;0;0;0;0;0;0;0
FR;9;2022-09-11;0;0;0;0;0;0;0;0;0;0;0;0;0;0;0;0;0;0
FR;9;2022-09-12;0;0;0;0;0;0;0;0;0;0;0;0;0;0;0;0;0;0
FR;9;2022-09-13;0;0;0;0;0;0;0;0;0;0;0;0;0;0;0;0;0;0
FR;9;2022-09-14;0;0;0;0;0;0;0;0;0;0;0;0;0;0;0;0;0;0
FR;9;2022-09-15;0;0;0;0;0;0;0;0;0;0;0;0;0;0;0;0;0;0
FR;9;2022-09-16;0;0;0;0;0;0;0;0;0;0;0;0;0;0;0;0;0;0
FR;9;2022-09-17;0;0;0;0;0;0;0;0;0;0;0;0;0;0;0;0;0;0
FR;9;2022-09-18;0;0;0;0;0;0;0;0;0;0;0;0;0;0;0;0;0;0
FR;9;2022-09-19;0;0;0;0;0;0;0;0;0;0;0;0;0;0;0;0;0;0
FR;9;2022-09-20;0;0;0;0;0;0;0;0;0;0;0;0;0;0;0;0;0;0
FR;9;2022-09-21;0;0;0;0;0;0;0;0;0;0;0;0;0;0;0;0;0;0
FR;9;2022-09-22;0;0;0;0;0;0;0;0;0;0;0;0;0;0;0;0;0;0
FR;9;2022-09-23;0;0;0;0;0;0;0;0;0;0;0;0;0;0;0;0;0;0
FR;9;2022-09-24;0;0;0;0;0;0;0;0;0;0;0;0;0;0;0;0;0;0
FR;9;2022-09-25;0;0;0;0;0;0;0;0;0;0;0;0;0;0;0;0;0;0
FR;9;2022-09-26;0;0;0;0;0;0;0;0;0;0;0;0;0;0;0;0;0;0
FR;9;2022-09-27;0;0;0;0;0;0;0;0;0;0;0;0;0;0;0;0;0;0
FR;9;2022-09-28;0;0;0;0;0;0;0;0;0;0;0;0;0;0;0;0;0;0
FR;9;2022-09-29;1;1;8;33;0;6;35;43;2;1;1;8;33;0;6;35;43;2
FR;9;2022-09-30;5;13;60;606;7;47;613;713;51;6;14;68;639;7;53;648;756;53
FR;9;2022-10-01;10;1;43;327;2;26;335;396;35;16;15;111;966;9;79;983;1152;88
FR;9;2022-10-02;2;1;5;50;0;4;51;66;11;18;16;116;1016;9;83;1034;1218;99
FR;9;2022-10-03;13;17;151;1714;11;129;1708;2074;234;31;33;267;2730;20;212;2742;3292;333
FR;9;2022-10-04;22;48;353;3954;18;228;4022;4704;450;53;81;620;6684;38;440;6764;7996;783
FR;9;2022-10-05;29;20;269;2998;17;203;3011;3656;433;82;101;889;9682;55;643;9775;11652;1216
FR;9;2022-10-06;23;35;400;4598;18;301;4631;5609;672;105;136;1289;14280;73;944;14406;17261;1888
FR;9;2022-10-07;29;50;499;5705;19;384;5719;7028;923;134;186;1788;19985;92;1328;20125;24289;2811
FR;9;2022-10-08;10;18;128;1090;8;86;1108;1389;191;144;204;1916;21075;100;1414;21233;25678;3002
FR;9;2022-10-09;1;7;22;197;1;29;198;277;50;145;211;1938;21272;101;1443;21431;25955;3052
FR;9;2022-10-10;11;26;207;2572;14;181;2576;3296;533;156;237;2145;23844;115;1624;24007;29251;3585
FR;9;2022-10-11;31;40;424;5043;27;312;5024;6197;851;187;277;2569;28887;142;1936;29031;35448;4436
FR;9;2022-10-12;22;26;297;2987;16;212;3044;3830;572;209;303;2866;31874;158;2148;32075;39278;5008
FR;9;2022-10-13;25;42;374;3980;16;245;4036;5027;740;234;345;3240;35854;174;2393;36111;44305;5748
FR;9;2022-10-14;27;26;381;4430;12;293;4414;5556;838;261;371;3621;40284;186;2686;40525;49861;6586
FR;9;2022-10-15;14;8;101;1052;7;79;1029;1308;198;275;379;3722;41336;193;2765;41554;51169;6784
FR;9;2022-10-16;4;1;9;132;2;12;126;168;28;279;380;3731;41468;195;2777;41680;51337;6812
FR;9;2022-10-17;4;22;165;1875;11;127;1883;2492;475;283;402;3896;43343;206;2904;43563;53829;7287
FR;9;2022-10-18;36;28;316;3430;17;235;3454;4661;963;319;430;4212;46773;223;3139;47017;58490;8250
FR;9;2022-10-19;22;19;262;2688;17;174;2717;3732;826;341;449;4474;49461;240;3313;49734;62222;9076
FR;9;2022-10-20;22;22;308;3628;8;233;3639;4813;933;363;471;4782;53089;248;3546;53373;67035;10009
FR;9;2022-10-21;14;31;325;3532;10;228;3554;4655;865;377;502;5107;56621;258;3774;56927;71690;10874
FR;9;2022-10-22;10;11;90;914;8;62;919;1193;207;387;513;5197;57535;266;3836;57846;72883;11081
FR;9;2022-10-23;2;2;17;100;2;10;105;148;33;389;515;5214;57635;268;3846;57951;73031;11114
FR;9;2022-10-24;7;17;159;1363;6;106;1434;1942;397;396;532;5373;58998;274;3952;59385;74973;11511
FR;9;2022-10-25;18;22;228;2841;16;188;2851;3938;896;414;554;5601;61839;290;4140;62236;78911;12407
FR;9;2022-10-26;14;16;169;1800;13;123;1812;2527;590;428;570;5770;63639;303;4263;64048;81438;12997
FR;9;2022-10-27;9;26;230;2303;15;173;2337;3210;689;437;596;6000;65942;318;4436;66385;84648;13686
FR;9;2022-10-28;18;27;224;2277;17;151;2303;3142;681;455;623;6224;68219;335;4587;68688;87790;14367
FR;9;2022-10-29;12;8;55;505;5;46;496;662;119;467;631;6279;68724;340;4633;69184;88452;14486
FR;9;2022-10-30;2;1;8;58;1;8;58;82;16;469;632;6287;68782;341;4641;69242;88534;14502
FR;9;2022-10-31;13;7;105;660;9;59;695;996;240;482;639;6392;69442;350;4700;69937;89530;14742
FR;9;2022-11-01;1;1;15;43;0;11;49;71;11;483;640;6407;69485;350;4711;69986;89601;14753
FR;9;2022-11-02;7;12;102;1027;4;76;1045;1577;452;490;652;6509;70512;354;4787;71031;91178;15205
FR;9;2022-11-03;17;18;157;1599;16;92;1647;2348;599;507;670;6666;72111;370;4879;72678;93526;15804
FR;9;2022-11-04;21;19;193;1749;15;120;1798;2534;611;528;689;6859;73860;385;4999;74476;96060;16415
FR;9;2022-11-05;8;10;58;403;9;39;424;573;107;536;699;6917;74263;394;5038;74900;96633;16522
FR;9;2022-11-06;5;4;5;62;6;2;61;88;25;541;703;6922;74325;400;5040;74961;96721;16547
FR;9;2022-11-07;16;19;89;933;16;110;941;1489;432;557;722;7011;75258;416;5150;75902;98210;16979
FR;9;2022-11-08;10;19;170;1823;13;137;1815;2660;703;567;741;7181;77081;429;5287;77717;100870;17682
FR;9;2022-11-09;16;16;123;1261;9;98;1322;1878;453;583;757;7304;78342;438;5385;79039;102748;18135
FR;9;2022-11-10;13;22;162;1622;14;137;1620;2280;519;596;779;7466;79964;452;5522;80659;105028;18654
FR;9;2022-11-11;1;1;13;81;1;6;83;124;35;597;780;7479;80045;453;5528;80742;105152;18689
FR;9;2022-11-12;5;8;44;259;7;19;278;395;97;602;788;7523;80304;460;5547;81020;105547;18786
FR;9;2022-11-13;2;0;4;30;0;4;31;51;16;604;788;7527;80334;460;5551;81051;105598;18802
FR;9;2022-11-14;11;12;56;707;11;44;722;1108;339;615;800;7583;81041;471;5595;81773;106706;19141
FR;9;2022-11-15;18;16;148;1325;7;103;1333;2080;638;633;816;7731;82366;478;5698;83106;108786;19779
FR;9;2022-11-16;10;5;99;979;8;58;997;1490;431;643;821;7830;83345;486;5756;84103;110276;20210
FR;9;2022-11-17;9;17;126;1086;11;78;1111;1695;501;652;838;7956;84431;497;5834;85214;111971;20711
FR;9;2022-11-18;7;16;120;1440;5;78;1455;2027;492;659;854;8076;85871;502;5912;86669;113998;21203
FR;9;2022-11-19;3;5;50;364;1;27;351;489;106;662;859;8126;86235;503;5939;87020;114487;21309
FR;9;2022-11-20;1;0;5;37;0;3;35;54;16;663;859;8131;86272;503;5942;87055;114541;21325
FR;9;2022-11-21;9;12;66;636;5;51;639;960;263;672;871;8197;86908;508;5993;87694;115501;21588
FR;9;2022-11-22;15;12;121;1037;13;74;1067;1592;449;687;883;8318;87945;521;6067;88761;117093;22037
FR;9;2022-11-23;7;10;69;733;5;33;760;1170;372;694;893;8387;88678;526;6100;89521;118263;22409
FR;9;2022-11-24;8;19;93;979;14;68;992;1472;406;702;912;8480;89657;540;6168;90513;119735;22815
FR;9;2022-11-25;8;10;107;1180;8;82;1195;1781;503;710;922;8587;90837;548;6250;91708;121516;23318
FR;9;2022-11-26;6;6;35;217;7;24;214;310;68;716;928;8622;91054;555;6274;91922;121826;23386
FR;9;2022-11-27;1;1;6;42;0;2;46;82;34;717;929;8628;91096;555;6276;91968;121908;23420
FR;9;2022-11-28;5;7;103;698;7;60;726;1135;344;722;936;8731;91794;562;6336;92694;123043;23764
FR;9;2022-11-29;6;18;140;1299;6;89;1325;1940;521;728;954;8871;93093;568;6425;94019;124983;24285
FR;9;2022-11-30;9;12;99;1026;5;76;1049;1600;470;737;966;8970;94119;573;6501;95068;126583;24755
FR;9;2022-12-01;16;14;111;1330;8;80;1315;1939;540;753;980;9081;95449;581;6581;96383;128522;25295
FR;9;2022-12-02;10;13;193;1817;10;107;1818;2631;700;763;993;9274;97266;591;6688;98201;131153;25995
FR;9;2022-12-03;7;9;79;619;5;41;632;887;208;770;1002;9353;97885;596;6729;98833;132040;26203
FR;9;2022-12-04;11;4;15;105;5;8;105;153;40;781;1006;9368;97990;601;6737;98938;132193;26243
FR;9;2022-12-05;19;24;144;1406;17;98;1421;2110;584;800;1030;9512;99396;618;6835;100359;134303;26827
FR;9;2022-12-06;30;21;262;2441;21;147;2535;3798;1097;830;1051;9774;101837;639;6982;102894;138101;27924
FR;9;2022-12-07;15;22;181;1848;20;112;1890;2825;814;845;1073;9955;103685;659;7094;104784;140926;28738
FR;9;2022-12-08;14;22;222;2403;15;125;2466;3699;1091;859;1095;10177;106088;674;7219;107250;144625;29829
FR;9;2022-12-09;14;25;287;2888;10;143;2986;4337;1200;873;1120;10464;108976;684;7362;110236;148962;31029
FR;9;2022-12-10;12;13;122;1324;5;56;1347;1819;410;885;1133;10586;110300;689;7418;111583;150781;31439
FR;9;2022-12-11;5;5;21;277;6;10;283;363;66;890;1138;10607;110577;695;7428;111866;151144;31505
FR;9;2022-12-12;17;14;215;1958;12;109;2032;2891;745;907;1152;10822;112535;707;7537;113898;154035;32250
FR;9;2022-12-13;28;23;317;3085;15;151;3221;4720;1337;935;1175;11139;115620;722;7688;117119;158755;33587
FR;9;2022-12-14;15;10;191;2335;8;94;2405;3505;989;950;1185;11330;117955;730;7782;119524;162260;34576
FR;9;2022-12-15;17;24;257;2611;13;138;2682;4069;1238;967;1209;11587;120566;743;7920;122206;166329;35814
FR;9;2022-12-16;15;29;294;3072;21;165;3155;4603;1274;982;1238;11881;123638;764;8085;125361;170932;37088
FR;9;2022-12-17;8;11;106;1192;6;50;1207;1663;402;990;1249;11987;124830;770;8135;126568;172595;37490
FR;9;2022-12-18;1;7;30;245;6;14;251;333;67;991;1256;12017;125075;776;8149;126819;172928;37557
FR;9;2022-12-19;20;21;149;1599;15;78;1631;2507;789;1011;1277;12166;126674;791;8227;128450;175435;38346
FR;9;2022-12-20;21;19;232;2306;6;115;2349;3708;1233;1032;1296;12398;128980;797;8342;130799;179143;39579
FR;9;2022-12-21;6;14;139;1501;7;66;1554;2402;775;1038;1310;12537;130481;804;8408;132353;181545;40354
FR;9;2022-12-22;18;9;136;1401;9;78;1418;2119;615;1056;1319;12673;131882;813;8486;133771;183664;40969
FR;9;2022-12-23;11;15;76;728;9;50;730;1091;305;1067;1334;12749;132610;822;8536;134501;184755;41274
FR;9;2022-12-24;1;5;13;96;4;6;98;138;34;1068;1339;12762;132706;826;8542;134599;184893;41308
FR;9;2022-12-25;1;0;5;5;0;4;6;12;2;1069;1339;12767;132711;826;8546;134605;184905;41310
FR;9;2022-12-26;17;8;64;547;11;37;554;829;235;1086;1347;12831;133258;837;8583;135159;185734;41545
FR;9;2022-12-27;12;30;97;882;14;69;917;1422;430;1098;1377;12928;134140;851;8652;136076;187156;41975
FR;9;2022-12-28;8;9;82;749;8;40;768;1185;372;1106;1386;13010;134889;859;8692;136844;188341;42347
FR;9;2022-12-29;9;14;92;720;10;51;753;1134;323;1115;1400;13102;135609;869;8743;137597;189475;42670
FR;9;2022-12-30;12;17;77;592;9;47;612;899;237;1127;1417;13179;136201;878;8790;138209;190374;42907
FR;9;2022-12-31;2;3;17;136;2;12;139;190;38;1129;1420;13196;136337;880;8802;138348;190564;42945
FR;9;2023-01-01;0;2;3;19;1;4;19;31;8;1129;1422;13199;136356;881;8806;138367;190595;42953
FR;9;2023-01-02;10;11;56;592;4;40;585;949;320;1139;1433;13255;136948;885;8846;138952;191544;43273
FR;9;2023-01-03;19;19;119;1079;19;74;1099;1937;749;1158;1452;13374;138027;904;8920;140051;193481;44022
FR;9;2023-01-04;21;18;113;846;8;73;898;1609;633;1179;1470;13487;138873;912;8993;140949;195090;44655
FR;9;2023-01-05;5;20;115;1059;11;65;1091;2048;882;1184;1490;13602;139932;923;9058;142040;197138;45537
FR;9;2023-01-06;11;17;152;1370;3;73;1388;2410;938;1195;1507;13754;141302;926;9131;143428;199548;46475
FR;9;2023-01-07;6;13;58;436;14;36;427;687;220;1201;1520;13812;141738;940;9167;143855;200235;46695
FR;9;2023-01-08;4;11;15;92;9;12;91;137;32;1205;1531;13827;141830;949;9179;143946;200372;46727
FR;9;2023-01-09;16;15;87;623;9;62;615;1275;585;1221;1546;13914;142453;958;9241;144561;201647;47312
FR;9;2023-01-10;13;12;154;979;11;74;1033;1990;871;1234;1558;14068;143432;969;9315;145594;203637;48183
FR;9;2023-01-11;19;9;74;679;10;49;688;1385;642;1253;1567;14142;144111;979;9364;146282;205022;48825
FR;9;2023-01-12;20;9;92;845;3;77;823;1688;775;1273;1576;14234;144956;982;9441;147105;206710;49600
FR;9;2023-01-13;15;19;105;881;12;73;901;1742;753;1288;1595;14339;145837;994;9514;148006;208452;50353
FR;9;2023-01-14;8;9;54;294;5;32;299;584;247;1296;1604;14393;146131;999;9546;148305;209036;50600
FR;9;2023-01-15;1;3;15;37;0;9;41;82;32;1297;1607;14408;146168;999;9555;148346;209118;50632
FR;9;2023-01-16;6;15;54;366;13;24;383;785;371;1303;1622;14462;146534;1012;9579;148729;209903;51003
FR;9;2023-01-17;7;9;83;563;4;49;577;1244;609;1310;1631;14545;147097;1016;9628;149306;211147;51612
FR;9;2023-01-18;8;14;37;380;6;32;397;834;398;1318;1645;14582;147477;1022;9660;149703;211981;52010
FR;9;2023-01-19;10;9;58;475;8;30;476;1078;562;1328;1654;14640;147952;1030;9690;150179;213059;52572
FR;9;2023-01-20;15;19;96;578;16;57;595;1190;534;1343;1673;14736;148530;1046;9747;150774;214249;53106
FR;9;2023-01-21;8;15;20;192;11;13;190;347;140;1351;1688;14756;148722;1057;9760;150964;214596;53246
FR;9;2023-01-22;0;0;8;20;0;5;21;42;16;1351;1688;14764;148742;1057;9765;150985;214638;53262
FR;9;2023-01-23;4;14;27;253;8;25;242;563;287;1355;1702;14791;148995;1065;9790;151227;215201;53549
FR;9;2023-01-24;11;10;70;461;9;42;484;1162;633;1366;1712;14861;149456;1074;9832;151711;216363;54182
FR;9;2023-01-25;11;20;50;325;8;48;336;799;410;1377;1732;14911;149781;1082;9880;152047;217162;54592
FR;9;2023-01-26;7;17;64;391;8;50;390;967;515;1384;1749;14975;150172;1090;9930;152437;218129;55107
FR;9;2023-01-27;4;7;59;381;3;31;397;906;462;1388;1756;15034;150553;1093;9961;152834;219035;55569
FR;9;2023-01-28;3;6;31;128;5;27;120;265;116;1391;1762;15065;150681;1098;9988;152954;219300;55685
FR;9;2023-01-29;3;0;3;18;2;1;17;40;22;1394;1762;15068;150699;1100;9989;152971;219340;55707
FR;9;2023-01-30;3;6;31;192;5;11;211;501;272;1397;1768;15099;150891;1105;10000;153182;219841;55979
FR;9;2023-01-31;14;7;38;260;9;18;264;649;359;1411;1775;15137;151151;1114;10018;153446;220490;56338
FR;9;2023-02-01;4;7;26;173;4;20;179;519;309;1415;1782;15163;151324;1118;10038;153625;221009;56647
FR;9;2023-02-02;4;6;31;252;6;23;233;665;394;1419;1788;15194;151576;1124;10061;153858;221674;57041
FR;9;2023-02-03;8;11;42;289;8;37;275;677;355;1427;1799;15236;151865;1132;10098;154133;222351;57396
FR;9;2023-02-04;6;5;10;70;7;8;68;160;84;1433;1804;15246;151935;1139;10106;154201;222511;57480
FR;9;2023-02-05;1;1;4;7;0;4;7;17;6;1434;1805;15250;151942;1139;10110;154208;222528;57486
FR;9;2023-02-06;3;5;17;81;4;15;78;229;134;1437;1810;15267;152023;1143;10125;154286;222757;57620
FR;9;2023-02-07;3;5;29;139;3;20;134;402;242;1440;1815;15296;152162;1146;10145;154420;223159;57862
FR;9;2023-02-08;4;6;25;116;3;13;125;301;160;1444;1821;15321;152278;1149;10158;154545;223460;58022
FR;9;2023-02-09;8;2;20;138;3;14;123;336;195;1452;1823;15341;152416;1152;10172;154668;223796;58217
FR;9;2023-02-10;8;8;19;149;10;11;145;309;147;1460;1831;15360;152565;1162;10183;154813;224105;58364
FR;9;2023-02-11;5;4;14;42;3;9;47;84;28;1465;1835;15374;152607;1165;10192;154860;224189;58392
FR;9;2023-02-12;0;0;0;1;0;0;1;8;7;1465;1835;15374;152608;1165;10192;154861;224197;58399
FR;9;2023-02-13;3;8;5;50;8;4;45;107;55;1468;1843;15379;152658;1173;10196;154906;224304;58454
FR;9;2023-02-14;10;10;16;66;12;13;63;225;146;1478;1853;15395;152724;1185;10209;154969;224529;58600
FR;9;2023-02-15;1;5;16;52;3;12;50;162;99;1479;1858;15411;152776;1188;10221;155019;224691;58699
FR;9;2023-02-16;4;6;19;77;1;17;78;197;93;1483;1864;15430;152853;1189;10238;155097;224888;58792
FR;9;2023-02-17;6;4;15;62;5;11;64;178;99;1489;1868;15445;152915;1194;10249;155161;225066;58891
FR;9;2023-02-18;1;5;1;30;5;3;25;58;29;1490;1873;15446;152945;1199;10252;155186;225124;58920
FR;9;2023-02-19;1;0;0;1;0;0;1;3;2;1491;1873;15446;152946;1199;10252;155187;225127;58922
FR;9;2023-02-20;2;3;9;60;2;6;60;123;55;1493;1876;15455;153006;1201;10258;155247;225250;58977
FR;9;2023-02-21;6;9;9;62;7;8;59;151;82;1499;1885;15464;153068;1208;10266;155306;225401;59059
FR;9;2023-02-22;2;4;17;69;3;13;68;201;113;1501;1889;15481;153137;1211;10279;155374;225602;59172
FR;9;2023-02-23;5;3;17;63;1;12;69;146;61;1506;1892;15498;153200;1212;10291;155443;225748;59233
FR;9;2023-02-24;6;4;13;80;5;8;83;211;114;1512;1896;15511;153280;1217;10299;155526;225959;59347
FR;9;2023-02-25;2;2;10;14;4;4;23;43;16;1514;1898;15521;153294;1221;10303;155549;226002;59363
FR;9;2023-02-26;3;1;0;4;3;1;4;5;0;1517;1899;15521;153298;1224;10304;155553;226007;59363
FR;9;2023-02-27;2;3;5;17;3;2;19;49;26;1519;1902;15526;153315;1227;10306;155572;226056;59389
FR;9;2023-02-28;6;13;18;55;11;16;58;155;76;1525;1915;15544;153370;1238;10322;155630;226211;59465
FR;9;2023-03-01;0;6;4;20;5;4;20;75;48;1525;1921;15548;153390;1243;10326;155650;226286;59513
FR;9;2023-03-02;0;1;7;31;1;2;36;80;41;1525;1922;15555;153421;1244;10328;155686;226366;59554
FR;9;2023-03-03;1;4;9;47;3;6;49;122;67;1526;1926;15564;153468;1247;10334;155735;226488;59621
FR;9;2023-03-04;1;2;7;19;1;4;25;41;10;1527;1928;15571;153487;1248;10338;155760;226529;59631
FR;9;2023-03-05;0;1;1;0;1;0;1;8;7;1527;1929;15572;153487;1249;10338;155761;226537;59638
FR;9;2023-03-06;1;6;6;8;3;6;9;35;19;1528;1935;15578;153495;1252;10344;155770;226572;59657
FR;9;2023-03-07;2;3;8;20;0;8;24;68;34;1530;1938;15586;153515;1252;10352;155794;226640;59691
FR;9;2023-03-08;2;4;10;6;4;4;13;39;20;1532;1942;15596;153521;1256;10356;155807;226679;59711
FR;9;2023-03-09;1;3;9;11;2;6;17;64;41;1533;1945;15605;153532;1258;10362;155824;226743;59752
FR;9;2023-03-10;3;3;6;20;2;4;19;58;34;1536;1948;15611;153552;1260;10366;155843;226801;59786
FR;9;2023-03-11;2;3;4;8;2;1;11;15;3;1538;1951;15615;153560;1262;10367;155854;226816;59789
FR;9;2023-03-12;0;0;0;0;0;0;0;0;0;1538;1951;15615;153560;1262;10367;155854;226816;59789
FR;9;2023-03-13;2;3;4;13;2;4;14;49;29;1540;1954;15619;153573;1264;10371;155868;226865;59818
FR;9;2023-03-14;2;3;7;27;1;6;29;79;41;1542;1957;15626;153600;1265;10377;155897;226944;59859
FR;9;2023-03-15;0;5;4;15;3;4;17;47;24;1542;1962;15630;153615;1268;10381;155914;226991;59883
FR;9;2023-03-16;0;9;7;15;5;8;15;76;51;1542;1971;15637;153630;1273;10389;155929;227067;59934
FR;9;2023-03-17;0;7;4;19;3;7;17;62;31;1542;1978;15641;153649;1276;10396;155946;227129;59965
FR;9;2023-03-18;2;2;5;13;1;4;16;48;26;1544;1980;15646;153662;1277;10400;155962;227177;59991
FR;9;2023-03-19;0;1;0;0;1;0;0;0;0;1544;1981;15646;153662;1278;10400;155962;227177;59991
FR;9;2023-03-20;3;5;1;6;4;1;7;18;10;1547;1986;15647;153668;1282;10401;155969;227195;60001
FR;9;2023-03-21;1;1;6;16;1;1;21;69;47;1548;1987;15653;153684;1283;10402;155990;227264;60048
FR;9;2023-03-22;1;2;4;19;2;2;22;78;49;1549;1989;15657;153703;1285;10404;156012;227342;60097
FR;9;2023-03-23;0;5;7;22;3;7;21;56;25;1549;1994;15664;153725;1288;10411;156033;227398;60122
FR;9;2023-03-24;2;1;5;21;1;5;23;49;18;1551;1995;15669;153746;1289;10416;156056;227447;60140
FR;9;2023-03-25;0;0;4;6;0;3;8;16;5;1551;1995;15673;153752;1289;10419;156064;227463;60145
FR;9;2023-03-26;0;1;0;0;0;1;0;2;1;1551;1996;15673;153752;1289;10420;156064;227465;60146
FR;10;2020-12-27;0;0;0;0;0;0;0;0;0;0;0;0;0;0;0;0;0;0
FR;10;2020-12-28;0;0;0;0;0;0;0;0;0;0;0;0;0;0;0;0;0;0
FR;10;2020-12-29;0;0;0;0;0;0;0;0;0;0;0;0;0;0;0;0;0;0
FR;10;2020-12-30;0;0;0;0;0;0;0;0;0;0;0;0;0;0;0;0;0;0
FR;10;2020-12-31;0;0;0;0;0;0;0;0;0;0;0;0;0;0;0;0;0;0
FR;10;2021-01-01;0;0;0;0;0;0;0;0;0;0;0;0;0;0;0;0;0;0
FR;10;2021-01-02;0;0;0;0;0;0;0;0;0;0;0;0;0;0;0;0;0;0
FR;10;2021-01-03;0;0;0;0;0;0;0;0;0;0;0;0;0;0;0;0;0;0
FR;10;2021-01-04;0;0;0;0;0;0;0;0;0;0;0;0;0;0;0;0;0;0
FR;10;2021-01-05;0;0;0;0;0;0;0;0;0;0;0;0;0;0;0;0;0;0
FR;10;2021-01-06;0;0;0;0;0;0;0;0;0;0;0;0;0;0;0;0;0;0
FR;10;2021-01-07;0;0;0;0;0;0;0;0;0;0;0;0;0;0;0;0;0;0
FR;10;2021-01-08;0;0;0;0;0;0;0;0;0;0;0;0;0;0;0;0;0;0
FR;10;2021-01-09;0;0;0;0;0;0;0;0;0;0;0;0;0;0;0;0;0;0
FR;10;2021-01-10;0;0;0;0;0;0;0;0;0;0;0;0;0;0;0;0;0;0
FR;10;2021-01-11;0;0;0;0;0;0;0;0;0;0;0;0;0;0;0;0;0;0
FR;10;2021-01-12;0;0;0;0;0;0;0;0;0;0;0;0;0;0;0;0;0;0
FR;10;2021-01-13;0;0;0;0;0;0;0;0;0;0;0;0;0;0;0;0;0;0
FR;10;2021-01-14;0;0;0;0;0;0;0;0;0;0;0;0;0;0;0;0;0;0
FR;10;2021-01-15;0;0;0;0;0;0;0;0;0;0;0;0;0;0;0;0;0;0
FR;10;2021-01-16;0;0;0;0;0;0;0;0;0;0;0;0;0;0;0;0;0;0
FR;10;2021-01-17;0;0;0;0;0;0;0;0;0;0;0;0;0;0;0;0;0;0
FR;10;2021-01-18;0;0;0;0;0;0;0;0;0;0;0;0;0;0;0;0;0;0
FR;10;2021-01-19;0;0;0;0;0;0;0;0;0;0;0;0;0;0;0;0;0;0
FR;10;2021-01-20;0;0;0;0;0;0;0;0;0;0;0;0;0;0;0;0;0;0
FR;10;2021-01-21;0;0;0;0;0;0;0;0;0;0;0;0;0;0;0;0;0;0
FR;10;2021-01-22;0;0;0;0;0;0;0;0;0;0;0;0;0;0;0;0;0;0
FR;10;2021-01-23;0;0;0;0;0;0;0;0;0;0;0;0;0;0;0;0;0;0
FR;10;2021-01-24;0;0;0;0;0;0;0;0;0;0;0;0;0;0;0;0;0;0
FR;10;2021-01-25;0;0;0;0;0;0;0;0;0;0;0;0;0;0;0;0;0;0
FR;10;2021-01-26;0;0;0;0;0;0;0;0;0;0;0;0;0;0;0;0;0;0
FR;10;2021-01-27;0;0;0;0;0;0;0;0;0;0;0;0;0;0;0;0;0;0
FR;10;2021-01-28;0;0;0;0;0;0;0;0;0;0;0;0;0;0;0;0;0;0
FR;10;2021-01-29;0;0;0;0;0;0;0;0;0;0;0;0;0;0;0;0;0;0
FR;10;2021-01-30;0;0;0;0;0;0;0;0;0;0;0;0;0;0;0;0;0;0
FR;10;2021-01-31;0;0;0;0;0;0;0;0;0;0;0;0;0;0;0;0;0;0
FR;10;2021-02-01;0;0;0;0;0;0;0;0;0;0;0;0;0;0;0;0;0;0
FR;10;2021-02-02;0;0;0;0;0;0;0;0;0;0;0;0;0;0;0;0;0;0
FR;10;2021-02-03;0;0;0;0;0;0;0;0;0;0;0;0;0;0;0;0;0;0
FR;10;2021-02-04;0;0;0;0;0;0;0;0;0;0;0;0;0;0;0;0;0;0
FR;10;2021-02-05;0;0;0;0;0;0;0;0;0;0;0;0;0;0;0;0;0;0
FR;10;2021-02-06;0;0;0;0;0;0;0;0;0;0;0;0;0;0;0;0;0;0
FR;10;2021-02-07;0;0;0;0;0;0;0;0;0;0;0;0;0;0;0;0;0;0
FR;10;2021-02-08;0;0;0;0;0;0;0;0;0;0;0;0;0;0;0;0;0;0
FR;10;2021-02-09;0;0;0;0;0;0;0;0;0;0;0;0;0;0;0;0;0;0
FR;10;2021-02-10;0;0;0;0;0;0;0;0;0;0;0;0;0;0;0;0;0;0
FR;10;2021-02-11;0;0;0;0;0;0;0;0;0;0;0;0;0;0;0;0;0;0
FR;10;2021-02-12;0;0;0;0;0;0;0;0;0;0;0;0;0;0;0;0;0;0
FR;10;2021-02-13;0;0;0;0;0;0;0;0;0;0;0;0;0;0;0;0;0;0
FR;10;2021-02-14;0;0;0;0;0;0;0;0;0;0;0;0;0;0;0;0;0;0
FR;10;2021-02-15;0;0;0;0;0;0;0;0;0;0;0;0;0;0;0;0;0;0
FR;10;2021-02-16;0;0;0;0;0;0;0;0;0;0;0;0;0;0;0;0;0;0
FR;10;2021-02-17;0;0;0;0;0;0;0;0;0;0;0;0;0;0;0;0;0;0
FR;10;2021-02-18;0;0;0;0;0;0;0;0;0;0;0;0;0;0;0;0;0;0
FR;10;2021-02-19;0;0;0;0;0;0;0;0;0;0;0;0;0;0;0;0;0;0
FR;10;2021-02-20;0;0;0;0;0;0;0;0;0;0;0;0;0;0;0;0;0;0
FR;10;2021-02-21;0;0;0;0;0;0;0;0;0;0;0;0;0;0;0;0;0;0
FR;10;2021-02-22;0;0;0;0;0;0;0;0;0;0;0;0;0;0;0;0;0;0
FR;10;2021-02-23;0;0;0;0;0;0;0;0;0;0;0;0;0;0;0;0;0;0
FR;10;2021-02-24;0;0;0;0;0;0;0;0;0;0;0;0;0;0;0;0;0;0
FR;10;2021-02-25;0;0;0;0;0;0;0;0;0;0;0;0;0;0;0;0;0;0
FR;10;2021-02-26;0;0;0;0;0;0;0;0;0;0;0;0;0;0;0;0;0;0
FR;10;2021-02-27;0;0;0;0;0;0;0;0;0;0;0;0;0;0;0;0;0;0
FR;10;2021-02-28;0;0;0;0;0;0;0;0;0;0;0;0;0;0;0;0;0;0
FR;10;2021-03-01;0;0;0;0;0;0;0;0;0;0;0;0;0;0;0;0;0;0
FR;10;2021-03-02;0;0;0;0;0;0;0;0;0;0;0;0;0;0;0;0;0;0
FR;10;2021-03-03;0;0;0;0;0;0;0;0;0;0;0;0;0;0;0;0;0;0
FR;10;2021-03-04;0;0;0;0;0;0;0;0;0;0;0;0;0;0;0;0;0;0
FR;10;2021-03-05;0;0;0;0;0;0;0;0;0;0;0;0;0;0;0;0;0;0
FR;10;2021-03-06;0;0;0;0;0;0;0;0;0;0;0;0;0;0;0;0;0;0
FR;10;2021-03-07;0;0;0;0;0;0;0;0;0;0;0;0;0;0;0;0;0;0
FR;10;2021-03-08;0;0;0;0;0;0;0;0;0;0;0;0;0;0;0;0;0;0
FR;10;2021-03-09;0;0;0;0;0;0;0;0;0;0;0;0;0;0;0;0;0;0
FR;10;2021-03-10;0;0;0;0;0;0;0;0;0;0;0;0;0;0;0;0;0;0
FR;10;2021-03-11;0;0;0;0;0;0;0;0;0;0;0;0;0;0;0;0;0;0
FR;10;2021-03-12;0;0;0;0;0;0;0;0;0;0;0;0;0;0;0;0;0;0
FR;10;2021-03-13;0;0;0;0;0;0;0;0;0;0;0;0;0;0;0;0;0;0
FR;10;2021-03-14;0;0;0;0;0;0;0;0;0;0;0;0;0;0;0;0;0;0
FR;10;2021-03-15;0;0;0;0;0;0;0;0;0;0;0;0;0;0;0;0;0;0
FR;10;2021-03-16;0;0;0;0;0;0;0;0;0;0;0;0;0;0;0;0;0;0
FR;10;2021-03-17;0;0;0;0;0;0;0;0;0;0;0;0;0;0;0;0;0;0
FR;10;2021-03-18;0;0;0;0;0;0;0;0;0;0;0;0;0;0;0;0;0;0
FR;10;2021-03-19;0;0;0;0;0;0;0;0;0;0;0;0;0;0;0;0;0;0
FR;10;2021-03-20;0;0;0;0;0;0;0;0;0;0;0;0;0;0;0;0;0;0
FR;10;2021-03-21;0;0;0;0;0;0;0;0;0;0;0;0;0;0;0;0;0;0
FR;10;2021-03-22;0;0;0;0;0;0;0;0;0;0;0;0;0;0;0;0;0;0
FR;10;2021-03-23;0;0;0;0;0;0;0;0;0;0;0;0;0;0;0;0;0;0
FR;10;2021-03-24;0;0;0;0;0;0;0;0;0;0;0;0;0;0;0;0;0;0
FR;10;2021-03-25;0;0;0;0;0;0;0;0;0;0;0;0;0;0;0;0;0;0
FR;10;2021-03-26;0;0;0;0;0;0;0;0;0;0;0;0;0;0;0;0;0;0
FR;10;2021-03-27;0;0;0;0;0;0;0;0;0;0;0;0;0;0;0;0;0;0
FR;10;2021-03-28;0;0;0;0;0;0;0;0;0;0;0;0;0;0;0;0;0;0
FR;10;2021-03-29;0;0;0;0;0;0;0;0;0;0;0;0;0;0;0;0;0;0
FR;10;2021-03-30;0;0;0;0;0;0;0;0;0;0;0;0;0;0;0;0;0;0
FR;10;2021-03-31;0;0;0;0;0;0;0;0;0;0;0;0;0;0;0;0;0;0
FR;10;2021-04-01;0;0;0;0;0;0;0;0;0;0;0;0;0;0;0;0;0;0
FR;10;2021-04-02;0;0;0;0;0;0;0;0;0;0;0;0;0;0;0;0;0;0
FR;10;2021-04-03;0;0;0;0;0;0;0;0;0;0;0;0;0;0;0;0;0;0
FR;10;2021-04-04;0;0;0;0;0;0;0;0;0;0;0;0;0;0;0;0;0;0
FR;10;2021-04-05;0;0;0;0;0;0;0;0;0;0;0;0;0;0;0;0;0;0
FR;10;2021-04-06;0;0;0;0;0;0;0;0;0;0;0;0;0;0;0;0;0;0
FR;10;2021-04-07;0;0;0;0;0;0;0;0;0;0;0;0;0;0;0;0;0;0
FR;10;2021-04-08;0;0;0;0;0;0;0;0;0;0;0;0;0;0;0;0;0;0
FR;10;2021-04-09;0;0;0;0;0;0;0;0;0;0;0;0;0;0;0;0;0;0
FR;10;2021-04-10;0;0;0;0;0;0;0;0;0;0;0;0;0;0;0;0;0;0
FR;10;2021-04-11;0;0;0;0;0;0;0;0;0;0;0;0;0;0;0;0;0;0
FR;10;2021-04-12;0;0;0;0;0;0;0;0;0;0;0;0;0;0;0;0;0;0
FR;10;2021-04-13;0;0;0;0;0;0;0;0;0;0;0;0;0;0;0;0;0;0
FR;10;2021-04-14;0;0;0;0;0;0;0;0;0;0;0;0;0;0;0;0;0;0
FR;10;2021-04-15;0;0;0;0;0;0;0;0;0;0;0;0;0;0;0;0;0;0
FR;10;2021-04-16;0;0;0;0;0;0;0;0;0;0;0;0;0;0;0;0;0;0
FR;10;2021-04-17;0;0;0;0;0;0;0;0;0;0;0;0;0;0;0;0;0;0
FR;10;2021-04-18;0;0;0;0;0;0;0;0;0;0;0;0;0;0;0;0;0;0
FR;10;2021-04-19;0;0;0;0;0;0;0;0;0;0;0;0;0;0;0;0;0;0
FR;10;2021-04-20;0;0;0;0;0;0;0;0;0;0;0;0;0;0;0;0;0;0
FR;10;2021-04-21;0;0;0;0;0;0;0;0;0;0;0;0;0;0;0;0;0;0
FR;10;2021-04-22;0;0;0;0;0;0;0;0;0;0;0;0;0;0;0;0;0;0
FR;10;2021-04-23;0;0;0;0;0;0;0;0;0;0;0;0;0;0;0;0;0;0
FR;10;2021-04-24;0;0;0;0;0;0;0;0;0;0;0;0;0;0;0;0;0;0
FR;10;2021-04-25;0;0;0;0;0;0;0;0;0;0;0;0;0;0;0;0;0;0
FR;10;2021-04-26;0;0;0;0;0;0;0;0;0;0;0;0;0;0;0;0;0;0
FR;10;2021-04-27;0;0;0;0;0;0;0;0;0;0;0;0;0;0;0;0;0;0
FR;10;2021-04-28;0;0;0;0;0;0;0;0;0;0;0;0;0;0;0;0;0;0
FR;10;2021-04-29;0;0;0;0;0;0;0;0;0;0;0;0;0;0;0;0;0;0
FR;10;2021-04-30;0;0;0;0;0;0;0;0;0;0;0;0;0;0;0;0;0;0
FR;10;2021-05-01;0;0;0;0;0;0;0;0;0;0;0;0;0;0;0;0;0;0
FR;10;2021-05-02;0;0;0;0;0;0;0;0;0;0;0;0;0;0;0;0;0;0
FR;10;2021-05-03;0;0;0;0;0;0;0;0;0;0;0;0;0;0;0;0;0;0
FR;10;2021-05-04;0;0;0;0;0;0;0;0;0;0;0;0;0;0;0;0;0;0
FR;10;2021-05-05;0;0;0;0;0;0;0;0;0;0;0;0;0;0;0;0;0;0
FR;10;2021-05-06;0;0;0;0;0;0;0;0;0;0;0;0;0;0;0;0;0;0
FR;10;2021-05-07;0;0;0;0;0;0;0;0;0;0;0;0;0;0;0;0;0;0
FR;10;2021-05-08;0;0;0;0;0;0;0;0;0;0;0;0;0;0;0;0;0;0
FR;10;2021-05-09;0;0;0;0;0;0;0;0;0;0;0;0;0;0;0;0;0;0
FR;10;2021-05-10;0;0;0;0;0;0;0;0;0;0;0;0;0;0;0;0;0;0
FR;10;2021-05-11;0;0;0;0;0;0;0;0;0;0;0;0;0;0;0;0;0;0
FR;10;2021-05-12;0;0;0;0;0;0;0;0;0;0;0;0;0;0;0;0;0;0
FR;10;2021-05-13;0;0;0;0;0;0;0;0;0;0;0;0;0;0;0;0;0;0
FR;10;2021-05-14;0;0;0;0;0;0;0;0;0;0;0;0;0;0;0;0;0;0
FR;10;2021-05-15;0;0;0;0;0;0;0;0;0;0;0;0;0;0;0;0;0;0
FR;10;2021-05-16;0;0;0;0;0;0;0;0;0;0;0;0;0;0;0;0;0;0
FR;10;2021-05-17;0;0;0;0;0;0;0;0;0;0;0;0;0;0;0;0;0;0
FR;10;2021-05-18;0;0;0;0;0;0;0;0;0;0;0;0;0;0;0;0;0;0
FR;10;2021-05-19;0;0;0;0;0;0;0;0;0;0;0;0;0;0;0;0;0;0
FR;10;2021-05-20;0;0;0;0;0;0;0;0;0;0;0;0;0;0;0;0;0;0
FR;10;2021-05-21;0;0;0;0;0;0;0;0;0;0;0;0;0;0;0;0;0;0
FR;10;2021-05-22;0;0;0;0;0;0;0;0;0;0;0;0;0;0;0;0;0;0
FR;10;2021-05-23;0;0;0;0;0;0;0;0;0;0;0;0;0;0;0;0;0;0
FR;10;2021-05-24;0;0;0;0;0;0;0;0;0;0;0;0;0;0;0;0;0;0
FR;10;2021-05-25;0;0;0;0;0;0;0;0;0;0;0;0;0;0;0;0;0;0
FR;10;2021-05-26;0;0;0;0;0;0;0;0;0;0;0;0;0;0;0;0;0;0
FR;10;2021-05-27;0;0;0;0;0;0;0;0;0;0;0;0;0;0;0;0;0;0
FR;10;2021-05-28;0;0;0;0;0;0;0;0;0;0;0;0;0;0;0;0;0;0
FR;10;2021-05-29;0;0;0;0;0;0;0;0;0;0;0;0;0;0;0;0;0;0
FR;10;2021-05-30;0;0;0;0;0;0;0;0;0;0;0;0;0;0;0;0;0;0
FR;10;2021-05-31;0;0;0;0;0;0;0;0;0;0;0;0;0;0;0;0;0;0
FR;10;2021-06-01;0;0;0;0;0;0;0;0;0;0;0;0;0;0;0;0;0;0
FR;10;2021-06-02;0;0;0;0;0;0;0;0;0;0;0;0;0;0;0;0;0;0
FR;10;2021-06-03;0;0;0;0;0;0;0;0;0;0;0;0;0;0;0;0;0;0
FR;10;2021-06-04;0;0;0;0;0;0;0;0;0;0;0;0;0;0;0;0;0;0
FR;10;2021-06-05;0;0;0;0;0;0;0;0;0;0;0;0;0;0;0;0;0;0
FR;10;2021-06-06;0;0;0;0;0;0;0;0;0;0;0;0;0;0;0;0;0;0
FR;10;2021-06-07;0;0;0;0;0;0;0;0;0;0;0;0;0;0;0;0;0;0
FR;10;2021-06-08;0;0;0;0;0;0;0;0;0;0;0;0;0;0;0;0;0;0
FR;10;2021-06-09;0;0;0;0;0;0;0;0;0;0;0;0;0;0;0;0;0;0
FR;10;2021-06-10;0;0;0;0;0;0;0;0;0;0;0;0;0;0;0;0;0;0
FR;10;2021-06-11;0;0;0;0;0;0;0;0;0;0;0;0;0;0;0;0;0;0
FR;10;2021-06-12;0;0;0;0;0;0;0;0;0;0;0;0;0;0;0;0;0;0
FR;10;2021-06-13;0;0;0;0;0;0;0;0;0;0;0;0;0;0;0;0;0;0
FR;10;2021-06-14;0;0;0;0;0;0;0;0;0;0;0;0;0;0;0;0;0;0
FR;10;2021-06-15;0;0;0;0;0;0;0;0;0;0;0;0;0;0;0;0;0;0
FR;10;2021-06-16;0;0;0;0;0;0;0;0;0;0;0;0;0;0;0;0;0;0
FR;10;2021-06-17;0;0;0;0;0;0;0;0;0;0;0;0;0;0;0;0;0;0
FR;10;2021-06-18;0;0;0;0;0;0;0;0;0;0;0;0;0;0;0;0;0;0
FR;10;2021-06-19;0;0;0;0;0;0;0;0;0;0;0;0;0;0;0;0;0;0
FR;10;2021-06-20;0;0;0;0;0;0;0;0;0;0;0;0;0;0;0;0;0;0
FR;10;2021-06-21;0;0;0;0;0;0;0;0;0;0;0;0;0;0;0;0;0;0
FR;10;2021-06-22;0;0;0;0;0;0;0;0;0;0;0;0;0;0;0;0;0;0
FR;10;2021-06-23;0;0;0;0;0;0;0;0;0;0;0;0;0;0;0;0;0;0
FR;10;2021-06-24;0;0;0;0;0;0;0;0;0;0;0;0;0;0;0;0;0;0
FR;10;2021-06-25;0;0;0;0;0;0;0;0;0;0;0;0;0;0;0;0;0;0
FR;10;2021-06-26;0;0;0;0;0;0;0;0;0;0;0;0;0;0;0;0;0;0
FR;10;2021-06-27;0;0;0;0;0;0;0;0;0;0;0;0;0;0;0;0;0;0
FR;10;2021-06-28;0;0;0;0;0;0;0;0;0;0;0;0;0;0;0;0;0;0
FR;10;2021-06-29;0;0;0;0;0;0;0;0;0;0;0;0;0;0;0;0;0;0
FR;10;2021-06-30;0;0;0;0;0;0;0;0;0;0;0;0;0;0;0;0;0;0
FR;10;2021-07-01;0;0;0;0;0;0;0;0;0;0;0;0;0;0;0;0;0;0
FR;10;2021-07-02;0;0;0;0;0;0;0;0;0;0;0;0;0;0;0;0;0;0
FR;10;2021-07-03;0;0;0;0;0;0;0;0;0;0;0;0;0;0;0;0;0;0
FR;10;2021-07-04;0;0;0;0;0;0;0;0;0;0;0;0;0;0;0;0;0;0
FR;10;2021-07-05;0;0;0;0;0;0;0;0;0;0;0;0;0;0;0;0;0;0
FR;10;2021-07-06;0;0;0;0;0;0;0;0;0;0;0;0;0;0;0;0;0;0
FR;10;2021-07-07;0;0;0;0;0;0;0;0;0;0;0;0;0;0;0;0;0;0
FR;10;2021-07-08;0;0;0;0;0;0;0;0;0;0;0;0;0;0;0;0;0;0
FR;10;2021-07-09;0;0;0;0;0;0;0;0;0;0;0;0;0;0;0;0;0;0
FR;10;2021-07-10;0;0;0;0;0;0;0;0;0;0;0;0;0;0;0;0;0;0
FR;10;2021-07-11;0;0;0;0;0;0;0;0;0;0;0;0;0;0;0;0;0;0
FR;10;2021-07-12;0;0;0;0;0;0;0;0;0;0;0;0;0;0;0;0;0;0
FR;10;2021-07-13;0;0;0;0;0;0;0;0;0;0;0;0;0;0;0;0;0;0
FR;10;2021-07-14;0;0;0;0;0;0;0;0;0;0;0;0;0;0;0;0;0;0
FR;10;2021-07-15;0;0;0;0;0;0;0;0;0;0;0;0;0;0;0;0;0;0
FR;10;2021-07-16;0;0;0;0;0;0;0;0;0;0;0;0;0;0;0;0;0;0
FR;10;2021-07-17;0;0;0;0;0;0;0;0;0;0;0;0;0;0;0;0;0;0
FR;10;2021-07-18;0;0;0;0;0;0;0;0;0;0;0;0;0;0;0;0;0;0
FR;10;2021-07-19;0;0;0;0;0;0;0;0;0;0;0;0;0;0;0;0;0;0
FR;10;2021-07-20;0;0;0;0;0;0;0;0;0;0;0;0;0;0;0;0;0;0
FR;10;2021-07-21;0;0;0;0;0;0;0;0;0;0;0;0;0;0;0;0;0;0
FR;10;2021-07-22;0;0;0;0;0;0;0;0;0;0;0;0;0;0;0;0;0;0
FR;10;2021-07-23;0;0;0;0;0;0;0;0;0;0;0;0;0;0;0;0;0;0
FR;10;2021-07-24;0;0;0;0;0;0;0;0;0;0;0;0;0;0;0;0;0;0
FR;10;2021-07-25;0;0;0;0;0;0;0;0;0;0;0;0;0;0;0;0;0;0
FR;10;2021-07-26;0;0;0;0;0;0;0;0;0;0;0;0;0;0;0;0;0;0
FR;10;2021-07-27;0;0;0;0;0;0;0;0;0;0;0;0;0;0;0;0;0;0
FR;10;2021-07-28;0;0;0;0;0;0;0;0;0;0;0;0;0;0;0;0;0;0
FR;10;2021-07-29;0;0;0;0;0;0;0;0;0;0;0;0;0;0;0;0;0;0
FR;10;2021-07-30;0;0;0;0;0;0;0;0;0;0;0;0;0;0;0;0;0;0
FR;10;2021-07-31;0;0;0;0;0;0;0;0;0;0;0;0;0;0;0;0;0;0
FR;10;2021-08-01;0;0;0;0;0;0;0;0;0;0;0;0;0;0;0;0;0;0
FR;10;2021-08-02;0;0;0;0;0;0;0;0;0;0;0;0;0;0;0;0;0;0
FR;10;2021-08-03;0;0;0;0;0;0;0;0;0;0;0;0;0;0;0;0;0;0
FR;10;2021-08-04;0;0;0;0;0;0;0;0;0;0;0;0;0;0;0;0;0;0
FR;10;2021-08-05;0;0;0;0;0;0;0;0;0;0;0;0;0;0;0;0;0;0
FR;10;2021-08-06;0;0;0;0;0;0;0;0;0;0;0;0;0;0;0;0;0;0
FR;10;2021-08-07;0;0;0;0;0;0;0;0;0;0;0;0;0;0;0;0;0;0
FR;10;2021-08-08;0;0;0;0;0;0;0;0;0;0;0;0;0;0;0;0;0;0
FR;10;2021-08-09;0;0;0;0;0;0;0;0;0;0;0;0;0;0;0;0;0;0
FR;10;2021-08-10;0;0;0;0;0;0;0;0;0;0;0;0;0;0;0;0;0;0
FR;10;2021-08-11;0;0;0;0;0;0;0;0;0;0;0;0;0;0;0;0;0;0
FR;10;2021-08-12;0;0;0;0;0;0;0;0;0;0;0;0;0;0;0;0;0;0
FR;10;2021-08-13;0;0;0;0;0;0;0;0;0;0;0;0;0;0;0;0;0;0
FR;10;2021-08-14;0;0;0;0;0;0;0;0;0;0;0;0;0;0;0;0;0;0
FR;10;2021-08-15;0;0;0;0;0;0;0;0;0;0;0;0;0;0;0;0;0;0
FR;10;2021-08-16;0;0;0;0;0;0;0;0;0;0;0;0;0;0;0;0;0;0
FR;10;2021-08-17;0;0;0;0;0;0;0;0;0;0;0;0;0;0;0;0;0;0
FR;10;2021-08-18;0;0;0;0;0;0;0;0;0;0;0;0;0;0;0;0;0;0
FR;10;2021-08-19;0;0;0;0;0;0;0;0;0;0;0;0;0;0;0;0;0;0
FR;10;2021-08-20;0;0;0;0;0;0;0;0;0;0;0;0;0;0;0;0;0;0
FR;10;2021-08-21;0;0;0;0;0;0;0;0;0;0;0;0;0;0;0;0;0;0
FR;10;2021-08-22;0;0;0;0;0;0;0;0;0;0;0;0;0;0;0;0;0;0
FR;10;2021-08-23;0;0;0;0;0;0;0;0;0;0;0;0;0;0;0;0;0;0
FR;10;2021-08-24;0;0;0;0;0;0;0;0;0;0;0;0;0;0;0;0;0;0
FR;10;2021-08-25;0;0;0;0;0;0;0;0;0;0;0;0;0;0;0;0;0;0
FR;10;2021-08-26;0;0;0;0;0;0;0;0;0;0;0;0;0;0;0;0;0;0
FR;10;2021-08-27;0;0;0;0;0;0;0;0;0;0;0;0;0;0;0;0;0;0
FR;10;2021-08-28;0;0;0;0;0;0;0;0;0;0;0;0;0;0;0;0;0;0
FR;10;2021-08-29;0;0;0;0;0;0;0;0;0;0;0;0;0;0;0;0;0;0
FR;10;2021-08-30;0;0;0;0;0;0;0;0;0;0;0;0;0;0;0;0;0;0
FR;10;2021-08-31;0;0;0;0;0;0;0;0;0;0;0;0;0;0;0;0;0;0
FR;10;2021-09-01;0;0;0;0;0;0;0;0;0;0;0;0;0;0;0;0;0;0
FR;10;2021-09-02;0;0;0;0;0;0;0;0;0;0;0;0;0;0;0;0;0;0
FR;10;2021-09-03;0;0;0;0;0;0;0;0;0;0;0;0;0;0;0;0;0;0
FR;10;2021-09-04;0;0;0;0;0;0;0;0;0;0;0;0;0;0;0;0;0;0
FR;10;2021-09-05;0;0;0;0;0;0;0;0;0;0;0;0;0;0;0;0;0;0
FR;10;2021-09-06;0;0;0;0;0;0;0;0;0;0;0;0;0;0;0;0;0;0
FR;10;2021-09-07;0;0;0;0;0;0;0;0;0;0;0;0;0;0;0;0;0;0
FR;10;2021-09-08;0;0;0;0;0;0;0;0;0;0;0;0;0;0;0;0;0;0
FR;10;2021-09-09;0;0;0;0;0;0;0;0;0;0;0;0;0;0;0;0;0;0
FR;10;2021-09-10;0;0;0;0;0;0;0;0;0;0;0;0;0;0;0;0;0;0
FR;10;2021-09-11;0;0;0;0;0;0;0;0;0;0;0;0;0;0;0;0;0;0
FR;10;2021-09-12;0;0;0;0;0;0;0;0;0;0;0;0;0;0;0;0;0;0
FR;10;2021-09-13;0;0;0;0;0;0;0;0;0;0;0;0;0;0;0;0;0;0
FR;10;2021-09-14;0;0;0;0;0;0;0;0;0;0;0;0;0;0;0;0;0;0
FR;10;2021-09-15;0;0;0;0;0;0;0;0;0;0;0;0;0;0;0;0;0;0
FR;10;2021-09-16;0;0;0;0;0;0;0;0;0;0;0;0;0;0;0;0;0;0
FR;10;2021-09-17;0;0;0;0;0;0;0;0;0;0;0;0;0;0;0;0;0;0
FR;10;2021-09-18;0;0;0;0;0;0;0;0;0;0;0;0;0;0;0;0;0;0
FR;10;2021-09-19;0;0;0;0;0;0;0;0;0;0;0;0;0;0;0;0;0;0
FR;10;2021-09-20;0;0;0;0;0;0;0;0;0;0;0;0;0;0;0;0;0;0
FR;10;2021-09-21;0;0;0;0;0;0;0;0;0;0;0;0;0;0;0;0;0;0
FR;10;2021-09-22;0;0;0;0;0;0;0;0;0;0;0;0;0;0;0;0;0;0
FR;10;2021-09-23;0;0;0;0;0;0;0;0;0;0;0;0;0;0;0;0;0;0
FR;10;2021-09-24;0;0;0;0;0;0;0;0;0;0;0;0;0;0;0;0;0;0
FR;10;2021-09-25;0;0;0;0;0;0;0;0;0;0;0;0;0;0;0;0;0;0
FR;10;2021-09-26;0;0;0;0;0;0;0;0;0;0;0;0;0;0;0;0;0;0
FR;10;2021-09-27;0;0;0;0;0;0;0;0;0;0;0;0;0;0;0;0;0;0
FR;10;2021-09-28;0;0;0;0;0;0;0;0;0;0;0;0;0;0;0;0;0;0
FR;10;2021-09-29;0;0;0;0;0;0;0;0;0;0;0;0;0;0;0;0;0;0
FR;10;2021-09-30;0;0;0;0;0;0;0;0;0;0;0;0;0;0;0;0;0;0
FR;10;2021-10-01;0;0;0;0;0;0;0;0;0;0;0;0;0;0;0;0;0;0
FR;10;2021-10-02;0;0;0;0;0;0;0;0;0;0;0;0;0;0;0;0;0;0
FR;10;2021-10-03;0;0;0;0;0;0;0;0;0;0;0;0;0;0;0;0;0;0
FR;10;2021-10-04;0;0;0;0;0;0;0;0;0;0;0;0;0;0;0;0;0;0
FR;10;2021-10-05;0;0;0;0;0;0;0;0;0;0;0;0;0;0;0;0;0;0
FR;10;2021-10-06;0;0;0;0;0;0;0;0;0;0;0;0;0;0;0;0;0;0
FR;10;2021-10-07;0;0;0;0;0;0;0;0;0;0;0;0;0;0;0;0;0;0
FR;10;2021-10-08;0;0;0;0;0;0;0;0;0;0;0;0;0;0;0;0;0;0
FR;10;2021-10-09;0;0;0;0;0;0;0;0;0;0;0;0;0;0;0;0;0;0
FR;10;2021-10-10;0;0;0;0;0;0;0;0;0;0;0;0;0;0;0;0;0;0
FR;10;2021-10-11;0;0;0;0;0;0;0;0;0;0;0;0;0;0;0;0;0;0
FR;10;2021-10-12;0;0;0;0;0;0;0;0;0;0;0;0;0;0;0;0;0;0
FR;10;2021-10-13;0;0;0;0;0;0;0;0;0;0;0;0;0;0;0;0;0;0
FR;10;2021-10-14;0;0;0;0;0;0;0;0;0;0;0;0;0;0;0;0;0;0
FR;10;2021-10-15;0;0;0;0;0;0;0;0;0;0;0;0;0;0;0;0;0;0
FR;10;2021-10-16;0;0;0;0;0;0;0;0;0;0;0;0;0;0;0;0;0;0
FR;10;2021-10-17;0;0;0;0;0;0;0;0;0;0;0;0;0;0;0;0;0;0
FR;10;2021-10-18;0;0;0;0;0;0;0;0;0;0;0;0;0;0;0;0;0;0
FR;10;2021-10-19;0;0;0;0;0;0;0;0;0;0;0;0;0;0;0;0;0;0
FR;10;2021-10-20;0;0;0;0;0;0;0;0;0;0;0;0;0;0;0;0;0;0
FR;10;2021-10-21;0;0;0;0;0;0;0;0;0;0;0;0;0;0;0;0;0;0
FR;10;2021-10-22;0;0;0;0;0;0;0;0;0;0;0;0;0;0;0;0;0;0
FR;10;2021-10-23;0;0;0;0;0;0;0;0;0;0;0;0;0;0;0;0;0;0
FR;10;2021-10-24;0;0;0;0;0;0;0;0;0;0;0;0;0;0;0;0;0;0
FR;10;2021-10-25;0;0;0;0;0;0;0;0;0;0;0;0;0;0;0;0;0;0
FR;10;2021-10-26;0;0;0;0;0;0;0;0;0;0;0;0;0;0;0;0;0;0
FR;10;2021-10-27;0;0;0;0;0;0;0;0;0;0;0;0;0;0;0;0;0;0
FR;10;2021-10-28;0;0;0;0;0;0;0;0;0;0;0;0;0;0;0;0;0;0
FR;10;2021-10-29;0;0;0;0;0;0;0;0;0;0;0;0;0;0;0;0;0;0
FR;10;2021-10-30;0;0;0;0;0;0;0;0;0;0;0;0;0;0;0;0;0;0
FR;10;2021-10-31;0;0;0;0;0;0;0;0;0;0;0;0;0;0;0;0;0;0
FR;10;2021-11-01;0;0;0;0;0;0;0;0;0;0;0;0;0;0;0;0;0;0
FR;10;2021-11-02;0;0;0;0;0;0;0;0;0;0;0;0;0;0;0;0;0;0
FR;10;2021-11-03;0;0;0;0;0;0;0;0;0;0;0;0;0;0;0;0;0;0
FR;10;2021-11-04;0;0;0;0;0;0;0;0;0;0;0;0;0;0;0;0;0;0
FR;10;2021-11-05;0;0;0;0;0;0;0;0;0;0;0;0;0;0;0;0;0;0
FR;10;2021-11-06;0;0;0;0;0;0;0;0;0;0;0;0;0;0;0;0;0;0
FR;10;2021-11-07;0;0;0;0;0;0;0;0;0;0;0;0;0;0;0;0;0;0
FR;10;2021-11-08;0;0;0;0;0;0;0;0;0;0;0;0;0;0;0;0;0;0
FR;10;2021-11-09;0;0;0;0;0;0;0;0;0;0;0;0;0;0;0;0;0;0
FR;10;2021-11-10;0;0;0;0;0;0;0;0;0;0;0;0;0;0;0;0;0;0
FR;10;2021-11-11;0;0;0;0;0;0;0;0;0;0;0;0;0;0;0;0;0;0
FR;10;2021-11-12;0;0;0;0;0;0;0;0;0;0;0;0;0;0;0;0;0;0
FR;10;2021-11-13;0;0;0;0;0;0;0;0;0;0;0;0;0;0;0;0;0;0
FR;10;2021-11-14;0;0;0;0;0;0;0;0;0;0;0;0;0;0;0;0;0;0
FR;10;2021-11-15;0;0;0;0;0;0;0;0;0;0;0;0;0;0;0;0;0;0
FR;10;2021-11-16;0;0;0;0;0;0;0;0;0;0;0;0;0;0;0;0;0;0
FR;10;2021-11-17;0;0;0;0;0;0;0;0;0;0;0;0;0;0;0;0;0;0
FR;10;2021-11-18;0;0;0;0;0;0;0;0;0;0;0;0;0;0;0;0;0;0
FR;10;2021-11-19;0;0;0;0;0;0;0;0;0;0;0;0;0;0;0;0;0;0
FR;10;2021-11-20;0;0;0;0;0;0;0;0;0;0;0;0;0;0;0;0;0;0
FR;10;2021-11-21;0;0;0;0;0;0;0;0;0;0;0;0;0;0;0;0;0;0
FR;10;2021-11-22;0;0;0;0;0;0;0;0;0;0;0;0;0;0;0;0;0;0
FR;10;2021-11-23;0;0;0;0;0;0;0;0;0;0;0;0;0;0;0;0;0;0
FR;10;2021-11-24;0;0;0;0;0;0;0;0;0;0;0;0;0;0;0;0;0;0
FR;10;2021-11-25;0;0;0;0;0;0;0;0;0;0;0;0;0;0;0;0;0;0
FR;10;2021-11-26;0;0;0;0;0;0;0;0;0;0;0;0;0;0;0;0;0;0
FR;10;2021-11-27;0;0;0;0;0;0;0;0;0;0;0;0;0;0;0;0;0;0
FR;10;2021-11-28;0;0;0;0;0;0;0;0;0;0;0;0;0;0;0;0;0;0
FR;10;2021-11-29;0;0;0;0;0;0;0;0;0;0;0;0;0;0;0;0;0;0
FR;10;2021-11-30;0;0;0;0;0;0;0;0;0;0;0;0;0;0;0;0;0;0
FR;10;2021-12-01;0;0;0;0;0;0;0;0;0;0;0;0;0;0;0;0;0;0
FR;10;2021-12-02;0;0;0;0;0;0;0;0;0;0;0;0;0;0;0;0;0;0
FR;10;2021-12-03;0;0;0;0;0;0;0;0;0;0;0;0;0;0;0;0;0;0
FR;10;2021-12-04;0;0;0;0;0;0;0;0;0;0;0;0;0;0;0;0;0;0
FR;10;2021-12-05;0;0;0;0;0;0;0;0;0;0;0;0;0;0;0;0;0;0
FR;10;2021-12-06;0;0;0;0;0;0;0;0;0;0;0;0;0;0;0;0;0;0
FR;10;2021-12-07;0;0;0;0;0;0;0;0;0;0;0;0;0;0;0;0;0;0
FR;10;2021-12-08;0;0;0;0;0;0;0;0;0;0;0;0;0;0;0;0;0;0
FR;10;2021-12-09;0;0;0;0;0;0;0;0;0;0;0;0;0;0;0;0;0;0
FR;10;2021-12-10;0;0;0;0;0;0;0;0;0;0;0;0;0;0;0;0;0;0
FR;10;2021-12-11;0;0;0;0;0;0;0;0;0;0;0;0;0;0;0;0;0;0
FR;10;2021-12-12;0;0;0;0;0;0;0;0;0;0;0;0;0;0;0;0;0;0
FR;10;2021-12-13;0;0;0;0;0;0;0;0;0;0;0;0;0;0;0;0;0;0
FR;10;2021-12-14;0;0;0;0;0;0;0;0;0;0;0;0;0;0;0;0;0;0
FR;10;2021-12-15;0;0;0;0;0;0;0;0;0;0;0;0;0;0;0;0;0;0
FR;10;2021-12-16;0;0;0;0;0;0;0;0;0;0;0;0;0;0;0;0;0;0
FR;10;2021-12-17;0;0;0;0;0;0;0;0;0;0;0;0;0;0;0;0;0;0
FR;10;2021-12-18;0;0;0;0;0;0;0;0;0;0;0;0;0;0;0;0;0;0
FR;10;2021-12-19;0;0;0;0;0;0;0;0;0;0;0;0;0;0;0;0;0;0
FR;10;2021-12-20;0;0;0;0;0;0;0;0;0;0;0;0;0;0;0;0;0;0
FR;10;2021-12-21;0;0;0;0;0;0;0;0;0;0;0;0;0;0;0;0;0;0
FR;10;2021-12-22;0;0;0;0;0;0;0;0;0;0;0;0;0;0;0;0;0;0
FR;10;2021-12-23;0;0;0;0;0;0;0;0;0;0;0;0;0;0;0;0;0;0
FR;10;2021-12-24;0;0;0;0;0;0;0;0;0;0;0;0;0;0;0;0;0;0
FR;10;2021-12-25;0;0;0;0;0;0;0;0;0;0;0;0;0;0;0;0;0;0
FR;10;2021-12-26;0;0;0;0;0;0;0;0;0;0;0;0;0;0;0;0;0;0
FR;10;2021-12-27;0;0;0;0;0;0;0;0;0;0;0;0;0;0;0;0;0;0
FR;10;2021-12-28;0;0;0;0;0;0;0;0;0;0;0;0;0;0;0;0;0;0
FR;10;2021-12-29;0;0;0;0;0;0;0;0;0;0;0;0;0;0;0;0;0;0
FR;10;2021-12-30;0;0;0;0;0;0;0;0;0;0;0;0;0;0;0;0;0;0
FR;10;2021-12-31;0;0;0;0;0;0;0;0;0;0;0;0;0;0;0;0;0;0
FR;10;2022-01-01;0;0;0;0;0;0;0;0;0;0;0;0;0;0;0;0;0;0
FR;10;2022-01-02;0;0;0;0;0;0;0;0;0;0;0;0;0;0;0;0;0;0
FR;10;2022-01-03;0;0;0;0;0;0;0;0;0;0;0;0;0;0;0;0;0;0
FR;10;2022-01-04;0;0;0;0;0;0;0;0;0;0;0;0;0;0;0;0;0;0
FR;10;2022-01-05;0;0;0;0;0;0;0;0;0;0;0;0;0;0;0;0;0;0
FR;10;2022-01-06;0;0;0;0;0;0;0;0;0;0;0;0;0;0;0;0;0;0
FR;10;2022-01-07;0;0;0;0;0;0;0;0;0;0;0;0;0;0;0;0;0;0
FR;10;2022-01-08;0;0;0;0;0;0;0;0;0;0;0;0;0;0;0;0;0;0
FR;10;2022-01-09;0;0;0;0;0;0;0;0;0;0;0;0;0;0;0;0;0;0
FR;10;2022-01-10;0;0;0;0;0;0;0;0;0;0;0;0;0;0;0;0;0;0
FR;10;2022-01-11;0;0;0;0;0;0;0;0;0;0;0;0;0;0;0;0;0;0
FR;10;2022-01-12;0;0;0;0;0;0;0;0;0;0;0;0;0;0;0;0;0;0
FR;10;2022-01-13;0;0;0;0;0;0;0;0;0;0;0;0;0;0;0;0;0;0
FR;10;2022-01-14;0;0;0;0;0;0;0;0;0;0;0;0;0;0;0;0;0;0
FR;10;2022-01-15;0;0;0;0;0;0;0;0;0;0;0;0;0;0;0;0;0;0
FR;10;2022-01-16;0;0;0;0;0;0;0;0;0;0;0;0;0;0;0;0;0;0
FR;10;2022-01-17;0;0;0;0;0;0;0;0;0;0;0;0;0;0;0;0;0;0
FR;10;2022-01-18;0;0;0;0;0;0;0;0;0;0;0;0;0;0;0;0;0;0
FR;10;2022-01-19;0;0;0;0;0;0;0;0;0;0;0;0;0;0;0;0;0;0
FR;10;2022-01-20;0;0;0;0;0;0;0;0;0;0;0;0;0;0;0;0;0;0
FR;10;2022-01-21;0;0;0;0;0;0;0;0;0;0;0;0;0;0;0;0;0;0
FR;10;2022-01-22;0;0;0;0;0;0;0;0;0;0;0;0;0;0;0;0;0;0
FR;10;2022-01-23;0;0;0;0;0;0;0;0;0;0;0;0;0;0;0;0;0;0
FR;10;2022-01-24;0;0;0;0;0;0;0;0;0;0;0;0;0;0;0;0;0;0
FR;10;2022-01-25;0;0;0;0;0;0;0;0;0;0;0;0;0;0;0;0;0;0
FR;10;2022-01-26;0;0;0;0;0;0;0;0;0;0;0;0;0;0;0;0;0;0
FR;10;2022-01-27;0;0;0;0;0;0;0;0;0;0;0;0;0;0;0;0;0;0
FR;10;2022-01-28;0;0;0;0;0;0;0;0;0;0;0;0;0;0;0;0;0;0
FR;10;2022-01-29;0;0;0;0;0;0;0;0;0;0;0;0;0;0;0;0;0;0
FR;10;2022-01-30;0;0;0;0;0;0;0;0;0;0;0;0;0;0;0;0;0;0
FR;10;2022-01-31;0;0;0;0;0;0;0;0;0;0;0;0;0;0;0;0;0;0
FR;10;2022-02-01;0;0;0;0;0;0;0;0;0;0;0;0;0;0;0;0;0;0
FR;10;2022-02-02;0;0;0;0;0;0;0;0;0;0;0;0;0;0;0;0;0;0
FR;10;2022-02-03;0;0;0;0;0;0;0;0;0;0;0;0;0;0;0;0;0;0
FR;10;2022-02-04;0;0;0;0;0;0;0;0;0;0;0;0;0;0;0;0;0;0
FR;10;2022-02-05;0;0;0;0;0;0;0;0;0;0;0;0;0;0;0;0;0;0
FR;10;2022-02-06;0;0;0;0;0;0;0;0;0;0;0;0;0;0;0;0;0;0
FR;10;2022-02-07;0;0;0;0;0;0;0;0;0;0;0;0;0;0;0;0;0;0
FR;10;2022-02-08;0;0;0;0;0;0;0;0;0;0;0;0;0;0;0;0;0;0
FR;10;2022-02-09;0;0;0;0;0;0;0;0;0;0;0;0;0;0;0;0;0;0
FR;10;2022-02-10;0;0;0;0;0;0;0;0;0;0;0;0;0;0;0;0;0;0
FR;10;2022-02-11;0;0;0;0;0;0;0;0;0;0;0;0;0;0;0;0;0;0
FR;10;2022-02-12;0;0;0;0;0;0;0;0;0;0;0;0;0;0;0;0;0;0
FR;10;2022-02-13;0;0;0;0;0;0;0;0;0;0;0;0;0;0;0;0;0;0
FR;10;2022-02-14;0;0;0;0;0;0;0;0;0;0;0;0;0;0;0;0;0;0
FR;10;2022-02-15;0;0;0;0;0;0;0;0;0;0;0;0;0;0;0;0;0;0
FR;10;2022-02-16;0;0;0;0;0;0;0;0;0;0;0;0;0;0;0;0;0;0
FR;10;2022-02-17;0;0;0;0;0;0;0;0;0;0;0;0;0;0;0;0;0;0
FR;10;2022-02-18;0;0;0;0;0;0;0;0;0;0;0;0;0;0;0;0;0;0
FR;10;2022-02-19;0;0;0;0;0;0;0;0;0;0;0;0;0;0;0;0;0;0
FR;10;2022-02-20;0;0;0;0;0;0;0;0;0;0;0;0;0;0;0;0;0;0
FR;10;2022-02-21;0;0;0;0;0;0;0;0;0;0;0;0;0;0;0;0;0;0
FR;10;2022-02-22;0;0;0;0;0;0;0;0;0;0;0;0;0;0;0;0;0;0
FR;10;2022-02-23;0;0;0;0;0;0;0;0;0;0;0;0;0;0;0;0;0;0
FR;10;2022-02-24;0;0;0;0;0;0;0;0;0;0;0;0;0;0;0;0;0;0
FR;10;2022-02-25;0;0;0;0;0;0;0;0;0;0;0;0;0;0;0;0;0;0
FR;10;2022-02-26;0;0;0;0;0;0;0;0;0;0;0;0;0;0;0;0;0;0
FR;10;2022-02-27;0;0;0;0;0;0;0;0;0;0;0;0;0;0;0;0;0;0
FR;10;2022-02-28;0;0;0;0;0;0;0;0;0;0;0;0;0;0;0;0;0;0
FR;10;2022-03-01;0;0;0;0;0;0;0;0;0;0;0;0;0;0;0;0;0;0
FR;10;2022-03-02;0;0;0;0;0;0;0;0;0;0;0;0;0;0;0;0;0;0
FR;10;2022-03-03;0;0;0;0;0;0;0;0;0;0;0;0;0;0;0;0;0;0
FR;10;2022-03-04;0;0;0;0;0;0;0;0;0;0;0;0;0;0;0;0;0;0
FR;10;2022-03-05;0;0;0;0;0;0;0;0;0;0;0;0;0;0;0;0;0;0
FR;10;2022-03-06;0;0;0;0;0;0;0;0;0;0;0;0;0;0;0;0;0;0
FR;10;2022-03-07;0;0;0;0;0;0;0;0;0;0;0;0;0;0;0;0;0;0
FR;10;2022-03-08;0;0;0;0;0;0;0;0;0;0;0;0;0;0;0;0;0;0
FR;10;2022-03-09;0;0;0;0;0;0;0;0;0;0;0;0;0;0;0;0;0;0
FR;10;2022-03-10;0;0;0;0;0;0;0;0;0;0;0;0;0;0;0;0;0;0
FR;10;2022-03-11;0;0;0;0;0;0;0;0;0;0;0;0;0;0;0;0;0;0
FR;10;2022-03-12;0;0;0;0;0;0;0;0;0;0;0;0;0;0;0;0;0;0
FR;10;2022-03-13;0;0;0;0;0;0;0;0;0;0;0;0;0;0;0;0;0;0
FR;10;2022-03-14;0;0;0;0;0;0;0;0;0;0;0;0;0;0;0;0;0;0
FR;10;2022-03-15;0;0;0;0;0;0;0;0;0;0;0;0;0;0;0;0;0;0
FR;10;2022-03-16;0;0;0;0;0;0;0;0;0;0;0;0;0;0;0;0;0;0
FR;10;2022-03-17;0;0;0;0;0;0;0;0;0;0;0;0;0;0;0;0;0;0
FR;10;2022-03-18;0;0;0;0;0;0;0;0;0;0;0;0;0;0;0;0;0;0
FR;10;2022-03-19;0;0;0;0;0;0;0;0;0;0;0;0;0;0;0;0;0;0
FR;10;2022-03-20;0;0;0;0;0;0;0;0;0;0;0;0;0;0;0;0;0;0
FR;10;2022-03-21;0;0;0;0;0;0;0;0;0;0;0;0;0;0;0;0;0;0
FR;10;2022-03-22;0;0;0;0;0;0;0;0;0;0;0;0;0;0;0;0;0;0
FR;10;2022-03-23;0;0;0;0;0;0;0;0;0;0;0;0;0;0;0;0;0;0
FR;10;2022-03-24;0;0;0;0;0;0;0;0;0;0;0;0;0;0;0;0;0;0
FR;10;2022-03-25;0;0;0;0;0;0;0;0;0;0;0;0;0;0;0;0;0;0
FR;10;2022-03-26;0;0;0;0;0;0;0;0;0;0;0;0;0;0;0;0;0;0
FR;10;2022-03-27;0;0;0;0;0;0;0;0;0;0;0;0;0;0;0;0;0;0
FR;10;2022-03-28;0;0;0;0;0;0;0;0;0;0;0;0;0;0;0;0;0;0
FR;10;2022-03-29;0;0;0;0;0;0;0;0;0;0;0;0;0;0;0;0;0;0
FR;10;2022-03-30;0;0;0;0;0;0;0;0;0;0;0;0;0;0;0;0;0;0
FR;10;2022-03-31;0;0;0;0;0;0;0;0;0;0;0;0;0;0;0;0;0;0
FR;10;2022-04-01;0;0;0;0;0;0;0;0;0;0;0;0;0;0;0;0;0;0
FR;10;2022-04-02;0;0;0;0;0;0;0;0;0;0;0;0;0;0;0;0;0;0
FR;10;2022-04-03;0;0;0;0;0;0;0;0;0;0;0;0;0;0;0;0;0;0
FR;10;2022-04-04;0;0;0;0;0;0;0;0;0;0;0;0;0;0;0;0;0;0
FR;10;2022-04-05;0;0;0;0;0;0;0;0;0;0;0;0;0;0;0;0;0;0
FR;10;2022-04-06;0;0;0;0;0;0;0;0;0;0;0;0;0;0;0;0;0;0
FR;10;2022-04-07;0;0;0;0;0;0;0;0;0;0;0;0;0;0;0;0;0;0
FR;10;2022-04-08;0;0;0;0;0;0;0;0;0;0;0;0;0;0;0;0;0;0
FR;10;2022-04-09;0;0;0;0;0;0;0;0;0;0;0;0;0;0;0;0;0;0
FR;10;2022-04-10;0;0;0;0;0;0;0;0;0;0;0;0;0;0;0;0;0;0
FR;10;2022-04-11;0;0;0;0;0;0;0;0;0;0;0;0;0;0;0;0;0;0
FR;10;2022-04-12;0;0;0;0;0;0;0;0;0;0;0;0;0;0;0;0;0;0
FR;10;2022-04-13;0;0;0;0;0;0;0;0;0;0;0;0;0;0;0;0;0;0
FR;10;2022-04-14;0;0;0;0;0;0;0;0;0;0;0;0;0;0;0;0;0;0
FR;10;2022-04-15;0;0;0;0;0;0;0;0;0;0;0;0;0;0;0;0;0;0
FR;10;2022-04-16;0;0;0;0;0;0;0;0;0;0;0;0;0;0;0;0;0;0
FR;10;2022-04-17;0;0;0;0;0;0;0;0;0;0;0;0;0;0;0;0;0;0
FR;10;2022-04-18;0;0;0;0;0;0;0;0;0;0;0;0;0;0;0;0;0;0
FR;10;2022-04-19;0;0;0;0;0;0;0;0;0;0;0;0;0;0;0;0;0;0
FR;10;2022-04-20;0;0;0;0;0;0;0;0;0;0;0;0;0;0;0;0;0;0
FR;10;2022-04-21;0;0;0;0;0;0;0;0;0;0;0;0;0;0;0;0;0;0
FR;10;2022-04-22;0;0;0;0;0;0;0;0;0;0;0;0;0;0;0;0;0;0
FR;10;2022-04-23;0;0;0;0;0;0;0;0;0;0;0;0;0;0;0;0;0;0
FR;10;2022-04-24;0;0;0;0;0;0;0;0;0;0;0;0;0;0;0;0;0;0
FR;10;2022-04-25;0;0;0;0;0;0;0;0;0;0;0;0;0;0;0;0;0;0
FR;10;2022-04-26;0;0;0;0;0;0;0;0;0;0;0;0;0;0;0;0;0;0
FR;10;2022-04-27;0;0;0;0;0;0;0;0;0;0;0;0;0;0;0;0;0;0
FR;10;2022-04-28;0;0;0;0;0;0;0;0;0;0;0;0;0;0;0;0;0;0
FR;10;2022-04-29;0;0;0;0;0;0;0;0;0;0;0;0;0;0;0;0;0;0
FR;10;2022-04-30;0;0;0;0;0;0;0;0;0;0;0;0;0;0;0;0;0;0
FR;10;2022-05-01;0;0;0;0;0;0;0;0;0;0;0;0;0;0;0;0;0;0
FR;10;2022-05-02;0;0;0;0;0;0;0;0;0;0;0;0;0;0;0;0;0;0
FR;10;2022-05-03;0;0;0;0;0;0;0;0;0;0;0;0;0;0;0;0;0;0
FR;10;2022-05-04;0;0;0;0;0;0;0;0;0;0;0;0;0;0;0;0;0;0
FR;10;2022-05-05;0;0;0;0;0;0;0;0;0;0;0;0;0;0;0;0;0;0
FR;10;2022-05-06;0;0;0;0;0;0;0;0;0;0;0;0;0;0;0;0;0;0
FR;10;2022-05-07;0;0;0;0;0;0;0;0;0;0;0;0;0;0;0;0;0;0
FR;10;2022-05-08;0;0;0;0;0;0;0;0;0;0;0;0;0;0;0;0;0;0
FR;10;2022-05-09;0;0;0;0;0;0;0;0;0;0;0;0;0;0;0;0;0;0
FR;10;2022-05-10;0;0;0;0;0;0;0;0;0;0;0;0;0;0;0;0;0;0
FR;10;2022-05-11;0;0;0;0;0;0;0;0;0;0;0;0;0;0;0;0;0;0
FR;10;2022-05-12;0;0;0;0;0;0;0;0;0;0;0;0;0;0;0;0;0;0
FR;10;2022-05-13;0;0;0;0;0;0;0;0;0;0;0;0;0;0;0;0;0;0
FR;10;2022-05-14;0;0;0;0;0;0;0;0;0;0;0;0;0;0;0;0;0;0
FR;10;2022-05-15;0;0;0;0;0;0;0;0;0;0;0;0;0;0;0;0;0;0
FR;10;2022-05-16;0;0;0;0;0;0;0;0;0;0;0;0;0;0;0;0;0;0
FR;10;2022-05-17;0;0;0;0;0;0;0;0;0;0;0;0;0;0;0;0;0;0
FR;10;2022-05-18;0;0;0;0;0;0;0;0;0;0;0;0;0;0;0;0;0;0
FR;10;2022-05-19;0;0;0;0;0;0;0;0;0;0;0;0;0;0;0;0;0;0
FR;10;2022-05-20;0;0;0;0;0;0;0;0;0;0;0;0;0;0;0;0;0;0
FR;10;2022-05-21;0;0;0;0;0;0;0;0;0;0;0;0;0;0;0;0;0;0
FR;10;2022-05-22;0;0;0;0;0;0;0;0;0;0;0;0;0;0;0;0;0;0
FR;10;2022-05-23;0;0;0;0;0;0;0;0;0;0;0;0;0;0;0;0;0;0
FR;10;2022-05-24;0;0;0;0;0;0;0;0;0;0;0;0;0;0;0;0;0;0
FR;10;2022-05-25;0;0;0;0;0;0;0;0;0;0;0;0;0;0;0;0;0;0
FR;10;2022-05-26;0;0;0;0;0;0;0;0;0;0;0;0;0;0;0;0;0;0
FR;10;2022-05-27;0;0;0;0;0;0;0;0;0;0;0;0;0;0;0;0;0;0
FR;10;2022-05-28;0;0;0;0;0;0;0;0;0;0;0;0;0;0;0;0;0;0
FR;10;2022-05-29;0;0;0;0;0;0;0;0;0;0;0;0;0;0;0;0;0;0
FR;10;2022-05-30;0;0;0;0;0;0;0;0;0;0;0;0;0;0;0;0;0;0
FR;10;2022-05-31;0;0;0;0;0;0;0;0;0;0;0;0;0;0;0;0;0;0
FR;10;2022-06-01;0;0;0;0;0;0;0;0;0;0;0;0;0;0;0;0;0;0
FR;10;2022-06-02;0;0;0;0;0;0;0;0;0;0;0;0;0;0;0;0;0;0
FR;10;2022-06-03;0;0;0;0;0;0;0;0;0;0;0;0;0;0;0;0;0;0
FR;10;2022-06-04;0;0;0;0;0;0;0;0;0;0;0;0;0;0;0;0;0;0
FR;10;2022-06-05;0;0;0;0;0;0;0;0;0;0;0;0;0;0;0;0;0;0
FR;10;2022-06-06;0;0;0;0;0;0;0;0;0;0;0;0;0;0;0;0;0;0
FR;10;2022-06-07;0;0;0;0;0;0;0;0;0;0;0;0;0;0;0;0;0;0
FR;10;2022-06-08;0;0;0;0;0;0;0;0;0;0;0;0;0;0;0;0;0;0
FR;10;2022-06-09;0;0;0;0;0;0;0;0;0;0;0;0;0;0;0;0;0;0
FR;10;2022-06-10;0;0;0;0;0;0;0;0;0;0;0;0;0;0;0;0;0;0
FR;10;2022-06-11;0;0;0;0;0;0;0;0;0;0;0;0;0;0;0;0;0;0
FR;10;2022-06-12;0;0;0;0;0;0;0;0;0;0;0;0;0;0;0;0;0;0
FR;10;2022-06-13;0;0;0;0;0;0;0;0;0;0;0;0;0;0;0;0;0;0
FR;10;2022-06-14;0;0;0;0;0;0;0;0;0;0;0;0;0;0;0;0;0;0
FR;10;2022-06-15;0;0;0;0;0;0;0;0;0;0;0;0;0;0;0;0;0;0
FR;10;2022-06-16;0;0;0;0;0;0;0;0;0;0;0;0;0;0;0;0;0;0
FR;10;2022-06-17;0;0;0;0;0;0;0;0;0;0;0;0;0;0;0;0;0;0
FR;10;2022-06-18;0;0;0;0;0;0;0;0;0;0;0;0;0;0;0;0;0;0
FR;10;2022-06-19;0;0;0;0;0;0;0;0;0;0;0;0;0;0;0;0;0;0
FR;10;2022-06-20;0;0;0;0;0;0;0;0;0;0;0;0;0;0;0;0;0;0
FR;10;2022-06-21;0;0;0;0;0;0;0;0;0;0;0;0;0;0;0;0;0;0
FR;10;2022-06-22;0;0;0;0;0;0;0;0;0;0;0;0;0;0;0;0;0;0
FR;10;2022-06-23;0;0;0;0;0;0;0;0;0;0;0;0;0;0;0;0;0;0
FR;10;2022-06-24;0;0;0;0;0;0;0;0;0;0;0;0;0;0;0;0;0;0
FR;10;2022-06-25;0;0;0;0;0;0;0;0;0;0;0;0;0;0;0;0;0;0
FR;10;2022-06-26;0;0;0;0;0;0;0;0;0;0;0;0;0;0;0;0;0;0
FR;10;2022-06-27;0;0;0;0;0;0;0;0;0;0;0;0;0;0;0;0;0;0
FR;10;2022-06-28;0;0;0;0;0;0;0;0;0;0;0;0;0;0;0;0;0;0
FR;10;2022-06-29;0;0;0;0;0;0;0;0;0;0;0;0;0;0;0;0;0;0
FR;10;2022-06-30;0;0;0;0;0;0;0;0;0;0;0;0;0;0;0;0;0;0
FR;10;2022-07-01;0;0;0;0;0;0;0;0;0;0;0;0;0;0;0;0;0;0
FR;10;2022-07-02;0;0;0;0;0;0;0;0;0;0;0;0;0;0;0;0;0;0
FR;10;2022-07-03;0;0;0;0;0;0;0;0;0;0;0;0;0;0;0;0;0;0
FR;10;2022-07-04;0;0;0;0;0;0;0;0;0;0;0;0;0;0;0;0;0;0
FR;10;2022-07-05;0;0;0;0;0;0;0;0;0;0;0;0;0;0;0;0;0;0
FR;10;2022-07-06;0;0;0;0;0;0;0;0;0;0;0;0;0;0;0;0;0;0
FR;10;2022-07-07;0;0;0;0;0;0;0;0;0;0;0;0;0;0;0;0;0;0
FR;10;2022-07-08;0;0;0;0;0;0;0;0;0;0;0;0;0;0;0;0;0;0
FR;10;2022-07-09;0;0;0;0;0;0;0;0;0;0;0;0;0;0;0;0;0;0
FR;10;2022-07-10;0;0;0;0;0;0;0;0;0;0;0;0;0;0;0;0;0;0
FR;10;2022-07-11;0;0;0;0;0;0;0;0;0;0;0;0;0;0;0;0;0;0
FR;10;2022-07-12;0;0;0;0;0;0;0;0;0;0;0;0;0;0;0;0;0;0
FR;10;2022-07-13;0;0;0;0;0;0;0;0;0;0;0;0;0;0;0;0;0;0
FR;10;2022-07-14;0;0;0;0;0;0;0;0;0;0;0;0;0;0;0;0;0;0
FR;10;2022-07-15;0;0;0;0;0;0;0;0;0;0;0;0;0;0;0;0;0;0
FR;10;2022-07-16;0;0;0;0;0;0;0;0;0;0;0;0;0;0;0;0;0;0
FR;10;2022-07-17;0;0;0;0;0;0;0;0;0;0;0;0;0;0;0;0;0;0
FR;10;2022-07-18;0;0;0;0;0;0;0;0;0;0;0;0;0;0;0;0;0;0
FR;10;2022-07-19;0;0;0;0;0;0;0;0;0;0;0;0;0;0;0;0;0;0
FR;10;2022-07-20;0;0;0;0;0;0;0;0;0;0;0;0;0;0;0;0;0;0
FR;10;2022-07-21;0;0;0;0;0;0;0;0;0;0;0;0;0;0;0;0;0;0
FR;10;2022-07-22;0;0;0;0;0;0;0;0;0;0;0;0;0;0;0;0;0;0
FR;10;2022-07-23;0;0;0;0;0;0;0;0;0;0;0;0;0;0;0;0;0;0
FR;10;2022-07-24;0;0;0;0;0;0;0;0;0;0;0;0;0;0;0;0;0;0
FR;10;2022-07-25;0;0;0;0;0;0;0;0;0;0;0;0;0;0;0;0;0;0
FR;10;2022-07-26;0;0;0;0;0;0;0;0;0;0;0;0;0;0;0;0;0;0
FR;10;2022-07-27;0;0;0;0;0;0;0;0;0;0;0;0;0;0;0;0;0;0
FR;10;2022-07-28;0;0;0;0;0;0;0;0;0;0;0;0;0;0;0;0;0;0
FR;10;2022-07-29;0;0;0;0;0;0;0;0;0;0;0;0;0;0;0;0;0;0
FR;10;2022-07-30;0;0;0;0;0;0;0;0;0;0;0;0;0;0;0;0;0;0
FR;10;2022-07-31;0;0;0;0;0;0;0;0;0;0;0;0;0;0;0;0;0;0
FR;10;2022-08-01;0;0;0;0;0;0;0;0;0;0;0;0;0;0;0;0;0;0
FR;10;2022-08-02;0;0;0;0;0;0;0;0;0;0;0;0;0;0;0;0;0;0
FR;10;2022-08-03;0;0;0;0;0;0;0;0;0;0;0;0;0;0;0;0;0;0
FR;10;2022-08-04;0;0;0;0;0;0;0;0;0;0;0;0;0;0;0;0;0;0
FR;10;2022-08-05;0;0;0;0;0;0;0;0;0;0;0;0;0;0;0;0;0;0
FR;10;2022-08-06;0;0;0;0;0;0;0;0;0;0;0;0;0;0;0;0;0;0
FR;10;2022-08-07;0;0;0;0;0;0;0;0;0;0;0;0;0;0;0;0;0;0
FR;10;2022-08-08;0;0;0;0;0;0;0;0;0;0;0;0;0;0;0;0;0;0
FR;10;2022-08-09;0;0;0;0;0;0;0;0;0;0;0;0;0;0;0;0;0;0
FR;10;2022-08-10;0;0;0;0;0;0;0;0;0;0;0;0;0;0;0;0;0;0
FR;10;2022-08-11;0;0;0;0;0;0;0;0;0;0;0;0;0;0;0;0;0;0
FR;10;2022-08-12;0;0;0;0;0;0;0;0;0;0;0;0;0;0;0;0;0;0
FR;10;2022-08-13;0;0;0;0;0;0;0;0;0;0;0;0;0;0;0;0;0;0
FR;10;2022-08-14;0;0;0;0;0;0;0;0;0;0;0;0;0;0;0;0;0;0
FR;10;2022-08-15;0;0;0;0;0;0;0;0;0;0;0;0;0;0;0;0;0;0
FR;10;2022-08-16;0;0;0;0;0;0;0;0;0;0;0;0;0;0;0;0;0;0
FR;10;2022-08-17;0;0;0;0;0;0;0;0;0;0;0;0;0;0;0;0;0;0
FR;10;2022-08-18;0;0;0;0;0;0;0;0;0;0;0;0;0;0;0;0;0;0
FR;10;2022-08-19;0;0;0;0;0;0;0;0;0;0;0;0;0;0;0;0;0;0
FR;10;2022-08-20;0;0;0;0;0;0;0;0;0;0;0;0;0;0;0;0;0;0
FR;10;2022-08-21;0;0;0;0;0;0;0;0;0;0;0;0;0;0;0;0;0;0
FR;10;2022-08-22;0;0;0;0;0;0;0;0;0;0;0;0;0;0;0;0;0;0
FR;10;2022-08-23;0;0;0;0;0;0;0;0;0;0;0;0;0;0;0;0;0;0
FR;10;2022-08-24;0;0;0;0;0;0;0;0;0;0;0;0;0;0;0;0;0;0
FR;10;2022-08-25;0;0;0;0;0;0;0;0;0;0;0;0;0;0;0;0;0;0
FR;10;2022-08-26;0;0;0;0;0;0;0;0;0;0;0;0;0;0;0;0;0;0
FR;10;2022-08-27;0;0;0;0;0;0;0;0;0;0;0;0;0;0;0;0;0;0
FR;10;2022-08-28;0;0;0;0;0;0;0;0;0;0;0;0;0;0;0;0;0;0
FR;10;2022-08-29;0;0;0;0;0;0;0;0;0;0;0;0;0;0;0;0;0;0
FR;10;2022-08-30;0;0;0;0;0;0;0;0;0;0;0;0;0;0;0;0;0;0
FR;10;2022-08-31;0;0;0;0;0;0;0;0;0;0;0;0;0;0;0;0;0;0
FR;10;2022-09-01;0;0;0;0;0;0;0;0;0;0;0;0;0;0;0;0;0;0
FR;10;2022-09-02;0;0;0;0;0;0;0;0;0;0;0;0;0;0;0;0;0;0
FR;10;2022-09-03;0;0;0;0;0;0;0;0;0;0;0;0;0;0;0;0;0;0
FR;10;2022-09-04;0;0;0;0;0;0;0;0;0;0;0;0;0;0;0;0;0;0
FR;10;2022-09-05;0;0;0;0;0;0;0;0;0;0;0;0;0;0;0;0;0;0
FR;10;2022-09-06;0;0;0;0;0;0;0;0;0;0;0;0;0;0;0;0;0;0
FR;10;2022-09-07;0;0;0;0;0;0;0;0;0;0;0;0;0;0;0;0;0;0
FR;10;2022-09-08;0;0;0;0;0;0;0;0;0;0;0;0;0;0;0;0;0;0
FR;10;2022-09-09;0;0;0;0;0;0;0;0;0;0;0;0;0;0;0;0;0;0
FR;10;2022-09-10;0;0;0;0;0;0;0;0;0;0;0;0;0;0;0;0;0;0
FR;10;2022-09-11;0;0;0;0;0;0;0;0;0;0;0;0;0;0;0;0;0;0
FR;10;2022-09-12;0;0;0;0;0;0;0;0;0;0;0;0;0;0;0;0;0;0
FR;10;2022-09-13;0;0;0;0;0;0;0;0;0;0;0;0;0;0;0;0;0;0
FR;10;2022-09-14;0;0;0;0;0;0;0;0;0;0;0;0;0;0;0;0;0;0
FR;10;2022-09-15;0;0;0;0;0;0;0;0;0;0;0;0;0;0;0;0;0;0
FR;10;2022-09-16;0;0;0;0;0;0;0;0;0;0;0;0;0;0;0;0;0;0
FR;10;2022-09-17;0;0;0;0;0;0;0;0;0;0;0;0;0;0;0;0;0;0
FR;10;2022-09-18;0;0;0;0;0;0;0;0;0;0;0;0;0;0;0;0;0;0
FR;10;2022-09-19;0;0;0;0;0;0;0;0;0;0;0;0;0;0;0;0;0;0
FR;10;2022-09-20;0;0;0;0;0;0;0;0;0;0;0;0;0;0;0;0;0;0
FR;10;2022-09-21;0;0;0;0;0;0;0;0;0;0;0;0;0;0;0;0;0;0
FR;10;2022-09-22;0;0;0;0;0;0;0;0;0;0;0;0;0;0;0;0;0;0
FR;10;2022-09-23;0;0;0;0;0;0;0;0;0;0;0;0;0;0;0;0;0;0
FR;10;2022-09-24;0;0;0;0;0;0;0;0;0;0;0;0;0;0;0;0;0;0
FR;10;2022-09-25;0;0;0;0;0;0;0;0;0;0;0;0;0;0;0;0;0;0
FR;10;2022-09-26;0;0;0;0;0;0;0;0;0;0;0;0;0;0;0;0;0;0
FR;10;2022-09-27;0;0;0;0;0;0;0;0;0;0;0;0;0;0;0;0;0;0
FR;10;2022-09-28;0;0;0;0;0;0;0;0;0;0;0;0;0;0;0;0;0;0
FR;10;2022-09-29;0;0;0;0;0;0;0;0;0;0;0;0;0;0;0;0;0;0
FR;10;2022-09-30;0;0;0;0;0;0;0;0;0;0;0;0;0;0;0;0;0;0
FR;10;2022-10-01;0;0;0;0;0;0;0;0;0;0;0;0;0;0;0;0;0;0
FR;10;2022-10-02;0;0;0;0;0;0;0;0;0;0;0;0;0;0;0;0;0;0
FR;10;2022-10-03;0;0;0;0;0;0;0;0;0;0;0;0;0;0;0;0;0;0
FR;10;2022-10-04;0;0;0;0;0;0;0;0;0;0;0;0;0;0;0;0;0;0
FR;10;2022-10-05;0;0;0;0;0;0;0;0;0;0;0;0;0;0;0;0;0;0
FR;10;2022-10-06;0;0;0;0;0;0;0;0;0;0;0;0;0;0;0;0;0;0
FR;10;2022-10-07;0;0;0;0;0;0;0;0;0;0;0;0;0;0;0;0;0;0
FR;10;2022-10-08;0;0;0;0;0;0;0;0;0;0;0;0;0;0;0;0;0;0
FR;10;2022-10-09;0;0;0;0;0;0;0;0;0;0;0;0;0;0;0;0;0;0
FR;10;2022-10-10;0;0;0;0;0;0;0;0;0;0;0;0;0;0;0;0;0;0
FR;10;2022-10-11;0;0;0;0;0;0;0;0;0;0;0;0;0;0;0;0;0;0
FR;10;2022-10-12;0;0;0;0;0;0;0;0;0;0;0;0;0;0;0;0;0;0
FR;10;2022-10-13;0;0;0;0;0;0;0;0;0;0;0;0;0;0;0;0;0;0
FR;10;2022-10-14;0;0;0;0;0;0;0;0;0;0;0;0;0;0;0;0;0;0
FR;10;2022-10-15;0;0;0;0;0;0;0;0;0;0;0;0;0;0;0;0;0;0
FR;10;2022-10-16;0;0;0;0;0;0;0;0;0;0;0;0;0;0;0;0;0;0
FR;10;2022-10-17;0;0;0;0;0;0;0;0;0;0;0;0;0;0;0;0;0;0
FR;10;2022-10-18;0;0;0;0;0;0;0;0;0;0;0;0;0;0;0;0;0;0
FR;10;2022-10-19;0;0;0;0;0;0;0;0;0;0;0;0;0;0;0;0;0;0
FR;10;2022-10-20;0;0;0;0;0;0;0;0;0;0;0;0;0;0;0;0;0;0
FR;10;2022-10-21;0;0;0;0;0;0;0;0;0;0;0;0;0;0;0;0;0;0
FR;10;2022-10-22;0;0;0;0;0;0;0;0;0;0;0;0;0;0;0;0;0;0
FR;10;2022-10-23;0;0;0;0;0;0;0;0;0;0;0;0;0;0;0;0;0;0
FR;10;2022-10-24;0;0;0;0;0;0;0;0;0;0;0;0;0;0;0;0;0;0
FR;10;2022-10-25;0;0;0;0;0;0;0;0;0;0;0;0;0;0;0;0;0;0
FR;10;2022-10-26;0;0;0;0;0;0;0;0;0;0;0;0;0;0;0;0;0;0
FR;10;2022-10-27;0;0;0;0;0;0;0;0;0;0;0;0;0;0;0;0;0;0
FR;10;2022-10-28;0;0;0;0;0;0;0;0;0;0;0;0;0;0;0;0;0;0
FR;10;2022-10-29;0;0;0;0;0;0;0;0;0;0;0;0;0;0;0;0;0;0
FR;10;2022-10-30;0;0;0;0;0;0;0;0;0;0;0;0;0;0;0;0;0;0
FR;10;2022-10-31;0;0;0;0;0;0;0;0;0;0;0;0;0;0;0;0;0;0
FR;10;2022-11-01;0;0;0;0;0;0;0;0;0;0;0;0;0;0;0;0;0;0
FR;10;2022-11-02;0;0;0;0;0;0;0;0;0;0;0;0;0;0;0;0;0;0
FR;10;2022-11-03;0;0;0;0;0;0;0;0;0;0;0;0;0;0;0;0;0;0
FR;10;2022-11-04;0;0;0;0;0;0;0;0;0;0;0;0;0;0;0;0;0;0
FR;10;2022-11-05;0;0;0;0;0;0;0;0;0;0;0;0;0;0;0;0;0;0
FR;10;2022-11-06;0;0;0;0;0;0;0;0;0;0;0;0;0;0;0;0;0;0
FR;10;2022-11-07;0;0;0;0;0;0;0;0;0;0;0;0;0;0;0;0;0;0
FR;10;2022-11-08;0;0;0;0;0;0;0;0;0;0;0;0;0;0;0;0;0;0
FR;10;2022-11-09;0;0;0;0;0;0;0;0;0;0;0;0;0;0;0;0;0;0
FR;10;2022-11-10;0;0;0;0;0;0;0;0;0;0;0;0;0;0;0;0;0;0
FR;10;2022-11-11;0;0;0;0;0;0;0;0;0;0;0;0;0;0;0;0;0;0
FR;10;2022-11-12;0;0;0;0;0;0;0;0;0;0;0;0;0;0;0;0;0;0
FR;10;2022-11-13;0;0;0;0;0;0;0;0;0;0;0;0;0;0;0;0;0;0
FR;10;2022-11-14;0;0;0;0;0;0;0;0;0;0;0;0;0;0;0;0;0;0
FR;10;2022-11-15;0;0;0;0;0;0;0;0;0;0;0;0;0;0;0;0;0;0
FR;10;2022-11-16;0;0;0;0;0;0;0;0;0;0;0;0;0;0;0;0;0;0
FR;10;2022-11-17;0;0;0;0;0;0;0;0;0;0;0;0;0;0;0;0;0;0
FR;10;2022-11-18;0;0;0;0;0;0;0;0;0;0;0;0;0;0;0;0;0;0
FR;10;2022-11-19;0;0;0;0;0;0;0;0;0;0;0;0;0;0;0;0;0;0
FR;10;2022-11-20;0;0;0;0;0;0;0;0;0;0;0;0;0;0;0;0;0;0
FR;10;2022-11-21;0;0;0;0;0;0;0;0;0;0;0;0;0;0;0;0;0;0
FR;10;2022-11-22;0;0;0;0;0;0;0;0;0;0;0;0;0;0;0;0;0;0
FR;10;2022-11-23;0;0;0;0;0;0;0;0;0;0;0;0;0;0;0;0;0;0
FR;10;2022-11-24;0;0;0;0;0;0;0;0;0;0;0;0;0;0;0;0;0;0
FR;10;2022-11-25;0;0;0;0;0;0;0;0;0;0;0;0;0;0;0;0;0;0
FR;10;2022-11-26;0;0;0;0;0;0;0;0;0;0;0;0;0;0;0;0;0;0
FR;10;2022-11-27;0;0;0;0;0;0;0;0;0;0;0;0;0;0;0;0;0;0
FR;10;2022-11-28;0;0;0;0;0;0;0;0;0;0;0;0;0;0;0;0;0;0
FR;10;2022-11-29;0;0;0;0;0;0;0;0;0;0;0;0;0;0;0;0;0;0
FR;10;2022-11-30;0;0;0;0;0;0;0;0;0;0;0;0;0;0;0;0;0;0
FR;10;2022-12-01;0;0;0;0;0;0;0;0;0;0;0;0;0;0;0;0;0;0
FR;10;2022-12-02;0;0;0;0;0;0;0;0;0;0;0;0;0;0;0;0;0;0
FR;10;2022-12-03;0;0;0;0;0;0;0;0;0;0;0;0;0;0;0;0;0;0
FR;10;2022-12-04;0;0;0;0;0;0;0;0;0;0;0;0;0;0;0;0;0;0
FR;10;2022-12-05;0;0;0;0;0;0;0;0;0;0;0;0;0;0;0;0;0;0
FR;10;2022-12-06;0;0;0;0;0;0;0;0;0;0;0;0;0;0;0;0;0;0
FR;10;2022-12-07;0;0;0;0;0;0;0;0;0;0;0;0;0;0;0;0;0;0
FR;10;2022-12-08;0;0;0;0;0;0;0;0;0;0;0;0;0;0;0;0;0;0
FR;10;2022-12-09;0;0;0;0;0;0;0;0;0;0;0;0;0;0;0;0;0;0
FR;10;2022-12-10;0;0;0;0;0;0;0;0;0;0;0;0;0;0;0;0;0;0
FR;10;2022-12-11;0;0;0;0;0;0;0;0;0;0;0;0;0;0;0;0;0;0
FR;10;2022-12-12;0;0;0;0;0;0;0;0;0;0;0;0;0;0;0;0;0;0
FR;10;2022-12-13;0;0;0;0;0;0;0;0;0;0;0;0;0;0;0;0;0;0
FR;10;2022-12-14;0;0;0;0;0;0;0;0;0;0;0;0;0;0;0;0;0;0
FR;10;2022-12-15;0;0;0;0;0;0;0;0;0;0;0;0;0;0;0;0;0;0
FR;10;2022-12-16;0;0;0;0;0;0;0;0;0;0;0;0;0;0;0;0;0;0
FR;10;2022-12-17;0;0;0;0;0;0;0;0;0;0;0;0;0;0;0;0;0;0
FR;10;2022-12-18;0;0;0;0;0;0;0;0;0;0;0;0;0;0;0;0;0;0
FR;10;2022-12-19;0;0;0;0;0;0;0;0;0;0;0;0;0;0;0;0;0;0
FR;10;2022-12-20;0;0;0;0;0;0;0;0;0;0;0;0;0;0;0;0;0;0
FR;10;2022-12-21;0;0;1;0;0;1;0;0;0;0;0;1;0;0;1;0;0;0
FR;10;2022-12-22;0;0;0;1;0;0;1;0;0;0;0;1;1;0;1;1;0;0
FR;10;2022-12-23;0;0;1;14;0;2;14;0;7;0;0;2;15;0;3;15;0;7
FR;10;2022-12-24;0;0;0;3;0;0;3;0;1;0;0;2;18;0;3;18;0;8
FR;10;2022-12-25;0;0;0;0;0;0;0;0;0;0;0;2;18;0;3;18;0;8
FR;10;2022-12-26;3;1;11;35;0;8;39;0;5;3;1;13;53;0;11;57;0;13
FR;10;2022-12-27;1;1;14;35;1;11;38;0;10;4;2;27;88;1;22;95;0;23
FR;10;2022-12-28;0;0;2;15;0;1;14;0;3;4;2;29;103;1;23;109;0;26
FR;10;2022-12-29;0;0;6;48;0;1;48;0;17;4;2;35;151;1;24;157;0;43
FR;10;2022-12-30;0;1;5;33;0;8;31;0;6;4;3;40;184;1;32;188;0;49
FR;10;2022-12-31;0;0;3;12;0;4;10;0;4;4;3;43;196;1;36;198;0;53
FR;10;2023-01-01;0;0;1;6;0;0;7;0;2;4;3;44;202;1;36;205;0;55
FR;10;2023-01-02;0;4;4;37;1;6;36;0;21;4;7;48;239;2;42;241;0;76
FR;10;2023-01-03;1;2;6;63;2;5;64;0;25;5;9;54;302;4;47;305;0;101
FR;10;2023-01-04;0;1;7;52;0;6;53;0;53;5;10;61;354;4;53;358;0;154
FR;10;2023-01-05;1;2;15;74;0;11;76;0;37;6;12;76;428;4;64;434;0;191
FR;10;2023-01-06;2;3;16;107;2;13;107;0;52;8;15;92;535;6;77;541;0;243
FR;10;2023-01-07;3;1;3;41;1;3;40;0;13;11;16;95;576;7;80;581;0;256
FR;10;2023-01-08;1;0;0;9;0;0;7;0;5;12;16;95;585;7;80;588;0;261
FR;10;2023-01-09;3;2;7;67;1;7;66;0;26;15;18;102;652;8;87;654;0;287
FR;10;2023-01-10;6;1;21;118;0;13;124;0;57;21;19;123;770;8;100;778;0;344
FR;10;2023-01-11;5;4;19;77;1;16;79;0;38;26;23;142;847;9;116;857;0;382
FR;10;2023-01-12;13;1;7;77;2;3;80;0;51;39;24;149;924;11;119;937;0;433
FR;10;2023-01-13;0;6;15;122;1;8;129;0;77;39;30;164;1046;12;127;1066;0;510
FR;10;2023-01-14;2;1;8;43;0;5;47;0;3;41;31;172;1089;12;132;1113;0;513
FR;10;2023-01-15;0;0;2;10;0;1;7;0;8;41;31;174;1099;12;133;1120;0;521
FR;10;2023-01-16;0;1;11;70;1;7;73;0;68;41;32;185;1169;13;140;1193;0;589
FR;10;2023-01-17;0;7;22;109;2;11;118;0;61;41;39;207;1278;15;151;1311;0;650
FR;10;2023-01-18;2;1;13;92;1;9;104;0;15;43;40;220;1370;16;160;1415;0;665
FR;10;2023-01-19;6;6;24;142;3;22;135;0;56;49;46;244;1512;19;182;1550;0;721
FR;10;2023-01-20;2;1;11;111;0;9;106;0;73;51;47;255;1623;19;191;1656;0;794
FR;10;2023-01-21;2;1;5;26;0;5;23;0;15;53;48;260;1649;19;196;1679;0;809
FR;10;2023-01-22;0;0;0;5;0;0;5;0;0;53;48;260;1654;19;196;1684;0;809
FR;10;2023-01-23;1;2;5;62;1;5;59;0;23;54;50;265;1716;20;201;1743;0;832
FR;10;2023-01-24;6;6;27;148;2;19;152;0;75;60;56;292;1864;22;220;1895;0;907
FR;10;2023-01-25;2;1;9;81;1;5;82;0;55;62;57;301;1945;23;225;1977;0;962
FR;10;2023-01-26;4;5;33;147;1;22;159;0;52;66;62;334;2092;24;247;2136;0;1014
FR;10;2023-01-27;1;1;16;117;1;6;118;0;78;67;63;350;2209;25;253;2254;0;1092
FR;10;2023-01-28;0;1;3;18;1;1;21;0;15;67;64;353;2227;26;254;2275;0;1107
FR;10;2023-01-29;0;0;1;0;0;1;0;0;1;67;64;354;2227;26;255;2275;0;1108
FR;10;2023-01-30;2;1;11;60;1;5;63;0;40;69;65;365;2287;27;260;2338;0;1148
FR;10;2023-01-31;5;2;24;121;3;17;121;0;51;74;67;389;2408;30;277;2459;0;1199
FR;10;2023-02-01;0;2;11;49;2;10;49;0;28;74;69;400;2457;32;287;2508;0;1227
FR;10;2023-02-02;3;0;21;104;0;16;108;0;47;77;69;421;2561;32;303;2616;0;1274
FR;10;2023-02-03;6;5;18;48;4;11;51;0;64;83;74;439;2609;36;314;2667;0;1338
FR;10;2023-02-04;1;0;1;8;0;0;10;0;6;84;74;440;2617;36;314;2677;0;1344
FR;10;2023-02-05;7;1;2;3;2;1;4;0;5;91;75;442;2620;38;315;2681;0;1349
FR;10;2023-02-06;1;0;9;28;0;8;22;0;46;92;75;451;2648;38;323;2703;0;1395
FR;10;2023-02-07;2;2;2;12;1;3;12;0;13;94;77;453;2660;39;326;2715;0;1408
FR;10;2023-02-08;1;3;3;15;2;4;15;0;12;95;80;456;2675;41;330;2730;0;1420
FR;10;2023-02-09;2;1;11;91;2;7;97;0;41;97;81;467;2766;43;337;2827;0;1461
FR;10;2023-02-10;8;3;12;29;0;6;37;0;25;105;84;479;2795;43;343;2864;0;1486
FR;10;2023-02-11;1;0;2;2;0;2;2;0;1;106;84;481;2797;43;345;2866;0;1487
FR;10;2023-02-12;1;1;0;0;1;0;0;0;0;107;85;481;2797;44;345;2866;0;1487
FR;10;2023-02-13;3;1;9;15;0;7;18;0;10;110;86;490;2812;44;352;2884;0;1497
FR;10;2023-02-14;2;4;11;49;3;9;50;0;17;112;90;501;2861;47;361;2934;0;1514
FR;10;2023-02-15;7;3;2;10;2;3;8;0;8;119;93;503;2871;49;364;2942;0;1522
FR;10;2023-02-16;0;0;8;17;0;5;18;0;8;119;93;511;2888;49;369;2960;0;1530
FR;10;2023-02-17;13;5;7;28;5;2;22;0;17;132;98;518;2916;54;371;2982;0;1547
FR;10;2023-02-18;2;0;3;11;0;3;10;0;6;134;98;521;2927;54;374;2992;0;1553
FR;10;2023-02-19;0;0;0;0;0;0;0;0;0;134;98;521;2927;54;374;2992;0;1553
FR;10;2023-02-20;2;1;2;25;1;1;23;0;23;136;99;523;2952;55;375;3015;0;1576
FR;10;2023-02-21;2;3;12;27;1;6;35;0;30;138;102;535;2979;56;381;3050;0;1606
FR;10;2023-02-22;5;4;2;7;3;3;6;0;1;143;106;537;2986;59;384;3056;0;1607
FR;10;2023-02-23;3;2;17;31;2;14;37;0;12;146;108;554;3017;61;398;3093;0;1619
FR;10;2023-02-24;1;2;8;27;0;5;27;0;29;147;110;562;3044;61;403;3120;0;1648
FR;10;2023-02-25;0;0;2;3;0;2;3;0;7;147;110;564;3047;61;405;3123;0;1655
FR;10;2023-02-26;0;0;0;0;0;0;0;0;0;147;110;564;3047;61;405;3123;0;1655
FR;10;2023-02-27;3;3;2;20;4;2;21;0;15;150;113;566;3067;65;407;3144;0;1670
FR;10;2023-02-28;3;2;3;10;2;1;11;0;10;153;115;569;3077;67;408;3155;0;1680
FR;10;2023-03-01;2;2;11;12;2;10;12;0;14;155;117;580;3089;69;418;3167;0;1694
FR;10;2023-03-02;2;1;10;22;2;6;22;0;31;157;118;590;3111;71;424;3189;0;1725
FR;10;2023-03-03;7;2;5;21;0;6;20;0;18;164;120;595;3132;71;430;3209;0;1743
FR;10;2023-03-04;0;1;0;6;1;0;6;0;2;164;121;595;3138;72;430;3215;0;1745
FR;10;2023-03-05;0;0;0;1;0;0;0;0;2;164;121;595;3139;72;430;3215;0;1747
FR;10;2023-03-06;2;2;8;8;3;7;9;0;8;166;123;603;3147;75;437;3224;0;1755
FR;10;2023-03-07;2;3;0;11;1;2;11;0;8;168;126;603;3158;76;439;3235;0;1763
FR;10;2023-03-08;1;4;4;20;3;3;22;0;9;169;130;607;3178;79;442;3257;0;1772
FR;10;2023-03-09;0;3;1;9;1;2;8;0;8;169;133;608;3187;80;444;3265;0;1780
FR;10;2023-03-10;1;2;1;8;2;1;9;0;9;170;135;609;3195;82;445;3274;0;1789
FR;10;2023-03-11;2;1;5;4;0;3;7;0;2;172;136;614;3199;82;448;3281;0;1791
FR;10;2023-03-12;0;0;0;0;0;0;0;0;0;172;136;614;3199;82;448;3281;0;1791
FR;10;2023-03-13;0;2;2;3;2;2;3;0;5;172;138;616;3202;84;450;3284;0;1796
FR;10;2023-03-14;2;0;6;25;0;4;27;0;21;174;138;622;3227;84;454;3311;0;1817
FR;10;2023-03-15;0;2;2;5;1;4;4;0;6;174;140;624;3232;85;458;3315;0;1823
FR;10;2023-03-16;3;1;6;12;0;4;15;0;11;177;141;630;3244;85;462;3330;0;1834
FR;10;2023-03-17;3;5;7;17;4;4;20;0;19;180;146;637;3261;89;466;3350;0;1853
FR;10;2023-03-18;0;1;1;3;0;2;2;0;3;180;147;638;3264;89;468;3352;0;1856
FR;10;2023-03-19;6;0;0;0;0;0;0;0;0;186;147;638;3264;89;468;3352;0;1856
FR;10;2023-03-20;5;4;0;12;3;1;13;0;12;191;151;638;3276;92;469;3365;0;1868
FR;10;2023-03-21;1;2;2;7;0;3;9;0;14;192;153;640;3283;92;472;3374;0;1882
FR;10;2023-03-22;0;0;3;4;0;3;3;0;3;192;153;643;3287;92;475;3377;0;1885
FR;10;2023-03-23;9;9;4;6;9;1;8;0;13;201;162;647;3293;101;476;3385;0;1898
FR;10;2023-03-24;2;3;2;14;2;1;10;0;17;203;165;649;3307;103;477;3395;0;1915
FR;10;2023-03-25;1;3;0;4;1;3;5;0;8;204;168;649;3311;104;480;3400;0;1923
FR;10;2023-03-26;1;1;0;0;1;0;0;0;0;205;169;649;3311;105;480;3400;0;1923
FR;11;2020-12-27;0;0;0;0;0;0;0;0;0;0;0;0;0;0;0;0;0;0
FR;11;2020-12-28;0;0;0;0;0;0;0;0;0;0;0;0;0;0;0;0;0;0
FR;11;2020-12-29;0;0;0;0;0;0;0;0;0;0;0;0;0;0;0;0;0;0
FR;11;2020-12-30;0;0;0;0;0;0;0;0;0;0;0;0;0;0;0;0;0;0
FR;11;2020-12-31;0;0;0;0;0;0;0;0;0;0;0;0;0;0;0;0;0;0
FR;11;2021-01-01;0;0;0;0;0;0;0;0;0;0;0;0;0;0;0;0;0;0
FR;11;2021-01-02;0;0;0;0;0;0;0;0;0;0;0;0;0;0;0;0;0;0
FR;11;2021-01-03;0;0;0;0;0;0;0;0;0;0;0;0;0;0;0;0;0;0
FR;11;2021-01-04;0;0;0;0;0;0;0;0;0;0;0;0;0;0;0;0;0;0
FR;11;2021-01-05;0;0;0;0;0;0;0;0;0;0;0;0;0;0;0;0;0;0
FR;11;2021-01-06;0;0;0;0;0;0;0;0;0;0;0;0;0;0;0;0;0;0
FR;11;2021-01-07;0;0;0;0;0;0;0;0;0;0;0;0;0;0;0;0;0;0
FR;11;2021-01-08;0;0;0;0;0;0;0;0;0;0;0;0;0;0;0;0;0;0
FR;11;2021-01-09;0;0;0;0;0;0;0;0;0;0;0;0;0;0;0;0;0;0
FR;11;2021-01-10;0;0;0;0;0;0;0;0;0;0;0;0;0;0;0;0;0;0
FR;11;2021-01-11;0;0;0;0;0;0;0;0;0;0;0;0;0;0;0;0;0;0
FR;11;2021-01-12;0;0;0;0;0;0;0;0;0;0;0;0;0;0;0;0;0;0
FR;11;2021-01-13;0;0;0;0;0;0;0;0;0;0;0;0;0;0;0;0;0;0
FR;11;2021-01-14;0;0;0;0;0;0;0;0;0;0;0;0;0;0;0;0;0;0
FR;11;2021-01-15;0;0;0;0;0;0;0;0;0;0;0;0;0;0;0;0;0;0
FR;11;2021-01-16;0;0;0;0;0;0;0;0;0;0;0;0;0;0;0;0;0;0
FR;11;2021-01-17;0;0;0;0;0;0;0;0;0;0;0;0;0;0;0;0;0;0
FR;11;2021-01-18;0;0;0;0;0;0;0;0;0;0;0;0;0;0;0;0;0;0
FR;11;2021-01-19;0;0;0;0;0;0;0;0;0;0;0;0;0;0;0;0;0;0
FR;11;2021-01-20;0;0;0;0;0;0;0;0;0;0;0;0;0;0;0;0;0;0
FR;11;2021-01-21;0;0;0;0;0;0;0;0;0;0;0;0;0;0;0;0;0;0
FR;11;2021-01-22;0;0;0;0;0;0;0;0;0;0;0;0;0;0;0;0;0;0
FR;11;2021-01-23;0;0;0;0;0;0;0;0;0;0;0;0;0;0;0;0;0;0
FR;11;2021-01-24;0;0;0;0;0;0;0;0;0;0;0;0;0;0;0;0;0;0
FR;11;2021-01-25;0;0;0;0;0;0;0;0;0;0;0;0;0;0;0;0;0;0
FR;11;2021-01-26;0;0;0;0;0;0;0;0;0;0;0;0;0;0;0;0;0;0
FR;11;2021-01-27;0;0;0;0;0;0;0;0;0;0;0;0;0;0;0;0;0;0
FR;11;2021-01-28;0;0;0;0;0;0;0;0;0;0;0;0;0;0;0;0;0;0
FR;11;2021-01-29;0;0;0;0;0;0;0;0;0;0;0;0;0;0;0;0;0;0
FR;11;2021-01-30;0;0;0;0;0;0;0;0;0;0;0;0;0;0;0;0;0;0
FR;11;2021-01-31;0;0;0;0;0;0;0;0;0;0;0;0;0;0;0;0;0;0
FR;11;2021-02-01;0;0;0;0;0;0;0;0;0;0;0;0;0;0;0;0;0;0
FR;11;2021-02-02;0;0;0;0;0;0;0;0;0;0;0;0;0;0;0;0;0;0
FR;11;2021-02-03;0;0;0;0;0;0;0;0;0;0;0;0;0;0;0;0;0;0
FR;11;2021-02-04;0;0;0;0;0;0;0;0;0;0;0;0;0;0;0;0;0;0
FR;11;2021-02-05;0;0;0;0;0;0;0;0;0;0;0;0;0;0;0;0;0;0
FR;11;2021-02-06;0;0;0;0;0;0;0;0;0;0;0;0;0;0;0;0;0;0
FR;11;2021-02-07;0;0;0;0;0;0;0;0;0;0;0;0;0;0;0;0;0;0
FR;11;2021-02-08;0;0;0;0;0;0;0;0;0;0;0;0;0;0;0;0;0;0
FR;11;2021-02-09;0;0;0;0;0;0;0;0;0;0;0;0;0;0;0;0;0;0
FR;11;2021-02-10;0;0;0;0;0;0;0;0;0;0;0;0;0;0;0;0;0;0
FR;11;2021-02-11;0;0;0;0;0;0;0;0;0;0;0;0;0;0;0;0;0;0
FR;11;2021-02-12;0;0;0;0;0;0;0;0;0;0;0;0;0;0;0;0;0;0
FR;11;2021-02-13;0;0;0;0;0;0;0;0;0;0;0;0;0;0;0;0;0;0
FR;11;2021-02-14;0;0;0;0;0;0;0;0;0;0;0;0;0;0;0;0;0;0
FR;11;2021-02-15;0;0;0;0;0;0;0;0;0;0;0;0;0;0;0;0;0;0
FR;11;2021-02-16;0;0;0;0;0;0;0;0;0;0;0;0;0;0;0;0;0;0
FR;11;2021-02-17;0;0;0;0;0;0;0;0;0;0;0;0;0;0;0;0;0;0
FR;11;2021-02-18;0;0;0;0;0;0;0;0;0;0;0;0;0;0;0;0;0;0
FR;11;2021-02-19;0;0;0;0;0;0;0;0;0;0;0;0;0;0;0;0;0;0
FR;11;2021-02-20;0;0;0;0;0;0;0;0;0;0;0;0;0;0;0;0;0;0
FR;11;2021-02-21;0;0;0;0;0;0;0;0;0;0;0;0;0;0;0;0;0;0
FR;11;2021-02-22;0;0;0;0;0;0;0;0;0;0;0;0;0;0;0;0;0;0
FR;11;2021-02-23;0;0;0;0;0;0;0;0;0;0;0;0;0;0;0;0;0;0
FR;11;2021-02-24;0;0;0;0;0;0;0;0;0;0;0;0;0;0;0;0;0;0
FR;11;2021-02-25;0;0;0;0;0;0;0;0;0;0;0;0;0;0;0;0;0;0
FR;11;2021-02-26;0;0;0;0;0;0;0;0;0;0;0;0;0;0;0;0;0;0
FR;11;2021-02-27;0;0;0;0;0;0;0;0;0;0;0;0;0;0;0;0;0;0
FR;11;2021-02-28;0;0;0;0;0;0;0;0;0;0;0;0;0;0;0;0;0;0
FR;11;2021-03-01;0;0;0;0;0;0;0;0;0;0;0;0;0;0;0;0;0;0
FR;11;2021-03-02;0;0;0;0;0;0;0;0;0;0;0;0;0;0;0;0;0;0
FR;11;2021-03-03;0;0;0;0;0;0;0;0;0;0;0;0;0;0;0;0;0;0
FR;11;2021-03-04;0;0;0;0;0;0;0;0;0;0;0;0;0;0;0;0;0;0
FR;11;2021-03-05;0;0;0;0;0;0;0;0;0;0;0;0;0;0;0;0;0;0
FR;11;2021-03-06;0;0;0;0;0;0;0;0;0;0;0;0;0;0;0;0;0;0
FR;11;2021-03-07;0;0;0;0;0;0;0;0;0;0;0;0;0;0;0;0;0;0
FR;11;2021-03-08;0;0;0;0;0;0;0;0;0;0;0;0;0;0;0;0;0;0
FR;11;2021-03-09;0;0;0;0;0;0;0;0;0;0;0;0;0;0;0;0;0;0
FR;11;2021-03-10;0;0;0;0;0;0;0;0;0;0;0;0;0;0;0;0;0;0
FR;11;2021-03-11;0;0;0;0;0;0;0;0;0;0;0;0;0;0;0;0;0;0
FR;11;2021-03-12;0;0;0;0;0;0;0;0;0;0;0;0;0;0;0;0;0;0
FR;11;2021-03-13;0;0;0;0;0;0;0;0;0;0;0;0;0;0;0;0;0;0
FR;11;2021-03-14;0;0;0;0;0;0;0;0;0;0;0;0;0;0;0;0;0;0
FR;11;2021-03-15;0;0;0;0;0;0;0;0;0;0;0;0;0;0;0;0;0;0
FR;11;2021-03-16;0;0;0;0;0;0;0;0;0;0;0;0;0;0;0;0;0;0
FR;11;2021-03-17;0;0;0;0;0;0;0;0;0;0;0;0;0;0;0;0;0;0
FR;11;2021-03-18;0;0;0;0;0;0;0;0;0;0;0;0;0;0;0;0;0;0
FR;11;2021-03-19;0;0;0;0;0;0;0;0;0;0;0;0;0;0;0;0;0;0
FR;11;2021-03-20;0;0;0;0;0;0;0;0;0;0;0;0;0;0;0;0;0;0
FR;11;2021-03-21;0;0;0;0;0;0;0;0;0;0;0;0;0;0;0;0;0;0
FR;11;2021-03-22;0;0;0;0;0;0;0;0;0;0;0;0;0;0;0;0;0;0
FR;11;2021-03-23;0;0;0;0;0;0;0;0;0;0;0;0;0;0;0;0;0;0
FR;11;2021-03-24;0;0;0;0;0;0;0;0;0;0;0;0;0;0;0;0;0;0
FR;11;2021-03-25;0;0;0;0;0;0;0;0;0;0;0;0;0;0;0;0;0;0
FR;11;2021-03-26;0;0;0;0;0;0;0;0;0;0;0;0;0;0;0;0;0;0
FR;11;2021-03-27;0;0;0;0;0;0;0;0;0;0;0;0;0;0;0;0;0;0
FR;11;2021-03-28;0;0;0;0;0;0;0;0;0;0;0;0;0;0;0;0;0;0
FR;11;2021-03-29;0;0;0;0;0;0;0;0;0;0;0;0;0;0;0;0;0;0
FR;11;2021-03-30;0;0;0;0;0;0;0;0;0;0;0;0;0;0;0;0;0;0
FR;11;2021-03-31;0;0;0;0;0;0;0;0;0;0;0;0;0;0;0;0;0;0
FR;11;2021-04-01;0;0;0;0;0;0;0;0;0;0;0;0;0;0;0;0;0;0
FR;11;2021-04-02;0;0;0;0;0;0;0;0;0;0;0;0;0;0;0;0;0;0
FR;11;2021-04-03;0;0;0;0;0;0;0;0;0;0;0;0;0;0;0;0;0;0
FR;11;2021-04-04;0;0;0;0;0;0;0;0;0;0;0;0;0;0;0;0;0;0
FR;11;2021-04-05;0;0;0;0;0;0;0;0;0;0;0;0;0;0;0;0;0;0
FR;11;2021-04-06;0;0;0;0;0;0;0;0;0;0;0;0;0;0;0;0;0;0
FR;11;2021-04-07;0;0;0;0;0;0;0;0;0;0;0;0;0;0;0;0;0;0
FR;11;2021-04-08;0;0;0;0;0;0;0;0;0;0;0;0;0;0;0;0;0;0
FR;11;2021-04-09;0;0;0;0;0;0;0;0;0;0;0;0;0;0;0;0;0;0
FR;11;2021-04-10;0;0;0;0;0;0;0;0;0;0;0;0;0;0;0;0;0;0
FR;11;2021-04-11;0;0;0;0;0;0;0;0;0;0;0;0;0;0;0;0;0;0
FR;11;2021-04-12;0;0;0;0;0;0;0;0;0;0;0;0;0;0;0;0;0;0
FR;11;2021-04-13;0;0;0;0;0;0;0;0;0;0;0;0;0;0;0;0;0;0
FR;11;2021-04-14;0;0;0;0;0;0;0;0;0;0;0;0;0;0;0;0;0;0
FR;11;2021-04-15;0;0;0;0;0;0;0;0;0;0;0;0;0;0;0;0;0;0
FR;11;2021-04-16;0;0;0;0;0;0;0;0;0;0;0;0;0;0;0;0;0;0
FR;11;2021-04-17;0;0;0;0;0;0;0;0;0;0;0;0;0;0;0;0;0;0
FR;11;2021-04-18;0;0;0;0;0;0;0;0;0;0;0;0;0;0;0;0;0;0
FR;11;2021-04-19;0;0;0;0;0;0;0;0;0;0;0;0;0;0;0;0;0;0
FR;11;2021-04-20;0;0;0;0;0;0;0;0;0;0;0;0;0;0;0;0;0;0
FR;11;2021-04-21;0;0;0;0;0;0;0;0;0;0;0;0;0;0;0;0;0;0
FR;11;2021-04-22;0;0;0;0;0;0;0;0;0;0;0;0;0;0;0;0;0;0
FR;11;2021-04-23;0;0;0;0;0;0;0;0;0;0;0;0;0;0;0;0;0;0
FR;11;2021-04-24;0;0;0;0;0;0;0;0;0;0;0;0;0;0;0;0;0;0
FR;11;2021-04-25;0;0;0;0;0;0;0;0;0;0;0;0;0;0;0;0;0;0
FR;11;2021-04-26;0;0;0;0;0;0;0;0;0;0;0;0;0;0;0;0;0;0
FR;11;2021-04-27;0;0;0;0;0;0;0;0;0;0;0;0;0;0;0;0;0;0
FR;11;2021-04-28;0;0;0;0;0;0;0;0;0;0;0;0;0;0;0;0;0;0
FR;11;2021-04-29;0;0;0;0;0;0;0;0;0;0;0;0;0;0;0;0;0;0
FR;11;2021-04-30;0;0;0;0;0;0;0;0;0;0;0;0;0;0;0;0;0;0
FR;11;2021-05-01;0;0;0;0;0;0;0;0;0;0;0;0;0;0;0;0;0;0
FR;11;2021-05-02;0;0;0;0;0;0;0;0;0;0;0;0;0;0;0;0;0;0
FR;11;2021-05-03;0;0;0;0;0;0;0;0;0;0;0;0;0;0;0;0;0;0
FR;11;2021-05-04;0;0;0;0;0;0;0;0;0;0;0;0;0;0;0;0;0;0
FR;11;2021-05-05;0;0;0;0;0;0;0;0;0;0;0;0;0;0;0;0;0;0
FR;11;2021-05-06;0;0;0;0;0;0;0;0;0;0;0;0;0;0;0;0;0;0
FR;11;2021-05-07;0;0;0;0;0;0;0;0;0;0;0;0;0;0;0;0;0;0
FR;11;2021-05-08;0;0;0;0;0;0;0;0;0;0;0;0;0;0;0;0;0;0
FR;11;2021-05-09;0;0;0;0;0;0;0;0;0;0;0;0;0;0;0;0;0;0
FR;11;2021-05-10;0;0;0;0;0;0;0;0;0;0;0;0;0;0;0;0;0;0
FR;11;2021-05-11;0;0;0;0;0;0;0;0;0;0;0;0;0;0;0;0;0;0
FR;11;2021-05-12;0;0;0;0;0;0;0;0;0;0;0;0;0;0;0;0;0;0
FR;11;2021-05-13;0;0;0;0;0;0;0;0;0;0;0;0;0;0;0;0;0;0
FR;11;2021-05-14;0;0;0;0;0;0;0;0;0;0;0;0;0;0;0;0;0;0
FR;11;2021-05-15;0;0;0;0;0;0;0;0;0;0;0;0;0;0;0;0;0;0
FR;11;2021-05-16;0;0;0;0;0;0;0;0;0;0;0;0;0;0;0;0;0;0
FR;11;2021-05-17;0;0;0;0;0;0;0;0;0;0;0;0;0;0;0;0;0;0
FR;11;2021-05-18;0;0;0;0;0;0;0;0;0;0;0;0;0;0;0;0;0;0
FR;11;2021-05-19;0;0;0;0;0;0;0;0;0;0;0;0;0;0;0;0;0;0
FR;11;2021-05-20;0;0;0;0;0;0;0;0;0;0;0;0;0;0;0;0;0;0
FR;11;2021-05-21;0;0;0;0;0;0;0;0;0;0;0;0;0;0;0;0;0;0
FR;11;2021-05-22;0;0;0;0;0;0;0;0;0;0;0;0;0;0;0;0;0;0
FR;11;2021-05-23;0;0;0;0;0;0;0;0;0;0;0;0;0;0;0;0;0;0
FR;11;2021-05-24;0;0;0;0;0;0;0;0;0;0;0;0;0;0;0;0;0;0
FR;11;2021-05-25;0;0;0;0;0;0;0;0;0;0;0;0;0;0;0;0;0;0
FR;11;2021-05-26;0;0;0;0;0;0;0;0;0;0;0;0;0;0;0;0;0;0
FR;11;2021-05-27;0;0;0;0;0;0;0;0;0;0;0;0;0;0;0;0;0;0
FR;11;2021-05-28;0;0;0;0;0;0;0;0;0;0;0;0;0;0;0;0;0;0
FR;11;2021-05-29;0;0;0;0;0;0;0;0;0;0;0;0;0;0;0;0;0;0
FR;11;2021-05-30;0;0;0;0;0;0;0;0;0;0;0;0;0;0;0;0;0;0
FR;11;2021-05-31;0;0;0;0;0;0;0;0;0;0;0;0;0;0;0;0;0;0
FR;11;2021-06-01;0;0;0;0;0;0;0;0;0;0;0;0;0;0;0;0;0;0
FR;11;2021-06-02;0;0;0;0;0;0;0;0;0;0;0;0;0;0;0;0;0;0
FR;11;2021-06-03;0;0;0;0;0;0;0;0;0;0;0;0;0;0;0;0;0;0
FR;11;2021-06-04;0;0;0;0;0;0;0;0;0;0;0;0;0;0;0;0;0;0
FR;11;2021-06-05;0;0;0;0;0;0;0;0;0;0;0;0;0;0;0;0;0;0
FR;11;2021-06-06;0;0;0;0;0;0;0;0;0;0;0;0;0;0;0;0;0;0
FR;11;2021-06-07;0;0;0;0;0;0;0;0;0;0;0;0;0;0;0;0;0;0
FR;11;2021-06-08;0;0;0;0;0;0;0;0;0;0;0;0;0;0;0;0;0;0
FR;11;2021-06-09;0;0;0;0;0;0;0;0;0;0;0;0;0;0;0;0;0;0
FR;11;2021-06-10;0;0;0;0;0;0;0;0;0;0;0;0;0;0;0;0;0;0
FR;11;2021-06-11;0;0;0;0;0;0;0;0;0;0;0;0;0;0;0;0;0;0
FR;11;2021-06-12;0;0;0;0;0;0;0;0;0;0;0;0;0;0;0;0;0;0
FR;11;2021-06-13;0;0;0;0;0;0;0;0;0;0;0;0;0;0;0;0;0;0
FR;11;2021-06-14;0;0;0;0;0;0;0;0;0;0;0;0;0;0;0;0;0;0
FR;11;2021-06-15;0;0;0;0;0;0;0;0;0;0;0;0;0;0;0;0;0;0
FR;11;2021-06-16;0;0;0;0;0;0;0;0;0;0;0;0;0;0;0;0;0;0
FR;11;2021-06-17;0;0;0;0;0;0;0;0;0;0;0;0;0;0;0;0;0;0
FR;11;2021-06-18;0;0;0;0;0;0;0;0;0;0;0;0;0;0;0;0;0;0
FR;11;2021-06-19;0;0;0;0;0;0;0;0;0;0;0;0;0;0;0;0;0;0
FR;11;2021-06-20;0;0;0;0;0;0;0;0;0;0;0;0;0;0;0;0;0;0
FR;11;2021-06-21;0;0;0;0;0;0;0;0;0;0;0;0;0;0;0;0;0;0
FR;11;2021-06-22;0;0;0;0;0;0;0;0;0;0;0;0;0;0;0;0;0;0
FR;11;2021-06-23;0;0;0;0;0;0;0;0;0;0;0;0;0;0;0;0;0;0
FR;11;2021-06-24;0;0;0;0;0;0;0;0;0;0;0;0;0;0;0;0;0;0
FR;11;2021-06-25;0;0;0;0;0;0;0;0;0;0;0;0;0;0;0;0;0;0
FR;11;2021-06-26;0;0;0;0;0;0;0;0;0;0;0;0;0;0;0;0;0;0
FR;11;2021-06-27;0;0;0;0;0;0;0;0;0;0;0;0;0;0;0;0;0;0
FR;11;2021-06-28;0;0;0;0;0;0;0;0;0;0;0;0;0;0;0;0;0;0
FR;11;2021-06-29;0;0;0;0;0;0;0;0;0;0;0;0;0;0;0;0;0;0
FR;11;2021-06-30;0;0;0;0;0;0;0;0;0;0;0;0;0;0;0;0;0;0
FR;11;2021-07-01;0;0;0;0;0;0;0;0;0;0;0;0;0;0;0;0;0;0
FR;11;2021-07-02;0;0;0;0;0;0;0;0;0;0;0;0;0;0;0;0;0;0
FR;11;2021-07-03;0;0;0;0;0;0;0;0;0;0;0;0;0;0;0;0;0;0
FR;11;2021-07-04;0;0;0;0;0;0;0;0;0;0;0;0;0;0;0;0;0;0
FR;11;2021-07-05;0;0;0;0;0;0;0;0;0;0;0;0;0;0;0;0;0;0
FR;11;2021-07-06;0;0;0;0;0;0;0;0;0;0;0;0;0;0;0;0;0;0
FR;11;2021-07-07;0;0;0;0;0;0;0;0;0;0;0;0;0;0;0;0;0;0
FR;11;2021-07-08;0;0;0;0;0;0;0;0;0;0;0;0;0;0;0;0;0;0
FR;11;2021-07-09;0;0;0;0;0;0;0;0;0;0;0;0;0;0;0;0;0;0
FR;11;2021-07-10;0;0;0;0;0;0;0;0;0;0;0;0;0;0;0;0;0;0
FR;11;2021-07-11;0;0;0;0;0;0;0;0;0;0;0;0;0;0;0;0;0;0
FR;11;2021-07-12;0;0;0;0;0;0;0;0;0;0;0;0;0;0;0;0;0;0
FR;11;2021-07-13;0;0;0;0;0;0;0;0;0;0;0;0;0;0;0;0;0;0
FR;11;2021-07-14;0;0;0;0;0;0;0;0;0;0;0;0;0;0;0;0;0;0
FR;11;2021-07-15;0;0;0;0;0;0;0;0;0;0;0;0;0;0;0;0;0;0
FR;11;2021-07-16;0;0;0;0;0;0;0;0;0;0;0;0;0;0;0;0;0;0
FR;11;2021-07-17;0;0;0;0;0;0;0;0;0;0;0;0;0;0;0;0;0;0
FR;11;2021-07-18;0;0;0;0;0;0;0;0;0;0;0;0;0;0;0;0;0;0
FR;11;2021-07-19;0;0;0;0;0;0;0;0;0;0;0;0;0;0;0;0;0;0
FR;11;2021-07-20;0;0;0;0;0;0;0;0;0;0;0;0;0;0;0;0;0;0
FR;11;2021-07-21;0;0;0;0;0;0;0;0;0;0;0;0;0;0;0;0;0;0
FR;11;2021-07-22;0;0;0;0;0;0;0;0;0;0;0;0;0;0;0;0;0;0
FR;11;2021-07-23;0;0;0;0;0;0;0;0;0;0;0;0;0;0;0;0;0;0
FR;11;2021-07-24;0;0;0;0;0;0;0;0;0;0;0;0;0;0;0;0;0;0
FR;11;2021-07-25;0;0;0;0;0;0;0;0;0;0;0;0;0;0;0;0;0;0
FR;11;2021-07-26;0;0;0;0;0;0;0;0;0;0;0;0;0;0;0;0;0;0
FR;11;2021-07-27;0;0;0;0;0;0;0;0;0;0;0;0;0;0;0;0;0;0
FR;11;2021-07-28;0;0;0;0;0;0;0;0;0;0;0;0;0;0;0;0;0;0
FR;11;2021-07-29;0;0;0;0;0;0;0;0;0;0;0;0;0;0;0;0;0;0
FR;11;2021-07-30;0;0;0;0;0;0;0;0;0;0;0;0;0;0;0;0;0;0
FR;11;2021-07-31;0;0;0;0;0;0;0;0;0;0;0;0;0;0;0;0;0;0
FR;11;2021-08-01;0;0;0;0;0;0;0;0;0;0;0;0;0;0;0;0;0;0
FR;11;2021-08-02;0;0;0;0;0;0;0;0;0;0;0;0;0;0;0;0;0;0
FR;11;2021-08-03;0;0;0;0;0;0;0;0;0;0;0;0;0;0;0;0;0;0
FR;11;2021-08-04;0;0;0;0;0;0;0;0;0;0;0;0;0;0;0;0;0;0
FR;11;2021-08-05;0;0;0;0;0;0;0;0;0;0;0;0;0;0;0;0;0;0
FR;11;2021-08-06;0;0;0;0;0;0;0;0;0;0;0;0;0;0;0;0;0;0
FR;11;2021-08-07;0;0;0;0;0;0;0;0;0;0;0;0;0;0;0;0;0;0
FR;11;2021-08-08;0;0;0;0;0;0;0;0;0;0;0;0;0;0;0;0;0;0
FR;11;2021-08-09;0;0;0;0;0;0;0;0;0;0;0;0;0;0;0;0;0;0
FR;11;2021-08-10;0;0;0;0;0;0;0;0;0;0;0;0;0;0;0;0;0;0
FR;11;2021-08-11;0;0;0;0;0;0;0;0;0;0;0;0;0;0;0;0;0;0
FR;11;2021-08-12;0;0;0;0;0;0;0;0;0;0;0;0;0;0;0;0;0;0
FR;11;2021-08-13;0;0;0;0;0;0;0;0;0;0;0;0;0;0;0;0;0;0
FR;11;2021-08-14;0;0;0;0;0;0;0;0;0;0;0;0;0;0;0;0;0;0
FR;11;2021-08-15;0;0;0;0;0;0;0;0;0;0;0;0;0;0;0;0;0;0
FR;11;2021-08-16;0;0;0;0;0;0;0;0;0;0;0;0;0;0;0;0;0;0
FR;11;2021-08-17;0;0;0;0;0;0;0;0;0;0;0;0;0;0;0;0;0;0
FR;11;2021-08-18;0;0;0;0;0;0;0;0;0;0;0;0;0;0;0;0;0;0
FR;11;2021-08-19;0;0;0;0;0;0;0;0;0;0;0;0;0;0;0;0;0;0
FR;11;2021-08-20;0;0;0;0;0;0;0;0;0;0;0;0;0;0;0;0;0;0
FR;11;2021-08-21;0;0;0;0;0;0;0;0;0;0;0;0;0;0;0;0;0;0
FR;11;2021-08-22;0;0;0;0;0;0;0;0;0;0;0;0;0;0;0;0;0;0
FR;11;2021-08-23;0;0;0;0;0;0;0;0;0;0;0;0;0;0;0;0;0;0
FR;11;2021-08-24;0;0;0;0;0;0;0;0;0;0;0;0;0;0;0;0;0;0
FR;11;2021-08-25;0;0;0;0;0;0;0;0;0;0;0;0;0;0;0;0;0;0
FR;11;2021-08-26;0;0;0;0;0;0;0;0;0;0;0;0;0;0;0;0;0;0
FR;11;2021-08-27;0;0;0;0;0;0;0;0;0;0;0;0;0;0;0;0;0;0
FR;11;2021-08-28;0;0;0;0;0;0;0;0;0;0;0;0;0;0;0;0;0;0
FR;11;2021-08-29;0;0;0;0;0;0;0;0;0;0;0;0;0;0;0;0;0;0
FR;11;2021-08-30;0;0;0;0;0;0;0;0;0;0;0;0;0;0;0;0;0;0
FR;11;2021-08-31;0;0;0;0;0;0;0;0;0;0;0;0;0;0;0;0;0;0
FR;11;2021-09-01;0;0;0;0;0;0;0;0;0;0;0;0;0;0;0;0;0;0
FR;11;2021-09-02;0;0;0;0;0;0;0;0;0;0;0;0;0;0;0;0;0;0
FR;11;2021-09-03;0;0;0;0;0;0;0;0;0;0;0;0;0;0;0;0;0;0
FR;11;2021-09-04;0;0;0;0;0;0;0;0;0;0;0;0;0;0;0;0;0;0
FR;11;2021-09-05;0;0;0;0;0;0;0;0;0;0;0;0;0;0;0;0;0;0
FR;11;2021-09-06;0;0;0;0;0;0;0;0;0;0;0;0;0;0;0;0;0;0
FR;11;2021-09-07;0;0;0;0;0;0;0;0;0;0;0;0;0;0;0;0;0;0
FR;11;2021-09-08;0;0;0;0;0;0;0;0;0;0;0;0;0;0;0;0;0;0
FR;11;2021-09-09;0;0;0;0;0;0;0;0;0;0;0;0;0;0;0;0;0;0
FR;11;2021-09-10;0;0;0;0;0;0;0;0;0;0;0;0;0;0;0;0;0;0
FR;11;2021-09-11;0;0;0;0;0;0;0;0;0;0;0;0;0;0;0;0;0;0
FR;11;2021-09-12;0;0;0;0;0;0;0;0;0;0;0;0;0;0;0;0;0;0
FR;11;2021-09-13;0;0;0;0;0;0;0;0;0;0;0;0;0;0;0;0;0;0
FR;11;2021-09-14;0;0;0;0;0;0;0;0;0;0;0;0;0;0;0;0;0;0
FR;11;2021-09-15;0;0;0;0;0;0;0;0;0;0;0;0;0;0;0;0;0;0
FR;11;2021-09-16;0;0;0;0;0;0;0;0;0;0;0;0;0;0;0;0;0;0
FR;11;2021-09-17;0;0;0;0;0;0;0;0;0;0;0;0;0;0;0;0;0;0
FR;11;2021-09-18;0;0;0;0;0;0;0;0;0;0;0;0;0;0;0;0;0;0
FR;11;2021-09-19;0;0;0;0;0;0;0;0;0;0;0;0;0;0;0;0;0;0
FR;11;2021-09-20;0;0;0;0;0;0;0;0;0;0;0;0;0;0;0;0;0;0
FR;11;2021-09-21;0;0;0;0;0;0;0;0;0;0;0;0;0;0;0;0;0;0
FR;11;2021-09-22;0;0;0;0;0;0;0;0;0;0;0;0;0;0;0;0;0;0
FR;11;2021-09-23;0;0;0;0;0;0;0;0;0;0;0;0;0;0;0;0;0;0
FR;11;2021-09-24;0;0;0;0;0;0;0;0;0;0;0;0;0;0;0;0;0;0
FR;11;2021-09-25;0;0;0;0;0;0;0;0;0;0;0;0;0;0;0;0;0;0
FR;11;2021-09-26;0;0;0;0;0;0;0;0;0;0;0;0;0;0;0;0;0;0
FR;11;2021-09-27;0;0;0;0;0;0;0;0;0;0;0;0;0;0;0;0;0;0
FR;11;2021-09-28;0;0;0;0;0;0;0;0;0;0;0;0;0;0;0;0;0;0
FR;11;2021-09-29;0;0;0;0;0;0;0;0;0;0;0;0;0;0;0;0;0;0
FR;11;2021-09-30;0;0;0;0;0;0;0;0;0;0;0;0;0;0;0;0;0;0
FR;11;2021-10-01;0;0;0;0;0;0;0;0;0;0;0;0;0;0;0;0;0;0
FR;11;2021-10-02;0;0;0;0;0;0;0;0;0;0;0;0;0;0;0;0;0;0
FR;11;2021-10-03;0;0;0;0;0;0;0;0;0;0;0;0;0;0;0;0;0;0
FR;11;2021-10-04;0;0;0;0;0;0;0;0;0;0;0;0;0;0;0;0;0;0
FR;11;2021-10-05;0;0;0;0;0;0;0;0;0;0;0;0;0;0;0;0;0;0
FR;11;2021-10-06;0;0;0;0;0;0;0;0;0;0;0;0;0;0;0;0;0;0
FR;11;2021-10-07;0;0;0;0;0;0;0;0;0;0;0;0;0;0;0;0;0;0
FR;11;2021-10-08;0;0;0;0;0;0;0;0;0;0;0;0;0;0;0;0;0;0
FR;11;2021-10-09;0;0;0;0;0;0;0;0;0;0;0;0;0;0;0;0;0;0
FR;11;2021-10-10;0;0;0;0;0;0;0;0;0;0;0;0;0;0;0;0;0;0
FR;11;2021-10-11;0;0;0;0;0;0;0;0;0;0;0;0;0;0;0;0;0;0
FR;11;2021-10-12;0;0;0;0;0;0;0;0;0;0;0;0;0;0;0;0;0;0
FR;11;2021-10-13;0;0;0;0;0;0;0;0;0;0;0;0;0;0;0;0;0;0
FR;11;2021-10-14;0;0;0;0;0;0;0;0;0;0;0;0;0;0;0;0;0;0
FR;11;2021-10-15;0;0;0;0;0;0;0;0;0;0;0;0;0;0;0;0;0;0
FR;11;2021-10-16;0;0;0;0;0;0;0;0;0;0;0;0;0;0;0;0;0;0
FR;11;2021-10-17;0;0;0;0;0;0;0;0;0;0;0;0;0;0;0;0;0;0
FR;11;2021-10-18;0;0;0;0;0;0;0;0;0;0;0;0;0;0;0;0;0;0
FR;11;2021-10-19;0;0;0;0;0;0;0;0;0;0;0;0;0;0;0;0;0;0
FR;11;2021-10-20;0;0;0;0;0;0;0;0;0;0;0;0;0;0;0;0;0;0
FR;11;2021-10-21;0;0;0;0;0;0;0;0;0;0;0;0;0;0;0;0;0;0
FR;11;2021-10-22;0;0;0;0;0;0;0;0;0;0;0;0;0;0;0;0;0;0
FR;11;2021-10-23;0;0;0;0;0;0;0;0;0;0;0;0;0;0;0;0;0;0
FR;11;2021-10-24;0;0;0;0;0;0;0;0;0;0;0;0;0;0;0;0;0;0
FR;11;2021-10-25;0;0;0;0;0;0;0;0;0;0;0;0;0;0;0;0;0;0
FR;11;2021-10-26;0;0;0;0;0;0;0;0;0;0;0;0;0;0;0;0;0;0
FR;11;2021-10-27;0;0;0;0;0;0;0;0;0;0;0;0;0;0;0;0;0;0
FR;11;2021-10-28;0;0;0;0;0;0;0;0;0;0;0;0;0;0;0;0;0;0
FR;11;2021-10-29;0;0;0;0;0;0;0;0;0;0;0;0;0;0;0;0;0;0
FR;11;2021-10-30;0;0;0;0;0;0;0;0;0;0;0;0;0;0;0;0;0;0
FR;11;2021-10-31;0;0;0;0;0;0;0;0;0;0;0;0;0;0;0;0;0;0
FR;11;2021-11-01;0;0;0;0;0;0;0;0;0;0;0;0;0;0;0;0;0;0
FR;11;2021-11-02;0;0;0;0;0;0;0;0;0;0;0;0;0;0;0;0;0;0
FR;11;2021-11-03;0;0;0;0;0;0;0;0;0;0;0;0;0;0;0;0;0;0
FR;11;2021-11-04;0;0;0;0;0;0;0;0;0;0;0;0;0;0;0;0;0;0
FR;11;2021-11-05;0;0;0;0;0;0;0;0;0;0;0;0;0;0;0;0;0;0
FR;11;2021-11-06;0;0;0;0;0;0;0;0;0;0;0;0;0;0;0;0;0;0
FR;11;2021-11-07;0;0;0;0;0;0;0;0;0;0;0;0;0;0;0;0;0;0
FR;11;2021-11-08;0;0;0;0;0;0;0;0;0;0;0;0;0;0;0;0;0;0
FR;11;2021-11-09;0;0;0;0;0;0;0;0;0;0;0;0;0;0;0;0;0;0
FR;11;2021-11-10;0;0;0;0;0;0;0;0;0;0;0;0;0;0;0;0;0;0
FR;11;2021-11-11;0;0;0;0;0;0;0;0;0;0;0;0;0;0;0;0;0;0
FR;11;2021-11-12;0;0;0;0;0;0;0;0;0;0;0;0;0;0;0;0;0;0
FR;11;2021-11-13;0;0;0;0;0;0;0;0;0;0;0;0;0;0;0;0;0;0
FR;11;2021-11-14;0;0;0;0;0;0;0;0;0;0;0;0;0;0;0;0;0;0
FR;11;2021-11-15;0;0;0;0;0;0;0;0;0;0;0;0;0;0;0;0;0;0
FR;11;2021-11-16;0;0;0;0;0;0;0;0;0;0;0;0;0;0;0;0;0;0
FR;11;2021-11-17;0;0;0;0;0;0;0;0;0;0;0;0;0;0;0;0;0;0
FR;11;2021-11-18;0;0;0;0;0;0;0;0;0;0;0;0;0;0;0;0;0;0
FR;11;2021-11-19;0;0;0;0;0;0;0;0;0;0;0;0;0;0;0;0;0;0
FR;11;2021-11-20;0;0;0;0;0;0;0;0;0;0;0;0;0;0;0;0;0;0
FR;11;2021-11-21;0;0;0;0;0;0;0;0;0;0;0;0;0;0;0;0;0;0
FR;11;2021-11-22;0;0;0;0;0;0;0;0;0;0;0;0;0;0;0;0;0;0
FR;11;2021-11-23;0;0;0;0;0;0;0;0;0;0;0;0;0;0;0;0;0;0
FR;11;2021-11-24;0;0;0;0;0;0;0;0;0;0;0;0;0;0;0;0;0;0
FR;11;2021-11-25;0;0;0;0;0;0;0;0;0;0;0;0;0;0;0;0;0;0
FR;11;2021-11-26;0;0;0;0;0;0;0;0;0;0;0;0;0;0;0;0;0;0
FR;11;2021-11-27;0;0;0;0;0;0;0;0;0;0;0;0;0;0;0;0;0;0
FR;11;2021-11-28;0;0;0;0;0;0;0;0;0;0;0;0;0;0;0;0;0;0
FR;11;2021-11-29;0;0;0;0;0;0;0;0;0;0;0;0;0;0;0;0;0;0
FR;11;2021-11-30;0;0;0;0;0;0;0;0;0;0;0;0;0;0;0;0;0;0
FR;11;2021-12-01;0;0;0;0;0;0;0;0;0;0;0;0;0;0;0;0;0;0
FR;11;2021-12-02;0;0;0;0;0;0;0;0;0;0;0;0;0;0;0;0;0;0
FR;11;2021-12-03;0;0;0;0;0;0;0;0;0;0;0;0;0;0;0;0;0;0
FR;11;2021-12-04;0;0;0;0;0;0;0;0;0;0;0;0;0;0;0;0;0;0
FR;11;2021-12-05;0;0;0;0;0;0;0;0;0;0;0;0;0;0;0;0;0;0
FR;11;2021-12-06;0;0;0;0;0;0;0;0;0;0;0;0;0;0;0;0;0;0
FR;11;2021-12-07;0;0;0;0;0;0;0;0;0;0;0;0;0;0;0;0;0;0
FR;11;2021-12-08;0;0;0;0;0;0;0;0;0;0;0;0;0;0;0;0;0;0
FR;11;2021-12-09;0;0;0;0;0;0;0;0;0;0;0;0;0;0;0;0;0;0
FR;11;2021-12-10;0;0;0;0;0;0;0;0;0;0;0;0;0;0;0;0;0;0
FR;11;2021-12-11;0;0;0;0;0;0;0;0;0;0;0;0;0;0;0;0;0;0
FR;11;2021-12-12;0;0;0;0;0;0;0;0;0;0;0;0;0;0;0;0;0;0
FR;11;2021-12-13;0;0;0;0;0;0;0;0;0;0;0;0;0;0;0;0;0;0
FR;11;2021-12-14;0;0;0;0;0;0;0;0;0;0;0;0;0;0;0;0;0;0
FR;11;2021-12-15;0;0;0;0;0;0;0;0;0;0;0;0;0;0;0;0;0;0
FR;11;2021-12-16;0;0;0;0;0;0;0;0;0;0;0;0;0;0;0;0;0;0
FR;11;2021-12-17;0;0;0;0;0;0;0;0;0;0;0;0;0;0;0;0;0;0
FR;11;2021-12-18;0;0;0;0;0;0;0;0;0;0;0;0;0;0;0;0;0;0
FR;11;2021-12-19;0;0;0;0;0;0;0;0;0;0;0;0;0;0;0;0;0;0
FR;11;2021-12-20;0;0;0;0;0;0;0;0;0;0;0;0;0;0;0;0;0;0
FR;11;2021-12-21;0;0;0;0;0;0;0;0;0;0;0;0;0;0;0;0;0;0
FR;11;2021-12-22;0;0;0;0;0;0;0;0;0;0;0;0;0;0;0;0;0;0
FR;11;2021-12-23;0;0;0;0;0;0;0;0;0;0;0;0;0;0;0;0;0;0
FR;11;2021-12-24;0;0;0;0;0;0;0;0;0;0;0;0;0;0;0;0;0;0
FR;11;2021-12-25;0;0;0;0;0;0;0;0;0;0;0;0;0;0;0;0;0;0
FR;11;2021-12-26;0;0;0;0;0;0;0;0;0;0;0;0;0;0;0;0;0;0
FR;11;2021-12-27;0;0;0;0;0;0;0;0;0;0;0;0;0;0;0;0;0;0
FR;11;2021-12-28;0;0;0;0;0;0;0;0;0;0;0;0;0;0;0;0;0;0
FR;11;2021-12-29;0;0;0;0;0;0;0;0;0;0;0;0;0;0;0;0;0;0
FR;11;2021-12-30;0;0;0;0;0;0;0;0;0;0;0;0;0;0;0;0;0;0
FR;11;2021-12-31;0;0;0;0;0;0;0;0;0;0;0;0;0;0;0;0;0;0
FR;11;2022-01-01;0;0;0;0;0;0;0;0;0;0;0;0;0;0;0;0;0;0
FR;11;2022-01-02;0;0;0;0;0;0;0;0;0;0;0;0;0;0;0;0;0;0
FR;11;2022-01-03;0;0;0;0;0;0;0;0;0;0;0;0;0;0;0;0;0;0
FR;11;2022-01-04;0;0;0;0;0;0;0;0;0;0;0;0;0;0;0;0;0;0
FR;11;2022-01-05;0;0;0;0;0;0;0;0;0;0;0;0;0;0;0;0;0;0
FR;11;2022-01-06;0;0;0;0;0;0;0;0;0;0;0;0;0;0;0;0;0;0
FR;11;2022-01-07;0;0;0;0;0;0;0;0;0;0;0;0;0;0;0;0;0;0
FR;11;2022-01-08;0;0;0;0;0;0;0;0;0;0;0;0;0;0;0;0;0;0
FR;11;2022-01-09;0;0;0;0;0;0;0;0;0;0;0;0;0;0;0;0;0;0
FR;11;2022-01-10;0;0;0;0;0;0;0;0;0;0;0;0;0;0;0;0;0;0
FR;11;2022-01-11;0;0;0;0;0;0;0;0;0;0;0;0;0;0;0;0;0;0
FR;11;2022-01-12;0;0;0;0;0;0;0;0;0;0;0;0;0;0;0;0;0;0
FR;11;2022-01-13;0;0;0;0;0;0;0;0;0;0;0;0;0;0;0;0;0;0
FR;11;2022-01-14;0;0;0;0;0;0;0;0;0;0;0;0;0;0;0;0;0;0
FR;11;2022-01-15;0;0;0;0;0;0;0;0;0;0;0;0;0;0;0;0;0;0
FR;11;2022-01-16;0;0;0;0;0;0;0;0;0;0;0;0;0;0;0;0;0;0
FR;11;2022-01-17;0;0;0;0;0;0;0;0;0;0;0;0;0;0;0;0;0;0
FR;11;2022-01-18;0;0;0;0;0;0;0;0;0;0;0;0;0;0;0;0;0;0
FR;11;2022-01-19;0;0;0;0;0;0;0;0;0;0;0;0;0;0;0;0;0;0
FR;11;2022-01-20;0;0;0;0;0;0;0;0;0;0;0;0;0;0;0;0;0;0
FR;11;2022-01-21;0;0;0;0;0;0;0;0;0;0;0;0;0;0;0;0;0;0
FR;11;2022-01-22;0;0;0;0;0;0;0;0;0;0;0;0;0;0;0;0;0;0
FR;11;2022-01-23;0;0;0;0;0;0;0;0;0;0;0;0;0;0;0;0;0;0
FR;11;2022-01-24;0;0;0;0;0;0;0;0;0;0;0;0;0;0;0;0;0;0
FR;11;2022-01-25;0;0;0;0;0;0;0;0;0;0;0;0;0;0;0;0;0;0
FR;11;2022-01-26;0;0;0;0;0;0;0;0;0;0;0;0;0;0;0;0;0;0
FR;11;2022-01-27;0;0;0;0;0;0;0;0;0;0;0;0;0;0;0;0;0;0
FR;11;2022-01-28;0;0;0;0;0;0;0;0;0;0;0;0;0;0;0;0;0;0
FR;11;2022-01-29;0;0;0;0;0;0;0;0;0;0;0;0;0;0;0;0;0;0
FR;11;2022-01-30;0;0;0;0;0;0;0;0;0;0;0;0;0;0;0;0;0;0
FR;11;2022-01-31;0;0;0;0;0;0;0;0;0;0;0;0;0;0;0;0;0;0
FR;11;2022-02-01;0;0;0;0;0;0;0;0;0;0;0;0;0;0;0;0;0;0
FR;11;2022-02-02;0;0;0;0;0;0;0;0;0;0;0;0;0;0;0;0;0;0
FR;11;2022-02-03;0;0;0;0;0;0;0;0;0;0;0;0;0;0;0;0;0;0
FR;11;2022-02-04;0;0;0;0;0;0;0;0;0;0;0;0;0;0;0;0;0;0
FR;11;2022-02-05;0;0;0;0;0;0;0;0;0;0;0;0;0;0;0;0;0;0
FR;11;2022-02-06;0;0;0;0;0;0;0;0;0;0;0;0;0;0;0;0;0;0
FR;11;2022-02-07;0;0;0;0;0;0;0;0;0;0;0;0;0;0;0;0;0;0
FR;11;2022-02-08;0;0;0;0;0;0;0;0;0;0;0;0;0;0;0;0;0;0
FR;11;2022-02-09;0;0;0;0;0;0;0;0;0;0;0;0;0;0;0;0;0;0
FR;11;2022-02-10;0;0;0;0;0;0;0;0;0;0;0;0;0;0;0;0;0;0
FR;11;2022-02-11;0;0;0;0;0;0;0;0;0;0;0;0;0;0;0;0;0;0
FR;11;2022-02-12;0;0;0;0;0;0;0;0;0;0;0;0;0;0;0;0;0;0
FR;11;2022-02-13;0;0;0;0;0;0;0;0;0;0;0;0;0;0;0;0;0;0
FR;11;2022-02-14;0;0;0;0;0;0;0;0;0;0;0;0;0;0;0;0;0;0
FR;11;2022-02-15;0;0;0;0;0;0;0;0;0;0;0;0;0;0;0;0;0;0
FR;11;2022-02-16;0;0;0;0;0;0;0;0;0;0;0;0;0;0;0;0;0;0
FR;11;2022-02-17;0;0;0;0;0;0;0;0;0;0;0;0;0;0;0;0;0;0
FR;11;2022-02-18;0;0;0;0;0;0;0;0;0;0;0;0;0;0;0;0;0;0
FR;11;2022-02-19;0;0;0;0;0;0;0;0;0;0;0;0;0;0;0;0;0;0
FR;11;2022-02-20;0;0;0;0;0;0;0;0;0;0;0;0;0;0;0;0;0;0
FR;11;2022-02-21;0;0;0;0;0;0;0;0;0;0;0;0;0;0;0;0;0;0
FR;11;2022-02-22;0;0;0;0;0;0;0;0;0;0;0;0;0;0;0;0;0;0
FR;11;2022-02-23;0;0;0;0;0;0;0;0;0;0;0;0;0;0;0;0;0;0
FR;11;2022-02-24;0;0;0;0;0;0;0;0;0;0;0;0;0;0;0;0;0;0
FR;11;2022-02-25;0;0;0;0;0;0;0;0;0;0;0;0;0;0;0;0;0;0
FR;11;2022-02-26;0;0;0;0;0;0;0;0;0;0;0;0;0;0;0;0;0;0
FR;11;2022-02-27;0;0;0;0;0;0;0;0;0;0;0;0;0;0;0;0;0;0
FR;11;2022-02-28;0;0;0;0;0;0;0;0;0;0;0;0;0;0;0;0;0;0
FR;11;2022-03-01;0;0;0;0;0;0;0;0;0;0;0;0;0;0;0;0;0;0
FR;11;2022-03-02;0;0;0;0;0;0;0;0;0;0;0;0;0;0;0;0;0;0
FR;11;2022-03-03;0;0;0;0;0;0;0;0;0;0;0;0;0;0;0;0;0;0
FR;11;2022-03-04;0;0;0;0;0;0;0;0;0;0;0;0;0;0;0;0;0;0
FR;11;2022-03-05;0;0;0;0;0;0;0;0;0;0;0;0;0;0;0;0;0;0
FR;11;2022-03-06;0;0;0;0;0;0;0;0;0;0;0;0;0;0;0;0;0;0
FR;11;2022-03-07;0;0;0;0;0;0;0;0;0;0;0;0;0;0;0;0;0;0
FR;11;2022-03-08;0;0;0;0;0;0;0;0;0;0;0;0;0;0;0;0;0;0
FR;11;2022-03-09;0;0;0;0;0;0;0;0;0;0;0;0;0;0;0;0;0;0
FR;11;2022-03-10;0;0;0;0;0;0;0;0;0;0;0;0;0;0;0;0;0;0
FR;11;2022-03-11;0;0;0;0;0;0;0;0;0;0;0;0;0;0;0;0;0;0
FR;11;2022-03-12;0;0;0;0;0;0;0;0;0;0;0;0;0;0;0;0;0;0
FR;11;2022-03-13;0;0;0;0;0;0;0;0;0;0;0;0;0;0;0;0;0;0
FR;11;2022-03-14;0;0;0;0;0;0;0;0;0;0;0;0;0;0;0;0;0;0
FR;11;2022-03-15;0;0;0;0;0;0;0;0;0;0;0;0;0;0;0;0;0;0
FR;11;2022-03-16;0;0;0;0;0;0;0;0;0;0;0;0;0;0;0;0;0;0
FR;11;2022-03-17;0;0;0;0;0;0;0;0;0;0;0;0;0;0;0;0;0;0
FR;11;2022-03-18;0;0;0;0;0;0;0;0;0;0;0;0;0;0;0;0;0;0
FR;11;2022-03-19;0;0;0;0;0;0;0;0;0;0;0;0;0;0;0;0;0;0
FR;11;2022-03-20;0;0;0;0;0;0;0;0;0;0;0;0;0;0;0;0;0;0
FR;11;2022-03-21;0;0;0;0;0;0;0;0;0;0;0;0;0;0;0;0;0;0
FR;11;2022-03-22;0;0;0;0;0;0;0;0;0;0;0;0;0;0;0;0;0;0
FR;11;2022-03-23;0;0;0;0;0;0;0;0;0;0;0;0;0;0;0;0;0;0
FR;11;2022-03-24;0;0;0;0;0;0;0;0;0;0;0;0;0;0;0;0;0;0
FR;11;2022-03-25;0;0;0;0;0;0;0;0;0;0;0;0;0;0;0;0;0;0
FR;11;2022-03-26;0;0;0;0;0;0;0;0;0;0;0;0;0;0;0;0;0;0
FR;11;2022-03-27;0;0;0;0;0;0;0;0;0;0;0;0;0;0;0;0;0;0
FR;11;2022-03-28;0;0;0;0;0;0;0;0;0;0;0;0;0;0;0;0;0;0
FR;11;2022-03-29;0;0;0;0;0;0;0;0;0;0;0;0;0;0;0;0;0;0
FR;11;2022-03-30;0;0;0;0;0;0;0;0;0;0;0;0;0;0;0;0;0;0
FR;11;2022-03-31;0;0;0;0;0;0;0;0;0;0;0;0;0;0;0;0;0;0
FR;11;2022-04-01;0;0;0;0;0;0;0;0;0;0;0;0;0;0;0;0;0;0
FR;11;2022-04-02;0;0;0;0;0;0;0;0;0;0;0;0;0;0;0;0;0;0
FR;11;2022-04-03;0;0;0;0;0;0;0;0;0;0;0;0;0;0;0;0;0;0
FR;11;2022-04-04;0;0;0;0;0;0;0;0;0;0;0;0;0;0;0;0;0;0
FR;11;2022-04-05;0;0;0;0;0;0;0;0;0;0;0;0;0;0;0;0;0;0
FR;11;2022-04-06;0;0;0;0;0;0;0;0;0;0;0;0;0;0;0;0;0;0
FR;11;2022-04-07;0;0;0;0;0;0;0;0;0;0;0;0;0;0;0;0;0;0
FR;11;2022-04-08;0;0;0;0;0;0;0;0;0;0;0;0;0;0;0;0;0;0
FR;11;2022-04-09;0;0;0;0;0;0;0;0;0;0;0;0;0;0;0;0;0;0
FR;11;2022-04-10;0;0;0;0;0;0;0;0;0;0;0;0;0;0;0;0;0;0
FR;11;2022-04-11;0;0;0;0;0;0;0;0;0;0;0;0;0;0;0;0;0;0
FR;11;2022-04-12;0;0;0;0;0;0;0;0;0;0;0;0;0;0;0;0;0;0
FR;11;2022-04-13;0;0;0;0;0;0;0;0;0;0;0;0;0;0;0;0;0;0
FR;11;2022-04-14;0;0;0;0;0;0;0;0;0;0;0;0;0;0;0;0;0;0
FR;11;2022-04-15;0;0;0;0;0;0;0;0;0;0;0;0;0;0;0;0;0;0
FR;11;2022-04-16;0;0;0;0;0;0;0;0;0;0;0;0;0;0;0;0;0;0
FR;11;2022-04-17;0;0;0;0;0;0;0;0;0;0;0;0;0;0;0;0;0;0
FR;11;2022-04-18;0;0;0;0;0;0;0;0;0;0;0;0;0;0;0;0;0;0
FR;11;2022-04-19;0;0;0;0;0;0;0;0;0;0;0;0;0;0;0;0;0;0
FR;11;2022-04-20;0;0;0;0;0;0;0;0;0;0;0;0;0;0;0;0;0;0
FR;11;2022-04-21;0;0;0;0;0;0;0;0;0;0;0;0;0;0;0;0;0;0
FR;11;2022-04-22;0;0;0;0;0;0;0;0;0;0;0;0;0;0;0;0;0;0
FR;11;2022-04-23;0;0;0;0;0;0;0;0;0;0;0;0;0;0;0;0;0;0
FR;11;2022-04-24;0;0;0;0;0;0;0;0;0;0;0;0;0;0;0;0;0;0
FR;11;2022-04-25;0;0;0;0;0;0;0;0;0;0;0;0;0;0;0;0;0;0
FR;11;2022-04-26;0;0;0;0;0;0;0;0;0;0;0;0;0;0;0;0;0;0
FR;11;2022-04-27;0;0;0;0;0;0;0;0;0;0;0;0;0;0;0;0;0;0
FR;11;2022-04-28;0;0;0;0;0;0;0;0;0;0;0;0;0;0;0;0;0;0
FR;11;2022-04-29;0;0;0;0;0;0;0;0;0;0;0;0;0;0;0;0;0;0
FR;11;2022-04-30;0;0;0;0;0;0;0;0;0;0;0;0;0;0;0;0;0;0
FR;11;2022-05-01;0;0;0;0;0;0;0;0;0;0;0;0;0;0;0;0;0;0
FR;11;2022-05-02;0;0;0;0;0;0;0;0;0;0;0;0;0;0;0;0;0;0
FR;11;2022-05-03;0;0;0;0;0;0;0;0;0;0;0;0;0;0;0;0;0;0
FR;11;2022-05-04;0;0;0;0;0;0;0;0;0;0;0;0;0;0;0;0;0;0
FR;11;2022-05-05;0;0;0;0;0;0;0;0;0;0;0;0;0;0;0;0;0;0
FR;11;2022-05-06;0;0;0;0;0;0;0;0;0;0;0;0;0;0;0;0;0;0
FR;11;2022-05-07;0;0;0;0;0;0;0;0;0;0;0;0;0;0;0;0;0;0
FR;11;2022-05-08;0;0;0;0;0;0;0;0;0;0;0;0;0;0;0;0;0;0
FR;11;2022-05-09;0;0;0;0;0;0;0;0;0;0;0;0;0;0;0;0;0;0
FR;11;2022-05-10;0;0;0;0;0;0;0;0;0;0;0;0;0;0;0;0;0;0
FR;11;2022-05-11;0;0;0;0;0;0;0;0;0;0;0;0;0;0;0;0;0;0
FR;11;2022-05-12;0;0;0;0;0;0;0;0;0;0;0;0;0;0;0;0;0;0
FR;11;2022-05-13;0;0;0;0;0;0;0;0;0;0;0;0;0;0;0;0;0;0
FR;11;2022-05-14;0;0;0;0;0;0;0;0;0;0;0;0;0;0;0;0;0;0
FR;11;2022-05-15;0;0;0;0;0;0;0;0;0;0;0;0;0;0;0;0;0;0
FR;11;2022-05-16;0;0;0;0;0;0;0;0;0;0;0;0;0;0;0;0;0;0
FR;11;2022-05-17;0;0;0;0;0;0;0;0;0;0;0;0;0;0;0;0;0;0
FR;11;2022-05-18;0;0;0;0;0;0;0;0;0;0;0;0;0;0;0;0;0;0
FR;11;2022-05-19;0;0;0;0;0;0;0;0;0;0;0;0;0;0;0;0;0;0
FR;11;2022-05-20;0;0;0;0;0;0;0;0;0;0;0;0;0;0;0;0;0;0
FR;11;2022-05-21;0;0;0;0;0;0;0;0;0;0;0;0;0;0;0;0;0;0
FR;11;2022-05-22;0;0;0;0;0;0;0;0;0;0;0;0;0;0;0;0;0;0
FR;11;2022-05-23;0;0;0;0;0;0;0;0;0;0;0;0;0;0;0;0;0;0
FR;11;2022-05-24;0;0;0;0;0;0;0;0;0;0;0;0;0;0;0;0;0;0
FR;11;2022-05-25;0;0;0;0;0;0;0;0;0;0;0;0;0;0;0;0;0;0
FR;11;2022-05-26;0;0;0;0;0;0;0;0;0;0;0;0;0;0;0;0;0;0
FR;11;2022-05-27;0;0;0;0;0;0;0;0;0;0;0;0;0;0;0;0;0;0
FR;11;2022-05-28;0;0;0;0;0;0;0;0;0;0;0;0;0;0;0;0;0;0
FR;11;2022-05-29;0;0;0;0;0;0;0;0;0;0;0;0;0;0;0;0;0;0
FR;11;2022-05-30;0;0;0;0;0;0;0;0;0;0;0;0;0;0;0;0;0;0
FR;11;2022-05-31;0;0;0;0;0;0;0;0;0;0;0;0;0;0;0;0;0;0
FR;11;2022-06-01;0;0;0;0;0;0;0;0;0;0;0;0;0;0;0;0;0;0
FR;11;2022-06-02;0;0;0;0;0;0;0;0;0;0;0;0;0;0;0;0;0;0
FR;11;2022-06-03;0;0;0;0;0;0;0;0;0;0;0;0;0;0;0;0;0;0
FR;11;2022-06-04;0;0;0;0;0;0;0;0;0;0;0;0;0;0;0;0;0;0
FR;11;2022-06-05;0;0;0;0;0;0;0;0;0;0;0;0;0;0;0;0;0;0
FR;11;2022-06-06;0;0;0;0;0;0;0;0;0;0;0;0;0;0;0;0;0;0
FR;11;2022-06-07;0;0;0;0;0;0;0;0;0;0;0;0;0;0;0;0;0;0
FR;11;2022-06-08;0;0;0;0;0;0;0;0;0;0;0;0;0;0;0;0;0;0
FR;11;2022-06-09;0;0;0;0;0;0;0;0;0;0;0;0;0;0;0;0;0;0
FR;11;2022-06-10;0;0;0;0;0;0;0;0;0;0;0;0;0;0;0;0;0;0
FR;11;2022-06-11;0;0;0;0;0;0;0;0;0;0;0;0;0;0;0;0;0;0
FR;11;2022-06-12;0;0;0;0;0;0;0;0;0;0;0;0;0;0;0;0;0;0
FR;11;2022-06-13;0;0;0;0;0;0;0;0;0;0;0;0;0;0;0;0;0;0
FR;11;2022-06-14;0;0;0;0;0;0;0;0;0;0;0;0;0;0;0;0;0;0
FR;11;2022-06-15;0;0;0;0;0;0;0;0;0;0;0;0;0;0;0;0;0;0
FR;11;2022-06-16;0;0;0;0;0;0;0;0;0;0;0;0;0;0;0;0;0;0
FR;11;2022-06-17;0;0;0;0;0;0;0;0;0;0;0;0;0;0;0;0;0;0
FR;11;2022-06-18;0;0;0;0;0;0;0;0;0;0;0;0;0;0;0;0;0;0
FR;11;2022-06-19;0;0;0;0;0;0;0;0;0;0;0;0;0;0;0;0;0;0
FR;11;2022-06-20;0;0;0;0;0;0;0;0;0;0;0;0;0;0;0;0;0;0
FR;11;2022-06-21;0;0;0;0;0;0;0;0;0;0;0;0;0;0;0;0;0;0
FR;11;2022-06-22;0;0;0;0;0;0;0;0;0;0;0;0;0;0;0;0;0;0
FR;11;2022-06-23;0;0;0;0;0;0;0;0;0;0;0;0;0;0;0;0;0;0
FR;11;2022-06-24;0;0;0;0;0;0;0;0;0;0;0;0;0;0;0;0;0;0
FR;11;2022-06-25;0;0;0;0;0;0;0;0;0;0;0;0;0;0;0;0;0;0
FR;11;2022-06-26;0;0;0;0;0;0;0;0;0;0;0;0;0;0;0;0;0;0
FR;11;2022-06-27;0;0;0;0;0;0;0;0;0;0;0;0;0;0;0;0;0;0
FR;11;2022-06-28;0;0;0;0;0;0;0;0;0;0;0;0;0;0;0;0;0;0
FR;11;2022-06-29;0;0;0;0;0;0;0;0;0;0;0;0;0;0;0;0;0;0
FR;11;2022-06-30;0;0;0;0;0;0;0;0;0;0;0;0;0;0;0;0;0;0
FR;11;2022-07-01;0;0;0;0;0;0;0;0;0;0;0;0;0;0;0;0;0;0
FR;11;2022-07-02;0;0;0;0;0;0;0;0;0;0;0;0;0;0;0;0;0;0
FR;11;2022-07-03;0;0;0;0;0;0;0;0;0;0;0;0;0;0;0;0;0;0
FR;11;2022-07-04;0;0;0;0;0;0;0;0;0;0;0;0;0;0;0;0;0;0
FR;11;2022-07-05;0;0;0;0;0;0;0;0;0;0;0;0;0;0;0;0;0;0
FR;11;2022-07-06;0;0;0;0;0;0;0;0;0;0;0;0;0;0;0;0;0;0
FR;11;2022-07-07;0;0;0;0;0;0;0;0;0;0;0;0;0;0;0;0;0;0
FR;11;2022-07-08;0;0;0;0;0;0;0;0;0;0;0;0;0;0;0;0;0;0
FR;11;2022-07-09;0;0;0;0;0;0;0;0;0;0;0;0;0;0;0;0;0;0
FR;11;2022-07-10;0;0;0;0;0;0;0;0;0;0;0;0;0;0;0;0;0;0
FR;11;2022-07-11;0;0;0;0;0;0;0;0;0;0;0;0;0;0;0;0;0;0
FR;11;2022-07-12;0;0;0;0;0;0;0;0;0;0;0;0;0;0;0;0;0;0
FR;11;2022-07-13;0;0;0;0;0;0;0;0;0;0;0;0;0;0;0;0;0;0
FR;11;2022-07-14;0;0;0;0;0;0;0;0;0;0;0;0;0;0;0;0;0;0
FR;11;2022-07-15;0;0;0;0;0;0;0;0;0;0;0;0;0;0;0;0;0;0
FR;11;2022-07-16;0;0;0;0;0;0;0;0;0;0;0;0;0;0;0;0;0;0
FR;11;2022-07-17;0;0;0;0;0;0;0;0;0;0;0;0;0;0;0;0;0;0
FR;11;2022-07-18;0;0;0;0;0;0;0;0;0;0;0;0;0;0;0;0;0;0
FR;11;2022-07-19;0;0;0;0;0;0;0;0;0;0;0;0;0;0;0;0;0;0
FR;11;2022-07-20;0;0;0;0;0;0;0;0;0;0;0;0;0;0;0;0;0;0
FR;11;2022-07-21;0;0;0;0;0;0;0;0;0;0;0;0;0;0;0;0;0;0
FR;11;2022-07-22;0;0;0;0;0;0;0;0;0;0;0;0;0;0;0;0;0;0
FR;11;2022-07-23;0;0;0;0;0;0;0;0;0;0;0;0;0;0;0;0;0;0
FR;11;2022-07-24;0;0;0;0;0;0;0;0;0;0;0;0;0;0;0;0;0;0
FR;11;2022-07-25;0;0;0;0;0;0;0;0;0;0;0;0;0;0;0;0;0;0
FR;11;2022-07-26;0;0;0;0;0;0;0;0;0;0;0;0;0;0;0;0;0;0
FR;11;2022-07-27;0;0;0;0;0;0;0;0;0;0;0;0;0;0;0;0;0;0
FR;11;2022-07-28;0;0;0;0;0;0;0;0;0;0;0;0;0;0;0;0;0;0
FR;11;2022-07-29;0;0;0;0;0;0;0;0;0;0;0;0;0;0;0;0;0;0
FR;11;2022-07-30;0;0;0;0;0;0;0;0;0;0;0;0;0;0;0;0;0;0
FR;11;2022-07-31;0;0;0;0;0;0;0;0;0;0;0;0;0;0;0;0;0;0
FR;11;2022-08-01;0;0;0;0;0;0;0;0;0;0;0;0;0;0;0;0;0;0
FR;11;2022-08-02;0;0;0;0;0;0;0;0;0;0;0;0;0;0;0;0;0;0
FR;11;2022-08-03;0;0;0;0;0;0;0;0;0;0;0;0;0;0;0;0;0;0
FR;11;2022-08-04;0;0;0;0;0;0;0;0;0;0;0;0;0;0;0;0;0;0
FR;11;2022-08-05;0;0;0;0;0;0;0;0;0;0;0;0;0;0;0;0;0;0
FR;11;2022-08-06;0;0;0;0;0;0;0;0;0;0;0;0;0;0;0;0;0;0
FR;11;2022-08-07;0;0;0;0;0;0;0;0;0;0;0;0;0;0;0;0;0;0
FR;11;2022-08-08;0;0;0;0;0;0;0;0;0;0;0;0;0;0;0;0;0;0
FR;11;2022-08-09;0;0;0;0;0;0;0;0;0;0;0;0;0;0;0;0;0;0
FR;11;2022-08-10;0;0;0;0;0;0;0;0;0;0;0;0;0;0;0;0;0;0
FR;11;2022-08-11;0;0;0;0;0;0;0;0;0;0;0;0;0;0;0;0;0;0
FR;11;2022-08-12;0;0;0;0;0;0;0;0;0;0;0;0;0;0;0;0;0;0
FR;11;2022-08-13;0;0;0;0;0;0;0;0;0;0;0;0;0;0;0;0;0;0
FR;11;2022-08-14;0;0;0;0;0;0;0;0;0;0;0;0;0;0;0;0;0;0
FR;11;2022-08-15;0;0;0;0;0;0;0;0;0;0;0;0;0;0;0;0;0;0
FR;11;2022-08-16;0;0;0;0;0;0;0;0;0;0;0;0;0;0;0;0;0;0
FR;11;2022-08-17;0;0;0;0;0;0;0;0;0;0;0;0;0;0;0;0;0;0
FR;11;2022-08-18;0;0;0;0;0;0;0;0;0;0;0;0;0;0;0;0;0;0
FR;11;2022-08-19;0;0;0;0;0;0;0;0;0;0;0;0;0;0;0;0;0;0
FR;11;2022-08-20;0;0;0;0;0;0;0;0;0;0;0;0;0;0;0;0;0;0
FR;11;2022-08-21;0;0;0;0;0;0;0;0;0;0;0;0;0;0;0;0;0;0
FR;11;2022-08-22;0;0;0;0;0;0;0;0;0;0;0;0;0;0;0;0;0;0
FR;11;2022-08-23;0;0;0;0;0;0;0;0;0;0;0;0;0;0;0;0;0;0
FR;11;2022-08-24;0;0;0;0;0;0;0;0;0;0;0;0;0;0;0;0;0;0
FR;11;2022-08-25;0;0;0;0;0;0;0;0;0;0;0;0;0;0;0;0;0;0
FR;11;2022-08-26;0;0;0;0;0;0;0;0;0;0;0;0;0;0;0;0;0;0
FR;11;2022-08-27;0;0;0;0;0;0;0;0;0;0;0;0;0;0;0;0;0;0
FR;11;2022-08-28;0;0;0;0;0;0;0;0;0;0;0;0;0;0;0;0;0;0
FR;11;2022-08-29;0;0;0;0;0;0;0;0;0;0;0;0;0;0;0;0;0;0
FR;11;2022-08-30;0;0;0;0;0;0;0;0;0;0;0;0;0;0;0;0;0;0
FR;11;2022-08-31;0;0;0;0;0;0;0;0;0;0;0;0;0;0;0;0;0;0
FR;11;2022-09-01;0;0;0;0;0;0;0;0;0;0;0;0;0;0;0;0;0;0
FR;11;2022-09-02;0;0;0;0;0;0;0;0;0;0;0;0;0;0;0;0;0;0
FR;11;2022-09-03;0;0;0;0;0;0;0;0;0;0;0;0;0;0;0;0;0;0
FR;11;2022-09-04;0;0;0;0;0;0;0;0;0;0;0;0;0;0;0;0;0;0
FR;11;2022-09-05;0;0;0;0;0;0;0;0;0;0;0;0;0;0;0;0;0;0
FR;11;2022-09-06;0;0;0;0;0;0;0;0;0;0;0;0;0;0;0;0;0;0
FR;11;2022-09-07;0;0;0;0;0;0;0;0;0;0;0;0;0;0;0;0;0;0
FR;11;2022-09-08;0;0;0;0;0;0;0;0;0;0;0;0;0;0;0;0;0;0
FR;11;2022-09-09;0;0;0;0;0;0;0;0;0;0;0;0;0;0;0;0;0;0
FR;11;2022-09-10;0;0;0;0;0;0;0;0;0;0;0;0;0;0;0;0;0;0
FR;11;2022-09-11;0;0;0;0;0;0;0;0;0;0;0;0;0;0;0;0;0;0
FR;11;2022-09-12;0;0;0;0;0;0;0;0;0;0;0;0;0;0;0;0;0;0
FR;11;2022-09-13;0;0;0;0;0;0;0;0;0;0;0;0;0;0;0;0;0;0
FR;11;2022-09-14;0;0;0;0;0;0;0;0;0;0;0;0;0;0;0;0;0;0
FR;11;2022-09-15;0;0;0;0;0;0;0;0;0;0;0;0;0;0;0;0;0;0
FR;11;2022-09-16;0;0;0;0;0;0;0;0;0;0;0;0;0;0;0;0;0;0
FR;11;2022-09-17;0;0;0;0;0;0;0;0;0;0;0;0;0;0;0;0;0;0
FR;11;2022-09-18;0;0;0;0;0;0;0;0;0;0;0;0;0;0;0;0;0;0
FR;11;2022-09-19;0;0;0;0;0;0;0;0;0;0;0;0;0;0;0;0;0;0
FR;11;2022-09-20;0;0;0;0;0;0;0;0;0;0;0;0;0;0;0;0;0;0
FR;11;2022-09-21;0;0;0;0;0;0;0;0;0;0;0;0;0;0;0;0;0;0
FR;11;2022-09-22;0;0;0;0;0;0;0;0;0;0;0;0;0;0;0;0;0;0
FR;11;2022-09-23;0;0;0;0;0;0;0;0;0;0;0;0;0;0;0;0;0;0
FR;11;2022-09-24;0;0;0;0;0;0;0;0;0;0;0;0;0;0;0;0;0;0
FR;11;2022-09-25;0;0;0;0;0;0;0;0;0;0;0;0;0;0;0;0;0;0
FR;11;2022-09-26;0;0;0;0;0;0;0;0;0;0;0;0;0;0;0;0;0;0
FR;11;2022-09-27;0;0;0;0;0;0;0;0;0;0;0;0;0;0;0;0;0;0
FR;11;2022-09-28;0;0;0;0;0;0;0;0;0;0;0;0;0;0;0;0;0;0
FR;11;2022-09-29;0;0;0;0;0;0;0;0;0;0;0;0;0;0;0;0;0;0
FR;11;2022-09-30;0;0;0;0;0;0;0;0;0;0;0;0;0;0;0;0;0;0
FR;11;2022-10-01;0;0;0;0;0;0;0;0;0;0;0;0;0;0;0;0;0;0
FR;11;2022-10-02;0;0;0;0;0;0;0;0;0;0;0;0;0;0;0;0;0;0
FR;11;2022-10-03;0;0;0;0;0;0;0;0;0;0;0;0;0;0;0;0;0;0
FR;11;2022-10-04;0;0;0;0;0;0;0;0;0;0;0;0;0;0;0;0;0;0
FR;11;2022-10-05;0;0;0;0;0;0;0;0;0;0;0;0;0;0;0;0;0;0
FR;11;2022-10-06;0;0;0;0;0;0;0;0;0;0;0;0;0;0;0;0;0;0
FR;11;2022-10-07;0;0;0;0;0;0;0;0;0;0;0;0;0;0;0;0;0;0
FR;11;2022-10-08;0;0;0;0;0;0;0;0;0;0;0;0;0;0;0;0;0;0
FR;11;2022-10-09;0;0;0;0;0;0;0;0;0;0;0;0;0;0;0;0;0;0
FR;11;2022-10-10;0;0;0;0;0;0;0;0;0;0;0;0;0;0;0;0;0;0
FR;11;2022-10-11;0;0;0;0;0;0;0;0;0;0;0;0;0;0;0;0;0;0
FR;11;2022-10-12;0;0;0;0;0;0;0;0;0;0;0;0;0;0;0;0;0;0
FR;11;2022-10-13;0;0;0;0;0;0;0;0;0;0;0;0;0;0;0;0;0;0
FR;11;2022-10-14;0;0;0;0;0;0;0;0;0;0;0;0;0;0;0;0;0;0
FR;11;2022-10-15;0;0;0;0;0;0;0;0;0;0;0;0;0;0;0;0;0;0
FR;11;2022-10-16;0;0;0;0;0;0;0;0;0;0;0;0;0;0;0;0;0;0
FR;11;2022-10-17;0;0;0;0;0;0;0;0;0;0;0;0;0;0;0;0;0;0
FR;11;2022-10-18;0;0;0;0;0;0;0;0;0;0;0;0;0;0;0;0;0;0
FR;11;2022-10-19;0;0;0;0;0;0;0;0;0;0;0;0;0;0;0;0;0;0
FR;11;2022-10-20;0;0;0;0;0;0;0;0;0;0;0;0;0;0;0;0;0;0
FR;11;2022-10-21;0;0;0;0;0;0;0;0;0;0;0;0;0;0;0;0;0;0
FR;11;2022-10-22;0;0;0;0;0;0;0;0;0;0;0;0;0;0;0;0;0;0
FR;11;2022-10-23;0;0;0;0;0;0;0;0;0;0;0;0;0;0;0;0;0;0
FR;11;2022-10-24;0;0;0;0;0;0;0;0;0;0;0;0;0;0;0;0;0;0
FR;11;2022-10-25;0;0;0;0;0;0;0;0;0;0;0;0;0;0;0;0;0;0
FR;11;2022-10-26;0;0;0;0;0;0;0;0;0;0;0;0;0;0;0;0;0;0
FR;11;2022-10-27;0;0;0;0;0;0;0;0;0;0;0;0;0;0;0;0;0;0
FR;11;2022-10-28;0;0;0;0;0;0;0;0;0;0;0;0;0;0;0;0;0;0
FR;11;2022-10-29;0;0;0;0;0;0;0;0;0;0;0;0;0;0;0;0;0;0
FR;11;2022-10-30;0;0;0;0;0;0;0;0;0;0;0;0;0;0;0;0;0;0
FR;11;2022-10-31;0;0;0;0;0;0;0;0;0;0;0;0;0;0;0;0;0;0
FR;11;2022-11-01;0;0;0;0;0;0;0;0;0;0;0;0;0;0;0;0;0;0
FR;11;2022-11-02;0;0;0;0;0;0;0;0;0;0;0;0;0;0;0;0;0;0
FR;11;2022-11-03;0;0;0;0;0;0;0;0;0;0;0;0;0;0;0;0;0;0
FR;11;2022-11-04;0;0;0;0;0;0;0;0;0;0;0;0;0;0;0;0;0;0
FR;11;2022-11-05;0;0;0;0;0;0;0;0;0;0;0;0;0;0;0;0;0;0
FR;11;2022-11-06;0;0;0;0;0;0;0;0;0;0;0;0;0;0;0;0;0;0
FR;11;2022-11-07;0;0;0;0;0;0;0;0;0;0;0;0;0;0;0;0;0;0
FR;11;2022-11-08;0;0;0;0;0;0;0;0;0;0;0;0;0;0;0;0;0;0
FR;11;2022-11-09;0;0;0;0;0;0;0;0;0;0;0;0;0;0;0;0;0;0
FR;11;2022-11-10;0;0;0;0;0;0;0;0;0;0;0;0;0;0;0;0;0;0
FR;11;2022-11-11;0;0;0;0;0;0;0;0;0;0;0;0;0;0;0;0;0;0
FR;11;2022-11-12;0;0;0;0;0;0;0;0;0;0;0;0;0;0;0;0;0;0
FR;11;2022-11-13;0;0;0;0;0;0;0;0;0;0;0;0;0;0;0;0;0;0
FR;11;2022-11-14;0;0;0;0;0;0;0;0;0;0;0;0;0;0;0;0;0;0
FR;11;2022-11-15;0;0;0;0;0;0;0;0;0;0;0;0;0;0;0;0;0;0
FR;11;2022-11-16;0;0;0;0;0;0;0;0;0;0;0;0;0;0;0;0;0;0
FR;11;2022-11-17;0;0;0;0;0;0;0;0;0;0;0;0;0;0;0;0;0;0
FR;11;2022-11-18;0;0;0;0;0;0;0;0;0;0;0;0;0;0;0;0;0;0
FR;11;2022-11-19;0;0;0;0;0;0;0;0;0;0;0;0;0;0;0;0;0;0
FR;11;2022-11-20;0;0;0;0;0;0;0;0;0;0;0;0;0;0;0;0;0;0
FR;11;2022-11-21;0;0;0;0;0;0;0;0;0;0;0;0;0;0;0;0;0;0
FR;11;2022-11-22;0;0;0;0;0;0;0;0;0;0;0;0;0;0;0;0;0;0
FR;11;2022-11-23;0;0;0;0;0;0;0;0;0;0;0;0;0;0;0;0;0;0
FR;11;2022-11-24;0;0;0;0;0;0;0;0;0;0;0;0;0;0;0;0;0;0
FR;11;2022-11-25;0;0;0;0;0;0;0;0;0;0;0;0;0;0;0;0;0;0
FR;11;2022-11-26;0;0;0;0;0;0;0;0;0;0;0;0;0;0;0;0;0;0
FR;11;2022-11-27;0;0;0;0;0;0;0;0;0;0;0;0;0;0;0;0;0;0
FR;11;2022-11-28;0;0;0;0;0;0;0;0;0;0;0;0;0;0;0;0;0;0
FR;11;2022-11-29;0;0;0;0;0;0;0;0;0;0;0;0;0;0;0;0;0;0
FR;11;2022-11-30;0;0;0;0;0;0;0;0;0;0;0;0;0;0;0;0;0;0
FR;11;2022-12-01;0;0;0;0;0;0;0;0;0;0;0;0;0;0;0;0;0;0
FR;11;2022-12-02;0;0;0;0;0;0;0;0;0;0;0;0;0;0;0;0;0;0
FR;11;2022-12-03;0;0;0;0;0;0;0;0;0;0;0;0;0;0;0;0;0;0
FR;11;2022-12-04;0;0;0;0;0;0;0;0;0;0;0;0;0;0;0;0;0;0
FR;11;2022-12-05;0;0;0;0;0;0;0;0;0;0;0;0;0;0;0;0;0;0
FR;11;2022-12-06;0;0;0;0;0;0;0;0;0;0;0;0;0;0;0;0;0;0
FR;11;2022-12-07;0;0;0;0;0;0;0;0;0;0;0;0;0;0;0;0;0;0
FR;11;2022-12-08;0;0;0;0;0;0;0;0;0;0;0;0;0;0;0;0;0;0
FR;11;2022-12-09;0;0;0;0;0;0;0;0;0;0;0;0;0;0;0;0;0;0
FR;11;2022-12-10;0;0;0;0;0;0;0;0;0;0;0;0;0;0;0;0;0;0
FR;11;2022-12-11;0;0;0;0;0;0;0;0;0;0;0;0;0;0;0;0;0;0
FR;11;2022-12-12;0;0;0;0;0;0;0;0;0;0;0;0;0;0;0;0;0;0
FR;11;2022-12-13;0;0;0;0;0;0;0;0;0;0;0;0;0;0;0;0;0;0
FR;11;2022-12-14;0;0;0;0;0;0;0;0;0;0;0;0;0;0;0;0;0;0
FR;11;2022-12-15;0;0;0;0;0;0;0;0;0;0;0;0;0;0;0;0;0;0
FR;11;2022-12-16;0;0;0;0;0;0;0;0;0;0;0;0;0;0;0;0;0;0
FR;11;2022-12-17;0;0;0;0;0;0;0;0;0;0;0;0;0;0;0;0;0;0
FR;11;2022-12-18;0;0;0;0;0;0;0;0;0;0;0;0;0;0;0;0;0;0
FR;11;2022-12-19;0;0;0;0;0;0;0;0;0;0;0;0;0;0;0;0;0;0
FR;11;2022-12-20;0;0;0;0;0;0;0;0;0;0;0;0;0;0;0;0;0;0
FR;11;2022-12-21;0;0;0;0;0;0;0;0;0;0;0;0;0;0;0;0;0;0
FR;11;2022-12-22;0;0;0;0;0;0;0;0;0;0;0;0;0;0;0;0;0;0
FR;11;2022-12-23;0;0;0;0;0;0;0;0;0;0;0;0;0;0;0;0;0;0
FR;11;2022-12-24;0;0;0;0;0;0;0;0;0;0;0;0;0;0;0;0;0;0
FR;11;2022-12-25;0;0;0;0;0;0;0;0;0;0;0;0;0;0;0;0;0;0
FR;11;2022-12-26;0;0;0;0;0;0;0;0;0;0;0;0;0;0;0;0;0;0
FR;11;2022-12-27;0;0;0;0;0;0;0;0;0;0;0;0;0;0;0;0;0;0
FR;11;2022-12-28;0;0;0;0;0;0;0;0;0;0;0;0;0;0;0;0;0;0
FR;11;2022-12-29;0;0;0;0;0;0;0;0;0;0;0;0;0;0;0;0;0;0
FR;11;2022-12-30;0;0;0;0;0;0;0;0;0;0;0;0;0;0;0;0;0;0
FR;11;2022-12-31;0;0;0;0;0;0;0;0;0;0;0;0;0;0;0;0;0;0
FR;11;2023-01-01;0;0;0;0;0;0;0;0;0;0;0;0;0;0;0;0;0;0
FR;11;2023-01-02;0;0;0;0;0;0;0;0;0;0;0;0;0;0;0;0;0;0
FR;11;2023-01-03;0;0;0;0;0;0;0;0;0;0;0;0;0;0;0;0;0;0
FR;11;2023-01-04;0;0;0;0;0;0;0;0;0;0;0;0;0;0;0;0;0;0
FR;11;2023-01-05;0;0;0;0;0;0;0;0;0;0;0;0;0;0;0;0;0;0
FR;11;2023-01-06;0;0;0;0;0;0;0;0;0;0;0;0;0;0;0;0;0;0
FR;11;2023-01-07;0;0;0;0;0;0;0;0;0;0;0;0;0;0;0;0;0;0
FR;11;2023-01-08;0;0;0;0;0;0;0;0;0;0;0;0;0;0;0;0;0;0
FR;11;2023-01-09;0;0;0;0;0;0;0;0;0;0;0;0;0;0;0;0;0;0
FR;11;2023-01-10;0;0;0;0;0;0;0;0;0;0;0;0;0;0;0;0;0;0
FR;11;2023-01-11;0;0;0;0;0;0;0;0;0;0;0;0;0;0;0;0;0;0
FR;11;2023-01-12;0;0;0;0;0;0;0;0;0;0;0;0;0;0;0;0;0;0
FR;11;2023-01-13;0;0;0;0;0;0;0;0;0;0;0;0;0;0;0;0;0;0
FR;11;2023-01-14;0;0;0;0;0;0;0;0;0;0;0;0;0;0;0;0;0;0
FR;11;2023-01-15;0;0;0;0;0;0;0;0;0;0;0;0;0;0;0;0;0;0
FR;11;2023-01-16;0;0;0;0;0;0;0;0;0;0;0;0;0;0;0;0;0;0
FR;11;2023-01-17;0;0;0;0;0;0;0;0;0;0;0;0;0;0;0;0;0;0
FR;11;2023-01-18;0;0;0;0;0;0;0;0;0;0;0;0;0;0;0;0;0;0
FR;11;2023-01-19;0;0;0;0;0;0;0;0;0;0;0;0;0;0;0;0;0;0
FR;11;2023-01-20;0;0;0;0;0;0;0;0;0;0;0;0;0;0;0;0;0;0
FR;11;2023-01-21;0;0;0;0;0;0;0;0;0;0;0;0;0;0;0;0;0;0
FR;11;2023-01-22;0;0;0;0;0;0;0;0;0;0;0;0;0;0;0;0;0;0
FR;11;2023-01-23;0;0;0;0;0;0;0;0;0;0;0;0;0;0;0;0;0;0
FR;11;2023-01-24;0;0;0;0;0;0;0;0;0;0;0;0;0;0;0;0;0;0
FR;11;2023-01-25;0;0;0;0;0;0;0;0;0;0;0;0;0;0;0;0;0;0
FR;11;2023-01-26;0;0;0;0;0;0;0;0;0;0;0;0;0;0;0;0;0;0
FR;11;2023-01-27;0;0;0;0;0;0;0;0;0;0;0;0;0;0;0;0;0;0
FR;11;2023-01-28;0;0;0;0;0;0;0;0;0;0;0;0;0;0;0;0;0;0
FR;11;2023-01-29;0;0;0;0;0;0;0;0;0;0;0;0;0;0;0;0;0;0
FR;11;2023-01-30;0;0;0;0;0;0;0;0;0;0;0;0;0;0;0;0;0;0
FR;11;2023-01-31;0;0;0;0;0;0;0;0;0;0;0;0;0;0;0;0;0;0
FR;11;2023-02-01;0;0;0;0;0;0;0;0;0;0;0;0;0;0;0;0;0;0
FR;11;2023-02-02;0;0;0;0;0;0;0;0;0;0;0;0;0;0;0;0;0;0
FR;11;2023-02-03;0;0;0;0;0;0;0;0;0;0;0;0;0;0;0;0;0;0
FR;11;2023-02-04;0;0;0;0;0;0;0;0;0;0;0;0;0;0;0;0;0;0
FR;11;2023-02-05;0;0;0;0;0;0;0;0;0;0;0;0;0;0;0;0;0;0
FR;11;2023-02-06;1;0;0;0;0;0;0;0;0;1;0;0;0;0;0;0;0;0
FR;11;2023-02-07;0;0;0;0;0;0;0;0;0;1;0;0;0;0;0;0;0;0
FR;11;2023-02-08;2;0;0;0;0;0;0;0;0;3;0;0;0;0;0;0;0;0
FR;11;2023-02-09;2;0;0;0;0;0;0;0;0;5;0;0;0;0;0;0;0;0
FR;11;2023-02-10;0;0;0;0;0;0;0;0;0;5;0;0;0;0;0;0;0;0
FR;11;2023-02-11;0;0;0;0;0;0;0;0;0;5;0;0;0;0;0;0;0;0
FR;11;2023-02-12;0;0;0;0;0;0;0;0;0;5;0;0;0;0;0;0;0;0
FR;11;2023-02-13;2;0;0;0;0;0;0;0;0;7;0;0;0;0;0;0;0;0
FR;11;2023-02-14;0;0;0;0;0;0;0;0;0;7;0;0;0;0;0;0;0;0
FR;11;2023-02-15;2;0;0;0;0;0;0;0;0;9;0;0;0;0;0;0;0;0
FR;11;2023-02-16;0;0;0;0;0;0;0;0;0;9;0;0;0;0;0;0;0;0
FR;11;2023-02-17;0;0;0;0;0;0;0;0;0;9;0;0;0;0;0;0;0;0
FR;11;2023-02-18;0;0;0;0;0;0;0;0;0;9;0;0;0;0;0;0;0;0
FR;11;2023-02-19;0;0;0;0;0;0;0;0;0;9;0;0;0;0;0;0;0;0
FR;11;2023-02-20;0;0;0;0;0;0;0;0;0;9;0;0;0;0;0;0;0;0
FR;11;2023-02-21;1;0;0;0;0;0;0;0;0;10;0;0;0;0;0;0;0;0
FR;11;2023-02-22;0;0;0;0;0;0;0;0;0;10;0;0;0;0;0;0;0;0
FR;11;2023-02-23;0;0;0;0;0;0;0;0;0;10;0;0;0;0;0;0;0;0
FR;11;2023-02-24;0;0;0;0;0;0;0;0;0;10;0;0;0;0;0;0;0;0
FR;11;2023-02-25;0;0;0;0;0;0;0;0;0;10;0;0;0;0;0;0;0;0
FR;11;2023-02-26;0;0;2;0;0;2;0;0;0;10;0;2;0;0;2;0;0;0
FR;11;2023-02-27;0;0;0;0;0;0;0;0;0;10;0;2;0;0;2;0;0;0
FR;11;2023-02-28;1;1;0;0;1;0;0;0;0;11;1;2;0;1;2;0;0;0
FR;11;2023-03-01;0;1;0;0;1;0;0;0;0;11;2;2;0;2;2;0;0;0
FR;11;2023-03-02;0;0;0;0;0;0;0;0;0;11;2;2;0;2;2;0;0;0
FR;11;2023-03-03;0;0;0;0;0;0;0;0;0;11;2;2;0;2;2;0;0;0
FR;11;2023-03-04;2;1;0;0;1;0;0;0;0;13;3;2;0;3;2;0;0;0
FR;11;2023-03-05;0;0;0;0;0;0;0;0;0;13;3;2;0;3;2;0;0;0
FR;11;2023-03-06;4;0;1;0;0;1;0;0;0;17;3;3;0;3;3;0;0;0
FR;11;2023-03-07;0;1;0;0;1;0;0;0;0;17;4;3;0;4;3;0;0;0
FR;11;2023-03-08;1;1;0;0;1;0;0;0;0;18;5;3;0;5;3;0;0;0
FR;11;2023-03-09;0;0;0;0;0;0;0;0;0;18;5;3;0;5;3;0;0;0
FR;11;2023-03-10;0;0;0;0;0;0;0;0;0;18;5;3;0;5;3;0;0;0
FR;11;2023-03-11;2;0;0;0;0;0;0;0;0;20;5;3;0;5;3;0;0;0
FR;11;2023-03-12;0;1;0;0;1;0;0;0;0;20;6;3;0;6;3;0;0;0
FR;11;2023-03-13;0;0;0;0;0;0;0;0;0;20;6;3;0;6;3;0;0;0
FR;11;2023-03-14;0;0;0;0;0;0;0;0;0;20;6;3;0;6;3;0;0;0
FR;11;2023-03-15;0;1;0;0;1;0;0;0;0;20;7;3;0;7;3;0;0;0
FR;11;2023-03-16;0;0;0;0;0;0;0;0;0;20;7;3;0;7;3;0;0;0
FR;11;2023-03-17;0;0;0;0;0;0;0;0;0;20;7;3;0;7;3;0;0;0
FR;11;2023-03-18;1;0;0;0;0;0;0;0;0;21;7;3;0;7;3;0;0;0
FR;11;2023-03-19;0;0;0;0;0;0;0;0;0;21;7;3;0;7;3;0;0;0
FR;11;2023-03-20;0;0;0;0;0;0;0;0;0;21;7;3;0;7;3;0;0;0
FR;11;2023-03-21;1;0;0;0;0;0;0;0;0;22;7;3;0;7;3;0;0;0
FR;11;2023-03-22;2;0;0;0;0;0;0;0;0;24;7;3;0;7;3;0;0;0
FR;11;2023-03-23;0;0;0;1;0;0;1;0;0;24;7;3;1;7;3;1;0;0
FR;11;2023-03-24;0;0;0;0;0;0;0;0;0;24;7;3;1;7;3;1;0;0
FR;11;2023-03-25;1;1;0;0;1;0;0;0;0;25;8;3;1;8;3;1;0;0
FR;11;2023-03-26;0;0;0;0;0;0;0;0;0;25;8;3;1;8;3;1;0;0
FR;12;2020-12-27;0;0;0;0;0;0;0;0;0;0;0;0;0;0;0;0;0;0
FR;12;2020-12-28;0;0;0;0;0;0;0;0;0;0;0;0;0;0;0;0;0;0
FR;12;2020-12-29;0;0;0;0;0;0;0;0;0;0;0;0;0;0;0;0;0;0
FR;12;2020-12-30;0;0;0;0;0;0;0;0;0;0;0;0;0;0;0;0;0;0
FR;12;2020-12-31;0;0;0;0;0;0;0;0;0;0;0;0;0;0;0;0;0;0
FR;12;2021-01-01;0;0;0;0;0;0;0;0;0;0;0;0;0;0;0;0;0;0
FR;12;2021-01-02;0;0;0;0;0;0;0;0;0;0;0;0;0;0;0;0;0;0
FR;12;2021-01-03;0;0;0;0;0;0;0;0;0;0;0;0;0;0;0;0;0;0
FR;12;2021-01-04;0;0;0;0;0;0;0;0;0;0;0;0;0;0;0;0;0;0
FR;12;2021-01-05;0;0;0;0;0;0;0;0;0;0;0;0;0;0;0;0;0;0
FR;12;2021-01-06;0;0;0;0;0;0;0;0;0;0;0;0;0;0;0;0;0;0
FR;12;2021-01-07;0;0;0;0;0;0;0;0;0;0;0;0;0;0;0;0;0;0
FR;12;2021-01-08;0;0;0;0;0;0;0;0;0;0;0;0;0;0;0;0;0;0
FR;12;2021-01-09;0;0;0;0;0;0;0;0;0;0;0;0;0;0;0;0;0;0
FR;12;2021-01-10;0;0;0;0;0;0;0;0;0;0;0;0;0;0;0;0;0;0
FR;12;2021-01-11;0;0;0;0;0;0;0;0;0;0;0;0;0;0;0;0;0;0
FR;12;2021-01-12;0;0;0;0;0;0;0;0;0;0;0;0;0;0;0;0;0;0
FR;12;2021-01-13;0;0;0;0;0;0;0;0;0;0;0;0;0;0;0;0;0;0
FR;12;2021-01-14;0;0;0;0;0;0;0;0;0;0;0;0;0;0;0;0;0;0
FR;12;2021-01-15;0;0;0;0;0;0;0;0;0;0;0;0;0;0;0;0;0;0
FR;12;2021-01-16;0;0;0;0;0;0;0;0;0;0;0;0;0;0;0;0;0;0
FR;12;2021-01-17;0;0;0;0;0;0;0;0;0;0;0;0;0;0;0;0;0;0
FR;12;2021-01-18;0;0;0;0;0;0;0;0;0;0;0;0;0;0;0;0;0;0
FR;12;2021-01-19;0;0;0;0;0;0;0;0;0;0;0;0;0;0;0;0;0;0
FR;12;2021-01-20;0;0;0;0;0;0;0;0;0;0;0;0;0;0;0;0;0;0
FR;12;2021-01-21;0;0;0;0;0;0;0;0;0;0;0;0;0;0;0;0;0;0
FR;12;2021-01-22;0;0;0;0;0;0;0;0;0;0;0;0;0;0;0;0;0;0
FR;12;2021-01-23;0;0;0;0;0;0;0;0;0;0;0;0;0;0;0;0;0;0
FR;12;2021-01-24;0;0;0;0;0;0;0;0;0;0;0;0;0;0;0;0;0;0
FR;12;2021-01-25;0;0;0;0;0;0;0;0;0;0;0;0;0;0;0;0;0;0
FR;12;2021-01-26;0;0;0;0;0;0;0;0;0;0;0;0;0;0;0;0;0;0
FR;12;2021-01-27;0;0;0;0;0;0;0;0;0;0;0;0;0;0;0;0;0;0
FR;12;2021-01-28;0;0;0;0;0;0;0;0;0;0;0;0;0;0;0;0;0;0
FR;12;2021-01-29;0;0;0;0;0;0;0;0;0;0;0;0;0;0;0;0;0;0
FR;12;2021-01-30;0;0;0;0;0;0;0;0;0;0;0;0;0;0;0;0;0;0
FR;12;2021-01-31;0;0;0;0;0;0;0;0;0;0;0;0;0;0;0;0;0;0
FR;12;2021-02-01;0;0;0;0;0;0;0;0;0;0;0;0;0;0;0;0;0;0
FR;12;2021-02-02;0;0;0;0;0;0;0;0;0;0;0;0;0;0;0;0;0;0
FR;12;2021-02-03;0;0;0;0;0;0;0;0;0;0;0;0;0;0;0;0;0;0
FR;12;2021-02-04;0;0;0;0;0;0;0;0;0;0;0;0;0;0;0;0;0;0
FR;12;2021-02-05;0;0;0;0;0;0;0;0;0;0;0;0;0;0;0;0;0;0
FR;12;2021-02-06;0;0;0;0;0;0;0;0;0;0;0;0;0;0;0;0;0;0
FR;12;2021-02-07;0;0;0;0;0;0;0;0;0;0;0;0;0;0;0;0;0;0
FR;12;2021-02-08;0;0;0;0;0;0;0;0;0;0;0;0;0;0;0;0;0;0
FR;12;2021-02-09;0;0;0;0;0;0;0;0;0;0;0;0;0;0;0;0;0;0
FR;12;2021-02-10;0;0;0;0;0;0;0;0;0;0;0;0;0;0;0;0;0;0
FR;12;2021-02-11;0;0;0;0;0;0;0;0;0;0;0;0;0;0;0;0;0;0
FR;12;2021-02-12;0;0;0;0;0;0;0;0;0;0;0;0;0;0;0;0;0;0
FR;12;2021-02-13;0;0;0;0;0;0;0;0;0;0;0;0;0;0;0;0;0;0
FR;12;2021-02-14;0;0;0;0;0;0;0;0;0;0;0;0;0;0;0;0;0;0
FR;12;2021-02-15;0;0;0;0;0;0;0;0;0;0;0;0;0;0;0;0;0;0
FR;12;2021-02-16;0;0;0;0;0;0;0;0;0;0;0;0;0;0;0;0;0;0
FR;12;2021-02-17;0;0;0;0;0;0;0;0;0;0;0;0;0;0;0;0;0;0
FR;12;2021-02-18;0;0;0;0;0;0;0;0;0;0;0;0;0;0;0;0;0;0
FR;12;2021-02-19;0;0;0;0;0;0;0;0;0;0;0;0;0;0;0;0;0;0
FR;12;2021-02-20;0;0;0;0;0;0;0;0;0;0;0;0;0;0;0;0;0;0
FR;12;2021-02-21;0;0;0;0;0;0;0;0;0;0;0;0;0;0;0;0;0;0
FR;12;2021-02-22;0;0;0;0;0;0;0;0;0;0;0;0;0;0;0;0;0;0
FR;12;2021-02-23;0;0;0;0;0;0;0;0;0;0;0;0;0;0;0;0;0;0
FR;12;2021-02-24;0;0;0;0;0;0;0;0;0;0;0;0;0;0;0;0;0;0
FR;12;2021-02-25;0;0;0;0;0;0;0;0;0;0;0;0;0;0;0;0;0;0
FR;12;2021-02-26;0;0;0;0;0;0;0;0;0;0;0;0;0;0;0;0;0;0
FR;12;2021-02-27;0;0;0;0;0;0;0;0;0;0;0;0;0;0;0;0;0;0
FR;12;2021-02-28;0;0;0;0;0;0;0;0;0;0;0;0;0;0;0;0;0;0
FR;12;2021-03-01;0;0;0;0;0;0;0;0;0;0;0;0;0;0;0;0;0;0
FR;12;2021-03-02;0;0;0;0;0;0;0;0;0;0;0;0;0;0;0;0;0;0
FR;12;2021-03-03;0;0;0;0;0;0;0;0;0;0;0;0;0;0;0;0;0;0
FR;12;2021-03-04;0;0;0;0;0;0;0;0;0;0;0;0;0;0;0;0;0;0
FR;12;2021-03-05;0;0;0;0;0;0;0;0;0;0;0;0;0;0;0;0;0;0
FR;12;2021-03-06;0;0;0;0;0;0;0;0;0;0;0;0;0;0;0;0;0;0
FR;12;2021-03-07;0;0;0;0;0;0;0;0;0;0;0;0;0;0;0;0;0;0
FR;12;2021-03-08;0;0;0;0;0;0;0;0;0;0;0;0;0;0;0;0;0;0
FR;12;2021-03-09;0;0;0;0;0;0;0;0;0;0;0;0;0;0;0;0;0;0
FR;12;2021-03-10;0;0;0;0;0;0;0;0;0;0;0;0;0;0;0;0;0;0
FR;12;2021-03-11;0;0;0;0;0;0;0;0;0;0;0;0;0;0;0;0;0;0
FR;12;2021-03-12;0;0;0;0;0;0;0;0;0;0;0;0;0;0;0;0;0;0
FR;12;2021-03-13;0;0;0;0;0;0;0;0;0;0;0;0;0;0;0;0;0;0
FR;12;2021-03-14;0;0;0;0;0;0;0;0;0;0;0;0;0;0;0;0;0;0
FR;12;2021-03-15;0;0;0;0;0;0;0;0;0;0;0;0;0;0;0;0;0;0
FR;12;2021-03-16;0;0;0;0;0;0;0;0;0;0;0;0;0;0;0;0;0;0
FR;12;2021-03-17;0;0;0;0;0;0;0;0;0;0;0;0;0;0;0;0;0;0
FR;12;2021-03-18;0;0;0;0;0;0;0;0;0;0;0;0;0;0;0;0;0;0
FR;12;2021-03-19;0;0;0;0;0;0;0;0;0;0;0;0;0;0;0;0;0;0
FR;12;2021-03-20;0;0;0;0;0;0;0;0;0;0;0;0;0;0;0;0;0;0
FR;12;2021-03-21;0;0;0;0;0;0;0;0;0;0;0;0;0;0;0;0;0;0
FR;12;2021-03-22;0;0;0;0;0;0;0;0;0;0;0;0;0;0;0;0;0;0
FR;12;2021-03-23;0;0;0;0;0;0;0;0;0;0;0;0;0;0;0;0;0;0
FR;12;2021-03-24;0;0;0;0;0;0;0;0;0;0;0;0;0;0;0;0;0;0
FR;12;2021-03-25;0;0;0;0;0;0;0;0;0;0;0;0;0;0;0;0;0;0
FR;12;2021-03-26;0;0;0;0;0;0;0;0;0;0;0;0;0;0;0;0;0;0
FR;12;2021-03-27;0;0;0;0;0;0;0;0;0;0;0;0;0;0;0;0;0;0
FR;12;2021-03-28;0;0;0;0;0;0;0;0;0;0;0;0;0;0;0;0;0;0
FR;12;2021-03-29;0;0;0;0;0;0;0;0;0;0;0;0;0;0;0;0;0;0
FR;12;2021-03-30;0;0;0;0;0;0;0;0;0;0;0;0;0;0;0;0;0;0
FR;12;2021-03-31;0;0;0;0;0;0;0;0;0;0;0;0;0;0;0;0;0;0
FR;12;2021-04-01;0;0;0;0;0;0;0;0;0;0;0;0;0;0;0;0;0;0
FR;12;2021-04-02;0;0;0;0;0;0;0;0;0;0;0;0;0;0;0;0;0;0
FR;12;2021-04-03;0;0;0;0;0;0;0;0;0;0;0;0;0;0;0;0;0;0
FR;12;2021-04-04;0;0;0;0;0;0;0;0;0;0;0;0;0;0;0;0;0;0
FR;12;2021-04-05;0;0;0;0;0;0;0;0;0;0;0;0;0;0;0;0;0;0
FR;12;2021-04-06;0;0;0;0;0;0;0;0;0;0;0;0;0;0;0;0;0;0
FR;12;2021-04-07;0;0;0;0;0;0;0;0;0;0;0;0;0;0;0;0;0;0
FR;12;2021-04-08;0;0;0;0;0;0;0;0;0;0;0;0;0;0;0;0;0;0
FR;12;2021-04-09;0;0;0;0;0;0;0;0;0;0;0;0;0;0;0;0;0;0
FR;12;2021-04-10;0;0;0;0;0;0;0;0;0;0;0;0;0;0;0;0;0;0
FR;12;2021-04-11;0;0;0;0;0;0;0;0;0;0;0;0;0;0;0;0;0;0
FR;12;2021-04-12;0;0;0;0;0;0;0;0;0;0;0;0;0;0;0;0;0;0
FR;12;2021-04-13;0;0;0;0;0;0;0;0;0;0;0;0;0;0;0;0;0;0
FR;12;2021-04-14;0;0;0;0;0;0;0;0;0;0;0;0;0;0;0;0;0;0
FR;12;2021-04-15;0;0;0;0;0;0;0;0;0;0;0;0;0;0;0;0;0;0
FR;12;2021-04-16;0;0;0;0;0;0;0;0;0;0;0;0;0;0;0;0;0;0
FR;12;2021-04-17;0;0;0;0;0;0;0;0;0;0;0;0;0;0;0;0;0;0
FR;12;2021-04-18;0;0;0;0;0;0;0;0;0;0;0;0;0;0;0;0;0;0
FR;12;2021-04-19;0;0;0;0;0;0;0;0;0;0;0;0;0;0;0;0;0;0
FR;12;2021-04-20;0;0;0;0;0;0;0;0;0;0;0;0;0;0;0;0;0;0
FR;12;2021-04-21;0;0;0;0;0;0;0;0;0;0;0;0;0;0;0;0;0;0
FR;12;2021-04-22;0;0;0;0;0;0;0;0;0;0;0;0;0;0;0;0;0;0
FR;12;2021-04-23;0;0;0;0;0;0;0;0;0;0;0;0;0;0;0;0;0;0
FR;12;2021-04-24;0;0;0;0;0;0;0;0;0;0;0;0;0;0;0;0;0;0
FR;12;2021-04-25;0;0;0;0;0;0;0;0;0;0;0;0;0;0;0;0;0;0
FR;12;2021-04-26;0;0;0;0;0;0;0;0;0;0;0;0;0;0;0;0;0;0
FR;12;2021-04-27;0;0;0;0;0;0;0;0;0;0;0;0;0;0;0;0;0;0
FR;12;2021-04-28;0;0;0;0;0;0;0;0;0;0;0;0;0;0;0;0;0;0
FR;12;2021-04-29;0;0;0;0;0;0;0;0;0;0;0;0;0;0;0;0;0;0
FR;12;2021-04-30;0;0;0;0;0;0;0;0;0;0;0;0;0;0;0;0;0;0
FR;12;2021-05-01;0;0;0;0;0;0;0;0;0;0;0;0;0;0;0;0;0;0
FR;12;2021-05-02;0;0;0;0;0;0;0;0;0;0;0;0;0;0;0;0;0;0
FR;12;2021-05-03;0;0;0;0;0;0;0;0;0;0;0;0;0;0;0;0;0;0
FR;12;2021-05-04;0;0;0;0;0;0;0;0;0;0;0;0;0;0;0;0;0;0
FR;12;2021-05-05;0;0;0;0;0;0;0;0;0;0;0;0;0;0;0;0;0;0
FR;12;2021-05-06;0;0;0;0;0;0;0;0;0;0;0;0;0;0;0;0;0;0
FR;12;2021-05-07;0;0;0;0;0;0;0;0;0;0;0;0;0;0;0;0;0;0
FR;12;2021-05-08;0;0;0;0;0;0;0;0;0;0;0;0;0;0;0;0;0;0
FR;12;2021-05-09;0;0;0;0;0;0;0;0;0;0;0;0;0;0;0;0;0;0
FR;12;2021-05-10;0;0;0;0;0;0;0;0;0;0;0;0;0;0;0;0;0;0
FR;12;2021-05-11;0;0;0;0;0;0;0;0;0;0;0;0;0;0;0;0;0;0
FR;12;2021-05-12;0;0;0;0;0;0;0;0;0;0;0;0;0;0;0;0;0;0
FR;12;2021-05-13;0;0;0;0;0;0;0;0;0;0;0;0;0;0;0;0;0;0
FR;12;2021-05-14;0;0;0;0;0;0;0;0;0;0;0;0;0;0;0;0;0;0
FR;12;2021-05-15;0;0;0;0;0;0;0;0;0;0;0;0;0;0;0;0;0;0
FR;12;2021-05-16;0;0;0;0;0;0;0;0;0;0;0;0;0;0;0;0;0;0
FR;12;2021-05-17;0;0;0;0;0;0;0;0;0;0;0;0;0;0;0;0;0;0
FR;12;2021-05-18;0;0;0;0;0;0;0;0;0;0;0;0;0;0;0;0;0;0
FR;12;2021-05-19;0;0;0;0;0;0;0;0;0;0;0;0;0;0;0;0;0;0
FR;12;2021-05-20;0;0;0;0;0;0;0;0;0;0;0;0;0;0;0;0;0;0
FR;12;2021-05-21;0;0;0;0;0;0;0;0;0;0;0;0;0;0;0;0;0;0
FR;12;2021-05-22;0;0;0;0;0;0;0;0;0;0;0;0;0;0;0;0;0;0
FR;12;2021-05-23;0;0;0;0;0;0;0;0;0;0;0;0;0;0;0;0;0;0
FR;12;2021-05-24;0;0;0;0;0;0;0;0;0;0;0;0;0;0;0;0;0;0
FR;12;2021-05-25;0;0;0;0;0;0;0;0;0;0;0;0;0;0;0;0;0;0
FR;12;2021-05-26;0;0;0;0;0;0;0;0;0;0;0;0;0;0;0;0;0;0
FR;12;2021-05-27;0;0;0;0;0;0;0;0;0;0;0;0;0;0;0;0;0;0
FR;12;2021-05-28;0;0;0;0;0;0;0;0;0;0;0;0;0;0;0;0;0;0
FR;12;2021-05-29;0;0;0;0;0;0;0;0;0;0;0;0;0;0;0;0;0;0
FR;12;2021-05-30;0;0;0;0;0;0;0;0;0;0;0;0;0;0;0;0;0;0
FR;12;2021-05-31;0;0;0;0;0;0;0;0;0;0;0;0;0;0;0;0;0;0
FR;12;2021-06-01;0;0;0;0;0;0;0;0;0;0;0;0;0;0;0;0;0;0
FR;12;2021-06-02;0;0;0;0;0;0;0;0;0;0;0;0;0;0;0;0;0;0
FR;12;2021-06-03;0;0;0;0;0;0;0;0;0;0;0;0;0;0;0;0;0;0
FR;12;2021-06-04;0;0;0;0;0;0;0;0;0;0;0;0;0;0;0;0;0;0
FR;12;2021-06-05;0;0;0;0;0;0;0;0;0;0;0;0;0;0;0;0;0;0
FR;12;2021-06-06;0;0;0;0;0;0;0;0;0;0;0;0;0;0;0;0;0;0
FR;12;2021-06-07;0;0;0;0;0;0;0;0;0;0;0;0;0;0;0;0;0;0
FR;12;2021-06-08;0;0;0;0;0;0;0;0;0;0;0;0;0;0;0;0;0;0
FR;12;2021-06-09;0;0;0;0;0;0;0;0;0;0;0;0;0;0;0;0;0;0
FR;12;2021-06-10;0;0;0;0;0;0;0;0;0;0;0;0;0;0;0;0;0;0
FR;12;2021-06-11;0;0;0;0;0;0;0;0;0;0;0;0;0;0;0;0;0;0
FR;12;2021-06-12;0;0;0;0;0;0;0;0;0;0;0;0;0;0;0;0;0;0
FR;12;2021-06-13;0;0;0;0;0;0;0;0;0;0;0;0;0;0;0;0;0;0
FR;12;2021-06-14;0;0;0;0;0;0;0;0;0;0;0;0;0;0;0;0;0;0
FR;12;2021-06-15;0;0;0;0;0;0;0;0;0;0;0;0;0;0;0;0;0;0
FR;12;2021-06-16;0;0;0;0;0;0;0;0;0;0;0;0;0;0;0;0;0;0
FR;12;2021-06-17;0;0;0;0;0;0;0;0;0;0;0;0;0;0;0;0;0;0
FR;12;2021-06-18;0;0;0;0;0;0;0;0;0;0;0;0;0;0;0;0;0;0
FR;12;2021-06-19;0;0;0;0;0;0;0;0;0;0;0;0;0;0;0;0;0;0
FR;12;2021-06-20;0;0;0;0;0;0;0;0;0;0;0;0;0;0;0;0;0;0
FR;12;2021-06-21;0;0;0;0;0;0;0;0;0;0;0;0;0;0;0;0;0;0
FR;12;2021-06-22;0;0;0;0;0;0;0;0;0;0;0;0;0;0;0;0;0;0
FR;12;2021-06-23;0;0;0;0;0;0;0;0;0;0;0;0;0;0;0;0;0;0
FR;12;2021-06-24;0;0;0;0;0;0;0;0;0;0;0;0;0;0;0;0;0;0
FR;12;2021-06-25;0;0;0;0;0;0;0;0;0;0;0;0;0;0;0;0;0;0
FR;12;2021-06-26;0;0;0;0;0;0;0;0;0;0;0;0;0;0;0;0;0;0
FR;12;2021-06-27;0;0;0;0;0;0;0;0;0;0;0;0;0;0;0;0;0;0
FR;12;2021-06-28;0;0;0;0;0;0;0;0;0;0;0;0;0;0;0;0;0;0
FR;12;2021-06-29;0;0;0;0;0;0;0;0;0;0;0;0;0;0;0;0;0;0
FR;12;2021-06-30;0;0;0;0;0;0;0;0;0;0;0;0;0;0;0;0;0;0
FR;12;2021-07-01;0;0;0;0;0;0;0;0;0;0;0;0;0;0;0;0;0;0
FR;12;2021-07-02;0;0;0;0;0;0;0;0;0;0;0;0;0;0;0;0;0;0
FR;12;2021-07-03;0;0;0;0;0;0;0;0;0;0;0;0;0;0;0;0;0;0
FR;12;2021-07-04;0;0;0;0;0;0;0;0;0;0;0;0;0;0;0;0;0;0
FR;12;2021-07-05;0;0;0;0;0;0;0;0;0;0;0;0;0;0;0;0;0;0
FR;12;2021-07-06;0;0;0;0;0;0;0;0;0;0;0;0;0;0;0;0;0;0
FR;12;2021-07-07;0;0;0;0;0;0;0;0;0;0;0;0;0;0;0;0;0;0
FR;12;2021-07-08;0;0;0;0;0;0;0;0;0;0;0;0;0;0;0;0;0;0
FR;12;2021-07-09;0;0;0;0;0;0;0;0;0;0;0;0;0;0;0;0;0;0
FR;12;2021-07-10;0;0;0;0;0;0;0;0;0;0;0;0;0;0;0;0;0;0
FR;12;2021-07-11;0;0;0;0;0;0;0;0;0;0;0;0;0;0;0;0;0;0
FR;12;2021-07-12;0;0;0;0;0;0;0;0;0;0;0;0;0;0;0;0;0;0
FR;12;2021-07-13;0;0;0;0;0;0;0;0;0;0;0;0;0;0;0;0;0;0
FR;12;2021-07-14;0;0;0;0;0;0;0;0;0;0;0;0;0;0;0;0;0;0
FR;12;2021-07-15;0;0;0;0;0;0;0;0;0;0;0;0;0;0;0;0;0;0
FR;12;2021-07-16;0;0;0;0;0;0;0;0;0;0;0;0;0;0;0;0;0;0
FR;12;2021-07-17;0;0;0;0;0;0;0;0;0;0;0;0;0;0;0;0;0;0
FR;12;2021-07-18;0;0;0;0;0;0;0;0;0;0;0;0;0;0;0;0;0;0
FR;12;2021-07-19;0;0;0;0;0;0;0;0;0;0;0;0;0;0;0;0;0;0
FR;12;2021-07-20;0;0;0;0;0;0;0;0;0;0;0;0;0;0;0;0;0;0
FR;12;2021-07-21;0;0;0;0;0;0;0;0;0;0;0;0;0;0;0;0;0;0
FR;12;2021-07-22;0;0;0;0;0;0;0;0;0;0;0;0;0;0;0;0;0;0
FR;12;2021-07-23;0;0;0;0;0;0;0;0;0;0;0;0;0;0;0;0;0;0
FR;12;2021-07-24;0;0;0;0;0;0;0;0;0;0;0;0;0;0;0;0;0;0
FR;12;2021-07-25;0;0;0;0;0;0;0;0;0;0;0;0;0;0;0;0;0;0
FR;12;2021-07-26;0;0;0;0;0;0;0;0;0;0;0;0;0;0;0;0;0;0
FR;12;2021-07-27;0;0;0;0;0;0;0;0;0;0;0;0;0;0;0;0;0;0
FR;12;2021-07-28;0;0;0;0;0;0;0;0;0;0;0;0;0;0;0;0;0;0
FR;12;2021-07-29;0;0;0;0;0;0;0;0;0;0;0;0;0;0;0;0;0;0
FR;12;2021-07-30;0;0;0;0;0;0;0;0;0;0;0;0;0;0;0;0;0;0
FR;12;2021-07-31;0;0;0;0;0;0;0;0;0;0;0;0;0;0;0;0;0;0
FR;12;2021-08-01;0;0;0;0;0;0;0;0;0;0;0;0;0;0;0;0;0;0
FR;12;2021-08-02;0;0;0;0;0;0;0;0;0;0;0;0;0;0;0;0;0;0
FR;12;2021-08-03;0;0;0;0;0;0;0;0;0;0;0;0;0;0;0;0;0;0
FR;12;2021-08-04;0;0;0;0;0;0;0;0;0;0;0;0;0;0;0;0;0;0
FR;12;2021-08-05;0;0;0;0;0;0;0;0;0;0;0;0;0;0;0;0;0;0
FR;12;2021-08-06;0;0;0;0;0;0;0;0;0;0;0;0;0;0;0;0;0;0
FR;12;2021-08-07;0;0;0;0;0;0;0;0;0;0;0;0;0;0;0;0;0;0
FR;12;2021-08-08;0;0;0;0;0;0;0;0;0;0;0;0;0;0;0;0;0;0
FR;12;2021-08-09;0;0;0;0;0;0;0;0;0;0;0;0;0;0;0;0;0;0
FR;12;2021-08-10;0;0;0;0;0;0;0;0;0;0;0;0;0;0;0;0;0;0
FR;12;2021-08-11;0;0;0;0;0;0;0;0;0;0;0;0;0;0;0;0;0;0
FR;12;2021-08-12;0;0;0;0;0;0;0;0;0;0;0;0;0;0;0;0;0;0
FR;12;2021-08-13;0;0;0;0;0;0;0;0;0;0;0;0;0;0;0;0;0;0
FR;12;2021-08-14;0;0;0;0;0;0;0;0;0;0;0;0;0;0;0;0;0;0
FR;12;2021-08-15;0;0;0;0;0;0;0;0;0;0;0;0;0;0;0;0;0;0
FR;12;2021-08-16;0;0;0;0;0;0;0;0;0;0;0;0;0;0;0;0;0;0
FR;12;2021-08-17;0;0;0;0;0;0;0;0;0;0;0;0;0;0;0;0;0;0
FR;12;2021-08-18;0;0;0;0;0;0;0;0;0;0;0;0;0;0;0;0;0;0
FR;12;2021-08-19;0;0;0;0;0;0;0;0;0;0;0;0;0;0;0;0;0;0
FR;12;2021-08-20;0;0;0;0;0;0;0;0;0;0;0;0;0;0;0;0;0;0
FR;12;2021-08-21;0;0;0;0;0;0;0;0;0;0;0;0;0;0;0;0;0;0
FR;12;2021-08-22;0;0;0;0;0;0;0;0;0;0;0;0;0;0;0;0;0;0
FR;12;2021-08-23;0;0;0;0;0;0;0;0;0;0;0;0;0;0;0;0;0;0
FR;12;2021-08-24;0;0;0;0;0;0;0;0;0;0;0;0;0;0;0;0;0;0
FR;12;2021-08-25;0;0;0;0;0;0;0;0;0;0;0;0;0;0;0;0;0;0
FR;12;2021-08-26;0;0;0;0;0;0;0;0;0;0;0;0;0;0;0;0;0;0
FR;12;2021-08-27;0;0;0;0;0;0;0;0;0;0;0;0;0;0;0;0;0;0
FR;12;2021-08-28;0;0;0;0;0;0;0;0;0;0;0;0;0;0;0;0;0;0
FR;12;2021-08-29;0;0;0;0;0;0;0;0;0;0;0;0;0;0;0;0;0;0
FR;12;2021-08-30;0;0;0;0;0;0;0;0;0;0;0;0;0;0;0;0;0;0
FR;12;2021-08-31;0;0;0;0;0;0;0;0;0;0;0;0;0;0;0;0;0;0
FR;12;2021-09-01;0;0;0;0;0;0;0;0;0;0;0;0;0;0;0;0;0;0
FR;12;2021-09-02;0;0;0;0;0;0;0;0;0;0;0;0;0;0;0;0;0;0
FR;12;2021-09-03;0;0;0;0;0;0;0;0;0;0;0;0;0;0;0;0;0;0
FR;12;2021-09-04;0;0;0;0;0;0;0;0;0;0;0;0;0;0;0;0;0;0
FR;12;2021-09-05;0;0;0;0;0;0;0;0;0;0;0;0;0;0;0;0;0;0
FR;12;2021-09-06;0;0;0;0;0;0;0;0;0;0;0;0;0;0;0;0;0;0
FR;12;2021-09-07;0;0;0;0;0;0;0;0;0;0;0;0;0;0;0;0;0;0
FR;12;2021-09-08;0;0;0;0;0;0;0;0;0;0;0;0;0;0;0;0;0;0
FR;12;2021-09-09;0;0;0;0;0;0;0;0;0;0;0;0;0;0;0;0;0;0
FR;12;2021-09-10;0;0;0;0;0;0;0;0;0;0;0;0;0;0;0;0;0;0
FR;12;2021-09-11;0;0;0;0;0;0;0;0;0;0;0;0;0;0;0;0;0;0
FR;12;2021-09-12;0;0;0;0;0;0;0;0;0;0;0;0;0;0;0;0;0;0
FR;12;2021-09-13;0;0;0;0;0;0;0;0;0;0;0;0;0;0;0;0;0;0
FR;12;2021-09-14;0;0;0;0;0;0;0;0;0;0;0;0;0;0;0;0;0;0
FR;12;2021-09-15;0;0;0;0;0;0;0;0;0;0;0;0;0;0;0;0;0;0
FR;12;2021-09-16;0;0;0;0;0;0;0;0;0;0;0;0;0;0;0;0;0;0
FR;12;2021-09-17;0;0;0;0;0;0;0;0;0;0;0;0;0;0;0;0;0;0
FR;12;2021-09-18;0;0;0;0;0;0;0;0;0;0;0;0;0;0;0;0;0;0
FR;12;2021-09-19;0;0;0;0;0;0;0;0;0;0;0;0;0;0;0;0;0;0
FR;12;2021-09-20;0;0;0;0;0;0;0;0;0;0;0;0;0;0;0;0;0;0
FR;12;2021-09-21;0;0;0;0;0;0;0;0;0;0;0;0;0;0;0;0;0;0
FR;12;2021-09-22;0;0;0;0;0;0;0;0;0;0;0;0;0;0;0;0;0;0
FR;12;2021-09-23;0;0;0;0;0;0;0;0;0;0;0;0;0;0;0;0;0;0
FR;12;2021-09-24;0;0;0;0;0;0;0;0;0;0;0;0;0;0;0;0;0;0
FR;12;2021-09-25;0;0;0;0;0;0;0;0;0;0;0;0;0;0;0;0;0;0
FR;12;2021-09-26;0;0;0;0;0;0;0;0;0;0;0;0;0;0;0;0;0;0
FR;12;2021-09-27;0;0;0;0;0;0;0;0;0;0;0;0;0;0;0;0;0;0
FR;12;2021-09-28;0;0;0;0;0;0;0;0;0;0;0;0;0;0;0;0;0;0
FR;12;2021-09-29;0;0;0;0;0;0;0;0;0;0;0;0;0;0;0;0;0;0
FR;12;2021-09-30;0;0;0;0;0;0;0;0;0;0;0;0;0;0;0;0;0;0
FR;12;2021-10-01;0;0;0;0;0;0;0;0;0;0;0;0;0;0;0;0;0;0
FR;12;2021-10-02;0;0;0;0;0;0;0;0;0;0;0;0;0;0;0;0;0;0
FR;12;2021-10-03;0;0;0;0;0;0;0;0;0;0;0;0;0;0;0;0;0;0
FR;12;2021-10-04;0;0;0;0;0;0;0;0;0;0;0;0;0;0;0;0;0;0
FR;12;2021-10-05;0;0;0;0;0;0;0;0;0;0;0;0;0;0;0;0;0;0
FR;12;2021-10-06;0;0;0;0;0;0;0;0;0;0;0;0;0;0;0;0;0;0
FR;12;2021-10-07;0;0;0;0;0;0;0;0;0;0;0;0;0;0;0;0;0;0
FR;12;2021-10-08;0;0;0;0;0;0;0;0;0;0;0;0;0;0;0;0;0;0
FR;12;2021-10-09;0;0;0;0;0;0;0;0;0;0;0;0;0;0;0;0;0;0
FR;12;2021-10-10;0;0;0;0;0;0;0;0;0;0;0;0;0;0;0;0;0;0
FR;12;2021-10-11;0;0;0;0;0;0;0;0;0;0;0;0;0;0;0;0;0;0
FR;12;2021-10-12;0;0;0;0;0;0;0;0;0;0;0;0;0;0;0;0;0;0
FR;12;2021-10-13;0;0;0;0;0;0;0;0;0;0;0;0;0;0;0;0;0;0
FR;12;2021-10-14;0;0;0;0;0;0;0;0;0;0;0;0;0;0;0;0;0;0
FR;12;2021-10-15;0;0;0;0;0;0;0;0;0;0;0;0;0;0;0;0;0;0
FR;12;2021-10-16;0;0;0;0;0;0;0;0;0;0;0;0;0;0;0;0;0;0
FR;12;2021-10-17;0;0;0;0;0;0;0;0;0;0;0;0;0;0;0;0;0;0
FR;12;2021-10-18;0;0;0;0;0;0;0;0;0;0;0;0;0;0;0;0;0;0
FR;12;2021-10-19;0;0;0;0;0;0;0;0;0;0;0;0;0;0;0;0;0;0
FR;12;2021-10-20;0;0;0;0;0;0;0;0;0;0;0;0;0;0;0;0;0;0
FR;12;2021-10-21;0;0;0;0;0;0;0;0;0;0;0;0;0;0;0;0;0;0
FR;12;2021-10-22;0;0;0;0;0;0;0;0;0;0;0;0;0;0;0;0;0;0
FR;12;2021-10-23;0;0;0;0;0;0;0;0;0;0;0;0;0;0;0;0;0;0
FR;12;2021-10-24;0;0;0;0;0;0;0;0;0;0;0;0;0;0;0;0;0;0
FR;12;2021-10-25;0;0;0;0;0;0;0;0;0;0;0;0;0;0;0;0;0;0
FR;12;2021-10-26;0;0;0;0;0;0;0;0;0;0;0;0;0;0;0;0;0;0
FR;12;2021-10-27;0;0;0;0;0;0;0;0;0;0;0;0;0;0;0;0;0;0
FR;12;2021-10-28;0;0;0;0;0;0;0;0;0;0;0;0;0;0;0;0;0;0
FR;12;2021-10-29;0;0;0;0;0;0;0;0;0;0;0;0;0;0;0;0;0;0
FR;12;2021-10-30;0;0;0;0;0;0;0;0;0;0;0;0;0;0;0;0;0;0
FR;12;2021-10-31;0;0;0;0;0;0;0;0;0;0;0;0;0;0;0;0;0;0
FR;12;2021-11-01;0;0;0;0;0;0;0;0;0;0;0;0;0;0;0;0;0;0
FR;12;2021-11-02;0;0;0;0;0;0;0;0;0;0;0;0;0;0;0;0;0;0
FR;12;2021-11-03;0;0;0;0;0;0;0;0;0;0;0;0;0;0;0;0;0;0
FR;12;2021-11-04;0;0;0;0;0;0;0;0;0;0;0;0;0;0;0;0;0;0
FR;12;2021-11-05;0;0;0;0;0;0;0;0;0;0;0;0;0;0;0;0;0;0
FR;12;2021-11-06;0;0;0;0;0;0;0;0;0;0;0;0;0;0;0;0;0;0
FR;12;2021-11-07;0;0;0;0;0;0;0;0;0;0;0;0;0;0;0;0;0;0
FR;12;2021-11-08;0;0;0;0;0;0;0;0;0;0;0;0;0;0;0;0;0;0
FR;12;2021-11-09;0;0;0;0;0;0;0;0;0;0;0;0;0;0;0;0;0;0
FR;12;2021-11-10;0;0;0;0;0;0;0;0;0;0;0;0;0;0;0;0;0;0
FR;12;2021-11-11;0;0;0;0;0;0;0;0;0;0;0;0;0;0;0;0;0;0
FR;12;2021-11-12;0;0;0;0;0;0;0;0;0;0;0;0;0;0;0;0;0;0
FR;12;2021-11-13;0;0;0;0;0;0;0;0;0;0;0;0;0;0;0;0;0;0
FR;12;2021-11-14;0;0;0;0;0;0;0;0;0;0;0;0;0;0;0;0;0;0
FR;12;2021-11-15;0;0;0;0;0;0;0;0;0;0;0;0;0;0;0;0;0;0
FR;12;2021-11-16;0;0;0;0;0;0;0;0;0;0;0;0;0;0;0;0;0;0
FR;12;2021-11-17;0;0;0;0;0;0;0;0;0;0;0;0;0;0;0;0;0;0
FR;12;2021-11-18;0;0;0;0;0;0;0;0;0;0;0;0;0;0;0;0;0;0
FR;12;2021-11-19;0;0;0;0;0;0;0;0;0;0;0;0;0;0;0;0;0;0
FR;12;2021-11-20;0;0;0;0;0;0;0;0;0;0;0;0;0;0;0;0;0;0
FR;12;2021-11-21;0;0;0;0;0;0;0;0;0;0;0;0;0;0;0;0;0;0
FR;12;2021-11-22;0;0;0;0;0;0;0;0;0;0;0;0;0;0;0;0;0;0
FR;12;2021-11-23;0;0;0;0;0;0;0;0;0;0;0;0;0;0;0;0;0;0
FR;12;2021-11-24;0;0;0;0;0;0;0;0;0;0;0;0;0;0;0;0;0;0
FR;12;2021-11-25;0;0;0;0;0;0;0;0;0;0;0;0;0;0;0;0;0;0
FR;12;2021-11-26;0;0;0;0;0;0;0;0;0;0;0;0;0;0;0;0;0;0
FR;12;2021-11-27;0;0;0;0;0;0;0;0;0;0;0;0;0;0;0;0;0;0
FR;12;2021-11-28;0;0;0;0;0;0;0;0;0;0;0;0;0;0;0;0;0;0
FR;12;2021-11-29;0;0;0;0;0;0;0;0;0;0;0;0;0;0;0;0;0;0
FR;12;2021-11-30;0;0;0;0;0;0;0;0;0;0;0;0;0;0;0;0;0;0
FR;12;2021-12-01;0;0;0;0;0;0;0;0;0;0;0;0;0;0;0;0;0;0
FR;12;2021-12-02;0;0;0;0;0;0;0;0;0;0;0;0;0;0;0;0;0;0
FR;12;2021-12-03;0;0;0;0;0;0;0;0;0;0;0;0;0;0;0;0;0;0
FR;12;2021-12-04;0;0;0;0;0;0;0;0;0;0;0;0;0;0;0;0;0;0
FR;12;2021-12-05;0;0;0;0;0;0;0;0;0;0;0;0;0;0;0;0;0;0
FR;12;2021-12-06;0;0;0;0;0;0;0;0;0;0;0;0;0;0;0;0;0;0
FR;12;2021-12-07;0;0;0;0;0;0;0;0;0;0;0;0;0;0;0;0;0;0
FR;12;2021-12-08;0;0;0;0;0;0;0;0;0;0;0;0;0;0;0;0;0;0
FR;12;2021-12-09;0;0;0;0;0;0;0;0;0;0;0;0;0;0;0;0;0;0
FR;12;2021-12-10;0;0;0;0;0;0;0;0;0;0;0;0;0;0;0;0;0;0
FR;12;2021-12-11;0;0;0;0;0;0;0;0;0;0;0;0;0;0;0;0;0;0
FR;12;2021-12-12;0;0;0;0;0;0;0;0;0;0;0;0;0;0;0;0;0;0
FR;12;2021-12-13;0;0;0;0;0;0;0;0;0;0;0;0;0;0;0;0;0;0
FR;12;2021-12-14;0;0;0;0;0;0;0;0;0;0;0;0;0;0;0;0;0;0
FR;12;2021-12-15;0;0;0;0;0;0;0;0;0;0;0;0;0;0;0;0;0;0
FR;12;2021-12-16;0;0;0;0;0;0;0;0;0;0;0;0;0;0;0;0;0;0
FR;12;2021-12-17;0;0;0;0;0;0;0;0;0;0;0;0;0;0;0;0;0;0
FR;12;2021-12-18;0;0;0;0;0;0;0;0;0;0;0;0;0;0;0;0;0;0
FR;12;2021-12-19;0;0;0;0;0;0;0;0;0;0;0;0;0;0;0;0;0;0
FR;12;2021-12-20;0;0;0;0;0;0;0;0;0;0;0;0;0;0;0;0;0;0
FR;12;2021-12-21;0;0;0;0;0;0;0;0;0;0;0;0;0;0;0;0;0;0
FR;12;2021-12-22;0;0;0;0;0;0;0;0;0;0;0;0;0;0;0;0;0;0
FR;12;2021-12-23;0;0;0;0;0;0;0;0;0;0;0;0;0;0;0;0;0;0
FR;12;2021-12-24;0;0;0;0;0;0;0;0;0;0;0;0;0;0;0;0;0;0
FR;12;2021-12-25;0;0;0;0;0;0;0;0;0;0;0;0;0;0;0;0;0;0
FR;12;2021-12-26;0;0;0;0;0;0;0;0;0;0;0;0;0;0;0;0;0;0
FR;12;2021-12-27;0;0;0;0;0;0;0;0;0;0;0;0;0;0;0;0;0;0
FR;12;2021-12-28;0;0;0;0;0;0;0;0;0;0;0;0;0;0;0;0;0;0
FR;12;2021-12-29;0;0;0;0;0;0;0;0;0;0;0;0;0;0;0;0;0;0
FR;12;2021-12-30;0;0;0;0;0;0;0;0;0;0;0;0;0;0;0;0;0;0
FR;12;2021-12-31;0;0;0;0;0;0;0;0;0;0;0;0;0;0;0;0;0;0
FR;12;2022-01-01;0;0;0;0;0;0;0;0;0;0;0;0;0;0;0;0;0;0
FR;12;2022-01-02;0;0;0;0;0;0;0;0;0;0;0;0;0;0;0;0;0;0
FR;12;2022-01-03;0;0;0;0;0;0;0;0;0;0;0;0;0;0;0;0;0;0
FR;12;2022-01-04;0;0;0;0;0;0;0;0;0;0;0;0;0;0;0;0;0;0
FR;12;2022-01-05;0;0;0;0;0;0;0;0;0;0;0;0;0;0;0;0;0;0
FR;12;2022-01-06;0;0;0;0;0;0;0;0;0;0;0;0;0;0;0;0;0;0
FR;12;2022-01-07;0;0;0;0;0;0;0;0;0;0;0;0;0;0;0;0;0;0
FR;12;2022-01-08;0;0;0;0;0;0;0;0;0;0;0;0;0;0;0;0;0;0
FR;12;2022-01-09;0;0;0;0;0;0;0;0;0;0;0;0;0;0;0;0;0;0
FR;12;2022-01-10;0;0;0;0;0;0;0;0;0;0;0;0;0;0;0;0;0;0
FR;12;2022-01-11;0;0;0;0;0;0;0;0;0;0;0;0;0;0;0;0;0;0
FR;12;2022-01-12;0;0;0;0;0;0;0;0;0;0;0;0;0;0;0;0;0;0
FR;12;2022-01-13;0;0;0;0;0;0;0;0;0;0;0;0;0;0;0;0;0;0
FR;12;2022-01-14;0;0;0;0;0;0;0;0;0;0;0;0;0;0;0;0;0;0
FR;12;2022-01-15;0;0;0;0;0;0;0;0;0;0;0;0;0;0;0;0;0;0
FR;12;2022-01-16;0;0;0;0;0;0;0;0;0;0;0;0;0;0;0;0;0;0
FR;12;2022-01-17;0;0;0;0;0;0;0;0;0;0;0;0;0;0;0;0;0;0
FR;12;2022-01-18;0;0;0;0;0;0;0;0;0;0;0;0;0;0;0;0;0;0
FR;12;2022-01-19;0;0;0;0;0;0;0;0;0;0;0;0;0;0;0;0;0;0
FR;12;2022-01-20;0;0;0;0;0;0;0;0;0;0;0;0;0;0;0;0;0;0
FR;12;2022-01-21;0;0;0;0;0;0;0;0;0;0;0;0;0;0;0;0;0;0
FR;12;2022-01-22;0;0;0;0;0;0;0;0;0;0;0;0;0;0;0;0;0;0
FR;12;2022-01-23;0;0;0;0;0;0;0;0;0;0;0;0;0;0;0;0;0;0
FR;12;2022-01-24;0;0;0;0;0;0;0;0;0;0;0;0;0;0;0;0;0;0
FR;12;2022-01-25;0;0;0;0;0;0;0;0;0;0;0;0;0;0;0;0;0;0
FR;12;2022-01-26;0;0;0;0;0;0;0;0;0;0;0;0;0;0;0;0;0;0
FR;12;2022-01-27;0;0;0;0;0;0;0;0;0;0;0;0;0;0;0;0;0;0
FR;12;2022-01-28;0;0;0;0;0;0;0;0;0;0;0;0;0;0;0;0;0;0
FR;12;2022-01-29;0;0;0;0;0;0;0;0;0;0;0;0;0;0;0;0;0;0
FR;12;2022-01-30;0;0;0;0;0;0;0;0;0;0;0;0;0;0;0;0;0;0
FR;12;2022-01-31;0;0;0;0;0;0;0;0;0;0;0;0;0;0;0;0;0;0
FR;12;2022-02-01;0;0;0;0;0;0;0;0;0;0;0;0;0;0;0;0;0;0
FR;12;2022-02-02;0;0;0;0;0;0;0;0;0;0;0;0;0;0;0;0;0;0
FR;12;2022-02-03;0;0;0;0;0;0;0;0;0;0;0;0;0;0;0;0;0;0
FR;12;2022-02-04;0;0;0;0;0;0;0;0;0;0;0;0;0;0;0;0;0;0
FR;12;2022-02-05;0;0;0;0;0;0;0;0;0;0;0;0;0;0;0;0;0;0
FR;12;2022-02-06;0;0;0;0;0;0;0;0;0;0;0;0;0;0;0;0;0;0
FR;12;2022-02-07;0;0;0;0;0;0;0;0;0;0;0;0;0;0;0;0;0;0
FR;12;2022-02-08;0;0;0;0;0;0;0;0;0;0;0;0;0;0;0;0;0;0
FR;12;2022-02-09;0;0;0;0;0;0;0;0;0;0;0;0;0;0;0;0;0;0
FR;12;2022-02-10;0;0;0;0;0;0;0;0;0;0;0;0;0;0;0;0;0;0
FR;12;2022-02-11;0;0;0;0;0;0;0;0;0;0;0;0;0;0;0;0;0;0
FR;12;2022-02-12;0;0;0;0;0;0;0;0;0;0;0;0;0;0;0;0;0;0
FR;12;2022-02-13;0;0;0;0;0;0;0;0;0;0;0;0;0;0;0;0;0;0
FR;12;2022-02-14;0;0;0;0;0;0;0;0;0;0;0;0;0;0;0;0;0;0
FR;12;2022-02-15;0;0;0;0;0;0;0;0;0;0;0;0;0;0;0;0;0;0
FR;12;2022-02-16;0;0;0;0;0;0;0;0;0;0;0;0;0;0;0;0;0;0
FR;12;2022-02-17;0;0;0;0;0;0;0;0;0;0;0;0;0;0;0;0;0;0
FR;12;2022-02-18;0;0;0;0;0;0;0;0;0;0;0;0;0;0;0;0;0;0
FR;12;2022-02-19;0;0;0;0;0;0;0;0;0;0;0;0;0;0;0;0;0;0
FR;12;2022-02-20;0;0;0;0;0;0;0;0;0;0;0;0;0;0;0;0;0;0
FR;12;2022-02-21;0;0;0;0;0;0;0;0;0;0;0;0;0;0;0;0;0;0
FR;12;2022-02-22;0;0;0;0;0;0;0;0;0;0;0;0;0;0;0;0;0;0
FR;12;2022-02-23;0;0;0;0;0;0;0;0;0;0;0;0;0;0;0;0;0;0
FR;12;2022-02-24;0;0;0;0;0;0;0;0;0;0;0;0;0;0;0;0;0;0
FR;12;2022-02-25;0;0;0;0;0;0;0;0;0;0;0;0;0;0;0;0;0;0
FR;12;2022-02-26;0;0;0;0;0;0;0;0;0;0;0;0;0;0;0;0;0;0
FR;12;2022-02-27;0;0;0;0;0;0;0;0;0;0;0;0;0;0;0;0;0;0
FR;12;2022-02-28;0;0;0;0;0;0;0;0;0;0;0;0;0;0;0;0;0;0
FR;12;2022-03-01;0;0;0;0;0;0;0;0;0;0;0;0;0;0;0;0;0;0
FR;12;2022-03-02;0;0;0;0;0;0;0;0;0;0;0;0;0;0;0;0;0;0
FR;12;2022-03-03;0;0;0;0;0;0;0;0;0;0;0;0;0;0;0;0;0;0
FR;12;2022-03-04;0;0;0;0;0;0;0;0;0;0;0;0;0;0;0;0;0;0
FR;12;2022-03-05;0;0;0;0;0;0;0;0;0;0;0;0;0;0;0;0;0;0
FR;12;2022-03-06;0;0;0;0;0;0;0;0;0;0;0;0;0;0;0;0;0;0
FR;12;2022-03-07;0;0;0;0;0;0;0;0;0;0;0;0;0;0;0;0;0;0
FR;12;2022-03-08;0;0;0;0;0;0;0;0;0;0;0;0;0;0;0;0;0;0
FR;12;2022-03-09;0;0;0;0;0;0;0;0;0;0;0;0;0;0;0;0;0;0
FR;12;2022-03-10;0;0;0;0;0;0;0;0;0;0;0;0;0;0;0;0;0;0
FR;12;2022-03-11;0;0;0;0;0;0;0;0;0;0;0;0;0;0;0;0;0;0
FR;12;2022-03-12;0;0;0;0;0;0;0;0;0;0;0;0;0;0;0;0;0;0
FR;12;2022-03-13;0;0;0;0;0;0;0;0;0;0;0;0;0;0;0;0;0;0
FR;12;2022-03-14;0;0;0;0;0;0;0;0;0;0;0;0;0;0;0;0;0;0
FR;12;2022-03-15;0;0;0;0;0;0;0;0;0;0;0;0;0;0;0;0;0;0
FR;12;2022-03-16;0;0;0;0;0;0;0;0;0;0;0;0;0;0;0;0;0;0
FR;12;2022-03-17;0;0;0;0;0;0;0;0;0;0;0;0;0;0;0;0;0;0
FR;12;2022-03-18;0;0;0;0;0;0;0;0;0;0;0;0;0;0;0;0;0;0
FR;12;2022-03-19;0;0;0;0;0;0;0;0;0;0;0;0;0;0;0;0;0;0
FR;12;2022-03-20;0;0;0;0;0;0;0;0;0;0;0;0;0;0;0;0;0;0
FR;12;2022-03-21;0;0;0;0;0;0;0;0;0;0;0;0;0;0;0;0;0;0
FR;12;2022-03-22;0;0;0;0;0;0;0;0;0;0;0;0;0;0;0;0;0;0
FR;12;2022-03-23;0;0;0;0;0;0;0;0;0;0;0;0;0;0;0;0;0;0
FR;12;2022-03-24;0;0;0;0;0;0;0;0;0;0;0;0;0;0;0;0;0;0
FR;12;2022-03-25;0;0;0;0;0;0;0;0;0;0;0;0;0;0;0;0;0;0
FR;12;2022-03-26;0;0;0;0;0;0;0;0;0;0;0;0;0;0;0;0;0;0
FR;12;2022-03-27;0;0;0;0;0;0;0;0;0;0;0;0;0;0;0;0;0;0
FR;12;2022-03-28;0;0;0;0;0;0;0;0;0;0;0;0;0;0;0;0;0;0
FR;12;2022-03-29;0;0;0;0;0;0;0;0;0;0;0;0;0;0;0;0;0;0
FR;12;2022-03-30;0;0;0;0;0;0;0;0;0;0;0;0;0;0;0;0;0;0
FR;12;2022-03-31;0;0;0;0;0;0;0;0;0;0;0;0;0;0;0;0;0;0
FR;12;2022-04-01;0;0;0;0;0;0;0;0;0;0;0;0;0;0;0;0;0;0
FR;12;2022-04-02;0;0;0;0;0;0;0;0;0;0;0;0;0;0;0;0;0;0
FR;12;2022-04-03;0;0;0;0;0;0;0;0;0;0;0;0;0;0;0;0;0;0
FR;12;2022-04-04;0;0;0;0;0;0;0;0;0;0;0;0;0;0;0;0;0;0
FR;12;2022-04-05;0;0;0;0;0;0;0;0;0;0;0;0;0;0;0;0;0;0
FR;12;2022-04-06;0;0;0;0;0;0;0;0;0;0;0;0;0;0;0;0;0;0
FR;12;2022-04-07;0;0;0;0;0;0;0;0;0;0;0;0;0;0;0;0;0;0
FR;12;2022-04-08;0;0;0;0;0;0;0;0;0;0;0;0;0;0;0;0;0;0
FR;12;2022-04-09;0;0;0;0;0;0;0;0;0;0;0;0;0;0;0;0;0;0
FR;12;2022-04-10;0;0;0;0;0;0;0;0;0;0;0;0;0;0;0;0;0;0
FR;12;2022-04-11;0;0;0;0;0;0;0;0;0;0;0;0;0;0;0;0;0;0
FR;12;2022-04-12;0;0;0;0;0;0;0;0;0;0;0;0;0;0;0;0;0;0
FR;12;2022-04-13;0;0;0;0;0;0;0;0;0;0;0;0;0;0;0;0;0;0
FR;12;2022-04-14;0;0;0;0;0;0;0;0;0;0;0;0;0;0;0;0;0;0
FR;12;2022-04-15;0;0;0;0;0;0;0;0;0;0;0;0;0;0;0;0;0;0
FR;12;2022-04-16;0;0;0;0;0;0;0;0;0;0;0;0;0;0;0;0;0;0
FR;12;2022-04-17;0;0;0;0;0;0;0;0;0;0;0;0;0;0;0;0;0;0
FR;12;2022-04-18;0;0;0;0;0;0;0;0;0;0;0;0;0;0;0;0;0;0
FR;12;2022-04-19;0;0;0;0;0;0;0;0;0;0;0;0;0;0;0;0;0;0
FR;12;2022-04-20;0;0;0;0;0;0;0;0;0;0;0;0;0;0;0;0;0;0
FR;12;2022-04-21;0;0;0;0;0;0;0;0;0;0;0;0;0;0;0;0;0;0
FR;12;2022-04-22;0;0;0;0;0;0;0;0;0;0;0;0;0;0;0;0;0;0
FR;12;2022-04-23;0;0;0;0;0;0;0;0;0;0;0;0;0;0;0;0;0;0
FR;12;2022-04-24;0;0;0;0;0;0;0;0;0;0;0;0;0;0;0;0;0;0
FR;12;2022-04-25;0;0;0;0;0;0;0;0;0;0;0;0;0;0;0;0;0;0
FR;12;2022-04-26;0;0;0;0;0;0;0;0;0;0;0;0;0;0;0;0;0;0
FR;12;2022-04-27;0;0;0;0;0;0;0;0;0;0;0;0;0;0;0;0;0;0
FR;12;2022-04-28;0;0;0;0;0;0;0;0;0;0;0;0;0;0;0;0;0;0
FR;12;2022-04-29;0;0;0;0;0;0;0;0;0;0;0;0;0;0;0;0;0;0
FR;12;2022-04-30;0;0;0;0;0;0;0;0;0;0;0;0;0;0;0;0;0;0
FR;12;2022-05-01;0;0;0;0;0;0;0;0;0;0;0;0;0;0;0;0;0;0
FR;12;2022-05-02;0;0;0;0;0;0;0;0;0;0;0;0;0;0;0;0;0;0
FR;12;2022-05-03;0;0;0;0;0;0;0;0;0;0;0;0;0;0;0;0;0;0
FR;12;2022-05-04;0;0;0;0;0;0;0;0;0;0;0;0;0;0;0;0;0;0
FR;12;2022-05-05;0;0;0;0;0;0;0;0;0;0;0;0;0;0;0;0;0;0
FR;12;2022-05-06;0;0;0;0;0;0;0;0;0;0;0;0;0;0;0;0;0;0
FR;12;2022-05-07;0;0;0;0;0;0;0;0;0;0;0;0;0;0;0;0;0;0
FR;12;2022-05-08;0;0;0;0;0;0;0;0;0;0;0;0;0;0;0;0;0;0
FR;12;2022-05-09;0;0;0;0;0;0;0;0;0;0;0;0;0;0;0;0;0;0
FR;12;2022-05-10;0;0;0;0;0;0;0;0;0;0;0;0;0;0;0;0;0;0
FR;12;2022-05-11;0;0;0;0;0;0;0;0;0;0;0;0;0;0;0;0;0;0
FR;12;2022-05-12;0;0;0;0;0;0;0;0;0;0;0;0;0;0;0;0;0;0
FR;12;2022-05-13;0;0;0;0;0;0;0;0;0;0;0;0;0;0;0;0;0;0
FR;12;2022-05-14;0;0;0;0;0;0;0;0;0;0;0;0;0;0;0;0;0;0
FR;12;2022-05-15;0;0;0;0;0;0;0;0;0;0;0;0;0;0;0;0;0;0
FR;12;2022-05-16;0;0;0;0;0;0;0;0;0;0;0;0;0;0;0;0;0;0
FR;12;2022-05-17;0;0;0;0;0;0;0;0;0;0;0;0;0;0;0;0;0;0
FR;12;2022-05-18;0;0;0;0;0;0;0;0;0;0;0;0;0;0;0;0;0;0
FR;12;2022-05-19;0;0;0;0;0;0;0;0;0;0;0;0;0;0;0;0;0;0
FR;12;2022-05-20;0;0;0;0;0;0;0;0;0;0;0;0;0;0;0;0;0;0
FR;12;2022-05-21;0;0;0;0;0;0;0;0;0;0;0;0;0;0;0;0;0;0
FR;12;2022-05-22;0;0;0;0;0;0;0;0;0;0;0;0;0;0;0;0;0;0
FR;12;2022-05-23;0;0;0;0;0;0;0;0;0;0;0;0;0;0;0;0;0;0
FR;12;2022-05-24;0;0;0;0;0;0;0;0;0;0;0;0;0;0;0;0;0;0
FR;12;2022-05-25;0;0;0;0;0;0;0;0;0;0;0;0;0;0;0;0;0;0
FR;12;2022-05-26;0;0;0;0;0;0;0;0;0;0;0;0;0;0;0;0;0;0
FR;12;2022-05-27;0;0;0;0;0;0;0;0;0;0;0;0;0;0;0;0;0;0
FR;12;2022-05-28;0;0;0;0;0;0;0;0;0;0;0;0;0;0;0;0;0;0
FR;12;2022-05-29;0;0;0;0;0;0;0;0;0;0;0;0;0;0;0;0;0;0
FR;12;2022-05-30;0;0;0;0;0;0;0;0;0;0;0;0;0;0;0;0;0;0
FR;12;2022-05-31;0;0;0;0;0;0;0;0;0;0;0;0;0;0;0;0;0;0
FR;12;2022-06-01;0;0;0;0;0;0;0;0;0;0;0;0;0;0;0;0;0;0
FR;12;2022-06-02;0;0;0;0;0;0;0;0;0;0;0;0;0;0;0;0;0;0
FR;12;2022-06-03;0;0;0;0;0;0;0;0;0;0;0;0;0;0;0;0;0;0
FR;12;2022-06-04;0;0;0;0;0;0;0;0;0;0;0;0;0;0;0;0;0;0
FR;12;2022-06-05;0;0;0;0;0;0;0;0;0;0;0;0;0;0;0;0;0;0
FR;12;2022-06-06;0;0;0;0;0;0;0;0;0;0;0;0;0;0;0;0;0;0
FR;12;2022-06-07;0;0;0;0;0;0;0;0;0;0;0;0;0;0;0;0;0;0
FR;12;2022-06-08;0;0;0;0;0;0;0;0;0;0;0;0;0;0;0;0;0;0
FR;12;2022-06-09;0;0;0;0;0;0;0;0;0;0;0;0;0;0;0;0;0;0
FR;12;2022-06-10;0;0;0;0;0;0;0;0;0;0;0;0;0;0;0;0;0;0
FR;12;2022-06-11;0;0;0;0;0;0;0;0;0;0;0;0;0;0;0;0;0;0
FR;12;2022-06-12;0;0;0;0;0;0;0;0;0;0;0;0;0;0;0;0;0;0
FR;12;2022-06-13;0;0;0;0;0;0;0;0;0;0;0;0;0;0;0;0;0;0
FR;12;2022-06-14;0;0;0;0;0;0;0;0;0;0;0;0;0;0;0;0;0;0
FR;12;2022-06-15;0;0;0;0;0;0;0;0;0;0;0;0;0;0;0;0;0;0
FR;12;2022-06-16;0;0;0;0;0;0;0;0;0;0;0;0;0;0;0;0;0;0
FR;12;2022-06-17;0;0;0;0;0;0;0;0;0;0;0;0;0;0;0;0;0;0
FR;12;2022-06-18;0;0;0;0;0;0;0;0;0;0;0;0;0;0;0;0;0;0
FR;12;2022-06-19;0;0;0;0;0;0;0;0;0;0;0;0;0;0;0;0;0;0
FR;12;2022-06-20;0;0;0;0;0;0;0;0;0;0;0;0;0;0;0;0;0;0
FR;12;2022-06-21;0;0;0;0;0;0;0;0;0;0;0;0;0;0;0;0;0;0
FR;12;2022-06-22;0;0;0;0;0;0;0;0;0;0;0;0;0;0;0;0;0;0
FR;12;2022-06-23;0;0;0;0;0;0;0;0;0;0;0;0;0;0;0;0;0;0
FR;12;2022-06-24;0;0;0;0;0;0;0;0;0;0;0;0;0;0;0;0;0;0
FR;12;2022-06-25;0;0;0;0;0;0;0;0;0;0;0;0;0;0;0;0;0;0
FR;12;2022-06-26;0;0;0;0;0;0;0;0;0;0;0;0;0;0;0;0;0;0
FR;12;2022-06-27;0;0;0;0;0;0;0;0;0;0;0;0;0;0;0;0;0;0
FR;12;2022-06-28;0;0;0;0;0;0;0;0;0;0;0;0;0;0;0;0;0;0
FR;12;2022-06-29;0;0;0;0;0;0;0;0;0;0;0;0;0;0;0;0;0;0
FR;12;2022-06-30;0;0;0;0;0;0;0;0;0;0;0;0;0;0;0;0;0;0
FR;12;2022-07-01;0;0;0;0;0;0;0;0;0;0;0;0;0;0;0;0;0;0
FR;12;2022-07-02;0;0;0;0;0;0;0;0;0;0;0;0;0;0;0;0;0;0
FR;12;2022-07-03;0;0;0;0;0;0;0;0;0;0;0;0;0;0;0;0;0;0
FR;12;2022-07-04;0;0;0;0;0;0;0;0;0;0;0;0;0;0;0;0;0;0
FR;12;2022-07-05;0;0;0;0;0;0;0;0;0;0;0;0;0;0;0;0;0;0
FR;12;2022-07-06;0;0;0;0;0;0;0;0;0;0;0;0;0;0;0;0;0;0
FR;12;2022-07-07;0;0;0;0;0;0;0;0;0;0;0;0;0;0;0;0;0;0
FR;12;2022-07-08;0;0;0;0;0;0;0;0;0;0;0;0;0;0;0;0;0;0
FR;12;2022-07-09;0;0;0;0;0;0;0;0;0;0;0;0;0;0;0;0;0;0
FR;12;2022-07-10;0;0;0;0;0;0;0;0;0;0;0;0;0;0;0;0;0;0
FR;12;2022-07-11;0;0;0;0;0;0;0;0;0;0;0;0;0;0;0;0;0;0
FR;12;2022-07-12;0;0;0;0;0;0;0;0;0;0;0;0;0;0;0;0;0;0
FR;12;2022-07-13;0;0;0;0;0;0;0;0;0;0;0;0;0;0;0;0;0;0
FR;12;2022-07-14;0;0;0;0;0;0;0;0;0;0;0;0;0;0;0;0;0;0
FR;12;2022-07-15;0;0;0;0;0;0;0;0;0;0;0;0;0;0;0;0;0;0
FR;12;2022-07-16;0;0;0;0;0;0;0;0;0;0;0;0;0;0;0;0;0;0
FR;12;2022-07-17;0;0;0;0;0;0;0;0;0;0;0;0;0;0;0;0;0;0
FR;12;2022-07-18;0;0;0;0;0;0;0;0;0;0;0;0;0;0;0;0;0;0
FR;12;2022-07-19;0;0;0;0;0;0;0;0;0;0;0;0;0;0;0;0;0;0
FR;12;2022-07-20;0;0;0;0;0;0;0;0;0;0;0;0;0;0;0;0;0;0
FR;12;2022-07-21;0;0;0;0;0;0;0;0;0;0;0;0;0;0;0;0;0;0
FR;12;2022-07-22;0;0;0;0;0;0;0;0;0;0;0;0;0;0;0;0;0;0
FR;12;2022-07-23;0;0;0;0;0;0;0;0;0;0;0;0;0;0;0;0;0;0
FR;12;2022-07-24;0;0;0;0;0;0;0;0;0;0;0;0;0;0;0;0;0;0
FR;12;2022-07-25;0;0;0;0;0;0;0;0;0;0;0;0;0;0;0;0;0;0
FR;12;2022-07-26;0;0;0;0;0;0;0;0;0;0;0;0;0;0;0;0;0;0
FR;12;2022-07-27;0;0;0;0;0;0;0;0;0;0;0;0;0;0;0;0;0;0
FR;12;2022-07-28;0;0;0;0;0;0;0;0;0;0;0;0;0;0;0;0;0;0
FR;12;2022-07-29;0;0;0;0;0;0;0;0;0;0;0;0;0;0;0;0;0;0
FR;12;2022-07-30;0;0;0;0;0;0;0;0;0;0;0;0;0;0;0;0;0;0
FR;12;2022-07-31;0;0;0;0;0;0;0;0;0;0;0;0;0;0;0;0;0;0
FR;12;2022-08-01;0;0;0;0;0;0;0;0;0;0;0;0;0;0;0;0;0;0
FR;12;2022-08-02;0;0;0;0;0;0;0;0;0;0;0;0;0;0;0;0;0;0
FR;12;2022-08-03;0;0;0;0;0;0;0;0;0;0;0;0;0;0;0;0;0;0
FR;12;2022-08-04;0;0;0;0;0;0;0;0;0;0;0;0;0;0;0;0;0;0
FR;12;2022-08-05;0;0;0;0;0;0;0;0;0;0;0;0;0;0;0;0;0;0
FR;12;2022-08-06;0;0;0;0;0;0;0;0;0;0;0;0;0;0;0;0;0;0
FR;12;2022-08-07;0;0;0;0;0;0;0;0;0;0;0;0;0;0;0;0;0;0
FR;12;2022-08-08;0;0;0;0;0;0;0;0;0;0;0;0;0;0;0;0;0;0
FR;12;2022-08-09;0;0;0;0;0;0;0;0;0;0;0;0;0;0;0;0;0;0
FR;12;2022-08-10;0;0;0;0;0;0;0;0;0;0;0;0;0;0;0;0;0;0
FR;12;2022-08-11;0;0;0;0;0;0;0;0;0;0;0;0;0;0;0;0;0;0
FR;12;2022-08-12;0;0;0;0;0;0;0;0;0;0;0;0;0;0;0;0;0;0
FR;12;2022-08-13;0;0;0;0;0;0;0;0;0;0;0;0;0;0;0;0;0;0
FR;12;2022-08-14;0;0;0;0;0;0;0;0;0;0;0;0;0;0;0;0;0;0
FR;12;2022-08-15;0;0;0;0;0;0;0;0;0;0;0;0;0;0;0;0;0;0
FR;12;2022-08-16;0;0;0;0;0;0;0;0;0;0;0;0;0;0;0;0;0;0
FR;12;2022-08-17;0;0;0;0;0;0;0;0;0;0;0;0;0;0;0;0;0;0
FR;12;2022-08-18;0;0;0;0;0;0;0;0;0;0;0;0;0;0;0;0;0;0
FR;12;2022-08-19;0;0;0;0;0;0;0;0;0;0;0;0;0;0;0;0;0;0
FR;12;2022-08-20;0;0;0;0;0;0;0;0;0;0;0;0;0;0;0;0;0;0
FR;12;2022-08-21;0;0;0;0;0;0;0;0;0;0;0;0;0;0;0;0;0;0
FR;12;2022-08-22;0;0;0;0;0;0;0;0;0;0;0;0;0;0;0;0;0;0
FR;12;2022-08-23;0;0;0;0;0;0;0;0;0;0;0;0;0;0;0;0;0;0
FR;12;2022-08-24;0;0;0;0;0;0;0;0;0;0;0;0;0;0;0;0;0;0
FR;12;2022-08-25;0;0;0;0;0;0;0;0;0;0;0;0;0;0;0;0;0;0
FR;12;2022-08-26;0;0;0;0;0;0;0;0;0;0;0;0;0;0;0;0;0;0
FR;12;2022-08-27;0;0;0;0;0;0;0;0;0;0;0;0;0;0;0;0;0;0
FR;12;2022-08-28;0;0;0;0;0;0;0;0;0;0;0;0;0;0;0;0;0;0
FR;12;2022-08-29;0;0;0;0;0;0;0;0;0;0;0;0;0;0;0;0;0;0
FR;12;2022-08-30;0;0;0;0;0;0;0;0;0;0;0;0;0;0;0;0;0;0
FR;12;2022-08-31;0;0;0;0;0;0;0;0;0;0;0;0;0;0;0;0;0;0
FR;12;2022-09-01;0;0;0;0;0;0;0;0;0;0;0;0;0;0;0;0;0;0
FR;12;2022-09-02;0;0;0;0;0;0;0;0;0;0;0;0;0;0;0;0;0;0
FR;12;2022-09-03;0;0;0;0;0;0;0;0;0;0;0;0;0;0;0;0;0;0
FR;12;2022-09-04;0;0;0;0;0;0;0;0;0;0;0;0;0;0;0;0;0;0
FR;12;2022-09-05;0;0;0;0;0;0;0;0;0;0;0;0;0;0;0;0;0;0
FR;12;2022-09-06;0;0;0;0;0;0;0;0;0;0;0;0;0;0;0;0;0;0
FR;12;2022-09-07;0;0;0;0;0;0;0;0;0;0;0;0;0;0;0;0;0;0
FR;12;2022-09-08;0;0;0;0;0;0;0;0;0;0;0;0;0;0;0;0;0;0
FR;12;2022-09-09;0;0;0;0;0;0;0;0;0;0;0;0;0;0;0;0;0;0
FR;12;2022-09-10;0;0;0;0;0;0;0;0;0;0;0;0;0;0;0;0;0;0
FR;12;2022-09-11;0;0;0;0;0;0;0;0;0;0;0;0;0;0;0;0;0;0
FR;12;2022-09-12;0;0;0;0;0;0;0;0;0;0;0;0;0;0;0;0;0;0
FR;12;2022-09-13;0;0;0;0;0;0;0;0;0;0;0;0;0;0;0;0;0;0
FR;12;2022-09-14;0;0;0;0;0;0;0;0;0;0;0;0;0;0;0;0;0;0
FR;12;2022-09-15;0;0;0;0;0;0;0;0;0;0;0;0;0;0;0;0;0;0
FR;12;2022-09-16;0;0;0;0;0;0;0;0;0;0;0;0;0;0;0;0;0;0
FR;12;2022-09-17;0;0;0;0;0;0;0;0;0;0;0;0;0;0;0;0;0;0
FR;12;2022-09-18;0;0;0;0;0;0;0;0;0;0;0;0;0;0;0;0;0;0
FR;12;2022-09-19;0;0;0;0;0;0;0;0;0;0;0;0;0;0;0;0;0;0
FR;12;2022-09-20;0;0;0;0;0;0;0;0;0;0;0;0;0;0;0;0;0;0
FR;12;2022-09-21;0;0;0;0;0;0;0;0;0;0;0;0;0;0;0;0;0;0
FR;12;2022-09-22;0;0;0;0;0;0;0;0;0;0;0;0;0;0;0;0;0;0
FR;12;2022-09-23;0;0;0;0;0;0;0;0;0;0;0;0;0;0;0;0;0;0
FR;12;2022-09-24;0;0;0;0;0;0;0;0;0;0;0;0;0;0;0;0;0;0
FR;12;2022-09-25;0;0;0;0;0;0;0;0;0;0;0;0;0;0;0;0;0;0
FR;12;2022-09-26;0;0;0;0;0;0;0;0;0;0;0;0;0;0;0;0;0;0
FR;12;2022-09-27;0;0;0;0;0;0;0;0;0;0;0;0;0;0;0;0;0;0
FR;12;2022-09-28;0;0;0;0;0;0;0;0;0;0;0;0;0;0;0;0;0;0
FR;12;2022-09-29;0;0;0;0;0;0;0;0;0;0;0;0;0;0;0;0;0;0
FR;12;2022-09-30;0;0;0;0;0;0;0;0;0;0;0;0;0;0;0;0;0;0
FR;12;2022-10-01;0;0;0;0;0;0;0;0;0;0;0;0;0;0;0;0;0;0
FR;12;2022-10-02;0;0;0;0;0;0;0;0;0;0;0;0;0;0;0;0;0;0
FR;12;2022-10-03;0;0;0;0;0;0;0;0;0;0;0;0;0;0;0;0;0;0
FR;12;2022-10-04;0;0;0;0;0;0;0;0;0;0;0;0;0;0;0;0;0;0
FR;12;2022-10-05;0;0;0;0;0;0;0;0;0;0;0;0;0;0;0;0;0;0
FR;12;2022-10-06;0;0;0;0;0;0;0;0;0;0;0;0;0;0;0;0;0;0
FR;12;2022-10-07;0;0;0;0;0;0;0;0;0;0;0;0;0;0;0;0;0;0
FR;12;2022-10-08;0;0;0;0;0;0;0;0;0;0;0;0;0;0;0;0;0;0
FR;12;2022-10-09;0;0;0;0;0;0;0;0;0;0;0;0;0;0;0;0;0;0
FR;12;2022-10-10;0;0;0;0;0;0;0;0;0;0;0;0;0;0;0;0;0;0
FR;12;2022-10-11;0;0;0;0;0;0;0;0;0;0;0;0;0;0;0;0;0;0
FR;12;2022-10-12;0;0;0;0;0;0;0;0;0;0;0;0;0;0;0;0;0;0
FR;12;2022-10-13;0;0;0;0;0;0;0;0;0;0;0;0;0;0;0;0;0;0
FR;12;2022-10-14;0;0;0;0;0;0;0;0;0;0;0;0;0;0;0;0;0;0
FR;12;2022-10-15;0;0;0;0;0;0;0;0;0;0;0;0;0;0;0;0;0;0
FR;12;2022-10-16;0;0;0;0;0;0;0;0;0;0;0;0;0;0;0;0;0;0
FR;12;2022-10-17;0;0;0;0;0;0;0;0;0;0;0;0;0;0;0;0;0;0
FR;12;2022-10-18;0;0;0;0;0;0;0;0;0;0;0;0;0;0;0;0;0;0
FR;12;2022-10-19;0;0;0;0;0;0;0;0;0;0;0;0;0;0;0;0;0;0
FR;12;2022-10-20;0;0;0;0;0;0;0;0;0;0;0;0;0;0;0;0;0;0
FR;12;2022-10-21;0;0;0;0;0;0;0;0;0;0;0;0;0;0;0;0;0;0
FR;12;2022-10-22;0;0;0;0;0;0;0;0;0;0;0;0;0;0;0;0;0;0
FR;12;2022-10-23;0;0;0;0;0;0;0;0;0;0;0;0;0;0;0;0;0;0
FR;12;2022-10-24;0;0;0;0;0;0;0;0;0;0;0;0;0;0;0;0;0;0
FR;12;2022-10-25;0;0;0;0;0;0;0;0;0;0;0;0;0;0;0;0;0;0
FR;12;2022-10-26;0;0;0;0;0;0;0;0;0;0;0;0;0;0;0;0;0;0
FR;12;2022-10-27;0;0;0;0;0;0;0;0;0;0;0;0;0;0;0;0;0;0
FR;12;2022-10-28;0;0;0;0;0;0;0;0;0;0;0;0;0;0;0;0;0;0
FR;12;2022-10-29;0;0;0;0;0;0;0;0;0;0;0;0;0;0;0;0;0;0
FR;12;2022-10-30;0;0;0;0;0;0;0;0;0;0;0;0;0;0;0;0;0;0
FR;12;2022-10-31;0;0;0;0;0;0;0;0;0;0;0;0;0;0;0;0;0;0
FR;12;2022-11-01;0;0;0;0;0;0;0;0;0;0;0;0;0;0;0;0;0;0
FR;12;2022-11-02;0;0;0;0;0;0;0;0;0;0;0;0;0;0;0;0;0;0
FR;12;2022-11-03;0;0;0;0;0;0;0;0;0;0;0;0;0;0;0;0;0;0
FR;12;2022-11-04;0;0;0;0;0;0;0;0;0;0;0;0;0;0;0;0;0;0
FR;12;2022-11-05;0;0;0;0;0;0;0;0;0;0;0;0;0;0;0;0;0;0
FR;12;2022-11-06;0;0;0;0;0;0;0;0;0;0;0;0;0;0;0;0;0;0
FR;12;2022-11-07;0;0;0;0;0;0;0;0;0;0;0;0;0;0;0;0;0;0
FR;12;2022-11-08;0;0;0;0;0;0;0;0;0;0;0;0;0;0;0;0;0;0
FR;12;2022-11-09;0;0;0;0;0;0;0;0;0;0;0;0;0;0;0;0;0;0
FR;12;2022-11-10;0;0;0;0;0;0;0;0;0;0;0;0;0;0;0;0;0;0
FR;12;2022-11-11;0;0;0;0;0;0;0;0;0;0;0;0;0;0;0;0;0;0
FR;12;2022-11-12;0;0;0;0;0;0;0;0;0;0;0;0;0;0;0;0;0;0
FR;12;2022-11-13;0;0;0;0;0;0;0;0;0;0;0;0;0;0;0;0;0;0
FR;12;2022-11-14;0;0;0;0;0;0;0;0;0;0;0;0;0;0;0;0;0;0
FR;12;2022-11-15;0;0;0;0;0;0;0;0;0;0;0;0;0;0;0;0;0;0
FR;12;2022-11-16;0;0;0;0;0;0;0;0;0;0;0;0;0;0;0;0;0;0
FR;12;2022-11-17;0;0;0;0;0;0;0;0;0;0;0;0;0;0;0;0;0;0
FR;12;2022-11-18;0;0;0;0;0;0;0;0;0;0;0;0;0;0;0;0;0;0
FR;12;2022-11-19;0;0;0;0;0;0;0;0;0;0;0;0;0;0;0;0;0;0
FR;12;2022-11-20;0;0;0;0;0;0;0;0;0;0;0;0;0;0;0;0;0;0
FR;12;2022-11-21;0;0;0;0;0;0;0;0;0;0;0;0;0;0;0;0;0;0
FR;12;2022-11-22;0;0;0;0;0;0;0;0;0;0;0;0;0;0;0;0;0;0
FR;12;2022-11-23;0;0;0;0;0;0;0;0;0;0;0;0;0;0;0;0;0;0
FR;12;2022-11-24;0;0;0;0;0;0;0;0;0;0;0;0;0;0;0;0;0;0
FR;12;2022-11-25;0;0;0;0;0;0;0;0;0;0;0;0;0;0;0;0;0;0
FR;12;2022-11-26;0;0;0;0;0;0;0;0;0;0;0;0;0;0;0;0;0;0
FR;12;2022-11-27;0;0;0;0;0;0;0;0;0;0;0;0;0;0;0;0;0;0
FR;12;2022-11-28;0;0;0;0;0;0;0;0;0;0;0;0;0;0;0;0;0;0
FR;12;2022-11-29;0;0;0;0;0;0;0;0;0;0;0;0;0;0;0;0;0;0
FR;12;2022-11-30;0;0;0;0;0;0;0;0;0;0;0;0;0;0;0;0;0;0
FR;12;2022-12-01;0;0;0;0;0;0;0;0;0;0;0;0;0;0;0;0;0;0
FR;12;2022-12-02;0;0;0;0;0;0;0;0;0;0;0;0;0;0;0;0;0;0
FR;12;2022-12-03;0;0;0;0;0;0;0;0;0;0;0;0;0;0;0;0;0;0
FR;12;2022-12-04;0;0;0;0;0;0;0;0;0;0;0;0;0;0;0;0;0;0
FR;12;2022-12-05;0;0;0;0;0;0;0;0;0;0;0;0;0;0;0;0;0;0
FR;12;2022-12-06;0;0;0;0;0;0;0;0;0;0;0;0;0;0;0;0;0;0
FR;12;2022-12-07;0;0;0;0;0;0;0;0;0;0;0;0;0;0;0;0;0;0
FR;12;2022-12-08;0;0;0;0;0;0;0;0;0;0;0;0;0;0;0;0;0;0
FR;12;2022-12-09;0;0;0;0;0;0;0;0;0;0;0;0;0;0;0;0;0;0
FR;12;2022-12-10;0;0;0;0;0;0;0;0;0;0;0;0;0;0;0;0;0;0
FR;12;2022-12-11;0;0;0;0;0;0;0;0;0;0;0;0;0;0;0;0;0;0
FR;12;2022-12-12;0;0;0;0;0;0;0;0;0;0;0;0;0;0;0;0;0;0
FR;12;2022-12-13;0;0;0;0;0;0;0;0;0;0;0;0;0;0;0;0;0;0
FR;12;2022-12-14;0;0;0;0;0;0;0;0;0;0;0;0;0;0;0;0;0;0
FR;12;2022-12-15;0;0;0;0;0;0;0;0;0;0;0;0;0;0;0;0;0;0
FR;12;2022-12-16;0;0;0;0;0;0;0;0;0;0;0;0;0;0;0;0;0;0
FR;12;2022-12-17;0;0;0;0;0;0;0;0;0;0;0;0;0;0;0;0;0;0
FR;12;2022-12-18;0;0;0;0;0;0;0;0;0;0;0;0;0;0;0;0;0;0
FR;12;2022-12-19;0;0;0;0;0;0;0;0;0;0;0;0;0;0;0;0;0;0
FR;12;2022-12-20;0;0;0;0;0;0;0;0;0;0;0;0;0;0;0;0;0;0
FR;12;2022-12-21;0;0;0;0;0;0;0;0;0;0;0;0;0;0;0;0;0;0
FR;12;2022-12-22;0;0;0;0;0;0;0;0;0;0;0;0;0;0;0;0;0;0
FR;12;2022-12-23;0;0;0;0;0;0;0;0;0;0;0;0;0;0;0;0;0;0
FR;12;2022-12-24;0;0;0;0;0;0;0;0;0;0;0;0;0;0;0;0;0;0
FR;12;2022-12-25;0;0;0;0;0;0;0;0;0;0;0;0;0;0;0;0;0;0
FR;12;2022-12-26;0;0;0;0;0;0;0;0;0;0;0;0;0;0;0;0;0;0
FR;12;2022-12-27;0;0;0;0;0;0;0;0;0;0;0;0;0;0;0;0;0;0
FR;12;2022-12-28;0;0;0;0;0;0;0;0;0;0;0;0;0;0;0;0;0;0
FR;12;2022-12-29;0;0;0;0;0;0;0;0;0;0;0;0;0;0;0;0;0;0
FR;12;2022-12-30;0;0;0;0;0;0;0;0;0;0;0;0;0;0;0;0;0;0
FR;12;2022-12-31;0;0;0;0;0;0;0;0;0;0;0;0;0;0;0;0;0;0
FR;12;2023-01-01;0;0;0;0;0;0;0;0;0;0;0;0;0;0;0;0;0;0
FR;12;2023-01-02;0;0;0;0;0;0;0;0;0;0;0;0;0;0;0;0;0;0
FR;12;2023-01-03;0;0;0;0;0;0;0;0;0;0;0;0;0;0;0;0;0;0
FR;12;2023-01-04;0;0;0;0;0;0;0;0;0;0;0;0;0;0;0;0;0;0
FR;12;2023-01-05;0;0;0;0;0;0;0;0;0;0;0;0;0;0;0;0;0;0
FR;12;2023-01-06;0;0;0;0;0;0;0;0;0;0;0;0;0;0;0;0;0;0
FR;12;2023-01-07;0;0;0;0;0;0;0;0;0;0;0;0;0;0;0;0;0;0
FR;12;2023-01-08;0;0;0;0;0;0;0;0;0;0;0;0;0;0;0;0;0;0
FR;12;2023-01-09;0;0;0;0;0;0;0;0;0;0;0;0;0;0;0;0;0;0
FR;12;2023-01-10;0;0;0;0;0;0;0;0;0;0;0;0;0;0;0;0;0;0
FR;12;2023-01-11;0;0;0;0;0;0;0;0;0;0;0;0;0;0;0;0;0;0
FR;12;2023-01-12;0;0;0;0;0;0;0;0;0;0;0;0;0;0;0;0;0;0
FR;12;2023-01-13;0;0;0;0;0;0;0;0;0;0;0;0;0;0;0;0;0;0
FR;12;2023-01-14;0;0;0;0;0;0;0;0;0;0;0;0;0;0;0;0;0;0
FR;12;2023-01-15;0;0;0;0;0;0;0;0;0;0;0;0;0;0;0;0;0;0
FR;12;2023-01-16;0;0;0;0;0;0;0;0;0;0;0;0;0;0;0;0;0;0
FR;12;2023-01-17;0;0;0;0;0;0;0;0;0;0;0;0;0;0;0;0;0;0
FR;12;2023-01-18;0;0;0;0;0;0;0;0;0;0;0;0;0;0;0;0;0;0
FR;12;2023-01-19;0;0;0;0;0;0;0;0;0;0;0;0;0;0;0;0;0;0
FR;12;2023-01-20;0;0;0;0;0;0;0;0;0;0;0;0;0;0;0;0;0;0
FR;12;2023-01-21;0;0;0;0;0;0;0;0;0;0;0;0;0;0;0;0;0;0
FR;12;2023-01-22;0;0;0;0;0;0;0;0;0;0;0;0;0;0;0;0;0;0
FR;12;2023-01-23;0;0;0;0;0;0;0;0;0;0;0;0;0;0;0;0;0;0
FR;12;2023-01-24;0;0;0;0;0;0;0;0;0;0;0;0;0;0;0;0;0;0
FR;12;2023-01-25;0;0;0;0;0;0;0;0;0;0;0;0;0;0;0;0;0;0
FR;12;2023-01-26;0;0;0;0;0;0;0;0;0;0;0;0;0;0;0;0;0;0
FR;12;2023-01-27;0;0;0;0;0;0;0;0;0;0;0;0;0;0;0;0;0;0
FR;12;2023-01-28;0;0;0;0;0;0;0;0;0;0;0;0;0;0;0;0;0;0
FR;12;2023-01-29;0;0;0;0;0;0;0;0;0;0;0;0;0;0;0;0;0;0
FR;12;2023-01-30;0;0;0;0;0;0;0;0;0;0;0;0;0;0;0;0;0;0
FR;12;2023-01-31;0;0;0;0;0;0;0;0;0;0;0;0;0;0;0;0;0;0
FR;12;2023-02-01;0;0;0;0;0;0;0;0;0;0;0;0;0;0;0;0;0;0
FR;12;2023-02-02;0;0;0;1;0;0;0;2;2;0;0;0;1;0;0;0;2;2
FR;12;2023-02-03;0;1;6;57;0;4;58;141;77;0;1;6;58;0;4;58;143;79
FR;12;2023-02-04;1;3;6;51;1;5;52;110;52;1;4;12;109;1;9;110;253;131
FR;12;2023-02-05;0;0;0;0;0;0;0;1;1;1;4;12;109;1;9;110;254;132
FR;12;2023-02-06;3;2;13;63;0;11;69;154;69;4;6;25;172;1;20;179;408;201
FR;12;2023-02-07;2;7;18;95;4;13;98;237;121;6;13;43;267;5;33;277;645;322
FR;12;2023-02-08;1;3;10;62;1;10;69;170;89;7;16;53;329;6;43;346;815;411
FR;12;2023-02-09;5;3;12;73;2;13;76;246;154;12;19;65;402;8;56;422;1061;565
FR;12;2023-02-10;4;2;22;140;4;12;150;327;162;16;21;87;542;12;68;572;1388;727
FR;12;2023-02-11;0;2;8;59;1;3;58;123;60;16;23;95;601;13;71;630;1511;787
FR;12;2023-02-12;0;0;0;3;0;0;3;7;3;16;23;95;604;13;71;633;1518;790
FR;12;2023-02-13;0;0;17;78;0;8;85;217;114;16;23;112;682;13;79;718;1735;904
FR;12;2023-02-14;3;5;17;96;5;14;99;229;108;19;28;129;778;18;93;817;1964;1012
FR;12;2023-02-15;3;5;19;85;0;13;86;236;132;22;33;148;863;18;106;903;2200;1144
FR;12;2023-02-16;5;3;16;107;3;13;103;247;129;27;36;164;970;21;119;1006;2447;1273
FR;12;2023-02-17;2;4;12;115;3;11;110;280;153;29;40;176;1085;24;130;1116;2727;1426
FR;12;2023-02-18;1;4;10;51;2;12;52;102;36;30;44;186;1136;26;142;1168;2829;1462
FR;12;2023-02-19;0;0;0;2;0;0;1;2;1;30;44;186;1138;26;142;1169;2831;1463
FR;12;2023-02-20;10;1;11;65;6;10;69;217;131;40;45;197;1203;32;152;1238;3048;1594
FR;12;2023-02-21;6;6;19;98;4;14;94;280;167;46;51;216;1301;36;166;1332;3328;1761
FR;12;2023-02-22;2;4;19;74;2;20;78;231;125;48;55;235;1375;38;186;1410;3559;1886
FR;12;2023-02-23;4;3;20;88;2;16;87;265;155;52;58;255;1463;40;202;1497;3824;2041
FR;12;2023-02-24;3;7;20;135;3;17;142;360;189;55;65;275;1598;43;219;1639;4184;2230
FR;12;2023-02-25;7;1;19;92;1;10;106;200;77;62;66;294;1690;44;229;1745;4384;2307
FR;12;2023-02-26;0;0;0;0;0;0;0;2;2;62;66;294;1690;44;229;1745;4386;2309
FR;12;2023-02-27;6;10;20;92;8;16;95;270;156;68;76;314;1782;52;245;1840;4656;2465
FR;12;2023-02-28;6;9;21;125;0;23;128;385;227;74;85;335;1907;52;268;1968;5041;2692
FR;12;2023-03-01;4;7;23;78;2;18;91;292;175;78;92;358;1985;54;286;2059;5333;2867
FR;12;2023-03-02;7;9;21;108;6;18;115;302;163;85;101;379;2093;60;304;2174;5635;3030
FR;12;2023-03-03;10;8;45;142;7;39;148;418;220;95;109;424;2235;67;343;2322;6053;3250
FR;12;2023-03-04;3;2;12;55;0;10;53;119;49;98;111;436;2290;67;353;2375;6172;3299
FR;12;2023-03-05;0;1;1;2;1;1;2;8;5;98;112;437;2292;68;354;2377;6180;3304
FR;12;2023-03-06;4;5;26;74;2;19;82;267;157;102;117;463;2366;70;373;2459;6447;3461
FR;12;2023-03-07;6;10;29;130;9;24;132;356;191;108;127;492;2496;79;397;2591;6803;3652
FR;12;2023-03-08;4;7;27;71;5;22;77;249;137;112;134;519;2567;84;419;2668;7052;3789
FR;12;2023-03-09;3;8;18;91;4;22;85;323;197;115;142;537;2658;88;441;2753;7375;3986
FR;12;2023-03-10;11;7;23;137;9;23;133;367;208;126;149;560;2795;97;464;2886;7742;4194
FR;12;2023-03-11;1;4;15;45;4;9;50;132;72;127;153;575;2840;101;473;2936;7874;4266
FR;12;2023-03-12;0;2;0;2;0;2;1;5;2;127;155;575;2842;101;475;2937;7879;4268
FR;12;2023-03-13;3;4;32;101;1;28;103;293;155;130;159;607;2943;102;503;3040;8172;4423
FR;12;2023-03-14;2;7;16;85;2;15;83;322;210;132;166;623;3028;104;518;3123;8494;4633
FR;12;2023-03-15;1;4;20;66;2;19;69;225;124;133;170;643;3094;106;537;3192;8719;4757
FR;12;2023-03-16;4;5;20;98;5;13;114;297;156;137;175;663;3192;111;550;3306;9016;4913
FR;12;2023-03-17;3;11;30;112;4;28;113;388;224;140;186;693;3304;115;578;3419;9404;5137
FR;12;2023-03-18;1;4;20;50;4;16;56;137;61;141;190;713;3354;119;594;3475;9541;5198
FR;12;2023-03-19;0;0;0;6;0;0;5;10;5;141;190;713;3360;119;594;3480;9551;5203
FR;12;2023-03-20;9;7;27;87;6;23;90;258;134;150;197;740;3447;125;617;3570;9809;5337
FR;12;2023-03-21;2;7;42;81;3;36;93;351;205;152;204;782;3528;128;653;3663;10160;5542
FR;12;2023-03-22;6;4;35;49;4;28;57;236;137;158;208;817;3577;132;681;3720;10396;5679
FR;12;2023-03-23;3;8;26;79;5;25;81;261;145;161;216;843;3656;137;706;3801;10657;5824
FR;12;2023-03-24;6;2;24;97;3;22;106;343;203;167;218;867;3753;140;728;3907;11000;6027
FR;12;2023-03-25;7;8;22;58;3;14;69;149;56;174;226;889;3811;143;742;3976;11149;6083
FR;12;2023-03-26;0;1;0;1;1;0;1;5;4;174;227;889;3812;144;742;3977;11154;6087
FR;0;2020-12-27;616;0;0;0;55;0;0;0;0;616;0;0;0;55;0;0;0;0
FR;0;2020-12-28;707;1;0;0;44;0;0;0;0;1323;1;0;0;99;0;0;0;0
FR;0;2020-12-29;389;0;0;0;19;0;0;0;0;1712;1;0;0;118;0;0;0;0
FR;0;2020-12-30;455;0;0;0;19;0;0;0;0;2167;1;0;0;137;0;0;0;0
FR;0;2020-12-31;450;1;0;0;21;0;0;0;0;2617;2;0;0;158;0;0;0;0
FR;0;2021-01-01;1193;2;0;0;66;0;0;0;0;3810;4;0;0;224;0;0;0;0
FR;0;2021-01-02;369;4;0;0;29;0;0;0;0;4179;8;0;0;253;0;0;0;0
FR;0;2021-01-03;418;0;0;0;23;0;0;0;0;4597;8;0;0;276;0;0;0;0
FR;0;2021-01-04;2145;5;0;0;51;0;0;0;0;6742;13;0;0;327;0;0;0;0
FR;0;2021-01-05;7777;6;0;0;128;0;0;0;0;14519;19;0;0;455;0;0;0;0
FR;0;2021-01-06;12479;23;0;0;128;0;0;0;0;26998;42;0;0;583;0;0;0;0
FR;0;2021-01-07;29480;24;0;0;159;0;0;0;0;56478;66;0;0;742;0;0;0;0
FR;0;2021-01-08;37170;35;0;0;204;0;0;0;0;93648;101;0;0;946;0;0;0;0
FR;0;2021-01-09;11220;9;0;0;77;0;0;0;0;104868;110;0;0;1023;0;0;0;0
FR;0;2021-01-10;6016;8;0;0;28;0;0;0;0;110884;118;0;0;1051;0;0;0;0
FR;0;2021-01-11;39956;39;0;0;232;0;0;0;0;150840;157;0;0;1283;0;0;0;0
FR;0;2021-01-12;62162;30;0;0;298;0;0;0;0;213002;187;0;0;1581;0;0;0;0
FR;0;2021-01-13;65147;62;0;0;433;0;0;0;0;278149;249;0;0;2014;0;0;0;0
FR;0;2021-01-14;83109;261;0;0;1171;0;0;0;0;361258;510;0;0;3185;0;0;0;0
FR;0;2021-01-15;69036;101;0;0;556;0;0;0;0;430294;611;0;0;3741;0;0;0;0
FR;0;2021-01-16;20219;73;0;0;183;0;0;0;0;450513;684;0;0;3924;0;0;0;0
FR;0;2021-01-17;10993;54;0;0;137;0;0;0;0;461506;738;0;0;4061;0;0;0;0
FR;0;2021-01-18;85923;179;0;0;615;0;0;0;0;547429;917;0;0;4676;0;0;0;0
FR;0;2021-01-19;130616;211;0;0;869;0;0;0;0;678045;1128;0;0;5545;0;0;0;0
FR;0;2021-01-20;137576;196;0;0;837;0;0;0;0;815621;1324;0;0;6382;0;0;0;0
FR;0;2021-01-21;158430;205;0;0;951;0;0;0;0;974051;1529;0;0;7333;0;0;0;0
FR;0;2021-01-22;121090;258;0;0;845;0;0;0;0;1095141;1787;0;0;8178;0;0;0;0
FR;0;2021-01-23;38492;86;0;0;223;0;0;0;0;1133633;1873;0;0;8401;0;0;0;0
FR;0;2021-01-24;9752;130;0;0;195;0;0;0;0;1143385;2003;0;0;8596;0;0;0;0
FR;0;2021-01-25;78256;1457;0;0;1808;0;0;0;0;1221641;3460;0;0;10404;0;0;0;0
FR;0;2021-01-26;100401;3708;1;0;4185;0;0;0;0;1322042;7168;1;0;14589;0;0;0;0
FR;0;2021-01-27;107266;6444;0;0;7160;0;0;0;0;1429308;13612;1;0;21749;0;0;0;0
FR;0;2021-01-28;124384;16410;0;0;17234;0;0;0;0;1553692;30022;1;0;38983;0;0;0;0
FR;0;2021-01-29;92201;18801;0;0;19378;0;0;0;0;1645893;48823;1;0;58361;0;0;0;0
FR;0;2021-01-30;29128;4535;0;0;4672;0;0;0;0;1675021;53358;1;0;63033;0;0;0;0
FR;0;2021-01-31;5240;1900;0;0;1945;0;0;0;0;1680261;55258;1;0;64978;0;0;0;0
FR;0;2021-02-01;53160;23047;0;0;23320;0;0;0;0;1733421;78305;1;0;88298;0;0;0;0
FR;0;2021-02-02;72334;38204;0;0;38696;0;0;0;0;1805755;116509;1;0;126994;0;0;0;0
FR;0;2021-02-03;72327;40245;0;0;40751;0;0;0;0;1878082;156754;1;0;167745;0;0;0;0
FR;0;2021-02-04;82096;55123;0;0;55719;0;0;0;0;1960178;211877;1;0;223464;0;0;0;0
FR;0;2021-02-05;68252;48238;0;0;48676;0;0;0;0;2028430;260115;1;0;272140;0;0;0;0
FR;0;2021-02-06;22952;11434;0;0;11673;0;0;0;0;2051382;271549;1;0;283813;0;0;0;0
FR;0;2021-02-07;5195;6073;0;0;6199;0;0;0;0;2056577;277622;1;0;290012;0;0;0;0
FR;0;2021-02-08;46856;48793;0;0;49281;0;0;0;0;2103433;326415;1;0;339293;0;0;0;0
FR;0;2021-02-09;66048;78452;0;0;79549;0;0;0;0;2169481;404867;1;0;418842;0;0;0;0
FR;0;2021-02-10;71048;83494;0;0;84791;0;0;0;0;2240529;488361;1;0;503633;0;0;0;0
FR;0;2021-02-11;87308;105647;0;0;107595;0;0;0;0;2327837;594008;1;0;611228;0;0;0;0
FR;0;2021-02-12;79355;76085;0;0;77833;0;0;0;0;2407192;670093;1;0;689061;0;0;0;0
FR;0;2021-02-13;22391;19536;0;0;19903;0;0;0;0;2429583;689629;1;0;708964;0;0;0;0
FR;0;2021-02-14;5080;7334;0;0;7462;0;0;0;0;2434663;696963;1;0;716426;0;0;0;0
FR;0;2021-02-15;38132;76798;0;0;77819;0;0;0;0;2472795;773761;1;0;794245;0;0;0;0
FR;0;2021-02-16;50420;99690;0;0;101039;0;0;0;0;2523215;873451;1;0;895284;0;0;0;0
FR;0;2021-02-17;50557;106928;20;0;108377;0;0;0;0;2573772;980379;21;0;1003661;0;0;0;0
FR;0;2021-02-18;69814;123723;0;0;125772;0;0;0;0;2643586;1104102;21;0;1129433;0;0;0;0
FR;0;2021-02-19;65093;92324;1;0;94215;0;0;0;0;2708679;1196426;22;0;1223648;0;0;0;0
FR;0;2021-02-20;18602;28547;0;0;28918;0;0;0;0;2727281;1224973;22;0;1252566;0;0;0;0
FR;0;2021-02-21;3335;6041;0;0;6146;0;0;0;0;2730616;1231014;22;0;1258712;0;0;0;0
FR;0;2021-02-22;37512;73172;2;0;74185;0;0;0;0;2768128;1304186;24;0;1332897;0;0;0;0
FR;0;2021-02-23;53803;85296;1;0;86818;0;0;0;0;2821931;1389482;25;0;1419715;0;0;0;0
FR;0;2021-02-24;60039;82932;1;0;84513;0;0;0;0;2881970;1472414;26;0;1504228;0;0;0;0
FR;0;2021-02-25;100611;91209;1;0;94207;0;0;0;0;2982581;1563623;27;0;1598435;0;0;0;0
FR;0;2021-02-26;113491;70753;1;0;73903;0;0;0;0;3096072;1634376;28;0;1672338;0;0;0;0
FR;0;2021-02-27;52131;22439;1;0;23684;0;0;0;0;3148203;1656815;29;0;1696022;0;0;0;0
FR;0;2021-02-28;6209;4121;2;0;4319;0;0;0;0;3154412;1660936;31;0;1700341;0;0;0;0
FR;0;2021-03-01;65945;54065;1;0;55936;0;0;0;0;3220357;1715001;32;0;1756277;0;0;0;0
FR;0;2021-03-02;101415;67172;3;0;70218;0;0;0;0;3321772;1782173;35;0;1826495;0;0;0;0
FR;0;2021-03-03;116565;65474;0;0;69164;0;0;0;0;3438337;1847647;35;0;1895659;0;0;0;0
FR;0;2021-03-04;163662;72628;3;0;78198;0;0;0;0;3601999;1920275;38;0;1973857;0;0;0;0
FR;0;2021-03-05;200962;62704;3;0;69437;0;0;0;0;3802961;1982979;41;0;2043294;0;0;0;0
FR;0;2021-03-06;207992;17482;3;0;22784;0;0;0;0;4010953;2000461;44;0;2066078;0;0;0;0
FR;0;2021-03-07;121293;3974;1;0;7268;0;0;0;0;4132246;2004435;45;0;2073346;0;0;0;0
FR;0;2021-03-08;107180;49557;2;0;53045;0;0;0;0;4239426;2053992;47;0;2126391;0;0;0;0
FR;0;2021-03-09;172487;56023;2;0;61517;0;0;0;0;4411913;2110015;49;0;2187908;0;0;0;0
FR;0;2021-03-10;179042;57054;5;0;62729;0;0;0;0;4590955;2167069;54;0;2250637;0;0;0;0
FR;0;2021-03-11;242933;64019;2;0;72116;0;0;0;0;4833888;2231088;56;0;2322753;0;0;0;0
FR;0;2021-03-12;294876;53366;1;0;62822;0;0;0;0;5128764;2284454;57;0;2385575;0;0;0;0
FR;0;2021-03-13;231445;15263;1;0;21241;0;0;0;0;5360209;2299717;58;0;2406816;0;0;0;0
FR;0;2021-03-14;63364;3044;1;0;5080;0;0;0;0;5423573;2302761;59;0;2411896;0;0;0;0
FR;0;2021-03-15;158699;31500;3;0;36155;0;0;0;0;5582272;2334261;62;0;2448051;0;0;0;0
FR;0;2021-03-16;141598;38816;6;0;42967;0;0;0;0;5723870;2373077;68;0;2491018;0;0;0;0
FR;0;2021-03-17;150519;37566;4;0;42333;0;0;0;0;5874389;2410643;72;0;2533351;0;0;0;0
FR;0;2021-03-18;167869;44324;5;0;49891;0;0;0;0;6042258;2454967;77;0;2583242;0;0;0;0
FR;0;2021-03-19;230056;36747;2;0;44105;0;0;0;0;6272314;2491714;79;0;2627347;0;0;0;0
FR;0;2021-03-20;166719;11385;1;0;16010;0;0;0;0;6439033;2503099;80;0;2643357;0;0;0;0
FR;0;2021-03-21;49957;2133;1;0;3891;0;0;0;0;6488990;2505232;81;0;2647248;0;0;0;0
FR;0;2021-03-22;170085;33521;2;0;39024;0;0;0;0;6659075;2538753;83;0;2686272;0;0;0;0
FR;0;2021-03-23;250440;42379;1;0;50225;0;0;0;0;6909515;2581132;84;0;2736497;0;0;0;0
FR;0;2021-03-24;256949;43591;0;0;51690;0;0;0;0;7166464;2624723;84;0;2788187;0;0;0;0
FR;0;2021-03-25;341875;45286;5;0;56290;0;0;0;0;7508339;2670009;89;0;2844477;0;0;0;0
FR;0;2021-03-26;358848;41801;5;1;53559;0;0;0;0;7867187;2711810;94;1;2898036;0;0;0;0
FR;0;2021-03-27;195297;16953;1;0;23397;0;0;0;0;8062484;2728763;95;1;2921433;0;0;0;0
FR;0;2021-03-28;59358;4587;3;0;6652;0;0;0;0;8121842;2733350;98;1;2928085;0;0;0;0
FR;0;2021-03-29;203028;53398;4;0;60162;0;0;0;0;8324870;2786748;102;1;2988247;0;0;0;0
FR;0;2021-03-30;285547;70036;5;0;80448;0;0;0;0;8610417;2856784;107;1;3068695;0;0;0;0
FR;0;2021-03-31;263082;74055;4;0;84727;0;0;0;0;8873499;2930839;111;1;3153422;0;0;0;0
FR;0;2021-04-01;315584;92812;11;0;106394;0;0;0;0;9189083;3023651;122;1;3259816;0;0;0;0
FR;0;2021-04-02;281384;94821;7;0;106652;0;0;0;0;9470467;3118472;129;1;3366468;0;0;0;0
FR;0;2021-04-03;141097;62598;6;0;67859;0;0;0;0;9611564;3181070;135;1;3434327;0;0;0;0
FR;0;2021-04-04;46552;19021;2;0;21074;0;0;0;0;9658116;3200091;137;1;3455401;0;0;0;0
FR;0;2021-04-05;63371;10403;11;0;13060;0;0;0;0;9721487;3210494;148;1;3468461;0;0;0;0
FR;0;2021-04-06;217273;113129;17;0;121994;0;0;0;0;9938760;3323623;165;1;3590455;0;0;0;0
FR;0;2021-04-07;260323;115276;17;0;126629;0;0;0;0;10199083;3438899;182;1;3717084;0;0;0;0
FR;0;2021-04-08;337914;123214;15;0;138843;0;0;0;0;10536997;3562113;197;1;3855927;0;0;0;0
FR;0;2021-04-09;410239;116891;49;0;134299;0;0;0;0;10947236;3679004;246;1;3990226;0;0;0;0
FR;0;2021-04-10;212665;82872;15;0;91263;0;0;0;0;11159901;3761876;261;1;4081489;0;0;0;0
FR;0;2021-04-11;56162;34179;7;0;36705;0;0;0;0;11216063;3796055;268;1;4118194;0;0;0;0
FR;0;2021-04-12;237127;115833;46;0;125442;0;0;0;0;11453190;3911888;314;1;4243636;0;0;0;0
FR;0;2021-04-13;309555;144167;98;1;157131;0;0;0;0;11762745;4056055;412;2;4400767;0;0;0;0
FR;0;2021-04-14;294604;139850;215;0;153230;0;0;0;0;12057349;4195905;627;2;4553997;0;0;0;0
FR;0;2021-04-15;337198;150530;340;0;166071;0;0;0;0;12394547;4346435;967;2;4720068;0;0;0;0
FR;0;2021-04-16;339364;147057;354;0;161715;0;0;0;0;12733911;4493492;1321;2;4881783;0;0;0;0
FR;0;2021-04-17;188689;89983;109;0;97682;0;0;0;0;12922600;4583475;1430;2;4979465;0;0;0;0
FR;0;2021-04-18;51643;35459;48;0;37882;0;0;0;0;12974243;4618934;1478;2;5017347;0;0;0;0
FR;0;2021-04-19;205750;138293;456;0;147452;0;0;0;0;13179993;4757227;1934;2;5164799;0;0;0;0
FR;0;2021-04-20;254494;172038;569;0;183699;0;0;0;0;13434487;4929265;2503;2;5348498;0;0;0;0
FR;0;2021-04-21;253344;170234;836;0;182259;0;0;0;0;13687831;5099499;3339;2;5530757;0;0;0;0
FR;0;2021-04-22;287632;190446;820;0;205042;0;0;0;0;13975463;5289945;4159;2;5735799;0;0;0;0
FR;0;2021-04-23;297686;184736;747;0;203492;0;0;0;0;14273149;5474681;4906;2;5939291;0;0;0;0
FR;0;2021-04-24;190482;112059;252;0;122513;0;0;0;0;14463631;5586740;5158;2;6061804;0;0;0;0
FR;0;2021-04-25;69576;38862;51;0;42593;0;0;0;0;14533207;5625602;5209;2;6104397;0;0;0;0
FR;0;2021-04-26;221007;158706;564;0;171907;0;0;0;0;14754214;5784308;5773;2;6276304;0;0;0;0
FR;0;2021-04-27;284657;188049;941;0;211365;0;0;0;0;15038871;5972357;6714;2;6487669;0;0;0;0
FR;0;2021-04-28;299579;184739;1427;1;209818;1;0;0;0;15338450;6157096;8141;3;6697487;1;0;0;0
FR;0;2021-04-29;357215;198302;1281;0;233389;0;0;0;0;15695665;6355398;9422;3;6930876;1;0;0;0
FR;0;2021-04-30;372268;186143;1124;1;225484;0;0;0;0;16067933;6541541;10546;4;7156360;1;0;0;0
FR;0;2021-05-01;167681;52537;179;0;63783;0;0;0;0;16235614;6594078;10725;4;7220143;1;0;0;0
FR;0;2021-05-02;91771;37865;83;0;43594;0;0;0;0;16327385;6631943;10808;4;7263737;1;0;0;0
FR;0;2021-05-03;288983;165156;843;0;185682;0;0;0;0;16616368;6797099;11651;4;7449419;1;0;0;0
FR;0;2021-05-04;315761;225630;1237;0;251805;0;0;0;0;16932129;7022729;12888;4;7701224;1;0;0;0
FR;0;2021-05-05;327300;226657;1316;0;251738;0;0;0;0;17259429;7249386;14204;4;7952962;1;0;0;0
FR;0;2021-05-06;379620;241283;1634;0;275534;0;0;0;0;17639049;7490669;15838;4;8228496;1;0;0;0
FR;0;2021-05-07;372839;258909;1224;0;299968;0;0;0;0;18011888;7749578;17062;4;8528464;1;0;0;0
FR;0;2021-05-08;222191;71496;300;0;86706;0;0;0;0;18234079;7821074;17362;4;8615170;1;0;0;0
FR;0;2021-05-09;129734;44505;243;0;53143;0;0;0;0;18363813;7865579;17605;4;8668313;1;0;0;0
FR;0;2021-05-10;313435;229734;1239;0;255518;0;0;0;0;18677248;8095313;18844;4;8923831;1;0;0;0
FR;0;2021-05-11;403986;258438;1566;0;296868;0;0;0;0;19081234;8353751;20410;4;9220699;1;0;0;0
FR;0;2021-05-12;434213;233894;1544;0;270183;0;0;0;0;19515447;8587645;21954;4;9490882;1;0;0;0
FR;0;2021-05-13;338642;56436;432;0;77929;0;0;0;0;19854089;8644081;22386;4;9568811;1;0;0;0
FR;0;2021-05-14;454193;167503;1130;0;203114;0;0;0;0;20308282;8811584;23516;4;9771925;1;0;0;0
FR;0;2021-05-15;375018;94402;445;0;120802;0;0;0;0;20683300;8905986;23961;4;9892727;1;0;0;0
FR;0;2021-05-16;202777;20689;168;0;34090;0;0;0;0;20886077;8926675;24129;4;9926817;1;0;0;0
FR;0;2021-05-17;376165;148884;1555;0;178674;0;0;0;0;21262242;9075559;25684;4;10105491;1;0;0;0
FR;0;2021-05-18;460230;154150;1991;0;193305;0;0;0;0;21722472;9229709;27675;4;10298796;1;0;0;0
FR;0;2021-05-19;467471;142542;2466;0;179810;0;0;0;0;22189943;9372251;30141;4;10478606;1;0;0;0
FR;0;2021-05-20;507606;160249;2340;0;204211;0;0;0;0;22697549;9532500;32481;4;10682817;1;0;0;0
FR;0;2021-05-21;489738;175264;1997;0;221816;0;0;0;0;23187287;9707764;34478;4;10904633;1;0;0;0
FR;0;2021-05-22;347227;80248;670;0;108680;0;0;0;0;23534514;9788012;35148;4;11013313;1;0;0;0
FR;0;2021-05-23;161718;14213;246;0;26682;0;0;0;0;23696232;9802225;35394;4;11039995;1;0;0;0
FR;0;2021-05-24;263223;33108;604;0;52946;0;0;0;0;23959455;9835333;35998;4;11092941;1;0;0;0
FR;0;2021-05-25;400319;190474;2357;1;227041;0;0;0;0;24359774;10025807;38355;5;11319982;1;0;0;0
FR;0;2021-05-26;413514;191257;2227;0;229308;0;0;0;0;24773288;10217064;40582;5;11549290;1;0;0;0
FR;0;2021-05-27;449878;220097;2163;0;267244;0;0;0;0;25223166;10437161;42745;5;11816534;1;0;0;0
FR;0;2021-05-28;429615;261172;1895;0;319273;0;0;0;0;25652781;10698333;44640;5;12135807;1;0;0;0
FR;0;2021-05-29;299010;150532;586;0;183389;0;0;0;0;25951791;10848865;45226;5;12319196;1;0;0;0
FR;0;2021-05-30;107156;32504;164;0;42088;0;0;0;0;26058947;10881369;45390;5;12361284;1;0;0;0
FR;0;2021-05-31;358083;203502;1474;1;241786;1;0;0;0;26417030;11084871;46864;6;12603070;2;0;0;0
FR;0;2021-06-01;431145;251304;1969;1;302948;1;0;0;0;26848175;11336175;48833;7;12906018;3;0;0;0
FR;0;2021-06-02;420177;232783;1986;0;280173;0;0;0;0;27268352;11568958;50819;7;13186191;3;0;0;0
FR;0;2021-06-03;465708;257772;1826;0;312548;0;0;0;0;27734060;11826730;52645;7;13498739;3;0;0;0
FR;0;2021-06-04;456307;305898;1735;1;363311;1;0;0;0;28190367;12132628;54380;8;13862050;4;0;0;0
FR;0;2021-06-05;304840;189571;653;0;222797;0;0;0;0;28495207;12322199;55033;8;14084847;4;0;0;0
FR;0;2021-06-06;133342;49018;227;0;61159;0;0;0;0;28628549;12371217;55260;8;14146006;4;0;0;0
FR;0;2021-06-07;340026;261522;1529;0;298613;0;0;0;0;28968575;12632739;56789;8;14444619;4;0;0;0
FR;0;2021-06-08;393960;291405;1806;0;338276;0;0;0;0;29362535;12924144;58595;8;14782895;4;0;0;0
FR;0;2021-06-09;384967;273785;1734;0;318183;0;0;0;0;29747502;13197929;60329;8;15101078;4;0;0;0
FR;0;2021-06-10;404256;286294;1728;1;335748;0;0;0;0;30151758;13484223;62057;9;15436826;4;0;0;0
FR;0;2021-06-11;386727;356529;1468;1;406975;0;0;0;0;30538485;13840752;63525;10;15843801;4;0;0;0
FR;0;2021-06-12;283295;210993;497;0;243141;0;0;0;0;30821780;14051745;64022;10;16086942;4;0;0;0
FR;0;2021-06-13;104908;73842;204;0;84835;0;0;0;0;30926688;14125587;64226;10;16171777;4;0;0;0
FR;0;2021-06-14;240885;354052;1429;1;383244;0;0;0;0;31167573;14479639;65655;11;16555021;4;0;0;0
FR;0;2021-06-15;308230;384328;1574;1;423105;0;0;0;0;31475803;14863967;67229;12;16978126;4;0;0;0
FR;0;2021-06-16;314026;357593;1419;1;395356;0;0;0;0;31789829;15221560;68648;13;17373482;4;0;0;0
FR;0;2021-06-17;317738;373158;1432;1;414356;0;0;0;0;32107567;15594718;70080;14;17787838;4;0;0;0
FR;0;2021-06-18;321785;442594;1341;1;486003;0;0;0;0;32429352;16037312;71421;15;18273841;4;0;0;0
FR;0;2021-06-19;224367;274025;449;0;301219;0;0;0;0;32653719;16311337;71870;15;18575060;4;0;0;0
FR;0;2021-06-20;74459;102288;131;0;111484;0;0;0;0;32728178;16413625;72001;15;18686544;4;0;0;0
FR;0;2021-06-21;195818;401758;1038;1;427724;1;0;0;0;32923996;16815383;73039;16;19114268;5;0;0;0
FR;0;2021-06-22;223243;467807;1266;10;500474;1;0;0;0;33147239;17283190;74305;26;19614742;6;0;0;0
FR;0;2021-06-23;234081;440138;1198;1;474247;1;0;0;0;33381320;17723328;75503;27;20088989;7;0;0;0
FR;0;2021-06-24;241905;409734;1359;0;447225;0;0;0;0;33623225;18133062;76862;27;20536214;7;0;0;0
FR;0;2021-06-25;227673;523085;1404;0;562081;0;0;0;0;33850898;18656147;78266;27;21098295;7;0;0;0
FR;0;2021-06-26;153294;371094;589;1;395904;0;0;0;0;34004192;19027241;78855;28;21494199;7;0;0;0
FR;0;2021-06-27;55924;155944;169;1;164855;0;0;0;0;34060116;19183185;79024;29;21659054;7;0;0;0
FR;0;2021-06-28;154812;452525;1178;0;478123;0;0;0;0;34214928;19635710;80202;29;22137177;7;0;0;0
FR;0;2021-06-29;182744;507830;2123;0;539205;0;0;0;0;34397672;20143540;82325;29;22676382;7;0;0;0
FR;0;2021-06-30;204046;485242;2016;21;519513;2;0;0;0;34601718;20628782;84341;50;23195895;9;0;0;0
FR;0;2021-07-01;231462;458547;2226;5;498492;0;0;0;0;34833180;21087329;86567;55;23694387;9;0;0;0
FR;0;2021-07-02;228709;520025;2120;5;562340;2;0;0;0;35061889;21607354;88687;60;24256727;11;0;0;0
FR;0;2021-07-03;142057;368761;908;3;395250;1;0;0;0;35203946;21976115;89595;63;24651977;12;0;0;0
FR;0;2021-07-04;56764;141004;265;0;150695;0;0;0;0;35260710;22117119;89860;63;24802672;12;0;0;0
FR;0;2021-07-05;168551;418649;1668;8;448593;0;0;0;0;35429261;22535768;91528;71;25251265;12;0;0;0
FR;0;2021-07-06;196810;474521;1830;45;511115;8;0;0;0;35626071;23010289;93358;116;25762380;20;0;0;0
FR;0;2021-07-07;213254;438958;1881;25;477416;2;0;0;0;35839325;23449247;95239;141;26239796;22;0;0;0
FR;0;2021-07-08;231679;424135;2090;20;468068;2;0;0;0;36071004;23873382;97329;161;26707864;24;0;0;0
FR;0;2021-07-09;228641;511063;2185;4;557354;1;0;0;0;36299645;24384445;99514;165;27265218;25;0;0;0
FR;0;2021-07-10;148636;339924;986;1;368862;1;0;0;0;36448281;24724369;100500;166;27634080;26;0;0;0
FR;0;2021-07-11;60218;110049;284;0;120965;0;0;0;0;36508499;24834418;100784;166;27755045;26;0;0;0
FR;0;2021-07-12;169442;477694;1766;4;512425;0;0;0;0;36677941;25312112;102550;170;28267470;26;0;0;0
FR;0;2021-07-13;287308;526593;2050;8;585626;0;0;0;0;36965249;25838705;104600;178;28853096;26;0;0;0
FR;0;2021-07-14;181122;157332;435;0;186644;0;0;0;0;37146371;25996037;105035;178;29039740;26;0;0;0
FR;0;2021-07-15;347131;501599;2100;1;571564;0;0;0;0;37493502;26497636;107135;179;29611304;26;0;0;0
FR;0;2021-07-16;380123;494971;2023;3;574146;1;0;0;0;37873625;26992607;109158;182;30185450;27;0;0;0
FR;0;2021-07-17;259755;319636;877;1;368600;0;0;0;0;38133380;27312243;110035;183;30554050;27;0;0;0
FR;0;2021-07-18;109746;114566;310;0;133005;0;0;0;0;38243126;27426809;110345;183;30687055;27;0;0;0
FR;0;2021-07-19;285528;423875;1631;3;478891;0;0;0;0;38528654;27850684;111976;186;31165946;27;0;0;0
FR;0;2021-07-20;376943;451204;1725;0;523537;0;0;0;0;38905597;28301888;113701;186;31689483;27;0;0;0
FR;0;2021-07-21;395841;406836;1550;4;481825;1;0;0;0;39301438;28708724;115251;190;32171308;28;0;0;0
FR;0;2021-07-22;441090;387299;1715;4;471777;2;0;0;0;39742528;29096023;116966;194;32643085;30;0;0;0
FR;0;2021-07-23;440352;421950;1883;4;509914;1;0;0;0;40182880;29517973;118849;198;33152999;31;0;0;0
FR;0;2021-07-24;285263;269310;804;1;321989;0;0;0;0;40468143;29787283;119653;199;33474988;31;0;0;0
FR;0;2021-07-25;121127;79916;234;0;100271;0;0;0;0;40589270;29867199;119887;199;33575259;31;0;0;0
FR;0;2021-07-26;347451;322134;1614;3;384691;1;0;0;0;40936721;30189333;121501;202;33959950;32;0;0;0
FR;0;2021-07-27;464112;319253;1698;4;400404;1;0;0;0;41400833;30508586;123199;206;34360354;33;0;0;0
FR;0;2021-07-28;459481;289366;1637;4;366981;1;0;0;0;41860314;30797952;124836;210;34727335;34;0;0;0
FR;0;2021-07-29;489865;276103;1797;2;356978;0;0;0;0;42350179;31074055;126633;212;35084313;34;0;0;0
FR;0;2021-07-30;461860;302336;1942;5;380827;1;0;0;0;42812039;31376391;128575;217;35465140;35;0;0;0
FR;0;2021-07-31;285424;185019;916;1;231506;0;0;0;0;43097463;31561410;129491;218;35696646;35;0;0;0
FR;0;2021-08-01;112047;49910;257;0;65689;0;0;0;0;43209510;31611320;129748;218;35762335;35;0;0;0
FR;0;2021-08-02;341675;234024;1603;2;284720;0;0;0;0;43551185;31845344;131351;220;36047055;35;0;0;0
FR;0;2021-08-03;398644;244428;1729;2;304503;1;0;0;0;43949829;32089772;133080;222;36351558;36;0;0;0
FR;0;2021-08-04;384887;209506;1594;6;265632;3;0;0;0;44334716;32299278;134674;228;36617190;39;0;0;0
FR;0;2021-08-05;366204;228341;1711;0;281717;0;0;0;0;44700920;32527619;136385;228;36898907;39;0;0;0
FR;0;2021-08-06;359754;271206;1835;4;326591;0;0;0;0;45060674;32798825;138220;232;37225498;39;0;0;0
FR;0;2021-08-07;213150;178320;756;5;210051;1;0;0;0;45273824;32977145;138976;237;37435549;40;0;0;0
FR;0;2021-08-08;74212;63190;276;0;73624;0;0;0;0;45348036;33040335;139252;237;37509173;40;0;0;0
FR;0;2021-08-09;258779;258577;1549;4;297494;2;0;0;0;45606815;33298912;140801;241;37806667;42;0;0;0
FR;0;2021-08-10;306898;277040;1662;2;323429;0;0;0;0;45913713;33575952;142463;243;38130096;42;0;0;0
FR;0;2021-08-11;279768;259529;1442;5;301602;0;0;0;0;46193481;33835481;143905;248;38431698;42;0;0;0
FR;0;2021-08-12;271573;278016;1668;3;320275;0;0;0;0;46465054;34113497;145573;251;38751973;42;0;0;0
FR;0;2021-08-13;252179;278118;1594;3;316955;2;0;0;0;46717233;34391615;147167;254;39068928;44;0;0;0
FR;0;2021-08-14;145365;197055;740;0;218978;0;0;0;0;46862598;34588670;147907;254;39287906;44;0;0;0
FR;0;2021-08-15;39403;50088;218;1;55670;0;0;0;0;46902001;34638758;148125;255;39343576;44;0;0;0
FR;0;2021-08-16;186196;317463;1543;0;345379;0;0;0;0;47088197;34956221;149668;255;39688955;44;0;0;0
FR;0;2021-08-17;215720;335798;1638;7;368832;0;0;0;0;47303917;35292019;151306;262;40057787;44;0;0;0
FR;0;2021-08-18;199080;324366;1599;7;354533;3;0;0;0;47502997;35616385;152905;269;40412320;47;0;0;0
FR;0;2021-08-19;192049;325390;1642;1;355950;0;0;0;0;47695046;35941775;154547;270;40768270;47;0;0;0
FR;0;2021-08-20;186492;366183;1823;3;396614;2;0;0;0;47881538;36307958;156370;273;41164884;49;0;0;0
FR;0;2021-08-21;104808;238127;709;0;254558;0;0;0;0;47986346;36546085;157079;273;41419442;49;0;0;0
FR;0;2021-08-22;31949;87207;256;1;92160;1;0;0;0;48018295;36633292;157335;274;41511602;50;0;0;0
FR;0;2021-08-23;140999;356993;1561;3;379587;0;0;0;0;48159294;36990285;158896;277;41891189;50;0;0;0
FR;0;2021-08-24;162521;376580;1850;5;402831;0;0;0;0;48321815;37366865;160746;282;42294020;50;0;0;0
FR;0;2021-08-25;151162;350716;2038;8;375404;2;0;0;0;48472977;37717581;162784;290;42669424;52;0;0;0
FR;0;2021-08-26;142894;342761;2563;10;367554;0;0;0;0;48615871;38060342;165347;300;43036978;52;0;0;0
FR;0;2021-08-27;148458;388241;2791;11;414884;1;0;0;0;48764329;38448583;168138;311;43451862;53;0;0;0
FR;0;2021-08-28;90681;249638;1407;0;264965;0;0;0;0;48855010;38698221;169545;311;43716827;53;0;0;0
FR;0;2021-08-29;27325;83349;518;1;88266;0;0;0;0;48882335;38781570;170063;312;43805093;53;0;0;0
FR;0;2021-08-30;117433;324585;4714;6;342393;5848;0;0;0;48999768;39106155;174777;318;44147486;5901;0;0;0
FR;0;2021-08-31;128830;334450;10189;19;353927;11770;2;0;0;49128598;39440605;184966;337;44501413;17671;2;0;0
FR;0;2021-09-01;136169;285658;22436;8;302404;24413;1;0;0;49264767;39726263;207402;345;44803817;42084;3;0;0
FR;0;2021-09-02;114653;247195;26525;20;262093;29012;0;0;0;49379420;39973458;233927;365;45065910;71096;3;0;0
FR;0;2021-09-03;118327;292654;29968;24;309313;33075;1;0;0;49497747;40266112;263895;389;45375223;104171;4;0;0
FR;0;2021-09-04;89892;217795;12587;12;230495;14157;7;0;0;49587639;40483907;276482;401;45605718;118328;11;0;0
FR;0;2021-09-05;21365;44795;4397;2;48279;4716;0;0;0;49609004;40528702;280879;403;45653997;123044;11;0;0
FR;0;2021-09-06;75700;180485;31957;16;190664;34304;2;0;0;49684704;40709187;312836;419;45844661;157348;13;0;0
FR;0;2021-09-07;80318;181184;33250;43;191043;36322;2;0;0;49765022;40890371;346086;462;46035704;193670;15;0;0
FR;0;2021-09-08;91012;206085;29666;28;216571;32570;4;0;0;49856034;41096456;375752;490;46252275;226240;19;0;0
FR;0;2021-09-09;76975;165306;33084;27;174110;36702;5;0;0;49933009;41261762;408836;517;46426385;262942;24;0;0
FR;0;2021-09-10;96048;203813;35743;28;214894;40788;7;0;0;50029057;41465575;444579;545;46641279;303730;31;0;0
FR;0;2021-09-11;67168;169337;12141;19;178188;14412;0;0;0;50096225;41634912;456720;564;46819467;318142;31;0;0
FR;0;2021-09-12;12829;32095;2783;1;34139;3192;2;0;0;50109054;41667007;459503;565;46853606;321334;33;0;0
FR;0;2021-09-13;64580;126161;41249;35;134177;44267;17;0;0;50173634;41793168;500752;600;46987783;365601;50;0;0
FR;0;2021-09-14;73502;129005;56391;80;135754;62444;43;0;0;50247136;41922173;557143;680;47123537;428045;93;0;0
FR;0;2021-09-15;76663;167730;55670;58;174674;54848;77;0;0;50323799;42089903;612813;738;47298211;482893;170;0;0
FR;0;2021-09-16;63895;114507;60099;82;117882;60173;65;0;0;50387694;42204410;672912;820;47416093;543066;235;0;0
FR;0;2021-09-17;75092;156854;53867;71;159731;57362;68;0;0;50462786;42361264;726779;891;47575824;600428;303;0;0
FR;0;2021-09-18;48245;139636;15602;25;144319;17320;20;0;0;50511031;42500900;742381;916;47720143;617748;323;0;0
FR;0;2021-09-19;7908;23649;2442;1;24879;2618;1;0;0;50518939;42524549;744823;917;47745022;620366;324;0;0
FR;0;2021-09-20;44581;93751;50087;72;96242;50347;34;0;0;50563520;42618300;794910;989;47841264;670713;358;0;0
FR;0;2021-09-21;45917;98365;62772;77;98383;63505;79;0;0;50609437;42716665;857682;1066;47939647;734218;437;0;0
FR;0;2021-09-22;48707;142392;55384;82;144838;55484;47;0;0;50658144;42859057;913066;1148;48084485;789702;484;0;0
FR;0;2021-09-23;43294;92064;62408;95;91274;63589;86;0;0;50701438;42951121;975474;1243;48175759;853291;570;0;0
FR;0;2021-09-24;52323;133296;54568;107;132394;59228;78;0;0;50753761;43084417;1030042;1350;48308153;912519;648;0;0
FR;0;2021-09-25;35225;115660;16276;36;118648;18314;22;0;0;50788986;43200077;1046318;1386;48426801;930833;670;0;0
FR;0;2021-09-26;5561;17805;2273;5;18691;2332;5;0;0;50794547;43217882;1048591;1391;48445492;933165;675;0;0
FR;0;2021-09-27;33986;76896;47205;97;78781;48190;81;0;1;50828533;43294778;1095796;1488;48524273;981355;756;0;1
FR;0;2021-09-28;36525;75243;54983;90;74329;56597;47;0;0;50865058;43370021;1150779;1578;48598602;1037952;803;0;1
FR;0;2021-09-29;44426;100690;53375;112;102847;54912;41;0;0;50909484;43470711;1204154;1690;48701449;1092864;844;0;1
FR;0;2021-09-30;36350;72975;57044;96;71479;59608;58;0;0;50945834;43543686;1261198;1786;48772928;1152472;902;0;1
FR;0;2021-10-01;61718;102860;57835;108;101411;64019;23;0;0;51007552;43646546;1319033;1894;48874339;1216491;925;0;1
FR;0;2021-10-02;39470;78457;20965;39;81735;23385;12;0;0;51047022;43725003;1339998;1933;48956074;1239876;937;0;1
FR;0;2021-10-03;5289;10493;2536;4;11258;2543;4;0;0;51052311;43735496;1342534;1937;48967332;1242419;941;0;1
FR;0;2021-10-04;35205;58500;52635;84;59502;54856;37;0;0;51087516;43793996;1395169;2021;49026834;1297275;978;0;1
FR;0;2021-10-05;33937;64376;61031;135;62107;65119;48;0;0;51121453;43858372;1456200;2156;49088941;1362394;1026;0;1
FR;0;2021-10-06;42727;79300;65763;112;80174;68383;29;0;0;51164180;43937672;1521963;2268;49169115;1430777;1055;0;1
FR;0;2021-10-07;30573;62282;65446;88;59499;68895;38;0;0;51194753;43999954;1587409;2356;49228614;1499672;1093;0;1
FR;0;2021-10-08;49486;91946;77772;111;89888;84807;39;0;0;51244239;44091900;1665181;2467;49318502;1584479;1132;0;1
FR;0;2021-10-09;33677;60949;31549;35;64142;33933;17;0;0;51277916;44152849;1696730;2502;49382644;1618412;1149;0;1
FR;0;2021-10-10;4723;7422;3199;9;7940;3475;2;0;0;51282639;44160271;1699929;2511;49390584;1621887;1151;0;1
FR;0;2021-10-11;30734;49887;61049;105;50604;64113;50;0;0;51313373;44210158;1760978;2616;49441188;1686000;1201;0;1
FR;0;2021-10-12;31649;54488;70635;141;51316;76049;27;0;0;51345022;44264646;1831613;2757;49492504;1762049;1228;0;1
FR;0;2021-10-13;40167;62848;74443;137;62800;79395;29;0;1;51385189;44327494;1906056;2894;49555304;1841444;1257;0;2
FR;0;2021-10-14;30364;52865;68779;116;49691;73866;34;0;0;51415553;44380359;1974835;3010;49604995;1915310;1291;0;2
FR;0;2021-10-15;44958;75234;93253;191;70330;103054;26;0;0;51460511;44455593;2068088;3201;49675325;2018364;1317;0;2
FR;0;2021-10-16;31335;44088;36701;45;46705;39654;15;0;0;51491846;44499681;2104789;3246;49722030;2058018;1332;0;2
FR;0;2021-10-17;3898;5228;3603;2;5675;3674;4;0;0;51495744;44504909;2108392;3248;49727705;2061692;1336;0;2
FR;0;2021-10-18;29216;42340;67518;134;42556;71379;27;0;0;51524960;44547249;2175910;3382;49770261;2133071;1363;0;2
FR;0;2021-10-19;27197;45547;76430;140;43209;81675;45;0;0;51552157;44592796;2252340;3522;49813470;2214746;1408;0;2
FR;0;2021-10-20;35346;52403;96959;181;51811;101577;45;0;0;51587503;44645199;2349299;3703;49865281;2316323;1453;0;2
FR;0;2021-10-21;26166;45171;83997;112;41966;89196;30;0;0;51613669;44690370;2433296;3815;49907247;2405519;1483;0;2
FR;0;2021-10-22;38450;62487;104928;200;59351;112655;61;0;0;51652119;44752857;2538224;4015;49966598;2518174;1544;0;2
FR;0;2021-10-23;27034;41203;45466;57;42428;48637;14;0;0;51679153;44794060;2583690;4072;50009026;2566811;1558;0;2
FR;0;2021-10-24;2946;4764;3685;6;5015;3922;1;0;0;51682099;44798824;2587375;4078;50014041;2570733;1559;0;2
FR;0;2021-10-25;26109;36205;82347;144;35479;86680;38;0;0;51708208;44835029;2669722;4222;50049520;2657413;1597;0;2
FR;0;2021-10-26;23770;34991;87278;166;32159;92408;34;0;0;51731978;44870020;2757000;4388;50081679;2749821;1631;0;2
FR;0;2021-10-27;30116;46303;109033;257;44042;114752;48;0;0;51762094;44916323;2866033;4645;50125721;2864573;1679;0;2
FR;0;2021-10-28;23609;34929;88743;153;31196;94540;35;0;0;51785703;44951252;2954776;4798;50156917;2959113;1714;0;2
FR;0;2021-10-29;31589;51452;117348;206;46503;125434;52;0;0;51817292;45002704;3072124;5004;50203420;3084547;1766;0;2
FR;0;2021-10-30;20577;33241;50360;76;32924;53429;20;0;0;51837869;45035945;3122484;5080;50236344;3137976;1786;0;2
FR;0;2021-10-31;2519;3732;3595;3;3844;3881;3;0;0;51840388;45039677;3126079;5083;50240188;3141857;1789;0;2
FR;0;2021-11-01;8541;4869;3223;3;5021;3585;10;0;0;51848929;45044546;3129302;5086;50245209;3145442;1799;0;2
FR;0;2021-11-02;26386;40101;93612;156;36236;99677;44;0;1;51875315;45084647;3222914;5242;50281445;3245119;1843;0;3
FR;0;2021-11-03;30132;47900;118932;222;43554;125909;64;0;0;51905447;45132547;3341846;5464;50324999;3371028;1907;0;3
FR;0;2021-11-04;23823;37459;107601;217;31574;114481;46;0;0;51929270;45170006;3449447;5681;50356573;3485509;1953;0;3
FR;0;2021-11-05;32414;52935;141678;236;44648;151469;53;0;0;51961684;45222941;3591125;5917;50401221;3636978;2006;0;3
FR;0;2021-11-06;21555;34549;64912;123;32385;68354;26;0;0;51983239;45257490;3656037;6040;50433606;3705332;2032;0;3
FR;0;2021-11-07;2429;4154;5209;6;4000;5598;7;0;0;51985668;45261644;3661246;6046;50437606;3710930;2039;0;3
FR;0;2021-11-08;20633;37737;127234;227;30949;134359;50;0;0;52006301;45299381;3788480;6273;50468555;3845289;2089;0;3
FR;0;2021-11-09;22444;44647;161738;339;32854;172354;65;0;0;52028745;45344028;3950218;6612;50501409;4017643;2154;0;3
FR;0;2021-11-10;31619;54879;187067;447;44022;198890;91;0;0;52060364;45398907;4137285;7059;50545431;4216533;2245;0;3
FR;0;2021-11-11;4749;6743;12998;28;5904;13981;17;0;0;52065113;45405650;4150283;7087;50551335;4230514;2262;0;3
FR;0;2021-11-12;29100;55057;183839;252;41723;197506;86;0;0;52094213;45460707;4334122;7339;50593058;4428020;2348;0;3
FR;0;2021-11-13;20356;32597;80730;118;28228;86354;44;0;0;52114569;45493304;4414852;7457;50621286;4514374;2392;0;3
FR;0;2021-11-14;2367;3855;7183;6;3362;7847;9;0;0;52116936;45497159;4422035;7463;50624648;4522221;2401;0;3
FR;0;2021-11-15;20524;38552;160910;314;27785;171651;77;0;0;52137460;45535711;4582945;7777;50652433;4693872;2478;0;3
FR;0;2021-11-16;23674;43831;200490;394;27706;215189;115;0;1;52161134;45579542;4783435;8171;50680139;4909061;2593;0;4
FR;0;2021-11-17;30544;50238;199905;406;36450;212970;98;0;0;52191678;45629780;4983340;8577;50716589;5122031;2691;0;4
FR;0;2021-11-18;23458;45682;191753;469;29391;205741;94;0;0;52215136;45675462;5175093;9046;50745980;5327772;2785;0;4
FR;0;2021-11-19;33696;61271;243292;551;39910;262311;148;0;0;52248832;45736733;5418385;9597;50785890;5590083;2933;0;4
FR;0;2021-11-20;25425;36657;102192;207;29264;109767;43;0;0;52274257;45773390;5520577;9804;50815154;5699850;2976;0;4
FR;0;2021-11-21;2665;4441;9682;19;3441;10607;19;0;0;52276922;45777831;5530259;9823;50818595;5710457;2995;0;4
FR;0;2021-11-22;22824;33112;180438;472;18913;194923;90;0;0;52299746;45810943;5710697;10295;50837508;5905380;3085;0;4
FR;0;2021-11-23;25734;45461;229494;549;24115;247985;85;0;0;52325480;45856404;5940191;10844;50861623;6153365;3170;0;4
FR;0;2021-11-24;31821;53592;224909;715;34474;243363;80;0;0;52357301;45909996;6165100;11559;50896097;6396728;3250;0;4
FR;0;2021-11-25;25654;49132;256029;739;25048;277939;112;0;0;52382955;45959128;6421129;12298;50921145;6674667;3362;0;4
FR;0;2021-11-26;33255;74663;379565;867;37391;414795;172;0;0;52416210;46033791;6800694;13165;50958536;7089462;3534;0;4
FR;0;2021-11-27;23508;49553;214978;391;28442;236786;135;0;0;52439718;46083344;7015672;13556;50986978;7326248;3669;0;4
FR;0;2021-11-28;3528;10443;56786;66;4055;63333;42;0;0;52443246;46093787;7072458;13622;50991033;7389581;3711;0;4
FR;0;2021-11-29;19448;54062;341570;864;23084;371912;178;0;0;52462694;46147849;7414028;14486;51014117;7761493;3889;0;4
FR;0;2021-11-30;24788;71791;457490;988;26796;500927;291;0;0;52487482;46219640;7871518;15474;51040913;8262420;4180;0;4
FR;0;2021-12-01;27397;75424;469222;1162;31310;511447;304;0;0;52514879;46295064;8340740;16636;51072223;8773867;4484;0;4
FR;0;2021-12-02;22130;71466;527254;1282;20998;575057;309;0;0;52537009;46366530;8867994;17918;51093221;9348924;4793;0;4
FR;0;2021-12-03;25582;92772;596536;1421;34331;651330;342;0;0;52562591;46459302;9464530;19339;51127552;10000254;5135;0;4
FR;0;2021-12-04;18343;60290;336313;692;25666;369888;197;0;0;52580934;46519592;9800843;20031;51153218;10370142;5332;0;4
FR;0;2021-12-05;4158;16085;95819;157;4855;107048;92;0;0;52585092;46535677;9896662;20188;51158073;10477190;5424;0;4
FR;0;2021-12-06;28452;72668;493293;1175;25226;540115;384;0;0;52613544;46608345;10389955;21363;51183299;11017305;5808;0;4
FR;0;2021-12-07;23568;91191;645578;1774;28509;706591;416;0;0;52637112;46699536;11035533;23137;51211808;11723896;6224;0;4
FR;0;2021-12-08;25524;91862;591823;1875;34932;647693;440;0;0;52662636;46791398;11627356;25012;51246740;12371589;6664;0;4
FR;0;2021-12-09;24087;94025;663355;2179;28971;726801;463;0;0;52686723;46885423;12290711;27191;51275711;13098390;7127;0;4
FR;0;2021-12-10;28079;110828;736216;2075;37933;806389;471;0;1;52714802;46996251;13026927;29266;51313644;13904779;7598;0;5
FR;0;2021-12-11;20253;76037;435253;990;29933;480480;343;0;0;52735055;47072288;13462180;30256;51343577;14385259;7941;0;5
FR;0;2021-12-12;5684;23104;142362;262;6385;159233;108;0;0;52740739;47095392;13604542;30518;51349962;14544492;8049;0;5
FR;0;2021-12-13;21371;90684;587847;1699;29636;649467;397;0;0;52762110;47186076;14192389;32217;51379598;15193959;8446;0;5
FR;0;2021-12-14;27991;118211;765814;2657;35407;847795;700;0;1;52790101;47304287;14958203;34874;51415005;16041754;9146;0;6
FR;0;2021-12-15;28460;114139;694531;2267;39494;769314;503;0;1;52818561;47418426;15652734;37141;51454499;16811068;9649;0;7
FR;0;2021-12-16;28061;115569;764256;2559;35082;844679;516;0;0;52846622;47533995;16416990;39700;51489581;17655747;10165;0;7
FR;0;2021-12-17;31666;128222;808037;2713;43321;892190;612;0;0;52878288;47662217;17225027;42413;51532902;18547937;10777;0;7
FR;0;2021-12-18;24944;81480;470063;1179;30045;522272;353;0;0;52903232;47743697;17695090;43592;51562947;19070209;11130;0;7
FR;0;2021-12-19;8770;28508;169449;376;7832;191059;143;0;0;52912002;47772205;17864539;43968;51570779;19261268;11273;0;7
FR;0;2021-12-20;31785;97029;591628;1789;33824;658845;503;0;0;52943787;47869234;18456167;45757;51604603;19920113;11776;0;7
FR;0;2021-12-21;39479;111846;682563;2391;38752;759695;607;0;0;52983266;47981080;19138730;48148;51643355;20679808;12383;0;7
FR;0;2021-12-22;39566;99118;575904;2169;37085;642224;687;0;2;53022832;48080198;19714634;50317;51680440;21322032;13070;0;9
FR;0;2021-12-23;33789;79328;441110;1659;30100;494448;589;0;0;53056621;48159526;20155744;51976;51710540;21816480;13659;0;9
FR;0;2021-12-24;10700;26011;111060;398;11637;126675;236;0;1;53067321;48185537;20266804;52374;51722177;21943155;13895;0;10
FR;0;2021-12-25;778;3568;7603;25;2045;9025;72;0;0;53068099;48189105;20274407;52399;51724222;21952180;13967;0;10
FR;0;2021-12-26;4699;11879;52123;142;4738;60167;170;0;0;53072798;48200984;20326530;52541;51728960;22012347;14137;0;10
FR;0;2021-12-27;30511;83915;453630;1364;33022;509278;665;0;0;53103309;48284899;20780160;53905;51761982;22521625;14802;0;10
FR;0;2021-12-28;38368;98789;564240;1769;35082;632333;1558;0;2;53141677;48383688;21344400;55674;51797064;23153958;16360;0;12
FR;0;2021-12-29;39882;88138;501288;1687;33086;561054;1738;0;1;53181559;48471826;21845688;57361;51830150;23715012;18098;0;13
FR;0;2021-12-30;35928;75054;421074;1520;29500;471182;1880;0;0;53217487;48546880;22266762;58881;51859650;24186194;19978;0;13
FR;0;2021-12-31;12053;25074;116895;405;11266;131678;740;0;0;53229540;48571954;22383657;59286;51870916;24317872;20718;0;13
FR;0;2022-01-01;1590;3214;8533;37;1804;9942;103;0;0;53231130;48575168;22392190;59323;51872720;24327814;20821;0;13
FR;0;2022-01-02;6123;13009;58438;126;5107;66973;408;0;0;53237253;48588177;22450628;59449;51877827;24394787;21229;0;13
FR;0;2022-01-03;39503;90140;494907;1597;36876;551789;2650;0;1;53276756;48678317;22945535;61046;51914703;24946576;23879;0;14
FR;0;2022-01-04;42250;110980;641477;2309;40644;714486;3836;0;3;53319006;48789297;23587012;63355;51955347;25661062;27715;0;17
FR;0;2022-01-05;61219;103586;569275;1984;43797;634313;3428;0;2;53380225;48892883;24156287;65339;51999144;26295375;31143;0;19
FR;0;2022-01-06;44318;110303;639065;2702;40219;711586;4557;0;2;53424543;49003186;24795352;68041;52039363;27006961;35700;0;21
FR;0;2022-01-07;50843;123282;711076;2811;46838;790565;4995;0;2;53475386;49126468;25506428;70852;52086201;27797526;40695;0;23
FR;0;2022-01-08;45015;80263;423843;1213;35045;472910;2444;0;3;53520401;49206731;25930271;72065;52121246;28270436;43139;0;26
FR;0;2022-01-09;15615;26598;128584;300;11486;145664;830;0;0;53536016;49233329;26058855;72365;52132732;28416100;43969;0;26
FR;0;2022-01-10;35420;93255;469403;1816;43022;522792;3722;0;1;53571436;49326584;26528258;74181;52175754;28938892;47691;0;27
FR;0;2022-01-11;41948;100437;548338;2310;42400;608586;5219;0;2;53613384;49427021;27076596;76491;52218154;29547478;52910;0;29
FR;0;2022-01-12;60421;95681;452749;1969;49479;504413;4497;0;8;53673805;49522702;27529345;78460;52267633;30051891;57407;0;37
FR;0;2022-01-13;38273;92509;487419;2084;40547;541100;5467;0;8;53712078;49615211;28016764;80544;52308180;30592991;62874;0;45
FR;0;2022-01-14;42587;103296;568668;2286;43503;629057;6463;0;2;53754665;49718507;28585432;82830;52351683;31222048;69337;0;47
FR;0;2022-01-15;39434;65878;340166;985;31447;377577;3296;0;1;53794099;49784385;28925598;83815;52383130;31599625;72633;0;48
FR;0;2022-01-16;11415;19196;87447;216;9019;99404;764;0;0;53805514;49803581;29013045;84031;52392149;31699029;73397;0;48
FR;0;2022-01-17;24756;59983;320331;1384;28041;354169;3960;0;4;53830270;49863564;29333376;85415;52420190;32053198;77357;0;52
FR;0;2022-01-18;28333;68682;361145;1801;32020;397589;5771;0;1;53858603;49932246;29694521;87216;52452210;32450787;83128;0;53
FR;0;2022-01-19;43230;67015;281344;1452;40388;311085;4392;0;5;53901833;49999261;29975865;88668;52492598;32761872;87520;0;58
FR;0;2022-01-20;23680;59586;299069;1750;29556;328538;5636;0;4;53925513;50058847;30274934;90418;52522154;33090410;93156;0;62
FR;0;2022-01-21;28212;68770;366411;2086;33075;401219;6580;0;3;53953725;50127617;30641345;92504;52555229;33491629;99736;0;65
FR;0;2022-01-22;27629;47973;218810;840;27304;241794;2838;0;2;53981354;50175590;30860155;93344;52582533;33733423;102574;0;67
FR;0;2022-01-23;6741;12965;48694;173;7503;55171;591;0;1;53988095;50188555;30908849;93517;52590036;33788594;103165;0;68
FR;0;2022-01-24;16287;47436;217354;1149;25400;239353;4102;0;3;54004382;50235991;31126203;94666;52615436;34027947;107267;0;71
FR;0;2022-01-25;19031;54313;243099;1548;28804;267096;6068;0;5;54023413;50290304;31369302;96214;52644240;34295043;113335;0;76
FR;0;2022-01-26;28148;60548;209311;1298;41365;229538;4478;0;3;54051561;50350852;31578613;97512;52685605;34524581;117813;0;79
FR;0;2022-01-27;16337;46485;207675;1287;26153;226060;5693;0;4;54067898;50397337;31786288;98799;52711758;34750641;123506;0;83
FR;0;2022-01-28;21592;78647;290084;1574;44967;321343;7411;0;4;54089490;50475984;32076372;100373;52756725;35071984;130917;0;87
FR;0;2022-01-29;18424;52849;184142;689;32750;204576;3255;0;2;54107914;50528833;32260514;101062;52789475;35276560;134172;0;89
FR;0;2022-01-30;4476;14466;39151;124;9133;45057;637;0;1;54112390;50543299;32299665;101186;52798608;35321617;134809;0;90
FR;0;2022-01-31;11261;43907;148218;742;26131;164723;4231;0;5;54123651;50587206;32447883;101928;52824739;35486340;139040;0;95
FR;0;2022-02-01;13647;48294;174140;1144;27330;191330;7037;0;1;54137298;50635500;32622023;103072;52852069;35677670;146077;0;96
FR;0;2022-02-02;20671;66297;171559;1034;46160;190082;5970;0;10;54157969;50701797;32793582;104106;52898229;35867752;152047;0;106
FR;0;2022-02-03;11750;44786;157585;990;25342;173288;6933;0;6;54169719;50746583;32951167;105096;52923571;36041040;158980;0;112
FR;0;2022-02-04;14643;67905;239264;1267;37530;264083;9153;0;6;54184362;50814488;33190431;106363;52961101;36305123;168133;0;118
FR;0;2022-02-05;12903;51443;153565;523;31980;172297;3784;0;3;54197265;50865931;33343996;106886;52993081;36477420;171917;0;121
FR;0;2022-02-06;2726;12168;28898;102;7289;33830;662;0;0;54199991;50878099;33372894;106988;53000370;36511250;172579;0;121
FR;0;2022-02-07;9616;46620;156904;594;24512;176305;5294;0;6;54209607;50924719;33529798;107582;53024882;36687555;177873;0;127
FR;0;2022-02-08;9814;43101;166659;870;20967;184454;7054;0;6;54219421;50967820;33696457;108452;53045849;36872009;184927;0;133
FR;0;2022-02-09;14428;58261;172359;876;35359;193068;5788;0;9;54233849;51026081;33868816;109328;53081208;37065077;190715;0;142
FR;0;2022-02-10;8726;39221;150244;881;18696;166722;6503;0;2;54242575;51065302;34019060;110209;53099904;37231799;197218;0;144
FR;0;2022-02-11;10864;55695;218522;1101;25838;243116;8322;0;3;54253439;51120997;34237582;111310;53125742;37474915;205540;0;147
FR;0;2022-02-12;8409;40970;134739;465;22637;151767;3509;0;4;54261848;51161967;34372321;111775;53148379;37626682;209049;0;151
FR;0;2022-02-13;1940;8605;26568;86;4411;30930;544;0;3;54263788;51170572;34398889;111861;53152790;37657612;209593;0;154
FR;0;2022-02-14;6995;35259;148390;486;14672;166386;4788;0;5;54270783;51205831;34547279;112347;53167462;37823998;214381;0;159
FR;0;2022-02-15;7072;36235;147002;751;16005;162588;6848;0;3;54277855;51242066;34694281;113098;53183467;37986586;221229;0;162
FR;0;2022-02-16;9416;42992;132548;722;25984;146767;5727;0;6;54287271;51285058;34826829;113820;53209451;38133353;226956;0;168
FR;0;2022-02-17;5581;24344;87317;587;13144;94891;5408;0;5;54292852;51309402;34914146;114407;53222595;38228244;232364;0;173
FR;0;2022-02-18;7001;33591;119672;807;18762;129337;7416;0;2;54299853;51342993;35033818;115214;53241357;38357581;239780;0;175
FR;0;2022-02-19;5371;24558;70029;370;15910;77339;3019;0;2;54305224;51367551;35103847;115584;53257267;38434920;242799;0;177
FR;0;2022-02-20;1150;4660;12175;39;2915;13956;460;0;1;54306374;51372211;35116022;115623;53260182;38448876;243259;0;178
FR;0;2022-02-21;4100;17896;61958;351;10173;67188;4059;0;2;54310474;51390107;35177980;115974;53270355;38516064;247318;0;180
FR;0;2022-02-22;4467;18667;60840;577;11268;64481;5255;0;1;54314941;51408774;35238820;116551;53281623;38580545;252573;0;181
FR;0;2022-02-23;6593;27365;66509;593;19633;71907;4596;0;3;54321534;51436139;35305329;117144;53301256;38652452;257169;0;184
FR;0;2022-02-24;3851;15562;50435;519;9521;53259;4531;0;2;54325385;51451701;35355764;117663;53310777;38705711;261700;0;186
FR;0;2022-02-25;5287;24297;76370;804;15273;80102;7336;0;7;54330672;51475998;35432134;118467;53326050;38785813;269036;0;193
FR;0;2022-02-26;3995;17772;47421;359;12174;51488;3083;0;3;54334667;51493770;35479555;118826;53338224;38837301;272119;0;196
FR;0;2022-02-27;881;3011;8039;47;1980;8948;531;0;0;54335548;51496781;35487594;118873;53340204;38846249;272650;0;196
FR;0;2022-02-28;3126;12561;40495;359;7595;42928;3858;0;0;54338674;51509342;35528089;119232;53347799;38889177;276508;0;196
FR;0;2022-03-01;4012;12615;44205;437;7640;44875;5520;0;6;54342686;51521957;35572294;119669;53355439;38934052;282028;0;202
FR;0;2022-03-02;5338;17819;47153;446;12879;49085;4929;0;2;54348024;51539776;35619447;120115;53368318;38983137;286957;0;204
FR;0;2022-03-03;2829;9358;29903;371;6256;30026;4050;0;2;54350853;51549134;35649350;120486;53374574;39013163;291007;0;206
FR;0;2022-03-04;3229;12514;40342;669;8512;39491;6235;0;4;54354082;51561648;35689692;121155;53383086;39052654;297242;0;210
FR;0;2022-03-05;3074;9290;24962;314;7132;25127;3134;0;1;54357156;51570938;35714654;121469;53390218;39077781;300376;0;211
FR;0;2022-03-06;521;1408;3198;43;1031;3441;379;0;0;54357677;51572346;35717852;121512;53391249;39081222;300755;0;211
FR;0;2022-03-07;2476;5636;18437;315;3853;17709;3307;0;4;54360153;51577982;35736289;121827;53395102;39098931;304062;0;215
FR;0;2022-03-08;2153;6080;19452;363;4334;17924;4094;0;3;54362306;51584062;35755741;122190;53399436;39116855;308156;0;218
FR;0;2022-03-09;3582;10539;22199;408;8766;21295;4041;0;4;54365888;51594601;35777940;122598;53408202;39138150;312197;0;222
FR;0;2022-03-10;1832;5842;17007;345;4389;15833;3408;0;3;54367720;51600443;35794947;122943;53412591;39153983;315605;0;225
FR;0;2022-03-11;2422;7562;24511;545;5441;22277;5481;0;2;54370142;51608005;35819458;123488;53418032;39176260;321086;0;227
FR;0;2022-03-12;2698;6778;17168;309;5495;16522;3137;0;2;54372840;51614783;35836626;123797;53423527;39192782;324223;0;229
FR;0;2022-03-13;406;794;2323;149;603;2272;537;0;0;54373246;51615577;35838949;123946;53424130;39195054;324760;0;229
FR;0;2022-03-14;1560;4275;14989;4412;2810;13842;7295;0;8;54374806;51619852;35853938;128358;53426940;39208896;332055;0;237
FR;0;2022-03-15;1751;6294;16387;7556;4809;14618;11036;0;9;54376557;51626146;35870325;135914;53431749;39223514;343091;0;246
FR;0;2022-03-16;3036;7413;19435;13141;6214;18113;16297;0;8;54379593;51633559;35889760;149055;53437963;39241627;359388;0;254
FR;0;2022-03-17;1461;3987;13155;10846;2807;11995;13314;0;9;54381054;51637546;35902915;159901;53440770;39253622;372702;0;263
FR;0;2022-03-18;2268;5757;20018;18307;4099;18114;22039;0;15;54383322;51643303;35922933;178208;53444869;39271736;394741;0;278
FR;0;2022-03-19;2294;4805;13116;9406;4142;12420;11409;0;6;54385616;51648108;35936049;187614;53449011;39284156;406150;0;284
FR;0;2022-03-20;301;737;1920;1074;529;1933;1340;0;2;54385917;51648845;35937969;188688;53449540;39286089;407490;0;286
FR;0;2022-03-21;1395;3222;12733;14951;2157;11959;16910;0;11;54387312;51652067;35950702;203639;53451697;39298048;424400;0;297
FR;0;2022-03-22;1557;3741;13807;20553;2580;12562;22845;0;5;54388869;51655808;35964509;224192;53454277;39310610;447245;0;302
FR;0;2022-03-23;2689;6295;17734;23151;5226;17247;25268;0;40;54391558;51662103;35982243;247343;53459503;39327857;472513;0;342
FR;0;2022-03-24;1410;3160;11600;17619;2248;10685;19394;0;23;54392968;51665263;35993843;264962;53461751;39338542;491907;0;365
FR;0;2022-03-25;2089;5159;18579;27775;3690;16917;30809;0;31;54395057;51670422;36012422;292737;53465441;39355459;522716;0;396
FR;0;2022-03-26;2232;4417;12080;12678;3866;11520;14400;0;26;54397289;51674839;36024502;305415;53469307;39366979;537116;0;422
FR;0;2022-03-27;363;693;1908;1483;515;1942;1740;0;1;54397652;51675532;36026410;306898;53469822;39368921;538856;0;423
FR;0;2022-03-28;1468;3082;11131;17490;2120;10620;19069;0;16;54399120;51678614;36037541;324388;53471942;39379541;557925;0;439
FR;0;2022-03-29;1453;3283;12912;27585;2098;12054;29284;0;34;54400573;51681897;36050453;351973;53474040;39391595;587209;0;473
FR;0;2022-03-30;2854;5575;15689;27433;4759;15089;29339;0;21;54403427;51687472;36066142;379406;53478799;39406684;616548;0;494
FR;0;2022-03-31;1615;3577;12991;25037;2561;12330;26647;0;43;54405042;51691049;36079133;404443;53481360;39419014;643195;0;537
FR;0;2022-04-01;2686;4588;20083;30897;2973;18725;33490;0;61;54407728;51695637;36099216;435340;53484333;39437739;676685;0;598
FR;0;2022-04-02;1532;2649;9053;10135;2009;8727;11297;0;29;54409260;51698286;36108269;445475;53486342;39446466;687982;0;627
FR;0;2022-04-03;293;516;1562;1171;360;1580;1382;0;2;54409553;51698802;36109831;446646;53486702;39448046;689364;0;629
FR;0;2022-04-04;4488;3021;12384;19129;2042;11593;20601;0;35;54414041;51701823;36122215;465775;53488744;39459639;709965;0;664
FR;0;2022-04-05;2606;3174;14353;34150;2051;13206;35768;0;85;54416647;51704997;36136568;499925;53490795;39472845;745733;0;749
FR;0;2022-04-06;2611;3964;13542;26515;3030;12816;27985;0;72;54419258;51708961;36150110;526440;53493825;39485661;773718;0;821
FR;0;2022-04-07;1989;3151;13683;33812;2000;12896;35169;0;76;54421247;51712112;36163793;560252;53495825;39498557;808887;0;897
FR;0;2022-04-08;2310;4342;19236;44013;2673;17861;46366;0;89;54423557;51716454;36183029;604265;53498498;39516418;855253;0;986
FR;0;2022-04-09;1373;2682;9315;13568;1904;8869;14800;0;30;54424930;51719136;36192344;617833;53500402;39525287;870053;0;1016
FR;0;2022-04-10;295;756;1984;2017;554;2006;2279;0;7;54425225;51719892;36194328;619850;53500956;39527293;872332;0;1023
FR;0;2022-04-11;1350;2623;11876;23933;1643;11484;25205;0;74;54426575;51722515;36206204;643783;53502599;39538777;897537;0;1097
FR;0;2022-04-12;1728;3080;14022;40927;1963;13395;41816;0;127;54428303;51725595;36220226;684710;53504562;39552172;939353;0;1224
FR;0;2022-04-13;1978;3722;13415;33118;2720;13036;34087;0;96;54430281;51729317;36233641;717828;53507282;39565208;973440;0;1320
FR;0;2022-04-14;1501;2983;13215;36350;1911;13073;37019;0;105;54431782;51732300;36246856;754178;53509193;39578281;1010459;0;1425
FR;0;2022-04-15;1874;3835;15646;35584;2578;14925;37236;0;115;54433656;51736135;36262502;789762;53511771;39593206;1047695;0;1540
FR;0;2022-04-16;1045;1834;6400;8553;1263;6263;9435;0;40;54434701;51737969;36268902;798315;53513034;39599469;1057130;0;1580
FR;0;2022-04-17;195;339;993;1174;223;1036;1242;0;7;54434896;51738308;36269895;799489;53513257;39600505;1058372;0;1587
FR;0;2022-04-18;200;546;2768;1072;344;2787;1287;0;5;54435096;51738854;36272663;800561;53513601;39603292;1059659;0;1592
FR;0;2022-04-19;1546;3030;12919;29690;1878;12479;30737;0;78;54436642;51741884;36285582;830251;53515479;39615771;1090396;0;1670
FR;0;2022-04-20;2007;3497;13308;29071;2611;12996;30087;0;96;54438649;51745381;36298890;859322;53518090;39628767;1120483;0;1766
FR;0;2022-04-21;1515;2854;12553;35210;1824;12647;35783;0;117;54440164;51748235;36311443;894532;53519914;39641414;1156266;0;1883
FR;0;2022-04-22;1880;3626;16479;37624;2402;15838;39163;0;131;54442044;51751861;36327922;932156;53522316;39657252;1195429;0;2014
FR;0;2022-04-23;1151;2069;7391;10659;1479;7242;11444;0;38;54443195;51753930;36335313;942815;53523795;39664494;1206873;0;2052
FR;0;2022-04-24;250;467;1478;1591;326;1414;1849;0;7;54443445;51754397;36336791;944406;53524121;39665908;1208722;0;2059
FR;0;2022-04-25;1307;2534;10686;21073;1613;10491;22095;0;79;54444752;51756931;36347477;965479;53525734;39676399;1230817;0;2138
FR;0;2022-04-26;1627;3008;13671;38664;1967;13114;39461;0;181;54446379;51759939;36361148;1004143;53527701;39689513;1270278;0;2319
FR;0;2022-04-27;1964;3065;11539;31086;2280;11596;31504;0;131;54448343;51763004;36372687;1035229;53529981;39701109;1301782;0;2450
FR;0;2022-04-28;1570;2775;12530;36261;1856;12271;36578;0;139;54449913;51765779;36385217;1071490;53531837;39713380;1338360;0;2589
FR;0;2022-04-29;2010;4834;15561;37281;3638;14937;38752;0;164;54451923;51770613;36400778;1108771;53535475;39728317;1377112;0;2753
FR;0;2022-04-30;1225;4634;6929;9717;4128;6758;10608;0;44;54453148;51775247;36407707;1118488;53539603;39735075;1387720;0;2797
FR;0;2022-05-01;220;325;916;1000;229;911;1141;0;6;54453368;51775572;36408623;1119488;53539832;39735986;1388861;0;2803
FR;0;2022-05-02;2350;2958;11156;18179;2054;10990;19023;0;69;54455718;51778530;36419779;1137667;53541886;39746976;1407884;0;2872
FR;0;2022-05-03;2062;3268;13726;34702;2129;13567;35623;0;163;54457780;51781798;36433505;1172369;53544015;39760543;1443507;0;3035
FR;0;2022-05-04;1923;3299;12187;25651;2299;12303;26202;0;110;54459703;51785097;36445692;1198020;53546314;39772846;1469709;0;3145
FR;0;2022-05-05;1792;3037;13068;33602;2015;12914;34270;0;180;54461495;51788134;36458760;1231622;53548329;39785760;1503979;0;3325
FR;0;2022-05-06;2217;3662;15354;36807;2321;14864;38269;0;182;54463712;51791796;36474114;1268429;53550650;39800624;1542248;0;3507
FR;0;2022-05-07;1210;1783;6464;9614;1255;6456;10339;0;48;54464922;51793579;36480578;1278043;53551905;39807080;1552587;0;3555
FR;0;2022-05-08;267;400;1175;1548;288;1236;1654;0;8;54465189;51793979;36481753;1279591;53552193;39808316;1554241;0;3563
FR;0;2022-05-09;1403;2306;9929;20259;1413;9799;21176;0;102;54466592;51796285;36491682;1299850;53553606;39818115;1575417;0;3665
FR;0;2022-05-10;1800;3432;13572;38999;2296;13128;40026;0;200;54468392;51799717;36505254;1338849;53555902;39831243;1615443;0;3865
FR;0;2022-05-11;2004;3019;10753;27942;2323;10699;28445;0;146;54470396;51802736;36516007;1366791;53558225;39841942;1643888;0;4011
FR;0;2022-05-12;1594;2743;11382;35736;1812;11054;36498;0;211;54471990;51805479;36527389;1402527;53560037;39852996;1680386;0;4222
FR;0;2022-05-13;1983;3222;13761;37981;2064;13350;39246;0;162;54473973;51808701;36541150;1440508;53562101;39866346;1719632;0;4384
FR;0;2022-05-14;1149;1641;5938;10778;1198;5801;11366;0;57;54475122;51810342;36547088;1451286;53563299;39872147;1730998;0;4441
FR;0;2022-05-15;283;479;1278;1440;302;1361;1593;0;6;54475405;51810821;36548366;1452726;53563601;39873508;1732591;0;4447
FR;0;2022-05-16;1195;2047;8692;21069;1247;8698;21597;0;128;54476600;51812868;36557058;1473795;53564848;39882206;1754188;0;4575
FR;0;2022-05-17;1591;2605;11827;37881;1670;11403;38723;0;180;54478191;51815473;36568885;1511676;53566518;39893609;1792911;0;4755
FR;0;2022-05-18;1815;2653;9693;27166;1955;9667;27784;0;109;54480006;51818126;36578578;1538842;53568473;39903276;1820695;0;4864
FR;0;2022-05-19;1448;2660;10579;35840;1634;10719;36031;0;162;54481454;51820786;36589157;1574682;53570107;39913995;1856726;0;5026
FR;0;2022-05-20;1876;3118;13425;39369;2079;12913;40388;0;168;54483330;51823904;36602582;1614051;53572186;39926908;1897114;0;5194
FR;0;2022-05-21;1159;1718;5662;9897;1313;5533;10534;0;45;54484489;51825622;36608244;1623948;53573499;39932441;1907648;0;5239
FR;0;2022-05-22;241;341;1030;1439;263;1016;1583;0;10;54484730;51825963;36609274;1625387;53573762;39933457;1909231;0;5249
FR;0;2022-05-23;1177;2126;8880;20373;1409;8831;21028;0;86;54485907;51828089;36618154;1645760;53575171;39942288;1930259;0;5335
FR;0;2022-05-24;1541;2760;11366;38881;1737;11238;39510;0;190;54487448;51830849;36629520;1684641;53576908;39953526;1969769;0;5525
FR;0;2022-05-25;1814;2836;9343;24846;2074;9481;25322;0;116;54489262;51833685;36638863;1709487;53578982;39963007;1995091;0;5641
FR;0;2022-05-26;216;430;1665;1201;293;1676;1344;0;26;54489478;51834115;36640528;1710688;53579275;39964683;1996435;0;5667
FR;0;2022-05-27;1390;2477;9265;21291;1670;9005;22325;0;94;54490868;51836592;36649793;1731979;53580945;39973688;2018760;0;5761
FR;0;2022-05-28;669;1272;3919;6795;852;3968;7204;0;38;54491537;51837864;36653712;1738774;53581797;39977656;2025964;0;5799
FR;0;2022-05-29;157;315;752;921;200;773;1033;0;4;54491694;51838179;36654464;1739695;53581997;39978429;2026997;0;5803
FR;0;2022-05-30;1026;1967;6995;19296;1247;7013;19808;0;91;54492720;51840146;36661459;1758991;53583244;39985442;2046805;0;5894
FR;0;2022-05-31;1488;2520;9823;35664;1647;9645;36295;0;171;54494208;51842666;36671282;1794655;53584891;39995087;2083100;0;6065
FR;0;2022-06-01;1748;3104;11029;24538;2250;10896;25491;0;122;54495956;51845770;36682311;1819193;53587141;40005983;2108591;0;6187
FR;0;2022-06-02;1480;2615;11303;35570;1715;10859;36515;0;174;54497436;51848385;36693614;1854763;53588856;40016842;2145106;0;6361
FR;0;2022-06-03;1727;3082;13425;38729;2051;12790;39999;0;176;54499163;51851467;36707039;1893492;53590907;40029632;2185105;0;6537
FR;0;2022-06-04;975;1516;5046;9113;1076;5117;9649;0;73;54500138;51852983;36712085;1902605;53591983;40034749;2194754;0;6610
FR;0;2022-06-05;180;335;875;1108;205;886;1230;0;4;54500318;51853318;36712960;1903713;53592188;40035635;2195984;0;6614
FR;0;2022-06-06;867;1254;2124;1329;1078;2141;1510;0;13;54501185;51854572;36715084;1905042;53593266;40037776;2197494;0;6627
FR;0;2022-06-07;1496;2713;9855;35596;1792;9433;36823;0;153;54502681;51857285;36724939;1940638;53595058;40047209;2234317;0;6780
FR;0;2022-06-08;1583;2697;9176;28788;1940;9020;29754;0;112;54504264;51859982;36734115;1969426;53596998;40056229;2264071;0;6892
FR;0;2022-06-09;1296;2441;10618;39499;1554;10263;40274;0;167;54505560;51862423;36744733;2008925;53598552;40066492;2304345;0;7059
FR;0;2022-06-10;1630;3192;13103;44828;2159;12665;46153;0;223;54507190;51865615;36757836;2053753;53600711;40079157;2350498;0;7282
FR;0;2022-06-11;962;1738;5432;11627;1124;5465;12212;0;55;54508152;51867353;36763268;2065380;53601835;40084622;2362710;0;7337
FR;0;2022-06-12;201;445;1079;1765;255;1141;1867;0;11;54508353;51867798;36764347;2067145;53602090;40085763;2364577;0;7348
FR;0;2022-06-13;1122;2069;7439;23183;1343;7269;24099;0;90;54509475;51869867;36771786;2090328;53603433;40093032;2388676;0;7438
FR;0;2022-06-14;1346;2548;10448;44948;1597;9804;46144;0;200;54510821;51872415;36782234;2135276;53605030;40102836;2434820;0;7638
FR;0;2022-06-15;1526;2463;9324;30907;1931;8963;31597;0;179;54512347;51874878;36791558;2166183;53606961;40111799;2466417;0;7817
FR;0;2022-06-16;1188;2041;9917;39931;1276;9326;40952;0;201;54513535;51876919;36801475;2206114;53608237;40121125;2507369;0;8018
FR;0;2022-06-17;1492;2859;12512;46699;1788;11919;47935;0;240;54515027;51879778;36813987;2252813;53610025;40133044;2555304;0;8258
FR;0;2022-06-18;856;1527;4566;11125;1038;4501;11719;0;67;54515883;51881305;36818553;2263938;53611063;40137545;2567023;0;8325
FR;0;2022-06-19;183;363;1059;1615;208;1131;1701;0;14;54516066;51881668;36819612;2265553;53611271;40138676;2568724;0;8339
FR;0;2022-06-20;1027;1924;8908;26079;1200;8569;27020;0;156;54517093;51883592;36828520;2291632;53612471;40147245;2595744;0;8495
FR;0;2022-06-21;1327;2403;10309;49897;1541;9338;51281;0;264;54518420;51885995;36838829;2341529;53614012;40156583;2647025;0;8759
FR;0;2022-06-22;1397;2514;8920;39064;1803;8430;40006;0;256;54519817;51888509;36847749;2380593;53615815;40165013;2687031;0;9015
FR;0;2022-06-23;1229;2369;10679;55110;1364;9886;56242;0;320;54521046;51890878;36858428;2435703;53617179;40174899;2743273;0;9335
FR;0;2022-06-24;1493;2996;13646;69187;1751;12307;71006;0;405;54522539;51893874;36872074;2504890;53618930;40187206;2814279;0;9740
FR;0;2022-06-25;939;1781;6237;19921;1112;5990;20776;0;177;54523478;51895655;36878311;2524811;53620042;40193196;2835055;0;9917
FR;0;2022-06-26;229;459;1953;3688;259;1818;3966;0;39;54523707;51896114;36880264;2528499;53620301;40195014;2839021;0;9956
FR;0;2022-06-27;1133;2026;10493;48488;1178;9636;49756;0;339;54524840;51898140;36890757;2576987;53621479;40204650;2888777;0;10295
FR;0;2022-06-28;1463;2816;14672;91395;1584;13090;93167;0;623;54526303;51900956;36905429;2668382;53623063;40217740;2981944;0;10918
FR;0;2022-06-29;1712;2832;12292;71894;1845;11240;73037;0;548;54528015;51903788;36917721;2740276;53624908;40228980;3054981;0;11466
FR;0;2022-06-30;1537;2734;14395;95170;1658;12476;97185;0;724;54529552;51906522;36932116;2835446;53626566;40241456;3152166;0;12190
FR;0;2022-07-01;2015;3805;21507;115936;2308;18858;118586;0;954;54531567;51910327;36953623;2951382;53628874;40260314;3270752;0;13144
FR;0;2022-07-02;1088;1859;8528;35754;1108;7704;36876;0;342;54532655;51912186;36962151;2987136;53629982;40268018;3307628;0;13486
FR;0;2022-07-03;293;539;2095;6455;319;1898;6804;0;79;54532948;51912725;36964246;2993591;53630301;40269916;3314432;0;13565
FR;0;2022-07-04;1938;3470;14714;79227;2334;12993;81300;0;639;54534886;51916195;36978960;3072818;53632635;40282909;3395732;0;14204
FR;0;2022-07-05;1794;3169;18835;133262;1801;16017;135554;0;1146;54536680;51919364;36997795;3206080;53634436;40298926;3531286;0;15350
FR;0;2022-07-06;1843;2788;15856;99602;1848;13649;101170;0;900;54538523;51922152;37013651;3305682;53636284;40312575;3632456;0;16250
FR;0;2022-07-07;1712;2873;18008;126039;1713;14788;128366;0;1179;54540235;51925025;37031659;3431721;53637997;40327363;3760822;0;17429
FR;0;2022-07-08;1894;3153;20752;137088;1857;16765;140081;0;1347;54542129;51928178;37052411;3568809;53639854;40344128;3900903;0;18776
FR;0;2022-07-09;868;1464;7743;37926;883;6690;38769;0;426;54542997;51929642;37060154;3606735;53640737;40350818;3939672;0;19202
FR;0;2022-07-10;270;686;2346;7004;440;2125;7395;0;94;54543267;51930328;37062500;3613739;53641177;40352943;3947067;0;19296
FR;0;2022-07-11;1456;2480;15020;88284;1402;12514;90472;0;801;54544723;51932808;37077520;3702023;53642579;40365457;4037539;0;20097
FR;0;2022-07-12;1842;3119;20537;143974;1716;16732;146678;0;1604;54546565;51935927;37098057;3845997;53644295;40382189;4184217;0;21701
FR;0;2022-07-13;1781;2751;15696;94543;1661;13277;96402;0;1080;54548346;51938678;37113753;3940540;53645956;40395466;4280619;0;22781
FR;0;2022-07-14;186;370;1956;5540;220;1835;5707;0;82;54548532;51939048;37115709;3946080;53646176;40397301;4286326;0;22863
FR;0;2022-07-15;1486;2575;15115;84464;1441;12598;86623;0;1035;54550018;51941623;37130824;4030544;53647617;40409899;4372949;0;23898
FR;0;2022-07-16;627;1192;5950;24982;698;5156;25674;0;327;54550645;51942815;37136774;4055526;53648315;40415055;4398623;0;24225
FR;0;2022-07-17;182;395;1738;4666;218;1570;4938;0;66;54550827;51943210;37138512;4060192;53648533;40416625;4403561;0;24291
FR;0;2022-07-18;1132;2249;11828;61809;1339;9977;63673;0;780;54551959;51945459;37150340;4122001;53649872;40426602;4467234;0;25071
FR;0;2022-07-19;1421;2354;15474;103709;1395;12295;105898;0;1459;54553380;51947813;37165814;4225710;53651267;40438897;4573132;0;26530
FR;0;2022-07-20;1426;2301;12966;77586;1471;10739;79173;0;1051;54554806;51950114;37178780;4303296;53652738;40449636;4652305;0;27581
FR;0;2022-07-21;1287;2171;13097;88243;1371;10499;89728;0;1316;54556093;51952285;37191877;4391539;53654109;40460135;4742033;0;28897
FR;0;2022-07-22;1431;2487;14823;89536;1465;11974;91416;0;1347;54557524;51954772;37206700;4481075;53655574;40472109;4833449;0;30244
FR;0;2022-07-23;684;1310;5534;22482;821;4857;23080;0;411;54558208;51956082;37212234;4503557;53656395;40476966;4856529;0;30655
FR;0;2022-07-24;185;353;1400;3905;204;1242;4132;0;72;54558393;51956435;37213634;4507462;53656599;40478208;4860661;0;30727
FR;0;2022-07-25;1060;1795;9493;48080;1147;7845;49517;0;737;54559453;51958230;37223127;4555542;53657746;40486053;4910178;0;31464
FR;0;2022-07-26;1300;2211;13306;85437;1320;10828;87134;0;1311;54560753;51960441;37236433;4640979;53659066;40496881;4997312;0;32775
FR;0;2022-07-27;1226;2008;10236;61318;1340;8531;62522;0;971;54561979;51962449;37246669;4702297;53660406;40505412;5059834;0;33746
FR;0;2022-07-28;1093;1863;10313;64403;1259;8224;65634;0;1046;54563072;51964312;37256982;4766700;53661665;40513636;5125468;0;34792
FR;0;2022-07-29;1283;2078;11010;65897;1387;8764;67327;0;1140;54564355;51966390;37267992;4832597;53663052;40522400;5192795;0;35932
FR;0;2022-07-30;503;866;3523;15283;604;2973;15666;0;303;54564858;51967256;37271515;4847880;53663656;40525373;5208461;0;36235
FR;0;2022-07-31;154;289;929;2439;185;788;2588;0;49;54565012;51967545;37272444;4850319;53663841;40526161;5211049;0;36284
FR;0;2022-08-01;983;1663;7598;30237;1256;6396;31311;0;549;54565995;51969208;37280042;4880556;53665097;40532557;5242360;0;36833
FR;0;2022-08-02;1050;1650;8580;56119;1154;6894;56807;0;1170;54567045;51970858;37288622;4936675;53666251;40539451;5299167;0;38003
FR;0;2022-08-03;852;1265;6428;38681;902;5148;39419;0;702;54567897;51972123;37295050;4975356;53667153;40544599;5338586;0;38705
FR;0;2022-08-04;741;1186;6573;43159;782;5306;43723;0;917;54568638;51973309;37301623;5018515;53667935;40549905;5382309;0;39622
FR;0;2022-08-05;856;1363;7099;44969;971;5681;45629;0;993;54569494;51974672;37308722;5063484;53668906;40555586;5427938;0;40615
FR;0;2022-08-06;341;556;2101;9367;397;1759;9567;0;228;54569835;51975228;37310823;5072851;53669303;40557345;5437505;0;40843
FR;0;2022-08-07;104;159;536;1626;116;453;1702;0;38;54569939;51975387;37311359;5074477;53669419;40557798;5439207;0;40881
FR;0;2022-08-08;639;1158;4029;22108;913;3292;22543;0;490;54570578;51976545;37315388;5096585;53670332;40561090;5461750;0;41371
FR;0;2022-08-09;745;1167;5972;39955;852;4803;40446;0;844;54571323;51977712;37321360;5136540;53671184;40565893;5502196;0;42215
FR;0;2022-08-10;667;1284;4655;28058;999;3796;28392;0;652;54571990;51978996;37326015;5164598;53672183;40569689;5530588;0;42867
FR;0;2022-08-11;638;1027;4491;29251;739;3711;29587;0;676;54572628;51980023;37330506;5193849;53672922;40573400;5560175;0;43543
FR;0;2022-08-12;843;1162;4747;28218;848;3918;28655;0;704;54573471;51981185;37335253;5222067;53673770;40577318;5588830;0;44247
FR;0;2022-08-13;331;427;1295;5260;324;1120;5419;0;121;54573802;51981612;37336548;5227327;53674094;40578438;5594249;0;44368
FR;0;2022-08-14;74;121;289;923;104;247;995;0;25;54573876;51981733;37336837;5228250;53674198;40578685;5595244;0;44393
FR;0;2022-08-15;116;231;610;564;197;558;618;0;19;54573992;51981964;37337447;5228814;53674395;40579243;5595862;0;44412
FR;0;2022-08-16;644;1078;3960;22176;840;3354;22369;0;615;54574636;51983042;37341407;5250990;53675235;40582597;5618231;0;45027
FR;0;2022-08-17;650;1038;3890;22897;813;3294;23142;0;620;54575286;51984080;37345297;5273887;53676048;40585891;5641373;0;45647
FR;0;2022-08-18;636;999;4123;26308;802;3261;26541;0;673;54575922;51985079;37349420;5300195;53676850;40589152;5667914;0;46320
FR;0;2022-08-19;605;1166;4493;27259;874;3694;27565;0;766;54576527;51986245;37353913;5327454;53677724;40592846;5695479;0;47086
FR;0;2022-08-20;309;503;1356;5569;401;1171;5728;0;146;54576836;51986748;37355269;5333023;53678125;40594017;5701207;0;47232
FR;0;2022-08-21;97;135;305;1009;96;267;1044;0;27;54576933;51986883;37355574;5334032;53678221;40594284;5702251;0;47259
FR;0;2022-08-22;584;1001;3273;15358;780;2797;15688;0;425;54577517;51987884;37358847;5349390;53679001;40597081;5717939;0;47684
FR;0;2022-08-23;730;1179;4297;29001;852;3610;29088;0;870;54578247;51989063;37363144;5378391;53679853;40600691;5747027;0;48554
FR;0;2022-08-24;669;938;3495;19539;784;2858;19728;0;608;54578916;51990001;37366639;5397930;53680637;40603549;5766755;0;49162
FR;0;2022-08-25;627;1021;3945;23402;729;3293;23666;0;673;54579543;51991022;37370584;5421332;53681366;40606842;5790421;0;49835
FR;0;2022-08-26;858;1266;4478;25884;958;3671;26257;0;777;54580401;51992288;37375062;5447216;53682324;40610513;5816678;0;50612
FR;0;2022-08-27;297;500;1379;5467;362;1244;5531;0;194;54580698;51992788;37376441;5452683;53682686;40611757;5822209;0;50806
FR;0;2022-08-28;125;163;303;920;117;288;965;0;38;54580823;51992951;37376744;5453603;53682803;40612045;5823174;0;50844
FR;0;2022-08-29;620;966;3073;14657;766;2611;14963;0;433;54581443;51993917;37379817;5468260;53683569;40614656;5838137;0;51277
FR;0;2022-08-30;853;1224;4796;28544;900;3914;28874;0;823;54582296;51995141;37384613;5496804;53684469;40618570;5867011;0;52100
FR;0;2022-08-31;695;958;3205;17642;743;2716;17906;0;508;54582991;51996099;37387818;5514446;53685212;40621286;5884917;0;52608
FR;0;2022-09-01;748;996;4480;22490;707;3827;22765;0;623;54583739;51997095;37392298;5536936;53685919;40625113;5907682;0;53231
FR;0;2022-09-02;900;1153;5043;28611;840;4256;28905;0;914;54584639;51998248;37397341;5565547;53686759;40629369;5936587;0;54145
FR;0;2022-09-03;418;569;1919;6086;424;1665;6323;0;181;54585057;51998817;37399260;5571633;53687183;40631034;5942910;0;54326
FR;0;2022-09-04;134;150;351;873;85;347;942;0;24;54585191;51998967;37399611;5572506;53687268;40631381;5943852;0;54350
FR;0;2022-09-05;735;891;3176;16065;711;2657;16378;0;523;54585926;51999858;37402787;5588571;53687979;40634038;5960230;0;54873
FR;0;2022-09-06;891;1048;4739;31851;678;3872;32080;0;1040;54586817;52000906;37407526;5620422;53688657;40637910;5992310;0;55913
FR;0;2022-09-07;702;785;2998;16821;568;2478;16970;0;572;54587519;52001691;37410524;5637243;53689225;40640388;6009280;0;56485
FR;0;2022-09-08;631;859;3809;24864;594;3141;24955;0;818;54588150;52002550;37414333;5662107;53689819;40643529;6034235;0;57303
FR;0;2022-09-09;844;1021;4445;27660;661;3686;27837;0;948;54588994;52003571;37418778;5689767;53690480;40647215;6062072;0;58251
FR;0;2022-09-10;403;639;1738;5710;464;1538;5916;0;207;54589397;52004210;37420516;5695477;53690944;40648753;6067988;0;58458
FR;0;2022-09-11;124;131;324;657;93;307;716;0;17;54589521;52004341;37420840;5696134;53691037;40649060;6068704;0;58475
FR;0;2022-09-12;518;647;2690;13296;464;2295;13589;0;478;54590039;52004988;37423530;5709430;53691501;40651355;6082293;0;58953
FR;0;2022-09-13;661;869;3996;26516;558;3486;26396;0;875;54590700;52005857;37427526;5735946;53692059;40654841;6108689;0;59828
FR;0;2022-09-14;701;800;2968;16181;592;2485;16414;0;573;54591401;52006657;37430494;5752127;53692651;40657326;6125103;0;60401
FR;0;2022-09-15;577;840;3475;23585;593;2963;23654;0;728;54591978;52007497;37433969;5775712;53693244;40660289;6148757;0;61129
FR;0;2022-09-16;798;1047;4143;25915;731;3486;26137;0;932;54592776;52008544;37438112;5801627;53693975;40663775;6174894;0;62061
FR;0;2022-09-17;392;512;1454;6146;390;1284;6238;0;242;54593168;52009056;37439566;5807773;53694365;40665059;6181132;0;62303
FR;0;2022-09-18;117;144;323;961;123;291;1016;0;36;54593285;52009200;37439889;5808734;53694488;40665350;6182148;0;62339
FR;0;2022-09-19;481;648;2260;13218;450;1934;13401;0;436;54593766;52009848;37442149;5821952;53694938;40667284;6195549;0;62775
FR;0;2022-09-20;645;897;3788;26462;652;3155;26516;0;893;54594411;52010745;37445937;5848414;53695590;40670439;6222065;0;63668
FR;0;2022-09-21;587;774;2740;16259;578;2355;16250;0;586;54594998;52011519;37448677;5864673;53696168;40672794;6238315;0;64254
FR;0;2022-09-22;598;846;3423;23594;569;2796;23818;0;774;54595596;52012365;37452100;5888267;53696737;40675590;6262133;0;65028
FR;0;2022-09-23;838;1051;4495;28721;773;3763;28893;0;1020;54596434;52013416;37456595;5916988;53697510;40679353;6291026;0;66048
FR;0;2022-09-24;424;614;1644;6894;474;1418;7078;0;306;54596858;52014030;37458239;5923882;53697984;40680771;6298104;0;66354
FR;0;2022-09-25;99;194;336;1101;148;307;1143;0;37;54596957;52014224;37458575;5924983;53698132;40681078;6299247;0;66391
FR;0;2022-09-26;438;713;2299;13540;482;2019;13645;0;435;54597395;52014937;37460874;5938523;53698614;40683097;6312892;0;66826
FR;0;2022-09-27;612;844;3627;25944;614;2910;26099;0;959;54598007;52015781;37464501;5964467;53699228;40686007;6338991;0;67785
FR;0;2022-09-28;635;827;2557;15403;634;2305;15516;0;622;54598642;52016608;37467058;5979870;53699862;40688312;6354507;0;68407
FR;0;2022-09-29;564;768;3132;21051;544;2646;21079;43;810;54599206;52017376;37470190;6000921;53700406;40690958;6375586;43;69217
FR;0;2022-09-30;787;1120;3954;25563;837;3301;25829;713;1052;54599993;52018496;37474144;6026484;53701243;40694259;6401415;756;70269
FR;0;2022-10-01;431;619;2008;5975;467;1736;6212;396;318;54600424;52019115;37476152;6032459;53701710;40695995;6407627;1152;70587
FR;0;2022-10-02;63;136;218;639;97;215;665;66;42;54600487;52019251;37476370;6033098;53701807;40696210;6408292;1218;70629
FR;0;2022-10-03;559;898;2468;12053;731;2194;12231;2074;745;54601046;52020149;37478838;6045151;53702538;40698404;6420523;3292;71374
FR;0;2022-10-04;668;830;3394;23508;576;2785;23685;4704;1583;54601714;52020979;37482232;6068659;53703114;40701189;6444208;7996;72957
FR;0;2022-10-05;576;851;2446;14606;629;2161;14747;3656;1210;54602290;52021830;37484678;6083265;53703743;40703350;6458955;11652;74167
FR;0;2022-10-06;542;740;3088;21688;542;2520;21898;6668;1909;54602832;52022570;37487766;6104953;53704285;40705870;6480853;18320;76076
FR;0;2022-10-07;730;1008;4127;30308;737;3476;30397;16873;3204;54603562;52023578;37491893;6135261;53705022;40709346;6511250;35193;79280
FR;0;2022-10-08;350;520;1651;8432;382;1410;8601;6699;1170;54603912;52024098;37493544;6143693;53705404;40710756;6519851;41892;80450
FR;0;2022-10-09;109;137;337;1587;111;312;1650;1511;297;54604021;52024235;37493881;6145280;53705515;40711068;6521501;43403;80747
FR;0;2022-10-10;490;800;2928;20538;616;2508;20869;19565;3272;54604511;52025035;37496809;6165818;53706131;40713576;6542370;62968;84019
FR;0;2022-10-11;583;811;4268;40321;551;3571;40665;40161;6380;54605094;52025846;37501077;6206139;53706682;40717147;6583035;103129;90399
FR;0;2022-10-12;585;854;3266;26755;636;2773;27085;27302;4691;54605679;52026700;37504343;6232894;53707318;40719920;6610120;130431;95090
FR;0;2022-10-13;619;813;4016;38463;603;3137;38922;40607;6607;54606298;52027513;37508359;6271357;53707921;40723057;6649042;171038;101697
FR;0;2022-10-14;758;1067;4868;47665;778;3953;48139;51132;7863;54607056;52028580;37513227;6319022;53708699;40727010;6697181;222170;109560
FR;0;2022-10-15;363;571;1867;11851;410;1629;11965;13091;2274;54607419;52029151;37515094;6330873;53709109;40728639;6709146;235261;111834
FR;0;2022-10-16;92;134;372;1967;84;356;2012;2347;479;54607511;52029285;37515466;6332840;53709193;40728995;6711158;237608;112313
FR;0;2022-10-17;437;707;3042;26460;492;2481;26834;30786;5410;54607948;52029992;37518508;6359300;53709685;40731476;6737992;268394;117723
FR;0;2022-10-18;600;734;4703;46099;532;3760;46662;55445;11701;54608548;52030726;37523211;6405399;53710217;40735236;6784654;323839;129424
FR;0;2022-10-19;564;816;3641;34375;621;3073;34743;42461;9251;54609112;52031542;37526852;6439774;53710838;40738309;6819397;366300;138675
FR;0;2022-10-20;613;799;4842;49459;584;3729;50119;60518;12924;54609725;52032341;37531694;6489233;53711422;40742038;6869516;426818;151599
FR;0;2022-10-21;690;991;5708;57025;706;4519;57710;70956;14294;54610415;52033332;37537402;6546258;53712128;40746557;6927226;497774;165893
FR;0;2022-10-22;334;412;1654;12948;332;1320;13106;15938;3386;54610749;52033744;37539056;6559206;53712460;40747877;6940332;513712;169279
FR;0;2022-10-23;96;107;350;2063;102;266;2165;2757;631;54610845;52033851;37539406;6561269;53712562;40748143;6942497;516469;169910
FR;0;2022-10-24;551;597;3137;27134;422;2687;27562;35493;7809;54611396;52034448;37542543;6588403;53712984;40750830;6970059;551962;177719
FR;0;2022-10-25;595;724;4870;49108;534;3800;49782;65233;15440;54611991;52035172;37547413;6637511;53713518;40754630;7019841;617195;193159
FR;0;2022-10-26;532;643;3474;32622;481;2900;32928;43998;11022;54612523;52035815;37550887;6670133;53713999;40757530;7052769;661193;204181
FR;0;2022-10-27;591;694;4080;40795;495;3347;41272;54465;13127;54613114;52036509;37554967;6710928;53714494;40760877;7094041;715658;217308
FR;0;2022-10-28;703;865;4609;44186;628;3504;45006;58272;13184;54613817;52037374;37559576;6755114;53715122;40764381;7139047;773930;230492
FR;0;2022-10-29;260;356;1328;9494;254;1082;9627;12523;3012;54614077;52037730;37560904;6764608;53715376;40765463;7148674;786453;233504
FR;0;2022-10-30;87;116;287;1598;92;249;1646;2145;540;54614164;52037846;37561191;6766206;53715468;40765712;7150320;788598;234044
FR;0;2022-10-31;382;485;2073;16057;354;1625;16422;22198;5502;54614546;52038331;37563264;6782263;53715822;40767337;7166742;810796;239546
FR;0;2022-11-01;94;188;928;1121;146;961;1164;1694;503;54614640;52038519;37564192;6783384;53715968;40768298;7167906;812490;240049
FR;0;2022-11-02;513;669;3036;25397;499;2581;25873;36635;10132;54615153;52039188;37567228;6808781;53716467;40770879;7193779;849125;250181
FR;0;2022-11-03;645;700;4114;40064;533;3118;40796;57037;15377;54615798;52039888;37571342;6848845;53717000;40773997;7234575;906162;265558
FR;0;2022-11-04;657;829;4425;43657;575;3518;44276;60532;15248;54616455;52040717;37575767;6892502;53717575;40777515;7278851;966694;280806
FR;0;2022-11-05;255;361;1449;9715;284;1165;9924;13462;3294;54616710;52041078;37577216;6902217;53717859;40778680;7288775;980156;284100
FR;0;2022-11-06;94;116;263;1602;99;246;1631;2337;653;54616804;52041194;37577479;6903819;53717958;40778926;7290406;982493;284753
FR;0;2022-11-07;489;569;2759;26753;482;2244;27396;39118;11004;54617293;52041763;37580238;6930572;53718440;40781170;7317802;1021611;295757
FR;0;2022-11-08;615;804;5002;51974;590;3839;52982;74287;20078;54617908;52042567;37585240;6982546;53719030;40785009;7370784;1095898;315835
FR;0;2022-11-09;516;683;3360;31606;505;2688;32382;46337;13212;54618424;52043250;37588600;7014152;53719535;40787697;7403166;1142235;329047
FR;0;2022-11-10;622;919;4574;43673;668;3624;44574;62850;17354;54619046;52044169;37593174;7057825;53720203;40791321;7447740;1205085;346401
FR;0;2022-11-11;78;114;370;1664;83;312;1727;2799;1012;54619124;52044283;37593544;7059489;53720286;40791633;7449467;1207884;347413
FR;0;2022-11-12;211;346;1195;7102;255;978;7337;10289;2765;54619335;52044629;37594739;7066591;53720541;40792611;7456804;1218173;350178
FR;0;2022-11-13;69;115;249;1207;94;213;1261;1974;625;54619404;52044744;37594988;7067798;53720635;40792824;7458065;1220147;350803
FR;0;2022-11-14;441;529;2581;23986;377;2058;24625;36201;10889;54619845;52045273;37597569;7091784;53721012;40794882;7482690;1256348;361692
FR;0;2022-11-15;608;857;4324;45030;682;3369;45976;66885;19619;54620453;52046130;37601893;7136814;53721694;40798251;7528666;1323233;381311
FR;0;2022-11-16;552;661;3071;28588;533;2578;29124;43249;13312;54621005;52046791;37604964;7165402;53722227;40800829;7557790;1366482;394623
FR;0;2022-11-17;566;681;3825;39249;528;2985;39856;58349;17402;54621571;52047472;37608789;7204651;53722755;40803814;7597646;1424831;412025
FR;0;2022-11-18;621;781;4606;45140;595;3456;46048;65707;18344;54622192;52048253;37613395;7249791;53723350;40807270;7643694;1490538;430369
FR;0;2022-11-19;270;342;1501;9806;274;1096;10001;14322;4009;54622462;52048595;37614896;7259597;53723624;40808366;7653695;1504860;434378
FR;0;2022-11-20;79;177;304;1698;159;261;1772;2717;859;54622541;52048772;37615200;7261295;53723783;40808627;7655467;1507577;435237
FR;0;2022-11-21;437;513;2424;21431;351;1954;22002;33089;10320;54622978;52049285;37617624;7282726;53724134;40810581;7677469;1540666;445557
FR;0;2022-11-22;537;608;4026;39824;435;3165;40394;59757;18234;54623515;52049893;37621650;7322550;53724569;40813746;7717863;1600423;463791
FR;0;2022-11-23;471;562;2755;26025;407;2321;26514;40381;12879;54623986;52050455;37624405;7348575;53724976;40816067;7744377;1640804;476670
FR;0;2022-11-24;510;605;3767;37152;428;2963;37865;56814;17929;54624496;52051060;37628172;7385727;53725404;40819030;7782242;1697618;494599
FR;0;2022-11-25;577;724;4187;40148;577;3148;40991;59632;17474;54625073;52051784;37632359;7425875;53725981;40822178;7823233;1757250;512073
FR;0;2022-11-26;301;338;1335;9371;262;1064;9512;13999;3971;54625374;52052122;37633694;7435246;53726243;40823242;7832745;1771249;516044
FR;0;2022-11-27;77;87;265;1661;71;225;1689;2554;805;54625451;52052209;37633959;7436907;53726314;40823467;7834434;1773803;516849
FR;0;2022-11-28;417;481;2636;24795;361;1981;25534;38451;12192;54625868;52052690;37636595;7461702;53726675;40825448;7859968;1812254;529041
FR;0;2022-11-29;499;607;4399;46522;377;3291;47248;71073;22296;54626367;52053297;37640994;7508224;53727052;40828739;7907216;1883327;551337
FR;0;2022-11-30;508;693;3738;36919;495;2896;37726;56318;17227;54626875;52053990;37644732;7545143;53727547;40831635;7944942;1939645;568564
FR;0;2022-12-01;533;680;5315;51861;459;3910;52666;79616;25205;54627408;52054670;37650047;7597004;53728006;40835545;7997608;2019261;593769
FR;0;2022-12-02;643;747;6172;61533;532;4381;62765;92430;27449;54628051;52055417;37656219;7658537;53728538;40839926;8060373;2111691;621218
FR;0;2022-12-03;304;342;2286;18050;222;1626;18479;26726;7618;54628355;52055759;37658505;7676587;53728760;40841552;8078852;2138417;628836
FR;0;2022-12-04;96;124;524;4305;91;434;4356;6441;1856;54628451;52055883;37659029;7680892;53728851;40841986;8083208;2144858;630692
FR;0;2022-12-05;464;593;4305;44688;430;2916;45655;68986;21866;54628915;52056476;37663334;7725580;53729281;40844902;8128863;2213844;652558
FR;0;2022-12-06;629;741;6847;78284;481;4652;79802;121724;39588;54629544;52057217;37670181;7803864;53729762;40849554;8208665;2335568;692146
FR;0;2022-12-07;556;638;5358;58155;473;3605;59301;90505;29567;54630100;52057855;37675539;7862019;53730235;40853159;8267966;2426073;721713
FR;0;2022-12-08;608;713;6986;79665;453;4590;81359;124164;40869;54630708;52058568;37682525;7941684;53730688;40857749;8349325;2550237;762582
FR;0;2022-12-09;782;841;8676;95678;554;5729;97570;147321;46790;54631490;52059409;37691201;8037362;53731242;40863478;8446895;2697558;809372
FR;0;2022-12-10;409;439;3825;33957;283;2481;34853;50555;14712;54631899;52059848;37695026;8071319;53731525;40865959;8481748;2748113;824084
FR;0;2022-12-11;132;141;993;8362;101;687;8567;12255;3276;54632031;52059989;37696019;8079681;53731626;40866646;8490315;2760368;827360
FR;0;2022-12-12;519;588;6376;67472;379;4133;69064;106248;34815;54632550;52060577;37702395;8147153;53732005;40870779;8559379;2866616;862175
FR;0;2022-12-13;701;776;9045;103567;484;5628;106142;164822;55049;54633251;52061353;37711440;8250720;53732489;40876407;8665521;3031438;917224
FR;0;2022-12-14;591;707;6820;73338;470;4551;75003;116967;38758;54633842;52062060;37718260;8324058;53732959;40880958;8740524;3148405;955982
FR;0;2022-12-15;658;857;8885;95904;548;5708;98221;153292;51770;54634500;52062917;37727145;8419962;53733507;40886666;8838745;3301697;1007752
FR;0;2022-12-16;827;971;9772;104796;647;6455;107035;166491;55321;54635327;52063888;37736917;8524758;53734154;40893121;8945780;3468188;1063073
FR;0;2022-12-17;344;427;3503;31788;290;2295;32580;48430;14449;54635671;52064315;37740420;8556546;53734444;40895416;8978360;3516618;1077522
FR;0;2022-12-18;93;127;788;6333;80;541;6483;9629;2752;54635764;52064442;37741208;8562879;53734524;40895957;8984843;3526247;1080274
FR;0;2022-12-19;590;615;5754;56210;431;3681;57842;90252;30083;54636354;52065057;37746962;8619089;53734955;40899638;9042685;3616499;1110357
FR;0;2022-12-20;740;789;7949;79841;525;5244;81987;130807;45055;54637094;52065846;37754911;8698930;53735480;40904882;9124672;3747306;1155412
FR;0;2022-12-21;594;622;5331;50949;432;3579;52295;84087;29282;54637688;52066468;37760242;8749879;53735912;40908461;9176967;3831393;1184694
FR;0;2022-12-22;643;663;4912;46274;460;3433;47513;76883;26897;54638331;52067131;37765154;8796153;53736372;40911894;9224480;3908276;1211591
FR;0;2022-12-23;474;582;3442;26201;418;2603;26873;43358;14900;54638805;52067713;37768596;8822354;53736790;40914497;9251353;3951634;1226491
FR;0;2022-12-24;105;108;446;2708;81;337;2832;4289;1231;54638910;52067821;37769042;8825062;53736871;40914834;9254185;3955923;1227722
FR;0;2022-12-25;34;41;134;566;33;105;592;925;273;54638944;52067862;37769176;8825628;53736904;40914939;9254777;3956848;1227995
FR;0;2022-12-26;368;390;2500;16919;289;1822;17559;27592;8820;54639312;52068252;37771676;8842547;53737193;40916761;9272336;3984440;1236815
FR;0;2022-12-27;539;661;4213;33721;444;2952;34868;56708;19735;54639851;52068913;37775889;8876268;53737637;40919713;9307204;4041148;1256550
FR;0;2022-12-28;476;517;3240;25712;351;2315;26333;42920;14825;54640327;52069430;37779129;8901980;53737988;40922028;9333537;4084068;1271375
FR;0;2022-12-29;432;539;3423;26587;352;2407;27594;45102;15657;54640759;52069969;37782552;8928567;53738340;40924435;9361131;4129170;1287032
FR;0;2022-12-30;455;504;2628;19565;358;1864;20236;32604;10979;54641214;52070473;37785180;8948132;53738698;40926299;9381367;4161774;1298011
FR;0;2022-12-31;137;156;508;3184;120;413;3328;4945;1338;54641351;52070629;37785688;8951316;53738818;40926712;9384695;4166719;1299349
FR;0;2023-01-01;25;44;177;710;26;149;736;1026;246;54641376;52070673;37785865;8952026;53738844;40926861;9385431;4167745;1299595
FR;0;2023-01-02;385;548;2999;19027;374;2314;19506;32962;12061;54641761;52071221;37788864;8971053;53739218;40929175;9404937;4200707;1311656
FR;0;2023-01-03;659;674;4751;44182;451;3365;45123;82769;34814;54642420;52071895;37793615;9015235;53739669;40932540;9450060;4283476;1346470
FR;0;2023-01-04;538;589;3870;31098;398;2762;31914;59869;25813;54642958;52072484;37797485;9046333;53740067;40935302;9481974;4343345;1372283
FR;0;2023-01-05;664;744;4682;43299;546;3185;44233;84026;37163;54643622;52073228;37802167;9089632;53740613;40938487;9526207;4427371;1409446
FR;0;2023-01-06;742;855;5520;48567;576;3660;49627;92081;39504;54644364;52074083;37807687;9138199;53741189;40942147;9575834;4519452;1448950
FR;0;2023-01-07;345;411;1948;12931;298;1414;13252;23030;8766;54644709;52074494;37809635;9151130;53741487;40943561;9589086;4542482;1457716
FR;0;2023-01-08;104;143;494;2918;99;356;3014;5231;1992;54644813;52074637;37810129;9154048;53741586;40943917;9592100;4547713;1459708
FR;0;2023-01-09;577;627;2858;22323;448;2062;22906;45817;21205;54645390;52075264;37812987;9176371;53742034;40945979;9615006;4593530;1480913
FR;0;2023-01-10;613;767;4803;41549;530;3433;42378;86980;41762;54646003;52076031;37817790;9217920;53742564;40949412;9657384;4680510;1522675
FR;0;2023-01-11;498;589;3133;25081;427;2277;25610;52845;25231;54646501;52076620;37820923;9243001;53742991;40951689;9682994;4733355;1547906
FR;0;2023-01-12;588;679;3979;34331;457;2879;34957;72432;35046;54647089;52077299;37824902;9277332;53743448;40954568;9717951;4805787;1582952
FR;0;2023-01-13;733;789;4369;36210;544;3143;36856;74567;35175;54647822;52078088;37829271;9313542;53743992;40957711;9754807;4880354;1618127
FR;0;2023-01-14;353;344;1582;9307;236;1193;9499;17759;7416;54648175;52078432;37830853;9322849;53744228;40958904;9764306;4898113;1625543
FR;0;2023-01-15;100;122;378;1566;79;289;1677;3254;1404;54648275;52078554;37831231;9324415;53744307;40959193;9765983;4901367;1626947
FR;0;2023-01-16;421;474;2382;16343;328;1787;16606;35977;18093;54648696;52079028;37833613;9340758;53744635;40960980;9782589;4937344;1645040
FR;0;2023-01-17;503;589;3531;29059;405;2559;29619;65743;33908;54649199;52079617;37837144;9369817;53745040;40963539;9812208;5003087;1678948
FR;0;2023-01-18;469;558;2361;17447;405;1831;17758;39154;19874;54649668;52080175;37839505;9387264;53745445;40965370;9829966;5042241;1698822
FR;0;2023-01-19;506;521;2867;23060;356;2130;23408;52277;27001;54650174;52080696;37842372;9410324;53745801;40967500;9853374;5094518;1725823
FR;0;2023-01-20;630;696;3465;25783;495;2621;26266;57721;29389;54650804;52081392;37845837;9436107;53746296;40970121;9879640;5152239;1755212
FR;0;2023-01-21;261;305;1141;6421;220;880;6530;13240;6017;54651065;52081697;37846978;9442528;53746516;40971001;9886170;5165479;1761229
FR;0;2023-01-22;47;63;178;880;32;154;930;1921;874;54651112;52081760;37847156;9443408;53746548;40971155;9887100;5167400;1762103
FR;0;2023-01-23;321;410;1737;11035;268;1300;11258;27212;14813;54651433;52082170;37848893;9454443;53746816;40972455;9898358;5194612;1776916
FR;0;2023-01-24;475;527;2592;20713;371;1941;21023;51003;28301;54651908;52082697;37851485;9475156;53747187;40974396;9919381;5245615;1805217
FR;0;2023-01-25;405;552;1950;12610;394;1481;13039;30753;16451;54652313;52083249;37853435;9487766;53747581;40975877;9932420;5276368;1821668
FR;0;2023-01-26;435;525;2380;17185;378;1784;17495;42438;23387;54652748;52083774;37855815;9504951;53747959;40977661;9949915;5318806;1845055
FR;0;2023-01-27;526;660;2654;18513;486;2015;18760;45004;24527;54653274;52084434;37858469;9523464;53748445;40979676;9968675;5363810;1869582
FR;0;2023-01-28;237;290;866;4521;234;691;4640;9984;4749;54653511;52084724;37859335;9527985;53748679;40980367;9973315;5373794;1874331
FR;0;2023-01-29;42;72;124;466;55;102;504;1098;548;54653553;52084796;37859459;9528451;53748734;40980469;9973819;5374892;1874879
FR;0;2023-01-30;365;448;1341;8283;320;1109;8475;20926;11426;54653918;52085244;37860800;9536734;53749054;40981578;9982294;5395818;1886305
FR;0;2023-01-31;424;486;2042;14088;328;1528;14323;36840;21238;54654342;52085730;37862842;9550822;53749382;40983106;9996617;5432658;1907543
FR;0;2023-02-01;404;523;1716;8341;396;1465;8497;22189;12591;54654746;52086253;37864558;9559163;53749778;40984571;10005114;5454847;1920134
FR;0;2023-02-02;367;499;1718;11880;341;1424;12088;31623;18233;54655113;52086752;37866276;9571043;53750119;40985995;10017202;5486470;1938367
FR;0;2023-02-03;478;645;2057;12623;480;1640;12802;33740;19436;54655591;52087397;37868333;9583666;53750599;40987635;10030004;5520210;1957803
FR;0;2023-02-04;195;276;672;3134;237;564;3179;7451;3823;54655786;52087673;37869005;9586800;53750836;40988199;10033183;5527661;1961626
FR;0;2023-02-05;25;65;89;245;42;87;261;589;284;54655811;52087738;37869094;9587045;53750878;40988286;10033444;5528250;1961910
FR;0;2023-02-06;306;353;1094;5411;284;861;5593;15357;9041;54656117;52088091;37870188;9592456;53751162;40989147;10039037;5543607;1970951
FR;0;2023-02-07;348;495;1598;9722;364;1311;9876;28135;16869;54656465;52088586;37871786;9602178;53751526;40990458;10048913;5571742;1987820
FR;0;2023-02-08;298;383;1128;6048;302;913;6214;16954;9746;54656763;52088969;37872914;9608226;53751828;40991371;10055127;5588696;1997566
FR;0;2023-02-09;339;469;1296;7883;340;1106;8065;22728;13613;54657102;52089438;37874210;9616109;53752168;40992477;10063192;5611424;2011179
FR;0;2023-02-10;461;545;1510;8353;431;1269;8498;23744;13950;54657563;52089983;37875720;9624462;53752599;40993746;10071690;5635168;2025129
FR;0;2023-02-11;164;221;582;2146;175;512;2233;5427;2766;54657727;52090204;37876302;9626608;53752774;40994258;10073923;5640595;2027895
FR;0;2023-02-12;38;42;60;175;41;54;197;439;208;54657765;52090246;37876362;9626783;53752815;40994312;10074120;5641034;2028103
FR;0;2023-02-13;227;320;742;3331;243;675;3428;9587;5490;54657992;52090566;37877104;9630114;53753058;40994987;10077548;5650621;2033593
FR;0;2023-02-14;291;370;1181;5951;270;1004;6102;17514;10398;54658283;52090936;37878285;9636065;53753328;40995991;10083650;5668135;2043991
FR;0;2023-02-15;285;389;954;4073;287;828;4251;12193;7154;54658568;52091325;37879239;9640138;53753615;40996819;10087901;5680328;2051145
FR;0;2023-02-16;261;397;1137;5169;262;991;5329;15004;8732;54658829;52091722;37880376;9645307;53753877;40997810;10093230;5695332;2059877
FR;0;2023-02-17;366;465;1302;5472;374;1141;5695;16367;9619;54659195;52092187;37881678;9650779;53754251;40998951;10098925;5711699;2069496
FR;0;2023-02-18;159;216;559;1624;170;488;1694;4053;2045;54659354;52092403;37882237;9652403;53754421;40999439;10100619;5715752;2071541
FR;0;2023-02-19;37;38;48;139;36;39;140;337;167;54659391;52092441;37882285;9652542;53754457;40999478;10100759;5716089;2071708
FR;0;2023-02-20;243;336;707;2836;251;664;2955;8450;4838;54659634;52092777;37882992;9655378;53754708;41000142;10103714;5724539;2076546
FR;0;2023-02-21;266;412;1065;4520;267;928;4710;13912;8227;54659900;52093189;37884057;9659898;53754975;41001070;10108424;5738451;2084773
FR;0;2023-02-22;241;370;733;2936;280;697;2973;9018;5271;54660141;52093559;37884790;9662834;53755255;41001767;10111397;5747469;2090044
FR;0;2023-02-23;223;360;931;3985;247;836;4172;12208;7131;54660364;52093919;37885721;9666819;53755502;41002603;10115569;5759677;2097175
FR;0;2023-02-24;286;465;1031;4390;344;901;4584;12933;7409;54660650;52094384;37886752;9671209;53755846;41003504;10120153;5772610;2104584
FR;0;2023-02-25;122;163;443;1191;141;360;1270;3174;1613;54660772;52094547;37887195;9672400;53755987;41003864;10121423;5775784;2106197
FR;0;2023-02-26;20;27;34;101;27;35;113;256;111;54660792;52094574;37887229;9672501;53756014;41003899;10121536;5776040;2106308
FR;0;2023-02-27;204;322;593;1986;247;575;2056;6525;3923;54660996;52094896;37887822;9674487;53756261;41004474;10123592;5782565;2110231
FR;0;2023-02-28;259;362;833;3567;244;803;3706;12095;7441;54661255;52095258;37888655;9678054;53756505;41005277;10127298;5794660;2117672
FR;0;2023-03-01;214;323;731;1986;266;667;2160;6559;3902;54661469;52095581;37889386;9680040;53756771;41005944;10129458;5801219;2121574
FR;0;2023-03-02;210;305;825;2964;219;703;3184;10048;6184;54661679;52095886;37890211;9683004;53756990;41006647;10132642;5811267;2127758
FR;0;2023-03-03;318;453;1010;3659;344;902;3794;11711;6914;54661997;52096339;37891221;9686663;53757334;41007549;10136436;5822978;2134672
FR;0;2023-03-04;125;213;360;1073;153;344;1087;2771;1366;54662122;52096552;37891581;9687736;53757487;41007893;10137523;5825749;2136038
FR;0;2023-03-05;23;25;23;50;22;26;51;196;112;54662145;52096577;37891604;9687786;53757509;41007919;10137574;5825945;2136150
FR;0;2023-03-06;221;264;517;1407;188;500;1480;4678;2697;54662366;52096841;37892121;9689193;53757697;41008419;10139054;5830623;2138847
FR;0;2023-03-07;183;307;634;2349;214;588;2438;7908;4871;54662549;52097148;37892755;9691542;53757911;41009007;10141492;5838531;2143718
FR;0;2023-03-08;155;279;504;1420;214;447;1507;4936;2901;54662704;52097427;37893259;9692962;53758125;41009454;10142999;5843467;2146619
FR;0;2023-03-09;163;274;611;1980;183;584;2052;7035;4331;54662867;52097701;37893870;9694942;53758308;41010038;10145051;5850502;2150950
FR;0;2023-03-10;313;438;860;2590;321;784;2713;8873;5318;54663180;52098139;37894730;9697532;53758629;41010822;10147764;5859375;2156268
FR;0;2023-03-11;122;164;307;786;124;265;838;2271;1168;54663302;52098303;37895037;9698318;53758753;41011087;10148602;5861646;2157436
FR;0;2023-03-12;10;23;26;61;22;26;62;174;85;54663312;52098326;37895063;9698379;53758775;41011113;10148664;5861820;2157521
FR;0;2023-03-13;133;205;439;1087;152;398;1165;3612;2031;54663445;52098531;37895502;9699466;53758927;41011511;10149829;5865432;2159552
FR;0;2023-03-14;189;273;620;1852;188;607;1931;6653;4047;54663634;52098804;37896122;9701318;53759115;41012118;10151760;5872085;2163599
FR;0;2023-03-15;156;234;457;1160;190;426;1241;4166;2441;54663790;52099038;37896579;9702478;53759305;41012544;10153001;5876251;2166040
FR;0;2023-03-16;172;253;561;1603;183;515;1702;5773;3461;54663962;52099291;37897140;9704081;53759488;41013059;10154703;5882024;2169501
FR;0;2023-03-17;274;338;714;1983;253;632;2137;7144;4259;54664236;52099629;37897854;9706064;53759741;41013691;10156840;5889168;2173760
FR;0;2023-03-18;117;145;277;590;96;269;650;1970;1017;54664353;52099774;37898131;9706654;53759837;41013960;10157490;5891138;2174777
FR;0;2023-03-19;15;17;21;47;18;12;50;110;49;54664368;52099791;37898152;9706701;53759855;41013972;10157540;5891248;2174826
FR;0;2023-03-20;142;238;433;1010;155;435;1096;3695;2096;54664510;52100029;37898585;9707711;53760010;41014407;10158636;5894943;2176922
FR;0;2023-03-21;204;261;627;1564;181;593;1734;6287;3798;54664714;52100290;37899212;9709275;53760191;41015000;10160370;5901230;2180720
FR;0;2023-03-22;189;233;460;994;181;434;1106;3783;2197;54664903;52100523;37899672;9710269;53760372;41015434;10161476;5905013;2182917
FR;0;2023-03-23;154;226;556;1350;153;501;1444;4945;2892;54665057;52100749;37900228;9711619;53760525;41015935;10162920;5909958;2185809
FR;0;2023-03-24;223;340;708;1660;243;654;1830;6265;3616;54665280;52101089;37900936;9713279;53760768;41016589;10164750;5916223;2189425
FR;0;2023-03-25;109;148;282;543;116;250;607;1684;802;54665389;52101237;37901218;9713822;53760884;41016839;10165357;5917907;2190227
FR;0;2023-03-26;14;11;15;25;7;13;31;65;27;54665403;52101248;37901233;9713847;53760891;41016852;10165388;5917972;2190254
