fra;vaccin;jour;n_dose1;n_dose2;n_dose3;n_dose4;n_rappel;n_cum_dose1;n_cum_dose2;n_cum_dose3;n_cum_dose4;n_cum_rappel
FR;1;2020-12-27;603;0;0;0;0;603;0;0;0;0
FR;1;2020-12-28;670;1;0;0;0;1273;1;0;0;0
FR;1;2020-12-29;374;0;0;0;0;1647;1;0;0;0
FR;1;2020-12-30;440;0;0;0;0;2087;1;0;0;0
FR;1;2020-12-31;436;1;0;0;0;2523;2;0;0;0
FR;1;2021-01-01;1138;2;0;0;0;3661;4;0;0;0
FR;1;2021-01-02;359;3;0;0;0;4020;7;0;0;0
FR;1;2021-01-03;402;0;0;0;0;4422;7;0;0;0
FR;1;2021-01-04;2093;2;0;0;0;6515;9;0;0;0
FR;1;2021-01-05;7733;3;0;0;0;14248;12;0;0;0
FR;1;2021-01-06;12449;13;0;0;0;26697;25;0;0;0
FR;1;2021-01-07;29452;9;0;0;0;56149;34;0;0;0
FR;1;2021-01-08;37123;12;0;0;0;93272;46;0;0;0
FR;1;2021-01-09;11209;5;0;0;0;104481;51;0;0;0
FR;1;2021-01-10;5999;3;0;0;0;110480;54;0;0;0
FR;1;2021-01-11;39925;17;0;0;0;150405;71;0;0;0
FR;1;2021-01-12;62128;16;0;0;0;212533;87;0;0;0
FR;1;2021-01-13;65113;31;0;0;0;277646;118;0;0;0
FR;1;2021-01-14;81438;92;0;0;0;359084;210;0;0;0
FR;1;2021-01-15;68598;34;0;0;0;427682;244;0;0;0
FR;1;2021-01-16;19893;69;0;0;0;447575;313;0;0;0
FR;1;2021-01-17;10897;49;0;0;0;458472;362;0;0;0
FR;1;2021-01-18;82813;162;0;0;0;541285;524;0;0;0
FR;1;2021-01-19;125904;174;0;0;0;667189;698;0;0;0
FR;1;2021-01-20;132393;169;0;0;0;799582;867;0;0;0
FR;1;2021-01-21;153044;161;0;0;0;952626;1028;0;0;0
FR;1;2021-01-22;115932;202;0;0;0;1068558;1230;0;0;0
FR;1;2021-01-23;36601;64;0;0;0;1105159;1294;0;0;0
FR;1;2021-01-24;9581;74;0;0;0;1114740;1368;0;0;0
FR;1;2021-01-25;74413;1276;0;0;0;1189153;2644;0;0;0
FR;1;2021-01-26;96448;3295;1;0;0;1285601;5939;1;0;0
FR;1;2021-01-27;103628;5946;0;0;0;1389229;11885;1;0;0
FR;1;2021-01-28;120584;15110;0;0;0;1509813;26995;1;0;0
FR;1;2021-01-29;88881;17784;0;0;0;1598694;44779;1;0;0
FR;1;2021-01-30;27984;4317;0;0;0;1626678;49096;1;0;0
FR;1;2021-01-31;5183;1744;0;0;0;1631861;50840;1;0;0
FR;1;2021-02-01;49708;21587;0;0;0;1681569;72427;1;0;0
FR;1;2021-02-02;67796;35903;0;0;0;1749365;108330;1;0;0
FR;1;2021-02-03;67076;38215;0;0;0;1816441;146545;1;0;0
FR;1;2021-02-04;77123;51807;0;0;0;1893564;198352;1;0;0
FR;1;2021-02-05;63407;46142;0;0;0;1956971;244494;1;0;0
FR;1;2021-02-06;19410;10783;0;0;0;1976381;255277;1;0;0
FR;1;2021-02-07;3660;5344;0;0;0;1980041;260621;1;0;0
FR;1;2021-02-08;36484;46979;0;0;0;2016525;307600;1;0;0
FR;1;2021-02-09;50790;74772;0;0;0;2067315;382372;1;0;0
FR;1;2021-02-10;52050;79552;0;0;0;2119365;461924;1;0;0
FR;1;2021-02-11;63351;101547;0;0;0;2182716;563471;1;0;0
FR;1;2021-02-12;55841;74810;0;0;0;2238557;638281;1;0;0
FR;1;2021-02-13;15452;19265;0;0;0;2254009;657546;1;0;0
FR;1;2021-02-14;3744;7278;0;0;0;2257753;664824;1;0;0
FR;1;2021-02-15;24132;73547;0;0;0;2281885;738371;1;0;0
FR;1;2021-02-16;32761;96493;0;0;0;2314646;834864;1;0;0
FR;1;2021-02-17;35101;100282;1;0;0;2349747;935146;2;0;0
FR;1;2021-02-18;49430;115713;0;0;0;2399177;1050859;2;0;0
FR;1;2021-02-19;45370;86728;1;0;0;2444547;1137587;3;0;0
FR;1;2021-02-20;13378;27081;0;0;0;2457925;1164668;3;0;0
FR;1;2021-02-21;2454;6175;0;0;0;2460379;1170843;3;0;0
FR;1;2021-02-22;24711;69469;2;0;0;2485090;1240312;5;0;0
FR;1;2021-02-23;37416;80777;1;0;0;2522506;1321089;6;0;0
FR;1;2021-02-24;40677;78305;1;0;0;2563183;1399394;7;0;0
FR;1;2021-02-25;50135;87993;1;0;0;2613318;1487387;8;0;0
FR;1;2021-02-26;47190;67593;1;0;0;2660508;1554980;9;0;0
FR;1;2021-02-27;15668;21101;0;0;0;2676176;1576081;9;0;0
FR;1;2021-02-28;3553;4215;1;0;0;2679729;1580296;10;0;0
FR;1;2021-03-01;40151;49564;1;0;0;2719880;1629860;11;0;0
FR;1;2021-03-02;55961;61912;2;0;0;2775841;1691772;13;0;0
FR;1;2021-03-03;61211;60590;0;0;0;2837052;1752362;13;0;0
FR;1;2021-03-04;72977;66353;3;0;0;2910029;1818715;16;0;0
FR;1;2021-03-05;74737;58936;3;0;0;2984766;1877651;19;0;0
FR;1;2021-03-06;82436;15962;2;0;0;3067202;1893613;21;0;0
FR;1;2021-03-07;63709;4872;1;0;0;3130911;1898485;22;0;0
FR;1;2021-03-08;60147;41931;2;0;0;3191058;1940416;24;0;0
FR;1;2021-03-09;85968;47881;1;0;0;3277026;1988297;25;0;0
FR;1;2021-03-10;90878;47936;5;0;0;3367904;2036233;30;0;0
FR;1;2021-03-11;105042;54282;1;0;0;3472946;2090515;31;0;0
FR;1;2021-03-12;104090;45038;1;0;0;3577036;2135553;32;0;0
FR;1;2021-03-13;89182;12691;1;0;0;3666218;2148244;33;0;0
FR;1;2021-03-14;44449;2846;1;0;0;3710667;2151090;34;0;0
FR;1;2021-03-15;95479;28580;3;0;0;3806146;2179670;37;0;0
FR;1;2021-03-16;123573;34411;5;0;0;3929719;2214081;42;0;0
FR;1;2021-03-17;129284;34182;4;0;0;4059003;2248263;46;0;0
FR;1;2021-03-18;142862;39559;5;0;0;4201865;2287822;51;0;0
FR;1;2021-03-19;136220;32489;2;0;0;4338085;2320311;53;0;0
FR;1;2021-03-20;75977;9960;1;0;0;4414062;2330271;54;0;0
FR;1;2021-03-21;26495;2324;1;0;0;4440557;2332595;55;0;0
FR;1;2021-03-22;114721;30776;2;0;0;4555278;2363371;57;0;0
FR;1;2021-03-23;142997;38116;1;0;0;4698275;2401487;58;0;0
FR;1;2021-03-24;141975;38534;0;0;0;4840250;2440021;58;0;0
FR;1;2021-03-25;164978;39613;4;0;0;5005228;2479634;62;0;0
FR;1;2021-03-26;166363;37509;4;1;0;5171591;2517143;66;1;0
FR;1;2021-03-27;110867;15309;1;0;0;5282458;2532452;67;1;0
FR;1;2021-03-28;42292;3910;3;0;0;5324750;2536362;70;1;0
FR;1;2021-03-29;129790;49582;4;0;0;5454540;2585944;74;1;0
FR;1;2021-03-30;167700;63537;4;0;0;5622240;2649481;78;1;0
FR;1;2021-03-31;170898;67291;4;0;0;5793138;2716772;82;1;0
FR;1;2021-04-01;194741;80913;10;0;0;5987879;2797685;92;1;0
FR;1;2021-04-02;164418;85065;7;0;0;6152297;2882750;99;1;0
FR;1;2021-04-03;88229;58046;5;0;0;6240526;2940796;104;1;0
FR;1;2021-04-04;33618;17694;0;0;0;6274144;2958490;104;1;0
FR;1;2021-04-05;46382;9943;11;0;0;6320526;2968433;115;1;0
FR;1;2021-04-06;160273;102427;17;0;0;6480799;3070860;132;1;0
FR;1;2021-04-07;196948;108196;16;0;0;6677747;3179056;148;1;0
FR;1;2021-04-08;222067;112907;13;0;0;6899814;3291963;161;1;0
FR;1;2021-04-09;214509;107421;21;0;0;7114323;3399384;182;1;0
FR;1;2021-04-10;117155;73271;14;0;0;7231478;3472655;196;1;0
FR;1;2021-04-11;40876;30108;6;0;0;7272354;3502763;202;1;0
FR;1;2021-04-12;168428;103918;45;0;0;7440782;3606681;247;1;0
FR;1;2021-04-13;203762;127986;97;1;0;7644544;3734667;344;2;0
FR;1;2021-04-14;208565;122667;207;0;0;7853109;3857334;551;2;0
FR;1;2021-04-15;221621;127111;311;0;0;8074730;3984445;862;2;0
FR;1;2021-04-16;206012;125168;308;0;0;8280742;4109613;1170;2;0
FR;1;2021-04-17;122065;67231;103;0;0;8402807;4176844;1273;2;0
FR;1;2021-04-18;35954;20931;41;0;0;8438761;4197775;1314;2;0
FR;1;2021-04-19;163714;121699;432;0;0;8602475;4319474;1746;2;0
FR;1;2021-04-20;189368;148947;531;0;0;8791843;4468421;2277;2;0
FR;1;2021-04-21;193940;147003;758;0;0;8985783;4615424;3035;2;0
FR;1;2021-04-22;208986;163260;777;0;0;9194769;4778684;3812;2;0
FR;1;2021-04-23;198917;157074;671;0;0;9393686;4935758;4483;2;0
FR;1;2021-04-24;126304;95511;148;0;0;9519990;5031269;4631;2;0
FR;1;2021-04-25;53621;30025;46;0;0;9573611;5061294;4677;2;0
FR;1;2021-04-26;181095;138473;539;0;0;9754706;5199767;5216;2;0
FR;1;2021-04-27;221323;161905;900;0;0;9976029;5361672;6116;2;0
FR;1;2021-04-28;238246;155135;1311;1;1;10214275;5516807;7427;3;1
FR;1;2021-04-29;270235;160508;1208;0;0;10484510;5677315;8635;3;1
FR;1;2021-04-30;271937;148198;1069;0;0;10756447;5825513;9704;3;1
FR;1;2021-05-01;141123;40610;172;0;0;10897570;5866123;9876;3;1
FR;1;2021-05-02;81521;28093;81;0;0;10979091;5894216;9957;3;1
FR;1;2021-05-03;250738;145081;800;0;0;11229829;6039297;10757;3;1
FR;1;2021-05-04;265825;186972;1198;0;0;11495654;6226269;11955;3;1
FR;1;2021-05-05;283830;184816;1265;0;0;11779484;6411085;13220;3;1
FR;1;2021-05-06;309905;183324;1500;0;0;12089389;6594409;14720;3;1
FR;1;2021-05-07;284045;195715;1125;0;0;12373434;6790124;15845;3;1
FR;1;2021-05-08;191639;48845;285;0;0;12565073;6838969;16130;3;1
FR;1;2021-05-09;114043;35768;236;0;0;12679116;6874737;16366;3;1
FR;1;2021-05-10;258158;194077;1184;0;0;12937274;7068814;17550;3;1
FR;1;2021-05-11;318834;210972;1461;0;0;13256108;7279786;19011;3;1
FR;1;2021-05-12;356573;185725;1399;0;0;13612681;7465511;20410;3;1
FR;1;2021-05-13;283410;47692;399;0;0;13896091;7513203;20809;3;1
FR;1;2021-05-14;370446;128566;992;0;0;14266537;7641769;21801;3;1
FR;1;2021-05-15;298052;66108;402;0;0;14564589;7707877;22203;3;1
FR;1;2021-05-16;157756;15522;158;0;0;14722345;7723399;22361;3;1
FR;1;2021-05-17;318895;116295;1438;0;0;15041240;7839694;23799;3;1
FR;1;2021-05-18;383283;111229;1796;0;0;15424523;7950923;25595;3;1
FR;1;2021-05-19;395215;102519;2177;0;0;15819738;8053442;27772;3;1
FR;1;2021-05-20;421754;96107;2042;0;0;16241492;8149549;29814;3;1
FR;1;2021-05-21;399767;97159;1756;0;0;16641259;8246708;31570;3;1
FR;1;2021-05-22;275654;42016;602;0;0;16916913;8288724;32172;3;1
FR;1;2021-05-23;122998;11124;224;0;0;17039911;8299848;32396;3;1
FR;1;2021-05-24;243990;26216;567;0;0;17283901;8326064;32963;3;1
FR;1;2021-05-25;366186;131616;2109;1;0;17650087;8457680;35072;4;1
FR;1;2021-05-26;380772;126010;1990;0;0;18030859;8583690;37062;4;1
FR;1;2021-05-27;406101;128076;1974;0;0;18436960;8711766;39036;4;1
FR;1;2021-05-28;365985;145280;1698;0;0;18802945;8857046;40734;4;1
FR;1;2021-05-29;253808;80839;525;0;0;19056753;8937885;41259;4;1
FR;1;2021-05-30;100960;22551;157;0;0;19157713;8960436;41416;4;1
FR;1;2021-05-31;314274;148772;1280;1;1;19471987;9109208;42696;5;2
FR;1;2021-06-01;361548;166423;1724;1;1;19833535;9275631;44420;6;3
FR;1;2021-06-02;364842;153258;1792;0;0;20198377;9428889;46212;6;3
FR;1;2021-06-03;390946;147594;1649;0;0;20589323;9576483;47861;6;3
FR;1;2021-06-04;363670;175498;1492;1;1;20952993;9751981;49353;7;4
FR;1;2021-06-05;258476;112644;596;0;0;21211469;9864625;49949;7;4
FR;1;2021-06-06;126757;37539;215;0;0;21338226;9902164;50164;7;4
FR;1;2021-06-07;300379;207772;1362;0;0;21638605;10109936;51526;7;4
FR;1;2021-06-08;330598;220707;1639;0;0;21969203;10330643;53165;7;4
FR;1;2021-06-09;336443;212135;1609;0;0;22305646;10542778;54774;7;4
FR;1;2021-06-10;343772;201764;1609;0;0;22649418;10744542;56383;7;4
FR;1;2021-06-11;311825;235194;1294;0;0;22961243;10979736;57677;7;4
FR;1;2021-06-12;244038;150650;432;0;0;23205281;11130386;58109;7;4
FR;1;2021-06-13;100327;60999;188;0;0;23305608;11191385;58297;7;4
FR;1;2021-06-14;207769;288676;1317;1;0;23513377;11480061;59614;8;4
FR;1;2021-06-15;256773;282062;1391;1;0;23770150;11762123;61005;9;4
FR;1;2021-06-16;273591;270598;1263;1;0;24043741;12032721;62268;10;4
FR;1;2021-06-17;268146;244776;1231;1;0;24311887;12277497;63499;11;4
FR;1;2021-06-18;260495;295610;1149;1;0;24572382;12573107;64648;12;4
FR;1;2021-06-19;193430;209482;387;0;0;24765812;12782589;65035;12;4
FR;1;2021-06-20;69659;89146;117;0;0;24835471;12871735;65152;12;4
FR;1;2021-06-21;172207;319790;930;1;1;25007678;13191525;66082;13;5
FR;1;2021-06-22;185698;347863;1098;10;2;25193376;13539388;67180;23;7
FR;1;2021-06-23;204063;339462;1048;0;0;25397439;13878850;68228;23;7
FR;1;2021-06-24;203412;282103;1169;0;0;25600851;14160953;69397;23;7
FR;1;2021-06-25;182516;371821;1196;0;0;25783367;14532774;70593;23;7
FR;1;2021-06-26;131352;278346;503;0;0;25914719;14811120;71096;23;7
FR;1;2021-06-27;52378;122903;145;0;0;25967097;14934023;71241;23;7
FR;1;2021-06-28;136517;368158;1058;0;0;26103614;15302181;72299;23;7
FR;1;2021-06-29;154762;390775;1849;0;0;26258376;15692956;74148;23;7
FR;1;2021-06-30;179924;380019;1663;4;2;26438300;16072975;75811;27;9
FR;1;2021-07-01;201308;332221;1886;5;1;26639608;16405196;77697;32;10
FR;1;2021-07-02;193598;367621;1764;5;3;26833206;16772817;79461;37;13
FR;1;2021-07-03;124401;280464;704;3;1;26957607;17053281;80165;40;14
FR;1;2021-07-04;53909;113691;244;0;0;27011516;17166972;80409;40;14
FR;1;2021-07-05;153718;356022;1500;8;2;27165234;17522994;81909;48;16
FR;1;2021-07-06;173350;382523;1601;45;8;27338584;17905517;83510;93;24
FR;1;2021-07-07;190649;362567;1657;24;5;27529233;18268084;85167;117;29
FR;1;2021-07-08;201416;323118;1826;20;7;27730649;18591202;86993;137;36
FR;1;2021-07-09;189743;387758;1851;3;2;27920392;18978960;88844;140;38
FR;1;2021-07-10;129881;281138;814;1;1;28050273;19260098;89658;141;39
FR;1;2021-07-11;57635;102508;261;0;0;28107908;19362606;89919;141;39
FR;1;2021-07-12;149494;417026;1580;4;0;28257402;19779632;91499;145;39
FR;1;2021-07-13;234105;439476;1805;8;2;28491507;20219108;93304;153;41
FR;1;2021-07-14;171762;151526;417;0;0;28663269;20370634;93721;153;41
FR;1;2021-07-15;279528;424749;1856;1;0;28942797;20795383;95577;154;41
FR;1;2021-07-16;290298;401197;1711;3;1;29233095;21196580;97288;157;42
FR;1;2021-07-17;217284;282107;754;1;0;29450379;21478687;98042;158;42
FR;1;2021-07-18;101968;107298;288;0;0;29552347;21585985;98330;158;42
FR;1;2021-07-19;238092;379092;1496;3;0;29790439;21965077;99826;161;42
FR;1;2021-07-20;305608;380678;1468;0;0;30096047;22345755;101294;161;42
FR;1;2021-07-21;333149;353367;1412;4;2;30429196;22699122;102706;165;44
FR;1;2021-07-22;364557;319221;1501;3;2;30793753;23018343;104207;168;46
FR;1;2021-07-23;349269;343560;1586;4;2;31143022;23361903;105793;172;48
FR;1;2021-07-24;238915;240960;696;1;0;31381937;23602863;106489;173;48
FR;1;2021-07-25;112754;76054;219;0;0;31494691;23678917;106708;173;48
FR;1;2021-07-26;299036;289995;1496;2;2;31793727;23968912;108204;175;50
FR;1;2021-07-27;385723;268649;1457;4;2;32179450;24237561;109661;179;52
FR;1;2021-07-28;390105;251402;1460;4;2;32569555;24488963;111121;183;54
FR;1;2021-07-29;406031;228218;1538;2;1;32975586;24717181;112659;185;55
FR;1;2021-07-30;370613;246948;1632;4;1;33346199;24964129;114291;189;56
FR;1;2021-07-31;243356;165125;793;1;0;33589555;25129254;115084;190;56
FR;1;2021-08-01;105527;47228;233;0;0;33695082;25176482;115317;190;56
FR;1;2021-08-02;297060;213191;1476;2;0;33992142;25389673;116793;192;56
FR;1;2021-08-03;331196;209114;1547;2;1;34323338;25598787;118340;194;57
FR;1;2021-08-04;327881;184305;1437;5;3;34651219;25783092;119777;199;60
FR;1;2021-08-05;301144;193512;1482;0;0;34952363;25976604;121259;199;60
FR;1;2021-08-06;290873;224465;1559;3;1;35243236;26201069;122818;202;61
FR;1;2021-08-07;182603;158814;654;4;3;35425839;26359883;123472;206;64
FR;1;2021-08-08;68841;59128;247;0;0;35494680;26419011;123719;206;64
FR;1;2021-08-09;222653;235833;1440;4;3;35717333;26654844;125159;210;67
FR;1;2021-08-10;252548;240570;1487;2;1;35969881;26895414;126646;212;68
FR;1;2021-08-11;236095;232259;1271;5;1;36205976;27127673;127917;217;69
FR;1;2021-08-12;220664;240217;1486;3;1;36426640;27367890;129403;220;70
FR;1;2021-08-13;201643;238587;1357;2;2;36628283;27606477;130760;222;72
FR;1;2021-08-14;122829;174147;645;0;0;36751112;27780624;131405;222;72
FR;1;2021-08-15;34666;46131;199;1;0;36785778;27826755;131604;223;72
FR;1;2021-08-16;156862;289808;1421;0;0;36942640;28116563;133025;223;72
FR;1;2021-08-17;171524;291507;1421;5;1;37114164;28408070;134446;228;73
FR;1;2021-08-18;161354;286979;1389;6;3;37275518;28695049;135835;234;76
FR;1;2021-08-19;148860;277773;1400;1;0;37424378;28972822;137235;235;76
FR;1;2021-08-20;140439;309168;1527;2;2;37564817;29281990;138762;237;78
FR;1;2021-08-21;84246;213243;586;0;0;37649063;29495233;139348;237;78
FR;1;2021-08-22;28547;82691;230;0;0;37677610;29577924;139578;237;78
FR;1;2021-08-23;118596;321158;1421;2;1;37796206;29899082;140999;239;79
FR;1;2021-08-24;126603;319886;1602;5;1;37922809;30218968;142601;244;80
FR;1;2021-08-25;121474;306578;1777;8;3;38044283;30525546;144378;252;83
FR;1;2021-08-26;106547;286199;2157;10;1;38150830;30811745;146535;262;84
FR;1;2021-08-27;107605;321678;2300;9;3;38258435;31133423;148835;271;87
FR;1;2021-08-28;70984;220711;1100;0;0;38329419;31354134;149935;271;87
FR;1;2021-08-29;24134;78165;468;1;0;38353553;31432299;150403;272;87
FR;1;2021-08-30;96818;286513;4308;6;5112;38450371;31718812;154711;278;5199
FR;1;2021-08-31;98035;276408;9286;15;10148;38548406;31995220;163997;293;15347
FR;1;2021-09-01;112038;245355;21107;7;22085;38660444;32240575;185104;300;37432
FR;1;2021-09-02;84833;198012;24524;11;25445;38745277;32438587;209628;311;62877
FR;1;2021-09-03;82345;227609;26946;20;27976;38827622;32666196;236574;331;90853
FR;1;2021-09-04;71595;189729;11138;11;11659;38899217;32855925;247712;342;102512
FR;1;2021-09-05;18601;41181;4121;2;4292;38917818;32897106;251833;344;106804
FR;1;2021-09-06;59487;151603;30173;15;31141;38977305;33048709;282006;359;137945
FR;1;2021-09-07;57250;139733;30203;27;31127;39034555;33188442;312209;386;169072
FR;1;2021-09-08;71413;173889;26917;20;27876;39105968;33362331;339126;406;196948
FR;1;2021-09-09;54286;124574;28601;23;29655;39160254;33486905;367727;429;226603
FR;1;2021-09-10;65950;152095;30431;22;31571;39226204;33639000;398158;451;258174
FR;1;2021-09-11;52412;146619;9728;14;10310;39278616;33785619;407886;465;268484
FR;1;2021-09-12;10778;29246;2482;1;2635;39289394;33814865;410368;466;271119
FR;1;2021-09-13;51367;104572;38731;29;39943;39340761;33919437;449099;495;311062
FR;1;2021-09-14;53230;96062;51257;65;52931;39393991;34015499;500356;560;363993
FR;1;2021-09-15;60380;139321;50464;55;46972;39454371;34154820;550820;615;410965
FR;1;2021-09-16;46549;81465;53296;71;49492;39500920;34236285;604116;686;460457
FR;1;2021-09-17;53148;109391;45049;61;42644;39554068;34345676;649165;747;503101
FR;1;2021-09-18;37849;118497;11792;19;11260;39591917;34464173;660957;766;514361
FR;1;2021-09-19;6497;21038;2037;1;1972;39598414;34485211;662994;767;516333
FR;1;2021-09-20;36454;74926;46178;66;44094;39634868;34560137;709172;833;560427
FR;1;2021-09-21;34130;68160;56233;71;52641;39668998;34628297;765405;904;613068
FR;1;2021-09-22;38785;118534;49838;76;46829;39707783;34746831;815243;980;659897
FR;1;2021-09-23;31969;62865;54469;85;50827;39739752;34809696;869712;1065;710724
FR;1;2021-09-24;36750;90116;43643;91;41886;39776502;34899812;913355;1156;752610
FR;1;2021-09-25;27631;96643;12299;27;12167;39804133;34996455;925654;1183;764777
FR;1;2021-09-26;4361;15186;1771;5;1694;39808494;35011641;927425;1188;766471
FR;1;2021-09-27;27322;60230;42889;89;41582;39835816;35071871;970314;1277;808053
FR;1;2021-09-28;26871;49464;47165;75;44405;39862687;35121335;1017479;1352;852458
FR;1;2021-09-29;35848;80394;47247;87;45532;39898535;35201729;1064726;1439;897990
FR;1;2021-09-30;26017;46819;47501;80;45382;39924552;35248548;1112227;1519;943372
FR;1;2021-10-01;47162;65091;44861;83;44421;39971714;35313639;1157088;1602;987793
FR;1;2021-10-02;32346;62389;16107;32;16299;40004060;35376028;1173195;1634;1004092
FR;1;2021-10-03;4330;8573;2031;3;2025;40008390;35384601;1175226;1637;1006117
FR;1;2021-10-04;28826;44455;47089;79;46901;40037216;35429056;1222315;1716;1053018
FR;1;2021-10-05;24337;41632;49836;116;49197;40061553;35470688;1272151;1832;1102215
FR;1;2021-10-06;34474;61384;57448;102;57144;40096027;35532072;1329599;1934;1159359
FR;1;2021-10-07;20980;39834;52999;75;51818;40117007;35571906;1382598;2009;1211177
FR;1;2021-10-08;34985;59607;60363;83;61060;40151992;35631513;1442961;2092;1272237
FR;1;2021-10-09;27434;47988;25478;29;25979;40179426;35679501;1468439;2121;1298216
FR;1;2021-10-10;3663;5793;2747;7;2848;40183089;35685294;1471186;2128;1301064
FR;1;2021-10-11;24729;38166;54562;88;55172;40207818;35723460;1525748;2216;1356236
FR;1;2021-10-12;23210;36555;58026;126;59092;40231028;35760015;1583774;2342;1415328
FR;1;2021-10-13;32850;47845;64150;124;65626;40263878;35807860;1647924;2466;1480954
FR;1;2021-10-14;21625;34786;53730;103;54300;40285503;35842646;1701654;2569;1535254
FR;1;2021-10-15;32562;48823;72303;165;74922;40318065;35891469;1773957;2734;1610176
FR;1;2021-10-16;25970;35294;34859;44;36393;40344035;35926763;1808816;2778;1646569
FR;1;2021-10-17;3101;4065;3408;2;3317;40347136;35930828;1812224;2780;1649886
FR;1;2021-10-18;23595;34925;66809;131;69660;40370731;35965753;1879033;2911;1719546
FR;1;2021-10-19;20605;34736;75632;135;79522;40391336;36000489;1954665;3046;1799068
FR;1;2021-10-20;29817;44241;96146;177;99779;40421153;36044730;2050811;3223;1898847
FR;1;2021-10-21;19627;35087;83128;107;86982;40440780;36079817;2133939;3330;1985829
FR;1;2021-10-22;29541;47716;103703;196;109584;40470321;36127533;2237642;3526;2095413
FR;1;2021-10-23;23009;35159;44851;57;47355;40493330;36162692;2282493;3583;2142768
FR;1;2021-10-24;2374;3873;3579;6;3732;40495704;36166565;2286072;3589;2146500
FR;1;2021-10-25;22395;30821;81997;143;85767;40518099;36197386;2368069;3732;2232267
FR;1;2021-10-26;19306;27722;86062;162;90279;40537405;36225108;2454131;3894;2322546
FR;1;2021-10-27;26142;39675;107764;252;112608;40563547;36264783;2561895;4146;2435154
FR;1;2021-10-28;18668;27092;86897;150;91605;40582215;36291875;2648792;4296;2526759
FR;1;2021-10-29;25886;40240;114788;200;121532;40608101;36332115;2763580;4496;2648291
FR;1;2021-10-30;17681;28715;49340;75;51918;40625782;36360830;2812920;4571;2700209
FR;1;2021-10-31;2055;3194;3443;2;3677;40627837;36364024;2816363;4573;2703886
FR;1;2021-11-01;7756;4222;3021;3;3266;40635593;36368246;2819384;4576;2707152
FR;1;2021-11-02;21924;33218;92349;157;97700;40657517;36401464;2911733;4733;2804852
FR;1;2021-11-03;26331;41562;117447;215;123798;40683848;36443026;3029180;4948;2928650
FR;1;2021-11-04;19510;30309;105741;213;111832;40703358;36473335;3134921;5161;3040482
FR;1;2021-11-05;26928;42258;138721;228;147302;40730286;36515593;3273642;5389;3187784
FR;1;2021-11-06;18824;29831;63444;123;66420;40749110;36545424;3337086;5512;3254204
FR;1;2021-11-07;1791;3334;4959;6;5296;40750901;36548758;3342045;5518;3259500
FR;1;2021-11-08;17742;32315;125940;224;132508;40768643;36581073;3467985;5742;3392008
FR;1;2021-11-09;19318;37708;159236;335;168956;40787961;36618781;3627221;6077;3560964
FR;1;2021-11-10;28714;49220;181823;440;192377;40816675;36668001;3809044;6517;3753341
FR;1;2021-11-11;3861;5941;12199;26;13007;40820536;36673942;3821243;6543;3766348
FR;1;2021-11-12;25945;46860;174752;244;186353;40846481;36720802;3995995;6787;3952701
FR;1;2021-11-13;18710;29238;76803;111;81735;40865191;36750040;4072798;6898;4034436
FR;1;2021-11-14;2029;3305;6813;5;7375;40867220;36753345;4079611;6903;4041811
FR;1;2021-11-15;18668;34881;156352;304;166122;40885888;36788226;4235963;7207;4207933
FR;1;2021-11-16;21146;37950;192021;377;204807;40907034;36826176;4427984;7584;4412740
FR;1;2021-11-17;28528;45708;193154;399;204932;40935562;36871884;4621138;7983;4617672
FR;1;2021-11-18;21067;38967;182405;457;194385;40956629;36910851;4803543;8440;4812057
FR;1;2021-11-19;30782;53357;230155;529;246564;40987411;36964208;5033698;8969;5058621
FR;1;2021-11-20;23739;33318;96944;201;103579;41011150;36997526;5130642;9170;5162200
FR;1;2021-11-21;2313;4004;9098;18;9963;41013463;37001530;5139740;9188;5172163
FR;1;2021-11-22;21362;30479;175810;465;189319;41034825;37032009;5315550;9653;5361482
FR;1;2021-11-23;23883;41161;221101;539;237800;41058708;37073170;5536651;10192;5599282
FR;1;2021-11-24;30267;49822;217260;703;234394;41088975;37122992;5753911;10895;5833676
FR;1;2021-11-25;23539;43982;244375;718;263946;41112514;37166974;5998286;11613;6097622
FR;1;2021-11-26;30592;66532;356694;833;388388;41143106;37233506;6354980;12446;6486010
FR;1;2021-11-27;21814;45412;202565;371;222553;41164920;37278918;6557545;12817;6708563
FR;1;2021-11-28;3139;9669;54758;63;61030;41168059;37288587;6612303;12880;6769593
FR;1;2021-11-29;17857;49522;326284;840;354268;41185916;37338109;6938587;13720;7123861
FR;1;2021-11-30;22748;64984;431042;952;470606;41208664;37403093;7369629;14672;7594467
FR;1;2021-12-01;24940;69372;442754;1130;481599;41233604;37472465;7812383;15802;8076066
FR;1;2021-12-02;19997;64525;489258;1228;532703;41253601;37536990;8301641;17030;8608769
FR;1;2021-12-03;22850;81878;542616;1307;591609;41276451;37618868;8844257;18337;9200378
FR;1;2021-12-04;16382;53931;299036;652;328865;41292833;37672799;9143293;18989;9529243
FR;1;2021-12-05;3624;13914;81497;143;91060;41296457;37686713;9224790;19132;9620303
FR;1;2021-12-06;22152;62779;415328;1065;455054;41318609;37749492;9640118;20197;10075357
FR;1;2021-12-07;19824;75841;522826;1531;572434;41338433;37825333;10162944;21728;10647791
FR;1;2021-12-08;21579;75898;458242;1543;501958;41360012;37901231;10621186;23271;11149749
FR;1;2021-12-09;19401;74115;492790;1625;540658;41379413;37975346;11113976;24896;11690407
FR;1;2021-12-10;23202;87704;547280;1586;599861;41402615;38063050;11661256;26482;12290268
FR;1;2021-12-11;16523;59064;302688;747;335438;41419138;38122114;11963944;27229;12625706
FR;1;2021-12-12;4346;16033;83183;179;94072;41423484;38138147;12047127;27408;12719778
FR;1;2021-12-13;15675;63879;366835;1093;406185;41439159;38202026;12413962;28501;13125963
FR;1;2021-12-14;20602;80416;464567;1743;515042;41459761;38282442;12878529;30244;13641005
FR;1;2021-12-15;21457;77582;408933;1308;453016;41481218;38360024;13287462;31552;14094021
FR;1;2021-12-16;19990;77411;451712;1574;500477;41501208;38437435;13739174;33126;14594498
FR;1;2021-12-17;22553;86779;479809;1733;530950;41523761;38524214;14218983;34859;15125448
FR;1;2021-12-18;17589;54780;257564;730;288475;41541350;38578994;14476547;35589;15413923
FR;1;2021-12-19;5547;17133;79134;194;90730;41546897;38596127;14555681;35783;15504653
FR;1;2021-12-20;20858;63202;316117;1081;355189;41567755;38659329;14871798;36864;15859842
FR;1;2021-12-21;26122;73233;372635;1421;417993;41593877;38732562;15244433;38285;16277835
FR;1;2021-12-22;24911;66018;310521;1215;349498;41618788;38798580;15554954;39500;16627333
FR;1;2021-12-23;21244;52365;241404;954;272989;41640032;38850945;15796358;40454;16900322
FR;1;2021-12-24;7104;18263;67110;256;77031;41647136;38869208;15863468;40710;16977353
FR;1;2021-12-25;502;2804;5569;15;6530;41647638;38872012;15869037;40725;16983883
FR;1;2021-12-26;2749;7595;26922;70;31446;41650387;38879607;15895959;40795;17015329
FR;1;2021-12-27;18229;53564;235026;706;265694;41668616;38933171;16130985;41501;17281023
FR;1;2021-12-28;23256;62033;291961;1025;330150;41691872;38995204;16422946;42526;17611173
FR;1;2021-12-29;22201;55568;254923;918;288137;41714073;39050772;16677869;43444;17899310
FR;1;2021-12-30;21224;46399;212105;857;239566;41735297;39097171;16889974;44301;18138876
FR;1;2021-12-31;7461;16622;61835;229;70358;41742758;39113793;16951809;44530;18209234
FR;1;2022-01-01;1030;2484;5646;29;6578;41743788;39116277;16957455;44559;18215812
FR;1;2022-01-02;3056;8069;28878;50;33527;41746844;39124346;16986333;44609;18249339
FR;1;2022-01-03;21118;54015;228135;786;257553;41767962;39178361;17214468;45395;18506892
FR;1;2022-01-04;25320;64917;299162;1235;337210;41793282;39243278;17513630;46630;18844102
FR;1;2022-01-05;29943;64036;274774;1097;310126;41823225;39307314;17788404;47727;19154228
FR;1;2022-01-06;26692;66033;306815;1396;346454;41849917;39373347;18095219;49123;19500682
FR;1;2022-01-07;31475;74757;349762;1535;393868;41881392;39448104;18444981;50658;19894550
FR;1;2022-01-08;23367;51390;222468;696;251099;41904759;39499494;18667449;51354;20145649
FR;1;2022-01-09;7076;17180;66012;163;76146;41911835;39516674;18733461;51517;20221795
FR;1;2022-01-10;21637;57687;236707;952;267266;41933472;39574361;18970168;52469;20489061
FR;1;2022-01-11;26553;63334;282208;1277;317777;41960025;39637695;19252376;53746;20806838
FR;1;2022-01-12;28807;62348;246158;1103;277928;41988832;39700043;19498534;54849;21084766
FR;1;2022-01-13;24620;60028;262723;1252;296068;42013452;39760071;19761257;56101;21380834
FR;1;2022-01-14;27865;66589;313909;1366;351191;42041317;39826660;20075166;57467;21732025
FR;1;2022-01-15;19307;44362;199281;619;223859;42060624;39871022;20274447;58086;21955884
FR;1;2022-01-16;5138;12987;51499;135;59573;42065762;39884009;20325946;58221;22015457
FR;1;2022-01-17;16779;39753;184784;780;206826;42082541;39923762;20510730;59001;22222283
FR;1;2022-01-18;19275;45814;212358;1151;236989;42101816;39969576;20723088;60152;22459272
FR;1;2022-01-19;20243;43963;176047;896;197174;42122059;40013539;20899135;61048;22656446
FR;1;2022-01-20;16701;40504;183599;1138;204697;42138760;40054043;21082734;62186;22861143
FR;1;2022-01-21;19799;46987;228895;1406;253313;42158559;40101030;21311629;63592;23114456
FR;1;2022-01-22;13828;33350;144471;578;161368;42172387;40134380;21456100;64170;23275824
FR;1;2022-01-23;3347;8803;33405;130;38323;42175734;40143183;21489505;64300;23314147
FR;1;2022-01-24;11746;32908;142163;706;158248;42187480;40176091;21631668;65006;23472395
FR;1;2022-01-25;14109;38199;163346;1048;181534;42201589;40214290;21795014;66054;23653929
FR;1;2022-01-26;14846;37506;150208;931;166274;42216435;40251796;21945222;66985;23820203
FR;1;2022-01-27;12307;33046;143402;884;157891;42228742;40284842;22088624;67869;23978094
FR;1;2022-01-28;16254;54458;198257;1144;222441;42244996;40339300;22286881;69013;24200535
FR;1;2022-01-29;10261;35445;135178;522;151548;42255257;40374745;22422059;69535;24352083
FR;1;2022-01-30;2476;9290;29667;86;34459;42257733;40384035;22451726;69621;24386542
FR;1;2022-01-31;8734;32374;104310;530;117400;42266467;40416409;22556036;70151;24503942
FR;1;2022-02-01;10345;36323;127028;862;141235;42276812;40452732;22683064;71013;24645177
FR;1;2022-02-02;11569;41196;130311;780;145852;42288381;40493928;22813375;71793;24791029
FR;1;2022-02-03;8793;33525;116961;780;130357;42297174;40527453;22930336;72573;24921386
FR;1;2022-02-04;11430;48173;172528;965;192781;42308604;40575626;23102864;73538;25114167
FR;1;2022-02-05;7976;33918;117560;391;133060;42316580;40609544;23220424;73929;25247227
FR;1;2022-02-06;1690;8038;22734;85;26903;42318270;40617582;23243158;74014;25274130
FR;1;2022-02-07;7197;35458;119051;452;134976;42325467;40653040;23362209;74466;25409106
FR;1;2022-02-08;7595;31671;125607;694;140589;42333062;40684711;23487816;75160;25549695
FR;1;2022-02-09;8489;36288;135213;695;152437;42341551;40720999;23623029;75855;25702132
FR;1;2022-02-10;6602;29482;116308;674;130079;42348153;40750481;23739337;76529;25832211
FR;1;2022-02-11;8571;41407;165083;876;185298;42356724;40791888;23904420;77405;26017509
FR;1;2022-02-12;5299;27543;106676;378;120851;42362023;40819431;24011096;77783;26138360
FR;1;2022-02-13;1225;5703;21711;65;25323;42363248;40825134;24032807;77848;26163683
FR;1;2022-02-14;5388;27118;118040;388;133067;42368636;40852252;24150847;78236;26296750
FR;1;2022-02-15;5598;28249;118864;609;132475;42374234;40880501;24269711;78845;26429225
FR;1;2022-02-16;5668;28298;110382;595;122999;42379902;40908799;24380093;79440;26552224
FR;1;2022-02-17;4429;19475;73105;486;80191;42384331;40928274;24453198;79926;26632415
FR;1;2022-02-18;5539;26628;99158;670;108113;42389870;40954902;24552356;80596;26740528
FR;1;2022-02-19;3539;17129;59465;304;66042;42393409;40972031;24611821;80900;26806570
FR;1;2022-02-20;784;3231;10691;35;12314;42394193;40975262;24622512;80935;26818884
FR;1;2022-02-21;3365;14497;52799;286;57647;42397558;40989759;24675311;81221;26876531
FR;1;2022-02-22;3722;15419;51874;499;55603;42401280;41005178;24727185;81720;26932134
FR;1;2022-02-23;4165;17721;57453;508;62555;42405445;41022899;24784638;82228;26994689
FR;1;2022-02-24;3252;12892;43579;436;46366;42408697;41035791;24828217;82664;27041055
FR;1;2022-02-25;4408;19596;64851;695;68714;42413105;41055387;24893068;83359;27109769
FR;1;2022-02-26;2680;12779;41348;309;45101;42415785;41068166;24934416;83668;27154870
FR;1;2022-02-27;639;2170;7117;42;7982;42416424;41070336;24941533;83710;27162852
FR;1;2022-02-28;2567;10278;34927;303;37352;42418991;41080614;24976460;84013;27200204
FR;1;2022-03-01;2817;10430;38653;389;39578;42421808;41091044;25015113;84402;27239782
FR;1;2022-03-02;3505;11916;41817;390;43870;42425313;41102960;25056930;84792;27283652
FR;1;2022-03-03;2343;7625;26127;321;26443;42427656;41110585;25083057;85113;27310095
FR;1;2022-03-04;2659;10258;35395;576;34875;42430315;41120843;25118452;85689;27344970
FR;1;2022-03-05;1810;6297;21948;278;22334;42432125;41127140;25140400;85967;27367304
FR;1;2022-03-06;350;941;2914;38;3112;42432475;41128081;25143314;86005;27370416
FR;1;2022-03-07;1512;4593;16414;245;15873;42433987;41132674;25159728;86250;27386289
FR;1;2022-03-08;1566;5122;17136;307;15958;42435553;41137796;25176864;86557;27402247
FR;1;2022-03-09;1882;6519;19788;368;19137;42437435;41144315;25196652;86925;27421384
FR;1;2022-03-10;1309;4478;15227;306;14248;42438744;41148793;25211879;87231;27435632
FR;1;2022-03-11;1694;6174;21688;482;19835;42440438;41154967;25233567;87713;27455467
FR;1;2022-03-12;1227;4598;15353;276;14899;42441665;41159565;25248920;87989;27470366
FR;1;2022-03-13;241;605;2108;116;2056;42441906;41160170;25251028;88105;27472422
FR;1;2022-03-14;1079;3586;13371;3874;12495;42442985;41163756;25264399;91979;27484917
FR;1;2022-03-15;1263;3874;14538;6861;13017;42444248;41167630;25278937;98840;27497934
FR;1;2022-03-16;1613;4807;17357;11513;16409;42445861;41172437;25296294;110353;27514343
FR;1;2022-03-17;1099;3215;11683;9639;10778;42446960;41175652;25307977;119992;27525121
FR;1;2022-03-18;1670;4736;17924;16486;16357;42448630;41180388;25325901;136478;27541478
FR;1;2022-03-19;1118;3224;11885;8451;11352;42449748;41183612;25337786;144929;27552830
FR;1;2022-03-20;218;536;1719;1007;1752;42449966;41184148;25339505;145936;27554582
FR;1;2022-03-21;1040;2697;11474;13442;10821;42451006;41186845;25350979;159378;27565403
FR;1;2022-03-22;1192;3081;12225;18684;11213;42452198;41189926;25363204;178062;27576616
FR;1;2022-03-23;1468;4199;15984;20094;15665;42453666;41194125;25379188;198156;27592281
FR;1;2022-03-24;1070;2539;10362;16014;9613;42454736;41196664;25389550;214170;27601894
FR;1;2022-03-25;1501;4064;16693;25283;15336;42456237;41200728;25406243;239453;27617230
FR;1;2022-03-26;1098;2972;10841;11432;10498;42457335;41203700;25417084;250885;27627728
FR;1;2022-03-27;228;537;1738;1379;1790;42457563;41204237;25418822;252264;27629518
FR;1;2022-03-28;1036;2428;9949;15861;9570;42458599;41206665;25428771;268125;27639088
FR;1;2022-03-29;1114;2707;11528;25063;10894;42459713;41209372;25440299;293188;27649982
FR;1;2022-03-30;1597;3475;14129;24146;13663;42461310;41212847;25454428;317334;27663645
FR;1;2022-03-31;1269;2652;11657;22558;11162;42462579;41215499;25466085;339892;27674807
FR;1;2022-04-01;1682;3777;18409;28461;17256;42464261;41219276;25484494;368353;27692063
FR;1;2022-04-02;891;1859;8177;9208;7927;42465152;41221135;25492671;377561;27699990
FR;1;2022-04-03;190;368;1428;1056;1429;42465342;41221503;25494099;378617;27701419
FR;1;2022-04-04;1120;2211;11302;17634;10673;42466462;41223714;25505401;396251;27712092
FR;1;2022-04-05;1271;2512;12945;31107;11962;42467733;41226226;25518346;427358;27724054
FR;1;2022-04-06;1326;2741;12134;23782;11554;42469059;41228967;25530480;451140;27735608
FR;1;2022-04-07;1140;2531;12284;30970;11746;42470199;41231498;25542764;482110;27747354
FR;1;2022-04-08;1560;3472;17492;40436;16406;42471759;41234970;25560256;522546;27763760
FR;1;2022-04-09;808;1972;8387;12478;8080;42472567;41236942;25568643;535024;27771840
FR;1;2022-04-10;191;466;1825;1831;1859;42472758;41237408;25570468;536855;27773699
FR;1;2022-04-11;955;2113;10933;22123;10643;42473713;41239521;25581401;558978;27784342
FR;1;2022-04-12;1207;2391;12749;37865;12241;42474920;41241912;25594150;596843;27796583
FR;1;2022-04-13;1176;2627;12209;30368;11923;42476096;41244539;25606359;627211;27808506
FR;1;2022-04-14;1175;2315;12002;33327;12010;42477271;41246854;25618361;660538;27820516
FR;1;2022-04-15;1422;2791;14324;33032;13694;42478693;41249645;25632685;693570;27834210
FR;1;2022-04-16;653;1388;5822;7972;5742;42479346;41251033;25638507;701542;27839952
FR;1;2022-04-17;149;271;929;1110;971;42479495;41251304;25639436;702652;27840923
FR;1;2022-04-18;129;388;2620;988;2644;42479624;41251692;25642056;703640;27843567
FR;1;2022-04-19;1202;2498;11738;27741;11418;42480826;41254190;25653794;731381;27854985
FR;1;2022-04-20;1275;2530;12111;26737;11938;42482101;41256720;25665905;758118;27866923
FR;1;2022-04-21;1207;2354;11462;32949;11619;42483308;41259074;25677367;791067;27878542
FR;1;2022-04-22;1480;2952;15154;35352;14744;42484788;41262026;25692521;826419;27893286
FR;1;2022-04-23;748;1561;6716;9875;6622;42485536;41263587;25699237;836294;27899908
FR;1;2022-04-24;192;356;1370;1511;1322;42485728;41263943;25700607;837805;27901230
FR;1;2022-04-25;997;2052;9826;19575;9714;42486725;41265995;25710433;857380;27910944
FR;1;2022-04-26;1296;2575;12556;36375;12160;42488021;41268570;25722989;893755;27923104
FR;1;2022-04-27;1282;2355;10589;28866;10722;42489303;41270925;25733578;922621;27933826
FR;1;2022-04-28;1247;2290;11504;33871;11319;42490550;41273215;25745082;956492;27945145
FR;1;2022-04-29;1568;2912;14334;35238;13762;42492118;41276127;25759416;991730;27958907
FR;1;2022-04-30;810;1439;6418;9133;6264;42492928;41277566;25765834;1000863;27965171
FR;1;2022-05-01;157;271;813;918;809;42493085;41277837;25766647;1001781;27965980
FR;1;2022-05-02;932;1911;10260;16635;10140;42494017;41279748;25776907;1018416;27976120
FR;1;2022-05-03;1381;2562;12542;32575;12435;42495398;41282310;25789449;1050991;27988555
FR;1;2022-05-04;1283;2441;11100;23525;11242;42496681;41284751;25800549;1074516;27999797
FR;1;2022-05-05;1336;2350;11695;31373;11567;42498017;41287101;25812244;1105889;28011364
FR;1;2022-05-06;1669;3105;14114;34603;13661;42499686;41290206;25826358;1140492;28025025
FR;1;2022-05-07;833;1453;5940;9072;5973;42500519;41291659;25832298;1149564;28030998
FR;1;2022-05-08;185;319;1052;1454;1112;42500704;41291978;25833350;1151018;28032110
FR;1;2022-05-09;1017;1854;9187;19002;9093;42501721;41293832;25842537;1170020;28041203
FR;1;2022-05-10;1357;2500;12426;36717;12009;42503078;41296332;25854963;1206737;28053212
FR;1;2022-05-11;1373;2183;9799;25734;9700;42504451;41298515;25864762;1232471;28062912
FR;1;2022-05-12;1250;2220;10339;33121;9991;42505701;41300735;25875101;1265592;28072903
FR;1;2022-05-13;1565;2692;12650;35420;12291;42507266;41303427;25887751;1301012;28085194
FR;1;2022-05-14;762;1281;5439;10139;5312;42508028;41304708;25893190;1311151;28090506
FR;1;2022-05-15;206;365;1151;1341;1216;42508234;41305073;25894341;1312492;28091722
FR;1;2022-05-16;927;1667;7976;19825;8018;42509161;41306740;25902317;1332317;28099740
FR;1;2022-05-17;1237;2187;11034;35694;10635;42510398;41308927;25913351;1368011;28110375
FR;1;2022-05-18;1240;2005;8885;25471;8841;42511638;41310932;25922236;1393482;28119216
FR;1;2022-05-19;1148;2267;9715;33403;9753;42512786;41313199;25931951;1426885;28128969
FR;1;2022-05-20;1526;2631;12262;37353;11852;42514312;41315830;25944213;1464238;28140821
FR;1;2022-05-21;756;1338;5216;9284;5125;42515068;41317168;25949429;1473522;28145946
FR;1;2022-05-22;180;276;934;1357;935;42515248;41317444;25950363;1474879;28146881
FR;1;2022-05-23;912;1744;8277;19054;8198;42516160;41319188;25958640;1493933;28155079
FR;1;2022-05-24;1241;2371;10578;36543;10408;42517401;41321559;25969218;1530476;28165487
FR;1;2022-05-25;1228;2200;8662;23385;8792;42518629;41323759;25977880;1553861;28174279
FR;1;2022-05-26;142;277;1429;1086;1425;42518771;41324036;25979309;1554947;28175704
FR;1;2022-05-27;1061;2045;8305;20313;8079;42519832;41326081;25987614;1575260;28183783
FR;1;2022-05-28;469;1023;3571;6509;3628;42520301;41327104;25991185;1581769;28187411
FR;1;2022-05-29;108;245;696;882;702;42520409;41327349;25991881;1582651;28188113
FR;1;2022-05-30;778;1663;6437;18275;6431;42521187;41329012;25998318;1600926;28194544
FR;1;2022-05-31;1225;2092;9072;34020;8962;42522412;41331104;26007390;1634946;28203506
FR;1;2022-06-01;1122;2133;8662;22879;8490;42523534;41333237;26016052;1657825;28211996
FR;1;2022-06-02;1126;2127;9199;33613;8802;42524660;41335364;26025251;1691438;28220798
FR;1;2022-06-03;1317;2571;10833;36808;10395;42525977;41337935;26036084;1728246;28231193
FR;1;2022-06-04;644;1222;4203;8538;4292;42526621;41339157;26040287;1736784;28235485
FR;1;2022-06-05;110;264;756;1001;775;42526731;41339421;26041043;1737785;28236260
FR;1;2022-06-06;120;279;1195;1100;1192;42526851;41339700;26042238;1738885;28237452
FR;1;2022-06-07;1066;2139;8677;33684;8346;42527917;41341839;26050915;1772569;28245798
FR;1;2022-06-08;1040;2080;7680;27112;7543;42528957;41343919;26058595;1799681;28253341
FR;1;2022-06-09;1011;1985;8262;36938;7944;42529968;41345904;26066857;1836619;28261285
FR;1;2022-06-10;1246;2363;10249;42492;9877;42531214;41348267;26077106;1879111;28271162
FR;1;2022-06-11;610;1376;4555;10980;4605;42531824;41349643;26081661;1890091;28275767
FR;1;2022-06-12;130;334;919;1637;972;42531954;41349977;26082580;1891728;28276739
FR;1;2022-06-13;844;1609;5737;21796;5630;42532798;41351586;26088317;1913524;28282369
FR;1;2022-06-14;1005;1982;8682;42081;8114;42533803;41353568;26096999;1955605;28290483
FR;1;2022-06-15;982;1733;6989;28571;6790;42534785;41355301;26103988;1984176;28297273
FR;1;2022-06-16;873;1624;7560;37270;7098;42535658;41356925;26111548;2021446;28304371
FR;1;2022-06-17;1100;2290;9483;43550;8982;42536758;41359215;26121031;2064996;28313353
FR;1;2022-06-18;497;1135;3823;10141;3782;42537255;41360350;26124854;2075137;28317135
FR;1;2022-06-19;113;260;806;1378;876;42537368;41360610;26125660;2076515;28318011
FR;2;2020-12-27;0;0;0;0;0;0;0;0;0;0
FR;2;2020-12-28;0;0;0;0;0;0;0;0;0;0
FR;2;2020-12-29;0;0;0;0;0;0;0;0;0;0
FR;2;2020-12-30;0;0;0;0;0;0;0;0;0;0
FR;2;2020-12-31;0;0;0;0;0;0;0;0;0;0
FR;2;2021-01-01;0;0;0;0;0;0;0;0;0;0
FR;2;2021-01-02;0;0;0;0;0;0;0;0;0;0
FR;2;2021-01-03;0;0;0;0;0;0;0;0;0;0
FR;2;2021-01-04;0;0;0;0;0;0;0;0;0;0
FR;2;2021-01-05;0;0;0;0;0;0;0;0;0;0
FR;2;2021-01-06;0;0;0;0;0;0;0;0;0;0
FR;2;2021-01-07;0;0;0;0;0;0;0;0;0;0
FR;2;2021-01-08;0;0;0;0;0;0;0;0;0;0
FR;2;2021-01-09;0;0;0;0;0;0;0;0;0;0
FR;2;2021-01-10;0;0;0;0;0;0;0;0;0;0
FR;2;2021-01-11;0;0;0;0;0;0;0;0;0;0
FR;2;2021-01-12;0;0;0;0;0;0;0;0;0;0
FR;2;2021-01-13;0;0;0;0;0;0;0;0;0;0
FR;2;2021-01-14;1682;0;0;0;0;1682;0;0;0;0
FR;2;2021-01-15;396;0;0;0;0;2078;0;0;0;0
FR;2;2021-01-16;315;0;0;0;0;2393;0;0;0;0
FR;2;2021-01-17;81;0;0;0;0;2474;0;0;0;0
FR;2;2021-01-18;3074;2;0;0;0;5548;2;0;0;0
FR;2;2021-01-19;4678;0;0;0;0;10226;2;0;0;0
FR;2;2021-01-20;5135;4;0;0;0;15361;6;0;0;0
FR;2;2021-01-21;5338;9;0;0;0;20699;15;0;0;0
FR;2;2021-01-22;5115;9;0;0;0;25814;24;0;0;0
FR;2;2021-01-23;1866;0;0;0;0;27680;24;0;0;0
FR;2;2021-01-24;160;1;0;0;0;27840;25;0;0;0
FR;2;2021-01-25;3811;3;0;0;0;31651;28;0;0;0
FR;2;2021-01-26;3919;2;0;0;0;35570;30;0;0;0
FR;2;2021-01-27;3598;2;0;0;0;39168;32;0;0;0
FR;2;2021-01-28;3748;7;0;0;0;42916;39;0;0;0
FR;2;2021-01-29;3293;2;0;0;0;46209;41;0;0;0
FR;2;2021-01-30;1130;1;0;0;0;47339;42;0;0;0
FR;2;2021-01-31;45;1;0;0;0;47384;43;0;0;0
FR;2;2021-02-01;3400;4;0;0;0;50784;47;0;0;0
FR;2;2021-02-02;4490;10;0;0;0;55274;57;0;0;0
FR;2;2021-02-03;5219;6;0;0;0;60493;63;0;0;0
FR;2;2021-02-04;4931;10;0;0;0;65424;73;0;0;0
FR;2;2021-02-05;4810;13;0;0;0;70234;86;0;0;0
FR;2;2021-02-06;2040;13;0;0;0;72274;99;0;0;0
FR;2;2021-02-07;101;4;0;0;0;72375;103;0;0;0
FR;2;2021-02-08;7553;22;0;0;0;79928;125;0;0;0
FR;2;2021-02-09;8421;28;0;0;0;88349;153;0;0;0
FR;2;2021-02-10;9338;59;0;0;0;97687;212;0;0;0
FR;2;2021-02-11;10280;100;0;0;0;107967;312;0;0;0
FR;2;2021-02-12;10055;263;0;0;0;118022;575;0;0;0
FR;2;2021-02-13;3119;226;0;0;0;121141;801;0;0;0
FR;2;2021-02-14;355;9;0;0;0;121496;810;0;0;0
FR;2;2021-02-15;3456;3100;0;0;0;124952;3910;0;0;0
FR;2;2021-02-16;5067;4036;0;0;0;130019;7946;0;0;0
FR;2;2021-02-17;4254;4476;0;0;0;134273;12422;0;0;0
FR;2;2021-02-18;5400;5120;0;0;0;139673;17542;0;0;0
FR;2;2021-02-19;5324;4406;0;0;0;144997;21948;0;0;0
FR;2;2021-02-20;1869;1508;0;0;0;146866;23456;0;0;0
FR;2;2021-02-21;242;88;0;0;0;147108;23544;0;0;0
FR;2;2021-02-22;3612;3752;0;0;0;150720;27296;0;0;0
FR;2;2021-02-23;4953;3696;0;0;0;155673;30992;0;0;0
FR;2;2021-02-24;5010;3496;0;0;0;160683;34488;0;0;0
FR;2;2021-02-25;5483;3456;0;0;0;166166;37944;0;0;0
FR;2;2021-02-26;4361;3149;0;0;0;170527;41093;0;0;0
FR;2;2021-02-27;1623;1052;0;0;0;172150;42145;0;0;0
FR;2;2021-02-28;177;30;0;0;0;172327;42175;0;0;0
FR;2;2021-03-01;5179;3725;0;0;0;177506;45900;0;0;0
FR;2;2021-03-02;6528;4732;0;0;0;184034;50632;0;0;0
FR;2;2021-03-03;6535;4925;0;0;0;190569;55557;0;0;0
FR;2;2021-03-04;8403;4071;0;0;0;198972;59628;0;0;0
FR;2;2021-03-05;8028;4063;0;0;0;207000;63691;0;0;0
FR;2;2021-03-06;4785;1685;0;0;0;211785;65376;0;0;0
FR;2;2021-03-07;2372;30;0;0;0;214157;65406;0;0;0
FR;2;2021-03-08;4165;8333;0;0;0;218322;73739;0;0;0
FR;2;2021-03-09;7488;8504;1;0;0;225810;82243;1;0;0
FR;2;2021-03-10;7100;9144;0;0;0;232910;91387;1;0;0
FR;2;2021-03-11;9373;9244;1;0;0;242283;100631;2;0;0
FR;2;2021-03-12;7972;8235;0;0;0;250255;108866;2;0;0
FR;2;2021-03-13;10046;2563;0;0;0;260301;111429;2;0;0
FR;2;2021-03-14;4838;403;0;0;0;265139;111832;2;0;0
FR;2;2021-03-15;10908;3488;0;0;0;276047;115320;2;0;0
FR;2;2021-03-16;16762;4647;1;0;0;292809;119967;3;0;0
FR;2;2021-03-17;20227;3976;0;0;0;313036;123943;3;0;0
FR;2;2021-03-18;23365;5004;0;0;0;336401;128947;3;0;0
FR;2;2021-03-19;23303;4588;0;0;0;359704;133535;3;0;0
FR;2;2021-03-20;25445;1550;0;0;0;385149;135085;3;0;0
FR;2;2021-03-21;17671;151;0;0;0;402820;135236;3;0;0
FR;2;2021-03-22;17782;3147;0;0;0;420602;138383;3;0;0
FR;2;2021-03-23;22687;4209;0;0;0;443289;142592;3;0;0
FR;2;2021-03-24;23955;5010;0;0;0;467244;147602;3;0;0
FR;2;2021-03-25;26741;5141;1;0;0;493985;152743;4;0;0
FR;2;2021-03-26;26978;4236;0;0;0;520963;156979;4;0;0
FR;2;2021-03-27;15918;1331;0;0;0;536881;158310;4;0;0
FR;2;2021-03-28;10561;122;0;0;0;547442;158432;4;0;0
FR;2;2021-03-29;18989;4292;0;0;0;566431;162724;4;0;0
FR;2;2021-03-30;24577;6032;0;0;0;591008;168756;4;0;0
FR;2;2021-03-31;28553;5930;0;0;0;619561;174686;4;0;0
FR;2;2021-04-01;34544;8514;1;0;0;654105;183200;5;0;0
FR;2;2021-04-02;29976;7667;0;0;0;684081;190867;5;0;0
FR;2;2021-04-03;16953;3828;0;0;0;701034;194695;5;0;0
FR;2;2021-04-04;9305;1038;2;0;0;710339;195733;7;0;0
FR;2;2021-04-05;12444;804;0;0;0;722783;196537;7;0;0
FR;2;2021-04-06;27145;7049;0;0;0;749928;203586;7;0;0
FR;2;2021-04-07;30927;7139;1;0;0;780855;210725;8;0;0
FR;2;2021-04-08;36881;8715;1;0;0;817736;219440;9;0;0
FR;2;2021-04-09;33835;8523;28;0;0;851571;227963;37;0;0
FR;2;2021-04-10;19678;9052;1;0;0;871249;237015;38;0;0
FR;2;2021-04-11;7942;4253;1;0;0;879191;241268;39;0;0
FR;2;2021-04-12;17121;11127;0;0;0;896312;252395;39;0;0
FR;2;2021-04-13;19449;16179;1;0;0;915761;268574;40;0;0
FR;2;2021-04-14;18060;16320;7;0;0;933821;284894;47;0;0
FR;2;2021-04-15;22189;21032;27;0;0;956010;305926;74;0;0
FR;2;2021-04-16;20705;20185;45;0;0;976715;326111;119;0;0
FR;2;2021-04-17;13253;22436;5;0;0;989968;348547;124;0;0
FR;2;2021-04-18;5907;14392;6;0;0;995875;362939;130;0;0
FR;2;2021-04-19;16833;16276;24;0;0;1012708;379215;154;0;0
FR;2;2021-04-20;19318;21597;38;0;0;1032026;400812;192;0;0
FR;2;2021-04-21;20282;21720;76;0;0;1052308;422532;268;0;0
FR;2;2021-04-22;23813;24875;41;0;0;1076121;447407;309;0;0
FR;2;2021-04-23;24520;25358;76;0;0;1100641;472765;385;0;0
FR;2;2021-04-24;25301;15081;104;0;0;1125942;487846;489;0;0
FR;2;2021-04-25;9594;8603;5;0;0;1135536;496449;494;0;0
FR;2;2021-04-26;17158;17274;21;0;0;1152694;513723;515;0;0
FR;2;2021-04-27;19240;24217;40;0;0;1171934;537940;555;0;0
FR;2;2021-04-28;22333;26230;112;0;0;1194267;564170;667;0;0
FR;2;2021-04-29;25466;30182;69;0;0;1219733;594352;736;0;0
FR;2;2021-04-30;25529;27753;49;1;0;1245262;622105;785;1;0
FR;2;2021-05-01;14983;9872;6;0;0;1260245;631977;791;1;0
FR;2;2021-05-02;6635;9174;2;0;0;1266880;641151;793;1;0
FR;2;2021-05-03;20012;19231;40;0;0;1286892;660382;833;1;0
FR;2;2021-05-04;18281;29068;33;0;0;1305173;689450;866;1;0
FR;2;2021-05-05;18363;29410;48;0;0;1323536;718860;914;1;0
FR;2;2021-05-06;23541;35262;131;0;0;1347077;754122;1045;1;0
FR;2;2021-05-07;25324;33200;97;0;0;1372401;787322;1142;1;0
FR;2;2021-05-08;21337;9895;14;0;0;1393738;797217;1156;1;0
FR;2;2021-05-09;13162;7820;7;0;0;1406900;805037;1163;1;0
FR;2;2021-05-10;32938;22094;49;0;0;1439838;827131;1212;1;0
FR;2;2021-05-11;43597;21016;101;0;0;1483435;848147;1313;1;0
FR;2;2021-05-12;50041;19811;143;0;0;1533476;867958;1456;1;0
FR;2;2021-05-13;51292;5731;31;0;0;1584768;873689;1487;1;0
FR;2;2021-05-14;61345;12911;132;0;0;1646113;886600;1619;1;0
FR;2;2021-05-15;65927;7136;39;0;0;1712040;893736;1658;1;0
FR;2;2021-05-16;43581;2569;10;0;0;1755621;896305;1668;1;0
FR;2;2021-05-17;44742;12565;114;0;0;1800363;908870;1782;1;0
FR;2;2021-05-18;54637;12236;191;0;0;1855000;921106;1973;1;0
FR;2;2021-05-19;57164;10588;281;0;0;1912164;931694;2254;1;0
FR;2;2021-05-20;63433;10838;288;0;0;1975597;942532;2542;1;0
FR;2;2021-05-21;64289;11643;230;0;0;2039886;954175;2772;1;0
FR;2;2021-05-22;61479;4509;65;0;0;2101365;958684;2837;1;0
FR;2;2021-05-23;37531;571;22;0;0;2138896;959255;2859;1;0
FR;2;2021-05-24;17236;2037;34;0;0;2156132;961292;2893;1;0
FR;2;2021-05-25;21105;12221;240;0;0;2177237;973513;3133;1;0
FR;2;2021-05-26;19933;11462;229;0;0;2197170;984975;3362;1;0
FR;2;2021-05-27;22994;12658;182;0;0;2220164;997633;3544;1;0
FR;2;2021-05-28;29389;14950;190;0;0;2249553;1012583;3734;1;0
FR;2;2021-05-29;30418;8181;57;0;0;2279971;1020764;3791;1;0
FR;2;2021-05-30;4646;1818;6;0;0;2284617;1022582;3797;1;0
FR;2;2021-05-31;28587;18712;184;0;0;2313204;1041294;3981;1;0
FR;2;2021-06-01;45712;19991;224;0;0;2358916;1061285;4205;1;0
FR;2;2021-06-02;37466;19284;182;0;0;2396382;1080569;4387;1;0
FR;2;2021-06-03;51271;23307;161;0;0;2447653;1103876;4548;1;0
FR;2;2021-06-04;65509;24052;215;0;0;2513162;1127928;4763;1;0
FR;2;2021-06-05;34598;24037;51;0;0;2547760;1151965;4814;1;0
FR;2;2021-06-06;4953;6200;10;0;0;2552713;1158165;4824;1;0
FR;2;2021-06-07;28169;23037;146;0;0;2580882;1181202;4970;1;0
FR;2;2021-06-08;46369;22910;143;0;0;2627251;1204112;5113;1;0
FR;2;2021-06-09;34286;20911;107;0;0;2661537;1225023;5220;1;0
FR;2;2021-06-10;42637;19133;95;1;0;2704174;1244156;5315;2;0
FR;2;2021-06-11;55290;25215;134;0;0;2759464;1269371;5449;2;0
FR;2;2021-06-12;30559;19773;53;0;0;2790023;1289144;5502;2;0
FR;2;2021-06-13;3329;9186;13;0;0;2793352;1298330;5515;2;0
FR;2;2021-06-14;25296;24158;92;0;0;2818648;1322488;5607;2;0
FR;2;2021-06-15;39036;22838;154;0;0;2857684;1345326;5761;2;0
FR;2;2021-06-16;30160;21435;134;0;0;2887844;1366761;5895;2;0
FR;2;2021-06-17;36906;25852;150;0;0;2924750;1392613;6045;2;0
FR;2;2021-06-18;46849;28826;122;0;0;2971599;1421439;6167;2;0
FR;2;2021-06-19;24525;24893;39;0;0;2996124;1446332;6206;2;0
FR;2;2021-06-20;3740;10062;10;0;0;2999864;1456394;6216;2;0
FR;2;2021-06-21;17522;42847;87;0;0;3017386;1499241;6303;2;0
FR;2;2021-06-22;28358;49563;110;0;0;3045744;1548804;6413;2;0
FR;2;2021-06-23;21788;49564;107;1;1;3067532;1598368;6520;3;1
FR;2;2021-06-24;28375;50280;133;0;0;3095907;1648648;6653;3;1
FR;2;2021-06-25;33399;60402;127;0;0;3129306;1709050;6780;3;1
FR;2;2021-06-26;16379;59249;54;1;0;3145685;1768299;6834;4;1
FR;2;2021-06-27;2564;29317;22;1;0;3148249;1797616;6856;5;1
FR;2;2021-06-28;12637;54341;83;0;0;3160886;1851957;6939;5;1
FR;2;2021-06-29;19842;59889;178;0;0;3180728;1911846;7117;5;1
FR;2;2021-06-30;16323;57896;252;17;0;3197051;1969742;7369;22;1
FR;2;2021-07-01;20485;59896;227;0;0;3217536;2029638;7596;22;1
FR;2;2021-07-02;24071;62145;184;0;0;3241607;2091783;7780;22;1
FR;2;2021-07-03;12112;57078;153;0;0;3253719;2148861;7933;22;1
FR;2;2021-07-04;1957;23309;18;0;0;3255676;2172170;7951;22;1
FR;2;2021-07-05;9167;29367;106;0;0;3264843;2201537;8057;22;1
FR;2;2021-07-06;14577;36207;135;0;0;3279420;2237744;8192;22;1
FR;2;2021-07-07;14404;33674;139;0;0;3293824;2271418;8331;22;1
FR;2;2021-07-08;19714;40304;162;0;0;3313538;2311722;8493;22;1
FR;2;2021-07-09;27095;54283;202;1;0;3340633;2366005;8695;23;1
FR;2;2021-07-10;13385;33669;107;0;0;3354018;2399674;8802;23;1
FR;2;2021-07-11;1807;4350;16;0;0;3355825;2404024;8818;23;1
FR;2;2021-07-12;12964;37276;119;0;0;3368789;2441300;8937;23;1
FR;2;2021-07-13;37110;53208;150;0;0;3405899;2494508;9087;23;1
FR;2;2021-07-14;6610;3558;15;0;0;3412509;2498066;9102;23;1
FR;2;2021-07-15;47234;47021;156;0;0;3459743;2545087;9258;23;1
FR;2;2021-07-16;64306;55806;187;0;0;3524049;2600893;9445;23;1
FR;2;2021-07-17;31593;23930;96;0;0;3555642;2624823;9541;23;1
FR;2;2021-07-18;6086;4875;19;0;0;3561728;2629698;9560;23;1
FR;2;2021-07-19;32990;28679;94;0;0;3594718;2658377;9654;23;1
FR;2;2021-07-20;51988;44558;155;0;0;3646706;2702935;9809;23;1
FR;2;2021-07-21;45245;34749;93;0;0;3691951;2737684;9902;23;1
FR;2;2021-07-22;56273;41092;128;1;0;3748224;2778776;10030;24;1
FR;2;2021-07-23;68277;49072;170;0;0;3816501;2827848;10200;24;1
FR;2;2021-07-24;36169;21599;82;0;0;3852670;2849447;10282;24;1
FR;2;2021-07-25;6744;2644;10;0;0;3859414;2852091;10292;24;1
FR;2;2021-07-26;36299;22445;91;1;0;3895713;2874536;10383;25;1
FR;2;2021-07-27;62363;34608;180;0;0;3958076;2909144;10563;25;1
FR;2;2021-07-28;55303;26451;132;0;0;4013379;2935595;10695;25;1
FR;2;2021-07-29;68461;32792;189;0;0;4081840;2968387;10884;25;1
FR;2;2021-07-30;74439;37772;222;1;1;4156279;3006159;11106;26;2
FR;2;2021-07-31;34754;16191;104;0;0;4191033;3022350;11210;26;2
FR;2;2021-08-01;5403;2275;19;0;0;4196436;3024625;11229;26;2
FR;2;2021-08-02;35867;16201;101;0;0;4232303;3040826;11330;26;2
FR;2;2021-08-03;55970;28293;142;0;0;4288273;3069119;11472;26;2
FR;2;2021-08-04;46624;20858;128;1;0;4334897;3089977;11600;27;2
FR;2;2021-08-05;54622;31588;215;0;0;4389519;3121565;11815;27;2
FR;2;2021-08-06;58084;42384;242;1;0;4447603;3163949;12057;28;2
FR;2;2021-08-07;25142;17604;89;0;0;4472745;3181553;12146;28;2
FR;2;2021-08-08;3833;3667;21;0;0;4476578;3185220;12167;28;2
FR;2;2021-08-09;29303;21129;92;0;0;4505881;3206349;12259;28;2
FR;2;2021-08-10;44990;33516;154;0;0;4550871;3239865;12413;28;2
FR;2;2021-08-11;35267;25173;151;0;0;4586138;3265038;12564;28;2
FR;2;2021-08-12;41896;35734;162;0;0;4628034;3300772;12726;28;2
FR;2;2021-08-13;42587;37094;218;0;0;4670621;3337866;12944;28;2
FR;2;2021-08-14;18510;22240;93;0;0;4689131;3360106;13037;28;2
FR;2;2021-08-15;3826;3811;17;0;0;4692957;3363917;13054;28;2
FR;2;2021-08-16;25079;27195;110;0;0;4718036;3391112;13164;28;2
FR;2;2021-08-17;38252;43483;205;2;0;4756288;3434595;13369;30;2
FR;2;2021-08-18;32247;36366;195;1;1;4788535;3470961;13564;31;3
FR;2;2021-08-19;37430;46579;224;0;0;4825965;3517540;13788;31;3
FR;2;2021-08-20;40559;55608;269;1;0;4866524;3573148;14057;32;3
FR;2;2021-08-21;18118;24313;115;0;0;4884642;3597461;14172;32;3
FR;2;2021-08-22;2905;4322;22;1;1;4887547;3601783;14194;33;4
FR;2;2021-08-23;19242;35157;131;1;0;4906789;3636940;14325;34;4
FR;2;2021-08-24;31940;56031;235;0;0;4938729;3692971;14560;34;4
FR;2;2021-08-25;25926;43429;250;0;0;4964655;3736400;14810;34;4
FR;2;2021-08-26;32352;55800;387;0;0;4997007;3792200;15197;34;4
FR;2;2021-08-27;36996;65599;478;2;0;5034003;3857799;15675;36;4
FR;2;2021-08-28;17815;28497;300;0;0;5051818;3886296;15975;36;4
FR;2;2021-08-29;2654;5032;47;0;0;5054472;3891328;16022;36;4
FR;2;2021-08-30;18413;37747;399;0;756;5072885;3929075;16421;36;760
FR;2;2021-08-31;28075;57495;886;4;1545;5100960;3986570;17307;40;2305
FR;2;2021-09-01;21591;39846;1308;0;2096;5122551;4026416;18615;40;4401
FR;2;2021-09-02;25481;48619;1962;2;3300;5148032;4075035;20577;42;7701
FR;2;2021-09-03;33405;64492;2988;3;4833;5181437;4139527;23565;45;12534
FR;2;2021-09-04;16828;27707;1442;1;2360;5198265;4167234;25007;46;14894
FR;2;2021-09-05;2262;3609;265;0;411;5200527;4170843;25272;46;15305
FR;2;2021-09-06;14038;28725;1769;1;2930;5214565;4199568;27041;47;18235
FR;2;2021-09-07;21103;41061;3020;13;4864;5235668;4240629;30061;60;23099
FR;2;2021-09-08;17242;31935;2732;6;4469;5252910;4272564;32793;66;27568
FR;2;2021-09-09;20975;40432;4432;3;6757;5273885;4312996;37225;69;34325
FR;2;2021-09-10;28198;51163;5282;4;8830;5302083;4364159;42507;73;43155
FR;2;2021-09-11;13653;22373;2404;5;3946;5315736;4386532;44911;78;47101
FR;2;2021-09-12;1822;2788;285;0;506;5317558;4389320;45196;78;47607
FR;2;2021-09-13;11656;21443;2470;4;4012;5329214;4410763;47666;82;51619
FR;2;2021-09-14;18570;32773;5084;13;9050;5347784;4443536;52750;95;60669
FR;2;2021-09-15;14911;28288;5164;3;7781;5362695;4471824;57914;98;68450
FR;2;2021-09-16;16074;32762;6735;14;10525;5378769;4504586;64649;112;78975
FR;2;2021-09-17;20911;47096;8778;10;14583;5399680;4551682;73427;122;93558
FR;2;2021-09-18;9855;20920;3805;6;6022;5409535;4572602;77232;128;99580
FR;2;2021-09-19;1164;2647;396;0;645;5410699;4575249;77628;128;100225
FR;2;2021-09-20;7492;18777;3851;7;6154;5418191;4594026;81479;135;106379
FR;2;2021-09-21;11208;30005;6494;5;10740;5429399;4624031;87973;140;117119
FR;2;2021-09-22;9406;23541;5491;7;8514;5438805;4647572;93464;147;125633
FR;2;2021-09-23;10723;28880;7879;9;12632;5449528;4676452;101343;156;138265
FR;2;2021-09-24;15067;42876;10874;18;17203;5464595;4719328;112217;174;155468
FR;2;2021-09-25;7257;18750;3963;10;6087;5471852;4738078;116180;184;161555
FR;2;2021-09-26;1079;2557;494;0;631;5472931;4740635;116674;184;162186
FR;2;2021-09-27;6313;16446;4286;8;6550;5479244;4757081;120960;192;168736
FR;2;2021-09-28;9238;25558;7768;13;12075;5488482;4782639;128728;205;180811
FR;2;2021-09-29;8080;20204;6066;25;9261;5496562;4802843;134794;230;190072
FR;2;2021-09-30;9863;25800;9503;16;14082;5506425;4828643;144297;246;204154
FR;2;2021-10-01;13968;35647;12914;25;19239;5520393;4864290;157211;271;223393
FR;2;2021-10-02;6874;15883;4845;6;7009;5527267;4880173;162056;277;230402
FR;2;2021-10-03;841;1932;492;1;511;5528108;4882105;162548;278;230913
FR;2;2021-10-04;5819;13930;5516;5;7863;5533927;4896035;168064;283;238776
FR;2;2021-10-05;9052;22544;11120;19;15715;5542979;4918579;179184;302;254491
FR;2;2021-10-06;7783;17738;8240;11;11070;5550762;4936317;187424;313;265561
FR;2;2021-10-07;9194;22185;12380;15;16843;5559956;4958502;199804;328;282404
FR;2;2021-10-08;13425;32056;17346;27;23539;5573381;4990558;217150;355;305943
FR;2;2021-10-09;5998;12833;6041;6;7884;5579379;5003391;223191;361;313827
FR;2;2021-10-10;884;1634;436;2;631;5580263;5005025;223627;363;314458
FR;2;2021-10-11;5605;11586;6454;17;8828;5585868;5016611;230081;380;323286
FR;2;2021-10-12;8033;17761;12538;13;16735;5593901;5034372;242619;393;340021
FR;2;2021-10-13;6944;14842;10245;12;13605;5600845;5049214;252864;405;353626
FR;2;2021-10-14;8310;17943;14990;13;19448;5609155;5067157;267854;418;373074
FR;2;2021-10-15;11847;26278;20902;26;27948;5621002;5093435;288756;444;401022
FR;2;2021-10-16;5139;8728;1818;0;3208;5626141;5102163;290574;444;404230
FR;2;2021-10-17;651;1182;184;0;372;5626792;5103345;290758;444;404602
FR;2;2021-10-18;4559;7413;661;2;1668;5631351;5110758;291419;446;406270
FR;2;2021-10-19;6235;9886;729;5;2049;5637586;5120644;292148;451;408319
FR;2;2021-10-20;5163;8094;756;3;1686;5642749;5128738;292904;454;410005
FR;2;2021-10-21;6089;9971;779;5;2104;5648838;5138709;293683;459;412109
FR;2;2021-10-22;8448;14581;1148;4;2878;5657286;5153290;294831;463;414987
FR;2;2021-10-23;3840;6000;585;0;1234;5661126;5159290;295416;463;416221
FR;2;2021-10-24;494;886;100;0;203;5661620;5160176;295516;463;416424
FR;2;2021-10-25;3357;5368;304;1;826;5664977;5165544;295820;464;417250
FR;2;2021-10-26;4175;7260;1126;4;2006;5669152;5172804;296946;468;419256
FR;2;2021-10-27;3673;6630;1193;5;1998;5672825;5179434;298139;473;421254
FR;2;2021-10-28;4596;7696;1728;3;2746;5677421;5187130;299867;476;424000
FR;2;2021-10-29;5408;11073;2434;4;3670;5682829;5198203;302301;480;427670
FR;2;2021-10-30;2748;4437;973;1;1427;5685577;5202640;303274;481;429097
FR;2;2021-10-31;364;534;139;1;188;5685941;5203174;303413;482;429285
FR;2;2021-11-01;423;554;176;0;268;5686364;5203728;303589;482;429553
FR;2;2021-11-02;3288;6757;1180;0;1758;5689652;5210485;304769;482;431311
FR;2;2021-11-03;3339;6250;1383;2;1966;5692991;5216735;306152;484;433277
FR;2;2021-11-04;3984;7097;1762;4;2490;5696975;5223832;307914;488;435767
FR;2;2021-11-05;5227;10510;2864;5;3943;5702202;5234342;310778;493;439710
FR;2;2021-11-06;2594;4673;1399;0;1811;5704796;5239015;312177;493;441521
FR;2;2021-11-07;507;863;218;0;287;5705303;5239878;312395;493;441808
FR;2;2021-11-08;2578;5361;1201;3;1676;5707881;5245239;313596;496;443484
FR;2;2021-11-09;2750;6944;2395;6;3177;5710631;5252183;315991;502;446661
FR;2;2021-11-10;2587;5707;5095;6;6275;5713218;5257890;321086;508;452936
FR;2;2021-11-11;438;747;732;2;913;5713656;5258637;321818;510;453849
FR;2;2021-11-12;2951;8113;8965;8;10904;5716607;5266750;330783;518;464753
FR;2;2021-11-13;1534;3386;3865;7;4531;5718141;5270136;334648;525;469284
FR;2;2021-11-14;254;600;349;1;486;5718395;5270736;334997;526;469770
FR;2;2021-11-15;1622;3686;4436;9;5321;5720017;5274422;339433;535;475091
FR;2;2021-11-16;2184;5949;8297;14;10078;5722201;5280371;347730;549;485169
FR;2;2021-11-17;1739;4551;6620;8;7832;5723940;5284922;354350;557;493001
FR;2;2021-11-18;2190;5948;9173;11;11001;5726130;5290870;363523;568;504002
FR;2;2021-11-19;2697;7802;12960;19;15468;5728827;5298672;376483;587;519470
FR;2;2021-11-20;1563;3339;5173;5;6081;5730390;5302011;381656;592;525551
FR;2;2021-11-21;246;519;540;0;662;5730636;5302530;382196;592;526213
FR;2;2021-11-22;1275;2622;4470;5;5401;5731911;5305152;386666;597;531614
FR;2;2021-11-23;1614;4307;8188;9;9895;5733525;5309459;394854;606;541509
FR;2;2021-11-24;1418;3785;7464;14;8721;5734943;5313244;402318;620;550230
FR;2;2021-11-25;1812;4894;11451;21;13650;5736755;5318138;413769;641;563880
FR;2;2021-11-26;2539;7781;22657;31;26069;5739294;5325919;436426;672;589949
FR;2;2021-11-27;1496;4141;12258;18;14001;5740790;5330060;448684;690;603950
FR;2;2021-11-28;291;845;1967;3;2295;5741081;5330905;450651;693;606245
FR;2;2021-11-29;1443;4382;15074;23;17244;5742524;5335287;465725;716;623489
FR;2;2021-11-30;1911;6750;26221;36;29979;5744435;5342037;491946;752;653468
FR;2;2021-12-01;1908;6086;26186;29;29507;5746343;5348123;518132;781;682975
FR;2;2021-12-02;1908;6825;37686;52;41930;5748251;5354948;555818;833;724905
FR;2;2021-12-03;2552;10107;53591;112;59315;5750803;5365055;609409;945;784220
FR;2;2021-12-04;1849;6301;37093;38;40770;5752652;5371356;646502;983;824990
FR;2;2021-12-05;458;2263;14252;14;15988;5753110;5373619;660754;997;840978
FR;2;2021-12-06;2469;9893;77684;109;84732;5755579;5383512;738438;1106;925710
FR;2;2021-12-07;3447;15331;122413;238;133704;5759026;5398843;860851;1344;1059414
FR;2;2021-12-08;3718;16058;133178;330;145383;5762744;5414901;994029;1674;1204797
FR;2;2021-12-09;4544;19638;170152;554;185520;5767288;5434539;1164181;2228;1390317
FR;2;2021-12-10;4671;22814;188614;490;206050;5771959;5457353;1352795;2718;1596367
FR;2;2021-12-11;3681;16624;132427;239;144860;5775640;5473977;1485222;2957;1741227
FR;2;2021-12-12;1256;7129;59082;83;65132;5776896;5481106;1544304;3040;1806359
FR;2;2021-12-13;5525;26866;220658;605;242946;5782421;5507972;1764962;3645;2049305
FR;2;2021-12-14;7017;37530;300719;910;332190;5789438;5545502;2065681;4555;2381495
FR;2;2021-12-15;6558;36241;285178;955;315772;5795996;5581743;2350859;5510;2697267
FR;2;2021-12-16;7762;37919;312104;982;343687;5803758;5619662;2662963;6492;3040954
FR;2;2021-12-17;8682;41253;327836;976;360918;5812440;5660915;2990799;7468;3401872
FR;2;2021-12-18;6514;26564;212321;448;233624;5818954;5687479;3203120;7916;3635496
FR;2;2021-12-19;2601;11488;90204;183;100377;5821555;5698967;3293324;8099;3735873
FR;2;2021-12-20;9549;33604;275167;706;303343;5831104;5732571;3568491;8805;4039216
FR;2;2021-12-21;11554;38331;309597;969;341387;5842658;5770902;3878088;9774;4380603
FR;2;2021-12-22;10458;32851;265086;952;292468;5853116;5803753;4143174;10726;4673071
FR;2;2021-12-23;9429;26704;199463;700;221256;5862545;5830457;4342637;11426;4894327
FR;2;2021-12-24;2782;7505;43846;140;49562;5865327;5837962;4386483;11566;4943889
FR;2;2021-12-25;201;696;2000;10;2493;5865528;5838658;4388483;11576;4946382
FR;2;2021-12-26;1322;4209;25148;71;28675;5866850;5842867;4413631;11647;4975057
FR;2;2021-12-27;8075;29938;218386;659;243309;5874925;5872805;4632017;12306;5218366
FR;2;2021-12-28;9840;36339;272067;741;301949;5884765;5909144;4904084;13047;5520315
FR;2;2021-12-29;9497;32281;246109;766;272676;5894262;5941425;5150193;13813;5792991
FR;2;2021-12-30;9454;28136;208814;662;231468;5903716;5969561;5359007;14475;6024459
FR;2;2021-12-31;3007;8371;54982;177;61235;5906723;5977932;5413989;14652;6085694
FR;2;2022-01-01;227;690;2849;7;3343;5906950;5978622;5416838;14659;6089037
FR;2;2022-01-02;1504;4858;29508;75;33397;5908454;5983480;5446346;14734;6122434
FR;2;2022-01-03;9588;35387;266506;806;293870;5918042;6018867;5712852;15540;6416304
FR;2;2022-01-04;12844;45384;342069;1068;376961;5930886;6064251;6054921;16608;6793265
FR;2;2022-01-05;11269;38666;294155;886;323805;5942155;6102917;6349076;17494;7117070
FR;2;2022-01-06;13649;43511;331929;1298;364715;5955804;6146428;6681005;18792;7481785
FR;2;2022-01-07;14221;47638;361080;1270;396412;5970025;6194066;7042085;20062;7878197
FR;2;2022-01-08;7949;28147;201257;515;221687;5977974;6222213;7243342;20577;8099884
FR;2;2022-01-09;2749;8993;62520;137;69522;5980723;6231206;7305862;20714;8169406
FR;2;2022-01-10;10090;31934;232454;858;255044;5990813;6263140;7538316;21572;8424450
FR;2;2022-01-11;11470;36251;265885;1030;290571;6002283;6299391;7804201;22602;8715021
FR;2;2022-01-12;8758;29819;206306;862;226164;6011041;6329210;8010507;23464;8941185
FR;2;2022-01-13;9387;31355;224469;832;244820;6020428;6360565;8234976;24296;9186005
FR;2;2022-01-14;9743;35647;254519;920;277670;6030171;6396212;8489495;25216;9463675
FR;2;2022-01-15;5355;19457;140772;363;153638;6035526;6415669;8630267;25579;9617313
FR;2;2022-01-16;1511;5519;35875;81;39850;6037037;6421188;8666142;25660;9657163
FR;2;2022-01-17;5545;19303;135389;601;147252;6042582;6440491;8801531;26261;9804415
FR;2;2022-01-18;6418;21518;148611;648;160467;6049000;6462009;8950142;26909;9964882
FR;2;2022-01-19;4389;16358;105083;552;113702;6053389;6478367;9055225;27461;10078584
FR;2;2022-01-20;4867;17600;115280;603;123678;6058256;6495967;9170505;28064;10202262
FR;2;2022-01-21;5194;20062;137324;678;147741;6063450;6516029;9307829;28742;10350003
FR;2;2022-01-22;3029;10961;74257;259;80326;6066479;6526990;9382086;29001;10430329
FR;2;2022-01-23;724;2736;15237;41;16836;6067203;6529726;9397323;29042;10447165
FR;2;2022-01-24;3293;12814;75060;430;81016;6070496;6542540;9472383;29472;10528181
FR;2;2022-01-25;3572;14440;79614;496;85450;6074068;6556980;9551997;29968;10613631
FR;2;2022-01-26;2514;10673;58960;363;62990;6076582;6567653;9610957;30331;10676621
FR;2;2022-01-27;2680;11300;64170;388;67911;6079262;6578953;9675127;30719;10744532
FR;2;2022-01-28;3544;18371;91711;430;98957;6082806;6597324;9766838;31149;10843489
FR;2;2022-01-29;1894;9246;48842;164;52925;6084700;6606570;9815680;31313;10896414
FR;2;2022-01-30;464;2240;9452;38;10605;6085164;6608810;9825132;31351;10907019
FR;2;2022-01-31;1887;9587;43821;208;47342;6087051;6618397;9868953;31559;10954361
FR;2;2022-02-01;1911;10049;47020;279;50103;6088962;6628446;9915973;31838;11004464
FR;2;2022-02-02;1607;9026;41103;251;44174;6090569;6637472;9957076;32089;11048638
FR;2;2022-02-03;1723;8945;40511;204;42909;6092292;6646417;9997587;32293;11091547
FR;2;2022-02-04;2152;15213;66627;297;71343;6094444;6661630;10064214;32590;11162890
FR;2;2022-02-05;1360;8535;35941;131;39236;6095804;6670165;10100155;32721;11202126
FR;2;2022-02-06;274;1775;6124;16;6899;6096078;6671940;10106279;32737;11209025
FR;2;2022-02-07;1350;9597;37747;134;41305;6097428;6681537;10144026;32871;11250330
FR;2;2022-02-08;1300;9815;40928;173;43714;6098728;6691352;10184954;33044;11294044
FR;2;2022-02-09;1160;8821;37036;174;40455;6099888;6700173;10221990;33218;11334499
FR;2;2022-02-10;1024;7986;33833;204;36502;6100912;6708159;10255823;33422;11371001
FR;2;2022-02-11;1389;12080;53338;223;57687;6102301;6720239;10309161;33645;11428688
FR;2;2022-02-12;749;6533;27986;83;30805;6103050;6726772;10337147;33728;11459493
FR;2;2022-02-13;200;1336;4833;20;5574;6103250;6728108;10341980;33748;11465067
FR;2;2022-02-14;835;6729;30265;90;33229;6104085;6734837;10372245;33838;11498296
FR;2;2022-02-15;772;6453;28044;141;29984;6104857;6741290;10400289;33979;11528280
FR;2;2022-02-16;654;5353;22054;123;23618;6105511;6746643;10422343;34102;11551898
FR;2;2022-02-17;515;3776;14144;98;14609;6106026;6750419;10436487;34200;11566507
FR;2;2022-02-18;721;5363;20430;134;21126;6106747;6755782;10456917;34334;11587633
FR;2;2022-02-19;430;3052;10527;66;11241;6107177;6758834;10467444;34400;11598874
FR;2;2022-02-20;101;512;1456;3;1604;6107278;6759346;10468900;34403;11600478
FR;2;2022-02-21;421;2683;9117;65;9494;6107699;6762029;10478017;34468;11609972
FR;2;2022-02-22;389;2564;8888;76;8791;6108088;6764593;10486905;34544;11618763
FR;2;2022-02-23;431;2601;8987;82;9264;6108519;6767194;10495892;34626;11628027
FR;2;2022-02-24;314;2029;6798;81;6826;6108833;6769223;10502690;34707;11634853
FR;2;2022-02-25;456;3195;11414;108;11277;6109289;6772418;10514104;34815;11646130
FR;2;2022-02-26;295;1892;6035;49;6340;6109584;6774310;10520139;34864;11652470
FR;2;2022-02-27;75;312;905;5;948;6109659;6774622;10521044;34869;11653418
FR;2;2022-02-28;330;1682;5523;53;5531;6109989;6776304;10526567;34922;11658949
FR;2;2022-03-01;275;1559;5475;44;5191;6110264;6777863;10532042;34966;11664140
FR;2;2022-03-02;297;1432;5243;45;5085;6110561;6779295;10537285;35011;11669225
FR;2;2022-03-03;225;1103;3705;42;3480;6110786;6780398;10540990;35053;11672705
FR;2;2022-03-04;242;1464;4855;73;4500;6111028;6781862;10545845;35126;11677205
FR;2;2022-03-05;173;904;2978;32;2722;6111201;6782766;10548823;35158;11679927
FR;2;2022-03-06;40;182;278;5;318;6111241;6782948;10549101;35163;11680245
FR;2;2022-03-07;155;654;1983;69;1773;6111396;6783602;10551084;35232;11682018
FR;2;2022-03-08;143;655;2270;51;1902;6111539;6784257;10553354;35283;11683920
FR;2;2022-03-09;153;700;2341;37;2043;6111692;6784957;10555695;35320;11685963
FR;2;2022-03-10;120;599;1688;35;1462;6111812;6785556;10557383;35355;11687425
FR;2;2022-03-11;169;754;2767;57;2366;6111981;6786310;10560150;35412;11689791
FR;2;2022-03-12;145;482;1784;27;1553;6112126;6786792;10561934;35439;11691344
FR;2;2022-03-13;25;75;201;29;202;6112151;6786867;10562135;35468;11691546
FR;2;2022-03-14;125;465;1561;529;1290;6112276;6787332;10563696;35997;11692836
FR;2;2022-03-15;138;418;1707;688;1322;6112414;6787750;10565403;36685;11694158
FR;2;2022-03-16;141;467;2011;1611;1589;6112555;6788217;10567414;38296;11695747
FR;2;2022-03-17;93;412;1405;1193;1142;6112648;6788629;10568819;39489;11696889
FR;2;2022-03-18;145;490;2018;1787;1660;6112793;6789119;10570837;41276;11698549
FR;2;2022-03-19;108;319;1209;940;1014;6112901;6789438;10572046;42216;11699563
FR;2;2022-03-20;12;76;191;59;167;6112913;6789514;10572237;42275;11699730
FR;2;2022-03-21;96;301;1211;1481;1075;6113009;6789815;10573448;43756;11700805
FR;2;2022-03-22;117;383;1528;1828;1290;6113126;6790198;10574976;45584;11702095
FR;2;2022-03-23;139;352;1668;3032;1461;6113265;6790550;10576644;48616;11703556
FR;2;2022-03-24;116;290;1182;1546;997;6113381;6790840;10577826;50162;11704553
FR;2;2022-03-25;119;360;1803;2449;1473;6113500;6791200;10579629;52611;11706026
FR;2;2022-03-26;77;246;1203;1220;952;6113577;6791446;10580832;53831;11706978
FR;2;2022-03-27;19;36;152;100;131;6113596;6791482;10580984;53931;11707109
FR;2;2022-03-28;94;285;1134;1588;993;6113690;6791767;10582118;55519;11708102
FR;2;2022-03-29;108;257;1324;2462;1104;6113798;6792024;10583442;57981;11709206
FR;2;2022-03-30;91;312;1485;3183;1318;6113889;6792336;10584927;61164;11710524
FR;2;2022-03-31;104;281;1270;2327;1084;6113993;6792617;10586197;63491;11711608
FR;2;2022-04-01;121;316;1563;2341;1315;6114114;6792933;10587760;65832;11712923
FR;2;2022-04-02;72;161;845;889;737;6114186;6793094;10588605;66721;11713660
FR;2;2022-04-03;16;53;128;112;142;6114202;6793147;10588733;66833;11713802
FR;2;2022-04-04;108;227;985;1435;792;6114310;6793374;10589718;68268;11714594
FR;2;2022-04-05;142;286;1311;2872;1139;6114452;6793660;10591029;71140;11715733
FR;2;2022-04-06;88;247;1305;2517;1127;6114540;6793907;10592334;73657;11716860
FR;2;2022-04-07;119;214;1297;2681;1036;6114659;6794121;10593631;76338;11717896
FR;2;2022-04-08;123;328;1623;3230;1319;6114782;6794449;10595254;79568;11719215
FR;2;2022-04-09;90;219;899;1045;731;6114872;6794668;10596153;80613;11719946
FR;2;2022-04-10;37;46;143;161;118;6114909;6794714;10596296;80774;11720064
FR;2;2022-04-11;86;184;882;1518;772;6114995;6794898;10597178;82292;11720836
FR;2;2022-04-12;176;260;1177;2733;1055;6115171;6795158;10598355;85025;11721891
FR;2;2022-04-13;144;226;1119;2449;977;6115315;6795384;10599474;87474;11722868
FR;2;2022-04-14;114;219;1083;2669;915;6115429;6795603;10600557;90143;11723783
FR;2;2022-04-15;111;244;1194;2257;1050;6115540;6795847;10601751;92400;11724833
FR;2;2022-04-16;64;108;540;545;452;6115604;6795955;10602291;92945;11725285
FR;2;2022-04-17;15;26;57;53;53;6115619;6795981;10602348;92998;11725338
FR;2;2022-04-18;12;35;118;69;113;6115631;6796016;10602466;93067;11725451
FR;2;2022-04-19;108;235;1115;1705;945;6115739;6796251;10603581;94772;11726396
FR;2;2022-04-20;95;237;1092;2103;920;6115834;6796488;10604673;96875;11727316
FR;2;2022-04-21;111;229;973;1844;829;6115945;6796717;10605646;98719;11728145
FR;2;2022-04-22;96;269;1240;2080;1022;6116041;6796986;10606886;100799;11729167
FR;2;2022-04-23;66;154;644;762;573;6116107;6797140;10607530;101561;11729740
FR;2;2022-04-24;12;28;100;68;78;6116119;6797168;10607630;101629;11729818
FR;2;2022-04-25;103;201;819;1313;708;6116222;6797369;10608449;102942;11730526
FR;2;2022-04-26;109;183;1034;1955;872;6116331;6797552;10609483;104897;11731398
FR;2;2022-04-27;95;177;857;1757;760;6116426;6797729;10610340;106654;11732158
FR;2;2022-04-28;90;213;948;1897;842;6116516;6797942;10611288;108551;11733000
FR;2;2022-04-29;77;279;1125;1687;1034;6116593;6798221;10612413;110238;11734034
FR;2;2022-04-30;65;125;470;536;429;6116658;6798346;10612883;110774;11734463
FR;2;2022-05-01;18;23;80;46;81;6116676;6798369;10612963;110820;11734544
FR;2;2022-05-02;112;213;758;1204;655;6116788;6798582;10613721;112024;11735199
FR;2;2022-05-03;149;224;990;1729;928;6116937;6798806;10614711;113753;11736127
FR;2;2022-05-04;87;219;913;1796;856;6117024;6799025;10615624;115549;11736983
FR;2;2022-05-05;123;191;838;1698;751;6117147;6799216;10616462;117247;11737734
FR;2;2022-05-06;131;237;1093;1848;1005;6117278;6799453;10617555;119095;11738739
FR;2;2022-05-07;40;97;470;504;406;6117318;6799550;10618025;119599;11739145
FR;2;2022-05-08;45;53;106;70;100;6117363;6799603;10618131;119669;11739245
FR;2;2022-05-09;101;171;649;981;601;6117464;6799774;10618780;120650;11739846
FR;2;2022-05-10;116;236;935;1829;890;6117580;6800010;10619715;122479;11740736
FR;2;2022-05-11;97;165;805;1853;783;6117677;6800175;10620520;124332;11741519
FR;2;2022-05-12;109;166;831;2072;792;6117786;6800341;10621351;126404;11742311
FR;2;2022-05-13;95;228;963;2086;889;6117881;6800569;10622314;128490;11743200
FR;2;2022-05-14;75;116;450;553;408;6117956;6800685;10622764;129043;11743608
FR;2;2022-05-15;24;35;93;87;105;6117980;6800720;10622857;129130;11743713
FR;2;2022-05-16;103;168;587;921;525;6118083;6800888;10623444;130051;11744238
FR;2;2022-05-17;95;181;681;1667;652;6118178;6801069;10624125;131718;11744890
FR;2;2022-05-18;80;179;636;1420;640;6118258;6801248;10624761;133138;11745530
FR;2;2022-05-19;68;157;703;1792;735;6118326;6801405;10625464;134930;11746265
FR;2;2022-05-20;102;175;859;1699;766;6118428;6801580;10626323;136629;11747031
FR;2;2022-05-21;45;96;395;517;337;6118473;6801676;10626718;137146;11747368
FR;2;2022-05-22;8;22;67;37;56;6118481;6801698;10626785;137183;11747424
FR;2;2022-05-23;83;128;482;901;467;6118564;6801826;10627267;138084;11747891
FR;2;2022-05-24;84;161;618;1572;602;6118648;6801987;10627885;139656;11748493
FR;2;2022-05-25;69;139;529;1137;482;6118717;6802126;10628414;140793;11748975
FR;2;2022-05-26;8;25;65;41;71;6118725;6802151;10628479;140834;11749046
FR;2;2022-05-27;44;112;442;811;422;6118769;6802263;10628921;141645;11749468
FR;2;2022-05-28;28;60;218;239;218;6118797;6802323;10629139;141884;11749686
FR;2;2022-05-29;10;34;43;25;51;6118807;6802357;10629182;141909;11749737
FR;2;2022-05-30;65;105;405;709;388;6118872;6802462;10629587;142618;11750125
FR;2;2022-05-31;73;129;545;1223;494;6118945;6802591;10630132;143841;11750619
FR;2;2022-06-01;53;142;490;1032;476;6118998;6802733;10630622;144873;11751095
FR;2;2022-06-02;86;159;548;1346;518;6119084;6802892;10631170;146219;11751613
FR;2;2022-06-03;64;147;597;1590;537;6119148;6803039;10631767;147809;11752150
FR;2;2022-06-04;53;91;260;432;245;6119201;6803130;10632027;148241;11752395
FR;2;2022-06-05;11;17;61;57;47;6119212;6803147;10632088;148298;11752442
FR;2;2022-06-06;11;18;62;73;67;6119223;6803165;10632150;148371;11752509
FR;2;2022-06-07;97;205;616;1451;522;6119320;6803370;10632766;149822;11753031
FR;2;2022-06-08;70;111;442;1158;376;6119390;6803481;10633208;150980;11753407
FR;2;2022-06-09;88;159;550;1837;515;6119478;6803640;10633758;152817;11753922
FR;2;2022-06-10;79;152;582;1668;553;6119557;6803792;10634340;154485;11754475
FR;2;2022-06-11;40;75;246;521;231;6119597;6803867;10634586;155006;11754706
FR;2;2022-06-12;18;38;55;76;59;6119615;6803905;10634641;155082;11754765
FR;2;2022-06-13;33;108;331;938;320;6119648;6804013;10634972;156020;11755085
FR;2;2022-06-14;61;144;538;2034;485;6119709;6804157;10635510;158054;11755570
FR;2;2022-06-15;67;90;424;1481;368;6119776;6804247;10635934;159535;11755938
FR;2;2022-06-16;126;113;396;1388;336;6119902;6804360;10636330;160923;11756274
FR;2;2022-06-17;62;118;497;1784;439;6119964;6804478;10636827;162707;11756713
FR;2;2022-06-18;67;73;198;557;175;6120031;6804551;10637025;163264;11756888
FR;2;2022-06-19;6;8;49;67;36;6120037;6804559;10637074;163331;11756924
FR;3;2020-12-27;0;0;0;0;0;0;0;0;0;0
FR;3;2020-12-28;0;0;0;0;0;0;0;0;0;0
FR;3;2020-12-29;0;0;0;0;0;0;0;0;0;0
FR;3;2020-12-30;0;0;0;0;0;0;0;0;0;0
FR;3;2020-12-31;0;0;0;0;0;0;0;0;0;0
FR;3;2021-01-01;0;0;0;0;0;0;0;0;0;0
FR;3;2021-01-02;0;0;0;0;0;0;0;0;0;0
FR;3;2021-01-03;0;0;0;0;0;0;0;0;0;0
FR;3;2021-01-04;0;0;0;0;0;0;0;0;0;0
FR;3;2021-01-05;0;0;0;0;0;0;0;0;0;0
FR;3;2021-01-06;0;0;0;0;0;0;0;0;0;0
FR;3;2021-01-07;0;0;0;0;0;0;0;0;0;0
FR;3;2021-01-08;0;0;0;0;0;0;0;0;0;0
FR;3;2021-01-09;0;0;0;0;0;0;0;0;0;0
FR;3;2021-01-10;0;0;0;0;0;0;0;0;0;0
FR;3;2021-01-11;0;0;0;0;0;0;0;0;0;0
FR;3;2021-01-12;0;0;0;0;0;0;0;0;0;0
FR;3;2021-01-13;0;0;0;0;0;0;0;0;0;0
FR;3;2021-01-14;0;0;0;0;0;0;0;0;0;0
FR;3;2021-01-15;0;0;0;0;0;0;0;0;0;0
FR;3;2021-01-16;0;0;0;0;0;0;0;0;0;0
FR;3;2021-01-17;0;0;0;0;0;0;0;0;0;0
FR;3;2021-01-18;0;0;0;0;0;0;0;0;0;0
FR;3;2021-01-19;0;0;0;0;0;0;0;0;0;0
FR;3;2021-01-20;0;0;0;0;0;0;0;0;0;0
FR;3;2021-01-21;0;0;0;0;0;0;0;0;0;0
FR;3;2021-01-22;0;0;0;0;0;0;0;0;0;0
FR;3;2021-01-23;0;0;0;0;0;0;0;0;0;0
FR;3;2021-01-24;0;0;0;0;0;0;0;0;0;0
FR;3;2021-01-25;0;0;0;0;0;0;0;0;0;0
FR;3;2021-01-26;0;0;0;0;0;0;0;0;0;0
FR;3;2021-01-27;0;0;0;0;0;0;0;0;0;0
FR;3;2021-01-28;0;0;0;0;0;0;0;0;0;0
FR;3;2021-01-29;0;0;0;0;0;0;0;0;0;0
FR;3;2021-01-30;0;0;0;0;0;0;0;0;0;0
FR;3;2021-01-31;0;0;0;0;0;0;0;0;0;0
FR;3;2021-02-01;0;0;0;0;0;0;0;0;0;0
FR;3;2021-02-02;0;0;0;0;0;0;0;0;0;0
FR;3;2021-02-03;0;0;0;0;0;0;0;0;0;0
FR;3;2021-02-04;0;0;0;0;0;0;0;0;0;0
FR;3;2021-02-05;0;0;0;0;0;0;0;0;0;0
FR;3;2021-02-06;1644;0;0;0;0;1644;0;0;0;0
FR;3;2021-02-07;1423;0;0;0;0;3067;0;0;0;0
FR;3;2021-02-08;2784;1;0;0;0;5851;1;0;0;0
FR;3;2021-02-09;6782;0;0;0;0;12633;1;0;0;0
FR;3;2021-02-10;9605;0;0;0;0;22238;1;0;0;0
FR;3;2021-02-11;13612;0;0;0;0;35850;1;0;0;0
FR;3;2021-02-12;13403;0;0;0;0;49253;1;0;0;0
FR;3;2021-02-13;3786;1;0;0;0;53039;2;0;0;0
FR;3;2021-02-14;972;0;0;0;0;54011;2;0;0;0
FR;3;2021-02-15;10487;1;0;0;0;64498;3;0;0;0
FR;3;2021-02-16;12545;1;0;0;0;77043;4;0;0;0
FR;3;2021-02-17;11153;0;0;0;0;88196;4;0;0;0
FR;3;2021-02-18;14935;2;0;0;0;103131;6;0;0;0
FR;3;2021-02-19;14359;1;0;0;0;117490;7;0;0;0
FR;3;2021-02-20;3329;0;0;0;0;120819;7;0;0;0
FR;3;2021-02-21;618;0;0;0;0;121437;7;0;0;0
FR;3;2021-02-22;9163;0;0;0;0;130600;7;0;0;0
FR;3;2021-02-23;11395;1;0;0;0;141995;8;0;0;0
FR;3;2021-02-24;14299;1;0;0;0;156294;9;0;0;0
FR;3;2021-02-25;44930;1;0;0;0;201224;10;0;0;0
FR;3;2021-02-26;61883;4;0;0;0;263107;14;0;0;0
FR;3;2021-02-27;34801;5;0;0;0;297908;19;0;0;0
FR;3;2021-02-28;2463;0;0;0;0;300371;19;0;0;0
FR;3;2021-03-01;20514;12;0;0;0;320885;31;0;0;0
FR;3;2021-03-02;38867;19;0;0;0;359752;50;0;0;0
FR;3;2021-03-03;48732;15;0;0;0;408484;65;0;0;0
FR;3;2021-03-04;82218;21;0;0;0;490702;86;0;0;0
FR;3;2021-03-05;118123;40;0;0;0;608825;126;0;0;0
FR;3;2021-03-06;120714;56;1;0;0;729539;182;1;0;0
FR;3;2021-03-07;55174;27;0;0;0;784713;209;1;0;0
FR;3;2021-03-08;42809;25;0;0;0;827522;234;1;0;0
FR;3;2021-03-09;78968;45;0;0;0;906490;279;1;0;0
FR;3;2021-03-10;80969;47;0;0;0;987459;326;1;0;0
FR;3;2021-03-11;128424;56;0;0;0;1115883;382;1;0;0
FR;3;2021-03-12;182722;92;0;0;0;1298605;474;1;0;0
FR;3;2021-03-13;132146;67;0;0;0;1430751;541;1;0;0
FR;3;2021-03-14;14055;5;0;0;0;1444806;546;1;0;0
FR;3;2021-03-15;52226;49;0;0;0;1497032;595;1;0;0
FR;3;2021-03-16;1209;25;0;0;0;1498241;620;1;0;0
FR;3;2021-03-17;943;34;0;0;0;1499184;654;1;0;0
FR;3;2021-03-18;1565;13;0;0;0;1500749;667;1;0;0
FR;3;2021-03-19;70450;47;0;0;0;1571199;714;1;0;0
FR;3;2021-03-20;65226;46;0;0;0;1636425;760;1;0;0
FR;3;2021-03-21;5756;6;0;0;0;1642181;766;1;0;0
FR;3;2021-03-22;37498;40;0;0;0;1679679;806;1;0;0
FR;3;2021-03-23;84654;63;0;0;0;1764333;869;1;0;0
FR;3;2021-03-24;90938;92;0;0;0;1855271;961;1;0;0
FR;3;2021-03-25;150047;131;0;0;0;2005318;1092;1;0;0
FR;3;2021-03-26;165416;150;0;0;0;2170734;1242;1;0;0
FR;3;2021-03-27;68456;101;0;0;0;2239190;1343;1;0;0
FR;3;2021-03-28;6471;19;0;0;0;2245661;1362;1;0;0
FR;3;2021-03-29;54160;74;0;0;0;2299821;1436;1;0;0
FR;3;2021-03-30;93163;101;0;0;0;2392984;1537;1;0;0
FR;3;2021-03-31;63527;100;0;0;0;2456511;1637;1;0;0
FR;3;2021-04-01;86120;104;0;0;0;2542631;1741;1;0;0
FR;3;2021-04-02;86897;155;0;0;0;2629528;1896;1;0;0
FR;3;2021-04-03;35872;115;0;0;0;2665400;2011;1;0;0
FR;3;2021-04-04;3571;18;0;0;0;2668971;2029;1;0;0
FR;3;2021-04-05;4487;28;0;0;0;2673458;2057;1;0;0
FR;3;2021-04-06;29744;85;0;0;0;2703202;2142;1;0;0
FR;3;2021-04-07;32339;81;0;0;0;2735541;2223;1;0;0
FR;3;2021-04-08;78809;243;0;0;0;2814350;2466;1;0;0
FR;3;2021-04-09;161746;419;0;0;0;2976096;2885;1;0;0
FR;3;2021-04-10;75757;332;0;0;0;3051853;3217;1;0;0
FR;3;2021-04-11;7309;45;0;0;0;3059162;3262;1;0;0
FR;3;2021-04-12;51468;207;0;0;0;3110630;3469;1;0;0
FR;3;2021-04-13;86220;318;0;0;0;3196850;3787;1;0;0
FR;3;2021-04-14;67833;346;0;0;0;3264683;4133;1;0;0
FR;3;2021-04-15;93220;373;0;0;0;3357903;4506;1;0;0
FR;3;2021-04-16;112517;581;0;0;0;3470420;5087;1;0;0
FR;3;2021-04-17;53311;325;1;0;0;3523731;5412;2;0;0
FR;3;2021-04-18;9744;35;0;0;0;3533475;5447;2;0;0
FR;3;2021-04-19;25104;244;0;0;0;3558579;5691;2;0;0
FR;3;2021-04-20;45673;402;0;0;0;3604252;6093;2;0;0
FR;3;2021-04-21;38967;472;0;0;0;3643219;6565;2;0;0
FR;3;2021-04-22;54705;790;0;0;0;3697924;7355;2;0;0
FR;3;2021-04-23;70485;1027;0;0;0;3768409;8382;2;0;0
FR;3;2021-04-24;37240;1011;0;0;0;3805649;9393;2;0;0
FR;3;2021-04-25;6204;155;0;0;0;3811853;9548;2;0;0
FR;3;2021-04-26;19784;658;0;0;0;3831637;10206;2;0;0
FR;3;2021-04-27;34472;1266;0;0;0;3866109;11472;2;0;0
FR;3;2021-04-28;28967;1944;0;0;0;3895076;13416;2;0;0
FR;3;2021-04-29;45377;5972;0;0;0;3940453;19388;2;0;0
FR;3;2021-04-30;55454;8951;1;0;0;3995907;28339;3;0;0
FR;3;2021-05-01;9511;1985;0;0;0;4005418;30324;3;0;0
FR;3;2021-05-02;3070;487;0;0;0;4008488;30811;3;0;0
FR;3;2021-05-03;13059;3885;0;0;0;4021547;34696;3;0;0
FR;3;2021-05-04;23109;8415;0;0;0;4044656;43111;3;0;0
FR;3;2021-05-05;18754;10638;0;0;0;4063410;53749;3;0;0
FR;3;2021-05-06;34622;20933;0;0;0;4098032;74682;3;0;0
FR;3;2021-05-07;44202;28488;0;0;0;4142234;103170;3;0;0
FR;3;2021-05-08;6785;8983;0;0;0;4149019;112153;3;0;0
FR;3;2021-05-09;1794;2654;0;0;0;4150813;114807;3;0;0
FR;3;2021-05-10;14990;12648;0;0;0;4165803;127455;3;0;0
FR;3;2021-05-11;27092;25838;0;0;0;4192895;153293;3;0;0
FR;3;2021-05-12;17266;27582;0;0;0;4210161;180875;3;0;0
FR;3;2021-05-13;2278;3479;0;0;0;4212439;184354;3;0;0
FR;3;2021-05-14;14514;25814;0;0;0;4226953;210168;3;0;0
FR;3;2021-05-15;7231;20827;0;0;0;4234184;230995;3;0;0
FR;3;2021-05-16;975;2669;0;0;0;4235159;233664;3;0;0
FR;3;2021-05-17;7962;19976;0;0;0;4243121;253640;3;0;0
FR;3;2021-05-18;13410;29716;0;0;0;4256531;283356;3;0;0
FR;3;2021-05-19;9263;31417;0;0;0;4265794;314773;3;0;0
FR;3;2021-05-20;12801;53318;3;0;0;4278595;368091;6;0;0
FR;3;2021-05-21;12760;65629;2;0;0;4291355;433720;8;0;0
FR;3;2021-05-22;4963;33381;1;0;0;4296318;467101;9;0;0
FR;3;2021-05-23;649;2661;0;0;0;4296967;469762;9;0;0
FR;3;2021-05-24;879;4904;0;0;0;4297846;474666;9;0;0
FR;3;2021-05-25;5301;45466;1;0;0;4303147;520132;10;0;0
FR;3;2021-05-26;4973;51211;1;0;0;4308120;571343;11;0;0
FR;3;2021-05-27;6326;78095;3;0;0;4314446;649438;14;0;0
FR;3;2021-05-28;7542;99254;2;0;0;4321988;748692;16;0;0
FR;3;2021-05-29;3345;60421;1;0;0;4325333;809113;17;0;0
FR;3;2021-05-30;547;8206;0;0;0;4325880;817319;17;0;0
FR;3;2021-05-31;2439;35809;3;0;0;4328319;853128;20;0;0
FR;3;2021-06-01;3400;64730;10;0;0;4331719;917858;30;0;0
FR;3;2021-06-02;2727;58371;6;0;0;4334446;976229;36;0;0
FR;3;2021-06-03;3492;87464;10;0;0;4337938;1063693;46;0;0
FR;3;2021-06-04;4114;105152;22;0;0;4342052;1168845;68;0;0
FR;3;2021-06-05;1979;52280;4;0;0;4344031;1221125;72;0;0
FR;3;2021-06-06;505;5382;1;0;0;4344536;1226507;73;0;0
FR;3;2021-06-07;1473;31064;11;0;0;4346009;1257571;84;0;0
FR;3;2021-06-08;2048;47247;18;0;0;4348057;1304818;102;0;0
FR;3;2021-06-09;1788;42213;13;0;0;4349845;1347031;115;0;0
FR;3;2021-06-10;2245;67792;17;0;0;4352090;1414823;132;0;0
FR;3;2021-06-11;2476;96654;34;0;0;4354566;1511477;166;0;0
FR;3;2021-06-12;1175;40819;6;0;0;4355741;1552296;172;0;0
FR;3;2021-06-13;279;3770;3;0;0;4356020;1556066;175;0;0
FR;3;2021-06-14;1042;42552;17;0;0;4357062;1598618;192;0;0
FR;3;2021-06-15;1365;80581;20;0;0;4358427;1679199;212;0;0
FR;3;2021-06-16;1256;65649;20;0;0;4359683;1744848;232;0;0
FR;3;2021-06-17;1661;101860;41;0;0;4361344;1846708;273;0;0
FR;3;2021-06-18;1868;117968;62;0;0;4363212;1964676;335;0;0
FR;3;2021-06-19;801;39396;22;0;0;4364013;2004072;357;0;0
FR;3;2021-06-20;158;3356;0;0;0;4364171;2007428;357;0;0
FR;3;2021-06-21;768;39211;16;0;0;4364939;2046639;373;0;0
FR;3;2021-06-22;1061;69959;52;0;0;4366000;2116598;425;0;0
FR;3;2021-06-23;942;50820;39;0;0;4366942;2167418;464;0;0
FR;3;2021-06-24;1307;77143;48;0;0;4368249;2244561;512;0;0
FR;3;2021-06-25;1401;90019;73;0;0;4369650;2334580;585;0;0
FR;3;2021-06-26;628;33135;29;0;0;4370278;2367715;614;0;0
FR;3;2021-06-27;166;3980;1;0;0;4370444;2371695;615;0;0
FR;3;2021-06-28;649;30362;27;0;0;4371093;2402057;642;0;0
FR;3;2021-06-29;854;56173;95;0;0;4371947;2458230;737;0;0
FR;3;2021-06-30;901;45100;93;0;0;4372848;2503330;830;0;0
FR;3;2021-07-01;1160;65706;108;0;0;4374008;2569036;938;0;0
FR;3;2021-07-02;1302;90384;170;0;0;4375310;2659420;1108;0;0
FR;3;2021-07-03;600;31174;52;0;0;4375910;2690594;1160;0;0
FR;3;2021-07-04;142;4237;3;0;0;4376052;2694831;1163;0;0
FR;3;2021-07-05;609;33846;60;0;0;4376661;2728677;1223;0;0
FR;3;2021-07-06;958;56043;88;0;0;4377619;2784720;1311;0;0
FR;3;2021-07-07;870;43032;79;0;0;4378489;2827752;1390;0;0
FR;3;2021-07-08;1123;60732;99;0;0;4379612;2888484;1489;0;0
FR;3;2021-07-09;1258;68786;128;0;0;4380870;2957270;1617;0;0
FR;3;2021-07-10;642;25068;59;0;0;4381512;2982338;1676;0;0
FR;3;2021-07-11;128;3276;4;0;0;4381640;2985614;1680;0;0
FR;3;2021-07-12;660;23858;59;0;0;4382300;3009472;1739;0;0
FR;3;2021-07-13;1645;34700;90;0;0;4383945;3044172;1829;0;0
FR;3;2021-07-14;263;2603;2;0;0;4384208;3046775;1831;0;0
FR;3;2021-07-15;1934;30633;85;0;0;4386142;3077408;1916;0;0
FR;3;2021-07-16;2520;38847;122;0;0;4388662;3116255;2038;0;0
FR;3;2021-07-17;1046;13738;26;0;0;4389708;3129993;2064;0;0
FR;3;2021-07-18;263;2601;3;0;0;4389971;3132594;2067;0;0
FR;3;2021-07-19;1275;17161;37;0;0;4391246;3149755;2104;0;0
FR;3;2021-07-20;1823;27102;98;0;0;4393069;3176857;2202;0;0
FR;3;2021-07-21;1649;19704;44;0;0;4394718;3196561;2246;0;0
FR;3;2021-07-22;1850;27728;83;0;0;4396568;3224289;2329;0;0
FR;3;2021-07-23;2213;30428;117;0;0;4398781;3254717;2446;0;0
FR;3;2021-07-24;822;7004;25;0;0;4399603;3261721;2471;0;0
FR;3;2021-07-25;210;1338;1;0;0;4399813;3263059;2472;0;0
FR;3;2021-07-26;922;10686;28;0;0;4400735;3273745;2500;0;0
FR;3;2021-07-27;1167;16940;56;0;0;4401902;3290685;2556;0;0
FR;3;2021-07-28;988;12089;40;0;0;4402890;3302774;2596;0;0
FR;3;2021-07-29;1126;15828;63;0;0;4404016;3318602;2659;0;0
FR;3;2021-07-30;1126;18076;79;0;0;4405142;3336678;2738;0;0
FR;3;2021-07-31;406;3743;15;0;0;4405548;3340421;2753;0;0
FR;3;2021-08-01;113;484;1;0;0;4405661;3340905;2754;0;0
FR;3;2021-08-02;419;5148;22;0;0;4406080;3346053;2776;0;0
FR;3;2021-08-03;489;7574;27;0;0;4406569;3353627;2803;0;0
FR;3;2021-08-04;435;4879;26;0;0;4407004;3358506;2829;0;0
FR;3;2021-08-05;429;3732;12;0;0;4407433;3362238;2841;0;0
FR;3;2021-08-06;453;4778;30;0;0;4407886;3367016;2871;0;0
FR;3;2021-08-07;214;1923;11;0;0;4408100;3368939;2882;0;0
FR;3;2021-08-08;249;427;2;0;0;4408349;3369366;2884;0;0
FR;3;2021-08-09;314;2487;11;0;0;4408663;3371853;2895;0;0
FR;3;2021-08-10;363;3869;15;0;0;4409026;3375722;2910;0;0
FR;3;2021-08-11;286;2719;15;0;0;4409312;3378441;2925;0;0
FR;3;2021-08-12;276;2635;12;0;0;4409588;3381076;2937;0;0
FR;3;2021-08-13;277;2261;16;0;0;4409865;3383337;2953;0;0
FR;3;2021-08-14;169;914;1;0;0;4410034;3384251;2954;0;0
FR;3;2021-08-15;55;174;0;0;0;4410089;3384425;2954;0;0
FR;3;2021-08-16;123;1081;8;0;0;4410212;3385506;2962;0;0
FR;3;2021-08-17;186;1496;8;0;0;4410398;3387002;2970;0;0
FR;3;2021-08-18;200;1366;10;0;0;4410598;3388368;2980;0;0
FR;3;2021-08-19;165;1409;10;0;0;4410763;3389777;2990;0;0
FR;3;2021-08-20;166;1629;16;0;0;4410929;3391406;3006;0;0
FR;3;2021-08-21;93;587;2;0;0;4411022;3391993;3008;0;0
FR;3;2021-08-22;41;187;1;0;0;4411063;3392180;3009;0;0
FR;3;2021-08-23;140;926;7;0;0;4411203;3393106;3016;0;0
FR;3;2021-08-24;124;964;10;0;0;4411327;3394070;3026;0;0
FR;3;2021-08-25;136;838;2;0;0;4411463;3394908;3028;0;0
FR;3;2021-08-26;170;868;9;0;0;4411633;3395776;3037;0;0
FR;3;2021-08-27;172;966;9;0;0;4411805;3396742;3046;0;0
FR;3;2021-08-28;98;370;4;0;0;4411903;3397112;3050;0;0
FR;3;2021-08-29;128;134;1;0;0;4412031;3397246;3051;0;0
FR;3;2021-08-30;99;598;0;0;134;4412130;3397844;3051;0;134
FR;3;2021-08-31;129;709;7;0;150;4412259;3398553;3058;0;284
FR;3;2021-09-01;115;476;5;0;122;4412374;3399029;3063;0;406
FR;3;2021-09-02;100;634;22;0;119;4412474;3399663;3085;0;525
FR;3;2021-09-03;115;586;17;0;128;4412589;3400249;3102;0;653
FR;3;2021-09-04;53;302;3;0;57;4412642;3400551;3105;0;710
FR;3;2021-09-05;51;68;5;0;28;4412693;3400619;3110;0;738
FR;3;2021-09-06;115;391;4;0;143;4412808;3401010;3114;0;881
FR;3;2021-09-07;123;468;14;0;127;4412931;3401478;3128;0;1008
FR;3;2021-09-08;118;369;2;0;101;4413049;3401847;3130;0;1109
FR;3;2021-09-09;92;397;8;0;114;4413141;3402244;3138;0;1223
FR;3;2021-09-10;100;419;3;0;102;4413241;3402663;3141;0;1325
FR;3;2021-09-11;76;238;4;0;66;4413317;3402901;3145;0;1391
FR;3;2021-09-12;36;48;1;0;17;4413353;3402949;3146;0;1408
FR;3;2021-09-13;72;320;7;0;108;4413425;3403269;3153;0;1516
FR;3;2021-09-14;72;291;6;0;105;4413497;3403560;3159;0;1621
FR;3;2021-09-15;60;263;3;0;6;4413557;3403823;3162;0;1627
FR;3;2021-09-16;60;333;5;0;5;4413617;3404156;3167;0;1632
FR;3;2021-09-17;51;347;3;0;7;4413668;3404503;3170;0;1639
FR;3;2021-09-18;36;174;1;0;1;4413704;3404677;3171;0;1640
FR;3;2021-09-19;27;32;2;0;1;4413731;3404709;3173;0;1641
FR;3;2021-09-20;79;209;0;0;1;4413810;3404918;3173;0;1642
FR;3;2021-09-21;58;286;6;0;7;4413868;3405204;3179;0;1649
FR;3;2021-09-22;63;228;6;0;7;4413931;3405432;3185;0;1656
FR;3;2021-09-23;36;272;11;0;7;4413967;3405704;3196;0;1663
FR;3;2021-09-24;25;324;12;0;19;4413992;3406028;3208;0;1682
FR;3;2021-09-25;29;147;3;0;3;4414021;3406175;3211;0;1685
FR;3;2021-09-26;15;55;1;0;1;4414036;3406230;3212;0;1686
FR;3;2021-09-27;39;291;3;0;5;4414075;3406521;3215;0;1691
FR;3;2021-09-28;49;256;6;0;10;4414124;3406777;3221;0;1701
FR;3;2021-09-29;35;224;10;0;14;4414159;3407001;3231;0;1715
FR;3;2021-09-30;38;201;8;0;10;4414197;3407202;3239;0;1725
FR;3;2021-10-01;17;167;6;0;6;4414214;3407369;3245;0;1731
FR;3;2021-10-02;14;90;0;0;0;4414228;3407459;3245;0;1731
FR;3;2021-10-03;18;20;1;0;2;4414246;3407479;3246;0;1733
FR;3;2021-10-04;30;161;4;0;4;4414276;3407640;3250;0;1737
FR;3;2021-10-05;16;154;10;0;13;4414292;3407794;3260;0;1750
FR;3;2021-10-06;31;157;8;0;9;4414323;3407951;3268;0;1759
FR;3;2021-10-07;18;140;6;0;6;4414341;3408091;3274;0;1765
FR;3;2021-10-08;22;144;10;0;9;4414363;3408235;3284;0;1774
FR;3;2021-10-09;13;72;1;0;1;4414376;3408307;3285;0;1775
FR;3;2021-10-10;12;16;2;0;2;4414388;3408323;3287;0;1777
FR;3;2021-10-11;15;123;4;0;5;4414403;3408446;3291;0;1782
FR;3;2021-10-12;18;112;5;0;5;4414421;3408558;3296;0;1787
FR;3;2021-10-13;23;118;8;0;6;4414444;3408676;3304;0;1793
FR;3;2021-10-14;16;162;3;0;4;4414460;3408838;3307;0;1797
FR;3;2021-10-15;23;153;8;0;11;4414483;3408991;3315;0;1808
FR;3;2021-10-16;11;78;6;0;8;4414494;3409069;3321;0;1816
FR;3;2021-10-17;11;24;0;0;0;4414505;3409093;3321;0;1816
FR;3;2021-10-18;17;125;2;0;1;4414522;3409218;3323;0;1817
FR;3;2021-10-19;16;124;19;0;21;4414538;3409342;3342;0;1838
FR;3;2021-10-20;22;129;6;0;7;4414560;3409471;3348;0;1845
FR;3;2021-10-21;26;135;17;0;13;4414586;3409606;3365;0;1858
FR;3;2021-10-22;20;126;16;0;20;4414606;3409732;3381;0;1878
FR;3;2021-10-23;12;58;2;0;1;4414618;3409790;3383;0;1879
FR;3;2021-10-24;7;32;0;0;0;4414625;3409822;3383;0;1879
FR;3;2021-10-25;22;150;7;0;7;4414647;3409972;3390;0;1886
FR;3;2021-10-26;19;112;22;0;19;4414666;3410084;3412;0;1905
FR;3;2021-10-27;17;116;9;0;9;4414683;3410200;3421;0;1914
FR;3;2021-10-28;20;127;33;0;36;4414703;3410327;3454;0;1950
FR;3;2021-10-29;11;122;64;0;54;4414714;3410449;3518;0;2004
FR;3;2021-10-30;8;65;11;1;10;4414722;3410514;3529;1;2014
FR;3;2021-10-31;6;22;1;0;1;4414728;3410536;3530;1;2015
FR;3;2021-11-01;7;22;2;0;1;4414735;3410558;3532;1;2016
FR;3;2021-11-02;9;107;8;0;10;4414744;3410665;3540;1;2026
FR;3;2021-11-03;19;117;10;0;10;4414763;3410782;3550;1;2036
FR;3;2021-11-04;18;96;4;0;3;4414781;3410878;3554;1;2039
FR;3;2021-11-05;17;141;8;1;5;4414798;3411019;3562;2;2044
FR;3;2021-11-06;7;64;3;0;3;4414805;3411083;3565;2;2047
FR;3;2021-11-07;6;21;1;0;1;4414811;3411104;3566;2;2048
FR;3;2021-11-08;11;140;7;0;5;4414822;3411244;3573;2;2053
FR;3;2021-11-09;12;149;5;0;5;4414834;3411393;3578;2;2058
FR;3;2021-11-10;13;174;14;0;15;4414847;3411567;3592;2;2073
FR;3;2021-11-11;8;51;3;0;3;4414855;3411618;3595;2;2076
FR;3;2021-11-12;11;151;6;0;4;4414866;3411769;3601;2;2080
FR;3;2021-11-13;7;77;8;0;10;4414873;3411846;3609;2;2090
FR;3;2021-11-14;2;21;0;0;0;4414875;3411867;3609;2;2090
FR;3;2021-11-15;4;190;10;0;10;4414879;3412057;3619;2;2100
FR;3;2021-11-16;3;164;11;0;10;4414882;3412221;3630;2;2110
FR;3;2021-11-17;6;175;10;0;7;4414888;3412396;3640;2;2117
FR;3;2021-11-18;13;173;10;0;11;4414901;3412569;3650;2;2128
FR;3;2021-11-19;9;222;22;0;27;4414910;3412791;3672;2;2155
FR;3;2021-11-20;6;114;5;0;5;4414916;3412905;3677;2;2160
FR;3;2021-11-21;3;26;3;0;3;4414919;3412931;3680;2;2163
FR;3;2021-11-22;10;231;10;0;10;4414929;3413162;3690;2;2173
FR;3;2021-11-23;6;231;15;0;14;4414935;3413393;3705;2;2187
FR;3;2021-11-24;5;232;9;0;17;4414940;3413625;3714;2;2204
FR;3;2021-11-25;9;278;11;0;10;4414949;3413903;3725;2;2214
FR;3;2021-11-26;6;353;35;0;32;4414955;3414256;3760;2;2246
FR;3;2021-11-27;8;166;20;0;21;4414963;3414422;3780;2;2267
FR;3;2021-11-28;3;60;7;0;7;4414966;3414482;3787;2;2274
FR;3;2021-11-29;4;306;19;0;20;4414970;3414788;3806;2;2294
FR;3;2021-11-30;5;397;26;0;29;4414975;3415185;3832;2;2323
FR;3;2021-12-01;21;445;32;0;33;4414996;3415630;3864;2;2356
FR;3;2021-12-02;9;466;33;0;36;4415005;3416096;3897;2;2392
FR;3;2021-12-03;3;547;37;0;38;4415008;3416643;3934;2;2430
FR;3;2021-12-04;3;275;26;0;28;4415011;3416918;3960;2;2458
FR;3;2021-12-05;1;78;5;0;5;4415012;3416996;3965;2;2463
FR;3;2021-12-06;5;491;14;0;16;4415017;3417487;3979;2;2479
FR;3;2021-12-07;4;587;20;0;24;4415021;3418074;3999;2;2503
FR;3;2021-12-08;4;524;29;0;30;4415025;3418598;4028;2;2533
FR;3;2021-12-09;3;574;17;0;22;4415028;3419172;4045;2;2555
FR;3;2021-12-10;9;605;29;0;25;4415037;3419777;4074;2;2580
FR;3;2021-12-11;4;381;10;0;9;4415041;3420158;4084;2;2589
FR;3;2021-12-12;1;120;3;0;3;4415042;3420278;4087;2;2592
FR;3;2021-12-13;2;580;19;0;21;4415044;3420858;4106;2;2613
FR;3;2021-12-14;7;739;18;0;21;4415051;3421597;4124;2;2634
FR;3;2021-12-15;9;700;17;0;21;4415060;3422297;4141;2;2655
FR;3;2021-12-16;9;713;19;0;18;4415069;3423010;4160;2;2673
FR;3;2021-12-17;4;778;18;0;19;4415073;3423788;4178;2;2692
FR;3;2021-12-18;4;409;4;0;5;4415077;3424197;4182;2;2697
FR;3;2021-12-19;3;207;2;0;2;4415080;3424404;4184;2;2699
FR;3;2021-12-20;8;709;23;0;28;4415088;3425113;4207;2;2727
FR;3;2021-12-21;3;797;10;0;13;4415091;3425910;4217;2;2740
FR;3;2021-12-22;7;749;9;0;10;4415098;3426659;4226;2;2750
FR;3;2021-12-23;1;642;9;0;8;4415099;3427301;4235;2;2758
FR;3;2021-12-24;2;269;3;0;6;4415101;3427570;4238;2;2764
FR;3;2021-12-25;0;25;0;0;0;4415101;3427595;4238;2;2764
FR;3;2021-12-26;0;93;1;0;1;4415101;3427688;4239;2;2765
FR;3;2021-12-27;7;536;17;0;19;4415108;3428224;4256;2;2784
FR;3;2021-12-28;1;686;6;0;5;4415109;3428910;4262;2;2789
FR;3;2021-12-29;4;570;14;0;16;4415113;3429480;4276;2;2805
FR;3;2021-12-30;1;598;7;0;10;4415114;3430078;4283;2;2815
FR;3;2021-12-31;0;203;5;0;7;4415114;3430281;4288;2;2822
FR;3;2022-01-01;0;27;0;0;2;4415114;3430308;4288;2;2824
FR;3;2022-01-02;0;82;0;0;0;4415114;3430390;4288;2;2824
FR;3;2022-01-03;3;561;17;0;20;4415117;3430951;4305;2;2844
FR;3;2022-01-04;6;620;9;0;8;4415123;3431571;4314;2;2852
FR;3;2022-01-05;4;550;10;0;14;4415127;3432121;4324;2;2866
FR;3;2022-01-06;5;545;9;0;12;4415132;3432666;4333;2;2878
FR;3;2022-01-07;2;572;11;0;13;4415134;3433238;4344;2;2891
FR;3;2022-01-08;2;283;4;0;5;4415136;3433521;4348;2;2896
FR;3;2022-01-09;0;118;0;0;0;4415136;3433639;4348;2;2896
FR;3;2022-01-10;2;476;12;0;12;4415138;3434115;4360;2;2908
FR;3;2022-01-11;2;526;1;0;1;4415140;3434641;4361;2;2909
FR;3;2022-01-12;2;443;9;0;10;4415142;3435084;4370;2;2919
FR;3;2022-01-13;3;422;11;0;12;4415145;3435506;4381;2;2931
FR;3;2022-01-14;3;472;10;0;13;4415148;3435978;4391;2;2944
FR;3;2022-01-15;0;297;2;0;3;4415148;3436275;4393;2;2947
FR;3;2022-01-16;0;116;1;0;1;4415148;3436391;4394;2;2948
FR;3;2022-01-17;2;347;8;0;10;4415150;3436738;4402;2;2958
FR;3;2022-01-18;2;408;1;0;2;4415152;3437146;4403;2;2960
FR;3;2022-01-19;2;349;5;0;10;4415154;3437495;4408;2;2970
FR;3;2022-01-20;1;377;5;0;3;4415155;3437872;4413;2;2973
FR;3;2022-01-21;4;370;5;0;7;4415159;3438242;4418;2;2980
FR;3;2022-01-22;2;231;1;0;2;4415161;3438473;4419;2;2982
FR;3;2022-01-23;0;82;0;0;1;4415161;3438555;4419;2;2983
FR;3;2022-01-24;2;346;1;0;6;4415163;3438901;4420;2;2989
FR;3;2022-01-25;0;190;0;0;0;4415163;3439091;4420;2;2989
FR;3;2022-01-26;0;88;0;0;0;4415163;3439179;4420;2;2989
FR;3;2022-01-27;0;56;0;0;0;4415163;3439235;4420;2;2989
FR;3;2022-01-28;0;133;0;0;0;4415163;3439368;4420;2;2989
FR;3;2022-01-29;0;110;0;0;0;4415163;3439478;4420;2;2989
FR;3;2022-01-30;0;51;0;0;0;4415163;3439529;4420;2;2989
FR;3;2022-01-31;0;97;0;0;0;4415163;3439626;4420;2;2989
FR;3;2022-02-01;0;108;0;0;1;4415163;3439734;4420;2;2990
FR;3;2022-02-02;0;95;0;0;0;4415163;3439829;4420;2;2990
FR;3;2022-02-03;0;101;0;0;0;4415163;3439930;4420;2;2990
FR;3;2022-02-04;0;124;0;0;0;4415163;3440054;4420;2;2990
FR;3;2022-02-05;0;73;0;0;0;4415163;3440127;4420;2;2990
FR;3;2022-02-06;0;11;0;0;0;4415163;3440138;4420;2;2990
FR;3;2022-02-07;0;89;0;0;1;4415163;3440227;4420;2;2991
FR;3;2022-02-08;0;0;0;0;0;4415163;3440227;4420;2;2991
FR;3;2022-02-09;0;0;0;0;0;4415163;3440227;4420;2;2991
FR;3;2022-02-10;0;0;0;0;0;4415163;3440227;4420;2;2991
FR;3;2022-02-11;0;0;0;0;0;4415163;3440227;4420;2;2991
FR;3;2022-02-12;0;0;0;0;0;4415163;3440227;4420;2;2991
FR;3;2022-02-13;0;0;0;0;0;4415163;3440227;4420;2;2991
FR;3;2022-02-14;0;0;0;0;0;4415163;3440227;4420;2;2991
FR;3;2022-02-15;0;0;0;0;0;4415163;3440227;4420;2;2991
FR;3;2022-02-16;0;0;0;0;0;4415163;3440227;4420;2;2991
FR;3;2022-02-17;0;0;0;0;0;4415163;3440227;4420;2;2991
FR;3;2022-02-18;0;0;0;0;0;4415163;3440227;4420;2;2991
FR;3;2022-02-19;0;0;0;0;0;4415163;3440227;4420;2;2991
FR;3;2022-02-20;0;0;0;0;0;4415163;3440227;4420;2;2991
FR;3;2022-02-21;2;0;0;0;0;4415165;3440227;4420;2;2991
FR;3;2022-02-22;0;0;0;0;0;4415165;3440227;4420;2;2991
FR;3;2022-02-23;0;0;0;0;0;4415165;3440227;4420;2;2991
FR;3;2022-02-24;0;0;0;0;0;4415165;3440227;4420;2;2991
FR;3;2022-02-25;0;0;0;0;0;4415165;3440227;4420;2;2991
FR;3;2022-02-26;0;0;0;0;0;4415165;3440227;4420;2;2991
FR;3;2022-02-27;0;0;0;0;0;4415165;3440227;4420;2;2991
FR;3;2022-02-28;1;0;0;0;0;4415166;3440227;4420;2;2991
FR;3;2022-03-01;1;0;0;0;0;4415167;3440227;4420;2;2991
FR;3;2022-03-02;0;0;0;0;0;4415167;3440227;4420;2;2991
FR;3;2022-03-03;0;0;0;0;0;4415167;3440227;4420;2;2991
FR;3;2022-03-04;0;0;0;0;0;4415167;3440227;4420;2;2991
FR;3;2022-03-05;0;0;0;0;0;4415167;3440227;4420;2;2991
FR;3;2022-03-06;1;0;0;0;0;4415168;3440227;4420;2;2991
FR;3;2022-03-07;0;0;0;0;0;4415168;3440227;4420;2;2991
FR;3;2022-03-08;1;0;0;0;0;4415169;3440227;4420;2;2991
FR;3;2022-03-09;0;0;0;0;0;4415169;3440227;4420;2;2991
FR;3;2022-03-10;0;0;0;0;0;4415169;3440227;4420;2;2991
FR;3;2022-03-11;0;0;0;0;0;4415169;3440227;4420;2;2991
FR;3;2022-03-12;0;0;0;0;0;4415169;3440227;4420;2;2991
FR;3;2022-03-13;0;0;0;0;0;4415169;3440227;4420;2;2991
FR;3;2022-03-14;0;0;0;0;0;4415169;3440227;4420;2;2991
FR;3;2022-03-15;0;0;0;0;0;4415169;3440227;4420;2;2991
FR;3;2022-03-16;0;0;0;0;0;4415169;3440227;4420;2;2991
FR;3;2022-03-17;0;0;0;0;0;4415169;3440227;4420;2;2991
FR;3;2022-03-18;0;0;0;0;0;4415169;3440227;4420;2;2991
FR;3;2022-03-19;0;0;0;0;0;4415169;3440227;4420;2;2991
FR;3;2022-03-20;1;0;0;0;0;4415170;3440227;4420;2;2991
FR;3;2022-03-21;0;0;0;0;0;4415170;3440227;4420;2;2991
FR;3;2022-03-22;0;0;0;0;0;4415170;3440227;4420;2;2991
FR;3;2022-03-23;1;0;0;0;0;4415171;3440227;4420;2;2991
FR;3;2022-03-24;0;0;0;0;0;4415171;3440227;4420;2;2991
FR;3;2022-03-25;1;0;0;0;0;4415172;3440227;4420;2;2991
FR;3;2022-03-26;0;0;0;0;0;4415172;3440227;4420;2;2991
FR;3;2022-03-27;0;0;0;0;0;4415172;3440227;4420;2;2991
FR;3;2022-03-28;0;0;0;0;0;4415172;3440227;4420;2;2991
FR;3;2022-03-29;0;0;0;0;0;4415172;3440227;4420;2;2991
FR;3;2022-03-30;0;0;0;0;0;4415172;3440227;4420;2;2991
FR;3;2022-03-31;0;0;0;0;0;4415172;3440227;4420;2;2991
FR;3;2022-04-01;0;0;0;0;0;4415172;3440227;4420;2;2991
FR;3;2022-04-02;0;0;0;0;0;4415172;3440227;4420;2;2991
FR;3;2022-04-03;0;0;0;0;0;4415172;3440227;4420;2;2991
FR;3;2022-04-04;0;0;0;0;0;4415172;3440227;4420;2;2991
FR;3;2022-04-05;0;0;0;0;0;4415172;3440227;4420;2;2991
FR;3;2022-04-06;0;0;0;0;0;4415172;3440227;4420;2;2991
FR;3;2022-04-07;0;0;0;0;0;4415172;3440227;4420;2;2991
FR;3;2022-04-08;0;0;0;0;0;4415172;3440227;4420;2;2991
FR;3;2022-04-09;0;0;0;0;0;4415172;3440227;4420;2;2991
FR;3;2022-04-10;0;0;0;0;0;4415172;3440227;4420;2;2991
FR;3;2022-04-11;0;0;0;0;0;4415172;3440227;4420;2;2991
FR;3;2022-04-12;0;0;0;0;0;4415172;3440227;4420;2;2991
FR;3;2022-04-13;0;0;0;0;0;4415172;3440227;4420;2;2991
FR;3;2022-04-14;0;0;0;0;0;4415172;3440227;4420;2;2991
FR;3;2022-04-15;1;0;0;0;0;4415173;3440227;4420;2;2991
FR;3;2022-04-16;0;0;0;0;0;4415173;3440227;4420;2;2991
FR;3;2022-04-17;0;0;0;0;0;4415173;3440227;4420;2;2991
FR;3;2022-04-18;0;0;0;0;0;4415173;3440227;4420;2;2991
FR;3;2022-04-19;0;0;0;0;0;4415173;3440227;4420;2;2991
FR;3;2022-04-20;0;0;0;0;0;4415173;3440227;4420;2;2991
FR;3;2022-04-21;0;0;0;0;0;4415173;3440227;4420;2;2991
FR;3;2022-04-22;0;0;0;0;0;4415173;3440227;4420;2;2991
FR;3;2022-04-23;0;0;0;0;0;4415173;3440227;4420;2;2991
FR;3;2022-04-24;0;0;0;0;0;4415173;3440227;4420;2;2991
FR;3;2022-04-25;0;0;0;0;0;4415173;3440227;4420;2;2991
FR;3;2022-04-26;0;0;0;0;0;4415173;3440227;4420;2;2991
FR;3;2022-04-27;0;0;0;0;0;4415173;3440227;4420;2;2991
FR;3;2022-04-28;0;0;0;0;0;4415173;3440227;4420;2;2991
FR;3;2022-04-29;0;0;0;0;0;4415173;3440227;4420;2;2991
FR;3;2022-04-30;0;0;0;0;0;4415173;3440227;4420;2;2991
FR;3;2022-05-01;0;0;0;0;0;4415173;3440227;4420;2;2991
FR;3;2022-05-02;0;0;0;0;0;4415173;3440227;4420;2;2991
FR;3;2022-05-03;0;0;0;0;0;4415173;3440227;4420;2;2991
FR;3;2022-05-04;0;0;0;0;0;4415173;3440227;4420;2;2991
FR;3;2022-05-05;0;0;0;0;0;4415173;3440227;4420;2;2991
FR;3;2022-05-06;0;0;0;0;0;4415173;3440227;4420;2;2991
FR;3;2022-05-07;0;0;0;0;0;4415173;3440227;4420;2;2991
FR;3;2022-05-08;0;0;0;0;0;4415173;3440227;4420;2;2991
FR;3;2022-05-09;0;0;0;0;0;4415173;3440227;4420;2;2991
FR;3;2022-05-10;0;0;0;0;0;4415173;3440227;4420;2;2991
FR;3;2022-05-11;0;0;0;0;0;4415173;3440227;4420;2;2991
FR;3;2022-05-12;0;0;0;0;0;4415173;3440227;4420;2;2991
FR;3;2022-05-13;0;0;0;0;0;4415173;3440227;4420;2;2991
FR;3;2022-05-14;1;0;0;0;0;4415174;3440227;4420;2;2991
FR;3;2022-05-15;0;0;0;0;0;4415174;3440227;4420;2;2991
FR;3;2022-05-16;0;0;0;0;0;4415174;3440227;4420;2;2991
FR;3;2022-05-17;0;0;0;0;0;4415174;3440227;4420;2;2991
FR;3;2022-05-18;0;0;0;0;0;4415174;3440227;4420;2;2991
FR;3;2022-05-19;0;0;0;0;0;4415174;3440227;4420;2;2991
FR;3;2022-05-20;0;0;0;0;0;4415174;3440227;4420;2;2991
FR;3;2022-05-21;0;0;0;0;0;4415174;3440227;4420;2;2991
FR;3;2022-05-22;0;0;0;0;0;4415174;3440227;4420;2;2991
FR;3;2022-05-23;0;0;0;0;0;4415174;3440227;4420;2;2991
FR;3;2022-05-24;0;0;0;0;0;4415174;3440227;4420;2;2991
FR;3;2022-05-25;0;0;0;0;0;4415174;3440227;4420;2;2991
FR;3;2022-05-26;0;0;0;0;0;4415174;3440227;4420;2;2991
FR;3;2022-05-27;0;0;0;0;0;4415174;3440227;4420;2;2991
FR;3;2022-05-28;0;0;0;0;0;4415174;3440227;4420;2;2991
FR;3;2022-05-29;0;0;0;0;0;4415174;3440227;4420;2;2991
FR;3;2022-05-30;0;0;0;0;0;4415174;3440227;4420;2;2991
FR;3;2022-05-31;0;0;0;0;0;4415174;3440227;4420;2;2991
FR;3;2022-06-01;0;0;0;0;0;4415174;3440227;4420;2;2991
FR;3;2022-06-02;0;0;0;0;0;4415174;3440227;4420;2;2991
FR;3;2022-06-03;0;0;0;0;0;4415174;3440227;4420;2;2991
FR;3;2022-06-04;0;0;0;0;0;4415174;3440227;4420;2;2991
FR;3;2022-06-05;0;0;0;0;0;4415174;3440227;4420;2;2991
FR;3;2022-06-06;0;0;0;0;0;4415174;3440227;4420;2;2991
FR;3;2022-06-07;0;0;0;0;0;4415174;3440227;4420;2;2991
FR;3;2022-06-08;0;0;0;0;0;4415174;3440227;4420;2;2991
FR;3;2022-06-09;0;0;0;0;0;4415174;3440227;4420;2;2991
FR;3;2022-06-10;0;0;0;0;0;4415174;3440227;4420;2;2991
FR;3;2022-06-11;0;0;0;0;0;4415174;3440227;4420;2;2991
FR;3;2022-06-12;0;0;0;0;0;4415174;3440227;4420;2;2991
FR;3;2022-06-13;1;0;0;0;0;4415175;3440227;4420;2;2991
FR;3;2022-06-14;0;0;0;0;0;4415175;3440227;4420;2;2991
FR;3;2022-06-15;0;0;0;0;0;4415175;3440227;4420;2;2991
FR;3;2022-06-16;0;0;0;0;0;4415175;3440227;4420;2;2991
FR;3;2022-06-17;0;0;0;0;0;4415175;3440227;4420;2;2991
FR;3;2022-06-18;0;0;0;0;0;4415175;3440227;4420;2;2991
FR;3;2022-06-19;0;0;0;0;0;4415175;3440227;4420;2;2991
FR;4;2020-12-27;0;0;0;0;0;0;0;0;0;0
FR;4;2020-12-28;0;0;0;0;0;0;0;0;0;0
FR;4;2020-12-29;0;0;0;0;0;0;0;0;0;0
FR;4;2020-12-30;0;0;0;0;0;0;0;0;0;0
FR;4;2020-12-31;0;0;0;0;0;0;0;0;0;0
FR;4;2021-01-01;0;0;0;0;0;0;0;0;0;0
FR;4;2021-01-02;0;0;0;0;0;0;0;0;0;0
FR;4;2021-01-03;0;0;0;0;0;0;0;0;0;0
FR;4;2021-01-04;0;0;0;0;0;0;0;0;0;0
FR;4;2021-01-05;0;0;0;0;0;0;0;0;0;0
FR;4;2021-01-06;0;0;0;0;0;0;0;0;0;0
FR;4;2021-01-07;0;0;0;0;0;0;0;0;0;0
FR;4;2021-01-08;0;0;0;0;0;0;0;0;0;0
FR;4;2021-01-09;0;0;0;0;0;0;0;0;0;0
FR;4;2021-01-10;0;0;0;0;0;0;0;0;0;0
FR;4;2021-01-11;0;0;0;0;0;0;0;0;0;0
FR;4;2021-01-12;0;0;0;0;0;0;0;0;0;0
FR;4;2021-01-13;0;0;0;0;0;0;0;0;0;0
FR;4;2021-01-14;0;0;0;0;0;0;0;0;0;0
FR;4;2021-01-15;0;0;0;0;0;0;0;0;0;0
FR;4;2021-01-16;0;0;0;0;0;0;0;0;0;0
FR;4;2021-01-17;0;0;0;0;0;0;0;0;0;0
FR;4;2021-01-18;0;0;0;0;0;0;0;0;0;0
FR;4;2021-01-19;0;0;0;0;0;0;0;0;0;0
FR;4;2021-01-20;0;0;0;0;0;0;0;0;0;0
FR;4;2021-01-21;0;0;0;0;0;0;0;0;0;0
FR;4;2021-01-22;0;0;0;0;0;0;0;0;0;0
FR;4;2021-01-23;0;0;0;0;0;0;0;0;0;0
FR;4;2021-01-24;0;0;0;0;0;0;0;0;0;0
FR;4;2021-01-25;0;0;0;0;0;0;0;0;0;0
FR;4;2021-01-26;0;0;0;0;0;0;0;0;0;0
FR;4;2021-01-27;0;0;0;0;0;0;0;0;0;0
FR;4;2021-01-28;0;0;0;0;0;0;0;0;0;0
FR;4;2021-01-29;0;0;0;0;0;0;0;0;0;0
FR;4;2021-01-30;0;0;0;0;0;0;0;0;0;0
FR;4;2021-01-31;0;0;0;0;0;0;0;0;0;0
FR;4;2021-02-01;0;0;0;0;0;0;0;0;0;0
FR;4;2021-02-02;0;0;0;0;0;0;0;0;0;0
FR;4;2021-02-03;0;0;0;0;0;0;0;0;0;0
FR;4;2021-02-04;0;0;0;0;0;0;0;0;0;0
FR;4;2021-02-05;0;0;0;0;0;0;0;0;0;0
FR;4;2021-02-06;0;0;0;0;0;0;0;0;0;0
FR;4;2021-02-07;0;0;0;0;0;0;0;0;0;0
FR;4;2021-02-08;0;0;0;0;0;0;0;0;0;0
FR;4;2021-02-09;0;0;0;0;0;0;0;0;0;0
FR;4;2021-02-10;0;0;0;0;0;0;0;0;0;0
FR;4;2021-02-11;0;0;0;0;0;0;0;0;0;0
FR;4;2021-02-12;0;0;0;0;0;0;0;0;0;0
FR;4;2021-02-13;0;0;0;0;0;0;0;0;0;0
FR;4;2021-02-14;0;0;0;0;0;0;0;0;0;0
FR;4;2021-02-15;0;0;0;0;0;0;0;0;0;0
FR;4;2021-02-16;0;0;0;0;0;0;0;0;0;0
FR;4;2021-02-17;0;0;0;0;0;0;0;0;0;0
FR;4;2021-02-18;0;0;0;0;0;0;0;0;0;0
FR;4;2021-02-19;0;0;0;0;0;0;0;0;0;0
FR;4;2021-02-20;0;0;0;0;0;0;0;0;0;0
FR;4;2021-02-21;0;0;0;0;0;0;0;0;0;0
FR;4;2021-02-22;0;0;0;0;0;0;0;0;0;0
FR;4;2021-02-23;0;0;0;0;0;0;0;0;0;0
FR;4;2021-02-24;0;0;0;0;0;0;0;0;0;0
FR;4;2021-02-25;0;0;0;0;0;0;0;0;0;0
FR;4;2021-02-26;0;0;0;0;0;0;0;0;0;0
FR;4;2021-02-27;0;0;0;0;0;0;0;0;0;0
FR;4;2021-02-28;0;0;0;0;0;0;0;0;0;0
FR;4;2021-03-01;0;0;0;0;0;0;0;0;0;0
FR;4;2021-03-02;0;0;0;0;0;0;0;0;0;0
FR;4;2021-03-03;0;0;0;0;0;0;0;0;0;0
FR;4;2021-03-04;0;0;0;0;0;0;0;0;0;0
FR;4;2021-03-05;0;0;0;0;0;0;0;0;0;0
FR;4;2021-03-06;0;0;0;0;0;0;0;0;0;0
FR;4;2021-03-07;0;0;0;0;0;0;0;0;0;0
FR;4;2021-03-08;0;0;0;0;0;0;0;0;0;0
FR;4;2021-03-09;0;0;0;0;0;0;0;0;0;0
FR;4;2021-03-10;0;0;0;0;0;0;0;0;0;0
FR;4;2021-03-11;0;0;0;0;0;0;0;0;0;0
FR;4;2021-03-12;0;0;0;0;0;0;0;0;0;0
FR;4;2021-03-13;0;0;0;0;0;0;0;0;0;0
FR;4;2021-03-14;0;0;0;0;0;0;0;0;0;0
FR;4;2021-03-15;0;0;0;0;0;0;0;0;0;0
FR;4;2021-03-16;0;0;0;0;0;0;0;0;0;0
FR;4;2021-03-17;0;0;0;0;0;0;0;0;0;0
FR;4;2021-03-18;0;0;0;0;0;0;0;0;0;0
FR;4;2021-03-19;0;0;0;0;0;0;0;0;0;0
FR;4;2021-03-20;0;0;0;0;0;0;0;0;0;0
FR;4;2021-03-21;0;0;0;0;0;0;0;0;0;0
FR;4;2021-03-22;0;0;0;0;0;0;0;0;0;0
FR;4;2021-03-23;0;0;0;0;0;0;0;0;0;0
FR;4;2021-03-24;0;0;0;0;0;0;0;0;0;0
FR;4;2021-03-25;0;0;0;0;0;0;0;0;0;0
FR;4;2021-03-26;0;0;0;0;0;0;0;0;0;0
FR;4;2021-03-27;0;0;0;0;0;0;0;0;0;0
FR;4;2021-03-28;0;0;0;0;0;0;0;0;0;0
FR;4;2021-03-29;0;0;0;0;0;0;0;0;0;0
FR;4;2021-03-30;0;0;0;0;0;0;0;0;0;0
FR;4;2021-03-31;0;0;0;0;0;0;0;0;0;0
FR;4;2021-04-01;0;0;0;0;0;0;0;0;0;0
FR;4;2021-04-02;0;0;0;0;0;0;0;0;0;0
FR;4;2021-04-03;0;0;0;0;0;0;0;0;0;0
FR;4;2021-04-04;0;0;0;0;0;0;0;0;0;0
FR;4;2021-04-05;0;0;0;0;0;0;0;0;0;0
FR;4;2021-04-06;0;0;0;0;0;0;0;0;0;0
FR;4;2021-04-07;0;0;0;0;0;0;0;0;0;0
FR;4;2021-04-08;0;0;0;0;0;0;0;0;0;0
FR;4;2021-04-09;0;0;0;0;0;0;0;0;0;0
FR;4;2021-04-10;0;0;0;0;0;0;0;0;0;0
FR;4;2021-04-11;0;0;0;0;0;0;0;0;0;0
FR;4;2021-04-12;0;0;0;0;0;0;0;0;0;0
FR;4;2021-04-13;0;0;0;0;0;0;0;0;0;0
FR;4;2021-04-14;0;0;0;0;0;0;0;0;0;0
FR;4;2021-04-15;0;0;0;0;0;0;0;0;0;0
FR;4;2021-04-16;0;0;0;0;0;0;0;0;0;0
FR;4;2021-04-17;0;0;0;0;0;0;0;0;0;0
FR;4;2021-04-18;0;0;0;0;0;0;0;0;0;0
FR;4;2021-04-19;0;0;0;0;0;0;0;0;0;0
FR;4;2021-04-20;0;0;0;0;0;0;0;0;0;0
FR;4;2021-04-21;0;0;0;0;0;0;0;0;0;0
FR;4;2021-04-22;0;0;0;0;0;0;0;0;0;0
FR;4;2021-04-23;3996;0;0;0;0;3996;0;0;0;0
FR;4;2021-04-24;1569;0;0;0;0;5565;0;0;0;0
FR;4;2021-04-25;125;0;0;0;0;5690;0;0;0;0
FR;4;2021-04-26;2869;1;0;0;0;8559;1;0;0;0
FR;4;2021-04-27;9518;3;0;0;0;18077;4;0;0;0
FR;4;2021-04-28;9904;6;0;0;0;27981;10;0;0;0
FR;4;2021-04-29;15990;8;0;0;0;43971;18;0;0;0
FR;4;2021-04-30;19231;10;0;0;0;63202;28;0;0;0
FR;4;2021-05-01;1994;6;0;0;0;65196;34;0;0;0
FR;4;2021-05-02;482;0;0;0;0;65678;34;0;0;0
FR;4;2021-05-03;5058;2;0;0;0;70736;36;0;0;0
FR;4;2021-05-04;8398;10;0;0;0;79134;46;0;0;0
FR;4;2021-05-05;6182;7;0;0;0;85316;53;0;0;0
FR;4;2021-05-06;11378;11;0;0;0;96694;64;0;0;0
FR;4;2021-05-07;19121;9;0;0;0;115815;73;0;0;0
FR;4;2021-05-08;2377;6;0;0;0;118192;79;0;0;0
FR;4;2021-05-09;686;3;0;0;0;118878;82;0;0;0
FR;4;2021-05-10;7240;5;1;0;0;126118;87;1;0;0
FR;4;2021-05-11;14316;12;0;0;0;140434;99;1;0;0
FR;4;2021-05-12;10164;15;0;0;0;150598;114;1;0;0
FR;4;2021-05-13;1579;3;0;0;0;152177;117;1;0;0
FR;4;2021-05-14;7760;7;0;0;0;159937;124;1;0;0
FR;4;2021-05-15;3717;8;1;0;0;163654;132;2;0;0
FR;4;2021-05-16;417;1;0;0;0;164071;133;2;0;0
FR;4;2021-05-17;4477;6;0;0;0;168548;139;2;0;0
FR;4;2021-05-18;8753;10;0;0;0;177301;149;2;0;0
FR;4;2021-05-19;5690;7;0;0;0;182991;156;2;0;0
FR;4;2021-05-20;9481;7;0;0;0;192472;163;2;0;0
FR;4;2021-05-21;12791;30;0;0;0;205263;193;2;0;0
FR;4;2021-05-22;5057;15;0;0;0;210320;208;2;0;0
FR;4;2021-05-23;494;4;0;0;0;210814;212;2;0;0
FR;4;2021-05-24;1055;7;0;0;0;211869;219;2;0;0
FR;4;2021-05-25;7620;16;0;0;0;219489;235;2;0;0
FR;4;2021-05-26;7725;16;0;0;0;227214;251;2;0;0
FR;4;2021-05-27;14328;35;0;0;0;241542;286;2;0;0
FR;4;2021-05-28;26583;82;1;0;0;268125;368;3;0;0
FR;4;2021-05-29;11380;18;0;0;0;279505;386;3;0;0
FR;4;2021-05-30;971;6;0;0;0;280476;392;3;0;0
FR;4;2021-05-31;12687;21;0;0;0;293163;413;3;0;0
FR;4;2021-06-01;20252;46;1;0;0;313415;459;4;0;0
FR;4;2021-06-02;14519;33;0;0;0;327934;492;4;0;0
FR;4;2021-06-03;19411;24;1;0;0;347345;516;5;0;0
FR;4;2021-06-04;22512;47;0;0;0;369857;563;5;0;0
FR;4;2021-06-05;9713;32;0;0;0;379570;595;5;0;0
FR;4;2021-06-06;1039;1;0;0;0;380609;596;5;0;0
FR;4;2021-06-07;9224;19;0;0;0;389833;615;5;0;0
FR;4;2021-06-08;14607;31;0;0;0;404440;646;5;0;0
FR;4;2021-06-09;12203;25;0;0;0;416643;671;5;0;0
FR;4;2021-06-10;15399;30;0;0;0;432042;701;5;0;0
FR;4;2021-06-11;16981;56;0;0;0;449023;757;5;0;0
FR;4;2021-06-12;7446;27;0;0;0;456469;784;5;0;0
FR;4;2021-06-13;907;2;0;0;0;457376;786;5;0;0
FR;4;2021-06-14;6646;26;0;0;0;464022;812;5;0;0
FR;4;2021-06-15;10881;37;0;0;0;474903;849;5;0;0
FR;4;2021-06-16;8905;15;0;0;0;483808;864;5;0;0
FR;4;2021-06-17;10896;37;0;0;0;494704;901;5;0;0
FR;4;2021-06-18;12419;45;0;0;0;507123;946;5;0;0
FR;4;2021-06-19;5567;25;0;0;0;512690;971;5;0;0
FR;4;2021-06-20;819;5;0;0;0;513509;976;5;0;0
FR;4;2021-06-21;5083;20;0;0;0;518592;996;5;0;0
FR;4;2021-06-22;7905;28;2;0;0;526497;1024;7;0;0
FR;4;2021-06-23;7094;40;2;0;0;533591;1064;9;0;0
FR;4;2021-06-24;8647;46;1;0;0;542238;1110;10;0;0
FR;4;2021-06-25;10173;39;2;0;0;552411;1149;12;0;0
FR;4;2021-06-26;4840;21;0;0;0;557251;1170;12;0;0
FR;4;2021-06-27;761;3;0;0;0;558012;1173;12;0;0
FR;4;2021-06-28;4822;16;1;0;0;562834;1189;13;0;0
FR;4;2021-06-29;7101;27;2;0;0;569935;1216;15;0;0
FR;4;2021-06-30;6709;39;2;0;0;576644;1255;17;0;0
FR;4;2021-07-01;8193;40;0;0;0;584837;1295;17;0;0
FR;4;2021-07-02;9413;52;1;0;0;594250;1347;18;0;0
FR;4;2021-07-03;4845;19;0;0;0;599095;1366;18;0;0
FR;4;2021-07-04;686;5;0;0;0;599781;1371;18;0;0
FR;4;2021-07-05;4768;19;2;0;0;604549;1390;20;0;0
FR;4;2021-07-06;7718;28;4;0;0;612267;1418;24;0;0
FR;4;2021-07-07;7071;34;2;0;0;619338;1452;26;0;0
FR;4;2021-07-08;9222;40;2;0;0;628560;1492;28;0;0
FR;4;2021-07-09;10276;34;1;0;0;638836;1526;29;0;0
FR;4;2021-07-10;4635;14;2;0;0;643471;1540;31;0;0
FR;4;2021-07-11;582;4;1;0;0;644053;1544;32;0;0
FR;4;2021-07-12;5868;29;0;0;0;649921;1573;32;0;0
FR;4;2021-07-13;14229;29;0;0;0;664150;1602;32;0;0
FR;4;2021-07-14;2284;15;0;0;0;666434;1617;32;0;0
FR;4;2021-07-15;18234;36;0;0;0;684668;1653;32;0;0
FR;4;2021-07-16;22820;70;2;0;0;707488;1723;34;0;0
FR;4;2021-07-17;9735;20;0;0;0;717223;1743;34;0;0
FR;4;2021-07-18;1354;4;0;0;0;718577;1747;34;0;0
FR;4;2021-07-19;12983;28;1;0;0;731560;1775;35;0;0
FR;4;2021-07-20;17334;26;1;0;0;748894;1801;36;0;0
FR;4;2021-07-21;15607;33;0;0;0;764501;1834;36;0;0
FR;4;2021-07-22;18238;44;2;0;0;782739;1878;38;0;0
FR;4;2021-07-23;20407;57;7;0;0;803146;1935;45;0;0
FR;4;2021-07-24;9281;32;0;0;0;812427;1967;45;0;0
FR;4;2021-07-25;1350;8;0;0;0;813777;1975;45;0;0
FR;4;2021-07-26;11032;20;0;0;0;824809;1995;45;0;0
FR;4;2021-07-27;14664;35;3;0;0;839473;2030;48;0;0
FR;4;2021-07-28;12925;26;2;0;0;852398;2056;50;0;0
FR;4;2021-07-29;14080;54;4;0;0;866478;2110;54;0;0
FR;4;2021-07-30;15482;45;2;0;0;881960;2155;56;0;0
FR;4;2021-07-31;6833;14;2;0;0;888793;2169;58;0;0
FR;4;2021-08-01;904;1;0;0;0;889697;2170;58;0;0
FR;4;2021-08-02;7906;29;0;0;0;897603;2199;58;0;0
FR;4;2021-08-03;10790;32;2;0;0;908393;2231;60;0;0
FR;4;2021-08-04;9735;29;0;0;0;918128;2260;60;0;0
FR;4;2021-08-05;9815;41;0;0;0;927943;2301;60;0;0
FR;4;2021-08-06;10189;30;3;0;0;938132;2331;63;0;0
FR;4;2021-08-07;5092;30;1;0;0;943224;2361;64;0;0
FR;4;2021-08-08;1218;13;0;0;0;944442;2374;64;0;0
FR;4;2021-08-09;6334;31;0;0;0;950776;2405;64;0;0
FR;4;2021-08-10;8744;18;0;0;0;959520;2423;64;0;0
FR;4;2021-08-11;7932;33;4;0;0;967452;2456;68;0;0
FR;4;2021-08-12;8583;30;1;0;0;976035;2486;69;0;0
FR;4;2021-08-13;7547;24;0;1;0;983582;2510;69;1;0
FR;4;2021-08-14;3787;20;0;0;0;987369;2530;69;1;0
FR;4;2021-08-15;769;5;0;0;0;988138;2535;69;1;0
FR;4;2021-08-16;4005;17;0;0;0;992143;2552;69;1;0
FR;4;2021-08-17;5619;17;1;0;0;997762;2569;70;1;0
FR;4;2021-08-18;5165;35;0;0;0;1002927;2604;70;1;0
FR;4;2021-08-19;5479;33;3;0;0;1008406;2637;73;1;0
FR;4;2021-08-20;5211;24;1;0;0;1013617;2661;74;1;0
FR;4;2021-08-21;2309;21;1;0;0;1015926;2682;75;1;0
FR;4;2021-08-22;401;2;0;0;0;1016327;2684;75;1;0
FR;4;2021-08-23;2926;19;1;0;0;1019253;2703;76;1;0
FR;4;2021-08-24;3749;15;0;0;0;1023002;2718;76;1;0
FR;4;2021-08-25;3539;25;0;0;0;1026541;2743;76;1;0
FR;4;2021-08-26;3704;20;2;0;0;1030245;2763;78;1;0
FR;4;2021-08-27;3606;31;2;0;0;1033851;2794;80;1;0
FR;4;2021-08-28;1725;9;1;0;0;1035576;2803;81;1;0
FR;4;2021-08-29;387;7;1;0;0;1035963;2810;82;1;0
FR;4;2021-08-30;2009;25;0;0;15;1037972;2835;82;1;15
FR;4;2021-08-31;2482;20;0;0;13;1040454;2855;82;1;28
FR;4;2021-09-01;2078;38;1;0;21;1042532;2893;83;1;49
FR;4;2021-09-02;2302;31;4;0;18;1044834;2924;87;1;67
FR;4;2021-09-03;2357;44;5;0;32;1047191;2968;92;1;99
FR;4;2021-09-04;1373;17;0;0;8;1048564;2985;92;1;107
FR;4;2021-09-05;432;2;0;0;2;1048996;2987;92;1;109
FR;4;2021-09-06;1708;60;0;0;21;1050704;3047;92;1;130
FR;4;2021-09-07;1675;18;1;0;9;1052379;3065;93;1;139
FR;4;2021-09-08;1280;27;3;1;20;1053659;3092;96;2;159
FR;4;2021-09-09;1386;23;2;0;9;1055045;3115;98;2;168
FR;4;2021-09-10;1517;31;2;0;23;1056562;3146;100;2;191
FR;4;2021-09-11;742;11;0;0;3;1057304;3157;100;2;194
FR;4;2021-09-12;168;4;0;0;2;1057472;3161;100;2;196
FR;4;2021-09-13;1316;22;1;0;16;1058788;3183;101;2;212
FR;4;2021-09-14;1497;9;2;0;6;1060285;3192;103;2;218
FR;4;2021-09-15;1092;27;1;0;24;1061377;3219;104;2;242
FR;4;2021-09-16;1098;22;2;0;15;1062475;3241;106;2;257
FR;4;2021-09-17;890;21;1;0;12;1063365;3262;107;2;269
FR;4;2021-09-18;462;6;1;0;5;1063827;3268;108;2;274
FR;4;2021-09-19;181;3;0;0;2;1064008;3271;108;2;276
FR;4;2021-09-20;450;19;0;0;13;1064458;3290;108;2;289
FR;4;2021-09-21;423;11;0;0;7;1064881;3301;108;2;296
FR;4;2021-09-22;372;19;2;0;13;1065253;3320;110;2;309
FR;4;2021-09-23;477;16;1;0;15;1065730;3336;111;2;324
FR;4;2021-09-24;409;13;2;0;9;1066139;3349;113;2;333
FR;4;2021-09-25;281;9;1;0;4;1066420;3358;114;2;337
FR;4;2021-09-26;73;2;0;0;1;1066493;3360;114;2;338
FR;4;2021-09-27;262;10;1;0;8;1066755;3370;115;2;346
FR;4;2021-09-28;315;8;0;0;8;1067070;3378;115;2;354
FR;4;2021-09-29;373;18;1;0;12;1067443;3396;116;2;366
FR;4;2021-09-30;360;40;0;0;21;1067803;3436;116;2;387
FR;4;2021-10-01;408;49;0;0;43;1068211;3485;116;2;430
FR;4;2021-10-02;195;22;1;0;13;1068406;3507;117;2;443
FR;4;2021-10-03;85;1;0;0;0;1068491;3508;117;2;443
FR;4;2021-10-04;356;19;1;0;15;1068847;3527;118;2;458
FR;4;2021-10-05;277;19;2;0;15;1069124;3546;120;2;473
FR;4;2021-10-06;245;21;1;0;17;1069369;3567;121;2;490
FR;4;2021-10-07;258;25;2;0;13;1069627;3592;123;2;503
FR;4;2021-10-08;353;23;2;0;19;1069980;3615;125;2;522
FR;4;2021-10-09;193;6;6;0;7;1070173;3621;131;2;529
FR;4;2021-10-10;95;3;2;0;3;1070268;3624;133;2;532
FR;4;2021-10-11;247;15;1;0;14;1070515;3639;134;2;546
FR;4;2021-10-12;205;14;0;0;13;1070720;3653;134;2;559
FR;4;2021-10-13;219;27;1;0;24;1070939;3680;135;2;583
FR;4;2021-10-14;307;21;4;0;15;1071246;3701;139;2;598
FR;4;2021-10-15;321;24;5;0;25;1071567;3725;144;2;623
FR;4;2021-10-16;166;6;2;0;6;1071733;3731;146;2;629
FR;4;2021-10-17;70;2;0;0;1;1071803;3733;146;2;630
FR;4;2021-10-18;278;16;1;0;12;1072081;3749;147;2;642
FR;4;2021-10-19;210;14;2;0;15;1072291;3763;149;2;657
FR;4;2021-10-20;226;27;4;0;15;1072517;3790;153;2;672
FR;4;2021-10-21;236;17;0;0;13;1072753;3807;153;2;685
FR;4;2021-10-22;211;25;2;0;20;1072964;3832;155;2;705
FR;4;2021-10-23;115;16;1;0;15;1073079;3848;156;2;720
FR;4;2021-10-24;38;4;0;0;1;1073117;3852;156;2;721
FR;4;2021-10-25;210;7;2;0;9;1073327;3859;158;2;730
FR;4;2021-10-26;196;14;0;0;12;1073523;3873;158;2;742
FR;4;2021-10-27;192;11;4;0;11;1073715;3884;162;2;753
FR;4;2021-10-28;182;18;4;0;21;1073897;3902;166;2;774
FR;4;2021-10-29;220;15;2;0;13;1074117;3917;168;2;787
FR;4;2021-10-30;102;2;1;0;2;1074219;3919;169;2;789
FR;4;2021-10-31;56;3;2;0;3;1074275;3922;171;2;792
FR;4;2021-11-01;75;27;4;0;24;1074350;3949;175;2;816
FR;4;2021-11-02;156;20;2;0;21;1074506;3969;177;2;837
FR;4;2021-11-03;128;20;8;1;18;1074634;3989;185;3;855
FR;4;2021-11-04;178;15;1;0;12;1074812;4004;186;3;867
FR;4;2021-11-05;128;17;1;0;16;1074940;4021;187;3;883
FR;4;2021-11-06;77;6;1;0;6;1075017;4027;188;3;889
FR;4;2021-11-07;76;2;2;0;4;1075093;4029;190;3;893
FR;4;2021-11-08;158;20;1;0;20;1075251;4049;191;3;913
FR;4;2021-11-09;151;14;3;0;16;1075402;4063;194;3;929
FR;4;2021-11-10;115;29;6;0;31;1075517;4092;200;3;960
FR;4;2021-11-11;88;10;0;0;10;1075605;4102;200;3;970
FR;4;2021-11-12;101;19;2;0;18;1075706;4121;202;3;988
FR;4;2021-11-13;73;15;2;0;14;1075779;4136;204;3;1002
FR;4;2021-11-14;53;5;3;0;7;1075832;4141;207;3;1009
FR;4;2021-11-15;98;26;2;0;24;1075930;4167;209;3;1033
FR;4;2021-11-16;102;12;2;0;14;1076032;4179;211;3;1047
FR;4;2021-11-17;117;29;4;0;29;1076149;4208;215;3;1076
FR;4;2021-11-18;100;34;12;0;41;1076249;4242;227;3;1117
FR;4;2021-11-19;80;19;3;0;20;1076329;4261;230;3;1137
FR;4;2021-11-20;75;8;1;0;8;1076404;4269;231;3;1145
FR;4;2021-11-21;61;7;2;0;9;1076465;4276;233;3;1154
FR;4;2021-11-22;102;27;7;0;30;1076567;4303;240;3;1184
FR;4;2021-11-23;74;29;5;0;26;1076641;4332;245;3;1210
FR;4;2021-11-24;85;23;9;0;22;1076726;4355;254;3;1232
FR;4;2021-11-25;85;28;14;0;30;1076811;4383;268;3;1262
FR;4;2021-11-26;81;43;12;0;45;1076892;4426;280;3;1307
FR;4;2021-11-27;35;22;15;0;25;1076927;4448;295;3;1332
FR;4;2021-11-28;48;8;0;0;7;1076975;4456;295;3;1339
FR;4;2021-11-29;86;31;15;0;39;1077061;4487;310;3;1378
FR;4;2021-11-30;72;36;12;0;40;1077133;4523;322;3;1418
FR;4;2021-12-01;81;59;19;0;66;1077214;4582;341;3;1484
FR;4;2021-12-02;99;48;19;0;53;1077313;4630;360;3;1537
FR;4;2021-12-03;98;36;15;0;44;1077411;4666;375;3;1581
FR;4;2021-12-04;70;31;18;0;44;1077481;4697;393;3;1625
FR;4;2021-12-05;61;5;1;0;6;1077542;4702;394;3;1631
FR;4;2021-12-06;100;46;20;0;60;1077642;4748;414;3;1691
FR;4;2021-12-07;80;34;9;0;34;1077722;4782;423;3;1725
FR;4;2021-12-08;67;29;16;0;35;1077789;4811;439;3;1760
FR;4;2021-12-09;61;32;10;0;38;1077850;4843;449;3;1798
FR;4;2021-12-10;60;63;21;0;67;1077910;4906;470;3;1865
FR;4;2021-12-11;24;34;7;0;34;1077934;4940;477;3;1899
FR;4;2021-12-12;23;10;3;0;13;1077957;4950;480;3;1912
FR;4;2021-12-13;68;38;13;0;47;1078025;4988;493;3;1959
FR;4;2021-12-14;57;43;15;0;52;1078082;5031;508;3;2011
FR;4;2021-12-15;60;63;28;0;83;1078142;5094;536;3;2094
FR;4;2021-12-16;31;44;19;0;57;1078173;5138;555;3;2151
FR;4;2021-12-17;39;55;12;0;60;1078212;5193;567;3;2211
FR;4;2021-12-18;48;29;2;0;30;1078260;5222;569;3;2241
FR;4;2021-12-19;15;4;1;0;4;1078275;5226;570;3;2245
FR;4;2021-12-20;37;38;10;0;41;1078312;5264;580;3;2286
FR;4;2021-12-21;26;30;15;0;36;1078338;5294;595;3;2322
FR;4;2021-12-22;36;36;10;0;37;1078374;5330;605;3;2359
FR;4;2021-12-23;39;43;8;0;47;1078413;5373;613;3;2406
FR;4;2021-12-24;23;26;10;0;30;1078436;5399;623;3;2436
FR;4;2021-12-25;6;3;3;0;4;1078442;5402;626;3;2440
FR;4;2021-12-26;4;3;1;0;2;1078446;5405;627;3;2442
FR;4;2021-12-27;27;41;8;0;42;1078473;5446;635;3;2484
FR;4;2021-12-28;24;28;7;0;29;1078497;5474;642;3;2513
FR;4;2021-12-29;48;25;10;0;29;1078545;5499;652;3;2542
FR;4;2021-12-30;41;16;12;0;19;1078586;5515;664;3;2561
FR;4;2021-12-31;18;5;8;0;10;1078604;5520;672;3;2571
FR;4;2022-01-01;5;4;4;0;6;1078609;5524;676;3;2577
FR;4;2022-01-02;40;4;15;0;18;1078649;5528;691;3;2595
FR;4;2022-01-03;39;52;20;1;57;1078688;5580;711;4;2652
FR;4;2022-01-04;31;26;13;0;29;1078719;5606;724;4;2681
FR;4;2022-01-05;46;21;16;0;22;1078765;5627;740;4;2703
FR;4;2022-01-06;46;20;22;0;34;1078811;5647;762;4;2737
FR;4;2022-01-07;28;19;15;0;19;1078839;5666;777;4;2756
FR;4;2022-01-08;8;5;10;0;12;1078847;5671;787;4;2768
FR;4;2022-01-09;17;2;2;0;3;1078864;5673;789;4;2771
FR;4;2022-01-10;40;22;17;0;34;1078904;5695;806;4;2805
FR;4;2022-01-11;24;30;12;0;34;1078928;5725;818;4;2839
FR;4;2022-01-12;31;21;12;0;22;1078959;5746;830;4;2861
FR;4;2022-01-13;48;19;26;0;36;1079007;5765;856;4;2897
FR;4;2022-01-14;23;28;13;0;31;1079030;5793;869;4;2928
FR;4;2022-01-15;10;6;7;0;11;1079040;5799;876;4;2939
FR;4;2022-01-16;9;9;11;0;19;1079049;5808;887;4;2958
FR;4;2022-01-17;23;18;12;0;24;1079072;5826;899;4;2982
FR;4;2022-01-18;16;13;8;0;18;1079088;5839;907;4;3000
FR;4;2022-01-19;29;23;9;0;30;1079117;5862;916;4;3030
FR;4;2022-01-20;31;34;11;0;37;1079148;5896;927;4;3067
FR;4;2022-01-21;9;12;19;1;16;1079157;5908;946;5;3083
FR;4;2022-01-22;30;9;2;0;9;1079187;5917;948;5;3092
FR;4;2022-01-23;6;2;4;0;6;1079193;5919;952;5;3098
FR;4;2022-01-24;14;21;8;0;27;1079207;5940;960;5;3125
FR;4;2022-01-25;20;30;8;1;34;1079227;5970;968;6;3159
FR;4;2022-01-26;19;14;6;1;15;1079246;5984;974;7;3174
FR;4;2022-01-27;19;18;6;0;22;1079265;6002;980;7;3196
FR;4;2022-01-28;12;23;7;0;25;1079277;6025;987;7;3221
FR;4;2022-01-29;16;6;4;0;9;1079293;6031;991;7;3230
FR;4;2022-01-30;16;2;1;0;3;1079309;6033;992;7;3233
FR;4;2022-01-31;19;27;7;0;30;1079328;6060;999;7;3263
FR;4;2022-02-01;9;19;11;0;19;1079337;6079;1010;7;3282
FR;4;2022-02-02;17;11;10;2;16;1079354;6090;1020;9;3298
FR;4;2022-02-03;12;22;9;0;25;1079366;6112;1029;9;3323
FR;4;2022-02-04;6;5;7;0;9;1079372;6117;1036;9;3332
FR;4;2022-02-05;6;14;1;0;13;1079378;6131;1037;9;3345
FR;4;2022-02-06;5;2;2;0;3;1079383;6133;1039;9;3348
FR;4;2022-02-07;13;19;7;0;19;1079396;6152;1046;9;3367
FR;4;2022-02-08;15;19;13;1;20;1079411;6171;1059;10;3387
FR;4;2022-02-09;15;11;7;0;14;1079426;6182;1066;10;3401
FR;4;2022-02-10;18;23;9;0;24;1079444;6205;1075;10;3425
FR;4;2022-02-11;18;14;8;0;19;1079462;6219;1083;10;3444
FR;4;2022-02-12;23;6;1;0;5;1079485;6225;1084;10;3449
FR;4;2022-02-13;7;3;3;0;6;1079492;6228;1087;10;3455
FR;4;2022-02-14;18;10;7;0;13;1079510;6238;1094;10;3468
FR;4;2022-02-15;16;7;1;0;7;1079526;6245;1095;10;3475
FR;4;2022-02-16;11;9;10;0;15;1079537;6254;1105;10;3490
FR;4;2022-02-17;10;4;4;0;6;1079547;6258;1109;10;3496
FR;4;2022-02-18;17;13;6;0;17;1079564;6271;1115;10;3513
FR;4;2022-02-19;16;2;2;0;4;1079580;6273;1117;10;3517
FR;4;2022-02-20;7;2;0;0;1;1079587;6275;1117;10;3518
FR;4;2022-02-21;22;3;3;0;4;1079609;6278;1120;10;3522
FR;4;2022-02-22;8;4;8;0;8;1079617;6282;1128;10;3530
FR;4;2022-02-23;16;6;9;0;9;1079633;6288;1137;10;3539
FR;4;2022-02-24;9;5;2;0;5;1079642;6293;1139;10;3544
FR;4;2022-02-25;15;5;7;0;6;1079657;6298;1146;10;3550
FR;4;2022-02-26;26;3;0;0;3;1079683;6301;1146;10;3553
FR;4;2022-02-27;9;0;1;0;1;1079692;6301;1147;10;3554
FR;4;2022-02-28;14;3;2;0;3;1079706;6304;1149;10;3557
FR;4;2022-03-01;6;2;7;0;3;1079712;6306;1156;10;3560
FR;4;2022-03-02;12;2;3;0;4;1079724;6308;1159;10;3564
FR;4;2022-03-03;16;5;1;0;4;1079740;6313;1160;10;3568
FR;4;2022-03-04;6;7;2;1;5;1079746;6320;1162;11;3573
FR;4;2022-03-05;9;2;0;0;2;1079755;6322;1162;11;3575
FR;4;2022-03-06;4;0;1;0;1;1079759;6322;1163;11;3576
FR;4;2022-03-07;10;4;1;0;3;1079769;6326;1164;11;3579
FR;4;2022-03-08;13;2;0;0;2;1079782;6328;1164;11;3581
FR;4;2022-03-09;8;3;2;0;4;1079790;6331;1166;11;3585
FR;4;2022-03-10;5;1;5;0;2;1079795;6332;1171;11;3587
FR;4;2022-03-11;8;2;5;0;1;1079803;6334;1176;11;3588
FR;4;2022-03-12;9;2;0;0;0;1079812;6336;1176;11;3588
FR;4;2022-03-13;5;1;1;0;2;1079817;6337;1177;11;3590
FR;4;2022-03-14;4;1;0;0;1;1079821;6338;1177;11;3591
FR;4;2022-03-15;6;3;1;0;1;1079827;6341;1178;11;3592
FR;4;2022-03-16;7;3;3;0;3;1079834;6344;1181;11;3595
FR;4;2022-03-17;2;4;1;0;5;1079836;6348;1182;11;3600
FR;4;2022-03-18;7;3;0;0;3;1079843;6351;1182;11;3603
FR;4;2022-03-19;1;1;0;0;1;1079844;6352;1182;11;3604
FR;4;2022-03-20;2;0;2;0;1;1079846;6352;1184;11;3605
FR;4;2022-03-21;5;3;0;0;3;1079851;6355;1184;11;3608
FR;4;2022-03-22;3;2;1;0;2;1079854;6357;1185;11;3610
FR;4;2022-03-23;6;4;4;0;7;1079860;6361;1189;11;3617
FR;4;2022-03-24;2;4;3;1;5;1079862;6365;1192;12;3622
FR;4;2022-03-25;3;1;2;0;1;1079865;6366;1194;12;3623
FR;4;2022-03-26;5;5;0;0;5;1079870;6371;1194;12;3628
FR;4;2022-03-27;1;0;1;0;0;1079871;6371;1195;12;3628
FR;4;2022-03-28;4;1;3;0;3;1079875;6372;1198;12;3631
FR;4;2022-03-29;7;0;4;1;0;1079882;6372;1202;13;3631
FR;4;2022-03-30;1;4;0;0;4;1079883;6376;1202;13;3635
FR;4;2022-03-31;1;3;1;1;3;1079884;6379;1203;14;3638
FR;4;2022-04-01;13;2;5;0;5;1079897;6381;1208;14;3643
FR;4;2022-04-02;4;4;0;0;3;1079901;6385;1208;14;3646
FR;4;2022-04-03;0;0;0;0;0;1079901;6385;1208;14;3646
FR;4;2022-04-04;3;3;3;0;3;1079904;6388;1211;14;3649
FR;4;2022-04-05;3;3;1;1;2;1079907;6391;1212;15;3651
FR;4;2022-04-06;3;0;0;0;0;1079910;6391;1212;15;3651
FR;4;2022-04-07;3;2;1;2;3;1079913;6393;1213;17;3654
FR;4;2022-04-08;4;1;1;0;1;1079917;6394;1214;17;3655
FR;4;2022-04-09;0;0;1;1;1;1079917;6394;1215;18;3656
FR;4;2022-04-10;1;2;0;0;2;1079918;6396;1215;18;3658
FR;4;2022-04-11;3;2;4;0;4;1079921;6398;1219;18;3662
FR;4;2022-04-12;3;1;4;0;2;1079924;6399;1223;18;3664
FR;4;2022-04-13;4;7;1;0;8;1079928;6406;1224;18;3672
FR;4;2022-04-14;5;3;1;1;3;1079933;6409;1225;19;3675
FR;4;2022-04-15;5;7;1;0;8;1079938;6416;1226;19;3683
FR;4;2022-04-16;1;0;0;0;0;1079939;6416;1226;19;3683
FR;4;2022-04-17;1;1;0;0;1;1079940;6417;1226;19;3684
FR;4;2022-04-18;1;2;4;0;2;1079941;6419;1230;19;3686
FR;4;2022-04-19;2;0;1;0;0;1079943;6419;1231;19;3686
FR;4;2022-04-20;13;4;1;0;3;1079956;6423;1232;19;3689
FR;4;2022-04-21;5;1;0;0;1;1079961;6424;1232;19;3690
FR;4;2022-04-22;1;0;1;0;0;1079962;6424;1233;19;3690
FR;4;2022-04-23;1;3;2;0;5;1079963;6427;1235;19;3695
FR;4;2022-04-24;0;2;0;0;2;1079963;6429;1235;19;3697
FR;4;2022-04-25;3;4;3;0;7;1079966;6433;1238;19;3704
FR;4;2022-04-26;3;4;1;0;4;1079969;6437;1239;19;3708
FR;4;2022-04-27;4;0;0;0;0;1079973;6437;1239;19;3708
FR;4;2022-04-28;2;5;5;0;6;1079975;6442;1244;19;3714
FR;4;2022-04-29;3;2;0;0;1;1079978;6444;1244;19;3715
FR;4;2022-04-30;0;1;1;0;2;1079978;6445;1245;19;3717
FR;4;2022-05-01;0;0;0;0;0;1079978;6445;1245;19;3717
FR;4;2022-05-02;4;10;6;0;13;1079982;6455;1251;19;3730
FR;4;2022-05-03;0;3;1;0;3;1079982;6458;1252;19;3733
FR;4;2022-05-04;6;4;1;0;4;1079988;6462;1253;19;3737
FR;4;2022-05-05;2;1;1;0;1;1079990;6463;1254;19;3738
FR;4;2022-05-06;2;1;1;0;1;1079992;6464;1255;19;3739
FR;4;2022-05-07;0;0;0;0;0;1079992;6464;1255;19;3739
FR;4;2022-05-08;1;1;0;0;1;1079993;6465;1255;19;3740
FR;4;2022-05-09;5;0;0;0;0;1079998;6465;1255;19;3740
FR;4;2022-05-10;0;1;0;2;3;1079998;6466;1255;21;3743
FR;4;2022-05-11;2;2;1;0;3;1080000;6468;1256;21;3746
FR;4;2022-05-12;5;1;1;1;2;1080005;6469;1257;22;3748
FR;4;2022-05-13;0;0;2;0;2;1080005;6469;1259;22;3750
FR;4;2022-05-14;0;2;0;0;2;1080005;6471;1259;22;3752
FR;4;2022-05-15;1;2;0;0;0;1080006;6473;1259;22;3752
FR;4;2022-05-16;5;2;1;0;2;1080011;6475;1260;22;3754
FR;4;2022-05-17;3;1;1;0;2;1080014;6476;1261;22;3756
FR;4;2022-05-18;0;3;0;0;3;1080014;6479;1261;22;3759
FR;4;2022-05-19;2;1;2;0;2;1080016;6480;1263;22;3761
FR;4;2022-05-20;2;0;3;0;0;1080018;6480;1266;22;3761
FR;4;2022-05-21;2;0;1;0;1;1080020;6480;1267;22;3762
FR;4;2022-05-22;0;0;1;0;1;1080020;6480;1268;22;3763
FR;4;2022-05-23;0;0;2;0;0;1080020;6480;1270;22;3763
FR;4;2022-05-24;1;1;0;0;1;1080021;6481;1270;22;3764
FR;4;2022-05-25;1;2;0;0;0;1080022;6483;1270;22;3764
FR;4;2022-05-26;1;0;0;0;0;1080023;6483;1270;22;3764
FR;4;2022-05-27;0;0;0;0;0;1080023;6483;1270;22;3764
FR;4;2022-05-28;1;0;0;0;0;1080024;6483;1270;22;3764
FR;4;2022-05-29;0;0;0;0;0;1080024;6483;1270;22;3764
FR;4;2022-05-30;2;2;2;0;3;1080026;6485;1272;22;3767
FR;4;2022-05-31;2;0;0;0;0;1080028;6485;1272;22;3767
FR;4;2022-06-01;0;5;1;0;5;1080028;6490;1273;22;3772
FR;4;2022-06-02;1;1;0;0;1;1080029;6491;1273;22;3773
FR;4;2022-06-03;0;4;1;1;4;1080029;6495;1274;23;3777
FR;4;2022-06-04;0;1;0;0;1;1080029;6496;1274;23;3778
FR;4;2022-06-05;0;0;0;0;0;1080029;6496;1274;23;3778
FR;4;2022-06-06;1;1;0;0;1;1080030;6497;1274;23;3779
FR;4;2022-06-07;2;0;0;1;0;1080032;6497;1274;24;3779
FR;4;2022-06-08;0;2;0;0;2;1080032;6499;1274;24;3781
FR;4;2022-06-09;1;0;0;0;0;1080033;6499;1274;24;3781
FR;4;2022-06-10;0;0;2;0;1;1080033;6499;1276;24;3782
FR;4;2022-06-11;0;0;0;0;0;1080033;6499;1276;24;3782
FR;4;2022-06-12;1;0;0;0;0;1080034;6499;1276;24;3782
FR;4;2022-06-13;3;0;1;0;1;1080037;6499;1277;24;3783
FR;4;2022-06-14;3;2;0;0;2;1080040;6501;1277;24;3785
FR;4;2022-06-15;2;0;0;0;0;1080042;6501;1277;24;3785
FR;4;2022-06-16;0;2;0;1;1;1080042;6503;1277;25;3786
FR;4;2022-06-17;2;0;0;0;0;1080044;6503;1277;25;3786
FR;4;2022-06-18;0;0;0;0;0;1080044;6503;1277;25;3786
FR;4;2022-06-19;0;0;0;0;0;1080044;6503;1277;25;3786
FR;5;2020-12-27;0;0;0;0;0;0;0;0;0;0
FR;5;2020-12-28;0;0;0;0;0;0;0;0;0;0
FR;5;2020-12-29;0;0;0;0;0;0;0;0;0;0
FR;5;2020-12-30;0;0;0;0;0;0;0;0;0;0
FR;5;2020-12-31;0;0;0;0;0;0;0;0;0;0
FR;5;2021-01-01;0;0;0;0;0;0;0;0;0;0
FR;5;2021-01-02;0;0;0;0;0;0;0;0;0;0
FR;5;2021-01-03;0;0;0;0;0;0;0;0;0;0
FR;5;2021-01-04;0;0;0;0;0;0;0;0;0;0
FR;5;2021-01-05;0;0;0;0;0;0;0;0;0;0
FR;5;2021-01-06;0;0;0;0;0;0;0;0;0;0
FR;5;2021-01-07;0;0;0;0;0;0;0;0;0;0
FR;5;2021-01-08;0;0;0;0;0;0;0;0;0;0
FR;5;2021-01-09;0;0;0;0;0;0;0;0;0;0
FR;5;2021-01-10;0;0;0;0;0;0;0;0;0;0
FR;5;2021-01-11;0;0;0;0;0;0;0;0;0;0
FR;5;2021-01-12;0;0;0;0;0;0;0;0;0;0
FR;5;2021-01-13;0;0;0;0;0;0;0;0;0;0
FR;5;2021-01-14;0;0;0;0;0;0;0;0;0;0
FR;5;2021-01-15;0;0;0;0;0;0;0;0;0;0
FR;5;2021-01-16;0;0;0;0;0;0;0;0;0;0
FR;5;2021-01-17;0;0;0;0;0;0;0;0;0;0
FR;5;2021-01-18;0;0;0;0;0;0;0;0;0;0
FR;5;2021-01-19;0;0;0;0;0;0;0;0;0;0
FR;5;2021-01-20;0;0;0;0;0;0;0;0;0;0
FR;5;2021-01-21;0;0;0;0;0;0;0;0;0;0
FR;5;2021-01-22;0;0;0;0;0;0;0;0;0;0
FR;5;2021-01-23;0;0;0;0;0;0;0;0;0;0
FR;5;2021-01-24;0;0;0;0;0;0;0;0;0;0
FR;5;2021-01-25;0;0;0;0;0;0;0;0;0;0
FR;5;2021-01-26;0;0;0;0;0;0;0;0;0;0
FR;5;2021-01-27;0;0;0;0;0;0;0;0;0;0
FR;5;2021-01-28;0;0;0;0;0;0;0;0;0;0
FR;5;2021-01-29;0;0;0;0;0;0;0;0;0;0
FR;5;2021-01-30;0;0;0;0;0;0;0;0;0;0
FR;5;2021-01-31;0;0;0;0;0;0;0;0;0;0
FR;5;2021-02-01;0;0;0;0;0;0;0;0;0;0
FR;5;2021-02-02;0;0;0;0;0;0;0;0;0;0
FR;5;2021-02-03;0;0;0;0;0;0;0;0;0;0
FR;5;2021-02-04;0;0;0;0;0;0;0;0;0;0
FR;5;2021-02-05;0;0;0;0;0;0;0;0;0;0
FR;5;2021-02-06;0;0;0;0;0;0;0;0;0;0
FR;5;2021-02-07;0;0;0;0;0;0;0;0;0;0
FR;5;2021-02-08;0;0;0;0;0;0;0;0;0;0
FR;5;2021-02-09;0;0;0;0;0;0;0;0;0;0
FR;5;2021-02-10;0;0;0;0;0;0;0;0;0;0
FR;5;2021-02-11;0;0;0;0;0;0;0;0;0;0
FR;5;2021-02-12;0;0;0;0;0;0;0;0;0;0
FR;5;2021-02-13;0;0;0;0;0;0;0;0;0;0
FR;5;2021-02-14;0;0;0;0;0;0;0;0;0;0
FR;5;2021-02-15;0;0;0;0;0;0;0;0;0;0
FR;5;2021-02-16;0;0;0;0;0;0;0;0;0;0
FR;5;2021-02-17;0;0;0;0;0;0;0;0;0;0
FR;5;2021-02-18;0;0;0;0;0;0;0;0;0;0
FR;5;2021-02-19;0;0;0;0;0;0;0;0;0;0
FR;5;2021-02-20;0;0;0;0;0;0;0;0;0;0
FR;5;2021-02-21;0;0;0;0;0;0;0;0;0;0
FR;5;2021-02-22;0;0;0;0;0;0;0;0;0;0
FR;5;2021-02-23;0;0;0;0;0;0;0;0;0;0
FR;5;2021-02-24;0;0;0;0;0;0;0;0;0;0
FR;5;2021-02-25;0;0;0;0;0;0;0;0;0;0
FR;5;2021-02-26;0;0;0;0;0;0;0;0;0;0
FR;5;2021-02-27;0;0;0;0;0;0;0;0;0;0
FR;5;2021-02-28;0;0;0;0;0;0;0;0;0;0
FR;5;2021-03-01;0;0;0;0;0;0;0;0;0;0
FR;5;2021-03-02;0;0;0;0;0;0;0;0;0;0
FR;5;2021-03-03;0;0;0;0;0;0;0;0;0;0
FR;5;2021-03-04;0;0;0;0;0;0;0;0;0;0
FR;5;2021-03-05;0;0;0;0;0;0;0;0;0;0
FR;5;2021-03-06;0;0;0;0;0;0;0;0;0;0
FR;5;2021-03-07;0;0;0;0;0;0;0;0;0;0
FR;5;2021-03-08;0;0;0;0;0;0;0;0;0;0
FR;5;2021-03-09;0;0;0;0;0;0;0;0;0;0
FR;5;2021-03-10;0;0;0;0;0;0;0;0;0;0
FR;5;2021-03-11;0;0;0;0;0;0;0;0;0;0
FR;5;2021-03-12;0;0;0;0;0;0;0;0;0;0
FR;5;2021-03-13;0;0;0;0;0;0;0;0;0;0
FR;5;2021-03-14;0;0;0;0;0;0;0;0;0;0
FR;5;2021-03-15;0;0;0;0;0;0;0;0;0;0
FR;5;2021-03-16;0;0;0;0;0;0;0;0;0;0
FR;5;2021-03-17;0;0;0;0;0;0;0;0;0;0
FR;5;2021-03-18;0;0;0;0;0;0;0;0;0;0
FR;5;2021-03-19;0;0;0;0;0;0;0;0;0;0
FR;5;2021-03-20;0;0;0;0;0;0;0;0;0;0
FR;5;2021-03-21;0;0;0;0;0;0;0;0;0;0
FR;5;2021-03-22;0;0;0;0;0;0;0;0;0;0
FR;5;2021-03-23;0;0;0;0;0;0;0;0;0;0
FR;5;2021-03-24;0;0;0;0;0;0;0;0;0;0
FR;5;2021-03-25;0;0;0;0;0;0;0;0;0;0
FR;5;2021-03-26;0;0;0;0;0;0;0;0;0;0
FR;5;2021-03-27;0;0;0;0;0;0;0;0;0;0
FR;5;2021-03-28;0;0;0;0;0;0;0;0;0;0
FR;5;2021-03-29;0;0;0;0;0;0;0;0;0;0
FR;5;2021-03-30;0;0;0;0;0;0;0;0;0;0
FR;5;2021-03-31;0;0;0;0;0;0;0;0;0;0
FR;5;2021-04-01;0;0;0;0;0;0;0;0;0;0
FR;5;2021-04-02;0;0;0;0;0;0;0;0;0;0
FR;5;2021-04-03;0;0;0;0;0;0;0;0;0;0
FR;5;2021-04-04;0;0;0;0;0;0;0;0;0;0
FR;5;2021-04-05;0;0;0;0;0;0;0;0;0;0
FR;5;2021-04-06;0;0;0;0;0;0;0;0;0;0
FR;5;2021-04-07;0;0;0;0;0;0;0;0;0;0
FR;5;2021-04-08;0;0;0;0;0;0;0;0;0;0
FR;5;2021-04-09;0;0;0;0;0;0;0;0;0;0
FR;5;2021-04-10;0;0;0;0;0;0;0;0;0;0
FR;5;2021-04-11;0;0;0;0;0;0;0;0;0;0
FR;5;2021-04-12;0;0;0;0;0;0;0;0;0;0
FR;5;2021-04-13;0;0;0;0;0;0;0;0;0;0
FR;5;2021-04-14;0;0;0;0;0;0;0;0;0;0
FR;5;2021-04-15;0;0;0;0;0;0;0;0;0;0
FR;5;2021-04-16;0;0;0;0;0;0;0;0;0;0
FR;5;2021-04-17;0;0;0;0;0;0;0;0;0;0
FR;5;2021-04-18;0;0;0;0;0;0;0;0;0;0
FR;5;2021-04-19;0;0;0;0;0;0;0;0;0;0
FR;5;2021-04-20;0;0;0;0;0;0;0;0;0;0
FR;5;2021-04-21;0;0;0;0;0;0;0;0;0;0
FR;5;2021-04-22;0;0;0;0;0;0;0;0;0;0
FR;5;2021-04-23;0;0;0;0;0;0;0;0;0;0
FR;5;2021-04-24;0;0;0;0;0;0;0;0;0;0
FR;5;2021-04-25;0;0;0;0;0;0;0;0;0;0
FR;5;2021-04-26;0;0;0;0;0;0;0;0;0;0
FR;5;2021-04-27;0;0;0;0;0;0;0;0;0;0
FR;5;2021-04-28;0;0;0;0;0;0;0;0;0;0
FR;5;2021-04-29;0;0;0;0;0;0;0;0;0;0
FR;5;2021-04-30;0;0;0;0;0;0;0;0;0;0
FR;5;2021-05-01;0;0;0;0;0;0;0;0;0;0
FR;5;2021-05-02;0;0;0;0;0;0;0;0;0;0
FR;5;2021-05-03;0;0;0;0;0;0;0;0;0;0
FR;5;2021-05-04;0;0;0;0;0;0;0;0;0;0
FR;5;2021-05-05;0;0;0;0;0;0;0;0;0;0
FR;5;2021-05-06;0;0;0;0;0;0;0;0;0;0
FR;5;2021-05-07;0;0;0;0;0;0;0;0;0;0
FR;5;2021-05-08;0;0;0;0;0;0;0;0;0;0
FR;5;2021-05-09;0;0;0;0;0;0;0;0;0;0
FR;5;2021-05-10;0;0;0;0;0;0;0;0;0;0
FR;5;2021-05-11;0;0;0;0;0;0;0;0;0;0
FR;5;2021-05-12;0;0;0;0;0;0;0;0;0;0
FR;5;2021-05-13;0;0;0;0;0;0;0;0;0;0
FR;5;2021-05-14;0;0;0;0;0;0;0;0;0;0
FR;5;2021-05-15;0;0;0;0;0;0;0;0;0;0
FR;5;2021-05-16;0;0;0;0;0;0;0;0;0;0
FR;5;2021-05-17;0;0;0;0;0;0;0;0;0;0
FR;5;2021-05-18;0;0;0;0;0;0;0;0;0;0
FR;5;2021-05-19;0;0;0;0;0;0;0;0;0;0
FR;5;2021-05-20;0;0;0;0;0;0;0;0;0;0
FR;5;2021-05-21;0;0;0;0;0;0;0;0;0;0
FR;5;2021-05-22;0;0;0;0;0;0;0;0;0;0
FR;5;2021-05-23;0;0;0;0;0;0;0;0;0;0
FR;5;2021-05-24;0;0;0;0;0;0;0;0;0;0
FR;5;2021-05-25;0;0;0;0;0;0;0;0;0;0
FR;5;2021-05-26;0;0;0;0;0;0;0;0;0;0
FR;5;2021-05-27;0;0;0;0;0;0;0;0;0;0
FR;5;2021-05-28;0;0;0;0;0;0;0;0;0;0
FR;5;2021-05-29;0;0;0;0;0;0;0;0;0;0
FR;5;2021-05-30;0;0;0;0;0;0;0;0;0;0
FR;5;2021-05-31;0;0;0;0;0;0;0;0;0;0
FR;5;2021-06-01;0;0;0;0;0;0;0;0;0;0
FR;5;2021-06-02;0;0;0;0;0;0;0;0;0;0
FR;5;2021-06-03;0;0;0;0;0;0;0;0;0;0
FR;5;2021-06-04;0;0;0;0;0;0;0;0;0;0
FR;5;2021-06-05;0;0;0;0;0;0;0;0;0;0
FR;5;2021-06-06;0;0;0;0;0;0;0;0;0;0
FR;5;2021-06-07;0;0;0;0;0;0;0;0;0;0
FR;5;2021-06-08;0;0;0;0;0;0;0;0;0;0
FR;5;2021-06-09;0;0;0;0;0;0;0;0;0;0
FR;5;2021-06-10;0;0;0;0;0;0;0;0;0;0
FR;5;2021-06-11;0;0;0;0;0;0;0;0;0;0
FR;5;2021-06-12;0;0;0;0;0;0;0;0;0;0
FR;5;2021-06-13;0;0;0;0;0;0;0;0;0;0
FR;5;2021-06-14;0;0;0;0;0;0;0;0;0;0
FR;5;2021-06-15;0;0;0;0;0;0;0;0;0;0
FR;5;2021-06-16;0;0;0;0;0;0;0;0;0;0
FR;5;2021-06-17;0;0;0;0;0;0;0;0;0;0
FR;5;2021-06-18;0;0;0;0;0;0;0;0;0;0
FR;5;2021-06-19;0;0;0;0;0;0;0;0;0;0
FR;5;2021-06-20;0;0;0;0;0;0;0;0;0;0
FR;5;2021-06-21;0;0;0;0;0;0;0;0;0;0
FR;5;2021-06-22;0;0;0;0;0;0;0;0;0;0
FR;5;2021-06-23;0;0;0;0;0;0;0;0;0;0
FR;5;2021-06-24;0;0;0;0;0;0;0;0;0;0
FR;5;2021-06-25;0;0;0;0;0;0;0;0;0;0
FR;5;2021-06-26;0;0;0;0;0;0;0;0;0;0
FR;5;2021-06-27;0;0;0;0;0;0;0;0;0;0
FR;5;2021-06-28;0;0;0;0;0;0;0;0;0;0
FR;5;2021-06-29;0;0;0;0;0;0;0;0;0;0
FR;5;2021-06-30;0;0;0;0;0;0;0;0;0;0
FR;5;2021-07-01;0;0;0;0;0;0;0;0;0;0
FR;5;2021-07-02;0;0;0;0;0;0;0;0;0;0
FR;5;2021-07-03;0;0;0;0;0;0;0;0;0;0
FR;5;2021-07-04;0;0;0;0;0;0;0;0;0;0
FR;5;2021-07-05;0;0;0;0;0;0;0;0;0;0
FR;5;2021-07-06;0;0;0;0;0;0;0;0;0;0
FR;5;2021-07-07;0;0;0;0;0;0;0;0;0;0
FR;5;2021-07-08;0;0;0;0;0;0;0;0;0;0
FR;5;2021-07-09;0;0;0;0;0;0;0;0;0;0
FR;5;2021-07-10;0;0;0;0;0;0;0;0;0;0
FR;5;2021-07-11;0;0;0;0;0;0;0;0;0;0
FR;5;2021-07-12;0;0;0;0;0;0;0;0;0;0
FR;5;2021-07-13;0;0;0;0;0;0;0;0;0;0
FR;5;2021-07-14;0;0;0;0;0;0;0;0;0;0
FR;5;2021-07-15;0;0;0;0;0;0;0;0;0;0
FR;5;2021-07-16;0;0;0;0;0;0;0;0;0;0
FR;5;2021-07-17;0;0;0;0;0;0;0;0;0;0
FR;5;2021-07-18;0;0;0;0;0;0;0;0;0;0
FR;5;2021-07-19;0;0;0;0;0;0;0;0;0;0
FR;5;2021-07-20;0;0;0;0;0;0;0;0;0;0
FR;5;2021-07-21;0;0;0;0;0;0;0;0;0;0
FR;5;2021-07-22;0;0;0;0;0;0;0;0;0;0
FR;5;2021-07-23;0;0;0;0;0;0;0;0;0;0
FR;5;2021-07-24;0;0;0;0;0;0;0;0;0;0
FR;5;2021-07-25;0;0;0;0;0;0;0;0;0;0
FR;5;2021-07-26;0;0;0;0;0;0;0;0;0;0
FR;5;2021-07-27;0;0;0;0;0;0;0;0;0;0
FR;5;2021-07-28;0;0;0;0;0;0;0;0;0;0
FR;5;2021-07-29;0;0;0;0;0;0;0;0;0;0
FR;5;2021-07-30;0;0;0;0;0;0;0;0;0;0
FR;5;2021-07-31;0;0;0;0;0;0;0;0;0;0
FR;5;2021-08-01;0;0;0;0;0;0;0;0;0;0
FR;5;2021-08-02;0;0;0;0;0;0;0;0;0;0
FR;5;2021-08-03;0;0;0;0;0;0;0;0;0;0
FR;5;2021-08-04;0;0;0;0;0;0;0;0;0;0
FR;5;2021-08-05;0;0;0;0;0;0;0;0;0;0
FR;5;2021-08-06;0;0;0;0;0;0;0;0;0;0
FR;5;2021-08-07;0;0;0;0;0;0;0;0;0;0
FR;5;2021-08-08;0;0;0;0;0;0;0;0;0;0
FR;5;2021-08-09;0;0;0;0;0;0;0;0;0;0
FR;5;2021-08-10;0;0;0;0;0;0;0;0;0;0
FR;5;2021-08-11;0;0;0;0;0;0;0;0;0;0
FR;5;2021-08-12;0;0;0;0;0;0;0;0;0;0
FR;5;2021-08-13;0;0;0;0;0;0;0;0;0;0
FR;5;2021-08-14;0;0;0;0;0;0;0;0;0;0
FR;5;2021-08-15;0;0;0;0;0;0;0;0;0;0
FR;5;2021-08-16;0;0;0;0;0;0;0;0;0;0
FR;5;2021-08-17;0;0;0;0;0;0;0;0;0;0
FR;5;2021-08-18;0;0;0;0;0;0;0;0;0;0
FR;5;2021-08-19;0;0;0;0;0;0;0;0;0;0
FR;5;2021-08-20;0;0;0;0;0;0;0;0;0;0
FR;5;2021-08-21;0;0;0;0;0;0;0;0;0;0
FR;5;2021-08-22;0;0;0;0;0;0;0;0;0;0
FR;5;2021-08-23;0;0;0;0;0;0;0;0;0;0
FR;5;2021-08-24;0;0;0;0;0;0;0;0;0;0
FR;5;2021-08-25;0;0;0;0;0;0;0;0;0;0
FR;5;2021-08-26;0;0;0;0;0;0;0;0;0;0
FR;5;2021-08-27;0;0;0;0;0;0;0;0;0;0
FR;5;2021-08-28;0;0;0;0;0;0;0;0;0;0
FR;5;2021-08-29;0;0;0;0;0;0;0;0;0;0
FR;5;2021-08-30;0;0;0;0;0;0;0;0;0;0
FR;5;2021-08-31;0;0;0;0;0;0;0;0;0;0
FR;5;2021-09-01;0;0;0;0;0;0;0;0;0;0
FR;5;2021-09-02;0;0;0;0;0;0;0;0;0;0
FR;5;2021-09-03;0;0;0;0;0;0;0;0;0;0
FR;5;2021-09-04;0;0;0;0;0;0;0;0;0;0
FR;5;2021-09-05;0;0;0;0;0;0;0;0;0;0
FR;5;2021-09-06;0;0;0;0;0;0;0;0;0;0
FR;5;2021-09-07;0;0;0;0;0;0;0;0;0;0
FR;5;2021-09-08;0;0;0;0;0;0;0;0;0;0
FR;5;2021-09-09;0;0;0;0;0;0;0;0;0;0
FR;5;2021-09-10;0;0;0;0;0;0;0;0;0;0
FR;5;2021-09-11;0;0;0;0;0;0;0;0;0;0
FR;5;2021-09-12;0;0;0;0;0;0;0;0;0;0
FR;5;2021-09-13;0;0;0;0;0;0;0;0;0;0
FR;5;2021-09-14;0;0;0;0;0;0;0;0;0;0
FR;5;2021-09-15;0;0;0;0;0;0;0;0;0;0
FR;5;2021-09-16;0;0;0;0;0;0;0;0;0;0
FR;5;2021-09-17;0;0;0;0;0;0;0;0;0;0
FR;5;2021-09-18;0;0;0;0;0;0;0;0;0;0
FR;5;2021-09-19;0;0;0;0;0;0;0;0;0;0
FR;5;2021-09-20;0;0;0;0;0;0;0;0;0;0
FR;5;2021-09-21;0;0;0;0;0;0;0;0;0;0
FR;5;2021-09-22;0;0;0;0;0;0;0;0;0;0
FR;5;2021-09-23;0;0;0;0;0;0;0;0;0;0
FR;5;2021-09-24;0;0;0;0;0;0;0;0;0;0
FR;5;2021-09-25;0;0;0;0;0;0;0;0;0;0
FR;5;2021-09-26;0;0;0;0;0;0;0;0;0;0
FR;5;2021-09-27;0;0;0;0;0;0;0;0;0;0
FR;5;2021-09-28;0;0;0;0;0;0;0;0;0;0
FR;5;2021-09-29;0;0;0;0;0;0;0;0;0;0
FR;5;2021-09-30;0;0;0;0;0;0;0;0;0;0
FR;5;2021-10-01;0;0;0;0;0;0;0;0;0;0
FR;5;2021-10-02;0;0;0;0;0;0;0;0;0;0
FR;5;2021-10-03;0;0;0;0;0;0;0;0;0;0
FR;5;2021-10-04;0;0;0;0;0;0;0;0;0;0
FR;5;2021-10-05;0;0;0;0;0;0;0;0;0;0
FR;5;2021-10-06;0;0;0;0;0;0;0;0;0;0
FR;5;2021-10-07;0;0;0;0;0;0;0;0;0;0
FR;5;2021-10-08;0;0;0;0;0;0;0;0;0;0
FR;5;2021-10-09;0;0;0;0;0;0;0;0;0;0
FR;5;2021-10-10;0;0;0;0;0;0;0;0;0;0
FR;5;2021-10-11;0;0;0;0;0;0;0;0;0;0
FR;5;2021-10-12;0;0;0;0;0;0;0;0;0;0
FR;5;2021-10-13;0;0;0;0;0;0;0;0;0;0
FR;5;2021-10-14;0;0;0;0;0;0;0;0;0;0
FR;5;2021-10-15;0;0;0;0;0;0;0;0;0;0
FR;5;2021-10-16;0;0;0;0;0;0;0;0;0;0
FR;5;2021-10-17;0;0;0;0;0;0;0;0;0;0
FR;5;2021-10-18;0;0;0;0;0;0;0;0;0;0
FR;5;2021-10-19;0;0;0;0;0;0;0;0;0;0
FR;5;2021-10-20;0;0;0;0;0;0;0;0;0;0
FR;5;2021-10-21;0;0;0;0;0;0;0;0;0;0
FR;5;2021-10-22;0;0;0;0;0;0;0;0;0;0
FR;5;2021-10-23;0;0;0;0;0;0;0;0;0;0
FR;5;2021-10-24;0;0;0;0;0;0;0;0;0;0
FR;5;2021-10-25;0;0;0;0;0;0;0;0;0;0
FR;5;2021-10-26;0;0;0;0;0;0;0;0;0;0
FR;5;2021-10-27;0;0;0;0;0;0;0;0;0;0
FR;5;2021-10-28;0;0;0;0;0;0;0;0;0;0
FR;5;2021-10-29;0;0;0;0;0;0;0;0;0;0
FR;5;2021-10-30;0;0;0;0;0;0;0;0;0;0
FR;5;2021-10-31;0;0;0;0;0;0;0;0;0;0
FR;5;2021-11-01;0;0;0;0;0;0;0;0;0;0
FR;5;2021-11-02;0;0;0;0;0;0;0;0;0;0
FR;5;2021-11-03;0;0;0;0;0;0;0;0;0;0
FR;5;2021-11-04;0;0;0;0;0;0;0;0;0;0
FR;5;2021-11-05;0;0;0;0;0;0;0;0;0;0
FR;5;2021-11-06;0;0;0;0;0;0;0;0;0;0
FR;5;2021-11-07;0;0;0;0;0;0;0;0;0;0
FR;5;2021-11-08;0;0;0;0;0;0;0;0;0;0
FR;5;2021-11-09;0;0;0;0;0;0;0;0;0;0
FR;5;2021-11-10;0;0;0;0;0;0;0;0;0;0
FR;5;2021-11-11;0;0;0;0;0;0;0;0;0;0
FR;5;2021-11-12;0;0;0;0;0;0;0;0;0;0
FR;5;2021-11-13;0;0;0;0;0;0;0;0;0;0
FR;5;2021-11-14;0;0;0;0;0;0;0;0;0;0
FR;5;2021-11-15;0;0;0;0;0;0;0;0;0;0
FR;5;2021-11-16;0;0;0;0;0;0;0;0;0;0
FR;5;2021-11-17;0;0;0;0;0;0;0;0;0;0
FR;5;2021-11-18;0;0;0;0;0;0;0;0;0;0
FR;5;2021-11-19;0;0;0;0;0;0;0;0;0;0
FR;5;2021-11-20;0;0;0;0;0;0;0;0;0;0
FR;5;2021-11-21;0;0;0;0;0;0;0;0;0;0
FR;5;2021-11-22;0;0;0;0;0;0;0;0;0;0
FR;5;2021-11-23;0;0;0;0;0;0;0;0;0;0
FR;5;2021-11-24;0;0;0;0;0;0;0;0;0;0
FR;5;2021-11-25;0;0;0;0;0;0;0;0;0;0
FR;5;2021-11-26;0;0;0;0;0;0;0;0;0;0
FR;5;2021-11-27;0;0;0;0;0;0;0;0;0;0
FR;5;2021-11-28;0;0;0;0;0;0;0;0;0;0
FR;5;2021-11-29;0;0;0;0;0;0;0;0;0;0
FR;5;2021-11-30;0;0;0;0;0;0;0;0;0;0
FR;5;2021-12-01;0;0;0;0;0;0;0;0;0;0
FR;5;2021-12-02;0;0;0;0;0;0;0;0;0;0
FR;5;2021-12-03;0;0;0;0;0;0;0;0;0;0
FR;5;2021-12-04;0;0;0;0;0;0;0;0;0;0
FR;5;2021-12-05;0;0;0;0;0;0;0;0;0;0
FR;5;2021-12-06;0;0;0;0;0;0;0;0;0;0
FR;5;2021-12-07;0;0;0;0;0;0;0;0;0;0
FR;5;2021-12-08;0;0;0;0;0;0;0;0;0;0
FR;5;2021-12-09;0;0;0;0;0;0;0;0;0;0
FR;5;2021-12-10;0;0;0;0;0;0;0;0;0;0
FR;5;2021-12-11;0;0;0;0;0;0;0;0;0;0
FR;5;2021-12-12;0;0;0;0;0;0;0;0;0;0
FR;5;2021-12-13;0;0;0;0;0;0;0;0;0;0
FR;5;2021-12-14;29;45;77;0;88;29;45;77;0;88
FR;5;2021-12-15;196;44;37;0;49;225;89;114;0;137
FR;5;2021-12-16;181;21;44;0;48;406;110;158;0;185
FR;5;2021-12-17;310;16;72;0;74;716;126;230;0;259
FR;5;2021-12-18;765;24;22;0;29;1481;150;252;0;288
FR;5;2021-12-19;586;15;15;0;17;2067;165;267;0;305
FR;5;2021-12-20;1223;31;35;0;38;3290;196;302;0;343
FR;5;2021-12-21;1536;22;54;1;60;4826;218;356;1;403
FR;5;2021-12-22;4069;40;37;0;46;8895;258;393;1;449
FR;5;2021-12-23;3042;16;21;0;25;11937;274;414;1;474
FR;5;2021-12-24;759;19;9;0;15;12696;293;423;1;489
FR;5;2021-12-25;61;5;1;0;2;12757;298;424;1;491
FR;5;2021-12-26;623;6;3;0;4;13380;304;427;1;495
FR;5;2021-12-27;4080;25;21;0;23;17460;329;448;1;518
FR;5;2021-12-28;5203;23;41;1;43;22663;352;489;2;561
FR;5;2021-12-29;8106;34;66;2;69;30769;386;555;4;630
FR;5;2021-12-30;5173;18;33;0;39;35942;404;588;4;669
FR;5;2021-12-31;1553;8;10;0;11;37495;412;598;4;680
FR;5;2022-01-01;185;2;2;0;3;37680;414;600;4;683
FR;5;2022-01-02;1489;1;1;0;1;39169;415;601;4;684
FR;5;2022-01-03;3059;36;33;0;32;42228;451;634;4;716
FR;5;2022-01-04;3034;39;33;0;42;45262;490;667;4;758
FR;5;2022-01-05;19323;203;97;1;108;64585;693;764;5;866
FR;5;2022-01-06;3742;133;122;0;142;68327;826;886;5;1008
FR;5;2022-01-07;5007;200;48;2;56;73334;1026;934;7;1064
FR;5;2022-01-08;13658;514;45;0;52;86992;1540;979;7;1116
FR;5;2022-01-09;5755;399;15;0;20;92747;1939;994;7;1136
FR;5;2022-01-10;3453;326;25;0;29;96200;2265;1019;7;1165
FR;5;2022-01-11;3668;284;38;0;41;99868;2549;1057;7;1206
FR;5;2022-01-12;22653;3003;90;0;113;122521;5552;1147;7;1319
FR;5;2022-01-13;4035;622;30;0;32;126556;6174;1177;7;1351
FR;5;2022-01-14;4843;581;44;0;51;131399;6755;1221;7;1402
FR;5;2022-01-15;14683;1746;38;3;49;146082;8501;1259;10;1451
FR;5;2022-01-16;4727;666;3;0;5;150809;9167;1262;10;1456
FR;5;2022-01-17;2294;715;26;0;29;153103;9882;1288;10;1485
FR;5;2022-01-18;2430;870;30;0;40;155533;10752;1318;10;1525
FR;5;2022-01-19;18482;6422;74;2;142;174015;17174;1392;12;1667
FR;5;2022-01-20;1920;1067;25;0;34;175935;18241;1417;12;1701
FR;5;2022-01-21;3076;1371;47;1;59;179011;19612;1464;13;1760
FR;5;2022-01-22;10721;3454;33;1;43;189732;23066;1497;14;1803
FR;5;2022-01-23;2629;1415;5;0;9;192361;24481;1502;14;1812
FR;5;2022-01-24;1159;1340;19;0;23;193520;25821;1521;14;1835
FR;5;2022-01-25;1219;1548;19;2;29;194739;27369;1540;16;1864
FR;5;2022-01-26;10751;12025;50;1;89;205490;39394;1590;17;1953
FR;5;2022-01-27;1291;1693;10;0;17;206781;41087;1600;17;1970
FR;5;2022-01-28;1695;3347;16;0;19;208476;44434;1616;17;1989
FR;5;2022-01-29;6237;8040;68;0;96;214713;52474;1684;17;2085
FR;5;2022-01-30;1509;2950;5;0;18;216222;55424;1689;17;2103
FR;5;2022-01-31;588;1773;23;0;24;216810;57197;1712;17;2127
FR;5;2022-02-01;712;1703;10;0;15;217522;58900;1722;17;2142
FR;5;2022-02-02;6957;15654;52;0;94;224479;74554;1774;17;2236
FR;5;2022-02-03;490;1690;14;0;13;224969;76244;1788;17;2249
FR;5;2022-02-04;943;3001;19;0;31;225912;79245;1807;17;2280
FR;5;2022-02-05;3533;8916;23;0;37;229445;88161;1830;17;2317
FR;5;2022-02-06;737;2397;10;0;19;230182;90558;1840;17;2336
FR;5;2022-02-07;883;1596;22;0;24;231065;92154;1862;17;2360
FR;5;2022-02-08;722;1285;18;0;20;231787;93439;1880;17;2380
FR;5;2022-02-09;4536;12876;44;0;76;236323;106315;1924;17;2456
FR;5;2022-02-10;646;1059;14;0;15;236969;107374;1938;17;2471
FR;5;2022-02-11;793;2026;16;0;21;237762;109400;1954;17;2492
FR;5;2022-02-12;2285;6811;33;0;53;240047;116211;1987;17;2545
FR;5;2022-02-13;465;1540;8;0;8;240512;117751;1995;17;2553
FR;5;2022-02-14;678;1288;10;0;13;241190;119039;2005;17;2566
FR;5;2022-02-15;482;885;9;0;14;241672;119924;2014;17;2580
FR;5;2022-02-16;2980;9123;41;1;58;244652;129047;2055;18;2638
FR;5;2022-02-17;435;805;6;0;7;245087;129852;2061;18;2645
FR;5;2022-02-18;649;1407;13;0;17;245736;131259;2074;18;2662
FR;5;2022-02-19;1372;4315;16;0;28;247108;135574;2090;18;2690
FR;5;2022-02-20;247;879;6;0;8;247355;136453;2096;18;2698
FR;5;2022-02-21;221;607;2;0;4;247576;137060;2098;18;2702
FR;5;2022-02-22;260;545;17;0;17;247836;137605;2115;18;2719
FR;5;2022-02-23;1908;6924;22;1;42;249744;144529;2137;19;2761
FR;5;2022-02-24;182;374;6;1;7;249926;144903;2143;20;2768
FR;5;2022-02-25;336;949;13;0;12;250262;145852;2156;20;2780
FR;5;2022-02-26;972;3069;10;0;14;251234;148921;2166;20;2794
FR;5;2022-02-27;149;506;0;0;3;251383;149427;2166;20;2797
FR;5;2022-02-28;162;369;1;0;1;251545;149796;2167;20;2798
FR;5;2022-03-01;129;279;6;0;7;251674;150075;2173;20;2805
FR;5;2022-03-02;1240;4153;28;3;40;252914;154228;2201;23;2845
FR;5;2022-03-03;121;251;6;0;10;253035;154479;2207;23;2855
FR;5;2022-03-04;194;488;13;0;14;253229;154967;2220;23;2869
FR;5;2022-03-05;676;1990;8;0;16;253905;156957;2228;23;2885
FR;5;2022-03-06;108;260;0;0;0;254013;157217;2228;23;2885
FR;5;2022-03-07;71;228;5;0;3;254084;157445;2233;23;2888
FR;5;2022-03-08;46;130;7;1;7;254130;157575;2240;24;2895
FR;5;2022-03-09;909;3076;24;0;36;255039;160651;2264;24;2931
FR;5;2022-03-10;82;200;8;0;11;255121;160851;2272;24;2942
FR;5;2022-03-11;147;369;13;1;15;255268;161220;2285;25;2957
FR;5;2022-03-12;758;1613;13;1;30;256026;162833;2298;26;2987
FR;5;2022-03-13;76;100;0;0;0;256102;162933;2298;26;2987
FR;5;2022-03-14;67;119;7;1;7;256169;163052;2305;27;2994
FR;5;2022-03-15;83;99;3;0;6;256252;163151;2308;27;3000
FR;5;2022-03-16;883;1826;15;3;36;257135;164977;2323;30;3036
FR;5;2022-03-17;66;123;8;4;10;257201;165100;2331;34;3046
FR;5;2022-03-18;172;318;13;4;18;257373;165418;2344;38;3064
FR;5;2022-03-19;750;1162;12;5;33;258123;166580;2356;43;3097
FR;5;2022-03-20;45;93;1;0;1;258168;166673;2357;43;3098
FR;5;2022-03-21;71;120;10;6;15;258239;166793;2367;49;3113
FR;5;2022-03-22;56;119;8;8;9;258295;166912;2375;57;3122
FR;5;2022-03-23;804;1461;14;8;36;259099;168373;2389;65;3158
FR;5;2022-03-24;69;93;8;7;7;259168;168466;2397;72;3165
FR;5;2022-03-25;222;291;14;8;18;259390;168757;2411;80;3183
FR;5;2022-03-26;707;853;12;5;26;260097;169610;2423;85;3209
FR;5;2022-03-27;74;80;0;0;3;260171;169690;2423;85;3212
FR;5;2022-03-28;81;91;1;2;3;260252;169781;2424;87;3215
FR;5;2022-03-29;71;82;10;4;12;260323;169863;2434;91;3227
FR;5;2022-03-30;823;1115;16;13;29;261146;170978;2450;104;3256
FR;5;2022-03-31;102;125;1;4;6;261248;171103;2451;108;3262
FR;5;2022-04-01;107;86;7;12;11;261355;171189;2458;120;3273
FR;5;2022-04-02;329;349;3;3;15;261684;171538;2461;123;3288
FR;5;2022-04-03;54;59;1;0;1;261738;171597;2462;123;3289
FR;5;2022-04-04;38;57;4;1;8;261776;171654;2466;124;3297
FR;5;2022-04-05;51;60;6;7;9;261827;171714;2472;131;3306
FR;5;2022-04-06;421;439;7;15;16;262248;172153;2479;146;3322
FR;5;2022-04-07;45;68;5;7;7;262293;172221;2484;153;3329
FR;5;2022-04-08;133;110;12;14;15;262426;172331;2496;167;3344
FR;5;2022-04-09;308;323;2;5;17;262734;172654;2498;172;3361
FR;5;2022-04-10;43;31;2;0;2;262777;172685;2500;172;3363
FR;5;2022-04-11;50;60;3;2;4;262827;172745;2503;174;3367
FR;5;2022-04-12;57;54;3;3;5;262884;172799;2506;177;3372
FR;5;2022-04-13;382;413;3;8;16;263266;173212;2509;185;3388
FR;5;2022-04-14;48;48;5;5;9;263314;173260;2514;190;3397
FR;5;2022-04-15;91;109;3;5;5;263405;173369;2517;195;3402
FR;5;2022-04-16;188;184;2;1;13;263593;173553;2519;196;3415
FR;5;2022-04-17;12;10;1;0;1;263605;173563;2520;196;3416
FR;5;2022-04-18;8;9;2;0;2;263613;173572;2522;196;3418
FR;5;2022-04-19;73;70;6;1;6;263686;173642;2528;197;3424
FR;5;2022-04-20;360;349;9;6;12;264046;173991;2537;203;3436
FR;5;2022-04-21;42;64;9;10;12;264088;174055;2546;213;3448
FR;5;2022-04-22;113;96;5;4;5;264201;174151;2551;217;3453
FR;5;2022-04-23;209;192;3;2;10;264410;174343;2554;219;3463
FR;5;2022-04-24;37;35;0;0;3;264447;174378;2554;219;3466
FR;5;2022-04-25;69;65;1;1;4;264516;174443;2555;220;3470
FR;5;2022-04-26;60;62;2;1;5;264576;174505;2557;221;3475
FR;5;2022-04-27;335;316;2;7;14;264911;174821;2559;228;3489
FR;5;2022-04-28;80;54;4;5;8;264991;174875;2563;233;3497
FR;5;2022-04-29;117;83;5;18;12;265108;174958;2568;251;3509
FR;5;2022-04-30;182;115;2;3;10;265290;175073;2570;254;3519
FR;5;2022-05-01;11;7;0;0;0;265301;175080;2570;254;3519
FR;5;2022-05-02;51;27;4;5;2;265352;175107;2574;259;3521
FR;5;2022-05-03;83;55;2;5;11;265435;175162;2576;264;3532
FR;5;2022-05-04;277;204;1;2;7;265712;175366;2577;266;3539
FR;5;2022-05-05;62;32;2;4;4;265774;175398;2579;270;3543
FR;5;2022-05-06;105;64;2;3;5;265879;175462;2581;273;3548
FR;5;2022-05-07;171;115;3;10;13;266050;175577;2584;283;3561
FR;5;2022-05-08;8;8;0;0;2;266058;175585;2584;283;3563
FR;5;2022-05-09;44;32;15;3;16;266102;175617;2599;286;3579
FR;5;2022-05-10;54;49;3;4;5;266156;175666;2602;290;3584
FR;5;2022-05-11;326;236;12;7;21;266482;175902;2614;297;3605
FR;5;2022-05-12;46;34;1;3;2;266528;175936;2615;300;3607
FR;5;2022-05-13;109;83;3;8;9;266637;176019;2618;308;3616
FR;5;2022-05-14;208;131;0;1;8;266845;176150;2618;309;3624
FR;5;2022-05-15;22;7;2;0;1;266867;176157;2620;309;3625
FR;5;2022-05-16;52;34;4;5;4;266919;176191;2624;314;3629
FR;5;2022-05-17;72;40;5;0;2;266991;176231;2629;314;3631
FR;5;2022-05-18;289;214;4;4;8;267280;176445;2633;318;3639
FR;5;2022-05-19;44;35;5;3;3;267324;176480;2638;321;3642
FR;5;2022-05-20;74;62;3;10;1;267398;176542;2641;331;3643
FR;5;2022-05-21;241;166;2;3;17;267639;176708;2643;334;3660
FR;5;2022-05-22;20;14;2;5;2;267659;176722;2645;339;3662
FR;5;2022-05-23;42;28;4;3;6;267701;176750;2649;342;3668
FR;5;2022-05-24;45;45;3;2;5;267746;176795;2652;344;3673
FR;5;2022-05-25;326;254;4;1;16;268072;177049;2656;345;3689
FR;5;2022-05-26;16;5;0;1;2;268088;177054;2656;346;3691
FR;5;2022-05-27;98;54;4;4;9;268186;177108;2660;350;3700
FR;5;2022-05-28;95;77;5;3;10;268281;177185;2665;353;3710
FR;5;2022-05-29;14;14;1;0;2;268295;177199;2666;353;3712
FR;5;2022-05-30;56;41;2;1;2;268351;177240;2668;354;3714
FR;5;2022-05-31;55;43;1;8;1;268406;177283;2669;362;3715
FR;5;2022-06-01;248;238;9;2;24;268654;177521;2678;364;3739
FR;5;2022-06-02;57;60;5;0;8;268711;177581;2683;364;3747
FR;5;2022-06-03;81;69;3;5;8;268792;177650;2686;369;3755
FR;5;2022-06-04;155;109;2;1;9;268947;177759;2688;370;3764
FR;5;2022-06-05;17;11;0;0;1;268964;177770;2688;370;3765
FR;5;2022-06-06;15;9;0;0;0;268979;177779;2688;370;3765
FR;5;2022-06-07;48;55;0;1;1;269027;177834;2688;371;3766
FR;5;2022-06-08;280;224;3;4;17;269307;178058;2691;375;3783
FR;5;2022-06-09;52;40;5;3;6;269359;178098;2696;378;3789
FR;5;2022-06-10;79;71;1;1;6;269438;178169;2697;379;3795
FR;5;2022-06-11;169;141;2;3;10;269607;178310;2699;382;3805
FR;5;2022-06-12;14;16;0;0;2;269621;178326;2699;382;3807
FR;5;2022-06-13;56;42;8;3;8;269677;178368;2707;385;3815
FR;5;2022-06-14;56;54;0;3;4;269733;178422;2707;388;3819
FR;5;2022-06-15;262;257;2;2;23;269995;178679;2709;390;3842
FR;5;2022-06-16;45;26;3;2;1;270040;178705;2712;392;3843
FR;5;2022-06-17;94;65;3;5;8;270134;178770;2715;397;3851
FR;5;2022-06-18;135;92;8;2;26;270269;178862;2723;399;3877
FR;5;2022-06-19;25;13;0;1;2;270294;178875;2723;400;3879
FR;6;2020-12-27;0;0;0;0;0;0;0;0;0;0
FR;6;2020-12-28;0;0;0;0;0;0;0;0;0;0
FR;6;2020-12-29;0;0;0;0;0;0;0;0;0;0
FR;6;2020-12-30;0;0;0;0;0;0;0;0;0;0
FR;6;2020-12-31;0;0;0;0;0;0;0;0;0;0
FR;6;2021-01-01;0;0;0;0;0;0;0;0;0;0
FR;6;2021-01-02;0;0;0;0;0;0;0;0;0;0
FR;6;2021-01-03;0;0;0;0;0;0;0;0;0;0
FR;6;2021-01-04;0;0;0;0;0;0;0;0;0;0
FR;6;2021-01-05;0;0;0;0;0;0;0;0;0;0
FR;6;2021-01-06;0;0;0;0;0;0;0;0;0;0
FR;6;2021-01-07;0;0;0;0;0;0;0;0;0;0
FR;6;2021-01-08;0;0;0;0;0;0;0;0;0;0
FR;6;2021-01-09;0;0;0;0;0;0;0;0;0;0
FR;6;2021-01-10;0;0;0;0;0;0;0;0;0;0
FR;6;2021-01-11;0;0;0;0;0;0;0;0;0;0
FR;6;2021-01-12;0;0;0;0;0;0;0;0;0;0
FR;6;2021-01-13;0;0;0;0;0;0;0;0;0;0
FR;6;2021-01-14;0;0;0;0;0;0;0;0;0;0
FR;6;2021-01-15;0;0;0;0;0;0;0;0;0;0
FR;6;2021-01-16;0;0;0;0;0;0;0;0;0;0
FR;6;2021-01-17;0;0;0;0;0;0;0;0;0;0
FR;6;2021-01-18;0;0;0;0;0;0;0;0;0;0
FR;6;2021-01-19;0;0;0;0;0;0;0;0;0;0
FR;6;2021-01-20;0;0;0;0;0;0;0;0;0;0
FR;6;2021-01-21;0;0;0;0;0;0;0;0;0;0
FR;6;2021-01-22;0;0;0;0;0;0;0;0;0;0
FR;6;2021-01-23;0;0;0;0;0;0;0;0;0;0
FR;6;2021-01-24;0;0;0;0;0;0;0;0;0;0
FR;6;2021-01-25;0;0;0;0;0;0;0;0;0;0
FR;6;2021-01-26;0;0;0;0;0;0;0;0;0;0
FR;6;2021-01-27;0;0;0;0;0;0;0;0;0;0
FR;6;2021-01-28;0;0;0;0;0;0;0;0;0;0
FR;6;2021-01-29;0;0;0;0;0;0;0;0;0;0
FR;6;2021-01-30;0;0;0;0;0;0;0;0;0;0
FR;6;2021-01-31;0;0;0;0;0;0;0;0;0;0
FR;6;2021-02-01;0;0;0;0;0;0;0;0;0;0
FR;6;2021-02-02;0;0;0;0;0;0;0;0;0;0
FR;6;2021-02-03;0;0;0;0;0;0;0;0;0;0
FR;6;2021-02-04;0;0;0;0;0;0;0;0;0;0
FR;6;2021-02-05;0;0;0;0;0;0;0;0;0;0
FR;6;2021-02-06;0;0;0;0;0;0;0;0;0;0
FR;6;2021-02-07;0;0;0;0;0;0;0;0;0;0
FR;6;2021-02-08;0;0;0;0;0;0;0;0;0;0
FR;6;2021-02-09;0;0;0;0;0;0;0;0;0;0
FR;6;2021-02-10;0;0;0;0;0;0;0;0;0;0
FR;6;2021-02-11;0;0;0;0;0;0;0;0;0;0
FR;6;2021-02-12;0;0;0;0;0;0;0;0;0;0
FR;6;2021-02-13;0;0;0;0;0;0;0;0;0;0
FR;6;2021-02-14;0;0;0;0;0;0;0;0;0;0
FR;6;2021-02-15;0;0;0;0;0;0;0;0;0;0
FR;6;2021-02-16;0;0;0;0;0;0;0;0;0;0
FR;6;2021-02-17;0;0;0;0;0;0;0;0;0;0
FR;6;2021-02-18;0;0;0;0;0;0;0;0;0;0
FR;6;2021-02-19;0;0;0;0;0;0;0;0;0;0
FR;6;2021-02-20;0;0;0;0;0;0;0;0;0;0
FR;6;2021-02-21;0;0;0;0;0;0;0;0;0;0
FR;6;2021-02-22;0;0;0;0;0;0;0;0;0;0
FR;6;2021-02-23;0;0;0;0;0;0;0;0;0;0
FR;6;2021-02-24;0;0;0;0;0;0;0;0;0;0
FR;6;2021-02-25;0;0;0;0;0;0;0;0;0;0
FR;6;2021-02-26;0;0;0;0;0;0;0;0;0;0
FR;6;2021-02-27;0;0;0;0;0;0;0;0;0;0
FR;6;2021-02-28;0;0;0;0;0;0;0;0;0;0
FR;6;2021-03-01;0;0;0;0;0;0;0;0;0;0
FR;6;2021-03-02;0;0;0;0;0;0;0;0;0;0
FR;6;2021-03-03;0;0;0;0;0;0;0;0;0;0
FR;6;2021-03-04;0;0;0;0;0;0;0;0;0;0
FR;6;2021-03-05;0;0;0;0;0;0;0;0;0;0
FR;6;2021-03-06;0;0;0;0;0;0;0;0;0;0
FR;6;2021-03-07;0;0;0;0;0;0;0;0;0;0
FR;6;2021-03-08;0;0;0;0;0;0;0;0;0;0
FR;6;2021-03-09;0;0;0;0;0;0;0;0;0;0
FR;6;2021-03-10;0;0;0;0;0;0;0;0;0;0
FR;6;2021-03-11;0;0;0;0;0;0;0;0;0;0
FR;6;2021-03-12;0;0;0;0;0;0;0;0;0;0
FR;6;2021-03-13;0;0;0;0;0;0;0;0;0;0
FR;6;2021-03-14;0;0;0;0;0;0;0;0;0;0
FR;6;2021-03-15;0;0;0;0;0;0;0;0;0;0
FR;6;2021-03-16;0;0;0;0;0;0;0;0;0;0
FR;6;2021-03-17;0;0;0;0;0;0;0;0;0;0
FR;6;2021-03-18;0;0;0;0;0;0;0;0;0;0
FR;6;2021-03-19;0;0;0;0;0;0;0;0;0;0
FR;6;2021-03-20;0;0;0;0;0;0;0;0;0;0
FR;6;2021-03-21;0;0;0;0;0;0;0;0;0;0
FR;6;2021-03-22;0;0;0;0;0;0;0;0;0;0
FR;6;2021-03-23;0;0;0;0;0;0;0;0;0;0
FR;6;2021-03-24;0;0;0;0;0;0;0;0;0;0
FR;6;2021-03-25;0;0;0;0;0;0;0;0;0;0
FR;6;2021-03-26;0;0;0;0;0;0;0;0;0;0
FR;6;2021-03-27;0;0;0;0;0;0;0;0;0;0
FR;6;2021-03-28;0;0;0;0;0;0;0;0;0;0
FR;6;2021-03-29;0;0;0;0;0;0;0;0;0;0
FR;6;2021-03-30;0;0;0;0;0;0;0;0;0;0
FR;6;2021-03-31;0;0;0;0;0;0;0;0;0;0
FR;6;2021-04-01;0;0;0;0;0;0;0;0;0;0
FR;6;2021-04-02;0;0;0;0;0;0;0;0;0;0
FR;6;2021-04-03;0;0;0;0;0;0;0;0;0;0
FR;6;2021-04-04;0;0;0;0;0;0;0;0;0;0
FR;6;2021-04-05;0;0;0;0;0;0;0;0;0;0
FR;6;2021-04-06;0;0;0;0;0;0;0;0;0;0
FR;6;2021-04-07;0;0;0;0;0;0;0;0;0;0
FR;6;2021-04-08;0;0;0;0;0;0;0;0;0;0
FR;6;2021-04-09;0;0;0;0;0;0;0;0;0;0
FR;6;2021-04-10;0;0;0;0;0;0;0;0;0;0
FR;6;2021-04-11;0;0;0;0;0;0;0;0;0;0
FR;6;2021-04-12;0;0;0;0;0;0;0;0;0;0
FR;6;2021-04-13;0;0;0;0;0;0;0;0;0;0
FR;6;2021-04-14;0;0;0;0;0;0;0;0;0;0
FR;6;2021-04-15;0;0;0;0;0;0;0;0;0;0
FR;6;2021-04-16;0;0;0;0;0;0;0;0;0;0
FR;6;2021-04-17;0;0;0;0;0;0;0;0;0;0
FR;6;2021-04-18;0;0;0;0;0;0;0;0;0;0
FR;6;2021-04-19;0;0;0;0;0;0;0;0;0;0
FR;6;2021-04-20;0;0;0;0;0;0;0;0;0;0
FR;6;2021-04-21;0;0;0;0;0;0;0;0;0;0
FR;6;2021-04-22;0;0;0;0;0;0;0;0;0;0
FR;6;2021-04-23;0;0;0;0;0;0;0;0;0;0
FR;6;2021-04-24;0;0;0;0;0;0;0;0;0;0
FR;6;2021-04-25;0;0;0;0;0;0;0;0;0;0
FR;6;2021-04-26;0;0;0;0;0;0;0;0;0;0
FR;6;2021-04-27;0;0;0;0;0;0;0;0;0;0
FR;6;2021-04-28;0;0;0;0;0;0;0;0;0;0
FR;6;2021-04-29;0;0;0;0;0;0;0;0;0;0
FR;6;2021-04-30;0;0;0;0;0;0;0;0;0;0
FR;6;2021-05-01;0;0;0;0;0;0;0;0;0;0
FR;6;2021-05-02;0;0;0;0;0;0;0;0;0;0
FR;6;2021-05-03;0;0;0;0;0;0;0;0;0;0
FR;6;2021-05-04;0;0;0;0;0;0;0;0;0;0
FR;6;2021-05-05;0;0;0;0;0;0;0;0;0;0
FR;6;2021-05-06;0;0;0;0;0;0;0;0;0;0
FR;6;2021-05-07;0;0;0;0;0;0;0;0;0;0
FR;6;2021-05-08;0;0;0;0;0;0;0;0;0;0
FR;6;2021-05-09;0;0;0;0;0;0;0;0;0;0
FR;6;2021-05-10;0;0;0;0;0;0;0;0;0;0
FR;6;2021-05-11;0;0;0;0;0;0;0;0;0;0
FR;6;2021-05-12;0;0;0;0;0;0;0;0;0;0
FR;6;2021-05-13;0;0;0;0;0;0;0;0;0;0
FR;6;2021-05-14;0;0;0;0;0;0;0;0;0;0
FR;6;2021-05-15;0;0;0;0;0;0;0;0;0;0
FR;6;2021-05-16;0;0;0;0;0;0;0;0;0;0
FR;6;2021-05-17;0;0;0;0;0;0;0;0;0;0
FR;6;2021-05-18;0;0;0;0;0;0;0;0;0;0
FR;6;2021-05-19;0;0;0;0;0;0;0;0;0;0
FR;6;2021-05-20;0;0;0;0;0;0;0;0;0;0
FR;6;2021-05-21;0;0;0;0;0;0;0;0;0;0
FR;6;2021-05-22;0;0;0;0;0;0;0;0;0;0
FR;6;2021-05-23;0;0;0;0;0;0;0;0;0;0
FR;6;2021-05-24;0;0;0;0;0;0;0;0;0;0
FR;6;2021-05-25;0;0;0;0;0;0;0;0;0;0
FR;6;2021-05-26;0;0;0;0;0;0;0;0;0;0
FR;6;2021-05-27;0;0;0;0;0;0;0;0;0;0
FR;6;2021-05-28;0;0;0;0;0;0;0;0;0;0
FR;6;2021-05-29;0;0;0;0;0;0;0;0;0;0
FR;6;2021-05-30;0;0;0;0;0;0;0;0;0;0
FR;6;2021-05-31;0;0;0;0;0;0;0;0;0;0
FR;6;2021-06-01;0;0;0;0;0;0;0;0;0;0
FR;6;2021-06-02;0;0;0;0;0;0;0;0;0;0
FR;6;2021-06-03;0;0;0;0;0;0;0;0;0;0
FR;6;2021-06-04;0;0;0;0;0;0;0;0;0;0
FR;6;2021-06-05;0;0;0;0;0;0;0;0;0;0
FR;6;2021-06-06;0;0;0;0;0;0;0;0;0;0
FR;6;2021-06-07;0;0;0;0;0;0;0;0;0;0
FR;6;2021-06-08;0;0;0;0;0;0;0;0;0;0
FR;6;2021-06-09;0;0;0;0;0;0;0;0;0;0
FR;6;2021-06-10;0;0;0;0;0;0;0;0;0;0
FR;6;2021-06-11;0;0;0;0;0;0;0;0;0;0
FR;6;2021-06-12;0;0;0;0;0;0;0;0;0;0
FR;6;2021-06-13;0;0;0;0;0;0;0;0;0;0
FR;6;2021-06-14;0;0;0;0;0;0;0;0;0;0
FR;6;2021-06-15;0;0;0;0;0;0;0;0;0;0
FR;6;2021-06-16;0;0;0;0;0;0;0;0;0;0
FR;6;2021-06-17;0;0;0;0;0;0;0;0;0;0
FR;6;2021-06-18;0;0;0;0;0;0;0;0;0;0
FR;6;2021-06-19;0;0;0;0;0;0;0;0;0;0
FR;6;2021-06-20;0;0;0;0;0;0;0;0;0;0
FR;6;2021-06-21;0;0;0;0;0;0;0;0;0;0
FR;6;2021-06-22;0;0;0;0;0;0;0;0;0;0
FR;6;2021-06-23;0;0;0;0;0;0;0;0;0;0
FR;6;2021-06-24;0;0;0;0;0;0;0;0;0;0
FR;6;2021-06-25;0;0;0;0;0;0;0;0;0;0
FR;6;2021-06-26;0;0;0;0;0;0;0;0;0;0
FR;6;2021-06-27;0;0;0;0;0;0;0;0;0;0
FR;6;2021-06-28;0;0;0;0;0;0;0;0;0;0
FR;6;2021-06-29;0;0;0;0;0;0;0;0;0;0
FR;6;2021-06-30;0;0;0;0;0;0;0;0;0;0
FR;6;2021-07-01;0;0;0;0;0;0;0;0;0;0
FR;6;2021-07-02;0;0;0;0;0;0;0;0;0;0
FR;6;2021-07-03;0;0;0;0;0;0;0;0;0;0
FR;6;2021-07-04;0;0;0;0;0;0;0;0;0;0
FR;6;2021-07-05;0;0;0;0;0;0;0;0;0;0
FR;6;2021-07-06;0;0;0;0;0;0;0;0;0;0
FR;6;2021-07-07;0;0;0;0;0;0;0;0;0;0
FR;6;2021-07-08;0;0;0;0;0;0;0;0;0;0
FR;6;2021-07-09;0;0;0;0;0;0;0;0;0;0
FR;6;2021-07-10;0;0;0;0;0;0;0;0;0;0
FR;6;2021-07-11;0;0;0;0;0;0;0;0;0;0
FR;6;2021-07-12;0;0;0;0;0;0;0;0;0;0
FR;6;2021-07-13;0;0;0;0;0;0;0;0;0;0
FR;6;2021-07-14;0;0;0;0;0;0;0;0;0;0
FR;6;2021-07-15;0;0;0;0;0;0;0;0;0;0
FR;6;2021-07-16;0;0;0;0;0;0;0;0;0;0
FR;6;2021-07-17;0;0;0;0;0;0;0;0;0;0
FR;6;2021-07-18;0;0;0;0;0;0;0;0;0;0
FR;6;2021-07-19;0;0;0;0;0;0;0;0;0;0
FR;6;2021-07-20;0;0;0;0;0;0;0;0;0;0
FR;6;2021-07-21;0;0;0;0;0;0;0;0;0;0
FR;6;2021-07-22;0;0;0;0;0;0;0;0;0;0
FR;6;2021-07-23;0;0;0;0;0;0;0;0;0;0
FR;6;2021-07-24;0;0;0;0;0;0;0;0;0;0
FR;6;2021-07-25;0;0;0;0;0;0;0;0;0;0
FR;6;2021-07-26;0;0;0;0;0;0;0;0;0;0
FR;6;2021-07-27;0;0;0;0;0;0;0;0;0;0
FR;6;2021-07-28;0;0;0;0;0;0;0;0;0;0
FR;6;2021-07-29;0;0;0;0;0;0;0;0;0;0
FR;6;2021-07-30;0;0;0;0;0;0;0;0;0;0
FR;6;2021-07-31;0;0;0;0;0;0;0;0;0;0
FR;6;2021-08-01;0;0;0;0;0;0;0;0;0;0
FR;6;2021-08-02;0;0;0;0;0;0;0;0;0;0
FR;6;2021-08-03;0;0;0;0;0;0;0;0;0;0
FR;6;2021-08-04;0;0;0;0;0;0;0;0;0;0
FR;6;2021-08-05;0;0;0;0;0;0;0;0;0;0
FR;6;2021-08-06;0;0;0;0;0;0;0;0;0;0
FR;6;2021-08-07;0;0;0;0;0;0;0;0;0;0
FR;6;2021-08-08;0;0;0;0;0;0;0;0;0;0
FR;6;2021-08-09;0;0;0;0;0;0;0;0;0;0
FR;6;2021-08-10;0;0;0;0;0;0;0;0;0;0
FR;6;2021-08-11;0;0;0;0;0;0;0;0;0;0
FR;6;2021-08-12;0;0;0;0;0;0;0;0;0;0
FR;6;2021-08-13;0;0;0;0;0;0;0;0;0;0
FR;6;2021-08-14;0;0;0;0;0;0;0;0;0;0
FR;6;2021-08-15;0;0;0;0;0;0;0;0;0;0
FR;6;2021-08-16;0;0;0;0;0;0;0;0;0;0
FR;6;2021-08-17;0;0;0;0;0;0;0;0;0;0
FR;6;2021-08-18;0;0;0;0;0;0;0;0;0;0
FR;6;2021-08-19;0;0;0;0;0;0;0;0;0;0
FR;6;2021-08-20;0;0;0;0;0;0;0;0;0;0
FR;6;2021-08-21;0;0;0;0;0;0;0;0;0;0
FR;6;2021-08-22;0;0;0;0;0;0;0;0;0;0
FR;6;2021-08-23;0;0;0;0;0;0;0;0;0;0
FR;6;2021-08-24;0;0;0;0;0;0;0;0;0;0
FR;6;2021-08-25;0;0;0;0;0;0;0;0;0;0
FR;6;2021-08-26;0;0;0;0;0;0;0;0;0;0
FR;6;2021-08-27;0;0;0;0;0;0;0;0;0;0
FR;6;2021-08-28;0;0;0;0;0;0;0;0;0;0
FR;6;2021-08-29;0;0;0;0;0;0;0;0;0;0
FR;6;2021-08-30;0;0;0;0;0;0;0;0;0;0
FR;6;2021-08-31;0;0;0;0;0;0;0;0;0;0
FR;6;2021-09-01;0;0;0;0;0;0;0;0;0;0
FR;6;2021-09-02;0;0;0;0;0;0;0;0;0;0
FR;6;2021-09-03;0;0;0;0;0;0;0;0;0;0
FR;6;2021-09-04;0;0;0;0;0;0;0;0;0;0
FR;6;2021-09-05;0;0;0;0;0;0;0;0;0;0
FR;6;2021-09-06;0;0;0;0;0;0;0;0;0;0
FR;6;2021-09-07;0;0;0;0;0;0;0;0;0;0
FR;6;2021-09-08;0;0;0;0;0;0;0;0;0;0
FR;6;2021-09-09;0;0;0;0;0;0;0;0;0;0
FR;6;2021-09-10;0;0;0;0;0;0;0;0;0;0
FR;6;2021-09-11;0;0;0;0;0;0;0;0;0;0
FR;6;2021-09-12;0;0;0;0;0;0;0;0;0;0
FR;6;2021-09-13;0;0;0;0;0;0;0;0;0;0
FR;6;2021-09-14;0;0;0;0;0;0;0;0;0;0
FR;6;2021-09-15;0;0;0;0;0;0;0;0;0;0
FR;6;2021-09-16;0;0;0;0;0;0;0;0;0;0
FR;6;2021-09-17;0;0;0;0;0;0;0;0;0;0
FR;6;2021-09-18;0;0;0;0;0;0;0;0;0;0
FR;6;2021-09-19;0;0;0;0;0;0;0;0;0;0
FR;6;2021-09-20;0;0;0;0;0;0;0;0;0;0
FR;6;2021-09-21;0;0;0;0;0;0;0;0;0;0
FR;6;2021-09-22;0;0;0;0;0;0;0;0;0;0
FR;6;2021-09-23;0;0;0;0;0;0;0;0;0;0
FR;6;2021-09-24;0;0;0;0;0;0;0;0;0;0
FR;6;2021-09-25;0;0;0;0;0;0;0;0;0;0
FR;6;2021-09-26;0;0;0;0;0;0;0;0;0;0
FR;6;2021-09-27;0;0;0;0;0;0;0;0;0;0
FR;6;2021-09-28;0;0;0;0;0;0;0;0;0;0
FR;6;2021-09-29;0;0;0;0;0;0;0;0;0;0
FR;6;2021-09-30;0;0;0;0;0;0;0;0;0;0
FR;6;2021-10-01;0;0;0;0;0;0;0;0;0;0
FR;6;2021-10-02;0;0;0;0;0;0;0;0;0;0
FR;6;2021-10-03;0;0;0;0;0;0;0;0;0;0
FR;6;2021-10-04;0;0;0;0;0;0;0;0;0;0
FR;6;2021-10-05;0;0;0;0;0;0;0;0;0;0
FR;6;2021-10-06;0;0;0;0;0;0;0;0;0;0
FR;6;2021-10-07;0;0;0;0;0;0;0;0;0;0
FR;6;2021-10-08;0;0;0;0;0;0;0;0;0;0
FR;6;2021-10-09;0;0;0;0;0;0;0;0;0;0
FR;6;2021-10-10;0;0;0;0;0;0;0;0;0;0
FR;6;2021-10-11;0;0;0;0;0;0;0;0;0;0
FR;6;2021-10-12;0;0;0;0;0;0;0;0;0;0
FR;6;2021-10-13;0;0;0;0;0;0;0;0;0;0
FR;6;2021-10-14;0;0;0;0;0;0;0;0;0;0
FR;6;2021-10-15;0;0;0;0;0;0;0;0;0;0
FR;6;2021-10-16;0;0;0;0;0;0;0;0;0;0
FR;6;2021-10-17;0;0;0;0;0;0;0;0;0;0
FR;6;2021-10-18;0;0;0;0;0;0;0;0;0;0
FR;6;2021-10-19;0;0;0;0;0;0;0;0;0;0
FR;6;2021-10-20;0;0;0;0;0;0;0;0;0;0
FR;6;2021-10-21;0;0;0;0;0;0;0;0;0;0
FR;6;2021-10-22;0;0;0;0;0;0;0;0;0;0
FR;6;2021-10-23;0;0;0;0;0;0;0;0;0;0
FR;6;2021-10-24;0;0;0;0;0;0;0;0;0;0
FR;6;2021-10-25;0;0;0;0;0;0;0;0;0;0
FR;6;2021-10-26;0;0;0;0;0;0;0;0;0;0
FR;6;2021-10-27;0;0;0;0;0;0;0;0;0;0
FR;6;2021-10-28;0;0;0;0;0;0;0;0;0;0
FR;6;2021-10-29;0;0;0;0;0;0;0;0;0;0
FR;6;2021-10-30;0;0;0;0;0;0;0;0;0;0
FR;6;2021-10-31;0;0;0;0;0;0;0;0;0;0
FR;6;2021-11-01;0;0;0;0;0;0;0;0;0;0
FR;6;2021-11-02;0;0;0;0;0;0;0;0;0;0
FR;6;2021-11-03;0;0;0;0;0;0;0;0;0;0
FR;6;2021-11-04;0;0;0;0;0;0;0;0;0;0
FR;6;2021-11-05;0;0;0;0;0;0;0;0;0;0
FR;6;2021-11-06;0;0;0;0;0;0;0;0;0;0
FR;6;2021-11-07;0;0;0;0;0;0;0;0;0;0
FR;6;2021-11-08;0;0;0;0;0;0;0;0;0;0
FR;6;2021-11-09;0;0;0;0;0;0;0;0;0;0
FR;6;2021-11-10;0;0;0;0;0;0;0;0;0;0
FR;6;2021-11-11;0;0;0;0;0;0;0;0;0;0
FR;6;2021-11-12;0;0;0;0;0;0;0;0;0;0
FR;6;2021-11-13;0;0;0;0;0;0;0;0;0;0
FR;6;2021-11-14;0;0;0;0;0;0;0;0;0;0
FR;6;2021-11-15;0;0;0;0;0;0;0;0;0;0
FR;6;2021-11-16;0;0;0;0;0;0;0;0;0;0
FR;6;2021-11-17;0;0;0;0;0;0;0;0;0;0
FR;6;2021-11-18;0;0;0;0;0;0;0;0;0;0
FR;6;2021-11-19;0;0;0;0;0;0;0;0;0;0
FR;6;2021-11-20;0;0;0;0;0;0;0;0;0;0
FR;6;2021-11-21;0;0;0;0;0;0;0;0;0;0
FR;6;2021-11-22;0;0;0;0;0;0;0;0;0;0
FR;6;2021-11-23;0;0;0;0;0;0;0;0;0;0
FR;6;2021-11-24;0;0;0;0;0;0;0;0;0;0
FR;6;2021-11-25;0;0;0;0;0;0;0;0;0;0
FR;6;2021-11-26;0;0;0;0;0;0;0;0;0;0
FR;6;2021-11-27;0;0;0;0;0;0;0;0;0;0
FR;6;2021-11-28;0;0;0;0;0;0;0;0;0;0
FR;6;2021-11-29;0;0;0;0;0;0;0;0;0;0
FR;6;2021-11-30;0;0;0;0;0;0;0;0;0;0
FR;6;2021-12-01;0;0;0;0;0;0;0;0;0;0
FR;6;2021-12-02;0;0;0;0;0;0;0;0;0;0
FR;6;2021-12-03;0;0;0;0;0;0;0;0;0;0
FR;6;2021-12-04;0;0;0;0;0;0;0;0;0;0
FR;6;2021-12-05;0;0;0;0;0;0;0;0;0;0
FR;6;2021-12-06;0;0;0;0;0;0;0;0;0;0
FR;6;2021-12-07;0;0;0;0;0;0;0;0;0;0
FR;6;2021-12-08;0;0;0;0;0;0;0;0;0;0
FR;6;2021-12-09;0;0;0;0;0;0;0;0;0;0
FR;6;2021-12-10;0;0;0;0;0;0;0;0;0;0
FR;6;2021-12-11;0;0;0;0;0;0;0;0;0;0
FR;6;2021-12-12;0;0;0;0;0;0;0;0;0;0
FR;6;2021-12-13;0;0;0;0;0;0;0;0;0;0
FR;6;2021-12-14;0;0;0;0;0;0;0;0;0;0
FR;6;2021-12-15;0;0;0;0;0;0;0;0;0;0
FR;6;2021-12-16;0;0;0;0;0;0;0;0;0;0
FR;6;2021-12-17;0;0;0;0;0;0;0;0;0;0
FR;6;2021-12-18;0;0;0;0;0;0;0;0;0;0
FR;6;2021-12-19;0;0;0;0;0;0;0;0;0;0
FR;6;2021-12-20;0;0;0;0;0;0;0;0;0;0
FR;6;2021-12-21;0;0;0;0;0;0;0;0;0;0
FR;6;2021-12-22;0;0;0;0;0;0;0;0;0;0
FR;6;2021-12-23;0;0;0;0;0;0;0;0;0;0
FR;6;2021-12-24;0;0;0;0;0;0;0;0;0;0
FR;6;2021-12-25;0;0;0;0;0;0;0;0;0;0
FR;6;2021-12-26;0;0;0;0;0;0;0;0;0;0
FR;6;2021-12-27;0;0;0;0;0;0;0;0;0;0
FR;6;2021-12-28;0;0;0;0;0;0;0;0;0;0
FR;6;2021-12-29;0;0;0;0;0;0;0;0;0;0
FR;6;2021-12-30;0;0;0;0;0;0;0;0;0;0
FR;6;2021-12-31;0;0;0;0;0;0;0;0;0;0
FR;6;2022-01-01;0;0;0;0;0;0;0;0;0;0
FR;6;2022-01-02;0;0;0;0;0;0;0;0;0;0
FR;6;2022-01-03;0;0;0;0;0;0;0;0;0;0
FR;6;2022-01-04;0;0;0;0;0;0;0;0;0;0
FR;6;2022-01-05;0;0;0;0;0;0;0;0;0;0
FR;6;2022-01-06;0;0;0;0;0;0;0;0;0;0
FR;6;2022-01-07;0;0;0;0;0;0;0;0;0;0
FR;6;2022-01-08;0;0;0;0;0;0;0;0;0;0
FR;6;2022-01-09;0;0;0;0;0;0;0;0;0;0
FR;6;2022-01-10;0;0;0;0;0;0;0;0;0;0
FR;6;2022-01-11;0;0;0;0;0;0;0;0;0;0
FR;6;2022-01-12;0;0;0;0;0;0;0;0;0;0
FR;6;2022-01-13;0;0;0;0;0;0;0;0;0;0
FR;6;2022-01-14;0;0;0;0;0;0;0;0;0;0
FR;6;2022-01-15;0;0;0;0;0;0;0;0;0;0
FR;6;2022-01-16;0;0;0;0;0;0;0;0;0;0
FR;6;2022-01-17;0;0;0;0;0;0;0;0;0;0
FR;6;2022-01-18;0;0;0;0;0;0;0;0;0;0
FR;6;2022-01-19;0;0;0;0;0;0;0;0;0;0
FR;6;2022-01-20;0;0;0;0;0;0;0;0;0;0
FR;6;2022-01-21;0;0;0;0;0;0;0;0;0;0
FR;6;2022-01-22;0;0;0;0;0;0;0;0;0;0
FR;6;2022-01-23;0;0;0;0;0;0;0;0;0;0
FR;6;2022-01-24;0;0;0;0;0;0;0;0;0;0
FR;6;2022-01-25;0;0;0;0;0;0;0;0;0;0
FR;6;2022-01-26;0;0;0;0;0;0;0;0;0;0
FR;6;2022-01-27;0;0;0;0;0;0;0;0;0;0
FR;6;2022-01-28;0;0;0;0;0;0;0;0;0;0
FR;6;2022-01-29;0;0;0;0;0;0;0;0;0;0
FR;6;2022-01-30;0;0;0;0;0;0;0;0;0;0
FR;6;2022-01-31;0;0;0;0;0;0;0;0;0;0
FR;6;2022-02-01;0;0;0;0;0;0;0;0;0;0
FR;6;2022-02-02;0;0;0;0;0;0;0;0;0;0
FR;6;2022-02-03;0;0;0;0;0;0;0;0;0;0
FR;6;2022-02-04;0;0;0;0;0;0;0;0;0;0
FR;6;2022-02-05;0;0;0;0;0;0;0;0;0;0
FR;6;2022-02-06;0;0;0;0;0;0;0;0;0;0
FR;6;2022-02-07;0;0;0;0;0;0;0;0;0;0
FR;6;2022-02-08;0;0;0;0;0;0;0;0;0;0
FR;6;2022-02-09;0;0;0;0;0;0;0;0;0;0
FR;6;2022-02-10;0;0;0;0;0;0;0;0;0;0
FR;6;2022-02-11;0;0;0;0;0;0;0;0;0;0
FR;6;2022-02-12;0;0;0;0;0;0;0;0;0;0
FR;6;2022-02-13;0;0;0;0;0;0;0;0;0;0
FR;6;2022-02-14;0;0;0;0;0;0;0;0;0;0
FR;6;2022-02-15;0;0;0;0;0;0;0;0;0;0
FR;6;2022-02-16;0;0;0;0;0;0;0;0;0;0
FR;6;2022-02-17;0;0;0;0;0;0;0;0;0;0
FR;6;2022-02-18;0;0;0;0;0;0;0;0;0;0
FR;6;2022-02-19;0;0;0;0;0;0;0;0;0;0
FR;6;2022-02-20;0;0;0;0;0;0;0;0;0;0
FR;6;2022-02-21;0;0;0;0;0;0;0;0;0;0
FR;6;2022-02-22;0;0;0;0;0;0;0;0;0;0
FR;6;2022-02-23;0;0;0;0;0;0;0;0;0;0
FR;6;2022-02-24;0;0;0;0;0;0;0;0;0;0
FR;6;2022-02-25;0;0;0;0;0;0;0;0;0;0
FR;6;2022-02-26;1;0;0;0;0;1;0;0;0;0
FR;6;2022-02-27;0;0;0;0;0;1;0;0;0;0
FR;6;2022-02-28;0;0;0;0;0;1;0;0;0;0
FR;6;2022-03-01;3;0;0;0;0;4;0;0;0;0
FR;6;2022-03-02;97;9;2;0;7;101;9;2;0;7
FR;6;2022-03-03;0;0;0;0;0;101;9;2;0;7
FR;6;2022-03-04;91;4;0;0;4;192;13;2;0;11
FR;6;2022-03-05;391;23;2;0;14;583;36;4;0;25
FR;6;2022-03-06;7;1;0;0;0;590;37;4;0;25
FR;6;2022-03-07;337;19;0;0;13;927;56;4;0;38
FR;6;2022-03-08;230;14;0;0;5;1157;70;4;0;43
FR;6;2022-03-09;519;29;2;0;21;1676;99;6;0;64
FR;6;2022-03-10;206;19;0;1;12;1882;118;6;1;76
FR;6;2022-03-11;328;21;6;0;21;2210;139;12;1;97
FR;6;2022-03-12;518;25;1;0;20;2728;164;13;1;117
FR;6;2022-03-13;40;2;0;0;1;2768;166;13;1;118
FR;6;2022-03-14;201;4;2;0;3;2969;170;15;1;121
FR;6;2022-03-15;112;11;2;0;9;3081;181;17;1;130
FR;6;2022-03-16;310;17;1;1;14;3391;198;18;2;144
FR;6;2022-03-17;117;6;1;2;4;3508;204;19;4;148
FR;6;2022-03-18;214;11;0;0;6;3722;215;19;4;154
FR;6;2022-03-19;307;19;2;0;9;4029;234;21;4;163
FR;6;2022-03-20;15;5;0;0;1;4044;239;21;4;164
FR;6;2022-03-21;132;23;1;0;4;4176;262;22;4;168
FR;6;2022-03-22;97;15;0;0;4;4273;277;22;4;172
FR;6;2022-03-23;226;108;3;0;14;4499;385;25;4;186
FR;6;2022-03-24;100;15;1;3;4;4599;400;26;7;190
FR;6;2022-03-25;203;141;2;1;15;4802;541;28;8;205
FR;6;2022-03-26;331;295;7;1;19;5133;836;35;9;224
FR;6;2022-03-27;32;30;1;0;1;5165;866;36;9;225
FR;6;2022-03-28;200;208;8;1;17;5365;1074;44;10;242
FR;6;2022-03-29;126;189;12;2;12;5491;1263;56;12;254
FR;6;2022-03-30;305;476;10;2;22;5796;1739;66;14;276
FR;6;2022-03-31;124;140;10;0;14;5920;1879;76;14;290
FR;6;2022-04-01;195;150;11;2;23;6115;2029;87;16;313
FR;6;2022-04-02;205;241;9;1;13;6320;2270;96;17;326
FR;6;2022-04-03;17;21;0;0;1;6337;2291;96;17;327
FR;6;2022-04-04;132;114;6;1;9;6469;2405;102;18;336
FR;6;2022-04-05;145;88;15;1;11;6614;2493;117;19;347
FR;6;2022-04-06;204;245;22;26;27;6818;2738;139;45;374
FR;6;2022-04-07;127;96;15;9;17;6945;2834;154;54;391
FR;6;2022-04-08;199;170;16;3;17;7144;3004;170;57;408
FR;6;2022-04-09;145;139;6;12;13;7289;3143;176;69;421
FR;6;2022-04-10;10;20;3;0;1;7299;3163;179;69;422
FR;6;2022-04-11;101;106;4;0;5;7400;3269;183;69;427
FR;6;2022-04-12;136;75;5;8;10;7536;3344;188;77;437
FR;6;2022-04-13;161;175;7;5;13;7697;3519;195;82;450
FR;6;2022-04-14;100;103;5;10;8;7797;3622;200;92;458
FR;6;2022-04-15;160;148;11;7;19;7957;3770;211;99;477
FR;6;2022-04-16;127;132;5;0;14;8084;3902;216;99;491
FR;6;2022-04-17;8;9;4;0;4;8092;3911;220;99;495
FR;6;2022-04-18;8;15;3;0;4;8100;3926;223;99;499
FR;6;2022-04-19;97;112;4;3;3;8197;4038;227;102;502
FR;6;2022-04-20;173;227;8;7;15;8370;4265;235;109;517
FR;6;2022-04-21;111;93;8;4;11;8481;4358;243;113;528
FR;6;2022-04-22;138;160;13;12;13;8619;4518;256;125;541
FR;6;2022-04-23;104;129;1;1;7;8723;4647;257;126;548
FR;6;2022-04-24;5;21;1;0;0;8728;4668;258;126;548
FR;6;2022-04-25;90;128;3;8;11;8818;4796;261;134;559
FR;6;2022-04-26;101;128;18;2;16;8919;4924;279;136;575
FR;6;2022-04-27;197;159;21;1;27;9116;5083;300;137;602
FR;6;2022-04-28;109;87;7;1;8;9225;5170;307;138;610
FR;6;2022-04-29;191;168;16;2;20;9416;5338;323;140;630
FR;6;2022-04-30;133;125;7;1;24;9549;5463;330;141;654
FR;6;2022-05-01;7;6;0;0;0;9556;5469;330;141;654
FR;6;2022-05-02;94;65;3;4;3;9650;5534;333;145;657
FR;6;2022-05-03;137;92;11;2;7;9787;5626;344;147;664
FR;6;2022-05-04;166;118;25;12;29;9953;5744;369;159;693
FR;6;2022-05-05;101;70;8;3;12;10054;5814;377;162;705
FR;6;2022-05-06;152;110;10;9;16;10206;5924;387;171;721
FR;6;2022-05-07;138;93;13;3;23;10344;6017;400;174;744
FR;6;2022-05-08;20;8;6;5;7;10364;6025;406;179;751
FR;6;2022-05-09;86;73;9;7;13;10450;6098;415;186;764
FR;6;2022-05-10;111;80;15;7;12;10561;6178;430;193;776
FR;6;2022-05-11;130;120;11;14;20;10691;6298;441;207;796
FR;6;2022-05-12;105;75;6;5;13;10796;6373;447;212;809
FR;6;2022-05-13;154;95;17;21;20;10950;6468;464;233;829
FR;6;2022-05-14;81;60;6;7;15;11031;6528;470;240;844
FR;6;2022-05-15;12;7;0;0;0;11043;6535;470;240;844
FR;6;2022-05-16;64;54;6;2;12;11107;6589;476;242;856
FR;6;2022-05-17;123;77;5;7;11;11230;6666;481;249;867
FR;6;2022-05-18;131;116;5;1;13;11361;6782;486;250;880
FR;6;2022-05-19;124;57;6;8;9;11485;6839;492;258;889
FR;6;2022-05-20;127;115;13;3;18;11612;6954;505;261;907
FR;6;2022-05-21;90;67;14;3;12;11702;7021;519;264;919
FR;6;2022-05-22;19;12;5;0;4;11721;7033;524;264;923
FR;6;2022-05-23;73;72;4;2;7;11794;7105;528;266;930
FR;6;2022-05-24;116;98;8;2;16;11910;7203;536;268;946
FR;6;2022-05-25;139;129;6;3;11;12049;7332;542;271;957
FR;6;2022-05-26;7;9;3;0;9;12056;7341;545;271;966
FR;6;2022-05-27;127;105;15;11;18;12183;7446;560;282;984
FR;6;2022-05-28;52;75;1;5;8;12235;7521;561;287;992
FR;6;2022-05-29;8;10;0;0;1;12243;7531;561;287;993
FR;6;2022-05-30;70;69;7;4;4;12313;7600;568;291;997
FR;6;2022-05-31;87;102;10;2;14;12400;7702;578;293;1011
FR;6;2022-06-01;97;89;10;1;11;12497;7791;588;294;1022
FR;6;2022-06-02;88;60;6;3;9;12585;7851;594;297;1031
FR;6;2022-06-03;124;102;13;7;21;12709;7953;607;304;1052
FR;6;2022-06-04;61;51;10;0;12;12770;8004;617;304;1064
FR;6;2022-06-05;16;15;2;1;4;12786;8019;619;305;1068
FR;6;2022-06-06;9;6;0;0;0;12795;8025;619;305;1068
FR;6;2022-06-07;77;89;3;4;7;12872;8114;622;309;1075
FR;6;2022-06-08;92;109;13;5;20;12964;8223;635;314;1095
FR;6;2022-06-09;75;80;14;3;14;13039;8303;649;317;1109
FR;6;2022-06-10;116;91;25;9;22;13155;8394;674;326;1131
FR;6;2022-06-11;82;62;6;10;12;13237;8456;680;336;1143
FR;6;2022-06-12;6;14;1;0;2;13243;8470;681;336;1145
FR;6;2022-06-13;73;59;18;1;7;13316;8529;699;337;1152
FR;6;2022-06-14;98;98;7;5;16;13414;8627;706;342;1168
FR;6;2022-06-15;77;81;7;8;15;13491;8708;713;350;1183
FR;6;2022-06-16;53;38;9;7;12;13544;8746;722;357;1195
FR;6;2022-06-17;85;81;3;13;11;13629;8827;725;370;1206
FR;6;2022-06-18;67;55;12;0;20;13696;8882;737;370;1226
FR;6;2022-06-19;6;6;3;0;4;13702;8888;740;370;1230
FR;0;2020-12-27;603;0;0;0;0;603;0;0;0;0
FR;0;2020-12-28;670;1;0;0;0;1273;1;0;0;0
FR;0;2020-12-29;374;0;0;0;0;1647;1;0;0;0
FR;0;2020-12-30;440;0;0;0;0;2087;1;0;0;0
FR;0;2020-12-31;436;1;0;0;0;2523;2;0;0;0
FR;0;2021-01-01;1138;2;0;0;0;3661;4;0;0;0
FR;0;2021-01-02;359;3;0;0;0;4020;7;0;0;0
FR;0;2021-01-03;402;0;0;0;0;4422;7;0;0;0
FR;0;2021-01-04;2093;2;0;0;0;6515;9;0;0;0
FR;0;2021-01-05;7733;3;0;0;0;14248;12;0;0;0
FR;0;2021-01-06;12449;13;0;0;0;26697;25;0;0;0
FR;0;2021-01-07;29452;9;0;0;0;56149;34;0;0;0
FR;0;2021-01-08;37123;12;0;0;0;93272;46;0;0;0
FR;0;2021-01-09;11209;5;0;0;0;104481;51;0;0;0
FR;0;2021-01-10;5999;3;0;0;0;110480;54;0;0;0
FR;0;2021-01-11;39925;17;0;0;0;150405;71;0;0;0
FR;0;2021-01-12;62128;16;0;0;0;212533;87;0;0;0
FR;0;2021-01-13;65113;31;0;0;0;277646;118;0;0;0
FR;0;2021-01-14;83120;92;0;0;0;360766;210;0;0;0
FR;0;2021-01-15;68994;34;0;0;0;429760;244;0;0;0
FR;0;2021-01-16;20208;69;0;0;0;449968;313;0;0;0
FR;0;2021-01-17;10978;49;0;0;0;460946;362;0;0;0
FR;0;2021-01-18;85887;164;0;0;0;546833;526;0;0;0
FR;0;2021-01-19;130582;174;0;0;0;677415;700;0;0;0
FR;0;2021-01-20;137528;173;0;0;0;814943;873;0;0;0
FR;0;2021-01-21;158382;170;0;0;0;973325;1043;0;0;0
FR;0;2021-01-22;121047;211;0;0;0;1094372;1254;0;0;0
FR;0;2021-01-23;38467;64;0;0;0;1132839;1318;0;0;0
FR;0;2021-01-24;9741;75;0;0;0;1142580;1393;0;0;0
FR;0;2021-01-25;78224;1279;0;0;0;1220804;2672;0;0;0
FR;0;2021-01-26;100367;3297;1;0;0;1321171;5969;1;0;0
FR;0;2021-01-27;107226;5948;0;0;0;1428397;11917;1;0;0
FR;0;2021-01-28;124332;15117;0;0;0;1552729;27034;1;0;0
FR;0;2021-01-29;92174;17786;0;0;0;1644903;44820;1;0;0
FR;0;2021-01-30;29114;4318;0;0;0;1674017;49138;1;0;0
FR;0;2021-01-31;5228;1745;0;0;0;1679245;50883;1;0;0
FR;0;2021-02-01;53108;21591;0;0;0;1732353;72474;1;0;0
FR;0;2021-02-02;72286;35913;0;0;0;1804639;108387;1;0;0
FR;0;2021-02-03;72295;38221;0;0;0;1876934;146608;1;0;0
FR;0;2021-02-04;82054;51817;0;0;0;1958988;198425;1;0;0
FR;0;2021-02-05;68217;46155;0;0;0;2027205;244580;1;0;0
FR;0;2021-02-06;23094;10796;0;0;0;2050299;255376;1;0;0
FR;0;2021-02-07;5184;5348;0;0;0;2055483;260724;1;0;0
FR;0;2021-02-08;46821;47002;0;0;0;2102304;307726;1;0;0
FR;0;2021-02-09;65993;74800;0;0;0;2168297;382526;1;0;0
FR;0;2021-02-10;70993;79611;0;0;0;2239290;462137;1;0;0
FR;0;2021-02-11;87243;101647;0;0;0;2326533;563784;1;0;0
FR;0;2021-02-12;79299;75073;0;0;0;2405832;638857;1;0;0
FR;0;2021-02-13;22357;19492;0;0;0;2428189;658349;1;0;0
FR;0;2021-02-14;5071;7287;0;0;0;2433260;665636;1;0;0
FR;0;2021-02-15;38075;76648;0;0;0;2471335;742284;1;0;0
FR;0;2021-02-16;50373;100530;0;0;0;2521708;842814;1;0;0
FR;0;2021-02-17;50508;104758;1;0;0;2572216;947572;2;0;0
FR;0;2021-02-18;69765;120835;0;0;0;2641981;1068407;2;0;0
FR;0;2021-02-19;65053;91135;1;0;0;2707034;1159542;3;0;0
FR;0;2021-02-20;18576;28589;0;0;0;2725610;1188131;3;0;0
FR;0;2021-02-21;3314;6263;0;0;0;2728924;1194394;3;0;0
FR;0;2021-02-22;37486;73221;2;0;0;2766410;1267615;5;0;0
FR;0;2021-02-23;53764;84474;1;0;0;2820174;1352089;6;0;0
FR;0;2021-02-24;59986;81802;1;0;0;2880160;1433891;7;0;0
FR;0;2021-02-25;100548;91450;1;0;0;2980708;1525341;8;0;0
FR;0;2021-02-26;113434;70746;1;0;0;3094142;1596087;9;0;0
FR;0;2021-02-27;52092;22158;0;0;0;3146234;1618245;9;0;0
FR;0;2021-02-28;6193;4245;1;0;0;3152427;1622490;10;0;0
FR;0;2021-03-01;65844;53301;1;0;0;3218271;1675791;11;0;0
FR;0;2021-03-02;101356;66663;2;0;0;3319627;1742454;13;0;0
FR;0;2021-03-03;116478;65530;0;0;0;3436105;1807984;13;0;0
FR;0;2021-03-04;163598;70445;3;0;0;3599703;1878429;16;0;0
FR;0;2021-03-05;200888;63039;3;0;0;3800591;1941468;19;0;0
FR;0;2021-03-06;207935;17703;3;0;0;4008526;1959171;22;0;0
FR;0;2021-03-07;121255;4929;1;0;0;4129781;1964100;23;0;0
FR;0;2021-03-08;107121;50289;2;0;0;4236902;2014389;25;0;0
FR;0;2021-03-09;172424;56430;2;0;0;4409326;2070819;27;0;0
FR;0;2021-03-10;178947;57127;5;0;0;4588273;2127946;32;0;0
FR;0;2021-03-11;242839;63582;2;0;0;4831112;2191528;34;0;0
FR;0;2021-03-12;294784;53365;1;0;0;5125896;2244893;35;0;0
FR;0;2021-03-13;231375;15321;1;0;0;5357271;2260214;36;0;0
FR;0;2021-03-14;63342;3254;1;0;0;5420613;2263468;37;0;0
FR;0;2021-03-15;158613;32117;3;0;0;5579226;2295585;40;0;0
FR;0;2021-03-16;141544;39083;6;0;0;5720770;2334668;46;0;0
FR;0;2021-03-17;150454;38192;4;0;0;5871224;2372860;50;0;0
FR;0;2021-03-18;167792;44576;5;0;0;6039016;2417436;55;0;0
FR;0;2021-03-19;229973;37124;2;0;0;6268989;2454560;57;0;0
FR;0;2021-03-20;166648;11556;1;0;0;6435637;2466116;58;0;0
FR;0;2021-03-21;49922;2481;1;0;0;6485559;2468597;59;0;0
FR;0;2021-03-22;170001;33963;2;0;0;6655560;2502560;61;0;0
FR;0;2021-03-23;250338;42388;1;0;0;6905898;2544948;62;0;0
FR;0;2021-03-24;256868;43636;0;0;0;7162766;2588584;62;0;0
FR;0;2021-03-25;341766;44885;5;0;0;7504532;2633469;67;0;0
FR;0;2021-03-26;358757;41895;4;1;0;7863289;2675364;71;1;0
FR;0;2021-03-27;195241;16741;1;0;0;8058530;2692105;72;1;0
FR;0;2021-03-28;59324;4051;3;0;0;8117854;2696156;75;1;0
FR;0;2021-03-29;202939;53948;4;0;0;8320793;2750104;79;1;0
FR;0;2021-03-30;285440;69670;4;0;0;8606233;2819774;83;1;0
FR;0;2021-03-31;262978;73321;4;0;0;8869211;2893095;87;1;0
FR;0;2021-04-01;315405;89531;11;0;0;9184616;2982626;98;1;0
FR;0;2021-04-02;281291;92887;7;0;0;9465907;3075513;105;1;0
FR;0;2021-04-03;141054;61989;5;0;0;9606961;3137502;110;1;0
FR;0;2021-04-04;46494;18750;2;0;0;9653455;3156252;112;1;0
FR;0;2021-04-05;63313;10775;11;0;0;9716768;3167027;123;1;0
FR;0;2021-04-06;217162;109561;17;0;0;9933930;3276588;140;1;0
FR;0;2021-04-07;260214;115416;17;0;0;10194144;3392004;157;1;0
FR;0;2021-04-08;337757;121865;14;0;0;10531901;3513869;171;1;0
FR;0;2021-04-09;410090;116364;49;0;0;10941991;3630233;220;1;0
FR;0;2021-04-10;212590;82655;15;0;0;11154581;3712888;235;1;0
FR;0;2021-04-11;56127;34406;7;0;0;11210708;3747294;242;1;0
FR;0;2021-04-12;237017;115252;45;0;0;11447725;3862546;287;1;0
FR;0;2021-04-13;309431;144483;98;1;0;11757156;4007029;385;2;0
FR;0;2021-04-14;294458;139333;214;0;0;12051614;4146362;599;2;0
FR;0;2021-04-15;337030;148516;338;0;0;12388644;4294878;937;2;0
FR;0;2021-04-16;339234;145934;353;0;0;12727878;4440812;1290;2;0
FR;0;2021-04-17;188629;89992;109;0;0;12916507;4530804;1399;2;0
FR;0;2021-04-18;51605;35358;47;0;0;12968112;4566162;1446;2;0
FR;0;2021-04-19;205651;138219;456;0;0;13173763;4704381;1902;2;0
FR;0;2021-04-20;254359;170946;569;0;0;13428122;4875327;2471;2;0
FR;0;2021-04-21;253189;169195;834;0;0;13681311;5044522;3305;2;0
FR;0;2021-04-22;287504;188925;818;0;0;13968815;5233447;4123;2;0
FR;0;2021-04-23;297918;183459;747;0;0;14266733;5416906;4870;2;0
FR;0;2021-04-24;190414;111603;252;0;0;14457147;5528509;5122;2;0
FR;0;2021-04-25;69544;38783;51;0;0;14526691;5567292;5173;2;0
FR;0;2021-04-26;220906;156406;560;0;0;14747597;5723698;5733;2;0
FR;0;2021-04-27;284553;187391;940;0;0;15032150;5911089;6673;2;0
FR;0;2021-04-28;299450;183315;1423;1;1;15331600;6094404;8096;3;1
FR;0;2021-04-29;357068;196670;1277;0;0;15688668;6291074;9373;3;1
FR;0;2021-04-30;372151;184912;1119;1;0;16060819;6475986;10492;4;1
FR;0;2021-05-01;167611;52473;178;0;0;16228430;6528459;10670;4;1
FR;0;2021-05-02;91708;37754;83;0;0;16320138;6566213;10753;4;1
FR;0;2021-05-03;288867;168199;840;0;0;16609005;6734412;11593;4;1
FR;0;2021-05-04;315613;224465;1231;0;0;16924618;6958877;12824;4;1
FR;0;2021-05-05;327129;224871;1313;0;0;17251747;7183748;14137;4;1
FR;0;2021-05-06;379446;239530;1631;0;0;17631193;7423278;15768;4;1
FR;0;2021-05-07;372692;257413;1222;0;0;18003885;7680691;16990;4;1
FR;0;2021-05-08;222138;67729;299;0;0;18226023;7748420;17289;4;1
FR;0;2021-05-09;129685;46245;243;0;0;18355708;7794665;17532;4;1
FR;0;2021-05-10;313326;228824;1234;0;0;18669034;8023489;18766;4;1
FR;0;2021-05-11;403839;257838;1562;0;0;19072873;8281327;20328;4;1
FR;0;2021-05-12;434044;233133;1542;0;0;19506917;8514460;21870;4;1
FR;0;2021-05-13;338559;56905;430;0;0;19845476;8571365;22300;4;1
FR;0;2021-05-14;454065;167298;1124;0;0;20299541;8738663;23424;4;1
FR;0;2021-05-15;374927;94079;442;0;0;20674468;8832742;23866;4;1
FR;0;2021-05-16;202729;20761;168;0;0;20877197;8853503;24034;4;1
FR;0;2021-05-17;376076;148842;1552;0;0;21253273;9002345;25586;4;1
FR;0;2021-05-18;460083;153191;1987;0;0;21713356;9155536;27573;4;1
FR;0;2021-05-19;467332;144531;2458;0;0;22180688;9300067;30031;4;1
FR;0;2021-05-20;507469;160270;2333;0;0;22688157;9460337;32364;4;1
FR;0;2021-05-21;489607;174461;1988;0;0;23177764;9634798;34352;4;1
FR;0;2021-05-22;347153;79921;668;0;0;23524917;9714719;35020;4;1
FR;0;2021-05-23;161672;14360;246;0;0;23686589;9729079;35266;4;1
FR;0;2021-05-24;263160;33164;601;0;0;23949749;9762243;35867;4;1
FR;0;2021-05-25;400212;189319;2350;1;0;24349961;9951562;38217;5;1
FR;0;2021-05-26;413403;188699;2220;0;0;24763364;10140261;40437;5;1
FR;0;2021-05-27;449749;218865;2159;0;0;25213113;10359126;42596;5;1
FR;0;2021-05-28;429499;259566;1891;0;0;25642612;10618692;44487;5;1
FR;0;2021-05-29;298951;149459;583;0;0;25941563;10768151;45070;5;1
FR;0;2021-05-30;107124;32581;163;0;0;26048687;10800732;45233;5;1
FR;0;2021-05-31;357987;203314;1467;1;1;26406674;11004046;46700;6;2
FR;0;2021-06-01;430912;251190;1959;1;1;26837586;11255236;48659;7;3
FR;0;2021-06-02;419554;230946;1980;0;0;27257140;11486182;50639;7;3
FR;0;2021-06-03;465120;258389;1821;0;0;27722260;11744571;52460;7;3
FR;0;2021-06-04;455805;304749;1729;1;1;28178065;12049320;54189;8;4
FR;0;2021-06-05;304766;188993;651;0;0;28482831;12238313;54840;8;4
FR;0;2021-06-06;133254;49122;226;0;0;28616085;12287435;55066;8;4
FR;0;2021-06-07;339245;261892;1519;0;0;28955330;12549327;56585;8;4
FR;0;2021-06-08;393622;290895;1800;0;0;29348952;12840222;58385;8;4
FR;0;2021-06-09;384720;275284;1729;0;0;29733672;13115506;60114;8;4
FR;0;2021-06-10;404053;288719;1721;1;0;30137725;13404225;61835;9;4
FR;0;2021-06-11;386572;357119;1462;0;0;30524297;13761344;63297;9;4
FR;0;2021-06-12;283218;211269;491;0;0;30807515;13972613;63788;9;4
FR;0;2021-06-13;104842;73957;204;0;0;30912357;14046570;63992;9;4
FR;0;2021-06-14;240753;355412;1426;1;0;31153110;14401982;65418;10;4
FR;0;2021-06-15;308055;385518;1565;1;0;31461165;14787500;66983;11;4
FR;0;2021-06-16;313912;357697;1417;1;0;31775077;15145197;68400;12;4
FR;0;2021-06-17;317609;372525;1422;1;0;32092686;15517722;69822;13;4
FR;0;2021-06-18;321631;442449;1333;1;0;32414317;15960171;71155;14;4
FR;0;2021-06-19;224323;273796;448;0;0;32638640;16233967;71603;14;4
FR;0;2021-06-20;74376;102569;127;0;0;32713016;16336536;71730;14;4
FR;0;2021-06-21;195580;401868;1033;1;1;32908596;16738404;72763;15;5
FR;0;2021-06-22;223022;467413;1262;10;2;33131618;17205817;74025;25;7
FR;0;2021-06-23;233887;439886;1196;1;1;33365505;17645703;75221;26;8
FR;0;2021-06-24;241741;409572;1351;0;0;33607246;18055275;76572;26;8
FR;0;2021-06-25;227489;522281;1398;0;0;33834735;18577556;77970;26;8
FR;0;2021-06-26;153199;370751;586;1;0;33987934;18948307;78556;27;8
FR;0;2021-06-27;55869;156203;168;1;0;34043803;19104510;78724;28;8
FR;0;2021-06-28;154625;452877;1169;0;0;34198428;19557387;79893;28;8
FR;0;2021-06-29;182559;506864;2124;0;0;34380987;20064251;82017;28;8
FR;0;2021-06-30;203857;483054;2010;21;2;34584844;20547305;84027;49;10
FR;0;2021-07-01;231146;457863;2221;5;1;34815990;21005168;86248;54;11
FR;0;2021-07-02;228384;520202;2119;5;3;35044374;21525370;88367;59;14
FR;0;2021-07-03;141958;368735;909;3;1;35186332;21894105;89276;62;15
FR;0;2021-07-04;56694;141242;265;0;0;35243026;22035347;89541;62;15
FR;0;2021-07-05;168262;419254;1668;8;2;35411288;22454601;91209;70;17
FR;0;2021-07-06;196603;474801;1828;45;8;35607891;22929402;93037;115;25
FR;0;2021-07-07;212994;439307;1877;24;5;35820885;23368709;94914;139;30
FR;0;2021-07-08;231475;424194;2089;20;7;36052360;23792903;97003;159;37
FR;0;2021-07-09;228372;510861;2182;4;2;36280732;24303764;99185;163;39
FR;0;2021-07-10;148543;339889;982;1;1;36429275;24643653;100167;164;40
FR;0;2021-07-11;60152;110138;282;0;0;36489427;24753791;100449;164;40
FR;0;2021-07-12;168986;478189;1758;4;0;36658413;25231980;102207;168;40
FR;0;2021-07-13;287089;527413;2045;8;2;36945502;25759393;104252;176;42
FR;0;2021-07-14;180919;157702;434;0;0;37126421;25917095;104686;176;42
FR;0;2021-07-15;346930;502439;2097;1;0;37473351;26419534;106783;177;42
FR;0;2021-07-16;379944;495920;2022;3;1;37853295;26915454;108805;180;43
FR;0;2021-07-17;259658;319795;876;1;0;38112953;27235249;109681;181;43
FR;0;2021-07-18;109671;114778;310;0;0;38222624;27350027;109991;181;43
FR;0;2021-07-19;285340;424960;1628;3;0;38507964;27774987;111619;184;43
FR;0;2021-07-20;376753;452364;1722;0;0;38884717;28227351;113341;184;43
FR;0;2021-07-21;395650;407853;1549;4;2;39280367;28635204;114890;188;45
FR;0;2021-07-22;440918;388085;1714;4;2;39721285;29023289;116604;192;47
FR;0;2021-07-23;440166;423117;1880;4;2;40161451;29446406;118484;196;49
FR;0;2021-07-24;285187;269595;803;1;0;40446638;29716001;119287;197;49
FR;0;2021-07-25;121058;80044;230;0;0;40567696;29796045;119517;197;49
FR;0;2021-07-26;347289;323146;1615;3;2;40914985;30119191;121132;200;51
FR;0;2021-07-27;463917;320232;1696;4;2;41378902;30439423;122828;204;53
FR;0;2021-07-28;459321;289968;1634;4;2;41838223;30729391;124462;208;55
FR;0;2021-07-29;489698;276892;1794;2;1;42327921;31006283;126256;210;56
FR;0;2021-07-30;461660;302841;1935;5;2;42789581;31309124;128191;215;58
FR;0;2021-07-31;285349;185073;914;1;0;43074930;31494197;129105;216;58
FR;0;2021-08-01;111947;49988;253;0;0;43186877;31544185;129358;216;58
FR;0;2021-08-02;341252;234569;1599;2;0;43528129;31778754;130957;218;58
FR;0;2021-08-03;398445;245013;1718;2;1;43926574;32023767;132675;220;59
FR;0;2021-08-04;384675;210071;1591;6;3;44311249;32233838;134266;226;62
FR;0;2021-08-05;366010;228873;1709;0;0;44677259;32462711;135975;226;62
FR;0;2021-08-06;359599;271657;1834;4;1;45036858;32734368;137809;230;63
FR;0;2021-08-07;213051;178371;755;4;3;45249909;32912739;138564;234;66
FR;0;2021-08-08;74141;63235;270;0;0;45324050;32975974;138834;234;66
FR;0;2021-08-09;258604;259480;1543;4;3;45582654;33235454;140377;238;69
FR;0;2021-08-10;306645;277973;1656;2;1;45889299;33513427;142033;240;70
FR;0;2021-08-11;279580;260184;1441;5;1;46168879;33773611;143474;245;71
FR;0;2021-08-12;271419;278616;1661;3;1;46440298;34052227;145135;248;72
FR;0;2021-08-13;252054;277966;1591;3;2;46692352;34330193;146726;251;74
FR;0;2021-08-14;145295;197321;739;0;0;46837647;34527514;147465;251;74
FR;0;2021-08-15;39316;50121;216;1;0;46876963;34577635;147681;252;74
FR;0;2021-08-16;186069;318101;1539;0;0;47063032;34895736;149220;252;74
FR;0;2021-08-17;215581;336503;1635;7;1;47278613;35232239;150855;259;75
FR;0;2021-08-18;198966;324746;1594;7;4;47477579;35556985;152449;266;79
FR;0;2021-08-19;191934;325794;1637;1;0;47669513;35882779;154086;267;79
FR;0;2021-08-20;186375;366429;1813;3;2;47855888;36249208;155899;270;81
FR;0;2021-08-21;104766;238164;704;0;0;47960654;36487372;156603;270;81
FR;0;2021-08-22;31894;87202;253;1;1;47992548;36574574;156856;271;82
FR;0;2021-08-23;140904;357260;1560;3;1;48133452;36931834;158416;274;83
FR;0;2021-08-24;162416;376896;1847;5;1;48295868;37308730;160263;279;84
FR;0;2021-08-25;151075;350870;2029;8;3;48446943;37659600;162292;287;87
FR;0;2021-08-26;142773;342887;2555;10;1;48589716;38002487;164847;297;88
FR;0;2021-08-27;148379;388274;2789;11;3;48738095;38390761;167636;308;91
FR;0;2021-08-28;90622;249587;1405;0;0;48828717;38640348;169041;308;91
FR;0;2021-08-29;27303;83338;517;1;0;48856020;38723686;169558;309;91
FR;0;2021-08-30;117339;324883;4707;6;6017;48973359;39048569;174265;315;6108
FR;0;2021-08-31;128721;334632;10179;19;11856;49102080;39383201;184444;334;17964
FR;0;2021-09-01;135822;285715;22421;7;24324;49237902;39668916;206865;341;42288
FR;0;2021-09-02;112716;247296;26512;13;28882;49350618;39916212;233377;354;71170
FR;0;2021-09-03;118222;292731;29956;23;32969;49468840;40208943;263333;377;104139
FR;0;2021-09-04;89849;217755;12583;12;14084;49558689;40426698;275916;389;118223
FR;0;2021-09-05;21346;44860;4391;2;4733;49580035;40471558;280307;391;122956
FR;0;2021-09-06;75348;180779;31946;16;34235;49655383;40652337;312253;407;157191
FR;0;2021-09-07;80151;181280;33238;40;36127;49735534;40833617;345491;447;193318
FR;0;2021-09-08;90053;206220;29654;27;32466;49825587;41039837;375145;474;225784
FR;0;2021-09-09;76739;165426;33043;26;36535;49902326;41205263;408188;500;262319
FR;0;2021-09-10;95765;203708;35718;26;40526;49998091;41408971;443906;526;302845
FR;0;2021-09-11;66883;169241;12136;19;14325;50064974;41578212;456042;545;317170
FR;0;2021-09-12;12804;32086;2768;1;3160;50077778;41610298;458810;546;320330
FR;0;2021-09-13;64411;126357;41209;33;44079;50142189;41736655;500019;579;364409
FR;0;2021-09-14;73369;129135;56349;78;62092;50215558;41865790;556368;657;426501
FR;0;2021-09-15;76443;167899;55632;58;54783;50292001;42033689;612000;715;481284
FR;0;2021-09-16;63781;114582;60038;85;60037;50355782;42148271;672038;800;541321
FR;0;2021-09-17;75000;156855;53831;71;57246;50430782;42305126;725869;871;598567
FR;0;2021-09-18;48202;139597;15599;25;17288;50478984;42444723;741468;896;615855
FR;0;2021-09-19;7869;23720;2435;1;2620;50486853;42468443;743903;897;618475
FR;0;2021-09-20;44475;93931;50029;73;50262;50531328;42562374;793932;970;668737
FR;0;2021-09-21;45819;98462;62733;76;63395;50577147;42660836;856665;1046;732132
FR;0;2021-09-22;48626;142322;55337;83;55363;50625773;42803158;912002;1129;787495
FR;0;2021-09-23;43205;92033;62360;94;63481;50668978;42895191;974362;1223;850976
FR;0;2021-09-24;52251;133329;54531;109;59117;50721229;43028520;1028893;1332;910093
FR;0;2021-09-25;35198;115549;16266;37;18261;50756427;43144069;1045159;1369;928354
FR;0;2021-09-26;5528;17800;2266;5;2327;50761955;43161869;1047425;1374;930681
FR;0;2021-09-27;33936;76977;47179;97;48145;50795891;43238846;1094604;1471;978826
FR;0;2021-09-28;36473;75286;54939;88;56498;50832364;43314132;1149543;1559;1035324
FR;0;2021-09-29;44336;100840;53324;112;54819;50876700;43414972;1202867;1671;1090143
FR;0;2021-09-30;36278;72860;57012;96;59495;50912978;43487832;1259879;1767;1149638
FR;0;2021-10-01;61555;100954;57781;108;63709;50974533;43588786;1317660;1875;1213347
FR;0;2021-10-02;39429;78384;20953;38;23321;51013962;43667170;1338613;1913;1236668
FR;0;2021-10-03;5274;10526;2524;4;2538;51019236;43677696;1341137;1917;1239206
FR;0;2021-10-04;35031;58565;52610;84;54783;51054267;43736261;1393747;2001;1293989
FR;0;2021-10-05;33682;64349;60968;135;64940;51087949;43800610;1454715;2136;1358929
FR;0;2021-10-06;42533;79300;65697;113;68240;51130482;43879910;1520412;2249;1427169
FR;0;2021-10-07;30450;62184;65387;90;68680;51160932;43942094;1585799;2339;1495849
FR;0;2021-10-08;48785;91830;77721;110;84627;51209717;44033924;1663520;2449;1580476
FR;0;2021-10-09;33638;60899;31526;35;33871;51243355;44094823;1695046;2484;1614347
FR;0;2021-10-10;4654;7446;3187;9;3484;51248009;44102269;1698233;2493;1617831
FR;0;2021-10-11;30596;49890;61021;105;64019;51278605;44152159;1759254;2598;1681850
FR;0;2021-10-12;31466;54442;70569;139;75845;51310071;44206601;1829823;2737;1757695
FR;0;2021-10-13;40036;62832;74404;136;79261;51350107;44269433;1904227;2873;1836956
FR;0;2021-10-14;30258;52912;68727;116;73767;51380365;44322345;1972954;2989;1910723
FR;0;2021-10-15;44753;75278;93218;191;102906;51425118;44397623;2066172;3180;2013629
FR;0;2021-10-16;31286;44106;36685;44;39615;51456404;44441729;2102857;3224;2053244
FR;0;2021-10-17;3833;5273;3592;2;3690;51460237;44447002;2106449;3226;2056934
FR;0;2021-10-18;28449;42479;67473;133;71341;51488686;44489481;2173922;3359;2128275
FR;0;2021-10-19;27066;44760;76382;140;81607;51515752;44534241;2250304;3499;2209882
FR;0;2021-10-20;35228;52491;96912;180;101487;51550980;44586732;2347216;3679;2311369
FR;0;2021-10-21;25978;45210;83924;112;89112;51576958;44631942;2431140;3791;2400481
FR;0;2021-10-22;38220;62448;104869;200;112502;51615178;44694390;2536009;3991;2512983
FR;0;2021-10-23;26976;41233;45439;57;48605;51642154;44735623;2581448;4048;2561588
FR;0;2021-10-24;2913;4795;3679;6;3936;51645067;44740418;2585127;4054;2565524
FR;0;2021-10-25;25984;36346;82310;144;86609;51671051;44776764;2667437;4198;2652133
FR;0;2021-10-26;23696;35108;87210;166;92316;51694747;44811872;2754647;4364;2744449
FR;0;2021-10-27;30024;46432;108970;257;114626;51724771;44858304;2863617;4621;2859075
FR;0;2021-10-28;23466;34933;88662;153;94408;51748237;44893237;2952279;4774;2953483
FR;0;2021-10-29;31525;51450;117288;204;125269;51779762;44944687;3069567;4978;3078752
FR;0;2021-10-30;20539;33219;50325;77;53357;51800301;44977906;3119892;5055;3132109
FR;0;2021-10-31;2481;3753;3585;3;3869;51802782;44981659;3123477;5058;3135978
FR;0;2021-11-01;8261;4825;3203;3;3559;51811043;44986484;3126680;5061;3139537
FR;0;2021-11-02;25377;40102;93539;157;99489;51836420;45026586;3220219;5218;3239026
FR;0;2021-11-03;29817;47949;118848;218;125792;51866237;45074535;3339067;5436;3364818
FR;0;2021-11-04;23690;37517;107508;217;114337;51889927;45112052;3446575;5653;3479155
FR;0;2021-11-05;32300;52926;141594;234;151266;51922227;45164978;3588169;5887;3630421
FR;0;2021-11-06;21502;34574;64847;123;68240;51943729;45199552;3653016;6010;3698661
FR;0;2021-11-07;2380;4220;5180;6;5588;51946109;45203772;3658196;6016;3704249
FR;0;2021-11-08;20489;37836;127149;227;134209;51966598;45241608;3785345;6243;3838458
FR;0;2021-11-09;22231;44815;161639;341;172154;51988829;45286423;3946984;6584;4010612
FR;0;2021-11-10;31429;55130;186938;446;198698;52020258;45341553;4133922;7030;4209310
FR;0;2021-11-11;4395;6749;12934;28;13933;52024653;45348302;4146856;7058;4223243
FR;0;2021-11-12;29008;55143;183725;252;197279;52053661;45403445;4330581;7310;4420522
FR;0;2021-11-13;20324;32716;80678;118;86290;52073985;45436161;4411259;7428;4506812
FR;0;2021-11-14;2338;3931;7165;6;7868;52076323;45440092;4418424;7434;4514680
FR;0;2021-11-15;20392;38783;160800;313;171477;52096715;45478875;4579224;7747;4686157
FR;0;2021-11-16;23435;44075;200331;391;214909;52120150;45522950;4779555;8138;4901066
FR;0;2021-11-17;30390;50463;199788;407;212800;52150540;45573413;4979343;8545;5113866
FR;0;2021-11-18;23370;45122;191600;468;205438;52173910;45618535;5170943;9013;5319304
FR;0;2021-11-19;33568;61400;243140;548;262079;52207478;45679935;5414083;9561;5581383
FR;0;2021-11-20;25383;36779;102123;206;109673;52232861;45716714;5516206;9767;5691056
FR;0;2021-11-21;2623;4556;9643;18;10637;52235484;45721270;5525849;9785;5701693
FR;0;2021-11-22;22749;33359;180297;470;194760;52258233;45754629;5706146;10255;5896453
FR;0;2021-11-23;25577;45728;229309;548;247735;52283810;45800357;5935455;10803;6144188
FR;0;2021-11-24;31775;53862;224742;717;243154;52315585;45854219;6160197;11520;6387342
FR;0;2021-11-25;25445;49182;255851;739;277636;52341030;45903401;6416048;12259;6664978
FR;0;2021-11-26;33218;74709;379398;864;414534;52374248;45978110;6795446;13123;7079512
FR;0;2021-11-27;23353;49741;214858;389;236600;52397601;46027851;7010304;13512;7316112
FR;0;2021-11-28;3481;10582;56732;66;63339;52401082;46038433;7067036;13578;7379451
FR;0;2021-11-29;19390;54241;341392;863;371571;52420472;46092674;7408428;14441;7751022
FR;0;2021-11-30;24736;72167;457301;988;500654;52445208;46164841;7865729;15429;8251676
FR;0;2021-12-01;26950;75962;468991;1159;511205;52472158;46240803;8334720;16588;8762881
FR;0;2021-12-02;22013;71864;526996;1280;574722;52494171;46312667;8861716;17868;9337603
FR;0;2021-12-03;25503;92568;596259;1419;651006;52519674;46405235;9457975;19287;9988609
FR;0;2021-12-04;18304;60538;336173;690;369707;52537978;46465773;9794148;19977;10358316
FR;0;2021-12-05;4144;16260;95755;157;107059;52542122;46482033;9889903;20134;10465375
FR;0;2021-12-06;24726;73209;493046;1174;539862;52566848;46555242;10382949;21308;11005237
FR;0;2021-12-07;23355;91793;645268;1769;706196;52590203;46647035;11028217;23077;11711433
FR;0;2021-12-08;25368;92509;591465;1873;647406;52615571;46739544;11619682;24950;12358839
FR;0;2021-12-09;24009;94359;662969;2179;726238;52639580;46833903;12282651;27129;13085077
FR;0;2021-12-10;27942;111186;735944;2076;806003;52667522;46945089;13018595;29205;13891080
FR;0;2021-12-11;20232;76103;435132;986;480341;52687754;47021192;13453727;30191;14371421
FR;0;2021-12-12;5626;23292;142271;262;159220;52693380;47044484;13595998;30453;14530641
FR;0;2021-12-13;21270;91363;587525;1698;649199;52714650;47135847;14183523;32151;15179840
FR;0;2021-12-14;27712;118773;765396;2653;847393;52742362;47254620;14948919;34804;16027233
FR;0;2021-12-15;28280;114630;694193;2263;768941;52770642;47369250;15643112;37067;16796174
FR;0;2021-12-16;27973;116108;763898;2556;844287;52798615;47485358;16407010;39623;17640461
FR;0;2021-12-17;31588;128881;807747;2709;892021;52830203;47614239;17214757;42332;18532482
FR;0;2021-12-18;24920;81806;469913;1178;522163;52855123;47696045;17684670;43510;19054645
FR;0;2021-12-19;8752;28847;169356;377;191130;52863875;47724892;17854026;43887;19245775
FR;0;2021-12-20;31675;97584;591352;1787;658639;52895550;47822476;18445378;45674;19904414
FR;0;2021-12-21;39241;112413;682311;2391;759489;52934791;47934889;19127689;48065;20663903
FR;0;2021-12-22;39481;99694;575663;2167;642059;52974272;48034583;19703352;50232;21305962
FR;0;2021-12-23;33755;79770;440905;1654;494325;53008027;48114353;20144257;51886;21800287
FR;0;2021-12-24;10670;26082;110978;396;126644;53018697;48140435;20255235;52282;21926931
FR;0;2021-12-25;770;3533;7573;25;9029;53019467;48143968;20262808;52307;21935960
FR;0;2021-12-26;4698;11906;52075;141;60128;53024165;48155874;20314883;52448;21996088
FR;0;2021-12-27;30418;84104;453458;1365;509087;53054583;48239978;20768341;53813;22505175
FR;0;2021-12-28;38324;99109;564082;1767;632176;53092907;48339087;21332423;55580;23137351
FR;0;2021-12-29;39856;88478;501122;1686;560927;53132763;48427565;21833545;57266;23698278
FR;0;2021-12-30;35893;75167;420971;1519;471102;53168656;48502732;22254516;58785;24169380
FR;0;2021-12-31;12039;25209;116840;406;131621;53180695;48527941;22371356;59191;24301001
FR;0;2022-01-01;1447;3207;8501;36;9932;53182142;48531148;22379857;59227;24310933
FR;0;2022-01-02;6089;13014;58402;125;66943;53188231;48544162;22438259;59352;24377876
FR;0;2022-01-03;33807;90051;494711;1593;551532;53222038;48634213;22932970;60945;24929408
FR;0;2022-01-04;41235;110986;641286;2303;714250;53263273;48745199;23574256;63248;25643658
FR;0;2022-01-05;60585;103476;569052;1984;634075;53323858;48848675;24143308;65232;26277733
FR;0;2022-01-06;44134;110242;638897;2694;711357;53367992;48958917;24782205;67926;26989090
FR;0;2022-01-07;50733;123186;710916;2807;790368;53418725;49082103;25493121;70733;27779458
FR;0;2022-01-08;44984;80339;423784;1211;472855;53463709;49162442;25916905;71944;28252313
FR;0;2022-01-09;15597;26692;128549;300;145691;53479306;49189134;26045454;72244;28398004
FR;0;2022-01-10;35222;90445;469215;1810;522385;53514528;49279579;26514669;74054;28920389
FR;0;2022-01-11;41717;100425;548144;2307;608424;53556245;49380004;27062813;76361;29528813
FR;0;2022-01-12;60251;95634;452575;1965;504237;53616496;49475638;27515388;78326;30033050
FR;0;2022-01-13;38093;92446;487259;2084;540968;53654589;49568084;28002647;80410;30574018
FR;0;2022-01-14;42477;103317;568495;2286;628956;53697066;49671401;28571142;82696;31202974
FR;0;2022-01-15;39355;65868;340100;985;377560;53736421;49737269;28911242;83681;31580534
FR;0;2022-01-16;11385;19297;87389;216;99448;53747806;49756566;28998631;83897;31679982
FR;0;2022-01-17;24643;60136;320219;1381;354141;53772449;49816702;29318850;85278;32034123
FR;0;2022-01-18;28141;68623;361008;1799;397516;53800590;49885325;29679858;87077;32431639
FR;0;2022-01-19;43145;67115;281218;1450;311058;53843735;49952440;29961076;88527;32742697
FR;0;2022-01-20;23520;59582;298920;1741;328449;53867255;50012022;30259996;90268;33071146
FR;0;2022-01-21;28082;68802;366290;2086;401136;53895337;50080824;30626286;92354;33472282
FR;0;2022-01-22;27610;48005;218764;838;241748;53922947;50128829;30845050;93192;33714030
FR;0;2022-01-23;6706;13038;48651;171;55175;53929653;50141867;30893701;93363;33769205
FR;0;2022-01-24;16214;47429;217251;1136;239320;53945867;50189296;31110952;94499;34008525
FR;0;2022-01-25;18920;54407;242987;1547;267047;53964787;50243703;31353939;96046;34275572
FR;0;2022-01-26;28130;60306;209224;1296;229368;53992917;50304009;31563163;97342;34504940
FR;0;2022-01-27;16297;46113;207588;1272;225841;54009214;50350122;31770751;98614;34730781
FR;0;2022-01-28;21505;76332;289991;1574;321442;54030719;50426454;32060742;100188;35052223
FR;0;2022-01-29;18408;52847;184092;686;204578;54049127;50479301;32244834;100874;35256801
FR;0;2022-01-30;4465;14533;39125;124;45085;54053592;50493834;32283959;100998;35301886
FR;0;2022-01-31;11228;43858;148161;738;164796;54064820;50537692;32432120;101736;35466682
FR;0;2022-02-01;12977;48202;174069;1141;191373;54077797;50585894;32606189;102877;35658055
FR;0;2022-02-02;20150;65982;171476;1033;190136;54097947;50651876;32777665;103910;35848191
FR;0;2022-02-03;11018;44283;157495;984;173304;54108965;50696159;32935160;104894;36021495
FR;0;2022-02-04;14531;66516;239181;1262;264164;54123496;50762675;33174341;106156;36285659
FR;0;2022-02-05;12875;51456;153525;522;172346;54136371;50814131;33327866;106678;36458005
FR;0;2022-02-06;2706;12223;28870;101;33824;54139077;50826354;33356736;106779;36491829
FR;0;2022-02-07;9443;46759;156827;586;176325;54148520;50873113;33513563;107365;36668154
FR;0;2022-02-08;9632;42790;166566;868;184343;54158152;50915903;33680129;108233;36852497
FR;0;2022-02-09;14200;57996;172300;869;192982;54172352;50973899;33852429;109102;37045479
FR;0;2022-02-10;8290;38550;150164;878;166620;54180642;51012449;34002593;109980;37212099
FR;0;2022-02-11;10771;55527;218445;1099;243025;54191413;51067976;34221038;111079;37455124
FR;0;2022-02-12;8356;40893;134696;461;151714;54199769;51108869;34355734;111540;37606838
FR;0;2022-02-13;1897;8582;26555;85;30911;54201666;51117451;34382289;111625;37637749
FR;0;2022-02-14;6919;35145;148322;478;166322;54208585;51152596;34530611;112103;37804071
FR;0;2022-02-15;6868;35594;146918;750;162480;54215453;51188190;34677529;112853;37966551
FR;0;2022-02-16;9313;42783;132487;719;146690;54224766;51230973;34810016;113572;38113241
FR;0;2022-02-17;5389;24060;87259;584;94813;54230155;51255033;34897275;114156;38208054
FR;0;2022-02-18;6926;33411;119607;804;129273;54237081;51288444;35016882;114960;38337327
FR;0;2022-02-19;5357;24498;70010;370;77315;54242438;51312942;35086892;115330;38414642
FR;0;2022-02-20;1139;4624;12153;38;13927;54243577;51317566;35099045;115368;38428569
FR;0;2022-02-21;4031;17790;61921;351;67149;54247608;51335356;35160966;115719;38495718
FR;0;2022-02-22;4379;18532;60787;575;64419;54251987;51353888;35221753;116294;38560137
FR;0;2022-02-23;6520;27252;66471;591;71870;54258507;51381140;35288224;116885;38632007
FR;0;2022-02-24;3757;15300;50385;518;53204;54262264;51396440;35338609;117403;38685211
FR;0;2022-02-25;5215;23745;76285;803;80009;54267479;51420185;35414894;118206;38765220
FR;0;2022-02-26;3974;17743;47393;358;51458;54271453;51437928;35462287;118564;38816678
FR;0;2022-02-27;872;2988;8023;47;8934;54272325;51440916;35470310;118611;38825612
FR;0;2022-02-28;3074;12332;40453;356;42887;54275399;51453248;35510763;118967;38868499
FR;0;2022-03-01;3231;12270;44141;433;44779;54278630;51465518;35554904;119400;38913278
FR;0;2022-03-02;5151;17512;47093;438;49006;54283781;51483030;35601997;119838;38962284
FR;0;2022-03-03;2705;8984;29839;363;29937;54286486;51492014;35631836;120201;38992221
FR;0;2022-03-04;3192;12221;40265;650;39398;54289678;51504235;35672101;120851;39031619
FR;0;2022-03-05;3059;9216;24936;310;25088;54292737;51513451;35697037;121161;39056707
FR;0;2022-03-06;510;1384;3193;43;3431;54293247;51514835;35700230;121204;39060138
FR;0;2022-03-07;2085;5498;18403;314;17665;54295332;51520333;35718633;121518;39077803
FR;0;2022-03-08;1999;5923;19413;359;17874;54297331;51526256;35738046;121877;39095677
FR;0;2022-03-09;3471;10327;22157;405;21241;54300802;51536583;35760203;122282;39116918
FR;0;2022-03-10;1722;5297;16928;342;15735;54302524;51541880;35777131;122624;39132653
FR;0;2022-03-11;2346;7320;24479;540;22238;54304870;51549200;35801610;123164;39154891
FR;0;2022-03-12;2657;6720;17151;304;16502;54307527;51555920;35818761;123468;39171393
FR;0;2022-03-13;387;783;2310;145;2261;54307914;51556703;35821071;123613;39173654
FR;0;2022-03-14;1476;4175;14941;4404;13796;54309390;51560878;35836012;128017;39187450
FR;0;2022-03-15;1602;4405;16251;7549;14355;54310992;51565283;35852263;135566;39201805
FR;0;2022-03-16;2954;7120;19387;13128;18051;54313946;51572403;35871650;148694;39219856
FR;0;2022-03-17;1377;3760;13098;10838;11939;54315323;51576163;35884748;159532;39231795
FR;0;2022-03-18;2208;5558;19955;18277;18044;54317531;51581721;35904703;177809;39249839
FR;0;2022-03-19;2284;4725;13108;9396;12409;54319815;51586446;35917811;187205;39262248
FR;0;2022-03-20;293;710;1913;1066;1922;54320108;51587156;35919724;188271;39264170
FR;0;2022-03-21;1344;3144;12696;14929;11918;54321452;51590300;35932420;203200;39276088
FR;0;2022-03-22;1465;3600;13762;20520;12518;54322917;51593900;35946182;223720;39288606
FR;0;2022-03-23;2644;6124;17673;23134;17183;54325561;51600024;35963855;246854;39305789
FR;0;2022-03-24;1357;2941;11556;17571;10626;54326918;51602965;35975411;264425;39316415
FR;0;2022-03-25;2049;4857;18514;27741;16843;54328967;51607822;35993925;292166;39333258
FR;0;2022-03-26;2218;4371;12063;12658;11500;54331185;51612193;36005988;304824;39344758
FR;0;2022-03-27;354;683;1892;1479;1925;54331539;51612876;36007880;306303;39346683
FR;0;2022-03-28;1415;3013;11095;17452;10586;54332954;51615889;36018975;323755;39357269
FR;0;2022-03-29;1426;3235;12878;27532;12022;54334380;51619124;36031853;351287;39369291
FR;0;2022-03-30;2817;5382;15640;27344;15036;54337197;51624506;36047493;378631;39384327
FR;0;2022-03-31;1600;3201;12939;24890;12269;54338797;51627707;36060432;403521;39396596
FR;0;2022-04-01;2118;4331;19995;30816;18610;54340915;51632038;36080427;434337;39415206
FR;0;2022-04-02;1501;2614;9034;10101;8695;54342416;51634652;36089461;444438;39423901
FR;0;2022-04-03;277;501;1557;1168;1573;54342693;51635153;36091018;445606;39425474
FR;0;2022-04-04;1401;2612;12300;19071;11485;54344094;51637765;36103318;464677;39436959
FR;0;2022-04-05;1612;2949;14278;33988;13123;54345706;51640714;36117596;498665;39450082
FR;0;2022-04-06;2042;3672;13468;26340;12724;54347748;51644386;36131064;525005;39462806
FR;0;2022-04-07;1434;2911;13602;33669;12809;54349182;51647297;36144666;558674;39475615
FR;0;2022-04-08;2019;4081;19144;43683;17758;54351201;51651378;36163810;602357;39493373
FR;0;2022-04-09;1351;2653;9295;13541;8842;54352552;51654031;36173105;615898;39502215
FR;0;2022-04-10;282;565;1973;1992;1982;54352834;51654596;36175078;617890;39504197
FR;0;2022-04-11;1195;2465;11826;23643;11428;54354029;51657061;36186904;641533;39515625
FR;0;2022-04-12;1579;2781;13938;40609;13313;54355608;51659842;36200842;682142;39528938
FR;0;2022-04-13;1867;3448;13339;32830;12937;54357475;51663290;36214181;714972;39541875
FR;0;2022-04-14;1442;2688;13096;36012;12945;54358917;51665978;36227277;750984;39554820
FR;0;2022-04-15;1790;3299;15533;35301;14776;54360707;51669277;36242810;786285;39569596
FR;0;2022-04-16;1033;1812;6369;8518;6221;54361740;51671089;36249179;794803;39575817
FR;0;2022-04-17;185;317;991;1163;1030;54361925;51671406;36250170;795966;39576847
FR;0;2022-04-18;158;449;2747;1057;2765;54362083;51671855;36252917;797023;39579612
FR;0;2022-04-19;1482;2915;12864;29450;12372;54363565;51674770;36265781;826473;39591984
FR;0;2022-04-20;1916;3347;13221;28853;12888;54365481;51678117;36279002;855326;39604872
FR;0;2022-04-21;1476;2741;12452;34807;12472;54366957;51680858;36291454;890133;39617344
FR;0;2022-04-22;1828;3477;16413;37448;15784;54368785;51684335;36307867;927581;39633128
FR;0;2022-04-23;1128;2039;7366;10640;7217;54369913;51686374;36315233;938221;39640345
FR;0;2022-04-24;246;442;1471;1579;1405;54370159;51686816;36316704;939800;39641750
FR;0;2022-04-25;1262;2450;10652;20897;10444;54371421;51689266;36327356;960697;39652194
FR;0;2022-04-26;1569;2952;13611;38333;13057;54372990;51692218;36340967;999030;39665251
FR;0;2022-04-27;1913;3007;11469;30631;11523;54374903;51695225;36352436;1029661;39676774
FR;0;2022-04-28;1528;2649;12468;35774;12183;54376431;51697874;36364904;1065435;39688957
FR;0;2022-04-29;1956;3444;15480;36945;14829;54378387;51701318;36380384;1102380;39703786
FR;0;2022-04-30;1190;1805;6898;9673;6729;54379577;51703123;36387282;1112053;39710515
FR;0;2022-05-01;193;307;893;964;890;54379770;51703430;36388175;1113017;39711405
FR;0;2022-05-02;1193;2226;11031;17848;10813;54380963;51705656;36399206;1130865;39722218
FR;0;2022-05-03;1750;2936;13546;34311;13384;54382713;51708592;36412752;1165176;39735602
FR;0;2022-05-04;1819;2986;12040;25335;12138;54384532;51711578;36424792;1190511;39747740
FR;0;2022-05-05;1624;2644;12544;33078;12335;54386156;51714222;36437336;1223589;39760075
FR;0;2022-05-06;2059;3517;15220;36463;14688;54388215;51717739;36452556;1260052;39774763
FR;0;2022-05-07;1182;1758;6426;9589;6415;54389397;51719497;36458982;1269641;39781178
FR;0;2022-05-08;259;389;1164;1529;1222;54389656;51719886;36460146;1271170;39782400
FR;0;2022-05-09;1253;2130;9860;19993;9723;54390909;51722016;36470006;1291163;39792123
FR;0;2022-05-10;1638;2866;13379;38559;12919;54392547;51724882;36483385;1329722;39805042
FR;0;2022-05-11;1928;2706;10628;27608;10527;54394475;51727588;36494013;1357330;39815569
FR;0;2022-05-12;1515;2496;11178;35202;10800;54395990;51730084;36505191;1392532;39826369
FR;0;2022-05-13;1923;3098;13635;37535;13211;54397913;51733182;36518826;1430067;39839580
FR;0;2022-05-14;1127;1590;5895;10700;5745;54399040;51734772;36524721;1440767;39845325
FR;0;2022-05-15;265;416;1246;1428;1322;54399305;51735188;36525967;1442195;39846647
FR;0;2022-05-16;1151;1925;8574;20753;8561;54400456;51737113;36534541;1462948;39855208
FR;0;2022-05-17;1530;2486;11726;37368;11302;54401986;51739599;36546267;1500316;39866510
FR;0;2022-05-18;1740;2517;9530;26896;9505;54403726;51742116;36555797;1527212;39876015
FR;0;2022-05-19;1386;2517;10431;35206;10502;54405112;51744633;36566228;1562418;39886517
FR;0;2022-05-20;1831;2983;13140;39065;12637;54406943;51747616;36579368;1601483;39899154
FR;0;2022-05-21;1134;1667;5628;9807;5492;54408077;51749283;36584996;1611290;39904646
FR;0;2022-05-22;227;324;1009;1399;998;54408304;51749607;36586005;1612689;39905644
FR;0;2022-05-23;1110;1972;8769;19960;8678;54409414;51751579;36594774;1632649;39914322
FR;0;2022-05-24;1487;2676;11207;38119;11032;54410901;51754255;36605981;1670768;39925354
FR;0;2022-05-25;1763;2724;9201;24526;9301;54412664;51756979;36615182;1695294;39934655
FR;0;2022-05-26;174;316;1497;1128;1507;54412838;51757295;36616679;1696422;39936162
FR;0;2022-05-27;1330;2316;8766;21139;8528;54414168;51759611;36625445;1717561;39944690
FR;0;2022-05-28;645;1235;3795;6756;3864;54414813;51760846;36629240;1724317;39948554
FR;0;2022-05-29;140;303;740;907;756;54414953;51761149;36629980;1725224;39949310
FR;0;2022-05-30;971;1880;6853;18989;6828;54415924;51763029;36636833;1744213;39956138
FR;0;2022-05-31;1442;2366;9628;35253;9471;54417366;51765395;36646461;1779466;39965609
FR;0;2022-06-01;1520;2607;9172;23914;9006;54418886;51768002;36655633;1803380;39974615
FR;0;2022-06-02;1358;2407;9758;34962;9338;54420244;51770409;36665391;1838342;39983953
FR;0;2022-06-03;1586;2893;11447;38411;10965;54421830;51773302;36676838;1876753;39994918
FR;0;2022-06-04;913;1474;4475;8971;4559;54422743;51774776;36681313;1885724;39999477
FR;0;2022-06-05;154;307;819;1059;827;54422897;51775083;36682132;1886783;40000304
FR;0;2022-06-06;156;313;1257;1173;1260;54423053;51775396;36683389;1887956;40001564
FR;0;2022-06-07;1290;2488;9296;35141;8876;54424343;51777884;36692685;1923097;40010440
FR;0;2022-06-08;1482;2526;8138;28279;7958;54425825;51780410;36700823;1951376;40018398
FR;0;2022-06-09;1227;2264;8831;38781;8479;54427052;51782674;36709654;1990157;40026877
FR;0;2022-06-10;1520;2677;10859;44170;10459;54428572;51785351;36720513;2034327;40037336
FR;0;2022-06-11;901;1654;4809;11514;4858;54429473;51787005;36725322;2045841;40042194
FR;0;2022-06-12;169;402;975;1713;1035;54429642;51787407;36726297;2047554;40043229
FR;0;2022-06-13;1010;1818;6095;22738;5966;54430652;51789225;36732392;2070292;40049195
FR;0;2022-06-14;1223;2280;9227;44123;8621;54431875;51791505;36741619;2114415;40057816
FR;0;2022-06-15;1390;2161;7422;30062;7196;54433265;51793666;36749041;2144477;40065012
FR;0;2022-06-16;1097;1803;7968;38668;7448;54434362;51795469;36757009;2183145;40072460
FR;0;2022-06-17;1343;2554;9986;45352;9440;54435705;51798023;36766995;2228497;40081900
FR;0;2022-06-18;766;1355;4041;10700;4003;54436471;51799378;36771036;2239197;40085903
FR;0;2022-06-19;150;287;858;1446;918;54436621;51799665;36771894;2240643;40086821
