fra;vaccin;jour;n_dose1;n_dose2;n_dose3;n_dose4;n_rappel;n_cum_dose1;n_cum_dose2;n_cum_dose3;n_cum_dose4;n_cum_rappel
FR;1;2020-12-27;603;0;0;0;0;603;0;0;0;0
FR;1;2020-12-28;669;1;0;0;0;1272;1;0;0;0
FR;1;2020-12-29;374;0;0;0;0;1646;1;0;0;0
FR;1;2020-12-30;440;0;0;0;0;2086;1;0;0;0
FR;1;2020-12-31;436;1;0;0;0;2522;2;0;0;0
FR;1;2021-01-01;1137;2;0;0;0;3659;4;0;0;0
FR;1;2021-01-02;359;3;0;0;0;4018;7;0;0;0
FR;1;2021-01-03;402;0;0;0;0;4420;7;0;0;0
FR;1;2021-01-04;2093;2;0;0;0;6513;9;0;0;0
FR;1;2021-01-05;7733;3;0;0;0;14246;12;0;0;0
FR;1;2021-01-06;12449;13;0;0;0;26695;25;0;0;0
FR;1;2021-01-07;29452;9;0;0;0;56147;34;0;0;0
FR;1;2021-01-08;37123;12;0;0;0;93270;46;0;0;0
FR;1;2021-01-09;11209;5;0;0;0;104479;51;0;0;0
FR;1;2021-01-10;5999;3;0;0;0;110478;54;0;0;0
FR;1;2021-01-11;39925;17;0;0;0;150403;71;0;0;0
FR;1;2021-01-12;62128;16;0;0;0;212531;87;0;0;0
FR;1;2021-01-13;65113;31;0;0;0;277644;118;0;0;0
FR;1;2021-01-14;81437;91;0;0;0;359081;209;0;0;0
FR;1;2021-01-15;68598;34;0;0;0;427679;243;0;0;0
FR;1;2021-01-16;19893;69;0;0;0;447572;312;0;0;0
FR;1;2021-01-17;10897;49;0;0;0;458469;361;0;0;0
FR;1;2021-01-18;82814;162;0;0;0;541283;523;0;0;0
FR;1;2021-01-19;125903;174;0;0;0;667186;697;0;0;0
FR;1;2021-01-20;132392;167;0;0;0;799578;864;0;0;0
FR;1;2021-01-21;153042;161;0;0;0;952620;1025;0;0;0
FR;1;2021-01-22;115932;202;0;0;0;1068552;1227;0;0;0
FR;1;2021-01-23;36601;64;0;0;0;1105153;1291;0;0;0
FR;1;2021-01-24;9580;73;0;0;0;1114733;1364;0;0;0
FR;1;2021-01-25;74413;1271;0;0;0;1189146;2635;0;0;0
FR;1;2021-01-26;96448;3295;1;0;0;1285594;5930;1;0;0
FR;1;2021-01-27;103628;5938;0;0;0;1389222;11868;1;0;0
FR;1;2021-01-28;120583;15105;0;0;0;1509805;26973;1;0;0
FR;1;2021-01-29;88881;17782;0;0;0;1598686;44755;1;0;0
FR;1;2021-01-30;27984;4316;0;0;0;1626670;49071;1;0;0
FR;1;2021-01-31;5183;1743;0;0;0;1631853;50814;1;0;0
FR;1;2021-02-01;49709;21576;0;0;0;1681562;72390;1;0;0
FR;1;2021-02-02;67795;35867;0;0;0;1749357;108257;1;0;0
FR;1;2021-02-03;67074;38174;0;0;0;1816431;146431;1;0;0
FR;1;2021-02-04;77122;51764;0;0;0;1893553;198195;1;0;0
FR;1;2021-02-05;63407;46122;0;0;0;1956960;244317;1;0;0
FR;1;2021-02-06;19410;10778;0;0;0;1976370;255095;1;0;0
FR;1;2021-02-07;3660;5333;0;0;0;1980030;260428;1;0;0
FR;1;2021-02-08;36483;46957;0;0;0;2016513;307385;1;0;0
FR;1;2021-02-09;50790;74722;0;0;0;2067303;382107;1;0;0
FR;1;2021-02-10;52048;79493;0;0;0;2119351;461600;1;0;0
FR;1;2021-02-11;63351;101476;0;0;0;2182702;563076;1;0;0
FR;1;2021-02-12;55840;74821;0;0;0;2238542;637897;1;0;0
FR;1;2021-02-13;15452;19270;0;0;0;2253994;657167;1;0;0
FR;1;2021-02-14;3744;7279;0;0;0;2257738;664446;1;0;0
FR;1;2021-02-15;24131;73512;0;0;0;2281869;737958;1;0;0
FR;1;2021-02-16;32759;96484;0;0;0;2314628;834442;1;0;0
FR;1;2021-02-17;35101;100255;1;0;0;2349729;934697;2;0;0
FR;1;2021-02-18;49429;115698;0;0;0;2399158;1050395;2;0;0
FR;1;2021-02-19;45370;86729;1;0;0;2444528;1137124;3;0;0
FR;1;2021-02-20;13378;27086;0;0;0;2457906;1164210;3;0;0
FR;1;2021-02-21;2454;6185;0;0;0;2460360;1170395;3;0;0
FR;1;2021-02-22;24711;69466;2;0;0;2485071;1239861;5;0;0
FR;1;2021-02-23;37416;80752;1;0;0;2522487;1320613;6;0;0
FR;1;2021-02-24;40675;78303;1;0;0;2563162;1398916;7;0;0
FR;1;2021-02-25;50135;87999;1;0;0;2613297;1486915;8;0;0
FR;1;2021-02-26;47190;67592;1;0;0;2660487;1554507;9;0;0
FR;1;2021-02-27;15668;21096;0;0;0;2676155;1575603;9;0;0
FR;1;2021-02-28;3553;4217;1;0;0;2679708;1579820;10;0;0
FR;1;2021-03-01;40151;49551;1;0;0;2719859;1629371;11;0;0
FR;1;2021-03-02;55960;61898;2;0;0;2775819;1691269;13;0;0
FR;1;2021-03-03;61209;60623;0;0;0;2837028;1751892;13;0;0
FR;1;2021-03-04;72977;66311;3;0;0;2910005;1818203;16;0;0
FR;1;2021-03-05;74737;58932;3;0;0;2984742;1877135;19;0;0
FR;1;2021-03-06;82435;15966;2;0;0;3067177;1893101;21;0;0
FR;1;2021-03-07;63705;4886;1;0;0;3130882;1897987;22;0;0
FR;1;2021-03-08;60146;41935;2;0;0;3191028;1939922;24;0;0
FR;1;2021-03-09;85968;47894;1;0;0;3276996;1987816;25;0;0
FR;1;2021-03-10;90877;47937;5;0;0;3367873;2035753;30;0;0
FR;1;2021-03-11;105040;54267;1;0;0;3472913;2090020;31;0;0
FR;1;2021-03-12;104089;45042;1;0;0;3577002;2135062;32;0;0
FR;1;2021-03-13;89182;12695;1;0;0;3666184;2147757;33;0;0
FR;1;2021-03-14;44448;2846;1;0;0;3710632;2150603;34;0;0
FR;1;2021-03-15;95478;28597;3;0;0;3806110;2179200;37;0;0
FR;1;2021-03-16;123571;34431;5;0;0;3929681;2213631;42;0;0
FR;1;2021-03-17;129281;34179;4;0;0;4058962;2247810;46;0;0
FR;1;2021-03-18;142862;39562;5;0;0;4201824;2287372;51;0;0
FR;1;2021-03-19;136219;32497;2;0;0;4338043;2319869;53;0;0
FR;1;2021-03-20;75977;9961;1;0;0;4414020;2329830;54;0;0
FR;1;2021-03-21;26495;2327;1;0;0;4440515;2332157;55;0;0
FR;1;2021-03-22;114720;30780;2;0;0;4555235;2362937;57;0;0
FR;1;2021-03-23;142996;38119;1;0;0;4698231;2401056;58;0;0
FR;1;2021-03-24;141974;38534;0;0;0;4840205;2439590;58;0;0
FR;1;2021-03-25;164976;39602;4;0;0;5005181;2479192;62;0;0
FR;1;2021-03-26;166363;37502;4;1;0;5171544;2516694;66;1;0
FR;1;2021-03-27;110867;15304;1;0;0;5282411;2531998;67;1;0
FR;1;2021-03-28;42292;3897;3;0;0;5324703;2535895;70;1;0
FR;1;2021-03-29;129790;49601;4;0;0;5454493;2585496;74;1;0
FR;1;2021-03-30;167698;63534;4;0;0;5622191;2649030;78;1;0
FR;1;2021-03-31;170898;67266;4;0;0;5793089;2716296;82;1;0
FR;1;2021-04-01;194737;80870;11;0;0;5987826;2797166;93;1;0
FR;1;2021-04-02;164418;85034;7;0;0;6152244;2882200;100;1;0
FR;1;2021-04-03;88228;58047;5;0;0;6240472;2940247;105;1;0
FR;1;2021-04-04;33616;17685;0;0;0;6274088;2957932;105;1;0
FR;1;2021-04-05;46381;9953;11;0;0;6320469;2967885;116;1;0
FR;1;2021-04-06;160272;102373;17;0;0;6480741;3070258;133;1;0
FR;1;2021-04-07;196945;108194;16;0;0;6677686;3178452;149;1;0
FR;1;2021-04-08;222063;112875;13;0;0;6899749;3291327;162;1;0
FR;1;2021-04-09;214506;107419;21;0;0;7114255;3398746;183;1;0
FR;1;2021-04-10;117155;73261;14;0;0;7231410;3472007;197;1;0
FR;1;2021-04-11;40875;30119;6;0;0;7272285;3502126;203;1;0
FR;1;2021-04-12;168422;103914;45;0;0;7440707;3606040;248;1;0
FR;1;2021-04-13;203762;127991;97;1;0;7644469;3734031;345;2;0
FR;1;2021-04-14;208562;122666;207;0;0;7853031;3856697;552;2;0
FR;1;2021-04-15;221620;127095;311;0;0;8074651;3983792;863;2;0
FR;1;2021-04-16;206009;125176;308;0;0;8280660;4108968;1171;2;0
FR;1;2021-04-17;122065;67232;103;0;0;8402725;4176200;1274;2;0
FR;1;2021-04-18;35954;20928;41;0;0;8438679;4197128;1315;2;0
FR;1;2021-04-19;163714;121694;432;0;0;8602393;4318822;1747;2;0
FR;1;2021-04-20;189368;148939;531;0;0;8791761;4467761;2278;2;0
FR;1;2021-04-21;193937;146988;758;0;0;8985698;4614749;3036;2;0
FR;1;2021-04-22;208985;163229;777;0;0;9194683;4777978;3813;2;0
FR;1;2021-04-23;198917;157064;671;0;0;9393600;4935042;4484;2;0
FR;1;2021-04-24;126304;95501;148;0;0;9519904;5030543;4632;2;0
FR;1;2021-04-25;53619;30024;46;0;0;9573523;5060567;4678;2;0
FR;1;2021-04-26;181091;138455;539;0;0;9754614;5199022;5217;2;0
FR;1;2021-04-27;221323;161908;900;0;0;9975937;5360930;6117;2;0
FR;1;2021-04-28;238245;155118;1310;1;1;10214182;5516048;7427;3;1
FR;1;2021-04-29;270232;160490;1208;0;0;10484414;5676538;8635;3;1
FR;1;2021-04-30;271937;148191;1069;0;0;10756351;5824729;9704;3;1
FR;1;2021-05-01;141123;40613;172;0;0;10897474;5865342;9876;3;1
FR;1;2021-05-02;81521;28092;81;0;0;10978995;5893434;9957;3;1
FR;1;2021-05-03;250736;145114;800;0;0;11229731;6038548;10757;3;1
FR;1;2021-05-04;265823;186958;1198;0;0;11495554;6225506;11955;3;1
FR;1;2021-05-05;283824;184806;1265;0;0;11779378;6410312;13220;3;1
FR;1;2021-05-06;309900;183305;1499;0;0;12089278;6593617;14719;3;1
FR;1;2021-05-07;284043;195715;1125;0;0;12373321;6789332;15844;3;1
FR;1;2021-05-08;191638;48803;285;0;0;12564959;6838135;16129;3;1
FR;1;2021-05-09;114045;35791;236;0;0;12679004;6873926;16365;3;1
FR;1;2021-05-10;258154;194067;1184;0;0;12937158;7067993;17549;3;1
FR;1;2021-05-11;318830;210974;1461;0;0;13255988;7278967;19010;3;1
FR;1;2021-05-12;356572;185716;1399;0;0;13612560;7464683;20409;3;1
FR;1;2021-05-13;283407;47697;399;0;0;13895967;7512380;20808;3;1
FR;1;2021-05-14;370446;128568;991;0;0;14266413;7640948;21799;3;1
FR;1;2021-05-15;298051;66104;402;0;0;14564464;7707052;22201;3;1
FR;1;2021-05-16;157754;15524;158;0;0;14722218;7722576;22359;3;1
FR;1;2021-05-17;318894;116300;1438;0;0;15041112;7838876;23797;3;1
FR;1;2021-05-18;383281;111215;1796;0;0;15424393;7950091;25593;3;1
FR;1;2021-05-19;395213;102517;2177;0;0;15819606;8052608;27770;3;1
FR;1;2021-05-20;421753;96113;2042;0;0;16241359;8148721;29812;3;1
FR;1;2021-05-21;399764;97156;1756;0;0;16641123;8245877;31568;3;1
FR;1;2021-05-22;275652;42012;602;0;0;16916775;8287889;32170;3;1
FR;1;2021-05-23;122998;11127;224;0;0;17039773;8299016;32394;3;1
FR;1;2021-05-24;243990;26214;567;0;0;17283763;8325230;32961;3;1
FR;1;2021-05-25;366179;131615;2109;1;0;17649942;8456845;35070;4;1
FR;1;2021-05-26;380770;125986;1990;0;0;18030712;8582831;37060;4;1
FR;1;2021-05-27;406101;128073;1974;0;0;18436813;8710904;39034;4;1
FR;1;2021-05-28;365983;145282;1698;0;0;18802796;8856186;40732;4;1
FR;1;2021-05-29;253808;80835;525;0;0;19056604;8937021;41257;4;1
FR;1;2021-05-30;100959;22551;157;0;0;19157563;8959572;41414;4;1
FR;1;2021-05-31;314274;148767;1280;1;1;19471837;9108339;42694;5;2
FR;1;2021-06-01;361540;166410;1724;1;1;19833377;9274749;44418;6;3
FR;1;2021-06-02;364831;153232;1792;0;0;20198208;9427981;46210;6;3
FR;1;2021-06-03;390863;147589;1649;0;0;20589071;9575570;47859;6;3
FR;1;2021-06-04;363660;175502;1492;1;1;20952731;9751072;49351;7;4
FR;1;2021-06-05;258473;112644;596;0;0;21211204;9863716;49947;7;4
FR;1;2021-06-06;126753;37537;215;0;0;21337957;9901253;50162;7;4
FR;1;2021-06-07;300324;207756;1362;0;0;21638281;10109009;51524;7;4
FR;1;2021-06-08;330592;220693;1639;0;0;21968873;10329702;53163;7;4
FR;1;2021-06-09;336436;212155;1608;0;0;22305309;10541857;54771;7;4
FR;1;2021-06-10;343764;201757;1609;0;0;22649073;10743614;56380;7;4
FR;1;2021-06-11;311824;235187;1294;0;0;22960897;10978801;57674;7;4
FR;1;2021-06-12;244037;150652;431;0;0;23204934;11129453;58105;7;4
FR;1;2021-06-13;100327;61002;188;0;0;23305261;11190455;58293;7;4
FR;1;2021-06-14;207764;288675;1317;1;0;23513025;11479130;59610;8;4
FR;1;2021-06-15;256770;282057;1391;1;0;23769795;11761187;61001;9;4
FR;1;2021-06-16;273539;270601;1262;1;0;24043334;12031788;62263;10;4
FR;1;2021-06-17;268110;244775;1231;1;0;24311444;12276563;63494;11;4
FR;1;2021-06-18;260433;295616;1149;1;0;24571877;12572179;64643;12;4
FR;1;2021-06-19;193420;209487;387;0;0;24765297;12781666;65030;12;4
FR;1;2021-06-20;69657;89149;117;0;0;24834954;12870815;65147;12;4
FR;1;2021-06-21;172207;319798;930;1;1;25007161;13190613;66077;13;5
FR;1;2021-06-22;185695;347862;1098;10;2;25192856;13538475;67175;23;7
FR;1;2021-06-23;204058;339467;1048;0;0;25396914;13877942;68223;23;7
FR;1;2021-06-24;203410;282105;1169;0;0;25600324;14160047;69392;23;7
FR;1;2021-06-25;182515;371815;1196;0;0;25782839;14531862;70588;23;7
FR;1;2021-06-26;131351;278346;503;0;0;25914190;14810208;71091;23;7
FR;1;2021-06-27;52378;122904;145;0;0;25966568;14933112;71236;23;7
FR;1;2021-06-28;136517;368157;1058;0;0;26103085;15301269;72294;23;7
FR;1;2021-06-29;154759;390766;1849;0;0;26257844;15692035;74143;23;7
FR;1;2021-06-30;179921;379939;1663;4;2;26437765;16071974;75806;27;9
FR;1;2021-07-01;201302;332218;1886;5;1;26639067;16404192;77692;32;10
FR;1;2021-07-02;193594;367633;1764;5;3;26832661;16771825;79456;37;13
FR;1;2021-07-03;124400;280459;704;3;1;26957061;17052284;80160;40;14
FR;1;2021-07-04;53909;113692;244;0;0;27010970;17165976;80404;40;14
FR;1;2021-07-05;153715;356024;1500;8;2;27164685;17522000;81904;48;16
FR;1;2021-07-06;173344;382525;1601;45;8;27338029;17904525;83505;93;24
FR;1;2021-07-07;190645;362560;1657;24;5;27528674;18267085;85162;117;29
FR;1;2021-07-08;201411;323114;1826;20;7;27730085;18590199;86988;137;36
FR;1;2021-07-09;189740;387712;1851;3;2;27919825;18977911;88839;140;38
FR;1;2021-07-10;129881;281151;814;1;1;28049706;19259062;89653;141;39
FR;1;2021-07-11;57635;102508;261;0;0;28107341;19361570;89914;141;39
FR;1;2021-07-12;149489;417022;1580;4;0;28256830;19778592;91494;145;39
FR;1;2021-07-13;234101;439478;1805;8;2;28490931;20218070;93299;153;41
FR;1;2021-07-14;171758;151527;417;0;0;28662689;20369597;93716;153;41
FR;1;2021-07-15;279517;424756;1856;1;0;28942206;20794353;95572;154;41
FR;1;2021-07-16;290290;401192;1710;3;1;29232496;21195545;97282;157;42
FR;1;2021-07-17;217281;282100;754;1;0;29449777;21477645;98036;158;42
FR;1;2021-07-18;101966;107298;288;0;0;29551743;21584943;98324;158;42
FR;1;2021-07-19;238088;379098;1496;3;0;29789831;21964041;99820;161;42
FR;1;2021-07-20;305603;380675;1468;0;0;30095434;22344716;101288;161;42
FR;1;2021-07-21;333143;353369;1412;4;2;30428577;22698085;102700;165;44
FR;1;2021-07-22;364544;319218;1501;3;2;30793121;23017303;104201;168;46
FR;1;2021-07-23;349266;343563;1586;4;2;31142387;23360866;105787;172;48
FR;1;2021-07-24;238914;240969;696;1;0;31381301;23601835;106483;173;48
FR;1;2021-07-25;112755;76055;219;0;0;31494056;23677890;106702;173;48
FR;1;2021-07-26;299034;290007;1496;2;2;31793090;23967897;108198;175;50
FR;1;2021-07-27;385725;268657;1457;4;2;32178815;24236554;109655;179;52
FR;1;2021-07-28;390103;251412;1460;4;2;32568918;24487966;111115;183;54
FR;1;2021-07-29;406029;228220;1538;2;1;32974947;24716186;112653;185;55
FR;1;2021-07-30;370610;246948;1632;4;1;33345557;24963134;114285;189;56
FR;1;2021-07-31;243356;165127;793;1;0;33588913;25128261;115078;190;56
FR;1;2021-08-01;105525;47230;233;0;0;33694438;25175491;115311;190;56
FR;1;2021-08-02;297058;213200;1476;2;0;33991496;25388691;116787;192;56
FR;1;2021-08-03;331190;209138;1547;2;1;34322686;25597829;118334;194;57
FR;1;2021-08-04;327878;184313;1437;5;3;34650564;25782142;119771;199;60
FR;1;2021-08-05;301132;193518;1482;0;0;34951696;25975660;121253;199;60
FR;1;2021-08-06;290869;224466;1559;3;1;35242565;26200126;122812;202;61
FR;1;2021-08-07;182603;158815;654;4;3;35425168;26358941;123466;206;64
FR;1;2021-08-08;68840;59125;247;0;0;35494008;26418066;123713;206;64
FR;1;2021-08-09;222651;235843;1440;4;3;35716659;26653909;125153;210;67
FR;1;2021-08-10;252538;240575;1487;2;1;35969197;26894484;126640;212;68
FR;1;2021-08-11;236091;232281;1271;5;1;36205288;27126765;127911;217;69
FR;1;2021-08-12;220658;240236;1486;3;1;36425946;27367001;129397;220;70
FR;1;2021-08-13;201641;238581;1357;2;2;36627587;27605582;130754;222;72
FR;1;2021-08-14;122829;174145;645;0;0;36750416;27779727;131399;222;72
FR;1;2021-08-15;34666;46135;199;1;0;36785082;27825862;131598;223;72
FR;1;2021-08-16;156851;289821;1421;0;0;36941933;28115683;133019;223;72
FR;1;2021-08-17;171512;291521;1421;5;1;37113445;28407204;134440;228;73
FR;1;2021-08-18;161346;286975;1389;6;3;37274791;28694179;135829;234;76
FR;1;2021-08-19;148846;277763;1399;1;0;37423637;28971942;137228;235;76
FR;1;2021-08-20;140435;309166;1527;2;2;37564072;29281108;138755;237;78
FR;1;2021-08-21;84245;213247;586;0;0;37648317;29494355;139341;237;78
FR;1;2021-08-22;28545;82692;230;0;0;37676862;29577047;139571;237;78
FR;1;2021-08-23;118596;321160;1421;2;1;37795458;29898207;140992;239;79
FR;1;2021-08-24;126601;319893;1602;5;1;37922059;30218100;142594;244;80
FR;1;2021-08-25;121471;306582;1776;8;3;38043530;30524682;144370;252;83
FR;1;2021-08-26;106544;286205;2157;10;1;38150074;30810887;146527;262;84
FR;1;2021-08-27;107602;321677;2300;9;3;38257676;31132564;148827;271;87
FR;1;2021-08-28;70980;220709;1100;0;0;38328656;31353273;149927;271;87
FR;1;2021-08-29;24134;78164;467;1;0;38352790;31431437;150394;272;87
FR;1;2021-08-30;96817;286518;4307;6;5114;38449607;31717955;154701;278;5201
FR;1;2021-08-31;98035;276415;9286;15;10149;38547642;31994370;163987;293;15350
FR;1;2021-09-01;112029;245348;21107;7;22081;38659671;32239718;185094;300;37431
FR;1;2021-09-02;84806;198007;24524;11;25446;38744477;32437725;209618;311;62877
FR;1;2021-09-03;82343;227604;26946;20;27977;38826820;32665329;236564;331;90854
FR;1;2021-09-04;71585;189724;11138;11;11659;38898405;32855053;247702;342;102513
FR;1;2021-09-05;18601;41183;4121;2;4292;38917006;32896236;251823;344;106805
FR;1;2021-09-06;59487;151603;30173;15;31139;38976493;33047839;281996;359;137944
FR;1;2021-09-07;57241;139718;30203;27;31125;39033734;33187557;312199;386;169069
FR;1;2021-09-08;71371;173885;26917;20;27872;39105105;33361442;339116;406;196941
FR;1;2021-09-09;54276;124584;28601;23;29651;39159381;33486026;367717;429;226592
FR;1;2021-09-10;65902;152098;30431;22;31568;39225283;33638124;398148;451;258160
FR;1;2021-09-11;52406;146618;9728;14;10309;39277689;33784742;407876;465;268469
FR;1;2021-09-12;10776;29246;2482;1;2635;39288465;33813988;410358;466;271104
FR;1;2021-09-13;51354;104578;38731;28;39946;39339819;33918566;449089;494;311050
FR;1;2021-09-14;53223;96066;51257;65;52926;39393042;34014632;500346;559;363976
FR;1;2021-09-15;60375;139320;50463;55;46970;39453417;34153952;550809;614;410946
FR;1;2021-09-16;46544;81452;53294;71;49490;39499961;34235404;604103;685;460436
FR;1;2021-09-17;53144;109384;45048;61;42643;39553105;34344788;649151;746;503079
FR;1;2021-09-18;37849;118495;11790;19;11258;39590954;34463283;660941;765;514337
FR;1;2021-09-19;6497;21035;2037;1;1972;39597451;34484318;662978;766;516309
FR;1;2021-09-20;36445;74929;46178;66;44095;39633896;34559247;709156;832;560404
FR;1;2021-09-21;34129;68152;56233;71;52636;39668025;34627399;765389;903;613040
FR;1;2021-09-22;38783;118534;49836;76;46827;39706808;34745933;815225;979;659867
FR;1;2021-09-23;31968;62862;54467;85;50824;39738776;34808795;869692;1064;710691
FR;1;2021-09-24;36738;90112;43643;91;41881;39775514;34898907;913335;1155;752572
FR;1;2021-09-25;27630;96628;12299;27;12167;39803144;34995535;925634;1182;764739
FR;1;2021-09-26;4360;15186;1771;5;1694;39807504;35010721;927405;1187;766433
FR;1;2021-09-27;27315;60225;42889;89;41582;39834819;35070946;970294;1276;808015
FR;1;2021-09-28;26855;49461;47164;75;44404;39861674;35120407;1017458;1351;852419
FR;1;2021-09-29;35834;80391;47246;87;45529;39897508;35200798;1064704;1438;897948
FR;1;2021-09-30;26017;46807;47500;80;45377;39923525;35247605;1112204;1518;943325
FR;1;2021-10-01;47154;65066;44862;83;44419;39970679;35312671;1157066;1601;987744
FR;1;2021-10-02;32344;62385;16107;32;16299;40003023;35375056;1173173;1633;1004043
FR;1;2021-10-03;4329;8574;2031;3;2025;40007352;35383630;1175204;1636;1006068
FR;1;2021-10-04;28801;44452;47089;79;46901;40036153;35428082;1222293;1715;1052969
FR;1;2021-10-05;24310;41625;49836;116;49195;40060463;35469707;1272129;1831;1102164
FR;1;2021-10-06;34454;61377;57445;102;57139;40094917;35531084;1329574;1933;1159303
FR;1;2021-10-07;20971;39833;52997;75;51818;40115888;35570917;1382571;2008;1211121
FR;1;2021-10-08;34973;59609;60363;83;61057;40150861;35630526;1442934;2091;1272178
FR;1;2021-10-09;27431;47990;25478;30;25979;40178292;35678516;1468412;2121;1298157
FR;1;2021-10-10;3658;5794;2747;7;2848;40181950;35684310;1471159;2128;1301005
FR;1;2021-10-11;24719;38160;54561;88;55170;40206669;35722470;1525720;2216;1356175
FR;1;2021-10-12;23188;36551;58024;126;59089;40229857;35759021;1583744;2342;1415264
FR;1;2021-10-13;32843;47824;64148;124;65623;40262700;35806845;1647892;2466;1480887
FR;1;2021-10-14;21620;34790;53729;103;54299;40284320;35841635;1701621;2569;1535186
FR;1;2021-10-15;32560;48824;72303;165;74922;40316880;35890459;1773924;2734;1610108
FR;1;2021-10-16;25965;35283;34859;44;36393;40342845;35925742;1808783;2778;1646501
FR;1;2021-10-17;3098;4059;3408;2;3317;40345943;35929801;1812191;2780;1649818
FR;1;2021-10-18;23581;34919;66808;131;69657;40369524;35964720;1878999;2911;1719475
FR;1;2021-10-19;20601;34689;75632;135;79522;40390125;35999409;1954631;3046;1798997
FR;1;2021-10-20;29808;44236;96144;177;99772;40419933;36043645;2050775;3223;1898769
FR;1;2021-10-21;19626;35079;83128;107;86980;40439559;36078724;2133903;3330;1985749
FR;1;2021-10-22;29541;47682;103703;196;109584;40469100;36126406;2237606;3526;2095333
FR;1;2021-10-23;23009;35164;44850;57;47353;40492109;36161570;2282456;3583;2142686
FR;1;2021-10-24;2374;3876;3579;6;3732;40494483;36165446;2286035;3589;2146418
FR;1;2021-10-25;22394;30813;81996;143;85764;40516877;36196259;2368031;3732;2232182
FR;1;2021-10-26;19306;27716;86062;162;90278;40536183;36223975;2454093;3894;2322460
FR;1;2021-10-27;26141;39669;107763;252;112607;40562324;36263644;2561856;4146;2435067
FR;1;2021-10-28;18655;27074;86896;150;91596;40580979;36290718;2648752;4296;2526663
FR;1;2021-10-29;25886;40209;114787;200;121529;40606865;36330927;2763539;4496;2648192
FR;1;2021-10-30;17678;28682;49340;75;51917;40624543;36359609;2812879;4571;2700109
FR;1;2021-10-31;2055;3198;3443;2;3678;40626598;36362807;2816322;4573;2703787
FR;1;2021-11-01;7733;4222;3021;3;3264;40634331;36367029;2819343;4576;2707051
FR;1;2021-11-02;21906;33212;92348;157;97698;40656237;36400241;2911691;4733;2804749
FR;1;2021-11-03;26323;41555;117447;215;123798;40682560;36441796;3029138;4948;2928547
FR;1;2021-11-04;19505;30307;105739;213;111831;40702065;36472103;3134877;5161;3040378
FR;1;2021-11-05;26925;42257;138721;228;147301;40728990;36514360;3273598;5389;3187679
FR;1;2021-11-06;18820;29827;63443;123;66417;40747810;36544187;3337041;5512;3254096
FR;1;2021-11-07;1791;3335;4959;6;5297;40749601;36547522;3342000;5518;3259393
FR;1;2021-11-08;17728;32314;125937;224;132503;40767329;36579836;3467937;5742;3391896
FR;1;2021-11-09;19291;37700;159234;335;168946;40786620;36617536;3627171;6077;3560842
FR;1;2021-11-10;28705;49220;181823;440;192379;40815325;36666756;3808994;6517;3753221
FR;1;2021-11-11;3848;5943;12199;26;13007;40819173;36672699;3821193;6543;3766228
FR;1;2021-11-12;25944;46854;174752;244;186346;40845117;36719553;3995945;6787;3952574
FR;1;2021-11-13;18706;29249;76803;111;81743;40863823;36748802;4072748;6898;4034317
FR;1;2021-11-14;2029;3305;6813;5;7376;40865852;36752107;4079561;6903;4041693
FR;1;2021-11-15;18656;34877;156350;304;166116;40884508;36786984;4235911;7207;4207809
FR;1;2021-11-16;21131;37943;192016;377;204799;40905639;36824927;4427927;7584;4412608
FR;1;2021-11-17;28522;45715;193150;399;204932;40934161;36870642;4621077;7983;4617540
FR;1;2021-11-18;21065;38950;182390;457;194366;40955226;36909592;4803467;8440;4811906
FR;1;2021-11-19;30778;53353;230153;529;246556;40986004;36962945;5033620;8969;5058462
FR;1;2021-11-20;23724;33326;96942;201;103579;41009728;36996271;5130562;9170;5162041
FR;1;2021-11-21;2313;4005;9098;18;9965;41012041;37000276;5139660;9188;5172006
FR;1;2021-11-22;21359;30483;175810;465;189326;41033400;37030759;5315470;9653;5361332
FR;1;2021-11-23;23883;41149;221099;539;237793;41057283;37071908;5536569;10192;5599125
FR;1;2021-11-24;30264;49805;217259;703;234391;41087547;37121713;5753828;10895;5833516
FR;1;2021-11-25;23530;43981;244368;718;263937;41111077;37165694;5998196;11613;6097453
FR;1;2021-11-26;30591;66522;356691;833;388373;41141668;37232216;6354887;12446;6485826
FR;1;2021-11-27;21805;45405;202562;371;222547;41163473;37277621;6557449;12817;6708373
FR;1;2021-11-28;3139;9672;54758;63;61032;41166612;37287293;6612207;12880;6769405
FR;1;2021-11-29;17857;49531;326281;840;354268;41184469;37336824;6938488;13720;7123673
FR;1;2021-11-30;22747;64979;431036;952;470606;41207216;37401803;7369524;14672;7594279
FR;1;2021-12-01;24936;69380;442749;1130;481595;41232152;37471183;7812273;15802;8075874
FR;1;2021-12-02;19996;64509;489254;1228;532701;41252148;37535692;8301527;17030;8608575
FR;1;2021-12-03;22849;81867;542613;1307;591607;41274997;37617559;8844140;18337;9200182
FR;1;2021-12-04;16380;53933;299035;652;328862;41291377;37671492;9143175;18989;9529044
FR;1;2021-12-05;3624;13914;81496;143;91059;41295001;37685406;9224671;19132;9620103
FR;1;2021-12-06;21863;62790;415321;1065;455051;41316864;37748196;9639992;20197;10075154
FR;1;2021-12-07;19816;75845;522822;1531;572434;41336680;37824041;10162814;21728;10647588
FR;1;2021-12-08;21576;75893;458239;1543;501949;41358256;37899934;10621053;23271;11149537
FR;1;2021-12-09;19400;74115;492785;1625;540651;41377656;37974049;11113838;24896;11690188
FR;1;2021-12-10;23157;87685;547274;1586;599853;41400813;38061734;11661112;26482;12290041
FR;1;2021-12-11;16520;59060;302683;747;335435;41417333;38120794;11963795;27229;12625476
FR;1;2021-12-12;4345;16030;83182;179;94069;41421678;38136824;12046977;27408;12719545
FR;1;2021-12-13;15647;63874;366832;1093;406182;41437325;38200698;12413809;28501;13125727
FR;1;2021-12-14;20584;80405;464557;1742;515036;41457909;38281103;12878366;30243;13640763
FR;1;2021-12-15;21450;77582;408928;1308;453014;41479359;38358685;13287294;31551;14093777
FR;1;2021-12-16;19977;77372;451703;1574;500460;41499336;38436057;13738997;33125;14594237
FR;1;2021-12-17;22541;86715;479799;1733;530932;41521877;38522772;14218796;34858;15125169
FR;1;2021-12-18;17588;54762;257563;730;288475;41539465;38577534;14476359;35588;15413644
FR;1;2021-12-19;5543;17127;79134;194;90729;41545008;38594661;14555493;35782;15504373
FR;1;2021-12-20;20841;63206;316116;1081;355189;41565849;38657867;14871609;36863;15859562
FR;1;2021-12-21;26117;73231;372631;1421;417986;41591966;38731098;15244240;38284;16277548
FR;1;2021-12-22;24907;66013;310518;1215;349493;41616873;38797111;15554758;39499;16627041
FR;1;2021-12-23;21240;52358;241402;954;272984;41638113;38849469;15796160;40453;16900025
FR;1;2021-12-24;7103;18265;67110;256;77034;41645216;38867734;15863270;40709;16977059
FR;1;2021-12-25;502;2800;5569;15;6530;41645718;38870534;15868839;40724;16983589
FR;1;2021-12-26;2749;7597;26922;70;31447;41648467;38878131;15895761;40794;17015036
FR;1;2021-12-27;18227;53566;235023;707;265693;41666694;38931697;16130784;41501;17280729
FR;1;2021-12-28;23256;62035;291959;1025;330151;41689950;38993732;16422743;42526;17610880
FR;1;2021-12-29;22199;55566;254922;918;288141;41712149;39049298;16677665;43444;17899021
FR;1;2021-12-30;21224;46399;212102;857;239565;41733373;39095697;16889767;44301;18138586
FR;1;2021-12-31;7461;16627;61835;229;70358;41740834;39112324;16951602;44530;18208944
FR;1;2022-01-01;1023;2483;5645;29;6577;41741857;39114807;16957247;44559;18215521
FR;1;2022-01-02;3056;8072;28877;50;33527;41744913;39122879;16986124;44609;18249048
FR;1;2022-01-03;21002;53998;228132;786;257544;41765915;39176877;17214256;45395;18506592
FR;1;2022-01-04;25315;64909;299161;1235;337213;41791230;39241786;17513417;46630;18843805
FR;1;2022-01-05;29917;64023;274774;1097;310127;41821147;39305809;17788191;47727;19153932
FR;1;2022-01-06;26673;66011;306812;1396;346447;41847820;39371820;18095003;49123;19500379
FR;1;2022-01-07;31459;74744;349760;1535;393863;41879279;39446564;18444763;50658;19894242
FR;1;2022-01-08;23364;51389;222467;695;251099;41902643;39497953;18667230;51353;20145341
FR;1;2022-01-09;7076;17181;66012;163;76144;41909719;39515134;18733242;51516;20221485
FR;1;2022-01-10;21600;57339;236701;952;267222;41931319;39572473;18969943;52468;20488707
FR;1;2022-01-11;26538;63296;282206;1277;317771;41957857;39635769;19252149;53745;20806478
FR;1;2022-01-12;28793;62329;246157;1103;277928;41986650;39698098;19498306;54848;21084406
FR;1;2022-01-13;24590;60016;262723;1252;296069;42011240;39758114;19761029;56100;21380475
FR;1;2022-01-14;27858;66581;313907;1366;351190;42039098;39824695;20074936;57466;21731665
FR;1;2022-01-15;19305;44366;199278;619;223855;42058403;39869061;20274214;58085;21955520
FR;1;2022-01-16;5138;12988;51499;135;59573;42063541;39882049;20325713;58220;22015093
FR;1;2022-01-17;16775;39746;184783;780;206825;42080316;39921795;20510496;59000;22221918
FR;1;2022-01-18;19262;45802;212356;1151;236986;42099578;39967597;20722852;60151;22458904
FR;1;2022-01-19;20217;43956;176046;896;197172;42119795;40011553;20898898;61047;22656076
FR;1;2022-01-20;16678;40496;183597;1138;204696;42136473;40052049;21082495;62185;22860772
FR;1;2022-01-21;19791;46988;228891;1406;253310;42156264;40099037;21311386;63591;23114082
FR;1;2022-01-22;13828;33344;144471;578;161370;42170092;40132381;21455857;64169;23275452
FR;1;2022-01-23;3347;8802;33404;130;38322;42173439;40141183;21489261;64299;23313774
FR;1;2022-01-24;11745;32889;142162;706;158248;42185184;40174072;21631423;65005;23472022
FR;1;2022-01-25;14108;38191;163342;1048;181530;42199292;40212263;21794765;66053;23653552
FR;1;2022-01-26;14842;37494;150208;931;166273;42214134;40249757;21944973;66984;23819825
FR;1;2022-01-27;12302;33034;143400;884;157884;42226436;40282791;22088373;67868;23977709
FR;1;2022-01-28;16253;54387;198256;1144;222443;42242689;40337178;22286629;69012;24200152
FR;1;2022-01-29;10261;35445;135177;522;151546;42252950;40372623;22421806;69534;24351698
FR;1;2022-01-30;2475;9295;29668;86;34462;42255425;40381918;22451474;69620;24386160
FR;1;2022-01-31;8733;32379;104308;530;117399;42264158;40414297;22555782;70150;24503559
FR;1;2022-02-01;10317;36312;127027;862;141233;42274475;40450609;22682809;71012;24644792
FR;1;2022-02-02;11559;41182;130307;780;145850;42286034;40491791;22813116;71792;24790642
FR;1;2022-02-03;8787;33498;116957;780;130349;42294821;40525289;22930073;72572;24920991
FR;1;2022-02-04;11425;48162;172526;965;192779;42306246;40573451;23102599;73537;25113770
FR;1;2022-02-05;7938;33919;117559;391;133058;42314184;40607370;23220158;73928;25246828
FR;1;2022-02-06;1690;8042;22734;85;26904;42315874;40615412;23242892;74013;25273732
FR;1;2022-02-07;7189;35433;119050;452;134976;42323063;40650845;23361942;74465;25408708
FR;1;2022-02-08;7588;31658;125606;694;140585;42330651;40682503;23487548;75159;25549293
FR;1;2022-02-09;8485;36276;135212;695;152435;42339136;40718779;23622760;75854;25701728
FR;1;2022-02-10;6595;29447;116304;674;130073;42345731;40748226;23739064;76528;25831801
FR;1;2022-02-11;8571;41398;165083;876;185297;42354302;40789624;23904147;77404;26017098
FR;1;2022-02-12;5298;27539;106676;378;120850;42359600;40817163;24010823;77782;26137948
FR;1;2022-02-13;1224;5703;21708;65;25320;42360824;40822866;24032531;77847;26163268
FR;1;2022-02-14;5386;27110;118039;388;133064;42366210;40849976;24150570;78235;26296332
FR;1;2022-02-15;5595;28228;118862;609;132468;42371805;40878204;24269432;78844;26428800
FR;1;2022-02-16;5664;28275;110382;595;122996;42377469;40906479;24379814;79439;26551796
FR;1;2022-02-17;4428;19420;73103;486;80186;42381897;40925899;24452917;79925;26631982
FR;1;2022-02-18;5535;26607;99156;670;108111;42387432;40952506;24552073;80595;26740093
FR;1;2022-02-19;3539;17115;59463;304;66040;42390971;40969621;24611536;80899;26806133
FR;1;2022-02-20;783;3227;10690;35;12313;42391754;40972848;24622226;80934;26818446
FR;1;2022-02-21;3364;14494;52797;286;57645;42395118;40987342;24675023;81220;26876091
FR;1;2022-02-22;3722;15403;51873;499;55601;42398840;41002745;24726896;81719;26931692
FR;1;2022-02-23;4163;17702;57452;508;62555;42403003;41020447;24784348;82227;26994247
FR;1;2022-02-24;3250;12859;43578;436;46364;42406253;41033306;24827926;82663;27040611
FR;1;2022-02-25;4408;19580;64851;695;68714;42410661;41052886;24892777;83358;27109325
FR;1;2022-02-26;2680;12740;41348;309;45101;42413341;41065626;24934125;83667;27154426
FR;1;2022-02-27;639;2170;7117;42;7982;42413980;41067796;24941242;83709;27162408
FR;1;2022-02-28;2566;10264;34926;301;37351;42416546;41078060;24976168;84010;27199759
FR;1;2022-03-01;2791;10424;38652;389;39575;42419337;41088484;25014820;84399;27239334
FR;1;2022-03-02;3460;11912;41816;390;43868;42422797;41100396;25056636;84789;27283202
FR;1;2022-03-03;2331;7621;26124;321;26440;42425128;41108017;25082760;85110;27309642
FR;1;2022-03-04;2659;10257;35394;576;34874;42427787;41118274;25118154;85686;27344516
FR;1;2022-03-05;1788;6297;21947;278;22333;42429575;41124571;25140101;85964;27366849
FR;1;2022-03-06;350;940;2914;38;3112;42429925;41125511;25143015;86002;27369961
FR;1;2022-03-07;1490;4589;16413;245;15872;42431415;41130100;25159428;86247;27385833
FR;1;2022-03-08;1553;5116;17136;307;15958;42432968;41135216;25176564;86554;27401791
FR;1;2022-03-09;1876;6508;19783;368;19129;42434844;41141724;25196347;86922;27420920
FR;1;2022-03-10;1307;4463;15215;306;14235;42436151;41146187;25211562;87228;27435155
FR;1;2022-03-11;1694;6170;21685;482;19833;42437845;41152357;25233247;87710;27454988
FR;1;2022-03-12;1227;4596;15353;276;14899;42439072;41156953;25248600;87986;27469887
FR;1;2022-03-13;241;605;2107;116;2055;42439313;41157558;25250707;88102;27471942
FR;1;2022-03-14;1076;3582;13370;3874;12494;42440389;41161140;25264077;91976;27484436
FR;1;2022-03-15;1263;3874;14533;6861;13014;42441652;41165014;25278610;98837;27497450
FR;1;2022-03-16;1608;4791;17354;11513;16406;42443260;41169805;25295964;110350;27513856
FR;1;2022-03-17;1099;3200;11683;9637;10778;42444359;41173005;25307647;119987;27524634
FR;1;2022-03-18;1669;4729;17921;16486;16353;42446028;41177734;25325568;136473;27540987
FR;1;2022-03-19;1117;3223;11884;8451;11351;42447145;41180957;25337452;144924;27552338
FR;1;2022-03-20;218;536;1719;1007;1752;42447363;41181493;25339171;145931;27554090
FR;1;2022-03-21;1040;2696;11475;13442;10821;42448403;41184189;25350646;159373;27564911
FR;1;2022-03-22;1192;3079;12223;18682;11211;42449595;41187268;25362869;178055;27576122
FR;1;2022-03-23;1468;4194;15981;20094;15660;42451063;41191462;25378850;198149;27591782
FR;1;2022-03-24;1070;2535;10360;16014;9611;42452133;41193997;25389210;214163;27601393
FR;1;2022-03-25;1501;4062;16690;25282;15333;42453634;41198059;25405900;239445;27616726
FR;1;2022-03-26;1098;2953;10841;11432;10498;42454732;41201012;25416741;250877;27627224
FR;1;2022-03-27;228;537;1738;1379;1790;42454960;41201549;25418479;252256;27629014
FR;1;2022-03-28;1036;2417;9948;15861;9569;42455996;41203966;25428427;268117;27638583
FR;1;2022-03-29;1112;2707;11528;25062;10894;42457108;41206673;25439955;293179;27649477
FR;1;2022-03-30;1595;3472;14127;24145;13660;42458703;41210145;25454082;317324;27663137
FR;1;2022-03-31;1268;2637;11648;22554;11153;42459971;41212782;25465730;339878;27674290
FR;1;2022-04-01;1675;3765;18406;28460;17252;42461646;41216547;25484136;368338;27691542
FR;1;2022-04-02;888;1859;8177;9208;7927;42462534;41218406;25492313;377546;27699469
FR;1;2022-04-03;188;366;1428;1056;1429;42462722;41218772;25493741;378602;27700898
FR;1;2022-04-04;1105;2194;11301;17634;10672;42463827;41220966;25505042;396236;27711570
FR;1;2022-04-05;1258;2509;12938;31104;11956;42465085;41223475;25517980;427340;27723526
FR;1;2022-04-06;1326;2728;12130;23777;11549;42466411;41226203;25530110;451117;27735075
FR;1;2022-04-07;1139;2507;12281;30969;11743;42467550;41228710;25542391;482086;27746818
FR;1;2022-04-08;1560;3466;17488;40433;16404;42469110;41232176;25559879;522519;27763222
FR;1;2022-04-09;804;1971;8387;12479;8080;42469914;41234147;25568266;534998;27771302
FR;1;2022-04-10;187;463;1823;1831;1857;42470101;41234610;25570089;536829;27773159
FR;1;2022-04-11;953;2109;10932;22123;10642;42471054;41236719;25581021;558952;27783801
FR;1;2022-04-12;1201;2388;12746;37856;12237;42472255;41239107;25593767;596808;27796038
FR;1;2022-04-13;1168;2618;12204;30358;11916;42473423;41241725;25605971;627166;27807954
FR;1;2022-04-14;1173;2304;11998;33321;12003;42474596;41244029;25617969;660487;27819957
FR;1;2022-04-15;1421;2788;14320;33030;13690;42476017;41246817;25632289;693517;27833647
FR;1;2022-04-16;652;1388;5822;7971;5742;42476669;41248205;25638111;701488;27839389
FR;1;2022-04-17;149;271;929;1110;971;42476818;41248476;25639040;702598;27840360
FR;1;2022-04-18;126;387;2615;985;2639;42476944;41248863;25641655;703583;27842999
FR;1;2022-04-19;1195;2495;11734;27720;11410;42478139;41251358;25653389;731303;27854409
FR;1;2022-04-20;1273;2523;12105;26731;11932;42479412;41253881;25665494;758034;27866341
FR;1;2022-04-21;1207;2351;11460;32944;11616;42480619;41256232;25676954;790978;27877957
FR;1;2022-04-22;1478;2948;15146;35352;14736;42482097;41259180;25692100;826330;27892693
FR;1;2022-04-23;746;1560;6715;9875;6620;42482843;41260740;25698815;836205;27899313
FR;1;2022-04-24;192;356;1369;1511;1321;42483035;41261096;25700184;837716;27900634
FR;1;2022-04-25;996;2052;9826;19574;9713;42484031;41263148;25710010;857290;27910347
FR;1;2022-04-26;1296;2574;12554;36372;12157;42485327;41265722;25722564;893662;27922504
FR;1;2022-04-27;1281;2352;10580;28865;10713;42486608;41268074;25733144;922527;27933217
FR;1;2022-04-28;1245;2287;11496;33867;11312;42487853;41270361;25744640;956394;27944529
FR;1;2022-04-29;1566;2907;14324;35185;13751;42489419;41273268;25758964;991579;27958280
FR;1;2022-04-30;807;1434;6403;9132;6249;42490226;41274702;25765367;1000711;27964529
FR;1;2022-05-01;153;265;810;915;805;42490379;41274967;25766177;1001626;27965334
FR;1;2022-05-02;927;1873;10250;16634;10124;42491306;41276840;25776427;1018260;27975458
FR;1;2022-05-03;1373;2524;12518;32558;12403;42492679;41279364;25788945;1050818;27987861
FR;1;2022-05-04;1280;2421;11011;23524;11157;42493959;41281785;25799956;1074342;27999018
FR;1;2022-05-05;1332;2342;11636;31367;11504;42495291;41284127;25811592;1105709;28010522
FR;1;2022-05-06;1660;3099;14080;34578;13627;42496951;41287226;25825672;1140287;28024149
FR;1;2022-05-07;832;1451;5927;9066;5960;42497783;41288677;25831599;1149353;28030109
FR;1;2022-05-08;183;318;1052;1454;1112;42497966;41288995;25832651;1150807;28031221
FR;1;2022-05-09;1017;1848;9176;18994;9081;42498983;41290843;25841827;1169801;28040302
FR;1;2022-05-10;1354;2496;12392;36698;11971;42500337;41293339;25854219;1206499;28052273
FR;1;2022-05-11;1372;2179;9790;25726;9693;42501709;41295518;25864009;1232225;28061966
FR;1;2022-05-12;1246;2217;10304;33104;9962;42502955;41297735;25874313;1265329;28071928
FR;1;2022-05-13;1562;2689;12631;35411;12273;42504517;41300424;25886944;1300740;28084201
FR;1;2022-05-14;758;1279;5423;10137;5296;42505275;41301703;25892367;1310877;28089497
FR;1;2022-05-15;206;364;1148;1341;1215;42505481;41302067;25893515;1312218;28090712
FR;1;2022-05-16;923;1664;7956;19824;7997;42506404;41303731;25901471;1332042;28098709
FR;1;2022-05-17;1234;2188;11002;35665;10606;42507638;41305919;25912473;1367707;28109315
FR;1;2022-05-18;1235;2001;8808;25454;8759;42508873;41307920;25921281;1393161;28118074
FR;1;2022-05-19;1140;2262;9684;33297;9692;42510013;41310182;25930965;1426458;28127766
FR;1;2022-05-20;1524;2625;12230;37331;11822;42511537;41312807;25943195;1463789;28139588
FR;1;2022-05-21;752;1336;5205;9246;5115;42512289;41314143;25948400;1473035;28144703
FR;1;2022-05-22;180;274;930;1341;922;42512469;41314417;25949330;1474376;28145625
FR;1;2022-05-23;909;1732;8254;19038;8180;42513378;41316149;25957584;1493414;28153805
FR;1;2022-05-24;1238;2366;10554;36466;10385;42514616;41318515;25968138;1529880;28164190
FR;1;2022-05-25;1225;2198;8632;23323;8770;42515841;41320713;25976770;1553203;28172960
FR;1;2022-05-26;137;270;1190;1073;1213;42515978;41320983;25977960;1554276;28174173
FR;1;2022-05-27;1046;2023;8066;20302;7853;42517024;41323006;25986026;1574578;28182026
FR;1;2022-05-28;469;1013;3508;6506;3566;42517493;41324019;25989534;1581084;28185592
FR;1;2022-05-29;108;245;695;880;701;42517601;41324264;25990229;1581964;28186293
FR;1;2022-05-30;779;1654;6351;18239;6347;42518380;41325918;25996580;1600203;28192640
FR;1;2022-05-31;1225;2085;9057;33968;8944;42519605;41328003;26005637;1634171;28201584
FR;1;2022-06-01;1114;2088;8147;22823;8004;42520719;41330091;26013784;1656994;28209588
FR;1;2022-06-02;1119;2098;8908;33568;8510;42521838;41332189;26022692;1690562;28218098
FR;1;2022-06-03;1315;2542;10379;36730;9969;42523153;41334731;26033071;1727292;28228067
FR;1;2022-06-04;644;1212;4102;8532;4198;42523797;41335943;26037173;1735824;28232265
FR;1;2022-06-05;105;264;742;991;761;42523902;41336207;26037915;1736815;28233026
FR;1;2022-06-06;119;260;1046;1087;1044;42524021;41336467;26038961;1737902;28234070
FR;1;2022-06-07;1058;2112;8486;33586;8159;42525079;41338579;26047447;1771488;28242229
FR;1;2022-06-08;1036;2050;7455;27048;7311;42526115;41340629;26054902;1798536;28249540
FR;1;2022-06-09;1004;1956;8081;36818;7765;42527119;41342585;26062983;1835354;28257305
FR;1;2022-06-10;1239;2345;10033;42375;9684;42528358;41344930;26073016;1877729;28266989
FR;1;2022-06-11;603;1352;4493;10929;4538;42528961;41346282;26077509;1888658;28271527
FR;1;2022-06-12;126;324;906;1620;959;42529087;41346606;26078415;1890278;28272486
FR;1;2022-06-13;833;1593;5673;21659;5565;42529920;41348199;26084088;1911937;28278051
FR;1;2022-06-14;987;1937;8531;41595;7981;42530907;41350136;26092619;1953532;28286032
FR;1;2022-06-15;937;1667;6749;27970;6549;42531844;41351803;26099368;1981502;28292581
FR;2;2020-12-27;0;0;0;0;0;0;0;0;0;0
FR;2;2020-12-28;0;0;0;0;0;0;0;0;0;0
FR;2;2020-12-29;0;0;0;0;0;0;0;0;0;0
FR;2;2020-12-30;0;0;0;0;0;0;0;0;0;0
FR;2;2020-12-31;0;0;0;0;0;0;0;0;0;0
FR;2;2021-01-01;0;0;0;0;0;0;0;0;0;0
FR;2;2021-01-02;0;0;0;0;0;0;0;0;0;0
FR;2;2021-01-03;0;0;0;0;0;0;0;0;0;0
FR;2;2021-01-04;0;0;0;0;0;0;0;0;0;0
FR;2;2021-01-05;0;0;0;0;0;0;0;0;0;0
FR;2;2021-01-06;0;0;0;0;0;0;0;0;0;0
FR;2;2021-01-07;0;0;0;0;0;0;0;0;0;0
FR;2;2021-01-08;0;0;0;0;0;0;0;0;0;0
FR;2;2021-01-09;0;0;0;0;0;0;0;0;0;0
FR;2;2021-01-10;0;0;0;0;0;0;0;0;0;0
FR;2;2021-01-11;0;0;0;0;0;0;0;0;0;0
FR;2;2021-01-12;0;0;0;0;0;0;0;0;0;0
FR;2;2021-01-13;0;0;0;0;0;0;0;0;0;0
FR;2;2021-01-14;1681;0;0;0;0;1681;0;0;0;0
FR;2;2021-01-15;396;0;0;0;0;2077;0;0;0;0
FR;2;2021-01-16;315;0;0;0;0;2392;0;0;0;0
FR;2;2021-01-17;81;0;0;0;0;2473;0;0;0;0
FR;2;2021-01-18;3073;2;0;0;0;5546;2;0;0;0
FR;2;2021-01-19;4677;0;0;0;0;10223;2;0;0;0
FR;2;2021-01-20;5135;4;0;0;0;15358;6;0;0;0
FR;2;2021-01-21;5338;9;0;0;0;20696;15;0;0;0
FR;2;2021-01-22;5115;9;0;0;0;25811;24;0;0;0
FR;2;2021-01-23;1866;0;0;0;0;27677;24;0;0;0
FR;2;2021-01-24;160;1;0;0;0;27837;25;0;0;0
FR;2;2021-01-25;3811;3;0;0;0;31648;28;0;0;0
FR;2;2021-01-26;3919;1;0;0;0;35567;29;0;0;0
FR;2;2021-01-27;3598;2;0;0;0;39165;31;0;0;0
FR;2;2021-01-28;3748;7;0;0;0;42913;38;0;0;0
FR;2;2021-01-29;3293;2;0;0;0;46206;40;0;0;0
FR;2;2021-01-30;1130;1;0;0;0;47336;41;0;0;0
FR;2;2021-01-31;45;1;0;0;0;47381;42;0;0;0
FR;2;2021-02-01;3400;4;0;0;0;50781;46;0;0;0
FR;2;2021-02-02;4490;10;0;0;0;55271;56;0;0;0
FR;2;2021-02-03;5219;6;0;0;0;60490;62;0;0;0
FR;2;2021-02-04;4931;10;0;0;0;65421;72;0;0;0
FR;2;2021-02-05;4810;13;0;0;0;70231;85;0;0;0
FR;2;2021-02-06;2040;13;0;0;0;72271;98;0;0;0
FR;2;2021-02-07;101;4;0;0;0;72372;102;0;0;0
FR;2;2021-02-08;7553;22;0;0;0;79925;124;0;0;0
FR;2;2021-02-09;8421;28;0;0;0;88346;152;0;0;0
FR;2;2021-02-10;9338;59;0;0;0;97684;211;0;0;0
FR;2;2021-02-11;10280;100;0;0;0;107964;311;0;0;0
FR;2;2021-02-12;10055;262;0;0;0;118019;573;0;0;0
FR;2;2021-02-13;3119;226;0;0;0;121138;799;0;0;0
FR;2;2021-02-14;355;9;0;0;0;121493;808;0;0;0
FR;2;2021-02-15;3456;3100;0;0;0;124949;3908;0;0;0
FR;2;2021-02-16;5067;4036;0;0;0;130016;7944;0;0;0
FR;2;2021-02-17;4254;4474;0;0;0;134270;12418;0;0;0
FR;2;2021-02-18;5400;5120;0;0;0;139670;17538;0;0;0
FR;2;2021-02-19;5324;4405;0;0;0;144994;21943;0;0;0
FR;2;2021-02-20;1869;1508;0;0;0;146863;23451;0;0;0
FR;2;2021-02-21;242;88;0;0;0;147105;23539;0;0;0
FR;2;2021-02-22;3612;3750;0;0;0;150717;27289;0;0;0
FR;2;2021-02-23;4953;3693;0;0;0;155670;30982;0;0;0
FR;2;2021-02-24;5010;3495;0;0;0;160680;34477;0;0;0
FR;2;2021-02-25;5483;3456;0;0;0;166163;37933;0;0;0
FR;2;2021-02-26;4361;3149;0;0;0;170524;41082;0;0;0
FR;2;2021-02-27;1623;1052;0;0;0;172147;42134;0;0;0
FR;2;2021-02-28;177;29;0;0;0;172324;42163;0;0;0
FR;2;2021-03-01;5179;3725;0;0;0;177503;45888;0;0;0
FR;2;2021-03-02;6528;4731;0;0;0;184031;50619;0;0;0
FR;2;2021-03-03;6534;4924;0;0;0;190565;55543;0;0;0
FR;2;2021-03-04;8400;4069;0;0;0;198965;59612;0;0;0
FR;2;2021-03-05;8028;4061;0;0;0;206993;63673;0;0;0
FR;2;2021-03-06;4785;1686;0;0;0;211778;65359;0;0;0
FR;2;2021-03-07;2372;30;0;0;0;214150;65389;0;0;0
FR;2;2021-03-08;4165;8334;0;0;0;218315;73723;0;0;0
FR;2;2021-03-09;7487;8500;1;0;0;225802;82223;1;0;0
FR;2;2021-03-10;7100;9144;0;0;0;232902;91367;1;0;0
FR;2;2021-03-11;9373;9243;1;0;0;242275;100610;2;0;0
FR;2;2021-03-12;7972;8233;0;0;0;250247;108843;2;0;0
FR;2;2021-03-13;10046;2562;0;0;0;260293;111405;2;0;0
FR;2;2021-03-14;4838;403;0;0;0;265131;111808;2;0;0
FR;2;2021-03-15;10908;3489;0;0;0;276039;115297;2;0;0
FR;2;2021-03-16;16762;4647;1;0;0;292801;119944;3;0;0
FR;2;2021-03-17;20227;3976;0;0;0;313028;123920;3;0;0
FR;2;2021-03-18;23365;4980;0;0;0;336393;128900;3;0;0
FR;2;2021-03-19;23303;4588;0;0;0;359696;133488;3;0;0
FR;2;2021-03-20;25445;1547;0;0;0;385141;135035;3;0;0
FR;2;2021-03-21;17671;151;0;0;0;402812;135186;3;0;0
FR;2;2021-03-22;17782;3147;0;0;0;420594;138333;3;0;0
FR;2;2021-03-23;22687;4208;0;0;0;443281;142541;3;0;0
FR;2;2021-03-24;23955;5012;0;0;0;467236;147553;3;0;0
FR;2;2021-03-25;26740;5139;1;0;0;493976;152692;4;0;0
FR;2;2021-03-26;26978;4236;0;0;0;520954;156928;4;0;0
FR;2;2021-03-27;15918;1330;0;0;0;536872;158258;4;0;0
FR;2;2021-03-28;10561;122;0;0;0;547433;158380;4;0;0
FR;2;2021-03-29;18989;4293;0;0;0;566422;162673;4;0;0
FR;2;2021-03-30;24577;6030;0;0;0;590999;168703;4;0;0
FR;2;2021-03-31;28553;5927;0;0;0;619552;174630;4;0;0
FR;2;2021-04-01;34544;8510;1;0;0;654096;183140;5;0;0
FR;2;2021-04-02;29976;7667;0;0;0;684072;190807;5;0;0
FR;2;2021-04-03;16953;3824;0;0;0;701025;194631;5;0;0
FR;2;2021-04-04;9305;1031;2;0;0;710330;195662;7;0;0
FR;2;2021-04-05;12444;804;0;0;0;722774;196466;7;0;0
FR;2;2021-04-06;27144;7045;0;0;0;749918;203511;7;0;0
FR;2;2021-04-07;30927;7143;1;0;0;780845;210654;8;0;0
FR;2;2021-04-08;36881;8733;1;0;0;817726;219387;9;0;0
FR;2;2021-04-09;33835;8527;28;0;0;851561;227914;37;0;0
FR;2;2021-04-10;19678;9050;1;0;0;871239;236964;38;0;0
FR;2;2021-04-11;7941;4254;1;0;0;879180;241218;39;0;0
FR;2;2021-04-12;17121;11126;0;0;0;896301;252344;39;0;0
FR;2;2021-04-13;19448;16178;1;0;0;915749;268522;40;0;0
FR;2;2021-04-14;18060;16318;7;0;0;933809;284840;47;0;0
FR;2;2021-04-15;22189;21032;27;0;0;955998;305872;74;0;0
FR;2;2021-04-16;20705;20181;45;0;0;976703;326053;119;0;0
FR;2;2021-04-17;13253;22435;5;0;0;989956;348488;124;0;0
FR;2;2021-04-18;5907;14393;6;0;0;995863;362881;130;0;0
FR;2;2021-04-19;16832;16275;24;0;0;1012695;379156;154;0;0
FR;2;2021-04-20;19318;21599;38;0;0;1032013;400755;192;0;0
FR;2;2021-04-21;20282;21717;76;0;0;1052295;422472;268;0;0
FR;2;2021-04-22;23811;24869;41;0;0;1076106;447341;309;0;0
FR;2;2021-04-23;24520;25358;76;0;0;1100626;472699;385;0;0
FR;2;2021-04-24;25301;15081;104;0;0;1125927;487780;489;0;0
FR;2;2021-04-25;9594;8601;5;0;0;1135521;496381;494;0;0
FR;2;2021-04-26;17157;17267;21;0;0;1152678;513648;515;0;0
FR;2;2021-04-27;19240;24221;40;0;0;1171918;537869;555;0;0
FR;2;2021-04-28;22333;26228;112;0;0;1194251;564097;667;0;0
FR;2;2021-04-29;25466;30174;69;0;0;1219717;594271;736;0;0
FR;2;2021-04-30;25529;27753;49;1;0;1245246;622024;785;1;0
FR;2;2021-05-01;14983;9870;6;0;0;1260229;631894;791;1;0
FR;2;2021-05-02;6635;9175;2;0;0;1266864;641069;793;1;0
FR;2;2021-05-03;20012;19234;40;0;0;1286876;660303;833;1;0
FR;2;2021-05-04;18281;29061;33;0;0;1305157;689364;866;1;0
FR;2;2021-05-05;18361;29396;48;0;0;1323518;718760;914;1;0
FR;2;2021-05-06;23541;35263;131;0;0;1347059;754023;1045;1;0
FR;2;2021-05-07;25324;33198;97;0;0;1372383;787221;1142;1;0
FR;2;2021-05-08;21337;9877;14;0;0;1393720;797098;1156;1;0
FR;2;2021-05-09;13162;7830;7;0;0;1406882;804928;1163;1;0
FR;2;2021-05-10;32938;22096;49;0;0;1439820;827024;1212;1;0
FR;2;2021-05-11;43597;21019;101;0;0;1483417;848043;1313;1;0
FR;2;2021-05-12;50041;19824;143;0;0;1533458;867867;1456;1;0
FR;2;2021-05-13;51291;5734;31;0;0;1584749;873601;1487;1;0
FR;2;2021-05-14;61345;12910;132;0;0;1646094;886511;1619;1;0
FR;2;2021-05-15;65927;7135;39;0;0;1712021;893646;1658;1;0
FR;2;2021-05-16;43581;2568;10;0;0;1755602;896214;1668;1;0
FR;2;2021-05-17;44742;12564;114;0;0;1800344;908778;1782;1;0
FR;2;2021-05-18;54636;12236;191;0;0;1854980;921014;1973;1;0
FR;2;2021-05-19;57164;10585;281;0;0;1912144;931599;2254;1;0
FR;2;2021-05-20;63433;10834;288;0;0;1975577;942433;2542;1;0
FR;2;2021-05-21;64289;11643;230;0;0;2039866;954076;2772;1;0
FR;2;2021-05-22;61479;4508;65;0;0;2101345;958584;2837;1;0
FR;2;2021-05-23;37531;571;22;0;0;2138876;959155;2859;1;0
FR;2;2021-05-24;17236;2037;34;0;0;2156112;961192;2893;1;0
FR;2;2021-05-25;21105;12221;240;0;0;2177217;973413;3133;1;0
FR;2;2021-05-26;19933;11460;229;0;0;2197150;984873;3362;1;0
FR;2;2021-05-27;22994;12660;182;0;0;2220144;997533;3544;1;0
FR;2;2021-05-28;29389;14949;190;0;0;2249533;1012482;3734;1;0
FR;2;2021-05-29;30418;8182;57;0;0;2279951;1020664;3791;1;0
FR;2;2021-05-30;4646;1818;6;0;0;2284597;1022482;3797;1;0
FR;2;2021-05-31;28587;18711;183;0;0;2313184;1041193;3980;1;0
FR;2;2021-06-01;45712;19995;224;0;0;2358896;1061188;4204;1;0
FR;2;2021-06-02;37465;19285;182;0;0;2396361;1080473;4386;1;0
FR;2;2021-06-03;51271;23305;161;0;0;2447632;1103778;4547;1;0
FR;2;2021-06-04;65509;24052;215;0;0;2513141;1127830;4762;1;0
FR;2;2021-06-05;34598;24037;51;0;0;2547739;1151867;4813;1;0
FR;2;2021-06-06;4953;6199;10;0;0;2552692;1158066;4823;1;0
FR;2;2021-06-07;28169;23036;146;0;0;2580861;1181102;4969;1;0
FR;2;2021-06-08;46369;22921;143;0;0;2627230;1204023;5112;1;0
FR;2;2021-06-09;34286;20909;107;0;0;2661516;1224932;5219;1;0
FR;2;2021-06-10;42637;19129;95;1;0;2704153;1244061;5314;2;0
FR;2;2021-06-11;55290;25220;134;0;0;2759443;1269281;5448;2;0
FR;2;2021-06-12;30559;19773;53;0;0;2790002;1289054;5501;2;0
FR;2;2021-06-13;3329;9186;13;0;0;2793331;1298240;5514;2;0
FR;2;2021-06-14;25296;24155;92;0;0;2818627;1322395;5606;2;0
FR;2;2021-06-15;39036;22842;154;0;0;2857663;1345237;5760;2;0
FR;2;2021-06-16;30160;21435;134;0;0;2887823;1366672;5894;2;0
FR;2;2021-06-17;36905;25852;150;0;0;2924728;1392524;6044;2;0
FR;2;2021-06-18;46846;28816;122;0;0;2971574;1421340;6166;2;0
FR;2;2021-06-19;24524;24894;39;0;0;2996098;1446234;6205;2;0
FR;2;2021-06-20;3740;10064;10;0;0;2999838;1456298;6215;2;0
FR;2;2021-06-21;17522;42844;87;0;0;3017360;1499142;6302;2;0
FR;2;2021-06-22;28358;49562;110;0;0;3045718;1548704;6412;2;0
FR;2;2021-06-23;21788;49566;107;1;1;3067506;1598270;6519;3;1
FR;2;2021-06-24;28375;50281;133;0;0;3095881;1648551;6652;3;1
FR;2;2021-06-25;33399;60397;127;0;0;3129280;1708948;6779;3;1
FR;2;2021-06-26;16379;59248;54;1;0;3145659;1768196;6833;4;1
FR;2;2021-06-27;2564;29319;22;1;0;3148223;1797515;6855;5;1
FR;2;2021-06-28;12637;54341;83;0;0;3160860;1851856;6938;5;1
FR;2;2021-06-29;19841;59889;178;0;0;3180701;1911745;7116;5;1
FR;2;2021-06-30;16323;57895;252;17;0;3197024;1969640;7368;22;1
FR;2;2021-07-01;20485;59897;227;0;0;3217509;2029537;7595;22;1
FR;2;2021-07-02;24071;62143;184;0;0;3241580;2091680;7779;22;1
FR;2;2021-07-03;12112;57077;153;0;0;3253692;2148757;7932;22;1
FR;2;2021-07-04;1957;23309;18;0;0;3255649;2172066;7950;22;1
FR;2;2021-07-05;9167;29368;106;0;0;3264816;2201434;8056;22;1
FR;2;2021-07-06;14576;36207;135;0;0;3279392;2237641;8191;22;1
FR;2;2021-07-07;14404;33674;139;0;0;3293796;2271315;8330;22;1
FR;2;2021-07-08;19714;40303;162;0;0;3313510;2311618;8492;22;1
FR;2;2021-07-09;27095;54282;202;1;0;3340605;2365900;8694;23;1
FR;2;2021-07-10;13385;33668;107;0;0;3353990;2399568;8801;23;1
FR;2;2021-07-11;1807;4350;16;0;0;3355797;2403918;8817;23;1
FR;2;2021-07-12;12964;37275;118;0;0;3368761;2441193;8935;23;1
FR;2;2021-07-13;37110;53212;150;0;0;3405871;2494405;9085;23;1
FR;2;2021-07-14;6610;3560;15;0;0;3412481;2497965;9100;23;1
FR;2;2021-07-15;47234;47023;156;0;0;3459715;2544988;9256;23;1
FR;2;2021-07-16;64306;55810;187;0;0;3524021;2600798;9443;23;1
FR;2;2021-07-17;31593;23930;96;0;0;3555614;2624728;9539;23;1
FR;2;2021-07-18;6086;4876;19;0;0;3561700;2629604;9558;23;1
FR;2;2021-07-19;32990;28680;94;0;0;3594690;2658284;9652;23;1
FR;2;2021-07-20;51988;44561;155;0;0;3646678;2702845;9807;23;1
FR;2;2021-07-21;45245;34755;93;0;0;3691923;2737600;9900;23;1
FR;2;2021-07-22;56273;41092;128;1;0;3748196;2778692;10028;24;1
FR;2;2021-07-23;68278;49074;170;0;0;3816474;2827766;10198;24;1
FR;2;2021-07-24;36169;21597;82;0;0;3852643;2849363;10280;24;1
FR;2;2021-07-25;6744;2646;10;0;0;3859387;2852009;10290;24;1
FR;2;2021-07-26;36299;22446;91;1;0;3895686;2874455;10381;25;1
FR;2;2021-07-27;62363;34615;180;0;0;3958049;2909070;10561;25;1
FR;2;2021-07-28;55301;26449;132;0;0;4013350;2935519;10693;25;1
FR;2;2021-07-29;68459;32791;189;0;0;4081809;2968310;10882;25;1
FR;2;2021-07-30;74438;37771;222;1;1;4156247;3006081;11104;26;2
FR;2;2021-07-31;34753;16191;104;0;0;4191000;3022272;11208;26;2
FR;2;2021-08-01;5403;2275;19;0;0;4196403;3024547;11227;26;2
FR;2;2021-08-02;35867;16201;101;0;0;4232270;3040748;11328;26;2
FR;2;2021-08-03;55970;28292;142;0;0;4288240;3069040;11470;26;2
FR;2;2021-08-04;46625;20861;128;1;0;4334865;3089901;11598;27;2
FR;2;2021-08-05;54622;31590;215;0;0;4389487;3121491;11813;27;2
FR;2;2021-08-06;58083;42382;242;1;0;4447570;3163873;12055;28;2
FR;2;2021-08-07;25142;17602;89;0;0;4472712;3181475;12144;28;2
FR;2;2021-08-08;3833;3667;21;0;0;4476545;3185142;12165;28;2
FR;2;2021-08-09;29304;21126;91;0;0;4505849;3206268;12256;28;2
FR;2;2021-08-10;44990;33515;154;0;0;4550839;3239783;12410;28;2
FR;2;2021-08-11;35267;25173;151;0;0;4586106;3264956;12561;28;2
FR;2;2021-08-12;41896;35736;162;0;0;4628002;3300692;12723;28;2
FR;2;2021-08-13;42587;37086;218;0;0;4670589;3337778;12941;28;2
FR;2;2021-08-14;18509;22248;93;0;0;4689098;3360026;13034;28;2
FR;2;2021-08-15;3826;3811;17;0;0;4692924;3363837;13051;28;2
FR;2;2021-08-16;25079;27196;110;0;0;4718003;3391033;13161;28;2
FR;2;2021-08-17;38252;43485;205;2;0;4756255;3434518;13366;30;2
FR;2;2021-08-18;32247;36366;195;1;1;4788502;3470884;13561;31;3
FR;2;2021-08-19;37429;46579;224;0;0;4825931;3517463;13785;31;3
FR;2;2021-08-20;40558;55607;269;1;0;4866489;3573070;14054;32;3
FR;2;2021-08-21;18118;24313;115;0;0;4884607;3597383;14169;32;3
FR;2;2021-08-22;2905;4321;22;1;1;4887512;3601704;14191;33;4
FR;2;2021-08-23;19241;35158;131;1;0;4906753;3636862;14322;34;4
FR;2;2021-08-24;31939;56032;235;0;0;4938692;3692894;14557;34;4
FR;2;2021-08-25;25926;43430;250;0;0;4964618;3736324;14807;34;4
FR;2;2021-08-26;32351;55796;387;0;0;4996969;3792120;15194;34;4
FR;2;2021-08-27;36996;65598;478;2;0;5033965;3857718;15672;36;4
FR;2;2021-08-28;17814;28493;300;0;0;5051779;3886211;15972;36;4
FR;2;2021-08-29;2654;5034;47;0;0;5054433;3891245;16019;36;4
FR;2;2021-08-30;18412;37744;399;0;755;5072845;3928989;16418;36;759
FR;2;2021-08-31;28075;57494;886;4;1546;5100920;3986483;17304;40;2305
FR;2;2021-09-01;21591;39845;1308;0;2094;5122511;4026328;18612;40;4399
FR;2;2021-09-02;25481;48622;1962;2;3300;5147992;4074950;20574;42;7699
FR;2;2021-09-03;33405;64492;2988;3;4833;5181397;4139442;23562;45;12532
FR;2;2021-09-04;16827;27703;1442;1;2358;5198224;4167145;25004;46;14890
FR;2;2021-09-05;2262;3608;265;0;411;5200486;4170753;25269;46;15301
FR;2;2021-09-06;14038;28724;1769;1;2930;5214524;4199477;27038;47;18231
FR;2;2021-09-07;21103;41064;3020;13;4863;5235627;4240541;30058;60;23094
FR;2;2021-09-08;17241;31934;2732;6;4469;5252868;4272475;32790;66;27563
FR;2;2021-09-09;20974;40430;4432;3;6755;5273842;4312905;37222;69;34318
FR;2;2021-09-10;28197;51165;5282;4;8831;5302039;4364070;42504;73;43149
FR;2;2021-09-11;13653;22369;2403;5;3943;5315692;4386439;44907;78;47092
FR;2;2021-09-12;1822;2788;285;0;506;5317514;4389227;45192;78;47598
FR;2;2021-09-13;11656;21444;2470;4;4013;5329170;4410671;47662;82;51611
FR;2;2021-09-14;18569;32776;5084;13;9050;5347739;4443447;52746;95;60661
FR;2;2021-09-15;14911;28286;5164;3;7780;5362650;4471733;57910;98;68441
FR;2;2021-09-16;16074;32761;6735;14;10525;5378724;4504494;64645;112;78966
FR;2;2021-09-17;20911;47094;8778;10;14583;5399635;4551588;73423;122;93549
FR;2;2021-09-18;9855;20920;3805;6;6021;5409490;4572508;77228;128;99570
FR;2;2021-09-19;1164;2646;396;0;644;5410654;4575154;77624;128;100214
FR;2;2021-09-20;7492;18776;3851;7;6153;5418146;4593930;81475;135;106367
FR;2;2021-09-21;11208;30005;6494;5;10740;5429354;4623935;87969;140;117107
FR;2;2021-09-22;9406;23542;5491;7;8515;5438760;4647477;93460;147;125622
FR;2;2021-09-23;10723;28879;7879;9;12632;5449483;4676356;101339;156;138254
FR;2;2021-09-24;15067;42877;10874;18;17203;5464550;4719233;112213;174;155457
FR;2;2021-09-25;7256;18744;3963;10;6085;5471806;4737977;116176;184;161542
FR;2;2021-09-26;1079;2558;494;0;631;5472885;4740535;116670;184;162173
FR;2;2021-09-27;6313;16446;4286;8;6551;5479198;4756981;120956;192;168724
FR;2;2021-09-28;9238;25556;7768;13;12075;5488436;4782537;128724;205;180799
FR;2;2021-09-29;8080;20203;6066;25;9261;5496516;4802740;134790;230;190060
FR;2;2021-09-30;9863;25800;9503;16;14082;5506379;4828540;144293;246;204142
FR;2;2021-10-01;13967;35646;12914;25;19239;5520346;4864186;157207;271;223381
FR;2;2021-10-02;6874;15882;4845;6;7009;5527220;4880068;162052;277;230390
FR;2;2021-10-03;841;1932;492;1;511;5528061;4882000;162544;278;230901
FR;2;2021-10-04;5819;13931;5516;5;7863;5533880;4895931;168060;283;238764
FR;2;2021-10-05;9052;22544;11121;19;15716;5542932;4918475;179181;302;254480
FR;2;2021-10-06;7783;17736;8240;11;11070;5550715;4936211;187421;313;265550
FR;2;2021-10-07;9195;22182;12380;15;16841;5559910;4958393;199801;328;282391
FR;2;2021-10-08;13425;32056;17346;27;23538;5573335;4990449;217147;355;305929
FR;2;2021-10-09;5998;12834;6041;6;7885;5579333;5003283;223188;361;313814
FR;2;2021-10-10;883;1633;436;2;630;5580216;5004916;223624;363;314444
FR;2;2021-10-11;5605;11587;6454;17;8829;5585821;5016503;230078;380;323273
FR;2;2021-10-12;8033;17757;12538;13;16733;5593854;5034260;242616;393;340006
FR;2;2021-10-13;6944;14845;10245;12;13607;5600798;5049105;252861;405;353613
FR;2;2021-10-14;8310;17942;14990;13;19448;5609108;5067047;267851;418;373061
FR;2;2021-10-15;11846;26278;20902;26;27948;5620954;5093325;288753;444;401009
FR;2;2021-10-16;5139;8727;1818;0;3208;5626093;5102052;290571;444;404217
FR;2;2021-10-17;651;1184;184;0;372;5626744;5103236;290755;444;404589
FR;2;2021-10-18;4559;7413;661;2;1669;5631303;5110649;291416;446;406258
FR;2;2021-10-19;6235;9887;729;5;2049;5637538;5120536;292145;451;408307
FR;2;2021-10-20;5163;8095;756;3;1686;5642701;5128631;292901;454;409993
FR;2;2021-10-21;6089;9970;779;5;2102;5648790;5138601;293680;459;412095
FR;2;2021-10-22;8448;14582;1147;4;2877;5657238;5153183;294827;463;414972
FR;2;2021-10-23;3840;6001;585;0;1235;5661078;5159184;295412;463;416207
FR;2;2021-10-24;494;886;100;0;203;5661572;5160070;295512;463;416410
FR;2;2021-10-25;3357;5369;304;1;826;5664929;5165439;295816;464;417236
FR;2;2021-10-26;4175;7259;1126;4;2006;5669104;5172698;296942;468;419242
FR;2;2021-10-27;3673;6631;1193;5;1998;5672777;5179329;298135;473;421240
FR;2;2021-10-28;4596;7695;1728;3;2746;5677373;5187024;299863;476;423986
FR;2;2021-10-29;5408;11073;2434;4;3670;5682781;5198097;302297;480;427656
FR;2;2021-10-30;2748;4440;973;1;1428;5685529;5202537;303270;481;429084
FR;2;2021-10-31;363;533;139;1;188;5685892;5203070;303409;482;429272
FR;2;2021-11-01;423;553;176;0;268;5686315;5203623;303585;482;429540
FR;2;2021-11-02;3288;6756;1180;0;1758;5689603;5210379;304765;482;431298
FR;2;2021-11-03;3339;6252;1383;2;1966;5692942;5216631;306148;484;433264
FR;2;2021-11-04;3984;7098;1762;4;2492;5696926;5223729;307910;488;435756
FR;2;2021-11-05;5227;10510;2864;5;3943;5702153;5234239;310774;493;439699
FR;2;2021-11-06;2594;4673;1399;0;1811;5704747;5238912;312173;493;441510
FR;2;2021-11-07;507;865;218;0;287;5705254;5239777;312391;493;441797
FR;2;2021-11-08;2578;5361;1201;3;1676;5707832;5245138;313592;496;443473
FR;2;2021-11-09;2750;6945;2395;6;3177;5710582;5252083;315987;502;446650
FR;2;2021-11-10;2587;5708;5094;6;6274;5713169;5257791;321081;508;452924
FR;2;2021-11-11;438;746;732;2;913;5713607;5258537;321813;510;453837
FR;2;2021-11-12;2951;8113;8965;8;10904;5716558;5266650;330778;518;464741
FR;2;2021-11-13;1534;3385;3865;7;4531;5718092;5270035;334643;525;469272
FR;2;2021-11-14;254;601;349;1;485;5718346;5270636;334992;526;469757
FR;2;2021-11-15;1622;3688;4436;9;5321;5719968;5274324;339428;535;475078
FR;2;2021-11-16;2184;5949;8297;14;10078;5722152;5280273;347725;549;485156
FR;2;2021-11-17;1739;4551;6619;8;7831;5723891;5284824;354344;557;492987
FR;2;2021-11-18;2190;5948;9172;11;10998;5726081;5290772;363516;568;503985
FR;2;2021-11-19;2697;7804;12960;19;15468;5728778;5298576;376476;587;519453
FR;2;2021-11-20;1563;3339;5173;5;6080;5730341;5301915;381649;592;525533
FR;2;2021-11-21;246;519;540;0;662;5730587;5302434;382189;592;526195
FR;2;2021-11-22;1275;2622;4469;5;5400;5731862;5305056;386658;597;531595
FR;2;2021-11-23;1614;4309;8188;9;9897;5733476;5309365;394846;606;541492
FR;2;2021-11-24;1418;3786;7463;14;8720;5734894;5313151;402309;620;550212
FR;2;2021-11-25;1812;4896;11451;21;13650;5736706;5318047;413760;641;563862
FR;2;2021-11-26;2539;7781;22656;31;26068;5739245;5325828;436416;672;589930
FR;2;2021-11-27;1496;4139;12258;18;14000;5740741;5329967;448674;690;603930
FR;2;2021-11-28;291;844;1967;3;2294;5741032;5330811;450641;693;606224
FR;2;2021-11-29;1443;4379;15074;23;17242;5742475;5335190;465715;716;623466
FR;2;2021-11-30;1911;6752;26221;36;29980;5744386;5341942;491936;752;653446
FR;2;2021-12-01;1908;6087;26186;29;29506;5746294;5348029;518122;781;682952
FR;2;2021-12-02;1908;6823;37685;52;41928;5748202;5354852;555807;833;724880
FR;2;2021-12-03;2552;10108;53589;112;59313;5750754;5364960;609396;945;784193
FR;2;2021-12-04;1849;6304;37092;38;40771;5752603;5371264;646488;983;824964
FR;2;2021-12-05;458;2263;14252;14;15988;5753061;5373527;660740;997;840952
FR;2;2021-12-06;2469;9893;77684;109;84731;5755530;5383420;738424;1106;925683
FR;2;2021-12-07;3446;15332;122411;238;133703;5758976;5398752;860835;1344;1059386
FR;2;2021-12-08;3718;16057;133178;330;145381;5762694;5414809;994013;1674;1204767
FR;2;2021-12-09;4544;19637;170151;554;185517;5767238;5434446;1164164;2228;1390284
FR;2;2021-12-10;4671;22815;188613;490;206050;5771909;5457261;1352777;2718;1596334
FR;2;2021-12-11;3681;16625;132425;239;144858;5775590;5473886;1485202;2957;1741192
FR;2;2021-12-12;1256;7129;59082;83;65132;5776846;5481015;1544284;3040;1806324
FR;2;2021-12-13;5525;26866;220659;605;242945;5782371;5507881;1764943;3645;2049269
FR;2;2021-12-14;7018;37528;300719;910;332188;5789389;5545409;2065662;4555;2381457
FR;2;2021-12-15;6558;36239;285175;955;315771;5795947;5581648;2350837;5510;2697228
FR;2;2021-12-16;7762;37921;312104;981;343688;5803709;5619569;2662941;6491;3040916
FR;2;2021-12-17;8682;41249;327835;976;360913;5812391;5660818;2990776;7467;3401829
FR;2;2021-12-18;6515;26562;212321;448;233623;5818906;5687380;3203097;7915;3635452
FR;2;2021-12-19;2601;11488;90203;183;100377;5821507;5698868;3293300;8098;3735829
FR;2;2021-12-20;9549;33612;275165;706;303341;5831056;5732480;3568465;8804;4039170
FR;2;2021-12-21;11555;38326;309597;969;341382;5842611;5770806;3878062;9773;4380552
FR;2;2021-12-22;10458;32852;265085;952;292468;5853069;5803658;4143147;10725;4673020
FR;2;2021-12-23;9429;26706;199463;700;221259;5862498;5830364;4342610;11425;4894279
FR;2;2021-12-24;2782;7504;43847;140;49563;5865280;5837868;4386457;11565;4943842
FR;2;2021-12-25;201;697;2000;10;2493;5865481;5838565;4388457;11575;4946335
FR;2;2021-12-26;1322;4209;25148;71;28675;5866803;5842774;4413605;11646;4975010
FR;2;2021-12-27;8075;29942;218382;659;243306;5874878;5872716;4631987;12305;5218316
FR;2;2021-12-28;9840;36340;272066;741;301952;5884718;5909056;4904053;13046;5520268
FR;2;2021-12-29;9495;32284;246109;766;272677;5894213;5941340;5150162;13812;5792945
FR;2;2021-12-30;9454;28137;208813;662;231467;5903667;5969477;5358975;14474;6024412
FR;2;2021-12-31;3007;8372;54981;177;61235;5906674;5977849;5413956;14651;6085647
FR;2;2022-01-01;227;690;2849;7;3343;5906901;5978539;5416805;14658;6088990
FR;2;2022-01-02;1504;4858;29508;75;33397;5908405;5983397;5446313;14733;6122387
FR;2;2022-01-03;9588;35384;266506;806;293869;5917993;6018781;5712819;15539;6416256
FR;2;2022-01-04;12844;45384;342069;1068;376961;5930837;6064165;6054888;16607;6793217
FR;2;2022-01-05;11269;38664;294153;886;323802;5942106;6102829;6349041;17493;7117019
FR;2;2022-01-06;13649;43514;331929;1298;364718;5955755;6146343;6680970;18791;7481737
FR;2;2022-01-07;14220;47635;361081;1270;396409;5969975;6193978;7042051;20061;7878146
FR;2;2022-01-08;7947;28146;201257;515;221686;5977922;6222124;7243308;20576;8099832
FR;2;2022-01-09;2749;8993;62520;137;69522;5980671;6231117;7305828;20713;8169354
FR;2;2022-01-10;10089;31937;232453;858;255046;5990760;6263054;7538281;21571;8424400
FR;2;2022-01-11;11470;36253;265884;1030;290572;6002230;6299307;7804165;22601;8714972
FR;2;2022-01-12;8758;29817;206306;862;226163;6010988;6329124;8010471;23463;8941135
FR;2;2022-01-13;9387;31352;224469;831;244818;6020375;6360476;8234940;24294;9185953
FR;2;2022-01-14;9743;35651;254519;920;277672;6030118;6396127;8489459;25214;9463625
FR;2;2022-01-15;5355;19459;140771;363;153638;6035473;6415586;8630230;25577;9617263
FR;2;2022-01-16;1511;5519;35874;81;39850;6036984;6421105;8666104;25658;9657113
FR;2;2022-01-17;5545;19301;135388;601;147249;6042529;6440406;8801492;26259;9804362
FR;2;2022-01-18;6418;21521;148611;648;160467;6048947;6461927;8950103;26907;9964829
FR;2;2022-01-19;4389;16360;105083;552;113704;6053336;6478287;9055186;27459;10078533
FR;2;2022-01-20;4867;17599;115281;603;123678;6058203;6495886;9170467;28062;10202211
FR;2;2022-01-21;5195;20064;137324;678;147742;6063398;6515950;9307791;28740;10349953
FR;2;2022-01-22;3027;10960;74257;259;80325;6066425;6526910;9382048;28999;10430278
FR;2;2022-01-23;724;2736;15237;41;16836;6067149;6529646;9397285;29040;10447114
FR;2;2022-01-24;3293;12816;75060;430;81018;6070442;6542462;9472345;29470;10528132
FR;2;2022-01-25;3572;14441;79613;496;85450;6074014;6556903;9551958;29966;10613582
FR;2;2022-01-26;2514;10672;58960;363;62990;6076528;6567575;9610918;30329;10676572
FR;2;2022-01-27;2680;11299;64170;388;67910;6079208;6578874;9675088;30717;10744482
FR;2;2022-01-28;3543;18369;91711;430;98957;6082751;6597243;9766799;31147;10843439
FR;2;2022-01-29;1894;9249;48841;164;52925;6084645;6606492;9815640;31311;10896364
FR;2;2022-01-30;464;2240;9452;38;10605;6085109;6608732;9825092;31349;10906969
FR;2;2022-01-31;1887;9584;43821;208;47341;6086996;6618316;9868913;31557;10954310
FR;2;2022-02-01;1911;10051;47020;279;50102;6088907;6628367;9915933;31836;11004412
FR;2;2022-02-02;1607;9024;41103;251;44173;6090514;6637391;9957036;32087;11048585
FR;2;2022-02-03;1723;8945;40511;204;42911;6092237;6646336;9997547;32291;11091496
FR;2;2022-02-04;2152;15211;66627;297;71344;6094389;6661547;10064174;32588;11162840
FR;2;2022-02-05;1360;8536;35940;131;39235;6095749;6670083;10100114;32719;11202075
FR;2;2022-02-06;274;1775;6124;16;6898;6096023;6671858;10106238;32735;11208973
FR;2;2022-02-07;1350;9601;37747;134;41305;6097373;6681459;10143985;32869;11250278
FR;2;2022-02-08;1300;9815;40928;173;43714;6098673;6691274;10184913;33042;11293992
FR;2;2022-02-09;1160;8821;37035;174;40454;6099833;6700095;10221948;33216;11334446
FR;2;2022-02-10;1024;7986;33833;204;36502;6100857;6708081;10255781;33420;11370948
FR;2;2022-02-11;1389;12080;53338;222;57686;6102246;6720161;10309119;33642;11428634
FR;2;2022-02-12;749;6533;27986;83;30805;6102995;6726694;10337105;33725;11459439
FR;2;2022-02-13;200;1336;4833;20;5574;6103195;6728030;10341938;33745;11465013
FR;2;2022-02-14;835;6728;30265;90;33228;6104030;6734758;10372203;33835;11498241
FR;2;2022-02-15;773;6452;28044;141;29984;6104803;6741210;10400247;33976;11528225
FR;2;2022-02-16;654;5352;22054;123;23618;6105457;6746562;10422301;34099;11551843
FR;2;2022-02-17;515;3776;14144;98;14609;6105972;6750338;10436445;34197;11566452
FR;2;2022-02-18;721;5363;20430;134;21126;6106693;6755701;10456875;34331;11587578
FR;2;2022-02-19;430;3050;10527;66;11241;6107123;6758751;10467402;34397;11598819
FR;2;2022-02-20;101;512;1456;3;1604;6107224;6759263;10468858;34400;11600423
FR;2;2022-02-21;421;2682;9117;65;9493;6107645;6761945;10477975;34465;11609916
FR;2;2022-02-22;389;2564;8888;76;8791;6108034;6764509;10486863;34541;11618707
FR;2;2022-02-23;431;2600;8987;82;9264;6108465;6767109;10495850;34623;11627971
FR;2;2022-02-24;314;2029;6798;81;6826;6108779;6769138;10502648;34704;11634797
FR;2;2022-02-25;455;3195;11414;108;11277;6109234;6772333;10514062;34812;11646074
FR;2;2022-02-26;294;1891;6035;49;6340;6109528;6774224;10520097;34861;11652414
FR;2;2022-02-27;75;312;905;5;948;6109603;6774536;10521002;34866;11653362
FR;2;2022-02-28;330;1682;5523;53;5531;6109933;6776218;10526525;34919;11658893
FR;2;2022-03-01;275;1559;5475;44;5191;6110208;6777777;10532000;34963;11664084
FR;2;2022-03-02;297;1431;5243;45;5084;6110505;6779208;10537243;35008;11669168
FR;2;2022-03-03;225;1103;3704;42;3479;6110730;6780311;10540947;35050;11672647
FR;2;2022-03-04;241;1464;4855;73;4500;6110971;6781775;10545802;35123;11677147
FR;2;2022-03-05;173;903;2978;32;2721;6111144;6782678;10548780;35155;11679868
FR;2;2022-03-06;40;182;278;5;318;6111184;6782860;10549058;35160;11680186
FR;2;2022-03-07;155;654;1983;69;1773;6111339;6783514;10551041;35229;11681959
FR;2;2022-03-08;143;655;2270;51;1902;6111482;6784169;10553311;35280;11683861
FR;2;2022-03-09;153;699;2341;37;2043;6111635;6784868;10555652;35317;11685904
FR;2;2022-03-10;120;599;1688;35;1462;6111755;6785467;10557340;35352;11687366
FR;2;2022-03-11;169;754;2767;57;2366;6111924;6786221;10560107;35409;11689732
FR;2;2022-03-12;144;482;1784;27;1553;6112068;6786703;10561891;35436;11691285
FR;2;2022-03-13;25;75;201;29;202;6112093;6786778;10562092;35465;11691487
FR;2;2022-03-14;125;465;1561;529;1290;6112218;6787243;10563653;35994;11692777
FR;2;2022-03-15;138;418;1707;688;1322;6112356;6787661;10565360;36682;11694099
FR;2;2022-03-16;141;466;2011;1611;1589;6112497;6788127;10567371;38293;11695688
FR;2;2022-03-17;93;412;1405;1193;1142;6112590;6788539;10568776;39486;11696830
FR;2;2022-03-18;145;490;2018;1787;1660;6112735;6789029;10570794;41273;11698490
FR;2;2022-03-19;108;319;1209;940;1014;6112843;6789348;10572003;42213;11699504
FR;2;2022-03-20;12;76;191;59;167;6112855;6789424;10572194;42272;11699671
FR;2;2022-03-21;96;301;1211;1481;1075;6112951;6789725;10573405;43753;11700746
FR;2;2022-03-22;117;383;1528;1828;1290;6113068;6790108;10574933;45581;11702036
FR;2;2022-03-23;139;351;1667;3032;1459;6113207;6790459;10576600;48613;11703495
FR;2;2022-03-24;116;290;1181;1546;997;6113323;6790749;10577781;50159;11704492
FR;2;2022-03-25;119;360;1803;2449;1473;6113442;6791109;10579584;52608;11705965
FR;2;2022-03-26;77;246;1203;1220;952;6113519;6791355;10580787;53828;11706917
FR;2;2022-03-27;19;36;152;100;131;6113538;6791391;10580939;53928;11707048
FR;2;2022-03-28;94;285;1134;1588;993;6113632;6791676;10582073;55516;11708041
FR;2;2022-03-29;108;257;1324;2462;1104;6113740;6791933;10583397;57978;11709145
FR;2;2022-03-30;91;312;1484;3183;1317;6113831;6792245;10584881;61161;11710462
FR;2;2022-03-31;104;281;1270;2327;1084;6113935;6792526;10586151;63488;11711546
FR;2;2022-04-01;121;316;1563;2341;1315;6114056;6792842;10587714;65829;11712861
FR;2;2022-04-02;72;161;845;889;737;6114128;6793003;10588559;66718;11713598
FR;2;2022-04-03;16;53;128;112;142;6114144;6793056;10588687;66830;11713740
FR;2;2022-04-04;108;227;985;1434;792;6114252;6793283;10589672;68264;11714532
FR;2;2022-04-05;142;286;1309;2871;1137;6114394;6793569;10590981;71135;11715669
FR;2;2022-04-06;88;247;1305;2517;1127;6114482;6793816;10592286;73652;11716796
FR;2;2022-04-07;119;214;1295;2681;1034;6114601;6794030;10593581;76333;11717830
FR;2;2022-04-08;123;328;1622;3206;1319;6114724;6794358;10595203;79539;11719149
FR;2;2022-04-09;90;218;899;1045;731;6114814;6794576;10596102;80584;11719880
FR;2;2022-04-10;37;46;143;161;118;6114851;6794622;10596245;80745;11719998
FR;2;2022-04-11;85;184;881;1518;772;6114936;6794806;10597126;82263;11720770
FR;2;2022-04-12;176;260;1177;2732;1055;6115112;6795066;10598303;84995;11721825
FR;2;2022-04-13;143;224;1115;2422;974;6115255;6795290;10599418;87417;11722799
FR;2;2022-04-14;114;219;1082;2668;914;6115369;6795509;10600500;90085;11723713
FR;2;2022-04-15;111;244;1194;2257;1050;6115480;6795753;10601694;92342;11724763
FR;2;2022-04-16;64;108;540;545;452;6115544;6795861;10602234;92887;11725215
FR;2;2022-04-17;15;26;57;53;53;6115559;6795887;10602291;92940;11725268
FR;2;2022-04-18;11;35;118;65;113;6115570;6795922;10602409;93005;11725381
FR;2;2022-04-19;108;235;1114;1705;945;6115678;6796157;10603523;94710;11726326
FR;2;2022-04-20;95;237;1092;2103;920;6115773;6796394;10604615;96813;11727246
FR;2;2022-04-21;111;229;972;1844;829;6115884;6796623;10605587;98657;11728075
FR;2;2022-04-22;96;268;1240;2080;1021;6115980;6796891;10606827;100737;11729096
FR;2;2022-04-23;66;154;644;762;573;6116046;6797045;10607471;101499;11729669
FR;2;2022-04-24;12;28;100;68;78;6116058;6797073;10607571;101567;11729747
FR;2;2022-04-25;103;201;819;1313;708;6116161;6797274;10608390;102880;11730455
FR;2;2022-04-26;109;183;1034;1955;872;6116270;6797457;10609424;104835;11731327
FR;2;2022-04-27;95;177;855;1690;758;6116365;6797634;10610279;106525;11732085
FR;2;2022-04-28;90;213;946;1897;840;6116455;6797847;10611225;108422;11732925
FR;2;2022-04-29;77;279;1124;1687;1034;6116532;6798126;10612349;110109;11733959
FR;2;2022-04-30;65;125;470;536;429;6116597;6798251;10612819;110645;11734388
FR;2;2022-05-01;17;23;80;46;81;6116614;6798274;10612899;110691;11734469
FR;2;2022-05-02;112;213;758;1204;655;6116726;6798487;10613657;111895;11735124
FR;2;2022-05-03;148;224;988;1729;927;6116874;6798711;10614645;113624;11736051
FR;2;2022-05-04;87;218;913;1788;855;6116961;6798929;10615558;115412;11736906
FR;2;2022-05-05;123;191;837;1673;751;6117084;6799120;10616395;117085;11737657
FR;2;2022-05-06;131;237;1092;1848;1004;6117215;6799357;10617487;118933;11738661
FR;2;2022-05-07;40;97;467;504;403;6117255;6799454;10617954;119437;11739064
FR;2;2022-05-08;45;52;106;70;99;6117300;6799506;10618060;119507;11739163
FR;2;2022-05-09;101;171;648;981;600;6117401;6799677;10618708;120488;11739763
FR;2;2022-05-10;116;236;931;1825;883;6117517;6799913;10619639;122313;11740646
FR;2;2022-05-11;97;165;804;1853;782;6117614;6800078;10620443;124166;11741428
FR;2;2022-05-12;109;166;830;2072;791;6117723;6800244;10621273;126238;11742219
FR;2;2022-05-13;95;228;963;2085;889;6117818;6800472;10622236;128323;11743108
FR;2;2022-05-14;75;116;447;553;405;6117893;6800588;10622683;128876;11743513
FR;2;2022-05-15;24;35;93;87;105;6117917;6800623;10622776;128963;11743618
FR;2;2022-05-16;102;168;587;921;525;6118019;6800791;10623363;129884;11744143
FR;2;2022-05-17;95;181;679;1667;650;6118114;6800972;10624042;131551;11744793
FR;2;2022-05-18;80;179;631;1419;636;6118194;6801151;10624673;132970;11745429
FR;2;2022-05-19;68;157;697;1764;730;6118262;6801308;10625370;134734;11746159
FR;2;2022-05-20;101;174;853;1670;758;6118363;6801482;10626223;136404;11746917
FR;2;2022-05-21;45;96;395;517;337;6118408;6801578;10626618;136921;11747254
FR;2;2022-05-22;8;22;66;37;56;6118416;6801600;10626684;136958;11747310
FR;2;2022-05-23;83;128;481;900;466;6118499;6801728;10627165;137858;11747776
FR;2;2022-05-24;84;161;614;1557;597;6118583;6801889;10627779;139415;11748373
FR;2;2022-05-25;69;136;529;1136;480;6118652;6802025;10628308;140551;11748853
FR;2;2022-05-26;8;25;63;41;69;6118660;6802050;10628371;140592;11748922
FR;2;2022-05-27;44;112;439;810;419;6118704;6802162;10628810;141402;11749341
FR;2;2022-05-28;28;60;215;238;216;6118732;6802222;10629025;141640;11749557
FR;2;2022-05-29;10;34;43;25;51;6118742;6802256;10629068;141665;11749608
FR;2;2022-05-30;65;105;405;709;388;6118807;6802361;10629473;142374;11749996
FR;2;2022-05-31;73;129;544;1221;493;6118880;6802490;10630017;143595;11750489
FR;2;2022-06-01;53;141;475;1031;463;6118933;6802631;10630492;144626;11750952
FR;2;2022-06-02;85;158;533;1345;506;6119018;6802789;10631025;145971;11751458
FR;2;2022-06-03;63;147;582;1557;528;6119081;6802936;10631607;147528;11751986
FR;2;2022-06-04;53;91;259;431;243;6119134;6803027;10631866;147959;11752229
FR;2;2022-06-05;11;17;61;57;47;6119145;6803044;10631927;148016;11752276
FR;2;2022-06-06;11;17;57;73;61;6119156;6803061;10631984;148089;11752337
FR;2;2022-06-07;97;199;611;1449;516;6119253;6803260;10632595;149538;11752853
FR;2;2022-06-08;68;109;433;1157;369;6119321;6803369;10633028;150695;11753222
FR;2;2022-06-09;89;156;547;1836;510;6119410;6803525;10633575;152531;11753732
FR;2;2022-06-10;77;151;572;1666;546;6119487;6803676;10634147;154197;11754278
FR;2;2022-06-11;40;75;238;521;223;6119527;6803751;10634385;154718;11754501
FR;2;2022-06-12;18;38;54;76;58;6119545;6803789;10634439;154794;11754559
FR;2;2022-06-13;32;105;315;921;308;6119577;6803894;10634754;155715;11754867
FR;2;2022-06-14;59;142;521;1992;463;6119636;6804036;10635275;157707;11755330
FR;2;2022-06-15;67;87;411;1442;357;6119703;6804123;10635686;159149;11755687
FR;3;2020-12-27;0;0;0;0;0;0;0;0;0;0
FR;3;2020-12-28;0;0;0;0;0;0;0;0;0;0
FR;3;2020-12-29;0;0;0;0;0;0;0;0;0;0
FR;3;2020-12-30;0;0;0;0;0;0;0;0;0;0
FR;3;2020-12-31;0;0;0;0;0;0;0;0;0;0
FR;3;2021-01-01;0;0;0;0;0;0;0;0;0;0
FR;3;2021-01-02;0;0;0;0;0;0;0;0;0;0
FR;3;2021-01-03;0;0;0;0;0;0;0;0;0;0
FR;3;2021-01-04;0;0;0;0;0;0;0;0;0;0
FR;3;2021-01-05;0;0;0;0;0;0;0;0;0;0
FR;3;2021-01-06;0;0;0;0;0;0;0;0;0;0
FR;3;2021-01-07;0;0;0;0;0;0;0;0;0;0
FR;3;2021-01-08;0;0;0;0;0;0;0;0;0;0
FR;3;2021-01-09;0;0;0;0;0;0;0;0;0;0
FR;3;2021-01-10;0;0;0;0;0;0;0;0;0;0
FR;3;2021-01-11;0;0;0;0;0;0;0;0;0;0
FR;3;2021-01-12;0;0;0;0;0;0;0;0;0;0
FR;3;2021-01-13;0;0;0;0;0;0;0;0;0;0
FR;3;2021-01-14;0;0;0;0;0;0;0;0;0;0
FR;3;2021-01-15;0;0;0;0;0;0;0;0;0;0
FR;3;2021-01-16;0;0;0;0;0;0;0;0;0;0
FR;3;2021-01-17;0;0;0;0;0;0;0;0;0;0
FR;3;2021-01-18;0;0;0;0;0;0;0;0;0;0
FR;3;2021-01-19;0;0;0;0;0;0;0;0;0;0
FR;3;2021-01-20;0;0;0;0;0;0;0;0;0;0
FR;3;2021-01-21;0;0;0;0;0;0;0;0;0;0
FR;3;2021-01-22;0;0;0;0;0;0;0;0;0;0
FR;3;2021-01-23;0;0;0;0;0;0;0;0;0;0
FR;3;2021-01-24;0;0;0;0;0;0;0;0;0;0
FR;3;2021-01-25;0;0;0;0;0;0;0;0;0;0
FR;3;2021-01-26;0;0;0;0;0;0;0;0;0;0
FR;3;2021-01-27;0;0;0;0;0;0;0;0;0;0
FR;3;2021-01-28;0;0;0;0;0;0;0;0;0;0
FR;3;2021-01-29;0;0;0;0;0;0;0;0;0;0
FR;3;2021-01-30;0;0;0;0;0;0;0;0;0;0
FR;3;2021-01-31;0;0;0;0;0;0;0;0;0;0
FR;3;2021-02-01;0;0;0;0;0;0;0;0;0;0
FR;3;2021-02-02;0;0;0;0;0;0;0;0;0;0
FR;3;2021-02-03;0;0;0;0;0;0;0;0;0;0
FR;3;2021-02-04;0;0;0;0;0;0;0;0;0;0
FR;3;2021-02-05;0;0;0;0;0;0;0;0;0;0
FR;3;2021-02-06;1648;0;0;0;0;1648;0;0;0;0
FR;3;2021-02-07;1423;0;0;0;0;3071;0;0;0;0
FR;3;2021-02-08;2784;1;0;0;0;5855;1;0;0;0
FR;3;2021-02-09;6782;0;0;0;0;12637;1;0;0;0
FR;3;2021-02-10;9605;0;0;0;0;22242;1;0;0;0
FR;3;2021-02-11;13612;0;0;0;0;35854;1;0;0;0
FR;3;2021-02-12;13402;0;0;0;0;49256;1;0;0;0
FR;3;2021-02-13;3786;1;0;0;0;53042;2;0;0;0
FR;3;2021-02-14;972;0;0;0;0;54014;2;0;0;0
FR;3;2021-02-15;10487;1;0;0;0;64501;3;0;0;0
FR;3;2021-02-16;12545;1;0;0;0;77046;4;0;0;0
FR;3;2021-02-17;11152;0;0;0;0;88198;4;0;0;0
FR;3;2021-02-18;14935;2;0;0;0;103133;6;0;0;0
FR;3;2021-02-19;14359;1;0;0;0;117492;7;0;0;0
FR;3;2021-02-20;3329;0;0;0;0;120821;7;0;0;0
FR;3;2021-02-21;618;0;0;0;0;121439;7;0;0;0
FR;3;2021-02-22;9163;0;0;0;0;130602;7;0;0;0
FR;3;2021-02-23;11395;1;0;0;0;141997;8;0;0;0
FR;3;2021-02-24;14299;1;0;0;0;156296;9;0;0;0
FR;3;2021-02-25;44929;1;0;0;0;201225;10;0;0;0
FR;3;2021-02-26;61882;4;0;0;0;263107;14;0;0;0
FR;3;2021-02-27;34801;5;0;0;0;297908;19;0;0;0
FR;3;2021-02-28;2463;0;0;0;0;300371;19;0;0;0
FR;3;2021-03-01;20514;11;0;0;0;320885;30;0;0;0
FR;3;2021-03-02;38864;19;0;0;0;359749;49;0;0;0
FR;3;2021-03-03;48732;15;0;0;0;408481;64;0;0;0
FR;3;2021-03-04;82218;20;0;0;0;490699;84;0;0;0
FR;3;2021-03-05;118123;40;0;0;0;608822;124;0;0;0
FR;3;2021-03-06;120713;56;1;0;0;729535;180;1;0;0
FR;3;2021-03-07;55175;27;0;0;0;784710;207;1;0;0
FR;3;2021-03-08;42809;25;0;0;0;827519;232;1;0;0
FR;3;2021-03-09;78968;45;0;0;0;906487;277;1;0;0
FR;3;2021-03-10;80969;46;0;0;0;987456;323;1;0;0
FR;3;2021-03-11;128424;56;0;0;0;1115880;379;1;0;0
FR;3;2021-03-12;182721;92;0;0;0;1298601;471;1;0;0
FR;3;2021-03-13;132146;65;0;0;0;1430747;536;1;0;0
FR;3;2021-03-14;14055;5;0;0;0;1444802;541;1;0;0
FR;3;2021-03-15;52226;49;0;0;0;1497028;590;1;0;0
FR;3;2021-03-16;1209;25;0;0;0;1498237;615;1;0;0
FR;3;2021-03-17;942;32;0;0;0;1499179;647;1;0;0
FR;3;2021-03-18;1565;13;0;0;0;1500744;660;1;0;0
FR;3;2021-03-19;70450;48;0;0;0;1571194;708;1;0;0
FR;3;2021-03-20;65226;46;0;0;0;1636420;754;1;0;0
FR;3;2021-03-21;5756;6;0;0;0;1642176;760;1;0;0
FR;3;2021-03-22;37497;40;0;0;0;1679673;800;1;0;0
FR;3;2021-03-23;84651;63;0;0;0;1764324;863;1;0;0
FR;3;2021-03-24;90936;93;0;0;0;1855260;956;1;0;0
FR;3;2021-03-25;150046;131;0;0;0;2005306;1087;1;0;0
FR;3;2021-03-26;165415;150;0;0;0;2170721;1237;1;0;0
FR;3;2021-03-27;68456;101;0;0;0;2239177;1338;1;0;0
FR;3;2021-03-28;6471;19;0;0;0;2245648;1357;1;0;0
FR;3;2021-03-29;54160;74;0;0;0;2299808;1431;1;0;0
FR;3;2021-03-30;93163;99;0;0;0;2392971;1530;1;0;0
FR;3;2021-03-31;63527;100;0;0;0;2456498;1630;1;0;0
FR;3;2021-04-01;86121;105;0;0;0;2542619;1735;1;0;0
FR;3;2021-04-02;86895;155;0;0;0;2629514;1890;1;0;0
FR;3;2021-04-03;35872;114;0;0;0;2665386;2004;1;0;0
FR;3;2021-04-04;3571;18;0;0;0;2668957;2022;1;0;0
FR;3;2021-04-05;4487;28;0;0;0;2673444;2050;1;0;0
FR;3;2021-04-06;29744;85;0;0;0;2703188;2135;1;0;0
FR;3;2021-04-07;32338;81;0;0;0;2735526;2216;1;0;0
FR;3;2021-04-08;78808;243;0;0;0;2814334;2459;1;0;0
FR;3;2021-04-09;161746;419;0;0;0;2976080;2878;1;0;0
FR;3;2021-04-10;75755;332;0;0;0;3051835;3210;1;0;0
FR;3;2021-04-11;7309;45;0;0;0;3059144;3255;1;0;0
FR;3;2021-04-12;51467;207;0;0;0;3110611;3462;1;0;0
FR;3;2021-04-13;86220;318;0;0;0;3196831;3780;1;0;0
FR;3;2021-04-14;67833;346;0;0;0;3264664;4126;1;0;0
FR;3;2021-04-15;93220;373;0;0;0;3357884;4499;1;0;0
FR;3;2021-04-16;112516;580;0;0;0;3470400;5079;1;0;0
FR;3;2021-04-17;53311;325;1;0;0;3523711;5404;2;0;0
FR;3;2021-04-18;9744;35;0;0;0;3533455;5439;2;0;0
FR;3;2021-04-19;25104;244;0;0;0;3558559;5683;2;0;0
FR;3;2021-04-20;45672;400;0;0;0;3604231;6083;2;0;0
FR;3;2021-04-21;38967;471;0;0;0;3643198;6554;2;0;0
FR;3;2021-04-22;54704;790;0;0;0;3697902;7344;2;0;0
FR;3;2021-04-23;70485;1025;0;0;0;3768387;8369;2;0;0
FR;3;2021-04-24;37240;1008;0;0;0;3805627;9377;2;0;0
FR;3;2021-04-25;6204;155;0;0;0;3811831;9532;2;0;0
FR;3;2021-04-26;19783;658;0;0;0;3831614;10190;2;0;0
FR;3;2021-04-27;34472;1266;0;0;0;3866086;11456;2;0;0
FR;3;2021-04-28;28967;1944;0;0;0;3895053;13400;2;0;0
FR;3;2021-04-29;45377;5972;0;0;0;3940430;19372;2;0;0
FR;3;2021-04-30;55454;8949;1;0;0;3995884;28321;3;0;0
FR;3;2021-05-01;9511;1984;0;0;0;4005395;30305;3;0;0
FR;3;2021-05-02;3070;486;0;0;0;4008465;30791;3;0;0
FR;3;2021-05-03;13059;3887;0;0;0;4021524;34678;3;0;0
FR;3;2021-05-04;23109;8413;0;0;0;4044633;43091;3;0;0
FR;3;2021-05-05;18754;10634;0;0;0;4063387;53725;3;0;0
FR;3;2021-05-06;34622;20924;0;0;0;4098009;74649;3;0;0
FR;3;2021-05-07;44202;28483;0;0;0;4142211;103132;3;0;0
FR;3;2021-05-08;6785;8978;0;0;0;4148996;112110;3;0;0
FR;3;2021-05-09;1794;2654;0;0;0;4150790;114764;3;0;0
FR;3;2021-05-10;14990;12636;0;0;0;4165780;127400;3;0;0
FR;3;2021-05-11;27092;25832;0;0;0;4192872;153232;3;0;0
FR;3;2021-05-12;17266;27569;0;0;0;4210138;180801;3;0;0
FR;3;2021-05-13;2277;3480;0;0;0;4212415;184281;3;0;0
FR;3;2021-05-14;14514;25800;0;0;0;4226929;210081;3;0;0
FR;3;2021-05-15;7231;20828;0;0;0;4234160;230909;3;0;0
FR;3;2021-05-16;975;2671;0;0;0;4235135;233580;3;0;0
FR;3;2021-05-17;7962;19973;0;0;0;4243097;253553;3;0;0
FR;3;2021-05-18;13410;29708;0;0;0;4256507;283261;3;0;0
FR;3;2021-05-19;9263;31437;0;0;0;4265770;314698;3;0;0
FR;3;2021-05-20;12801;53299;3;0;0;4278571;367997;6;0;0
FR;3;2021-05-21;12760;65619;2;0;0;4291331;433616;8;0;0
FR;3;2021-05-22;4963;33371;1;0;0;4296294;466987;9;0;0
FR;3;2021-05-23;649;2661;0;0;0;4296943;469648;9;0;0
FR;3;2021-05-24;879;4909;0;0;0;4297822;474557;9;0;0
FR;3;2021-05-25;5301;45427;1;0;0;4303123;519984;10;0;0
FR;3;2021-05-26;4973;51197;1;0;0;4308096;571181;11;0;0
FR;3;2021-05-27;6326;78046;3;0;0;4314422;649227;14;0;0
FR;3;2021-05-28;7542;99234;2;0;0;4321964;748461;16;0;0
FR;3;2021-05-29;3345;60407;1;0;0;4325309;808868;17;0;0
FR;3;2021-05-30;547;8201;0;0;0;4325856;817069;17;0;0
FR;3;2021-05-31;2439;35805;3;0;0;4328295;852874;20;0;0
FR;3;2021-06-01;3400;64740;10;0;0;4331695;917614;30;0;0
FR;3;2021-06-02;2727;58369;6;0;0;4334422;975983;36;0;0
FR;3;2021-06-03;3492;87478;10;0;0;4337914;1063461;46;0;0
FR;3;2021-06-04;4113;105126;22;0;0;4342027;1168587;68;0;0
FR;3;2021-06-05;1979;52268;4;0;0;4344006;1220855;72;0;0
FR;3;2021-06-06;505;5385;1;0;0;4344511;1226240;73;0;0
FR;3;2021-06-07;1472;31069;11;0;0;4345983;1257309;84;0;0
FR;3;2021-06-08;2048;47255;18;0;0;4348031;1304564;102;0;0
FR;3;2021-06-09;1788;42226;13;0;0;4349819;1346790;115;0;0
FR;3;2021-06-10;2245;67791;17;0;0;4352064;1414581;132;0;0
FR;3;2021-06-11;2475;96650;34;0;0;4354539;1511231;166;0;0
FR;3;2021-06-12;1175;40825;6;0;0;4355714;1552056;172;0;0
FR;3;2021-06-13;279;3776;3;0;0;4355993;1555832;175;0;0
FR;3;2021-06-14;1042;42563;17;0;0;4357035;1598395;192;0;0
FR;3;2021-06-15;1365;80578;20;0;0;4358400;1678973;212;0;0
FR;3;2021-06-16;1255;65656;20;0;0;4359655;1744629;232;0;0
FR;3;2021-06-17;1661;101828;41;0;0;4361316;1846457;273;0;0
FR;3;2021-06-18;1868;117948;61;0;0;4363184;1964405;334;0;0
FR;3;2021-06-19;801;39396;22;0;0;4363985;2003801;356;0;0
FR;3;2021-06-20;158;3362;0;0;0;4364143;2007163;356;0;0
FR;3;2021-06-21;768;39228;16;0;0;4364911;2046391;372;0;0
FR;3;2021-06-22;1061;69967;52;0;0;4365972;2116358;424;0;0
FR;3;2021-06-23;942;50822;39;0;0;4366914;2167180;463;0;0
FR;3;2021-06-24;1307;77146;48;0;0;4368221;2244326;511;0;0
FR;3;2021-06-25;1401;90000;73;0;0;4369622;2334326;584;0;0
FR;3;2021-06-26;628;33136;29;0;0;4370250;2367462;613;0;0
FR;3;2021-06-27;166;3976;1;0;0;4370416;2371438;614;0;0
FR;3;2021-06-28;649;30368;27;0;0;4371065;2401806;641;0;0
FR;3;2021-06-29;854;56169;95;0;0;4371919;2457975;736;0;0
FR;3;2021-06-30;902;45082;93;0;0;4372821;2503057;829;0;0
FR;3;2021-07-01;1160;65691;108;0;0;4373981;2568748;937;0;0
FR;3;2021-07-02;1300;90380;170;0;0;4375281;2659128;1107;0;0
FR;3;2021-07-03;600;31171;52;0;0;4375881;2690299;1159;0;0
FR;3;2021-07-04;142;4242;3;0;0;4376023;2694541;1162;0;0
FR;3;2021-07-05;609;33873;60;0;0;4376632;2728414;1222;0;0
FR;3;2021-07-06;958;56043;88;0;0;4377590;2784457;1310;0;0
FR;3;2021-07-07;870;43036;79;0;0;4378460;2827493;1389;0;0
FR;3;2021-07-08;1123;60730;99;0;0;4379583;2888223;1488;0;0
FR;3;2021-07-09;1258;68791;128;0;0;4380841;2957014;1616;0;0
FR;3;2021-07-10;642;25065;59;0;0;4381483;2982079;1675;0;0
FR;3;2021-07-11;128;3281;4;0;0;4381611;2985360;1679;0;0
FR;3;2021-07-12;660;23864;59;0;0;4382271;3009224;1738;0;0
FR;3;2021-07-13;1645;34714;90;0;0;4383916;3043938;1828;0;0
FR;3;2021-07-14;262;2608;2;0;0;4384178;3046546;1830;0;0
FR;3;2021-07-15;1934;30638;85;0;0;4386112;3077184;1915;0;0
FR;3;2021-07-16;2520;38850;122;0;0;4388632;3116034;2037;0;0
FR;3;2021-07-17;1046;13738;26;0;0;4389678;3129772;2063;0;0
FR;3;2021-07-18;263;2601;3;0;0;4389941;3132373;2066;0;0
FR;3;2021-07-19;1275;17168;37;0;0;4391216;3149541;2103;0;0
FR;3;2021-07-20;1823;27100;98;0;0;4393039;3176641;2201;0;0
FR;3;2021-07-21;1649;19707;44;0;0;4394688;3196348;2245;0;0
FR;3;2021-07-22;1850;27736;83;0;0;4396538;3224084;2328;0;0
FR;3;2021-07-23;2212;30431;117;0;0;4398750;3254515;2445;0;0
FR;3;2021-07-24;822;7005;25;0;0;4399572;3261520;2470;0;0
FR;3;2021-07-25;210;1338;1;0;0;4399782;3262858;2471;0;0
FR;3;2021-07-26;922;10689;28;0;0;4400704;3273547;2499;0;0
FR;3;2021-07-27;1166;16947;56;0;0;4401870;3290494;2555;0;0
FR;3;2021-07-28;988;12093;40;0;0;4402858;3302587;2595;0;0
FR;3;2021-07-29;1126;15830;63;0;0;4403984;3318417;2658;0;0
FR;3;2021-07-30;1126;18081;79;0;0;4405110;3336498;2737;0;0
FR;3;2021-07-31;406;3743;15;0;0;4405516;3340241;2752;0;0
FR;3;2021-08-01;113;485;1;0;0;4405629;3340726;2753;0;0
FR;3;2021-08-02;419;5148;22;0;0;4406048;3345874;2775;0;0
FR;3;2021-08-03;488;7575;27;0;0;4406536;3353449;2802;0;0
FR;3;2021-08-04;435;4880;26;0;0;4406971;3358329;2828;0;0
FR;3;2021-08-05;429;3732;12;0;0;4407400;3362061;2840;0;0
FR;3;2021-08-06;453;4782;30;0;0;4407853;3366843;2870;0;0
FR;3;2021-08-07;214;1923;11;0;0;4408067;3368766;2881;0;0
FR;3;2021-08-08;249;429;2;0;0;4408316;3369195;2883;0;0
FR;3;2021-08-09;314;2492;11;0;0;4408630;3371687;2894;0;0
FR;3;2021-08-10;363;3871;15;0;0;4408993;3375558;2909;0;0
FR;3;2021-08-11;286;2720;15;0;0;4409279;3378278;2924;0;0
FR;3;2021-08-12;276;2635;12;0;0;4409555;3380913;2936;0;0
FR;3;2021-08-13;277;2260;16;0;0;4409832;3383173;2952;0;0
FR;3;2021-08-14;169;915;1;0;0;4410001;3384088;2953;0;0
FR;3;2021-08-15;55;174;0;0;0;4410056;3384262;2953;0;0
FR;3;2021-08-16;123;1084;8;0;0;4410179;3385346;2961;0;0
FR;3;2021-08-17;186;1499;8;0;0;4410365;3386845;2969;0;0
FR;3;2021-08-18;200;1366;10;0;0;4410565;3388211;2979;0;0
FR;3;2021-08-19;165;1409;10;0;0;4410730;3389620;2989;0;0
FR;3;2021-08-20;166;1629;16;0;0;4410896;3391249;3005;0;0
FR;3;2021-08-21;93;586;2;0;0;4410989;3391835;3007;0;0
FR;3;2021-08-22;41;187;1;0;0;4411030;3392022;3008;0;0
FR;3;2021-08-23;140;927;7;0;0;4411170;3392949;3015;0;0
FR;3;2021-08-24;124;965;10;0;0;4411294;3393914;3025;0;0
FR;3;2021-08-25;136;839;2;0;0;4411430;3394753;3027;0;0
FR;3;2021-08-26;170;868;9;0;0;4411600;3395621;3036;0;0
FR;3;2021-08-27;172;967;9;0;0;4411772;3396588;3045;0;0
FR;3;2021-08-28;98;370;4;0;0;4411870;3396958;3049;0;0
FR;3;2021-08-29;128;133;1;0;0;4411998;3397091;3050;0;0
FR;3;2021-08-30;99;598;0;0;134;4412097;3397689;3050;0;134
FR;3;2021-08-31;129;710;7;0;150;4412226;3398399;3057;0;284
FR;3;2021-09-01;115;476;5;0;122;4412341;3398875;3062;0;406
FR;3;2021-09-02;100;634;22;0;119;4412441;3399509;3084;0;525
FR;3;2021-09-03;115;586;17;0;128;4412556;3400095;3101;0;653
FR;3;2021-09-04;53;302;3;0;58;4412609;3400397;3104;0;711
FR;3;2021-09-05;51;68;5;0;28;4412660;3400465;3109;0;739
FR;3;2021-09-06;113;394;4;0;144;4412773;3400859;3113;0;883
FR;3;2021-09-07;123;470;14;0;128;4412896;3401329;3127;0;1011
FR;3;2021-09-08;118;369;2;0;101;4413014;3401698;3129;0;1112
FR;3;2021-09-09;92;397;8;0;114;4413106;3402095;3137;0;1226
FR;3;2021-09-10;100;419;3;0;102;4413206;3402514;3140;0;1328
FR;3;2021-09-11;76;238;4;0;66;4413282;3402752;3144;0;1394
FR;3;2021-09-12;36;48;1;0;17;4413318;3402800;3145;0;1411
FR;3;2021-09-13;72;320;7;0;109;4413390;3403120;3152;0;1520
FR;3;2021-09-14;72;291;6;0;105;4413462;3403411;3158;0;1625
FR;3;2021-09-15;60;263;3;0;6;4413522;3403674;3161;0;1631
FR;3;2021-09-16;60;335;5;0;5;4413582;3404009;3166;0;1636
FR;3;2021-09-17;51;347;3;0;7;4413633;3404356;3169;0;1643
FR;3;2021-09-18;36;174;1;0;1;4413669;3404530;3170;0;1644
FR;3;2021-09-19;27;32;2;0;1;4413696;3404562;3172;0;1645
FR;3;2021-09-20;79;210;0;0;1;4413775;3404772;3172;0;1646
FR;3;2021-09-21;58;287;6;0;7;4413833;3405059;3178;0;1653
FR;3;2021-09-22;63;228;6;0;7;4413896;3405287;3184;0;1660
FR;3;2021-09-23;36;271;11;0;7;4413932;3405558;3195;0;1667
FR;3;2021-09-24;25;324;12;0;19;4413957;3405882;3207;0;1686
FR;3;2021-09-25;29;148;3;0;3;4413986;3406030;3210;0;1689
FR;3;2021-09-26;15;55;1;0;1;4414001;3406085;3211;0;1690
FR;3;2021-09-27;39;291;3;0;5;4414040;3406376;3214;0;1695
FR;3;2021-09-28;49;257;6;0;10;4414089;3406633;3220;0;1705
FR;3;2021-09-29;35;224;10;0;14;4414124;3406857;3230;0;1719
FR;3;2021-09-30;38;202;8;0;10;4414162;3407059;3238;0;1729
FR;3;2021-10-01;17;167;6;0;6;4414179;3407226;3244;0;1735
FR;3;2021-10-02;14;90;0;0;0;4414193;3407316;3244;0;1735
FR;3;2021-10-03;18;20;1;0;2;4414211;3407336;3245;0;1737
FR;3;2021-10-04;30;161;4;0;4;4414241;3407497;3249;0;1741
FR;3;2021-10-05;16;155;10;0;13;4414257;3407652;3259;0;1754
FR;3;2021-10-06;31;157;8;0;9;4414288;3407809;3267;0;1763
FR;3;2021-10-07;18;141;6;0;6;4414306;3407950;3273;0;1769
FR;3;2021-10-08;22;144;10;0;9;4414328;3408094;3283;0;1778
FR;3;2021-10-09;13;72;1;0;1;4414341;3408166;3284;0;1779
FR;3;2021-10-10;12;16;2;0;2;4414353;3408182;3286;0;1781
FR;3;2021-10-11;15;123;4;0;5;4414368;3408305;3290;0;1786
FR;3;2021-10-12;18;112;5;0;5;4414386;3408417;3295;0;1791
FR;3;2021-10-13;23;118;7;0;5;4414409;3408535;3302;0;1796
FR;3;2021-10-14;16;163;3;0;4;4414425;3408698;3305;0;1800
FR;3;2021-10-15;21;155;8;0;11;4414446;3408853;3313;0;1811
FR;3;2021-10-16;11;78;6;0;8;4414457;3408931;3319;0;1819
FR;3;2021-10-17;11;24;0;0;0;4414468;3408955;3319;0;1819
FR;3;2021-10-18;17;125;2;0;1;4414485;3409080;3321;0;1820
FR;3;2021-10-19;16;125;19;0;21;4414501;3409205;3340;0;1841
FR;3;2021-10-20;22;129;6;0;7;4414523;3409334;3346;0;1848
FR;3;2021-10-21;26;136;17;0;13;4414549;3409470;3363;0;1861
FR;3;2021-10-22;20;126;16;0;20;4414569;3409596;3379;0;1881
FR;3;2021-10-23;12;58;2;0;1;4414581;3409654;3381;0;1882
FR;3;2021-10-24;7;32;0;0;0;4414588;3409686;3381;0;1882
FR;3;2021-10-25;22;150;7;0;7;4414610;3409836;3388;0;1889
FR;3;2021-10-26;19;112;22;0;19;4414629;3409948;3410;0;1908
FR;3;2021-10-27;17;117;9;0;9;4414646;3410065;3419;0;1917
FR;3;2021-10-28;20;128;33;0;36;4414666;3410193;3452;0;1953
FR;3;2021-10-29;11;122;64;0;54;4414677;3410315;3516;0;2007
FR;3;2021-10-30;8;65;11;1;10;4414685;3410380;3527;1;2017
FR;3;2021-10-31;6;22;1;0;1;4414691;3410402;3528;1;2018
FR;3;2021-11-01;7;22;2;0;1;4414698;3410424;3530;1;2019
FR;3;2021-11-02;9;107;8;0;10;4414707;3410531;3538;1;2029
FR;3;2021-11-03;19;117;10;0;10;4414726;3410648;3548;1;2039
FR;3;2021-11-04;18;96;4;0;3;4414744;3410744;3552;1;2042
FR;3;2021-11-05;17;141;8;1;5;4414761;3410885;3560;2;2047
FR;3;2021-11-06;7;66;3;0;3;4414768;3410951;3563;2;2050
FR;3;2021-11-07;6;21;1;0;1;4414774;3410972;3564;2;2051
FR;3;2021-11-08;11;140;7;0;5;4414785;3411112;3571;2;2056
FR;3;2021-11-09;12;149;5;0;5;4414797;3411261;3576;2;2061
FR;3;2021-11-10;13;175;14;0;15;4414810;3411436;3590;2;2076
FR;3;2021-11-11;8;51;3;0;3;4414818;3411487;3593;2;2079
FR;3;2021-11-12;11;152;6;0;4;4414829;3411639;3599;2;2083
FR;3;2021-11-13;7;77;8;0;10;4414836;3411716;3607;2;2093
FR;3;2021-11-14;2;21;0;0;0;4414838;3411737;3607;2;2093
FR;3;2021-11-15;4;190;10;0;10;4414842;3411927;3617;2;2103
FR;3;2021-11-16;3;164;11;0;10;4414845;3412091;3628;2;2113
FR;3;2021-11-17;6;176;10;0;7;4414851;3412267;3638;2;2120
FR;3;2021-11-18;13;176;10;0;11;4414864;3412443;3648;2;2131
FR;3;2021-11-19;9;222;22;0;27;4414873;3412665;3670;2;2158
FR;3;2021-11-20;6;115;5;0;5;4414879;3412780;3675;2;2163
FR;3;2021-11-21;3;26;3;0;3;4414882;3412806;3678;2;2166
FR;3;2021-11-22;10;231;10;0;10;4414892;3413037;3688;2;2176
FR;3;2021-11-23;6;231;15;0;14;4414898;3413268;3703;2;2190
FR;3;2021-11-24;5;233;9;0;17;4414903;3413501;3712;2;2207
FR;3;2021-11-25;9;280;11;0;10;4414912;3413781;3723;2;2217
FR;3;2021-11-26;6;353;35;0;32;4414918;3414134;3758;2;2249
FR;3;2021-11-27;8;168;20;0;21;4414926;3414302;3778;2;2270
FR;3;2021-11-28;3;61;7;0;7;4414929;3414363;3785;2;2277
FR;3;2021-11-29;4;310;19;0;20;4414933;3414673;3804;2;2297
FR;3;2021-11-30;5;400;26;0;29;4414938;3415073;3830;2;2326
FR;3;2021-12-01;20;448;32;0;33;4414958;3415521;3862;2;2359
FR;3;2021-12-02;9;469;33;0;36;4414967;3415990;3895;2;2395
FR;3;2021-12-03;3;552;37;0;38;4414970;3416542;3932;2;2433
FR;3;2021-12-04;3;276;26;0;28;4414973;3416818;3958;2;2461
FR;3;2021-12-05;1;80;5;0;5;4414974;3416898;3963;2;2466
FR;3;2021-12-06;5;493;14;0;16;4414979;3417391;3977;2;2482
FR;3;2021-12-07;4;592;20;0;24;4414983;3417983;3997;2;2506
FR;3;2021-12-08;4;525;29;0;30;4414987;3418508;4026;2;2536
FR;3;2021-12-09;3;575;17;0;22;4414990;3419083;4043;2;2558
FR;3;2021-12-10;9;609;29;0;25;4414999;3419692;4072;2;2583
FR;3;2021-12-11;4;381;10;0;9;4415003;3420073;4082;2;2592
FR;3;2021-12-12;1;120;3;0;3;4415004;3420193;4085;2;2595
FR;3;2021-12-13;2;585;19;0;21;4415006;3420778;4104;2;2616
FR;3;2021-12-14;7;742;18;0;21;4415013;3421520;4122;2;2637
FR;3;2021-12-15;9;708;17;0;21;4415022;3422228;4139;2;2658
FR;3;2021-12-16;9;717;19;0;18;4415031;3422945;4158;2;2676
FR;3;2021-12-17;4;785;18;0;19;4415035;3423730;4176;2;2695
FR;3;2021-12-18;4;409;4;0;5;4415039;3424139;4180;2;2700
FR;3;2021-12-19;3;207;2;0;2;4415042;3424346;4182;2;2702
FR;3;2021-12-20;8;712;23;0;28;4415050;3425058;4205;2;2730
FR;3;2021-12-21;3;800;10;0;13;4415053;3425858;4215;2;2743
FR;3;2021-12-22;6;752;9;0;10;4415059;3426610;4224;2;2753
FR;3;2021-12-23;1;644;9;0;8;4415060;3427254;4233;2;2761
FR;3;2021-12-24;2;269;3;0;6;4415062;3427523;4236;2;2767
FR;3;2021-12-25;0;25;0;0;0;4415062;3427548;4236;2;2767
FR;3;2021-12-26;0;93;1;0;1;4415062;3427641;4237;2;2768
FR;3;2021-12-27;7;537;17;0;19;4415069;3428178;4254;2;2787
FR;3;2021-12-28;1;687;6;0;5;4415070;3428865;4260;2;2792
FR;3;2021-12-29;4;571;14;0;16;4415074;3429436;4274;2;2808
FR;3;2021-12-30;1;599;7;0;10;4415075;3430035;4281;2;2818
FR;3;2021-12-31;0;204;5;0;7;4415075;3430239;4286;2;2825
FR;3;2022-01-01;0;27;0;0;2;4415075;3430266;4286;2;2827
FR;3;2022-01-02;0;82;0;0;0;4415075;3430348;4286;2;2827
FR;3;2022-01-03;3;563;17;0;20;4415078;3430911;4303;2;2847
FR;3;2022-01-04;6;623;9;0;8;4415084;3431534;4312;2;2855
FR;3;2022-01-05;4;550;10;0;14;4415088;3432084;4322;2;2869
FR;3;2022-01-06;5;545;9;0;12;4415093;3432629;4331;2;2881
FR;3;2022-01-07;2;572;11;0;13;4415095;3433201;4342;2;2894
FR;3;2022-01-08;2;283;4;0;5;4415097;3433484;4346;2;2899
FR;3;2022-01-09;0;118;0;0;0;4415097;3433602;4346;2;2899
FR;3;2022-01-10;2;478;12;0;12;4415099;3434080;4358;2;2911
FR;3;2022-01-11;2;526;1;0;1;4415101;3434606;4359;2;2912
FR;3;2022-01-12;2;443;9;0;10;4415103;3435049;4368;2;2922
FR;3;2022-01-13;3;422;11;0;12;4415106;3435471;4379;2;2934
FR;3;2022-01-14;3;472;10;0;13;4415109;3435943;4389;2;2947
FR;3;2022-01-15;0;298;2;0;3;4415109;3436241;4391;2;2950
FR;3;2022-01-16;0;116;1;0;1;4415109;3436357;4392;2;2951
FR;3;2022-01-17;2;347;8;0;10;4415111;3436704;4400;2;2961
FR;3;2022-01-18;2;409;1;0;2;4415113;3437113;4401;2;2963
FR;3;2022-01-19;2;349;5;0;10;4415115;3437462;4406;2;2973
FR;3;2022-01-20;1;377;5;0;3;4415116;3437839;4411;2;2976
FR;3;2022-01-21;4;370;5;0;7;4415120;3438209;4416;2;2983
FR;3;2022-01-22;2;231;1;0;2;4415122;3438440;4417;2;2985
FR;3;2022-01-23;0;82;0;0;1;4415122;3438522;4417;2;2986
FR;3;2022-01-24;2;346;1;0;6;4415124;3438868;4418;2;2992
FR;3;2022-01-25;0;191;0;0;0;4415124;3439059;4418;2;2992
FR;3;2022-01-26;0;88;0;0;0;4415124;3439147;4418;2;2992
FR;3;2022-01-27;0;56;0;0;0;4415124;3439203;4418;2;2992
FR;3;2022-01-28;0;133;0;0;0;4415124;3439336;4418;2;2992
FR;3;2022-01-29;0;110;0;0;0;4415124;3439446;4418;2;2992
FR;3;2022-01-30;0;51;0;0;0;4415124;3439497;4418;2;2992
FR;3;2022-01-31;0;97;0;0;0;4415124;3439594;4418;2;2992
FR;3;2022-02-01;0;108;0;0;1;4415124;3439702;4418;2;2993
FR;3;2022-02-02;0;95;0;0;0;4415124;3439797;4418;2;2993
FR;3;2022-02-03;0;101;0;0;0;4415124;3439898;4418;2;2993
FR;3;2022-02-04;0;124;0;0;0;4415124;3440022;4418;2;2993
FR;3;2022-02-05;0;73;0;0;0;4415124;3440095;4418;2;2993
FR;3;2022-02-06;0;11;0;0;0;4415124;3440106;4418;2;2993
FR;3;2022-02-07;0;89;0;0;1;4415124;3440195;4418;2;2994
FR;3;2022-02-08;0;0;0;0;0;4415124;3440195;4418;2;2994
FR;3;2022-02-09;0;0;0;0;0;4415124;3440195;4418;2;2994
FR;3;2022-02-10;0;0;0;0;0;4415124;3440195;4418;2;2994
FR;3;2022-02-11;0;0;0;0;0;4415124;3440195;4418;2;2994
FR;3;2022-02-12;0;0;0;0;0;4415124;3440195;4418;2;2994
FR;3;2022-02-13;0;0;0;0;0;4415124;3440195;4418;2;2994
FR;3;2022-02-14;0;0;0;0;0;4415124;3440195;4418;2;2994
FR;3;2022-02-15;0;0;0;0;0;4415124;3440195;4418;2;2994
FR;3;2022-02-16;0;0;0;0;0;4415124;3440195;4418;2;2994
FR;3;2022-02-17;0;0;0;0;0;4415124;3440195;4418;2;2994
FR;3;2022-02-18;0;0;0;0;0;4415124;3440195;4418;2;2994
FR;3;2022-02-19;0;0;0;0;0;4415124;3440195;4418;2;2994
FR;3;2022-02-20;0;0;0;0;0;4415124;3440195;4418;2;2994
FR;3;2022-02-21;2;0;0;0;0;4415126;3440195;4418;2;2994
FR;3;2022-02-22;0;0;0;0;0;4415126;3440195;4418;2;2994
FR;3;2022-02-23;0;0;0;0;0;4415126;3440195;4418;2;2994
FR;3;2022-02-24;0;0;0;0;0;4415126;3440195;4418;2;2994
FR;3;2022-02-25;0;0;0;0;0;4415126;3440195;4418;2;2994
FR;3;2022-02-26;0;0;0;0;0;4415126;3440195;4418;2;2994
FR;3;2022-02-27;0;0;0;0;0;4415126;3440195;4418;2;2994
FR;3;2022-02-28;1;0;0;0;0;4415127;3440195;4418;2;2994
FR;3;2022-03-01;1;0;0;0;0;4415128;3440195;4418;2;2994
FR;3;2022-03-02;0;0;0;0;0;4415128;3440195;4418;2;2994
FR;3;2022-03-03;0;0;0;0;0;4415128;3440195;4418;2;2994
FR;3;2022-03-04;0;0;0;0;0;4415128;3440195;4418;2;2994
FR;3;2022-03-05;0;0;0;0;0;4415128;3440195;4418;2;2994
FR;3;2022-03-06;1;0;0;0;0;4415129;3440195;4418;2;2994
FR;3;2022-03-07;0;0;0;0;0;4415129;3440195;4418;2;2994
FR;3;2022-03-08;1;0;0;0;0;4415130;3440195;4418;2;2994
FR;3;2022-03-09;0;0;0;0;0;4415130;3440195;4418;2;2994
FR;3;2022-03-10;0;0;0;0;0;4415130;3440195;4418;2;2994
FR;3;2022-03-11;0;0;0;0;0;4415130;3440195;4418;2;2994
FR;3;2022-03-12;0;0;0;0;0;4415130;3440195;4418;2;2994
FR;3;2022-03-13;0;0;0;0;0;4415130;3440195;4418;2;2994
FR;3;2022-03-14;0;0;0;0;0;4415130;3440195;4418;2;2994
FR;3;2022-03-15;0;0;0;0;0;4415130;3440195;4418;2;2994
FR;3;2022-03-16;0;0;0;0;0;4415130;3440195;4418;2;2994
FR;3;2022-03-17;0;0;0;0;0;4415130;3440195;4418;2;2994
FR;3;2022-03-18;0;0;0;0;0;4415130;3440195;4418;2;2994
FR;3;2022-03-19;0;0;0;0;0;4415130;3440195;4418;2;2994
FR;3;2022-03-20;1;0;0;0;0;4415131;3440195;4418;2;2994
FR;3;2022-03-21;0;0;0;0;0;4415131;3440195;4418;2;2994
FR;3;2022-03-22;0;0;0;0;0;4415131;3440195;4418;2;2994
FR;3;2022-03-23;1;0;0;0;0;4415132;3440195;4418;2;2994
FR;3;2022-03-24;0;0;0;0;0;4415132;3440195;4418;2;2994
FR;3;2022-03-25;1;0;0;0;0;4415133;3440195;4418;2;2994
FR;3;2022-03-26;0;0;0;0;0;4415133;3440195;4418;2;2994
FR;3;2022-03-27;0;0;0;0;0;4415133;3440195;4418;2;2994
FR;3;2022-03-28;0;0;0;0;0;4415133;3440195;4418;2;2994
FR;3;2022-03-29;0;0;0;0;0;4415133;3440195;4418;2;2994
FR;3;2022-03-30;0;0;0;0;0;4415133;3440195;4418;2;2994
FR;3;2022-03-31;0;0;0;0;0;4415133;3440195;4418;2;2994
FR;3;2022-04-01;0;0;0;0;0;4415133;3440195;4418;2;2994
FR;3;2022-04-02;0;0;0;0;0;4415133;3440195;4418;2;2994
FR;3;2022-04-03;0;0;0;0;0;4415133;3440195;4418;2;2994
FR;3;2022-04-04;0;0;0;0;0;4415133;3440195;4418;2;2994
FR;3;2022-04-05;0;0;0;0;0;4415133;3440195;4418;2;2994
FR;3;2022-04-06;0;0;0;0;0;4415133;3440195;4418;2;2994
FR;3;2022-04-07;0;0;0;0;0;4415133;3440195;4418;2;2994
FR;3;2022-04-08;0;0;0;0;0;4415133;3440195;4418;2;2994
FR;3;2022-04-09;0;0;0;0;0;4415133;3440195;4418;2;2994
FR;3;2022-04-10;0;0;0;0;0;4415133;3440195;4418;2;2994
FR;3;2022-04-11;0;0;0;0;0;4415133;3440195;4418;2;2994
FR;3;2022-04-12;0;0;0;0;0;4415133;3440195;4418;2;2994
FR;3;2022-04-13;0;0;0;0;0;4415133;3440195;4418;2;2994
FR;3;2022-04-14;0;0;0;0;0;4415133;3440195;4418;2;2994
FR;3;2022-04-15;1;0;0;0;0;4415134;3440195;4418;2;2994
FR;3;2022-04-16;0;0;0;0;0;4415134;3440195;4418;2;2994
FR;3;2022-04-17;0;0;0;0;0;4415134;3440195;4418;2;2994
FR;3;2022-04-18;0;0;0;0;0;4415134;3440195;4418;2;2994
FR;3;2022-04-19;0;0;0;0;0;4415134;3440195;4418;2;2994
FR;3;2022-04-20;0;0;0;0;0;4415134;3440195;4418;2;2994
FR;3;2022-04-21;0;0;0;0;0;4415134;3440195;4418;2;2994
FR;3;2022-04-22;0;0;0;0;0;4415134;3440195;4418;2;2994
FR;3;2022-04-23;0;0;0;0;0;4415134;3440195;4418;2;2994
FR;3;2022-04-24;0;0;0;0;0;4415134;3440195;4418;2;2994
FR;3;2022-04-25;0;0;0;0;0;4415134;3440195;4418;2;2994
FR;3;2022-04-26;0;0;0;0;0;4415134;3440195;4418;2;2994
FR;3;2022-04-27;0;0;0;0;0;4415134;3440195;4418;2;2994
FR;3;2022-04-28;0;0;0;0;0;4415134;3440195;4418;2;2994
FR;3;2022-04-29;0;0;0;0;0;4415134;3440195;4418;2;2994
FR;3;2022-04-30;0;0;0;0;0;4415134;3440195;4418;2;2994
FR;3;2022-05-01;0;0;0;0;0;4415134;3440195;4418;2;2994
FR;3;2022-05-02;0;0;0;0;0;4415134;3440195;4418;2;2994
FR;3;2022-05-03;0;0;0;0;0;4415134;3440195;4418;2;2994
FR;3;2022-05-04;0;0;0;0;0;4415134;3440195;4418;2;2994
FR;3;2022-05-05;0;0;0;0;0;4415134;3440195;4418;2;2994
FR;3;2022-05-06;0;0;0;0;0;4415134;3440195;4418;2;2994
FR;3;2022-05-07;0;0;0;0;0;4415134;3440195;4418;2;2994
FR;3;2022-05-08;0;0;0;0;0;4415134;3440195;4418;2;2994
FR;3;2022-05-09;0;0;0;0;0;4415134;3440195;4418;2;2994
FR;3;2022-05-10;0;0;0;0;0;4415134;3440195;4418;2;2994
FR;3;2022-05-11;0;0;0;0;0;4415134;3440195;4418;2;2994
FR;3;2022-05-12;0;0;0;0;0;4415134;3440195;4418;2;2994
FR;3;2022-05-13;0;0;0;0;0;4415134;3440195;4418;2;2994
FR;3;2022-05-14;1;0;0;0;0;4415135;3440195;4418;2;2994
FR;3;2022-05-15;0;0;0;0;0;4415135;3440195;4418;2;2994
FR;3;2022-05-16;0;0;0;0;0;4415135;3440195;4418;2;2994
FR;3;2022-05-17;0;0;0;0;0;4415135;3440195;4418;2;2994
FR;3;2022-05-18;0;0;0;0;0;4415135;3440195;4418;2;2994
FR;3;2022-05-19;0;0;0;0;0;4415135;3440195;4418;2;2994
FR;3;2022-05-20;0;0;0;0;0;4415135;3440195;4418;2;2994
FR;3;2022-05-21;0;0;0;0;0;4415135;3440195;4418;2;2994
FR;3;2022-05-22;0;0;0;0;0;4415135;3440195;4418;2;2994
FR;3;2022-05-23;0;0;0;0;0;4415135;3440195;4418;2;2994
FR;3;2022-05-24;0;0;0;0;0;4415135;3440195;4418;2;2994
FR;3;2022-05-25;0;0;0;0;0;4415135;3440195;4418;2;2994
FR;3;2022-05-26;0;0;0;0;0;4415135;3440195;4418;2;2994
FR;3;2022-05-27;0;0;0;0;0;4415135;3440195;4418;2;2994
FR;3;2022-05-28;0;0;0;0;0;4415135;3440195;4418;2;2994
FR;3;2022-05-29;0;0;0;0;0;4415135;3440195;4418;2;2994
FR;3;2022-05-30;0;0;0;0;0;4415135;3440195;4418;2;2994
FR;3;2022-05-31;0;0;0;0;0;4415135;3440195;4418;2;2994
FR;3;2022-06-01;0;0;0;0;0;4415135;3440195;4418;2;2994
FR;3;2022-06-02;0;0;0;0;0;4415135;3440195;4418;2;2994
FR;3;2022-06-03;0;0;0;0;0;4415135;3440195;4418;2;2994
FR;3;2022-06-04;0;0;0;0;0;4415135;3440195;4418;2;2994
FR;3;2022-06-05;0;0;0;0;0;4415135;3440195;4418;2;2994
FR;3;2022-06-06;0;0;0;0;0;4415135;3440195;4418;2;2994
FR;3;2022-06-07;0;0;0;0;0;4415135;3440195;4418;2;2994
FR;3;2022-06-08;0;0;0;0;0;4415135;3440195;4418;2;2994
FR;3;2022-06-09;0;0;0;0;0;4415135;3440195;4418;2;2994
FR;3;2022-06-10;0;0;0;0;0;4415135;3440195;4418;2;2994
FR;3;2022-06-11;0;0;0;0;0;4415135;3440195;4418;2;2994
FR;3;2022-06-12;0;0;0;0;0;4415135;3440195;4418;2;2994
FR;3;2022-06-13;1;0;0;0;0;4415136;3440195;4418;2;2994
FR;3;2022-06-14;0;0;0;0;0;4415136;3440195;4418;2;2994
FR;3;2022-06-15;0;0;0;0;0;4415136;3440195;4418;2;2994
FR;4;2020-12-27;0;0;0;0;0;0;0;0;0;0
FR;4;2020-12-28;0;0;0;0;0;0;0;0;0;0
FR;4;2020-12-29;0;0;0;0;0;0;0;0;0;0
FR;4;2020-12-30;0;0;0;0;0;0;0;0;0;0
FR;4;2020-12-31;0;0;0;0;0;0;0;0;0;0
FR;4;2021-01-01;0;0;0;0;0;0;0;0;0;0
FR;4;2021-01-02;0;0;0;0;0;0;0;0;0;0
FR;4;2021-01-03;0;0;0;0;0;0;0;0;0;0
FR;4;2021-01-04;0;0;0;0;0;0;0;0;0;0
FR;4;2021-01-05;0;0;0;0;0;0;0;0;0;0
FR;4;2021-01-06;0;0;0;0;0;0;0;0;0;0
FR;4;2021-01-07;0;0;0;0;0;0;0;0;0;0
FR;4;2021-01-08;0;0;0;0;0;0;0;0;0;0
FR;4;2021-01-09;0;0;0;0;0;0;0;0;0;0
FR;4;2021-01-10;0;0;0;0;0;0;0;0;0;0
FR;4;2021-01-11;0;0;0;0;0;0;0;0;0;0
FR;4;2021-01-12;0;0;0;0;0;0;0;0;0;0
FR;4;2021-01-13;0;0;0;0;0;0;0;0;0;0
FR;4;2021-01-14;0;0;0;0;0;0;0;0;0;0
FR;4;2021-01-15;0;0;0;0;0;0;0;0;0;0
FR;4;2021-01-16;0;0;0;0;0;0;0;0;0;0
FR;4;2021-01-17;0;0;0;0;0;0;0;0;0;0
FR;4;2021-01-18;0;0;0;0;0;0;0;0;0;0
FR;4;2021-01-19;0;0;0;0;0;0;0;0;0;0
FR;4;2021-01-20;0;0;0;0;0;0;0;0;0;0
FR;4;2021-01-21;0;0;0;0;0;0;0;0;0;0
FR;4;2021-01-22;0;0;0;0;0;0;0;0;0;0
FR;4;2021-01-23;0;0;0;0;0;0;0;0;0;0
FR;4;2021-01-24;0;0;0;0;0;0;0;0;0;0
FR;4;2021-01-25;0;0;0;0;0;0;0;0;0;0
FR;4;2021-01-26;0;0;0;0;0;0;0;0;0;0
FR;4;2021-01-27;0;0;0;0;0;0;0;0;0;0
FR;4;2021-01-28;0;0;0;0;0;0;0;0;0;0
FR;4;2021-01-29;0;0;0;0;0;0;0;0;0;0
FR;4;2021-01-30;0;0;0;0;0;0;0;0;0;0
FR;4;2021-01-31;0;0;0;0;0;0;0;0;0;0
FR;4;2021-02-01;0;0;0;0;0;0;0;0;0;0
FR;4;2021-02-02;0;0;0;0;0;0;0;0;0;0
FR;4;2021-02-03;0;0;0;0;0;0;0;0;0;0
FR;4;2021-02-04;0;0;0;0;0;0;0;0;0;0
FR;4;2021-02-05;0;0;0;0;0;0;0;0;0;0
FR;4;2021-02-06;0;0;0;0;0;0;0;0;0;0
FR;4;2021-02-07;0;0;0;0;0;0;0;0;0;0
FR;4;2021-02-08;0;0;0;0;0;0;0;0;0;0
FR;4;2021-02-09;0;0;0;0;0;0;0;0;0;0
FR;4;2021-02-10;0;0;0;0;0;0;0;0;0;0
FR;4;2021-02-11;0;0;0;0;0;0;0;0;0;0
FR;4;2021-02-12;0;0;0;0;0;0;0;0;0;0
FR;4;2021-02-13;0;0;0;0;0;0;0;0;0;0
FR;4;2021-02-14;0;0;0;0;0;0;0;0;0;0
FR;4;2021-02-15;0;0;0;0;0;0;0;0;0;0
FR;4;2021-02-16;0;0;0;0;0;0;0;0;0;0
FR;4;2021-02-17;0;0;0;0;0;0;0;0;0;0
FR;4;2021-02-18;0;0;0;0;0;0;0;0;0;0
FR;4;2021-02-19;0;0;0;0;0;0;0;0;0;0
FR;4;2021-02-20;0;0;0;0;0;0;0;0;0;0
FR;4;2021-02-21;0;0;0;0;0;0;0;0;0;0
FR;4;2021-02-22;0;0;0;0;0;0;0;0;0;0
FR;4;2021-02-23;0;0;0;0;0;0;0;0;0;0
FR;4;2021-02-24;0;0;0;0;0;0;0;0;0;0
FR;4;2021-02-25;0;0;0;0;0;0;0;0;0;0
FR;4;2021-02-26;0;0;0;0;0;0;0;0;0;0
FR;4;2021-02-27;0;0;0;0;0;0;0;0;0;0
FR;4;2021-02-28;0;0;0;0;0;0;0;0;0;0
FR;4;2021-03-01;0;0;0;0;0;0;0;0;0;0
FR;4;2021-03-02;0;0;0;0;0;0;0;0;0;0
FR;4;2021-03-03;0;0;0;0;0;0;0;0;0;0
FR;4;2021-03-04;0;0;0;0;0;0;0;0;0;0
FR;4;2021-03-05;0;0;0;0;0;0;0;0;0;0
FR;4;2021-03-06;0;0;0;0;0;0;0;0;0;0
FR;4;2021-03-07;0;0;0;0;0;0;0;0;0;0
FR;4;2021-03-08;0;0;0;0;0;0;0;0;0;0
FR;4;2021-03-09;0;0;0;0;0;0;0;0;0;0
FR;4;2021-03-10;0;0;0;0;0;0;0;0;0;0
FR;4;2021-03-11;0;0;0;0;0;0;0;0;0;0
FR;4;2021-03-12;0;0;0;0;0;0;0;0;0;0
FR;4;2021-03-13;0;0;0;0;0;0;0;0;0;0
FR;4;2021-03-14;0;0;0;0;0;0;0;0;0;0
FR;4;2021-03-15;0;0;0;0;0;0;0;0;0;0
FR;4;2021-03-16;0;0;0;0;0;0;0;0;0;0
FR;4;2021-03-17;0;0;0;0;0;0;0;0;0;0
FR;4;2021-03-18;0;0;0;0;0;0;0;0;0;0
FR;4;2021-03-19;0;0;0;0;0;0;0;0;0;0
FR;4;2021-03-20;0;0;0;0;0;0;0;0;0;0
FR;4;2021-03-21;0;0;0;0;0;0;0;0;0;0
FR;4;2021-03-22;0;0;0;0;0;0;0;0;0;0
FR;4;2021-03-23;0;0;0;0;0;0;0;0;0;0
FR;4;2021-03-24;0;0;0;0;0;0;0;0;0;0
FR;4;2021-03-25;0;0;0;0;0;0;0;0;0;0
FR;4;2021-03-26;0;0;0;0;0;0;0;0;0;0
FR;4;2021-03-27;0;0;0;0;0;0;0;0;0;0
FR;4;2021-03-28;0;0;0;0;0;0;0;0;0;0
FR;4;2021-03-29;0;0;0;0;0;0;0;0;0;0
FR;4;2021-03-30;0;0;0;0;0;0;0;0;0;0
FR;4;2021-03-31;0;0;0;0;0;0;0;0;0;0
FR;4;2021-04-01;0;0;0;0;0;0;0;0;0;0
FR;4;2021-04-02;0;0;0;0;0;0;0;0;0;0
FR;4;2021-04-03;0;0;0;0;0;0;0;0;0;0
FR;4;2021-04-04;0;0;0;0;0;0;0;0;0;0
FR;4;2021-04-05;0;0;0;0;0;0;0;0;0;0
FR;4;2021-04-06;0;0;0;0;0;0;0;0;0;0
FR;4;2021-04-07;0;0;0;0;0;0;0;0;0;0
FR;4;2021-04-08;0;0;0;0;0;0;0;0;0;0
FR;4;2021-04-09;0;0;0;0;0;0;0;0;0;0
FR;4;2021-04-10;0;0;0;0;0;0;0;0;0;0
FR;4;2021-04-11;0;0;0;0;0;0;0;0;0;0
FR;4;2021-04-12;0;0;0;0;0;0;0;0;0;0
FR;4;2021-04-13;0;0;0;0;0;0;0;0;0;0
FR;4;2021-04-14;0;0;0;0;0;0;0;0;0;0
FR;4;2021-04-15;0;0;0;0;0;0;0;0;0;0
FR;4;2021-04-16;0;0;0;0;0;0;0;0;0;0
FR;4;2021-04-17;0;0;0;0;0;0;0;0;0;0
FR;4;2021-04-18;0;0;0;0;0;0;0;0;0;0
FR;4;2021-04-19;0;0;0;0;0;0;0;0;0;0
FR;4;2021-04-20;0;0;0;0;0;0;0;0;0;0
FR;4;2021-04-21;0;0;0;0;0;0;0;0;0;0
FR;4;2021-04-22;0;0;0;0;0;0;0;0;0;0
FR;4;2021-04-23;4000;0;0;0;0;4000;0;0;0;0
FR;4;2021-04-24;1569;0;0;0;0;5569;0;0;0;0
FR;4;2021-04-25;125;0;0;0;0;5694;0;0;0;0
FR;4;2021-04-26;2869;1;0;0;0;8563;1;0;0;0
FR;4;2021-04-27;9518;3;0;0;0;18081;4;0;0;0
FR;4;2021-04-28;9904;6;0;0;0;27985;10;0;0;0
FR;4;2021-04-29;15990;8;0;0;0;43975;18;0;0;0
FR;4;2021-04-30;19231;10;0;0;0;63206;28;0;0;0
FR;4;2021-05-01;1994;6;0;0;0;65200;34;0;0;0
FR;4;2021-05-02;482;0;0;0;0;65682;34;0;0;0
FR;4;2021-05-03;5058;2;0;0;0;70740;36;0;0;0
FR;4;2021-05-04;8397;10;0;0;0;79137;46;0;0;0
FR;4;2021-05-05;6182;7;0;0;0;85319;53;0;0;0
FR;4;2021-05-06;11378;11;0;0;0;96697;64;0;0;0
FR;4;2021-05-07;19121;9;0;0;0;115818;73;0;0;0
FR;4;2021-05-08;2377;6;0;0;0;118195;79;0;0;0
FR;4;2021-05-09;685;3;0;0;0;118880;82;0;0;0
FR;4;2021-05-10;7240;5;1;0;0;126120;87;1;0;0
FR;4;2021-05-11;14316;12;0;0;0;140436;99;1;0;0
FR;4;2021-05-12;10164;15;0;0;0;150600;114;1;0;0
FR;4;2021-05-13;1579;3;0;0;0;152179;117;1;0;0
FR;4;2021-05-14;7760;7;0;0;0;159939;124;1;0;0
FR;4;2021-05-15;3717;8;1;0;0;163656;132;2;0;0
FR;4;2021-05-16;417;1;0;0;0;164073;133;2;0;0
FR;4;2021-05-17;4477;6;0;0;0;168550;139;2;0;0
FR;4;2021-05-18;8753;10;0;0;0;177303;149;2;0;0
FR;4;2021-05-19;5690;7;0;0;0;182993;156;2;0;0
FR;4;2021-05-20;9480;7;0;0;0;192473;163;2;0;0
FR;4;2021-05-21;12791;30;0;0;0;205264;193;2;0;0
FR;4;2021-05-22;5057;15;0;0;0;210321;208;2;0;0
FR;4;2021-05-23;494;4;0;0;0;210815;212;2;0;0
FR;4;2021-05-24;1054;7;0;0;0;211869;219;2;0;0
FR;4;2021-05-25;7620;16;0;0;0;219489;235;2;0;0
FR;4;2021-05-26;7725;16;0;0;0;227214;251;2;0;0
FR;4;2021-05-27;14328;35;0;0;0;241542;286;2;0;0
FR;4;2021-05-28;26583;82;1;0;0;268125;368;3;0;0
FR;4;2021-05-29;11380;18;0;0;0;279505;386;3;0;0
FR;4;2021-05-30;971;6;0;0;0;280476;392;3;0;0
FR;4;2021-05-31;12687;21;0;0;0;293163;413;3;0;0
FR;4;2021-06-01;20251;46;1;0;0;313414;459;4;0;0
FR;4;2021-06-02;14519;33;0;0;0;327933;492;4;0;0
FR;4;2021-06-03;19411;24;1;0;0;347344;516;5;0;0
FR;4;2021-06-04;22512;47;0;0;0;369856;563;5;0;0
FR;4;2021-06-05;9712;32;0;0;0;379568;595;5;0;0
FR;4;2021-06-06;1039;1;0;0;0;380607;596;5;0;0
FR;4;2021-06-07;9224;19;0;0;0;389831;615;5;0;0
FR;4;2021-06-08;14607;31;0;0;0;404438;646;5;0;0
FR;4;2021-06-09;12203;25;0;0;0;416641;671;5;0;0
FR;4;2021-06-10;15398;30;0;0;0;432039;701;5;0;0
FR;4;2021-06-11;16980;56;0;0;0;449019;757;5;0;0
FR;4;2021-06-12;7446;27;0;0;0;456465;784;5;0;0
FR;4;2021-06-13;907;2;0;0;0;457372;786;5;0;0
FR;4;2021-06-14;6646;25;0;0;0;464018;811;5;0;0
FR;4;2021-06-15;10883;37;0;0;0;474901;848;5;0;0
FR;4;2021-06-16;8904;15;0;0;0;483805;863;5;0;0
FR;4;2021-06-17;10896;36;0;0;0;494701;899;5;0;0
FR;4;2021-06-18;12420;45;0;0;0;507121;944;5;0;0
FR;4;2021-06-19;5567;25;0;0;0;512688;969;5;0;0
FR;4;2021-06-20;819;5;0;0;0;513507;974;5;0;0
FR;4;2021-06-21;5082;20;0;0;0;518589;994;5;0;0
FR;4;2021-06-22;7905;28;2;0;0;526494;1022;7;0;0
FR;4;2021-06-23;7093;40;2;0;0;533587;1062;9;0;0
FR;4;2021-06-24;8647;46;1;0;0;542234;1108;10;0;0
FR;4;2021-06-25;10173;39;2;0;0;552407;1147;12;0;0
FR;4;2021-06-26;4840;21;0;0;0;557247;1168;12;0;0
FR;4;2021-06-27;761;3;0;0;0;558008;1171;12;0;0
FR;4;2021-06-28;4822;16;1;0;0;562830;1187;13;0;0
FR;4;2021-06-29;7099;27;2;0;0;569929;1214;15;0;0
FR;4;2021-06-30;6708;39;2;0;0;576637;1253;17;0;0
FR;4;2021-07-01;8193;40;0;0;0;584830;1293;17;0;0
FR;4;2021-07-02;9412;52;1;0;0;594242;1345;18;0;0
FR;4;2021-07-03;4844;19;0;0;0;599086;1364;18;0;0
FR;4;2021-07-04;686;5;0;0;0;599772;1369;18;0;0
FR;4;2021-07-05;4767;19;2;0;0;604539;1388;20;0;0
FR;4;2021-07-06;7718;28;4;0;0;612257;1416;24;0;0
FR;4;2021-07-07;7071;34;2;0;0;619328;1450;26;0;0
FR;4;2021-07-08;9222;40;2;0;0;628550;1490;28;0;0
FR;4;2021-07-09;10276;34;1;0;0;638826;1524;29;0;0
FR;4;2021-07-10;4634;14;2;0;0;643460;1538;31;0;0
FR;4;2021-07-11;582;4;1;0;0;644042;1542;32;0;0
FR;4;2021-07-12;5868;29;0;0;0;649910;1571;32;0;0
FR;4;2021-07-13;14229;29;0;0;0;664139;1600;32;0;0
FR;4;2021-07-14;2283;14;0;0;0;666422;1614;32;0;0
FR;4;2021-07-15;18233;36;0;0;0;684655;1650;32;0;0
FR;4;2021-07-16;22816;70;2;0;0;707471;1720;34;0;0
FR;4;2021-07-17;9735;20;0;0;0;717206;1740;34;0;0
FR;4;2021-07-18;1354;4;0;0;0;718560;1744;34;0;0
FR;4;2021-07-19;12982;28;1;0;0;731542;1772;35;0;0
FR;4;2021-07-20;17334;26;1;0;0;748876;1798;36;0;0
FR;4;2021-07-21;15607;33;0;0;0;764483;1831;36;0;0
FR;4;2021-07-22;18239;44;2;0;0;782722;1875;38;0;0
FR;4;2021-07-23;20406;57;7;0;0;803128;1932;45;0;0
FR;4;2021-07-24;9281;32;0;0;0;812409;1964;45;0;0
FR;4;2021-07-25;1350;8;0;0;0;813759;1972;45;0;0
FR;4;2021-07-26;11032;20;0;0;0;824791;1992;45;0;0
FR;4;2021-07-27;14663;35;3;0;0;839454;2027;48;0;0
FR;4;2021-07-28;12925;26;2;0;0;852379;2053;50;0;0
FR;4;2021-07-29;14080;54;4;0;0;866459;2107;54;0;0
FR;4;2021-07-30;15482;45;2;0;0;881941;2152;56;0;0
FR;4;2021-07-31;6833;14;2;0;0;888774;2166;58;0;0
FR;4;2021-08-01;904;1;0;0;0;889678;2167;58;0;0
FR;4;2021-08-02;7906;29;0;0;0;897584;2196;58;0;0
FR;4;2021-08-03;10790;32;2;0;0;908374;2228;60;0;0
FR;4;2021-08-04;9735;29;0;0;0;918109;2257;60;0;0
FR;4;2021-08-05;9815;41;0;0;0;927924;2298;60;0;0
FR;4;2021-08-06;10188;30;3;0;0;938112;2328;63;0;0
FR;4;2021-08-07;5091;30;1;0;0;943203;2358;64;0;0
FR;4;2021-08-08;1218;13;0;0;0;944421;2371;64;0;0
FR;4;2021-08-09;6334;31;0;0;0;950755;2402;64;0;0
FR;4;2021-08-10;8742;18;0;0;0;959497;2420;64;0;0
FR;4;2021-08-11;7932;33;4;0;0;967429;2453;68;0;0
FR;4;2021-08-12;8582;30;1;0;0;976011;2483;69;0;0
FR;4;2021-08-13;7547;24;0;1;0;983558;2507;69;1;0
FR;4;2021-08-14;3787;20;0;0;0;987345;2527;69;1;0
FR;4;2021-08-15;769;5;0;0;0;988114;2532;69;1;0
FR;4;2021-08-16;4005;16;0;0;0;992119;2548;69;1;0
FR;4;2021-08-17;5618;17;1;0;0;997737;2565;70;1;0
FR;4;2021-08-18;5166;34;0;0;0;1002903;2599;70;1;0
FR;4;2021-08-19;5478;33;3;0;0;1008381;2632;73;1;0
FR;4;2021-08-20;5211;24;1;0;0;1013592;2656;74;1;0
FR;4;2021-08-21;2309;21;1;0;0;1015901;2677;75;1;0
FR;4;2021-08-22;401;2;0;0;0;1016302;2679;75;1;0
FR;4;2021-08-23;2927;19;1;0;0;1019229;2698;76;1;0
FR;4;2021-08-24;3747;15;0;0;0;1022976;2713;76;1;0
FR;4;2021-08-25;3538;25;0;0;0;1026514;2738;76;1;0
FR;4;2021-08-26;3704;20;2;0;0;1030218;2758;78;1;0
FR;4;2021-08-27;3605;31;2;0;0;1033823;2789;80;1;0
FR;4;2021-08-28;1725;9;1;0;0;1035548;2798;81;1;0
FR;4;2021-08-29;387;7;1;0;0;1035935;2805;82;1;0
FR;4;2021-08-30;2009;25;0;0;15;1037944;2830;82;1;15
FR;4;2021-08-31;2482;20;0;0;13;1040426;2850;82;1;28
FR;4;2021-09-01;2078;38;1;0;21;1042504;2888;83;1;49
FR;4;2021-09-02;2301;31;4;0;18;1044805;2919;87;1;67
FR;4;2021-09-03;2357;44;5;0;32;1047162;2963;92;1;99
FR;4;2021-09-04;1373;17;0;0;8;1048535;2980;92;1;107
FR;4;2021-09-05;432;2;0;0;2;1048967;2982;92;1;109
FR;4;2021-09-06;1708;60;0;0;21;1050675;3042;92;1;130
FR;4;2021-09-07;1675;18;1;0;9;1052350;3060;93;1;139
FR;4;2021-09-08;1280;27;3;1;20;1053630;3087;96;2;159
FR;4;2021-09-09;1386;23;2;0;9;1055016;3110;98;2;168
FR;4;2021-09-10;1517;31;2;0;23;1056533;3141;100;2;191
FR;4;2021-09-11;739;11;0;0;3;1057272;3152;100;2;194
FR;4;2021-09-12;168;4;0;0;2;1057440;3156;100;2;196
FR;4;2021-09-13;1316;22;1;0;16;1058756;3178;101;2;212
FR;4;2021-09-14;1497;9;2;0;6;1060253;3187;103;2;218
FR;4;2021-09-15;1092;27;1;0;24;1061345;3214;104;2;242
FR;4;2021-09-16;1098;22;2;0;15;1062443;3236;106;2;257
FR;4;2021-09-17;890;21;1;0;12;1063333;3257;107;2;269
FR;4;2021-09-18;462;6;1;0;5;1063795;3263;108;2;274
FR;4;2021-09-19;181;3;0;0;2;1063976;3266;108;2;276
FR;4;2021-09-20;449;19;0;0;13;1064425;3285;108;2;289
FR;4;2021-09-21;423;11;0;0;7;1064848;3296;108;2;296
FR;4;2021-09-22;372;19;2;0;13;1065220;3315;110;2;309
FR;4;2021-09-23;477;16;1;0;15;1065697;3331;111;2;324
FR;4;2021-09-24;409;13;2;0;9;1066106;3344;113;2;333
FR;4;2021-09-25;281;9;1;0;4;1066387;3353;114;2;337
FR;4;2021-09-26;73;2;0;0;1;1066460;3355;114;2;338
FR;4;2021-09-27;262;10;1;0;8;1066722;3365;115;2;346
FR;4;2021-09-28;315;8;0;0;8;1067037;3373;115;2;354
FR;4;2021-09-29;373;18;1;0;12;1067410;3391;116;2;366
FR;4;2021-09-30;360;40;0;0;21;1067770;3431;116;2;387
FR;4;2021-10-01;408;49;0;0;43;1068178;3480;116;2;430
FR;4;2021-10-02;195;22;1;0;13;1068373;3502;117;2;443
FR;4;2021-10-03;85;1;0;0;0;1068458;3503;117;2;443
FR;4;2021-10-04;356;19;1;0;15;1068814;3522;118;2;458
FR;4;2021-10-05;277;19;2;0;15;1069091;3541;120;2;473
FR;4;2021-10-06;245;21;1;0;17;1069336;3562;121;2;490
FR;4;2021-10-07;258;25;2;0;13;1069594;3587;123;2;503
FR;4;2021-10-08;353;23;2;0;19;1069947;3610;125;2;522
FR;4;2021-10-09;193;6;6;0;7;1070140;3616;131;2;529
FR;4;2021-10-10;95;3;2;0;3;1070235;3619;133;2;532
FR;4;2021-10-11;247;15;1;0;14;1070482;3634;134;2;546
FR;4;2021-10-12;205;14;0;0;13;1070687;3648;134;2;559
FR;4;2021-10-13;220;27;1;0;24;1070907;3675;135;2;583
FR;4;2021-10-14;307;21;4;0;15;1071214;3696;139;2;598
FR;4;2021-10-15;321;24;5;0;25;1071535;3720;144;2;623
FR;4;2021-10-16;166;6;2;0;6;1071701;3726;146;2;629
FR;4;2021-10-17;70;2;0;0;1;1071771;3728;146;2;630
FR;4;2021-10-18;278;16;1;0;12;1072049;3744;147;2;642
FR;4;2021-10-19;210;14;2;0;15;1072259;3758;149;2;657
FR;4;2021-10-20;226;27;4;0;15;1072485;3785;153;2;672
FR;4;2021-10-21;236;17;0;0;13;1072721;3802;153;2;685
FR;4;2021-10-22;211;25;2;0;20;1072932;3827;155;2;705
FR;4;2021-10-23;115;16;1;0;15;1073047;3843;156;2;720
FR;4;2021-10-24;38;4;0;0;1;1073085;3847;156;2;721
FR;4;2021-10-25;210;7;2;0;9;1073295;3854;158;2;730
FR;4;2021-10-26;196;14;0;0;12;1073491;3868;158;2;742
FR;4;2021-10-27;192;11;4;0;11;1073683;3879;162;2;753
FR;4;2021-10-28;182;18;4;0;21;1073865;3897;166;2;774
FR;4;2021-10-29;220;15;2;0;13;1074085;3912;168;2;787
FR;4;2021-10-30;102;2;1;0;2;1074187;3914;169;2;789
FR;4;2021-10-31;56;3;2;0;3;1074243;3917;171;2;792
FR;4;2021-11-01;75;27;4;0;24;1074318;3944;175;2;816
FR;4;2021-11-02;156;20;2;0;21;1074474;3964;177;2;837
FR;4;2021-11-03;127;20;8;1;18;1074601;3984;185;3;855
FR;4;2021-11-04;178;15;1;0;12;1074779;3999;186;3;867
FR;4;2021-11-05;128;17;1;0;16;1074907;4016;187;3;883
FR;4;2021-11-06;77;6;1;0;6;1074984;4022;188;3;889
FR;4;2021-11-07;76;2;2;0;4;1075060;4024;190;3;893
FR;4;2021-11-08;158;20;1;0;20;1075218;4044;191;3;913
FR;4;2021-11-09;151;14;3;0;16;1075369;4058;194;3;929
FR;4;2021-11-10;114;29;6;0;31;1075483;4087;200;3;960
FR;4;2021-11-11;88;10;0;0;10;1075571;4097;200;3;970
FR;4;2021-11-12;99;19;2;0;18;1075670;4116;202;3;988
FR;4;2021-11-13;73;15;2;0;14;1075743;4131;204;3;1002
FR;4;2021-11-14;53;5;3;0;7;1075796;4136;207;3;1009
FR;4;2021-11-15;98;26;2;0;24;1075894;4162;209;3;1033
FR;4;2021-11-16;102;12;2;0;14;1075996;4174;211;3;1047
FR;4;2021-11-17;117;29;4;0;29;1076113;4203;215;3;1076
FR;4;2021-11-18;100;34;12;0;41;1076213;4237;227;3;1117
FR;4;2021-11-19;80;19;3;0;20;1076293;4256;230;3;1137
FR;4;2021-11-20;75;8;1;0;8;1076368;4264;231;3;1145
FR;4;2021-11-21;61;7;2;0;9;1076429;4271;233;3;1154
FR;4;2021-11-22;101;27;7;0;30;1076530;4298;240;3;1184
FR;4;2021-11-23;74;29;5;0;26;1076604;4327;245;3;1210
FR;4;2021-11-24;85;23;9;0;22;1076689;4350;254;3;1232
FR;4;2021-11-25;85;28;14;0;30;1076774;4378;268;3;1262
FR;4;2021-11-26;81;43;12;0;45;1076855;4421;280;3;1307
FR;4;2021-11-27;35;22;15;0;25;1076890;4443;295;3;1332
FR;4;2021-11-28;48;8;0;0;7;1076938;4451;295;3;1339
FR;4;2021-11-29;86;31;15;0;39;1077024;4482;310;3;1378
FR;4;2021-11-30;72;36;12;0;40;1077096;4518;322;3;1418
FR;4;2021-12-01;81;59;19;0;66;1077177;4577;341;3;1484
FR;4;2021-12-02;99;48;19;0;53;1077276;4625;360;3;1537
FR;4;2021-12-03;98;36;15;0;44;1077374;4661;375;3;1581
FR;4;2021-12-04;70;31;18;0;44;1077444;4692;393;3;1625
FR;4;2021-12-05;61;5;1;0;6;1077505;4697;394;3;1631
FR;4;2021-12-06;99;46;20;0;60;1077604;4743;414;3;1691
FR;4;2021-12-07;80;34;9;0;34;1077684;4777;423;3;1725
FR;4;2021-12-08;67;29;16;0;35;1077751;4806;439;3;1760
FR;4;2021-12-09;61;32;10;0;38;1077812;4838;449;3;1798
FR;4;2021-12-10;60;63;21;0;67;1077872;4901;470;3;1865
FR;4;2021-12-11;24;34;7;0;34;1077896;4935;477;3;1899
FR;4;2021-12-12;23;10;3;0;13;1077919;4945;480;3;1912
FR;4;2021-12-13;68;38;13;0;47;1077987;4983;493;3;1959
FR;4;2021-12-14;56;43;15;0;52;1078043;5026;508;3;2011
FR;4;2021-12-15;60;63;28;0;83;1078103;5089;536;3;2094
FR;4;2021-12-16;31;44;18;0;56;1078134;5133;554;3;2150
FR;4;2021-12-17;39;55;12;0;60;1078173;5188;566;3;2210
FR;4;2021-12-18;48;29;2;0;30;1078221;5217;568;3;2240
FR;4;2021-12-19;15;4;1;0;4;1078236;5221;569;3;2244
FR;4;2021-12-20;37;38;10;0;41;1078273;5259;579;3;2285
FR;4;2021-12-21;26;30;15;0;36;1078299;5289;594;3;2321
FR;4;2021-12-22;36;36;10;0;37;1078335;5325;604;3;2358
FR;4;2021-12-23;39;43;8;0;47;1078374;5368;612;3;2405
FR;4;2021-12-24;23;26;10;0;30;1078397;5394;622;3;2435
FR;4;2021-12-25;6;3;3;0;4;1078403;5397;625;3;2439
FR;4;2021-12-26;4;3;1;0;2;1078407;5400;626;3;2441
FR;4;2021-12-27;27;41;8;0;42;1078434;5441;634;3;2483
FR;4;2021-12-28;24;28;7;0;29;1078458;5469;641;3;2512
FR;4;2021-12-29;48;25;10;0;29;1078506;5494;651;3;2541
FR;4;2021-12-30;41;16;12;0;19;1078547;5510;663;3;2560
FR;4;2021-12-31;18;5;8;0;10;1078565;5515;671;3;2570
FR;4;2022-01-01;5;4;4;0;6;1078570;5519;675;3;2576
FR;4;2022-01-02;40;4;15;0;18;1078610;5523;690;3;2594
FR;4;2022-01-03;38;52;20;1;57;1078648;5575;710;4;2651
FR;4;2022-01-04;31;26;13;0;29;1078679;5601;723;4;2680
FR;4;2022-01-05;46;21;16;0;22;1078725;5622;739;4;2702
FR;4;2022-01-06;45;20;22;0;34;1078770;5642;761;4;2736
FR;4;2022-01-07;28;19;15;0;19;1078798;5661;776;4;2755
FR;4;2022-01-08;8;5;10;0;12;1078806;5666;786;4;2767
FR;4;2022-01-09;17;2;2;0;3;1078823;5668;788;4;2770
FR;4;2022-01-10;40;22;17;0;34;1078863;5690;805;4;2804
FR;4;2022-01-11;23;30;12;0;34;1078886;5720;817;4;2838
FR;4;2022-01-12;31;21;12;0;22;1078917;5741;829;4;2860
FR;4;2022-01-13;48;19;26;0;36;1078965;5760;855;4;2896
FR;4;2022-01-14;23;28;13;0;31;1078988;5788;868;4;2927
FR;4;2022-01-15;10;6;7;0;11;1078998;5794;875;4;2938
FR;4;2022-01-16;9;9;11;0;19;1079007;5803;886;4;2957
FR;4;2022-01-17;23;18;12;0;24;1079030;5821;898;4;2981
FR;4;2022-01-18;16;13;8;0;18;1079046;5834;906;4;2999
FR;4;2022-01-19;29;23;9;0;30;1079075;5857;915;4;3029
FR;4;2022-01-20;31;34;11;0;37;1079106;5891;926;4;3066
FR;4;2022-01-21;9;12;18;1;15;1079115;5903;944;5;3081
FR;4;2022-01-22;30;9;2;0;9;1079145;5912;946;5;3090
FR;4;2022-01-23;6;2;4;0;6;1079151;5914;950;5;3096
FR;4;2022-01-24;14;21;8;0;27;1079165;5935;958;5;3123
FR;4;2022-01-25;20;30;8;1;34;1079185;5965;966;6;3157
FR;4;2022-01-26;19;15;6;1;16;1079204;5980;972;7;3173
FR;4;2022-01-27;19;18;6;0;22;1079223;5998;978;7;3195
FR;4;2022-01-28;12;23;7;0;25;1079235;6021;985;7;3220
FR;4;2022-01-29;16;6;4;0;9;1079251;6027;989;7;3229
FR;4;2022-01-30;16;2;1;0;3;1079267;6029;990;7;3232
FR;4;2022-01-31;19;27;6;0;29;1079286;6056;996;7;3261
FR;4;2022-02-01;9;19;11;0;19;1079295;6075;1007;7;3280
FR;4;2022-02-02;17;11;10;2;16;1079312;6086;1017;9;3296
FR;4;2022-02-03;12;22;9;0;25;1079324;6108;1026;9;3321
FR;4;2022-02-04;6;5;7;0;9;1079330;6113;1033;9;3330
FR;4;2022-02-05;6;14;1;0;13;1079336;6127;1034;9;3343
FR;4;2022-02-06;5;2;2;0;3;1079341;6129;1036;9;3346
FR;4;2022-02-07;13;19;7;0;19;1079354;6148;1043;9;3365
FR;4;2022-02-08;15;19;13;1;20;1079369;6167;1056;10;3385
FR;4;2022-02-09;15;11;7;0;14;1079384;6178;1063;10;3399
FR;4;2022-02-10;18;23;9;0;24;1079402;6201;1072;10;3423
FR;4;2022-02-11;18;14;8;0;19;1079420;6215;1080;10;3442
FR;4;2022-02-12;23;6;1;0;5;1079443;6221;1081;10;3447
FR;4;2022-02-13;7;3;3;0;6;1079450;6224;1084;10;3453
FR;4;2022-02-14;18;10;7;0;13;1079468;6234;1091;10;3466
FR;4;2022-02-15;16;7;1;0;7;1079484;6241;1092;10;3473
FR;4;2022-02-16;11;9;10;0;15;1079495;6250;1102;10;3488
FR;4;2022-02-17;10;4;4;0;6;1079505;6254;1106;10;3494
FR;4;2022-02-18;17;13;6;0;17;1079522;6267;1112;10;3511
FR;4;2022-02-19;16;2;2;0;4;1079538;6269;1114;10;3515
FR;4;2022-02-20;7;2;0;0;1;1079545;6271;1114;10;3516
FR;4;2022-02-21;22;3;3;0;4;1079567;6274;1117;10;3520
FR;4;2022-02-22;8;4;8;0;8;1079575;6278;1125;10;3528
FR;4;2022-02-23;16;6;9;0;9;1079591;6284;1134;10;3537
FR;4;2022-02-24;9;4;2;0;4;1079600;6288;1136;10;3541
FR;4;2022-02-25;15;5;7;0;6;1079615;6293;1143;10;3547
FR;4;2022-02-26;26;3;0;0;3;1079641;6296;1143;10;3550
FR;4;2022-02-27;9;0;1;0;1;1079650;6296;1144;10;3551
FR;4;2022-02-28;14;3;2;0;3;1079664;6299;1146;10;3554
FR;4;2022-03-01;6;2;7;0;3;1079670;6301;1153;10;3557
FR;4;2022-03-02;12;2;3;0;4;1079682;6303;1156;10;3561
FR;4;2022-03-03;16;5;1;0;4;1079698;6308;1157;10;3565
FR;4;2022-03-04;6;7;2;1;5;1079704;6315;1159;11;3570
FR;4;2022-03-05;9;2;0;0;2;1079713;6317;1159;11;3572
FR;4;2022-03-06;4;0;1;0;1;1079717;6317;1160;11;3573
FR;4;2022-03-07;10;4;1;0;3;1079727;6321;1161;11;3576
FR;4;2022-03-08;13;2;0;0;2;1079740;6323;1161;11;3578
FR;4;2022-03-09;8;3;2;0;4;1079748;6326;1163;11;3582
FR;4;2022-03-10;5;1;5;0;2;1079753;6327;1168;11;3584
FR;4;2022-03-11;8;2;5;0;1;1079761;6329;1173;11;3585
FR;4;2022-03-12;9;2;0;0;0;1079770;6331;1173;11;3585
FR;4;2022-03-13;5;1;1;0;2;1079775;6332;1174;11;3587
FR;4;2022-03-14;4;1;0;0;1;1079779;6333;1174;11;3588
FR;4;2022-03-15;5;3;1;0;1;1079784;6336;1175;11;3589
FR;4;2022-03-16;7;3;3;0;3;1079791;6339;1178;11;3592
FR;4;2022-03-17;2;4;1;0;5;1079793;6343;1179;11;3597
FR;4;2022-03-18;7;3;0;0;3;1079800;6346;1179;11;3600
FR;4;2022-03-19;1;1;0;0;1;1079801;6347;1179;11;3601
FR;4;2022-03-20;2;0;2;0;1;1079803;6347;1181;11;3602
FR;4;2022-03-21;5;3;0;0;3;1079808;6350;1181;11;3605
FR;4;2022-03-22;3;2;1;0;2;1079811;6352;1182;11;3607
FR;4;2022-03-23;6;4;4;0;7;1079817;6356;1186;11;3614
FR;4;2022-03-24;2;4;3;1;5;1079819;6360;1189;12;3619
FR;4;2022-03-25;3;1;2;0;1;1079822;6361;1191;12;3620
FR;4;2022-03-26;5;5;0;0;5;1079827;6366;1191;12;3625
FR;4;2022-03-27;1;0;1;0;0;1079828;6366;1192;12;3625
FR;4;2022-03-28;4;1;3;0;3;1079832;6367;1195;12;3628
FR;4;2022-03-29;7;0;4;1;0;1079839;6367;1199;13;3628
FR;4;2022-03-30;1;4;0;0;4;1079840;6371;1199;13;3632
FR;4;2022-03-31;1;3;1;1;3;1079841;6374;1200;14;3635
FR;4;2022-04-01;13;2;5;0;5;1079854;6376;1205;14;3640
FR;4;2022-04-02;4;4;0;0;3;1079858;6380;1205;14;3643
FR;4;2022-04-03;0;0;0;0;0;1079858;6380;1205;14;3643
FR;4;2022-04-04;3;3;3;0;3;1079861;6383;1208;14;3646
FR;4;2022-04-05;3;3;1;1;2;1079864;6386;1209;15;3648
FR;4;2022-04-06;3;0;0;0;0;1079867;6386;1209;15;3648
FR;4;2022-04-07;3;2;1;2;3;1079870;6388;1210;17;3651
FR;4;2022-04-08;4;1;1;0;1;1079874;6389;1211;17;3652
FR;4;2022-04-09;0;0;1;1;1;1079874;6389;1212;18;3653
FR;4;2022-04-10;1;2;0;0;2;1079875;6391;1212;18;3655
FR;4;2022-04-11;3;2;4;0;4;1079878;6393;1216;18;3659
FR;4;2022-04-12;3;1;4;0;2;1079881;6394;1220;18;3661
FR;4;2022-04-13;4;7;1;0;8;1079885;6401;1221;18;3669
FR;4;2022-04-14;5;3;1;1;3;1079890;6404;1222;19;3672
FR;4;2022-04-15;5;7;1;0;8;1079895;6411;1223;19;3680
FR;4;2022-04-16;1;0;0;0;0;1079896;6411;1223;19;3680
FR;4;2022-04-17;1;1;0;0;1;1079897;6412;1223;19;3681
FR;4;2022-04-18;1;2;4;0;2;1079898;6414;1227;19;3683
FR;4;2022-04-19;2;0;1;0;0;1079900;6414;1228;19;3683
FR;4;2022-04-20;13;4;1;0;3;1079913;6418;1229;19;3686
FR;4;2022-04-21;5;1;0;0;1;1079918;6419;1229;19;3687
FR;4;2022-04-22;1;0;1;0;0;1079919;6419;1230;19;3687
FR;4;2022-04-23;1;3;2;0;5;1079920;6422;1232;19;3692
FR;4;2022-04-24;0;2;0;0;2;1079920;6424;1232;19;3694
FR;4;2022-04-25;3;4;3;0;7;1079923;6428;1235;19;3701
FR;4;2022-04-26;3;4;1;0;4;1079926;6432;1236;19;3705
FR;4;2022-04-27;4;0;0;0;0;1079930;6432;1236;19;3705
FR;4;2022-04-28;2;5;5;0;6;1079932;6437;1241;19;3711
FR;4;2022-04-29;3;2;0;0;1;1079935;6439;1241;19;3712
FR;4;2022-04-30;0;1;1;0;2;1079935;6440;1242;19;3714
FR;4;2022-05-01;0;0;0;0;0;1079935;6440;1242;19;3714
FR;4;2022-05-02;4;8;6;0;11;1079939;6448;1248;19;3725
FR;4;2022-05-03;0;3;1;0;3;1079939;6451;1249;19;3728
FR;4;2022-05-04;4;4;1;0;4;1079943;6455;1250;19;3732
FR;4;2022-05-05;2;1;1;0;1;1079945;6456;1251;19;3733
FR;4;2022-05-06;2;1;1;0;1;1079947;6457;1252;19;3734
FR;4;2022-05-07;0;0;0;0;0;1079947;6457;1252;19;3734
FR;4;2022-05-08;1;1;0;0;1;1079948;6458;1252;19;3735
FR;4;2022-05-09;5;0;0;0;0;1079953;6458;1252;19;3735
FR;4;2022-05-10;0;1;0;2;3;1079953;6459;1252;21;3738
FR;4;2022-05-11;2;2;0;0;2;1079955;6461;1252;21;3740
FR;4;2022-05-12;5;1;1;1;2;1079960;6462;1253;22;3742
FR;4;2022-05-13;0;0;2;0;2;1079960;6462;1255;22;3744
FR;4;2022-05-14;0;2;0;0;2;1079960;6464;1255;22;3746
FR;4;2022-05-15;1;2;0;0;0;1079961;6466;1255;22;3746
FR;4;2022-05-16;5;2;1;0;2;1079966;6468;1256;22;3748
FR;4;2022-05-17;3;1;1;0;2;1079969;6469;1257;22;3750
FR;4;2022-05-18;0;2;0;0;2;1079969;6471;1257;22;3752
FR;4;2022-05-19;2;1;2;0;2;1079971;6472;1259;22;3754
FR;4;2022-05-20;2;0;3;0;0;1079973;6472;1262;22;3754
FR;4;2022-05-21;2;0;1;0;1;1079975;6472;1263;22;3755
FR;4;2022-05-22;0;0;1;0;1;1079975;6472;1264;22;3756
FR;4;2022-05-23;0;0;2;0;0;1079975;6472;1266;22;3756
FR;4;2022-05-24;1;1;0;0;1;1079976;6473;1266;22;3757
FR;4;2022-05-25;1;2;0;0;0;1079977;6475;1266;22;3757
FR;4;2022-05-26;1;0;0;0;0;1079978;6475;1266;22;3757
FR;4;2022-05-27;0;0;0;0;0;1079978;6475;1266;22;3757
FR;4;2022-05-28;1;0;0;0;0;1079979;6475;1266;22;3757
FR;4;2022-05-29;0;0;0;0;0;1079979;6475;1266;22;3757
FR;4;2022-05-30;2;0;2;0;1;1079981;6475;1268;22;3758
FR;4;2022-05-31;2;0;0;0;0;1079983;6475;1268;22;3758
FR;4;2022-06-01;0;5;0;0;5;1079983;6480;1268;22;3763
FR;4;2022-06-02;1;0;0;0;0;1079984;6480;1268;22;3763
FR;4;2022-06-03;0;3;1;1;3;1079984;6483;1269;23;3766
FR;4;2022-06-04;0;1;0;0;1;1079984;6484;1269;23;3767
FR;4;2022-06-05;0;0;0;0;0;1079984;6484;1269;23;3767
FR;4;2022-06-06;1;0;0;0;0;1079985;6484;1269;23;3767
FR;4;2022-06-07;2;0;0;0;0;1079987;6484;1269;23;3767
FR;4;2022-06-08;0;2;0;0;2;1079987;6486;1269;23;3769
FR;4;2022-06-09;1;0;0;0;0;1079988;6486;1269;23;3769
FR;4;2022-06-10;0;0;2;0;1;1079988;6486;1271;23;3770
FR;4;2022-06-11;0;0;0;0;0;1079988;6486;1271;23;3770
FR;4;2022-06-12;1;0;0;0;0;1079989;6486;1271;23;3770
FR;4;2022-06-13;1;0;1;0;1;1079990;6486;1272;23;3771
FR;4;2022-06-14;3;2;0;0;2;1079993;6488;1272;23;3773
FR;4;2022-06-15;2;0;0;0;0;1079995;6488;1272;23;3773
FR;5;2020-12-27;0;0;0;0;0;0;0;0;0;0
FR;5;2020-12-28;0;0;0;0;0;0;0;0;0;0
FR;5;2020-12-29;0;0;0;0;0;0;0;0;0;0
FR;5;2020-12-30;0;0;0;0;0;0;0;0;0;0
FR;5;2020-12-31;0;0;0;0;0;0;0;0;0;0
FR;5;2021-01-01;0;0;0;0;0;0;0;0;0;0
FR;5;2021-01-02;0;0;0;0;0;0;0;0;0;0
FR;5;2021-01-03;0;0;0;0;0;0;0;0;0;0
FR;5;2021-01-04;0;0;0;0;0;0;0;0;0;0
FR;5;2021-01-05;0;0;0;0;0;0;0;0;0;0
FR;5;2021-01-06;0;0;0;0;0;0;0;0;0;0
FR;5;2021-01-07;0;0;0;0;0;0;0;0;0;0
FR;5;2021-01-08;0;0;0;0;0;0;0;0;0;0
FR;5;2021-01-09;0;0;0;0;0;0;0;0;0;0
FR;5;2021-01-10;0;0;0;0;0;0;0;0;0;0
FR;5;2021-01-11;0;0;0;0;0;0;0;0;0;0
FR;5;2021-01-12;0;0;0;0;0;0;0;0;0;0
FR;5;2021-01-13;0;0;0;0;0;0;0;0;0;0
FR;5;2021-01-14;0;0;0;0;0;0;0;0;0;0
FR;5;2021-01-15;0;0;0;0;0;0;0;0;0;0
FR;5;2021-01-16;0;0;0;0;0;0;0;0;0;0
FR;5;2021-01-17;0;0;0;0;0;0;0;0;0;0
FR;5;2021-01-18;0;0;0;0;0;0;0;0;0;0
FR;5;2021-01-19;0;0;0;0;0;0;0;0;0;0
FR;5;2021-01-20;0;0;0;0;0;0;0;0;0;0
FR;5;2021-01-21;0;0;0;0;0;0;0;0;0;0
FR;5;2021-01-22;0;0;0;0;0;0;0;0;0;0
FR;5;2021-01-23;0;0;0;0;0;0;0;0;0;0
FR;5;2021-01-24;0;0;0;0;0;0;0;0;0;0
FR;5;2021-01-25;0;0;0;0;0;0;0;0;0;0
FR;5;2021-01-26;0;0;0;0;0;0;0;0;0;0
FR;5;2021-01-27;0;0;0;0;0;0;0;0;0;0
FR;5;2021-01-28;0;0;0;0;0;0;0;0;0;0
FR;5;2021-01-29;0;0;0;0;0;0;0;0;0;0
FR;5;2021-01-30;0;0;0;0;0;0;0;0;0;0
FR;5;2021-01-31;0;0;0;0;0;0;0;0;0;0
FR;5;2021-02-01;0;0;0;0;0;0;0;0;0;0
FR;5;2021-02-02;0;0;0;0;0;0;0;0;0;0
FR;5;2021-02-03;0;0;0;0;0;0;0;0;0;0
FR;5;2021-02-04;0;0;0;0;0;0;0;0;0;0
FR;5;2021-02-05;0;0;0;0;0;0;0;0;0;0
FR;5;2021-02-06;0;0;0;0;0;0;0;0;0;0
FR;5;2021-02-07;0;0;0;0;0;0;0;0;0;0
FR;5;2021-02-08;0;0;0;0;0;0;0;0;0;0
FR;5;2021-02-09;0;0;0;0;0;0;0;0;0;0
FR;5;2021-02-10;0;0;0;0;0;0;0;0;0;0
FR;5;2021-02-11;0;0;0;0;0;0;0;0;0;0
FR;5;2021-02-12;0;0;0;0;0;0;0;0;0;0
FR;5;2021-02-13;0;0;0;0;0;0;0;0;0;0
FR;5;2021-02-14;0;0;0;0;0;0;0;0;0;0
FR;5;2021-02-15;0;0;0;0;0;0;0;0;0;0
FR;5;2021-02-16;0;0;0;0;0;0;0;0;0;0
FR;5;2021-02-17;0;0;0;0;0;0;0;0;0;0
FR;5;2021-02-18;0;0;0;0;0;0;0;0;0;0
FR;5;2021-02-19;0;0;0;0;0;0;0;0;0;0
FR;5;2021-02-20;0;0;0;0;0;0;0;0;0;0
FR;5;2021-02-21;0;0;0;0;0;0;0;0;0;0
FR;5;2021-02-22;0;0;0;0;0;0;0;0;0;0
FR;5;2021-02-23;0;0;0;0;0;0;0;0;0;0
FR;5;2021-02-24;0;0;0;0;0;0;0;0;0;0
FR;5;2021-02-25;0;0;0;0;0;0;0;0;0;0
FR;5;2021-02-26;0;0;0;0;0;0;0;0;0;0
FR;5;2021-02-27;0;0;0;0;0;0;0;0;0;0
FR;5;2021-02-28;0;0;0;0;0;0;0;0;0;0
FR;5;2021-03-01;0;0;0;0;0;0;0;0;0;0
FR;5;2021-03-02;0;0;0;0;0;0;0;0;0;0
FR;5;2021-03-03;0;0;0;0;0;0;0;0;0;0
FR;5;2021-03-04;0;0;0;0;0;0;0;0;0;0
FR;5;2021-03-05;0;0;0;0;0;0;0;0;0;0
FR;5;2021-03-06;0;0;0;0;0;0;0;0;0;0
FR;5;2021-03-07;0;0;0;0;0;0;0;0;0;0
FR;5;2021-03-08;0;0;0;0;0;0;0;0;0;0
FR;5;2021-03-09;0;0;0;0;0;0;0;0;0;0
FR;5;2021-03-10;0;0;0;0;0;0;0;0;0;0
FR;5;2021-03-11;0;0;0;0;0;0;0;0;0;0
FR;5;2021-03-12;0;0;0;0;0;0;0;0;0;0
FR;5;2021-03-13;0;0;0;0;0;0;0;0;0;0
FR;5;2021-03-14;0;0;0;0;0;0;0;0;0;0
FR;5;2021-03-15;0;0;0;0;0;0;0;0;0;0
FR;5;2021-03-16;0;0;0;0;0;0;0;0;0;0
FR;5;2021-03-17;0;0;0;0;0;0;0;0;0;0
FR;5;2021-03-18;0;0;0;0;0;0;0;0;0;0
FR;5;2021-03-19;0;0;0;0;0;0;0;0;0;0
FR;5;2021-03-20;0;0;0;0;0;0;0;0;0;0
FR;5;2021-03-21;0;0;0;0;0;0;0;0;0;0
FR;5;2021-03-22;0;0;0;0;0;0;0;0;0;0
FR;5;2021-03-23;0;0;0;0;0;0;0;0;0;0
FR;5;2021-03-24;0;0;0;0;0;0;0;0;0;0
FR;5;2021-03-25;0;0;0;0;0;0;0;0;0;0
FR;5;2021-03-26;0;0;0;0;0;0;0;0;0;0
FR;5;2021-03-27;0;0;0;0;0;0;0;0;0;0
FR;5;2021-03-28;0;0;0;0;0;0;0;0;0;0
FR;5;2021-03-29;0;0;0;0;0;0;0;0;0;0
FR;5;2021-03-30;0;0;0;0;0;0;0;0;0;0
FR;5;2021-03-31;0;0;0;0;0;0;0;0;0;0
FR;5;2021-04-01;0;0;0;0;0;0;0;0;0;0
FR;5;2021-04-02;0;0;0;0;0;0;0;0;0;0
FR;5;2021-04-03;0;0;0;0;0;0;0;0;0;0
FR;5;2021-04-04;0;0;0;0;0;0;0;0;0;0
FR;5;2021-04-05;0;0;0;0;0;0;0;0;0;0
FR;5;2021-04-06;0;0;0;0;0;0;0;0;0;0
FR;5;2021-04-07;0;0;0;0;0;0;0;0;0;0
FR;5;2021-04-08;0;0;0;0;0;0;0;0;0;0
FR;5;2021-04-09;0;0;0;0;0;0;0;0;0;0
FR;5;2021-04-10;0;0;0;0;0;0;0;0;0;0
FR;5;2021-04-11;0;0;0;0;0;0;0;0;0;0
FR;5;2021-04-12;0;0;0;0;0;0;0;0;0;0
FR;5;2021-04-13;0;0;0;0;0;0;0;0;0;0
FR;5;2021-04-14;0;0;0;0;0;0;0;0;0;0
FR;5;2021-04-15;0;0;0;0;0;0;0;0;0;0
FR;5;2021-04-16;0;0;0;0;0;0;0;0;0;0
FR;5;2021-04-17;0;0;0;0;0;0;0;0;0;0
FR;5;2021-04-18;0;0;0;0;0;0;0;0;0;0
FR;5;2021-04-19;0;0;0;0;0;0;0;0;0;0
FR;5;2021-04-20;0;0;0;0;0;0;0;0;0;0
FR;5;2021-04-21;0;0;0;0;0;0;0;0;0;0
FR;5;2021-04-22;0;0;0;0;0;0;0;0;0;0
FR;5;2021-04-23;0;0;0;0;0;0;0;0;0;0
FR;5;2021-04-24;0;0;0;0;0;0;0;0;0;0
FR;5;2021-04-25;0;0;0;0;0;0;0;0;0;0
FR;5;2021-04-26;0;0;0;0;0;0;0;0;0;0
FR;5;2021-04-27;0;0;0;0;0;0;0;0;0;0
FR;5;2021-04-28;0;0;0;0;0;0;0;0;0;0
FR;5;2021-04-29;0;0;0;0;0;0;0;0;0;0
FR;5;2021-04-30;0;0;0;0;0;0;0;0;0;0
FR;5;2021-05-01;0;0;0;0;0;0;0;0;0;0
FR;5;2021-05-02;0;0;0;0;0;0;0;0;0;0
FR;5;2021-05-03;0;0;0;0;0;0;0;0;0;0
FR;5;2021-05-04;0;0;0;0;0;0;0;0;0;0
FR;5;2021-05-05;0;0;0;0;0;0;0;0;0;0
FR;5;2021-05-06;0;0;0;0;0;0;0;0;0;0
FR;5;2021-05-07;0;0;0;0;0;0;0;0;0;0
FR;5;2021-05-08;0;0;0;0;0;0;0;0;0;0
FR;5;2021-05-09;0;0;0;0;0;0;0;0;0;0
FR;5;2021-05-10;0;0;0;0;0;0;0;0;0;0
FR;5;2021-05-11;0;0;0;0;0;0;0;0;0;0
FR;5;2021-05-12;0;0;0;0;0;0;0;0;0;0
FR;5;2021-05-13;0;0;0;0;0;0;0;0;0;0
FR;5;2021-05-14;0;0;0;0;0;0;0;0;0;0
FR;5;2021-05-15;0;0;0;0;0;0;0;0;0;0
FR;5;2021-05-16;0;0;0;0;0;0;0;0;0;0
FR;5;2021-05-17;0;0;0;0;0;0;0;0;0;0
FR;5;2021-05-18;0;0;0;0;0;0;0;0;0;0
FR;5;2021-05-19;0;0;0;0;0;0;0;0;0;0
FR;5;2021-05-20;0;0;0;0;0;0;0;0;0;0
FR;5;2021-05-21;0;0;0;0;0;0;0;0;0;0
FR;5;2021-05-22;0;0;0;0;0;0;0;0;0;0
FR;5;2021-05-23;0;0;0;0;0;0;0;0;0;0
FR;5;2021-05-24;0;0;0;0;0;0;0;0;0;0
FR;5;2021-05-25;0;0;0;0;0;0;0;0;0;0
FR;5;2021-05-26;0;0;0;0;0;0;0;0;0;0
FR;5;2021-05-27;0;0;0;0;0;0;0;0;0;0
FR;5;2021-05-28;0;0;0;0;0;0;0;0;0;0
FR;5;2021-05-29;0;0;0;0;0;0;0;0;0;0
FR;5;2021-05-30;0;0;0;0;0;0;0;0;0;0
FR;5;2021-05-31;0;0;0;0;0;0;0;0;0;0
FR;5;2021-06-01;0;0;0;0;0;0;0;0;0;0
FR;5;2021-06-02;0;0;0;0;0;0;0;0;0;0
FR;5;2021-06-03;0;0;0;0;0;0;0;0;0;0
FR;5;2021-06-04;0;0;0;0;0;0;0;0;0;0
FR;5;2021-06-05;0;0;0;0;0;0;0;0;0;0
FR;5;2021-06-06;0;0;0;0;0;0;0;0;0;0
FR;5;2021-06-07;0;0;0;0;0;0;0;0;0;0
FR;5;2021-06-08;0;0;0;0;0;0;0;0;0;0
FR;5;2021-06-09;0;0;0;0;0;0;0;0;0;0
FR;5;2021-06-10;0;0;0;0;0;0;0;0;0;0
FR;5;2021-06-11;0;0;0;0;0;0;0;0;0;0
FR;5;2021-06-12;0;0;0;0;0;0;0;0;0;0
FR;5;2021-06-13;0;0;0;0;0;0;0;0;0;0
FR;5;2021-06-14;0;0;0;0;0;0;0;0;0;0
FR;5;2021-06-15;0;0;0;0;0;0;0;0;0;0
FR;5;2021-06-16;0;0;0;0;0;0;0;0;0;0
FR;5;2021-06-17;0;0;0;0;0;0;0;0;0;0
FR;5;2021-06-18;0;0;0;0;0;0;0;0;0;0
FR;5;2021-06-19;0;0;0;0;0;0;0;0;0;0
FR;5;2021-06-20;0;0;0;0;0;0;0;0;0;0
FR;5;2021-06-21;0;0;0;0;0;0;0;0;0;0
FR;5;2021-06-22;0;0;0;0;0;0;0;0;0;0
FR;5;2021-06-23;0;0;0;0;0;0;0;0;0;0
FR;5;2021-06-24;0;0;0;0;0;0;0;0;0;0
FR;5;2021-06-25;0;0;0;0;0;0;0;0;0;0
FR;5;2021-06-26;0;0;0;0;0;0;0;0;0;0
FR;5;2021-06-27;0;0;0;0;0;0;0;0;0;0
FR;5;2021-06-28;0;0;0;0;0;0;0;0;0;0
FR;5;2021-06-29;0;0;0;0;0;0;0;0;0;0
FR;5;2021-06-30;0;0;0;0;0;0;0;0;0;0
FR;5;2021-07-01;0;0;0;0;0;0;0;0;0;0
FR;5;2021-07-02;0;0;0;0;0;0;0;0;0;0
FR;5;2021-07-03;0;0;0;0;0;0;0;0;0;0
FR;5;2021-07-04;0;0;0;0;0;0;0;0;0;0
FR;5;2021-07-05;0;0;0;0;0;0;0;0;0;0
FR;5;2021-07-06;0;0;0;0;0;0;0;0;0;0
FR;5;2021-07-07;0;0;0;0;0;0;0;0;0;0
FR;5;2021-07-08;0;0;0;0;0;0;0;0;0;0
FR;5;2021-07-09;0;0;0;0;0;0;0;0;0;0
FR;5;2021-07-10;0;0;0;0;0;0;0;0;0;0
FR;5;2021-07-11;0;0;0;0;0;0;0;0;0;0
FR;5;2021-07-12;0;0;0;0;0;0;0;0;0;0
FR;5;2021-07-13;0;0;0;0;0;0;0;0;0;0
FR;5;2021-07-14;0;0;0;0;0;0;0;0;0;0
FR;5;2021-07-15;0;0;0;0;0;0;0;0;0;0
FR;5;2021-07-16;0;0;0;0;0;0;0;0;0;0
FR;5;2021-07-17;0;0;0;0;0;0;0;0;0;0
FR;5;2021-07-18;0;0;0;0;0;0;0;0;0;0
FR;5;2021-07-19;0;0;0;0;0;0;0;0;0;0
FR;5;2021-07-20;0;0;0;0;0;0;0;0;0;0
FR;5;2021-07-21;0;0;0;0;0;0;0;0;0;0
FR;5;2021-07-22;0;0;0;0;0;0;0;0;0;0
FR;5;2021-07-23;0;0;0;0;0;0;0;0;0;0
FR;5;2021-07-24;0;0;0;0;0;0;0;0;0;0
FR;5;2021-07-25;0;0;0;0;0;0;0;0;0;0
FR;5;2021-07-26;0;0;0;0;0;0;0;0;0;0
FR;5;2021-07-27;0;0;0;0;0;0;0;0;0;0
FR;5;2021-07-28;0;0;0;0;0;0;0;0;0;0
FR;5;2021-07-29;0;0;0;0;0;0;0;0;0;0
FR;5;2021-07-30;0;0;0;0;0;0;0;0;0;0
FR;5;2021-07-31;0;0;0;0;0;0;0;0;0;0
FR;5;2021-08-01;0;0;0;0;0;0;0;0;0;0
FR;5;2021-08-02;0;0;0;0;0;0;0;0;0;0
FR;5;2021-08-03;0;0;0;0;0;0;0;0;0;0
FR;5;2021-08-04;0;0;0;0;0;0;0;0;0;0
FR;5;2021-08-05;0;0;0;0;0;0;0;0;0;0
FR;5;2021-08-06;0;0;0;0;0;0;0;0;0;0
FR;5;2021-08-07;0;0;0;0;0;0;0;0;0;0
FR;5;2021-08-08;0;0;0;0;0;0;0;0;0;0
FR;5;2021-08-09;0;0;0;0;0;0;0;0;0;0
FR;5;2021-08-10;0;0;0;0;0;0;0;0;0;0
FR;5;2021-08-11;0;0;0;0;0;0;0;0;0;0
FR;5;2021-08-12;0;0;0;0;0;0;0;0;0;0
FR;5;2021-08-13;0;0;0;0;0;0;0;0;0;0
FR;5;2021-08-14;0;0;0;0;0;0;0;0;0;0
FR;5;2021-08-15;0;0;0;0;0;0;0;0;0;0
FR;5;2021-08-16;0;0;0;0;0;0;0;0;0;0
FR;5;2021-08-17;0;0;0;0;0;0;0;0;0;0
FR;5;2021-08-18;0;0;0;0;0;0;0;0;0;0
FR;5;2021-08-19;0;0;0;0;0;0;0;0;0;0
FR;5;2021-08-20;0;0;0;0;0;0;0;0;0;0
FR;5;2021-08-21;0;0;0;0;0;0;0;0;0;0
FR;5;2021-08-22;0;0;0;0;0;0;0;0;0;0
FR;5;2021-08-23;0;0;0;0;0;0;0;0;0;0
FR;5;2021-08-24;0;0;0;0;0;0;0;0;0;0
FR;5;2021-08-25;0;0;0;0;0;0;0;0;0;0
FR;5;2021-08-26;0;0;0;0;0;0;0;0;0;0
FR;5;2021-08-27;0;0;0;0;0;0;0;0;0;0
FR;5;2021-08-28;0;0;0;0;0;0;0;0;0;0
FR;5;2021-08-29;0;0;0;0;0;0;0;0;0;0
FR;5;2021-08-30;0;0;0;0;0;0;0;0;0;0
FR;5;2021-08-31;0;0;0;0;0;0;0;0;0;0
FR;5;2021-09-01;0;0;0;0;0;0;0;0;0;0
FR;5;2021-09-02;0;0;0;0;0;0;0;0;0;0
FR;5;2021-09-03;0;0;0;0;0;0;0;0;0;0
FR;5;2021-09-04;0;0;0;0;0;0;0;0;0;0
FR;5;2021-09-05;0;0;0;0;0;0;0;0;0;0
FR;5;2021-09-06;0;0;0;0;0;0;0;0;0;0
FR;5;2021-09-07;0;0;0;0;0;0;0;0;0;0
FR;5;2021-09-08;0;0;0;0;0;0;0;0;0;0
FR;5;2021-09-09;0;0;0;0;0;0;0;0;0;0
FR;5;2021-09-10;0;0;0;0;0;0;0;0;0;0
FR;5;2021-09-11;0;0;0;0;0;0;0;0;0;0
FR;5;2021-09-12;0;0;0;0;0;0;0;0;0;0
FR;5;2021-09-13;0;0;0;0;0;0;0;0;0;0
FR;5;2021-09-14;0;0;0;0;0;0;0;0;0;0
FR;5;2021-09-15;0;0;0;0;0;0;0;0;0;0
FR;5;2021-09-16;0;0;0;0;0;0;0;0;0;0
FR;5;2021-09-17;0;0;0;0;0;0;0;0;0;0
FR;5;2021-09-18;0;0;0;0;0;0;0;0;0;0
FR;5;2021-09-19;0;0;0;0;0;0;0;0;0;0
FR;5;2021-09-20;0;0;0;0;0;0;0;0;0;0
FR;5;2021-09-21;0;0;0;0;0;0;0;0;0;0
FR;5;2021-09-22;0;0;0;0;0;0;0;0;0;0
FR;5;2021-09-23;0;0;0;0;0;0;0;0;0;0
FR;5;2021-09-24;0;0;0;0;0;0;0;0;0;0
FR;5;2021-09-25;0;0;0;0;0;0;0;0;0;0
FR;5;2021-09-26;0;0;0;0;0;0;0;0;0;0
FR;5;2021-09-27;0;0;0;0;0;0;0;0;0;0
FR;5;2021-09-28;0;0;0;0;0;0;0;0;0;0
FR;5;2021-09-29;0;0;0;0;0;0;0;0;0;0
FR;5;2021-09-30;0;0;0;0;0;0;0;0;0;0
FR;5;2021-10-01;0;0;0;0;0;0;0;0;0;0
FR;5;2021-10-02;0;0;0;0;0;0;0;0;0;0
FR;5;2021-10-03;0;0;0;0;0;0;0;0;0;0
FR;5;2021-10-04;0;0;0;0;0;0;0;0;0;0
FR;5;2021-10-05;0;0;0;0;0;0;0;0;0;0
FR;5;2021-10-06;0;0;0;0;0;0;0;0;0;0
FR;5;2021-10-07;0;0;0;0;0;0;0;0;0;0
FR;5;2021-10-08;0;0;0;0;0;0;0;0;0;0
FR;5;2021-10-09;0;0;0;0;0;0;0;0;0;0
FR;5;2021-10-10;0;0;0;0;0;0;0;0;0;0
FR;5;2021-10-11;0;0;0;0;0;0;0;0;0;0
FR;5;2021-10-12;0;0;0;0;0;0;0;0;0;0
FR;5;2021-10-13;0;0;0;0;0;0;0;0;0;0
FR;5;2021-10-14;0;0;0;0;0;0;0;0;0;0
FR;5;2021-10-15;0;0;0;0;0;0;0;0;0;0
FR;5;2021-10-16;0;0;0;0;0;0;0;0;0;0
FR;5;2021-10-17;0;0;0;0;0;0;0;0;0;0
FR;5;2021-10-18;0;0;0;0;0;0;0;0;0;0
FR;5;2021-10-19;0;0;0;0;0;0;0;0;0;0
FR;5;2021-10-20;0;0;0;0;0;0;0;0;0;0
FR;5;2021-10-21;0;0;0;0;0;0;0;0;0;0
FR;5;2021-10-22;0;0;0;0;0;0;0;0;0;0
FR;5;2021-10-23;0;0;0;0;0;0;0;0;0;0
FR;5;2021-10-24;0;0;0;0;0;0;0;0;0;0
FR;5;2021-10-25;0;0;0;0;0;0;0;0;0;0
FR;5;2021-10-26;0;0;0;0;0;0;0;0;0;0
FR;5;2021-10-27;0;0;0;0;0;0;0;0;0;0
FR;5;2021-10-28;0;0;0;0;0;0;0;0;0;0
FR;5;2021-10-29;0;0;0;0;0;0;0;0;0;0
FR;5;2021-10-30;0;0;0;0;0;0;0;0;0;0
FR;5;2021-10-31;0;0;0;0;0;0;0;0;0;0
FR;5;2021-11-01;0;0;0;0;0;0;0;0;0;0
FR;5;2021-11-02;0;0;0;0;0;0;0;0;0;0
FR;5;2021-11-03;0;0;0;0;0;0;0;0;0;0
FR;5;2021-11-04;0;0;0;0;0;0;0;0;0;0
FR;5;2021-11-05;0;0;0;0;0;0;0;0;0;0
FR;5;2021-11-06;0;0;0;0;0;0;0;0;0;0
FR;5;2021-11-07;0;0;0;0;0;0;0;0;0;0
FR;5;2021-11-08;0;0;0;0;0;0;0;0;0;0
FR;5;2021-11-09;0;0;0;0;0;0;0;0;0;0
FR;5;2021-11-10;0;0;0;0;0;0;0;0;0;0
FR;5;2021-11-11;0;0;0;0;0;0;0;0;0;0
FR;5;2021-11-12;0;0;0;0;0;0;0;0;0;0
FR;5;2021-11-13;0;0;0;0;0;0;0;0;0;0
FR;5;2021-11-14;0;0;0;0;0;0;0;0;0;0
FR;5;2021-11-15;0;0;0;0;0;0;0;0;0;0
FR;5;2021-11-16;0;0;0;0;0;0;0;0;0;0
FR;5;2021-11-17;0;0;0;0;0;0;0;0;0;0
FR;5;2021-11-18;0;0;0;0;0;0;0;0;0;0
FR;5;2021-11-19;0;0;0;0;0;0;0;0;0;0
FR;5;2021-11-20;0;0;0;0;0;0;0;0;0;0
FR;5;2021-11-21;0;0;0;0;0;0;0;0;0;0
FR;5;2021-11-22;0;0;0;0;0;0;0;0;0;0
FR;5;2021-11-23;0;0;0;0;0;0;0;0;0;0
FR;5;2021-11-24;0;0;0;0;0;0;0;0;0;0
FR;5;2021-11-25;0;0;0;0;0;0;0;0;0;0
FR;5;2021-11-26;0;0;0;0;0;0;0;0;0;0
FR;5;2021-11-27;0;0;0;0;0;0;0;0;0;0
FR;5;2021-11-28;0;0;0;0;0;0;0;0;0;0
FR;5;2021-11-29;0;0;0;0;0;0;0;0;0;0
FR;5;2021-11-30;0;0;0;0;0;0;0;0;0;0
FR;5;2021-12-01;0;0;0;0;0;0;0;0;0;0
FR;5;2021-12-02;0;0;0;0;0;0;0;0;0;0
FR;5;2021-12-03;0;0;0;0;0;0;0;0;0;0
FR;5;2021-12-04;0;0;0;0;0;0;0;0;0;0
FR;5;2021-12-05;0;0;0;0;0;0;0;0;0;0
FR;5;2021-12-06;0;0;0;0;0;0;0;0;0;0
FR;5;2021-12-07;0;0;0;0;0;0;0;0;0;0
FR;5;2021-12-08;0;0;0;0;0;0;0;0;0;0
FR;5;2021-12-09;0;0;0;0;0;0;0;0;0;0
FR;5;2021-12-10;0;0;0;0;0;0;0;0;0;0
FR;5;2021-12-11;0;0;0;0;0;0;0;0;0;0
FR;5;2021-12-12;0;0;0;0;0;0;0;0;0;0
FR;5;2021-12-13;0;0;0;0;0;0;0;0;0;0
FR;5;2021-12-14;29;45;77;0;88;29;45;77;0;88
FR;5;2021-12-15;196;44;37;0;49;225;89;114;0;137
FR;5;2021-12-16;180;21;44;0;48;405;110;158;0;185
FR;5;2021-12-17;310;16;72;0;74;715;126;230;0;259
FR;5;2021-12-18;765;24;22;0;29;1480;150;252;0;288
FR;5;2021-12-19;586;15;15;0;17;2066;165;267;0;305
FR;5;2021-12-20;1223;31;35;0;38;3289;196;302;0;343
FR;5;2021-12-21;1536;22;54;1;60;4825;218;356;1;403
FR;5;2021-12-22;4069;40;37;0;46;8894;258;393;1;449
FR;5;2021-12-23;3042;16;21;0;25;11936;274;414;1;474
FR;5;2021-12-24;759;18;9;0;15;12695;292;423;1;489
FR;5;2021-12-25;61;5;1;0;2;12756;297;424;1;491
FR;5;2021-12-26;623;6;3;0;4;13379;303;427;1;495
FR;5;2021-12-27;4080;25;21;0;23;17459;328;448;1;518
FR;5;2021-12-28;5202;23;41;1;43;22661;351;489;2;561
FR;5;2021-12-29;8104;34;66;2;69;30765;385;555;4;630
FR;5;2021-12-30;5173;18;33;0;39;35938;403;588;4;669
FR;5;2021-12-31;1553;8;10;0;11;37491;411;598;4;680
FR;5;2022-01-01;185;2;2;0;3;37676;413;600;4;683
FR;5;2022-01-02;1489;1;1;0;1;39165;414;601;4;684
FR;5;2022-01-03;3059;36;33;0;32;42224;450;634;4;716
FR;5;2022-01-04;3034;39;33;0;42;45258;489;667;4;758
FR;5;2022-01-05;19323;203;97;1;108;64581;692;764;5;866
FR;5;2022-01-06;3742;133;122;0;142;68323;825;886;5;1008
FR;5;2022-01-07;5007;200;48;2;56;73330;1025;934;7;1064
FR;5;2022-01-08;13658;514;45;0;52;86988;1539;979;7;1116
FR;5;2022-01-09;5755;399;15;0;20;92743;1938;994;7;1136
FR;5;2022-01-10;3453;326;25;0;29;96196;2264;1019;7;1165
FR;5;2022-01-11;3668;284;38;0;41;99864;2548;1057;7;1206
FR;5;2022-01-12;22653;3003;90;0;113;122517;5551;1147;7;1319
FR;5;2022-01-13;4035;622;30;0;32;126552;6173;1177;7;1351
FR;5;2022-01-14;4843;581;44;0;51;131395;6754;1221;7;1402
FR;5;2022-01-15;14681;1746;38;3;49;146076;8500;1259;10;1451
FR;5;2022-01-16;4727;666;3;0;5;150803;9166;1262;10;1456
FR;5;2022-01-17;2294;715;26;0;29;153097;9881;1288;10;1485
FR;5;2022-01-18;2430;870;30;0;40;155527;10751;1318;10;1525
FR;5;2022-01-19;18482;6422;74;2;142;174009;17173;1392;12;1667
FR;5;2022-01-20;1920;1067;25;0;34;175929;18240;1417;12;1701
FR;5;2022-01-21;3076;1371;47;1;59;179005;19611;1464;13;1760
FR;5;2022-01-22;10721;3454;33;1;43;189726;23065;1497;14;1803
FR;5;2022-01-23;2629;1415;5;0;9;192355;24480;1502;14;1812
FR;5;2022-01-24;1159;1340;19;0;23;193514;25820;1521;14;1835
FR;5;2022-01-25;1219;1548;19;2;29;194733;27368;1540;16;1864
FR;5;2022-01-26;10751;12025;50;1;89;205484;39393;1590;17;1953
FR;5;2022-01-27;1291;1693;10;0;17;206775;41086;1600;17;1970
FR;5;2022-01-28;1695;3347;16;0;19;208470;44433;1616;17;1989
FR;5;2022-01-29;6237;8040;68;0;96;214707;52473;1684;17;2085
FR;5;2022-01-30;1509;2950;5;0;18;216216;55423;1689;17;2103
FR;5;2022-01-31;588;1773;23;0;24;216804;57196;1712;17;2127
FR;5;2022-02-01;712;1703;10;0;15;217516;58899;1722;17;2142
FR;5;2022-02-02;6957;15654;52;0;94;224473;74553;1774;17;2236
FR;5;2022-02-03;490;1690;14;0;13;224963;76243;1788;17;2249
FR;5;2022-02-04;943;3001;19;0;31;225906;79244;1807;17;2280
FR;5;2022-02-05;3533;8916;23;0;37;229439;88160;1830;17;2317
FR;5;2022-02-06;737;2397;10;0;19;230176;90557;1840;17;2336
FR;5;2022-02-07;883;1595;22;0;24;231059;92152;1862;17;2360
FR;5;2022-02-08;722;1285;18;0;20;231781;93437;1880;17;2380
FR;5;2022-02-09;4536;12876;44;0;76;236317;106313;1924;17;2456
FR;5;2022-02-10;646;1059;14;0;15;236963;107372;1938;17;2471
FR;5;2022-02-11;793;2026;16;0;21;237756;109398;1954;17;2492
FR;5;2022-02-12;2285;6811;33;0;53;240041;116209;1987;17;2545
FR;5;2022-02-13;465;1540;8;0;8;240506;117749;1995;17;2553
FR;5;2022-02-14;678;1288;10;0;13;241184;119037;2005;17;2566
FR;5;2022-02-15;482;885;9;0;14;241666;119922;2014;17;2580
FR;5;2022-02-16;2980;9123;41;1;58;244646;129045;2055;18;2638
FR;5;2022-02-17;435;805;6;0;7;245081;129850;2061;18;2645
FR;5;2022-02-18;649;1407;13;0;17;245730;131257;2074;18;2662
FR;5;2022-02-19;1372;4315;16;0;28;247102;135572;2090;18;2690
FR;5;2022-02-20;247;879;6;0;8;247349;136451;2096;18;2698
FR;5;2022-02-21;221;607;2;0;4;247570;137058;2098;18;2702
FR;5;2022-02-22;260;545;17;0;17;247830;137603;2115;18;2719
FR;5;2022-02-23;1908;6924;22;1;42;249738;144527;2137;19;2761
FR;5;2022-02-24;182;374;6;1;7;249920;144901;2143;20;2768
FR;5;2022-02-25;336;949;13;0;12;250256;145850;2156;20;2780
FR;5;2022-02-26;972;3069;10;0;14;251228;148919;2166;20;2794
FR;5;2022-02-27;147;506;0;0;3;251375;149425;2166;20;2797
FR;5;2022-02-28;162;369;1;0;1;251537;149794;2167;20;2798
FR;5;2022-03-01;128;279;6;0;7;251665;150073;2173;20;2805
FR;5;2022-03-02;1240;4152;28;3;40;252905;154225;2201;23;2845
FR;5;2022-03-03;121;250;6;0;9;253026;154475;2207;23;2854
FR;5;2022-03-04;194;488;13;0;14;253220;154963;2220;23;2868
FR;5;2022-03-05;676;1990;8;0;16;253896;156953;2228;23;2884
FR;5;2022-03-06;108;260;0;0;0;254004;157213;2228;23;2884
FR;5;2022-03-07;71;228;5;0;3;254075;157441;2233;23;2887
FR;5;2022-03-08;46;130;7;1;7;254121;157571;2240;24;2894
FR;5;2022-03-09;909;3076;24;0;36;255030;160647;2264;24;2930
FR;5;2022-03-10;82;200;8;0;11;255112;160847;2272;24;2941
FR;5;2022-03-11;147;369;13;1;15;255259;161216;2285;25;2956
FR;5;2022-03-12;758;1613;13;1;30;256017;162829;2298;26;2986
FR;5;2022-03-13;76;100;0;0;0;256093;162929;2298;26;2986
FR;5;2022-03-14;67;118;7;1;7;256160;163047;2305;27;2993
FR;5;2022-03-15;83;99;3;0;6;256243;163146;2308;27;2999
FR;5;2022-03-16;883;1825;15;3;36;257126;164971;2323;30;3035
FR;5;2022-03-17;66;123;8;4;10;257192;165094;2331;34;3045
FR;5;2022-03-18;172;318;13;4;18;257364;165412;2344;38;3063
FR;5;2022-03-19;750;1162;12;5;33;258114;166574;2356;43;3096
FR;5;2022-03-20;45;93;1;0;1;258159;166667;2357;43;3097
FR;5;2022-03-21;71;120;10;6;15;258230;166787;2367;49;3112
FR;5;2022-03-22;56;119;8;8;9;258286;166906;2375;57;3121
FR;5;2022-03-23;804;1461;14;8;36;259090;168367;2389;65;3157
FR;5;2022-03-24;69;93;8;7;7;259159;168460;2397;72;3164
FR;5;2022-03-25;222;291;14;8;18;259381;168751;2411;80;3182
FR;5;2022-03-26;707;853;12;5;26;260088;169604;2423;85;3208
FR;5;2022-03-27;74;78;0;0;3;260162;169682;2423;85;3211
FR;5;2022-03-28;81;91;1;2;3;260243;169773;2424;87;3214
FR;5;2022-03-29;71;82;10;4;12;260314;169855;2434;91;3226
FR;5;2022-03-30;822;1115;16;13;29;261136;170970;2450;104;3255
FR;5;2022-03-31;102;124;1;4;6;261238;171094;2451;108;3261
FR;5;2022-04-01;107;86;7;12;11;261345;171180;2458;120;3272
FR;5;2022-04-02;329;349;3;3;15;261674;171529;2461;123;3287
FR;5;2022-04-03;54;59;1;0;1;261728;171588;2462;123;3288
FR;5;2022-04-04;38;57;4;1;8;261766;171645;2466;124;3296
FR;5;2022-04-05;51;60;6;7;9;261817;171705;2472;131;3305
FR;5;2022-04-06;421;439;7;15;16;262238;172144;2479;146;3321
FR;5;2022-04-07;45;68;5;7;7;262283;172212;2484;153;3328
FR;5;2022-04-08;133;110;12;14;15;262416;172322;2496;167;3343
FR;5;2022-04-09;308;323;2;5;17;262724;172645;2498;172;3360
FR;5;2022-04-10;43;31;2;0;2;262767;172676;2500;172;3362
FR;5;2022-04-11;50;60;3;2;4;262817;172736;2503;174;3366
FR;5;2022-04-12;57;54;3;3;5;262874;172790;2506;177;3371
FR;5;2022-04-13;382;413;3;8;16;263256;173203;2509;185;3387
FR;5;2022-04-14;47;48;5;5;9;263303;173251;2514;190;3396
FR;5;2022-04-15;91;109;3;5;5;263394;173360;2517;195;3401
FR;5;2022-04-16;188;184;2;1;13;263582;173544;2519;196;3414
FR;5;2022-04-17;12;10;1;0;1;263594;173554;2520;196;3415
FR;5;2022-04-18;8;9;2;0;2;263602;173563;2522;196;3417
FR;5;2022-04-19;73;70;6;1;6;263675;173633;2528;197;3423
FR;5;2022-04-20;360;349;9;6;12;264035;173982;2537;203;3435
FR;5;2022-04-21;42;64;9;10;12;264077;174046;2546;213;3447
FR;5;2022-04-22;113;96;5;4;5;264190;174142;2551;217;3452
FR;5;2022-04-23;209;192;3;2;10;264399;174334;2554;219;3462
FR;5;2022-04-24;37;35;0;0;3;264436;174369;2554;219;3465
FR;5;2022-04-25;68;65;1;1;4;264504;174434;2555;220;3469
FR;5;2022-04-26;60;62;2;1;5;264564;174496;2557;221;3474
FR;5;2022-04-27;335;316;2;7;14;264899;174812;2559;228;3488
FR;5;2022-04-28;76;54;4;5;8;264975;174866;2563;233;3496
FR;5;2022-04-29;117;83;5;18;12;265092;174949;2568;251;3508
FR;5;2022-04-30;182;115;2;3;10;265274;175064;2570;254;3518
FR;5;2022-05-01;11;7;0;0;0;265285;175071;2570;254;3518
FR;5;2022-05-02;49;27;4;5;2;265334;175098;2574;259;3520
FR;5;2022-05-03;83;55;2;5;11;265417;175153;2576;264;3531
FR;5;2022-05-04;277;204;1;2;7;265694;175357;2577;266;3538
FR;5;2022-05-05;62;32;2;4;4;265756;175389;2579;270;3542
FR;5;2022-05-06;105;64;2;3;5;265861;175453;2581;273;3547
FR;5;2022-05-07;171;115;3;10;13;266032;175568;2584;283;3560
FR;5;2022-05-08;8;8;0;0;2;266040;175576;2584;283;3562
FR;5;2022-05-09;44;32;15;3;16;266084;175608;2599;286;3578
FR;5;2022-05-10;54;49;3;4;5;266138;175657;2602;290;3583
FR;5;2022-05-11;326;236;12;7;21;266464;175893;2614;297;3604
FR;5;2022-05-12;46;34;1;3;2;266510;175927;2615;300;3606
FR;5;2022-05-13;109;83;3;8;9;266619;176010;2618;308;3615
FR;5;2022-05-14;208;131;0;1;8;266827;176141;2618;309;3623
FR;5;2022-05-15;22;7;2;0;1;266849;176148;2620;309;3624
FR;5;2022-05-16;52;33;4;5;4;266901;176181;2624;314;3628
FR;5;2022-05-17;72;40;5;0;2;266973;176221;2629;314;3630
FR;5;2022-05-18;289;214;4;4;8;267262;176435;2633;318;3638
FR;5;2022-05-19;44;35;4;3;2;267306;176470;2637;321;3640
FR;5;2022-05-20;74;62;2;6;1;267380;176532;2639;327;3641
FR;5;2022-05-21;241;166;2;3;17;267621;176698;2641;330;3658
FR;5;2022-05-22;20;14;2;5;2;267641;176712;2643;335;3660
FR;5;2022-05-23;42;26;4;3;6;267683;176738;2647;338;3666
FR;5;2022-05-24;45;45;3;2;5;267728;176783;2650;340;3671
FR;5;2022-05-25;326;254;4;1;16;268054;177037;2654;341;3687
FR;5;2022-05-26;15;5;0;1;2;268069;177042;2654;342;3689
FR;5;2022-05-27;98;54;4;4;9;268167;177096;2658;346;3698
FR;5;2022-05-28;95;77;5;3;10;268262;177173;2663;349;3708
FR;5;2022-05-29;14;14;1;0;2;268276;177187;2664;349;3710
FR;5;2022-05-30;56;41;2;1;2;268332;177228;2666;350;3712
FR;5;2022-05-31;55;43;1;8;1;268387;177271;2667;358;3713
FR;5;2022-06-01;247;238;9;2;24;268634;177509;2676;360;3737
FR;5;2022-06-02;56;60;4;0;7;268690;177569;2680;360;3744
FR;5;2022-06-03;81;69;3;5;8;268771;177638;2683;365;3752
FR;5;2022-06-04;155;109;2;1;9;268926;177747;2685;366;3761
FR;5;2022-06-05;16;11;0;0;1;268942;177758;2685;366;3762
FR;5;2022-06-06;15;9;0;0;0;268957;177767;2685;366;3762
FR;5;2022-06-07;48;55;0;1;1;269005;177822;2685;367;3763
FR;5;2022-06-08;279;223;2;4;16;269284;178045;2687;371;3779
FR;5;2022-06-09;50;40;5;3;6;269334;178085;2692;374;3785
FR;5;2022-06-10;79;71;1;1;6;269413;178156;2693;375;3791
FR;5;2022-06-11;169;140;2;3;10;269582;178296;2695;378;3801
FR;5;2022-06-12;14;16;0;0;2;269596;178312;2695;378;3803
FR;5;2022-06-13;55;42;7;3;7;269651;178354;2702;381;3810
FR;5;2022-06-14;50;53;0;3;4;269701;178407;2702;384;3814
FR;5;2022-06-15;259;255;2;2;22;269960;178662;2704;386;3836
FR;6;2020-12-27;0;0;0;0;0;0;0;0;0;0
FR;6;2020-12-28;0;0;0;0;0;0;0;0;0;0
FR;6;2020-12-29;0;0;0;0;0;0;0;0;0;0
FR;6;2020-12-30;0;0;0;0;0;0;0;0;0;0
FR;6;2020-12-31;0;0;0;0;0;0;0;0;0;0
FR;6;2021-01-01;0;0;0;0;0;0;0;0;0;0
FR;6;2021-01-02;0;0;0;0;0;0;0;0;0;0
FR;6;2021-01-03;0;0;0;0;0;0;0;0;0;0
FR;6;2021-01-04;0;0;0;0;0;0;0;0;0;0
FR;6;2021-01-05;0;0;0;0;0;0;0;0;0;0
FR;6;2021-01-06;0;0;0;0;0;0;0;0;0;0
FR;6;2021-01-07;0;0;0;0;0;0;0;0;0;0
FR;6;2021-01-08;0;0;0;0;0;0;0;0;0;0
FR;6;2021-01-09;0;0;0;0;0;0;0;0;0;0
FR;6;2021-01-10;0;0;0;0;0;0;0;0;0;0
FR;6;2021-01-11;0;0;0;0;0;0;0;0;0;0
FR;6;2021-01-12;0;0;0;0;0;0;0;0;0;0
FR;6;2021-01-13;0;0;0;0;0;0;0;0;0;0
FR;6;2021-01-14;0;0;0;0;0;0;0;0;0;0
FR;6;2021-01-15;0;0;0;0;0;0;0;0;0;0
FR;6;2021-01-16;0;0;0;0;0;0;0;0;0;0
FR;6;2021-01-17;0;0;0;0;0;0;0;0;0;0
FR;6;2021-01-18;0;0;0;0;0;0;0;0;0;0
FR;6;2021-01-19;0;0;0;0;0;0;0;0;0;0
FR;6;2021-01-20;0;0;0;0;0;0;0;0;0;0
FR;6;2021-01-21;0;0;0;0;0;0;0;0;0;0
FR;6;2021-01-22;0;0;0;0;0;0;0;0;0;0
FR;6;2021-01-23;0;0;0;0;0;0;0;0;0;0
FR;6;2021-01-24;0;0;0;0;0;0;0;0;0;0
FR;6;2021-01-25;0;0;0;0;0;0;0;0;0;0
FR;6;2021-01-26;0;0;0;0;0;0;0;0;0;0
FR;6;2021-01-27;0;0;0;0;0;0;0;0;0;0
FR;6;2021-01-28;0;0;0;0;0;0;0;0;0;0
FR;6;2021-01-29;0;0;0;0;0;0;0;0;0;0
FR;6;2021-01-30;0;0;0;0;0;0;0;0;0;0
FR;6;2021-01-31;0;0;0;0;0;0;0;0;0;0
FR;6;2021-02-01;0;0;0;0;0;0;0;0;0;0
FR;6;2021-02-02;0;0;0;0;0;0;0;0;0;0
FR;6;2021-02-03;0;0;0;0;0;0;0;0;0;0
FR;6;2021-02-04;0;0;0;0;0;0;0;0;0;0
FR;6;2021-02-05;0;0;0;0;0;0;0;0;0;0
FR;6;2021-02-06;0;0;0;0;0;0;0;0;0;0
FR;6;2021-02-07;0;0;0;0;0;0;0;0;0;0
FR;6;2021-02-08;0;0;0;0;0;0;0;0;0;0
FR;6;2021-02-09;0;0;0;0;0;0;0;0;0;0
FR;6;2021-02-10;0;0;0;0;0;0;0;0;0;0
FR;6;2021-02-11;0;0;0;0;0;0;0;0;0;0
FR;6;2021-02-12;0;0;0;0;0;0;0;0;0;0
FR;6;2021-02-13;0;0;0;0;0;0;0;0;0;0
FR;6;2021-02-14;0;0;0;0;0;0;0;0;0;0
FR;6;2021-02-15;0;0;0;0;0;0;0;0;0;0
FR;6;2021-02-16;0;0;0;0;0;0;0;0;0;0
FR;6;2021-02-17;0;0;0;0;0;0;0;0;0;0
FR;6;2021-02-18;0;0;0;0;0;0;0;0;0;0
FR;6;2021-02-19;0;0;0;0;0;0;0;0;0;0
FR;6;2021-02-20;0;0;0;0;0;0;0;0;0;0
FR;6;2021-02-21;0;0;0;0;0;0;0;0;0;0
FR;6;2021-02-22;0;0;0;0;0;0;0;0;0;0
FR;6;2021-02-23;0;0;0;0;0;0;0;0;0;0
FR;6;2021-02-24;0;0;0;0;0;0;0;0;0;0
FR;6;2021-02-25;0;0;0;0;0;0;0;0;0;0
FR;6;2021-02-26;0;0;0;0;0;0;0;0;0;0
FR;6;2021-02-27;0;0;0;0;0;0;0;0;0;0
FR;6;2021-02-28;0;0;0;0;0;0;0;0;0;0
FR;6;2021-03-01;0;0;0;0;0;0;0;0;0;0
FR;6;2021-03-02;0;0;0;0;0;0;0;0;0;0
FR;6;2021-03-03;0;0;0;0;0;0;0;0;0;0
FR;6;2021-03-04;0;0;0;0;0;0;0;0;0;0
FR;6;2021-03-05;0;0;0;0;0;0;0;0;0;0
FR;6;2021-03-06;0;0;0;0;0;0;0;0;0;0
FR;6;2021-03-07;0;0;0;0;0;0;0;0;0;0
FR;6;2021-03-08;0;0;0;0;0;0;0;0;0;0
FR;6;2021-03-09;0;0;0;0;0;0;0;0;0;0
FR;6;2021-03-10;0;0;0;0;0;0;0;0;0;0
FR;6;2021-03-11;0;0;0;0;0;0;0;0;0;0
FR;6;2021-03-12;0;0;0;0;0;0;0;0;0;0
FR;6;2021-03-13;0;0;0;0;0;0;0;0;0;0
FR;6;2021-03-14;0;0;0;0;0;0;0;0;0;0
FR;6;2021-03-15;0;0;0;0;0;0;0;0;0;0
FR;6;2021-03-16;0;0;0;0;0;0;0;0;0;0
FR;6;2021-03-17;0;0;0;0;0;0;0;0;0;0
FR;6;2021-03-18;0;0;0;0;0;0;0;0;0;0
FR;6;2021-03-19;0;0;0;0;0;0;0;0;0;0
FR;6;2021-03-20;0;0;0;0;0;0;0;0;0;0
FR;6;2021-03-21;0;0;0;0;0;0;0;0;0;0
FR;6;2021-03-22;0;0;0;0;0;0;0;0;0;0
FR;6;2021-03-23;0;0;0;0;0;0;0;0;0;0
FR;6;2021-03-24;0;0;0;0;0;0;0;0;0;0
FR;6;2021-03-25;0;0;0;0;0;0;0;0;0;0
FR;6;2021-03-26;0;0;0;0;0;0;0;0;0;0
FR;6;2021-03-27;0;0;0;0;0;0;0;0;0;0
FR;6;2021-03-28;0;0;0;0;0;0;0;0;0;0
FR;6;2021-03-29;0;0;0;0;0;0;0;0;0;0
FR;6;2021-03-30;0;0;0;0;0;0;0;0;0;0
FR;6;2021-03-31;0;0;0;0;0;0;0;0;0;0
FR;6;2021-04-01;0;0;0;0;0;0;0;0;0;0
FR;6;2021-04-02;0;0;0;0;0;0;0;0;0;0
FR;6;2021-04-03;0;0;0;0;0;0;0;0;0;0
FR;6;2021-04-04;0;0;0;0;0;0;0;0;0;0
FR;6;2021-04-05;0;0;0;0;0;0;0;0;0;0
FR;6;2021-04-06;0;0;0;0;0;0;0;0;0;0
FR;6;2021-04-07;0;0;0;0;0;0;0;0;0;0
FR;6;2021-04-08;0;0;0;0;0;0;0;0;0;0
FR;6;2021-04-09;0;0;0;0;0;0;0;0;0;0
FR;6;2021-04-10;0;0;0;0;0;0;0;0;0;0
FR;6;2021-04-11;0;0;0;0;0;0;0;0;0;0
FR;6;2021-04-12;0;0;0;0;0;0;0;0;0;0
FR;6;2021-04-13;0;0;0;0;0;0;0;0;0;0
FR;6;2021-04-14;0;0;0;0;0;0;0;0;0;0
FR;6;2021-04-15;0;0;0;0;0;0;0;0;0;0
FR;6;2021-04-16;0;0;0;0;0;0;0;0;0;0
FR;6;2021-04-17;0;0;0;0;0;0;0;0;0;0
FR;6;2021-04-18;0;0;0;0;0;0;0;0;0;0
FR;6;2021-04-19;0;0;0;0;0;0;0;0;0;0
FR;6;2021-04-20;0;0;0;0;0;0;0;0;0;0
FR;6;2021-04-21;0;0;0;0;0;0;0;0;0;0
FR;6;2021-04-22;0;0;0;0;0;0;0;0;0;0
FR;6;2021-04-23;0;0;0;0;0;0;0;0;0;0
FR;6;2021-04-24;0;0;0;0;0;0;0;0;0;0
FR;6;2021-04-25;0;0;0;0;0;0;0;0;0;0
FR;6;2021-04-26;0;0;0;0;0;0;0;0;0;0
FR;6;2021-04-27;0;0;0;0;0;0;0;0;0;0
FR;6;2021-04-28;0;0;0;0;0;0;0;0;0;0
FR;6;2021-04-29;0;0;0;0;0;0;0;0;0;0
FR;6;2021-04-30;0;0;0;0;0;0;0;0;0;0
FR;6;2021-05-01;0;0;0;0;0;0;0;0;0;0
FR;6;2021-05-02;0;0;0;0;0;0;0;0;0;0
FR;6;2021-05-03;0;0;0;0;0;0;0;0;0;0
FR;6;2021-05-04;0;0;0;0;0;0;0;0;0;0
FR;6;2021-05-05;0;0;0;0;0;0;0;0;0;0
FR;6;2021-05-06;0;0;0;0;0;0;0;0;0;0
FR;6;2021-05-07;0;0;0;0;0;0;0;0;0;0
FR;6;2021-05-08;0;0;0;0;0;0;0;0;0;0
FR;6;2021-05-09;0;0;0;0;0;0;0;0;0;0
FR;6;2021-05-10;0;0;0;0;0;0;0;0;0;0
FR;6;2021-05-11;0;0;0;0;0;0;0;0;0;0
FR;6;2021-05-12;0;0;0;0;0;0;0;0;0;0
FR;6;2021-05-13;0;0;0;0;0;0;0;0;0;0
FR;6;2021-05-14;0;0;0;0;0;0;0;0;0;0
FR;6;2021-05-15;0;0;0;0;0;0;0;0;0;0
FR;6;2021-05-16;0;0;0;0;0;0;0;0;0;0
FR;6;2021-05-17;0;0;0;0;0;0;0;0;0;0
FR;6;2021-05-18;0;0;0;0;0;0;0;0;0;0
FR;6;2021-05-19;0;0;0;0;0;0;0;0;0;0
FR;6;2021-05-20;0;0;0;0;0;0;0;0;0;0
FR;6;2021-05-21;0;0;0;0;0;0;0;0;0;0
FR;6;2021-05-22;0;0;0;0;0;0;0;0;0;0
FR;6;2021-05-23;0;0;0;0;0;0;0;0;0;0
FR;6;2021-05-24;0;0;0;0;0;0;0;0;0;0
FR;6;2021-05-25;0;0;0;0;0;0;0;0;0;0
FR;6;2021-05-26;0;0;0;0;0;0;0;0;0;0
FR;6;2021-05-27;0;0;0;0;0;0;0;0;0;0
FR;6;2021-05-28;0;0;0;0;0;0;0;0;0;0
FR;6;2021-05-29;0;0;0;0;0;0;0;0;0;0
FR;6;2021-05-30;0;0;0;0;0;0;0;0;0;0
FR;6;2021-05-31;0;0;0;0;0;0;0;0;0;0
FR;6;2021-06-01;0;0;0;0;0;0;0;0;0;0
FR;6;2021-06-02;0;0;0;0;0;0;0;0;0;0
FR;6;2021-06-03;0;0;0;0;0;0;0;0;0;0
FR;6;2021-06-04;0;0;0;0;0;0;0;0;0;0
FR;6;2021-06-05;0;0;0;0;0;0;0;0;0;0
FR;6;2021-06-06;0;0;0;0;0;0;0;0;0;0
FR;6;2021-06-07;0;0;0;0;0;0;0;0;0;0
FR;6;2021-06-08;0;0;0;0;0;0;0;0;0;0
FR;6;2021-06-09;0;0;0;0;0;0;0;0;0;0
FR;6;2021-06-10;0;0;0;0;0;0;0;0;0;0
FR;6;2021-06-11;0;0;0;0;0;0;0;0;0;0
FR;6;2021-06-12;0;0;0;0;0;0;0;0;0;0
FR;6;2021-06-13;0;0;0;0;0;0;0;0;0;0
FR;6;2021-06-14;0;0;0;0;0;0;0;0;0;0
FR;6;2021-06-15;0;0;0;0;0;0;0;0;0;0
FR;6;2021-06-16;0;0;0;0;0;0;0;0;0;0
FR;6;2021-06-17;0;0;0;0;0;0;0;0;0;0
FR;6;2021-06-18;0;0;0;0;0;0;0;0;0;0
FR;6;2021-06-19;0;0;0;0;0;0;0;0;0;0
FR;6;2021-06-20;0;0;0;0;0;0;0;0;0;0
FR;6;2021-06-21;0;0;0;0;0;0;0;0;0;0
FR;6;2021-06-22;0;0;0;0;0;0;0;0;0;0
FR;6;2021-06-23;0;0;0;0;0;0;0;0;0;0
FR;6;2021-06-24;0;0;0;0;0;0;0;0;0;0
FR;6;2021-06-25;0;0;0;0;0;0;0;0;0;0
FR;6;2021-06-26;0;0;0;0;0;0;0;0;0;0
FR;6;2021-06-27;0;0;0;0;0;0;0;0;0;0
FR;6;2021-06-28;0;0;0;0;0;0;0;0;0;0
FR;6;2021-06-29;0;0;0;0;0;0;0;0;0;0
FR;6;2021-06-30;0;0;0;0;0;0;0;0;0;0
FR;6;2021-07-01;0;0;0;0;0;0;0;0;0;0
FR;6;2021-07-02;0;0;0;0;0;0;0;0;0;0
FR;6;2021-07-03;0;0;0;0;0;0;0;0;0;0
FR;6;2021-07-04;0;0;0;0;0;0;0;0;0;0
FR;6;2021-07-05;0;0;0;0;0;0;0;0;0;0
FR;6;2021-07-06;0;0;0;0;0;0;0;0;0;0
FR;6;2021-07-07;0;0;0;0;0;0;0;0;0;0
FR;6;2021-07-08;0;0;0;0;0;0;0;0;0;0
FR;6;2021-07-09;0;0;0;0;0;0;0;0;0;0
FR;6;2021-07-10;0;0;0;0;0;0;0;0;0;0
FR;6;2021-07-11;0;0;0;0;0;0;0;0;0;0
FR;6;2021-07-12;0;0;0;0;0;0;0;0;0;0
FR;6;2021-07-13;0;0;0;0;0;0;0;0;0;0
FR;6;2021-07-14;0;0;0;0;0;0;0;0;0;0
FR;6;2021-07-15;0;0;0;0;0;0;0;0;0;0
FR;6;2021-07-16;0;0;0;0;0;0;0;0;0;0
FR;6;2021-07-17;0;0;0;0;0;0;0;0;0;0
FR;6;2021-07-18;0;0;0;0;0;0;0;0;0;0
FR;6;2021-07-19;0;0;0;0;0;0;0;0;0;0
FR;6;2021-07-20;0;0;0;0;0;0;0;0;0;0
FR;6;2021-07-21;0;0;0;0;0;0;0;0;0;0
FR;6;2021-07-22;0;0;0;0;0;0;0;0;0;0
FR;6;2021-07-23;0;0;0;0;0;0;0;0;0;0
FR;6;2021-07-24;0;0;0;0;0;0;0;0;0;0
FR;6;2021-07-25;0;0;0;0;0;0;0;0;0;0
FR;6;2021-07-26;0;0;0;0;0;0;0;0;0;0
FR;6;2021-07-27;0;0;0;0;0;0;0;0;0;0
FR;6;2021-07-28;0;0;0;0;0;0;0;0;0;0
FR;6;2021-07-29;0;0;0;0;0;0;0;0;0;0
FR;6;2021-07-30;0;0;0;0;0;0;0;0;0;0
FR;6;2021-07-31;0;0;0;0;0;0;0;0;0;0
FR;6;2021-08-01;0;0;0;0;0;0;0;0;0;0
FR;6;2021-08-02;0;0;0;0;0;0;0;0;0;0
FR;6;2021-08-03;0;0;0;0;0;0;0;0;0;0
FR;6;2021-08-04;0;0;0;0;0;0;0;0;0;0
FR;6;2021-08-05;0;0;0;0;0;0;0;0;0;0
FR;6;2021-08-06;0;0;0;0;0;0;0;0;0;0
FR;6;2021-08-07;0;0;0;0;0;0;0;0;0;0
FR;6;2021-08-08;0;0;0;0;0;0;0;0;0;0
FR;6;2021-08-09;0;0;0;0;0;0;0;0;0;0
FR;6;2021-08-10;0;0;0;0;0;0;0;0;0;0
FR;6;2021-08-11;0;0;0;0;0;0;0;0;0;0
FR;6;2021-08-12;0;0;0;0;0;0;0;0;0;0
FR;6;2021-08-13;0;0;0;0;0;0;0;0;0;0
FR;6;2021-08-14;0;0;0;0;0;0;0;0;0;0
FR;6;2021-08-15;0;0;0;0;0;0;0;0;0;0
FR;6;2021-08-16;0;0;0;0;0;0;0;0;0;0
FR;6;2021-08-17;0;0;0;0;0;0;0;0;0;0
FR;6;2021-08-18;0;0;0;0;0;0;0;0;0;0
FR;6;2021-08-19;0;0;0;0;0;0;0;0;0;0
FR;6;2021-08-20;0;0;0;0;0;0;0;0;0;0
FR;6;2021-08-21;0;0;0;0;0;0;0;0;0;0
FR;6;2021-08-22;0;0;0;0;0;0;0;0;0;0
FR;6;2021-08-23;0;0;0;0;0;0;0;0;0;0
FR;6;2021-08-24;0;0;0;0;0;0;0;0;0;0
FR;6;2021-08-25;0;0;0;0;0;0;0;0;0;0
FR;6;2021-08-26;0;0;0;0;0;0;0;0;0;0
FR;6;2021-08-27;0;0;0;0;0;0;0;0;0;0
FR;6;2021-08-28;0;0;0;0;0;0;0;0;0;0
FR;6;2021-08-29;0;0;0;0;0;0;0;0;0;0
FR;6;2021-08-30;0;0;0;0;0;0;0;0;0;0
FR;6;2021-08-31;0;0;0;0;0;0;0;0;0;0
FR;6;2021-09-01;0;0;0;0;0;0;0;0;0;0
FR;6;2021-09-02;0;0;0;0;0;0;0;0;0;0
FR;6;2021-09-03;0;0;0;0;0;0;0;0;0;0
FR;6;2021-09-04;0;0;0;0;0;0;0;0;0;0
FR;6;2021-09-05;0;0;0;0;0;0;0;0;0;0
FR;6;2021-09-06;0;0;0;0;0;0;0;0;0;0
FR;6;2021-09-07;0;0;0;0;0;0;0;0;0;0
FR;6;2021-09-08;0;0;0;0;0;0;0;0;0;0
FR;6;2021-09-09;0;0;0;0;0;0;0;0;0;0
FR;6;2021-09-10;0;0;0;0;0;0;0;0;0;0
FR;6;2021-09-11;0;0;0;0;0;0;0;0;0;0
FR;6;2021-09-12;0;0;0;0;0;0;0;0;0;0
FR;6;2021-09-13;0;0;0;0;0;0;0;0;0;0
FR;6;2021-09-14;0;0;0;0;0;0;0;0;0;0
FR;6;2021-09-15;0;0;0;0;0;0;0;0;0;0
FR;6;2021-09-16;0;0;0;0;0;0;0;0;0;0
FR;6;2021-09-17;0;0;0;0;0;0;0;0;0;0
FR;6;2021-09-18;0;0;0;0;0;0;0;0;0;0
FR;6;2021-09-19;0;0;0;0;0;0;0;0;0;0
FR;6;2021-09-20;0;0;0;0;0;0;0;0;0;0
FR;6;2021-09-21;0;0;0;0;0;0;0;0;0;0
FR;6;2021-09-22;0;0;0;0;0;0;0;0;0;0
FR;6;2021-09-23;0;0;0;0;0;0;0;0;0;0
FR;6;2021-09-24;0;0;0;0;0;0;0;0;0;0
FR;6;2021-09-25;0;0;0;0;0;0;0;0;0;0
FR;6;2021-09-26;0;0;0;0;0;0;0;0;0;0
FR;6;2021-09-27;0;0;0;0;0;0;0;0;0;0
FR;6;2021-09-28;0;0;0;0;0;0;0;0;0;0
FR;6;2021-09-29;0;0;0;0;0;0;0;0;0;0
FR;6;2021-09-30;0;0;0;0;0;0;0;0;0;0
FR;6;2021-10-01;0;0;0;0;0;0;0;0;0;0
FR;6;2021-10-02;0;0;0;0;0;0;0;0;0;0
FR;6;2021-10-03;0;0;0;0;0;0;0;0;0;0
FR;6;2021-10-04;0;0;0;0;0;0;0;0;0;0
FR;6;2021-10-05;0;0;0;0;0;0;0;0;0;0
FR;6;2021-10-06;0;0;0;0;0;0;0;0;0;0
FR;6;2021-10-07;0;0;0;0;0;0;0;0;0;0
FR;6;2021-10-08;0;0;0;0;0;0;0;0;0;0
FR;6;2021-10-09;0;0;0;0;0;0;0;0;0;0
FR;6;2021-10-10;0;0;0;0;0;0;0;0;0;0
FR;6;2021-10-11;0;0;0;0;0;0;0;0;0;0
FR;6;2021-10-12;0;0;0;0;0;0;0;0;0;0
FR;6;2021-10-13;0;0;0;0;0;0;0;0;0;0
FR;6;2021-10-14;0;0;0;0;0;0;0;0;0;0
FR;6;2021-10-15;0;0;0;0;0;0;0;0;0;0
FR;6;2021-10-16;0;0;0;0;0;0;0;0;0;0
FR;6;2021-10-17;0;0;0;0;0;0;0;0;0;0
FR;6;2021-10-18;0;0;0;0;0;0;0;0;0;0
FR;6;2021-10-19;0;0;0;0;0;0;0;0;0;0
FR;6;2021-10-20;0;0;0;0;0;0;0;0;0;0
FR;6;2021-10-21;0;0;0;0;0;0;0;0;0;0
FR;6;2021-10-22;0;0;0;0;0;0;0;0;0;0
FR;6;2021-10-23;0;0;0;0;0;0;0;0;0;0
FR;6;2021-10-24;0;0;0;0;0;0;0;0;0;0
FR;6;2021-10-25;0;0;0;0;0;0;0;0;0;0
FR;6;2021-10-26;0;0;0;0;0;0;0;0;0;0
FR;6;2021-10-27;0;0;0;0;0;0;0;0;0;0
FR;6;2021-10-28;0;0;0;0;0;0;0;0;0;0
FR;6;2021-10-29;0;0;0;0;0;0;0;0;0;0
FR;6;2021-10-30;0;0;0;0;0;0;0;0;0;0
FR;6;2021-10-31;0;0;0;0;0;0;0;0;0;0
FR;6;2021-11-01;0;0;0;0;0;0;0;0;0;0
FR;6;2021-11-02;0;0;0;0;0;0;0;0;0;0
FR;6;2021-11-03;0;0;0;0;0;0;0;0;0;0
FR;6;2021-11-04;0;0;0;0;0;0;0;0;0;0
FR;6;2021-11-05;0;0;0;0;0;0;0;0;0;0
FR;6;2021-11-06;0;0;0;0;0;0;0;0;0;0
FR;6;2021-11-07;0;0;0;0;0;0;0;0;0;0
FR;6;2021-11-08;0;0;0;0;0;0;0;0;0;0
FR;6;2021-11-09;0;0;0;0;0;0;0;0;0;0
FR;6;2021-11-10;0;0;0;0;0;0;0;0;0;0
FR;6;2021-11-11;0;0;0;0;0;0;0;0;0;0
FR;6;2021-11-12;0;0;0;0;0;0;0;0;0;0
FR;6;2021-11-13;0;0;0;0;0;0;0;0;0;0
FR;6;2021-11-14;0;0;0;0;0;0;0;0;0;0
FR;6;2021-11-15;0;0;0;0;0;0;0;0;0;0
FR;6;2021-11-16;0;0;0;0;0;0;0;0;0;0
FR;6;2021-11-17;0;0;0;0;0;0;0;0;0;0
FR;6;2021-11-18;0;0;0;0;0;0;0;0;0;0
FR;6;2021-11-19;0;0;0;0;0;0;0;0;0;0
FR;6;2021-11-20;0;0;0;0;0;0;0;0;0;0
FR;6;2021-11-21;0;0;0;0;0;0;0;0;0;0
FR;6;2021-11-22;0;0;0;0;0;0;0;0;0;0
FR;6;2021-11-23;0;0;0;0;0;0;0;0;0;0
FR;6;2021-11-24;0;0;0;0;0;0;0;0;0;0
FR;6;2021-11-25;0;0;0;0;0;0;0;0;0;0
FR;6;2021-11-26;0;0;0;0;0;0;0;0;0;0
FR;6;2021-11-27;0;0;0;0;0;0;0;0;0;0
FR;6;2021-11-28;0;0;0;0;0;0;0;0;0;0
FR;6;2021-11-29;0;0;0;0;0;0;0;0;0;0
FR;6;2021-11-30;0;0;0;0;0;0;0;0;0;0
FR;6;2021-12-01;0;0;0;0;0;0;0;0;0;0
FR;6;2021-12-02;0;0;0;0;0;0;0;0;0;0
FR;6;2021-12-03;0;0;0;0;0;0;0;0;0;0
FR;6;2021-12-04;0;0;0;0;0;0;0;0;0;0
FR;6;2021-12-05;0;0;0;0;0;0;0;0;0;0
FR;6;2021-12-06;0;0;0;0;0;0;0;0;0;0
FR;6;2021-12-07;0;0;0;0;0;0;0;0;0;0
FR;6;2021-12-08;0;0;0;0;0;0;0;0;0;0
FR;6;2021-12-09;0;0;0;0;0;0;0;0;0;0
FR;6;2021-12-10;0;0;0;0;0;0;0;0;0;0
FR;6;2021-12-11;0;0;0;0;0;0;0;0;0;0
FR;6;2021-12-12;0;0;0;0;0;0;0;0;0;0
FR;6;2021-12-13;0;0;0;0;0;0;0;0;0;0
FR;6;2021-12-14;0;0;0;0;0;0;0;0;0;0
FR;6;2021-12-15;0;0;0;0;0;0;0;0;0;0
FR;6;2021-12-16;0;0;0;0;0;0;0;0;0;0
FR;6;2021-12-17;0;0;0;0;0;0;0;0;0;0
FR;6;2021-12-18;0;0;0;0;0;0;0;0;0;0
FR;6;2021-12-19;0;0;0;0;0;0;0;0;0;0
FR;6;2021-12-20;0;0;0;0;0;0;0;0;0;0
FR;6;2021-12-21;0;0;0;0;0;0;0;0;0;0
FR;6;2021-12-22;0;0;0;0;0;0;0;0;0;0
FR;6;2021-12-23;0;0;0;0;0;0;0;0;0;0
FR;6;2021-12-24;0;0;0;0;0;0;0;0;0;0
FR;6;2021-12-25;0;0;0;0;0;0;0;0;0;0
FR;6;2021-12-26;0;0;0;0;0;0;0;0;0;0
FR;6;2021-12-27;0;0;0;0;0;0;0;0;0;0
FR;6;2021-12-28;0;0;0;0;0;0;0;0;0;0
FR;6;2021-12-29;0;0;0;0;0;0;0;0;0;0
FR;6;2021-12-30;0;0;0;0;0;0;0;0;0;0
FR;6;2021-12-31;0;0;0;0;0;0;0;0;0;0
FR;6;2022-01-01;0;0;0;0;0;0;0;0;0;0
FR;6;2022-01-02;0;0;0;0;0;0;0;0;0;0
FR;6;2022-01-03;0;0;0;0;0;0;0;0;0;0
FR;6;2022-01-04;0;0;0;0;0;0;0;0;0;0
FR;6;2022-01-05;0;0;0;0;0;0;0;0;0;0
FR;6;2022-01-06;0;0;0;0;0;0;0;0;0;0
FR;6;2022-01-07;0;0;0;0;0;0;0;0;0;0
FR;6;2022-01-08;0;0;0;0;0;0;0;0;0;0
FR;6;2022-01-09;0;0;0;0;0;0;0;0;0;0
FR;6;2022-01-10;0;0;0;0;0;0;0;0;0;0
FR;6;2022-01-11;0;0;0;0;0;0;0;0;0;0
FR;6;2022-01-12;0;0;0;0;0;0;0;0;0;0
FR;6;2022-01-13;0;0;0;0;0;0;0;0;0;0
FR;6;2022-01-14;0;0;0;0;0;0;0;0;0;0
FR;6;2022-01-15;0;0;0;0;0;0;0;0;0;0
FR;6;2022-01-16;0;0;0;0;0;0;0;0;0;0
FR;6;2022-01-17;0;0;0;0;0;0;0;0;0;0
FR;6;2022-01-18;0;0;0;0;0;0;0;0;0;0
FR;6;2022-01-19;0;0;0;0;0;0;0;0;0;0
FR;6;2022-01-20;0;0;0;0;0;0;0;0;0;0
FR;6;2022-01-21;0;0;0;0;0;0;0;0;0;0
FR;6;2022-01-22;0;0;0;0;0;0;0;0;0;0
FR;6;2022-01-23;0;0;0;0;0;0;0;0;0;0
FR;6;2022-01-24;0;0;0;0;0;0;0;0;0;0
FR;6;2022-01-25;0;0;0;0;0;0;0;0;0;0
FR;6;2022-01-26;0;0;0;0;0;0;0;0;0;0
FR;6;2022-01-27;0;0;0;0;0;0;0;0;0;0
FR;6;2022-01-28;0;0;0;0;0;0;0;0;0;0
FR;6;2022-01-29;0;0;0;0;0;0;0;0;0;0
FR;6;2022-01-30;0;0;0;0;0;0;0;0;0;0
FR;6;2022-01-31;0;0;0;0;0;0;0;0;0;0
FR;6;2022-02-01;0;0;0;0;0;0;0;0;0;0
FR;6;2022-02-02;0;0;0;0;0;0;0;0;0;0
FR;6;2022-02-03;0;0;0;0;0;0;0;0;0;0
FR;6;2022-02-04;0;0;0;0;0;0;0;0;0;0
FR;6;2022-02-05;0;0;0;0;0;0;0;0;0;0
FR;6;2022-02-06;0;0;0;0;0;0;0;0;0;0
FR;6;2022-02-07;0;0;0;0;0;0;0;0;0;0
FR;6;2022-02-08;0;0;0;0;0;0;0;0;0;0
FR;6;2022-02-09;0;0;0;0;0;0;0;0;0;0
FR;6;2022-02-10;0;0;0;0;0;0;0;0;0;0
FR;6;2022-02-11;0;0;0;0;0;0;0;0;0;0
FR;6;2022-02-12;0;0;0;0;0;0;0;0;0;0
FR;6;2022-02-13;0;0;0;0;0;0;0;0;0;0
FR;6;2022-02-14;0;0;0;0;0;0;0;0;0;0
FR;6;2022-02-15;0;0;0;0;0;0;0;0;0;0
FR;6;2022-02-16;0;0;0;0;0;0;0;0;0;0
FR;6;2022-02-17;0;0;0;0;0;0;0;0;0;0
FR;6;2022-02-18;0;0;0;0;0;0;0;0;0;0
FR;6;2022-02-19;0;0;0;0;0;0;0;0;0;0
FR;6;2022-02-20;0;0;0;0;0;0;0;0;0;0
FR;6;2022-02-21;0;0;0;0;0;0;0;0;0;0
FR;6;2022-02-22;0;0;0;0;0;0;0;0;0;0
FR;6;2022-02-23;0;0;0;0;0;0;0;0;0;0
FR;6;2022-02-24;0;0;0;0;0;0;0;0;0;0
FR;6;2022-02-25;0;0;0;0;0;0;0;0;0;0
FR;6;2022-02-26;1;0;0;0;0;1;0;0;0;0
FR;6;2022-02-27;0;0;0;0;0;1;0;0;0;0
FR;6;2022-02-28;0;0;0;0;0;1;0;0;0;0
FR;6;2022-03-01;3;0;0;0;0;4;0;0;0;0
FR;6;2022-03-02;97;9;2;0;7;101;9;2;0;7
FR;6;2022-03-03;0;0;0;0;0;101;9;2;0;7
FR;6;2022-03-04;91;4;0;0;4;192;13;2;0;11
FR;6;2022-03-05;391;23;2;0;14;583;36;4;0;25
FR;6;2022-03-06;7;1;0;0;0;590;37;4;0;25
FR;6;2022-03-07;337;19;0;0;13;927;56;4;0;38
FR;6;2022-03-08;230;14;0;0;5;1157;70;4;0;43
FR;6;2022-03-09;519;29;2;0;21;1676;99;6;0;64
FR;6;2022-03-10;206;19;0;1;12;1882;118;6;1;76
FR;6;2022-03-11;328;21;6;0;21;2210;139;12;1;97
FR;6;2022-03-12;518;25;1;0;20;2728;164;13;1;117
FR;6;2022-03-13;40;2;0;0;1;2768;166;13;1;118
FR;6;2022-03-14;201;4;2;0;3;2969;170;15;1;121
FR;6;2022-03-15;112;11;2;0;9;3081;181;17;1;130
FR;6;2022-03-16;310;17;1;1;14;3391;198;18;2;144
FR;6;2022-03-17;117;6;1;2;4;3508;204;19;4;148
FR;6;2022-03-18;214;11;0;0;6;3722;215;19;4;154
FR;6;2022-03-19;307;19;2;0;9;4029;234;21;4;163
FR;6;2022-03-20;15;5;0;0;1;4044;239;21;4;164
FR;6;2022-03-21;132;23;1;0;4;4176;262;22;4;168
FR;6;2022-03-22;97;15;0;0;4;4273;277;22;4;172
FR;6;2022-03-23;226;108;3;0;14;4499;385;25;4;186
FR;6;2022-03-24;100;15;1;3;4;4599;400;26;7;190
FR;6;2022-03-25;203;141;2;1;15;4802;541;28;8;205
FR;6;2022-03-26;331;295;7;1;19;5133;836;35;9;224
FR;6;2022-03-27;32;30;1;0;1;5165;866;36;9;225
FR;6;2022-03-28;200;208;8;1;17;5365;1074;44;10;242
FR;6;2022-03-29;126;189;12;2;12;5491;1263;56;12;254
FR;6;2022-03-30;305;476;10;2;22;5796;1739;66;14;276
FR;6;2022-03-31;124;140;10;0;14;5920;1879;76;14;290
FR;6;2022-04-01;195;150;11;2;23;6115;2029;87;16;313
FR;6;2022-04-02;205;241;9;1;13;6320;2270;96;17;326
FR;6;2022-04-03;17;21;0;0;1;6337;2291;96;17;327
FR;6;2022-04-04;132;114;6;1;9;6469;2405;102;18;336
FR;6;2022-04-05;145;88;15;1;11;6614;2493;117;19;347
FR;6;2022-04-06;204;245;22;26;27;6818;2738;139;45;374
FR;6;2022-04-07;127;96;15;9;17;6945;2834;154;54;391
FR;6;2022-04-08;199;170;16;3;17;7144;3004;170;57;408
FR;6;2022-04-09;145;139;6;12;13;7289;3143;176;69;421
FR;6;2022-04-10;10;20;3;0;1;7299;3163;179;69;422
FR;6;2022-04-11;101;106;4;0;5;7400;3269;183;69;427
FR;6;2022-04-12;136;75;5;8;10;7536;3344;188;77;437
FR;6;2022-04-13;161;175;7;5;13;7697;3519;195;82;450
FR;6;2022-04-14;100;103;5;10;8;7797;3622;200;92;458
FR;6;2022-04-15;160;148;11;7;19;7957;3770;211;99;477
FR;6;2022-04-16;127;132;5;0;14;8084;3902;216;99;491
FR;6;2022-04-17;8;9;4;0;4;8092;3911;220;99;495
FR;6;2022-04-18;8;15;3;0;4;8100;3926;223;99;499
FR;6;2022-04-19;97;112;4;3;3;8197;4038;227;102;502
FR;6;2022-04-20;173;227;8;7;15;8370;4265;235;109;517
FR;6;2022-04-21;111;93;8;4;11;8481;4358;243;113;528
FR;6;2022-04-22;138;160;13;12;13;8619;4518;256;125;541
FR;6;2022-04-23;104;129;1;1;7;8723;4647;257;126;548
FR;6;2022-04-24;5;21;1;0;0;8728;4668;258;126;548
FR;6;2022-04-25;90;128;3;8;11;8818;4796;261;134;559
FR;6;2022-04-26;101;128;18;2;16;8919;4924;279;136;575
FR;6;2022-04-27;197;159;21;1;27;9116;5083;300;137;602
FR;6;2022-04-28;109;87;7;1;8;9225;5170;307;138;610
FR;6;2022-04-29;191;168;16;2;20;9416;5338;323;140;630
FR;6;2022-04-30;131;125;7;1;24;9547;5463;330;141;654
FR;6;2022-05-01;7;6;0;0;0;9554;5469;330;141;654
FR;6;2022-05-02;94;65;3;4;3;9648;5534;333;145;657
FR;6;2022-05-03;137;92;11;2;7;9785;5626;344;147;664
FR;6;2022-05-04;166;118;25;12;29;9951;5744;369;159;693
FR;6;2022-05-05;101;70;8;3;12;10052;5814;377;162;705
FR;6;2022-05-06;152;110;10;9;16;10204;5924;387;171;721
FR;6;2022-05-07;138;93;13;3;23;10342;6017;400;174;744
FR;6;2022-05-08;20;8;6;5;7;10362;6025;406;179;751
FR;6;2022-05-09;86;73;9;7;13;10448;6098;415;186;764
FR;6;2022-05-10;111;80;15;7;12;10559;6178;430;193;776
FR;6;2022-05-11;130;120;11;14;20;10689;6298;441;207;796
FR;6;2022-05-12;105;75;6;5;13;10794;6373;447;212;809
FR;6;2022-05-13;154;95;17;21;20;10948;6468;464;233;829
FR;6;2022-05-14;81;60;6;7;15;11029;6528;470;240;844
FR;6;2022-05-15;12;7;0;0;0;11041;6535;470;240;844
FR;6;2022-05-16;64;54;6;2;12;11105;6589;476;242;856
FR;6;2022-05-17;123;77;5;7;11;11228;6666;481;249;867
FR;6;2022-05-18;131;116;5;1;13;11359;6782;486;250;880
FR;6;2022-05-19;124;57;6;8;9;11483;6839;492;258;889
FR;6;2022-05-20;127;115;13;3;18;11610;6954;505;261;907
FR;6;2022-05-21;90;67;14;3;12;11700;7021;519;264;919
FR;6;2022-05-22;19;12;5;0;4;11719;7033;524;264;923
FR;6;2022-05-23;73;72;4;2;7;11792;7105;528;266;930
FR;6;2022-05-24;116;98;8;2;16;11908;7203;536;268;946
FR;6;2022-05-25;139;129;6;3;11;12047;7332;542;271;957
FR;6;2022-05-26;7;9;3;0;9;12054;7341;545;271;966
FR;6;2022-05-27;127;105;15;11;18;12181;7446;560;282;984
FR;6;2022-05-28;51;73;1;5;8;12232;7519;561;287;992
FR;6;2022-05-29;8;10;0;0;1;12240;7529;561;287;993
FR;6;2022-05-30;70;69;7;4;4;12310;7598;568;291;997
FR;6;2022-05-31;87;102;10;2;14;12397;7700;578;293;1011
FR;6;2022-06-01;97;89;10;1;11;12494;7789;588;294;1022
FR;6;2022-06-02;88;60;6;3;9;12582;7849;594;297;1031
FR;6;2022-06-03;124;102;13;7;21;12706;7951;607;304;1052
FR;6;2022-06-04;61;51;10;0;12;12767;8002;617;304;1064
FR;6;2022-06-05;16;15;2;1;4;12783;8017;619;305;1068
FR;6;2022-06-06;9;6;0;0;0;12792;8023;619;305;1068
FR;6;2022-06-07;77;89;3;4;7;12869;8112;622;309;1075
FR;6;2022-06-08;92;109;13;5;20;12961;8221;635;314;1095
FR;6;2022-06-09;75;80;14;3;14;13036;8301;649;317;1109
FR;6;2022-06-10;116;91;25;9;22;13152;8392;674;326;1131
FR;6;2022-06-11;82;62;4;10;11;13234;8454;678;336;1142
FR;6;2022-06-12;6;14;1;0;2;13240;8468;679;336;1144
FR;6;2022-06-13;73;59;18;1;7;13313;8527;697;337;1151
FR;6;2022-06-14;98;98;7;5;16;13411;8625;704;342;1167
FR;6;2022-06-15;77;80;7;8;15;13488;8705;711;350;1182
FR;0;2020-12-27;603;0;0;0;0;603;0;0;0;0
FR;0;2020-12-28;669;1;0;0;0;1272;1;0;0;0
FR;0;2020-12-29;374;0;0;0;0;1646;1;0;0;0
FR;0;2020-12-30;440;0;0;0;0;2086;1;0;0;0
FR;0;2020-12-31;436;1;0;0;0;2522;2;0;0;0
FR;0;2021-01-01;1137;2;0;0;0;3659;4;0;0;0
FR;0;2021-01-02;359;3;0;0;0;4018;7;0;0;0
FR;0;2021-01-03;402;0;0;0;0;4420;7;0;0;0
FR;0;2021-01-04;2093;2;0;0;0;6513;9;0;0;0
FR;0;2021-01-05;7733;3;0;0;0;14246;12;0;0;0
FR;0;2021-01-06;12449;13;0;0;0;26695;25;0;0;0
FR;0;2021-01-07;29452;9;0;0;0;56147;34;0;0;0
FR;0;2021-01-08;37123;12;0;0;0;93270;46;0;0;0
FR;0;2021-01-09;11209;5;0;0;0;104479;51;0;0;0
FR;0;2021-01-10;5999;3;0;0;0;110478;54;0;0;0
FR;0;2021-01-11;39925;17;0;0;0;150403;71;0;0;0
FR;0;2021-01-12;62128;16;0;0;0;212531;87;0;0;0
FR;0;2021-01-13;65113;31;0;0;0;277644;118;0;0;0
FR;0;2021-01-14;83118;91;0;0;0;360762;209;0;0;0
FR;0;2021-01-15;68994;34;0;0;0;429756;243;0;0;0
FR;0;2021-01-16;20208;69;0;0;0;449964;312;0;0;0
FR;0;2021-01-17;10978;49;0;0;0;460942;361;0;0;0
FR;0;2021-01-18;85887;164;0;0;0;546829;525;0;0;0
FR;0;2021-01-19;130580;174;0;0;0;677409;699;0;0;0
FR;0;2021-01-20;137527;171;0;0;0;814936;870;0;0;0
FR;0;2021-01-21;158380;170;0;0;0;973316;1040;0;0;0
FR;0;2021-01-22;121047;211;0;0;0;1094363;1251;0;0;0
FR;0;2021-01-23;38467;64;0;0;0;1132830;1315;0;0;0
FR;0;2021-01-24;9740;74;0;0;0;1142570;1389;0;0;0
FR;0;2021-01-25;78224;1274;0;0;0;1220794;2663;0;0;0
FR;0;2021-01-26;100367;3296;1;0;0;1321161;5959;1;0;0
FR;0;2021-01-27;107226;5940;0;0;0;1428387;11899;1;0;0
FR;0;2021-01-28;124331;15112;0;0;0;1552718;27011;1;0;0
FR;0;2021-01-29;92174;17784;0;0;0;1644892;44795;1;0;0
FR;0;2021-01-30;29114;4317;0;0;0;1674006;49112;1;0;0
FR;0;2021-01-31;5228;1744;0;0;0;1679234;50856;1;0;0
FR;0;2021-02-01;53109;21580;0;0;0;1732343;72436;1;0;0
FR;0;2021-02-02;72285;35877;0;0;0;1804628;108313;1;0;0
FR;0;2021-02-03;72293;38180;0;0;0;1876921;146493;1;0;0
FR;0;2021-02-04;82053;51774;0;0;0;1958974;198267;1;0;0
FR;0;2021-02-05;68217;46135;0;0;0;2027191;244402;1;0;0
FR;0;2021-02-06;23098;10791;0;0;0;2050289;255193;1;0;0
FR;0;2021-02-07;5184;5337;0;0;0;2055473;260530;1;0;0
FR;0;2021-02-08;46820;46980;0;0;0;2102293;307510;1;0;0
FR;0;2021-02-09;65993;74750;0;0;0;2168286;382260;1;0;0
FR;0;2021-02-10;70991;79552;0;0;0;2239277;461812;1;0;0
FR;0;2021-02-11;87243;101576;0;0;0;2326520;563388;1;0;0
FR;0;2021-02-12;79297;75083;0;0;0;2405817;638471;1;0;0
FR;0;2021-02-13;22357;19497;0;0;0;2428174;657968;1;0;0
FR;0;2021-02-14;5071;7288;0;0;0;2433245;665256;1;0;0
FR;0;2021-02-15;38074;76613;0;0;0;2471319;741869;1;0;0
FR;0;2021-02-16;50371;100521;0;0;0;2521690;842390;1;0;0
FR;0;2021-02-17;50507;104729;1;0;0;2572197;947119;2;0;0
FR;0;2021-02-18;69764;120820;0;0;0;2641961;1067939;2;0;0
FR;0;2021-02-19;65053;91135;1;0;0;2707014;1159074;3;0;0
FR;0;2021-02-20;18576;28594;0;0;0;2725590;1187668;3;0;0
FR;0;2021-02-21;3314;6273;0;0;0;2728904;1193941;3;0;0
FR;0;2021-02-22;37486;73216;2;0;0;2766390;1267157;5;0;0
FR;0;2021-02-23;53764;84446;1;0;0;2820154;1351603;6;0;0
FR;0;2021-02-24;59984;81799;1;0;0;2880138;1433402;7;0;0
FR;0;2021-02-25;100547;91456;1;0;0;2980685;1524858;8;0;0
FR;0;2021-02-26;113433;70745;1;0;0;3094118;1595603;9;0;0
FR;0;2021-02-27;52092;22153;0;0;0;3146210;1617756;9;0;0
FR;0;2021-02-28;6193;4246;1;0;0;3152403;1622002;10;0;0
FR;0;2021-03-01;65844;53287;1;0;0;3218247;1675289;11;0;0
FR;0;2021-03-02;101352;66648;2;0;0;3319599;1741937;13;0;0
FR;0;2021-03-03;116475;65562;0;0;0;3436074;1807499;13;0;0
FR;0;2021-03-04;163595;70400;3;0;0;3599669;1877899;16;0;0
FR;0;2021-03-05;200888;63033;3;0;0;3800557;1940932;19;0;0
FR;0;2021-03-06;207933;17708;3;0;0;4008490;1958640;22;0;0
FR;0;2021-03-07;121252;4943;1;0;0;4129742;1963583;23;0;0
FR;0;2021-03-08;107120;50294;2;0;0;4236862;2013877;25;0;0
FR;0;2021-03-09;172423;56439;2;0;0;4409285;2070316;27;0;0
FR;0;2021-03-10;178946;57127;5;0;0;4588231;2127443;32;0;0
FR;0;2021-03-11;242837;63566;2;0;0;4831068;2191009;34;0;0
FR;0;2021-03-12;294782;53367;1;0;0;5125850;2244376;35;0;0
FR;0;2021-03-13;231375;15322;1;0;0;5357225;2259698;36;0;0
FR;0;2021-03-14;63341;3254;1;0;0;5420566;2262952;37;0;0
FR;0;2021-03-15;158612;32135;3;0;0;5579178;2295087;40;0;0
FR;0;2021-03-16;141542;39103;6;0;0;5720720;2334190;46;0;0
FR;0;2021-03-17;150450;38187;4;0;0;5871170;2372377;50;0;0
FR;0;2021-03-18;167792;44555;5;0;0;6038962;2416932;55;0;0
FR;0;2021-03-19;229972;37133;2;0;0;6268934;2454065;57;0;0
FR;0;2021-03-20;166648;11554;1;0;0;6435582;2465619;58;0;0
FR;0;2021-03-21;49922;2484;1;0;0;6485504;2468103;59;0;0
FR;0;2021-03-22;169999;33967;2;0;0;6655503;2502070;61;0;0
FR;0;2021-03-23;250334;42390;1;0;0;6905837;2544460;62;0;0
FR;0;2021-03-24;256865;43639;0;0;0;7162702;2588099;62;0;0
FR;0;2021-03-25;341762;44872;5;0;0;7504464;2632971;67;0;0
FR;0;2021-03-26;358756;41888;4;1;0;7863220;2674859;71;1;0
FR;0;2021-03-27;195241;16735;1;0;0;8058461;2691594;72;1;0
FR;0;2021-03-28;59324;4038;3;0;0;8117785;2695632;75;1;0
FR;0;2021-03-29;202939;53968;4;0;0;8320724;2749600;79;1;0
FR;0;2021-03-30;285438;69663;4;0;0;8606162;2819263;83;1;0
FR;0;2021-03-31;262978;73293;4;0;0;8869140;2892556;87;1;0
FR;0;2021-04-01;315402;89485;12;0;0;9184542;2982041;99;1;0
FR;0;2021-04-02;281289;92856;7;0;0;9465831;3074897;106;1;0
FR;0;2021-04-03;141053;61985;5;0;0;9606884;3136882;111;1;0
FR;0;2021-04-04;46492;18734;2;0;0;9653376;3155616;113;1;0
FR;0;2021-04-05;63312;10785;11;0;0;9716688;3166401;124;1;0
FR;0;2021-04-06;217160;109503;17;0;0;9933848;3275904;141;1;0
FR;0;2021-04-07;260210;115418;17;0;0;10194058;3391322;158;1;0
FR;0;2021-04-08;337752;121851;14;0;0;10531810;3513173;172;1;0
FR;0;2021-04-09;410087;116366;49;0;0;10941897;3629539;221;1;0
FR;0;2021-04-10;212588;82643;15;0;0;11154485;3712182;236;1;0
FR;0;2021-04-11;56125;34418;7;0;0;11210610;3746600;243;1;0
FR;0;2021-04-12;237010;115247;45;0;0;11447620;3861847;288;1;0
FR;0;2021-04-13;309430;144487;98;1;0;11757050;4006334;386;2;0
FR;0;2021-04-14;294455;139330;214;0;0;12051505;4145664;600;2;0
FR;0;2021-04-15;337029;148500;338;0;0;12388534;4294164;938;2;0
FR;0;2021-04-16;339230;145937;353;0;0;12727764;4440101;1291;2;0
FR;0;2021-04-17;188629;89992;109;0;0;12916393;4530093;1400;2;0
FR;0;2021-04-18;51605;35356;47;0;0;12967998;4565449;1447;2;0
FR;0;2021-04-19;205650;138213;456;0;0;13173648;4703662;1903;2;0
FR;0;2021-04-20;254358;170938;569;0;0;13428006;4874600;2472;2;0
FR;0;2021-04-21;253186;169176;834;0;0;13681192;5043776;3306;2;0
FR;0;2021-04-22;287500;188888;818;0;0;13968692;5232664;4124;2;0
FR;0;2021-04-23;297922;183447;747;0;0;14266614;5416111;4871;2;0
FR;0;2021-04-24;190414;111590;252;0;0;14457028;5527701;5123;2;0
FR;0;2021-04-25;69542;38780;51;0;0;14526570;5566481;5174;2;0
FR;0;2021-04-26;220900;156381;560;0;0;14747470;5722862;5734;2;0
FR;0;2021-04-27;284553;187398;940;0;0;15032023;5910260;6674;2;0
FR;0;2021-04-28;299449;183296;1422;1;1;15331472;6093556;8096;3;1
FR;0;2021-04-29;357065;196644;1277;0;0;15688537;6290200;9373;3;1
FR;0;2021-04-30;372151;184903;1119;1;0;16060688;6475103;10492;4;1
FR;0;2021-05-01;167611;52473;178;0;0;16228299;6527576;10670;4;1
FR;0;2021-05-02;91708;37753;83;0;0;16320007;6565329;10753;4;1
FR;0;2021-05-03;288865;168237;840;0;0;16608872;6733566;11593;4;1
FR;0;2021-05-04;315610;224442;1231;0;0;16924482;6958008;12824;4;1
FR;0;2021-05-05;327121;224843;1313;0;0;17251603;7182851;14137;4;1
FR;0;2021-05-06;379441;239503;1630;0;0;17631044;7422354;15767;4;1
FR;0;2021-05-07;372690;257406;1222;0;0;18003734;7679760;16989;4;1
FR;0;2021-05-08;222137;67664;299;0;0;18225871;7747424;17288;4;1
FR;0;2021-05-09;129686;46278;243;0;0;18355557;7793702;17531;4;1
FR;0;2021-05-10;313322;228804;1234;0;0;18668879;8022506;18765;4;1
FR;0;2021-05-11;403835;257837;1562;0;0;19072714;8280343;20327;4;1
FR;0;2021-05-12;434043;233124;1542;0;0;19506757;8513467;21869;4;1
FR;0;2021-05-13;338554;56914;430;0;0;19845311;8570381;22299;4;1
FR;0;2021-05-14;454065;167285;1123;0;0;20299376;8737666;23422;4;1
FR;0;2021-05-15;374926;94075;442;0;0;20674302;8831741;23864;4;1
FR;0;2021-05-16;202727;20764;168;0;0;20877029;8852505;24032;4;1
FR;0;2021-05-17;376075;148843;1552;0;0;21253104;9001348;25584;4;1
FR;0;2021-05-18;460080;153169;1987;0;0;21713184;9154517;27571;4;1
FR;0;2021-05-19;467330;144546;2458;0;0;22180514;9299063;30029;4;1
FR;0;2021-05-20;507467;160253;2333;0;0;22687981;9459316;32362;4;1
FR;0;2021-05-21;489604;174448;1988;0;0;23177585;9633764;34350;4;1
FR;0;2021-05-22;347151;79906;668;0;0;23524736;9713670;35018;4;1
FR;0;2021-05-23;161672;14363;246;0;0;23686408;9728033;35264;4;1
FR;0;2021-05-24;263159;33167;601;0;0;23949567;9761200;35865;4;1
FR;0;2021-05-25;400205;189279;2350;1;0;24349772;9950479;38215;5;1
FR;0;2021-05-26;413401;188659;2220;0;0;24763173;10139138;40435;5;1
FR;0;2021-05-27;449749;218815;2159;0;0;25212922;10357953;42594;5;1
FR;0;2021-05-28;429497;259547;1891;0;0;25642419;10617500;44485;5;1
FR;0;2021-05-29;298951;149442;583;0;0;25941370;10766942;45068;5;1
FR;0;2021-05-30;107123;32576;163;0;0;26048493;10799518;45231;5;1
FR;0;2021-05-31;357987;203304;1466;1;1;26406480;11002822;46697;6;2
FR;0;2021-06-01;430903;251191;1959;1;1;26837383;11254013;48656;7;3
FR;0;2021-06-02;419542;230919;1980;0;0;27256925;11484932;50636;7;3
FR;0;2021-06-03;465037;258396;1821;0;0;27721962;11743328;52457;7;3
FR;0;2021-06-04;455794;304727;1729;1;1;28177756;12048055;54186;8;4
FR;0;2021-06-05;304762;188981;651;0;0;28482518;12237036;54837;8;4
FR;0;2021-06-06;133250;49122;226;0;0;28615768;12286158;55063;8;4
FR;0;2021-06-07;339189;261880;1519;0;0;28954957;12548038;56582;8;4
FR;0;2021-06-08;393616;290900;1800;0;0;29348573;12838938;58382;8;4
FR;0;2021-06-09;384713;275315;1728;0;0;29733286;13114253;60110;8;4
FR;0;2021-06-10;404044;288707;1721;1;0;30137330;13402960;61831;9;4
FR;0;2021-06-11;386569;357113;1462;0;0;30523899;13760073;63293;9;4
FR;0;2021-06-12;283217;211277;490;0;0;30807116;13971350;63783;9;4
FR;0;2021-06-13;104842;73966;204;0;0;30911958;14045316;63987;9;4
FR;0;2021-06-14;240748;355418;1426;1;0;31152706;14400734;65413;10;4
FR;0;2021-06-15;308054;385514;1565;1;0;31460760;14786248;66978;11;4
FR;0;2021-06-16;313858;357707;1416;1;0;31774618;15143955;68394;12;4
FR;0;2021-06-17;317572;372491;1422;1;0;32092190;15516446;69816;13;4
FR;0;2021-06-18;321567;442425;1332;1;0;32413757;15958871;71148;14;4
FR;0;2021-06-19;224312;273802;448;0;0;32638069;16232673;71596;14;4
FR;0;2021-06-20;74374;102580;127;0;0;32712443;16335253;71723;14;4
FR;0;2021-06-21;195579;401890;1033;1;1;32908022;16737143;72756;15;5
FR;0;2021-06-22;223019;467419;1262;10;2;33131041;17204562;74018;25;7
FR;0;2021-06-23;233881;439895;1196;1;1;33364922;17644457;75214;26;8
FR;0;2021-06-24;241739;409578;1351;0;0;33606661;18054035;76565;26;8
FR;0;2021-06-25;227488;522251;1398;0;0;33834149;18576286;77963;26;8
FR;0;2021-06-26;153198;370751;586;1;0;33987347;18947037;78549;27;8
FR;0;2021-06-27;55869;156202;168;1;0;34043216;19103239;78717;28;8
FR;0;2021-06-28;154625;452882;1169;0;0;34197841;19556121;79886;28;8
FR;0;2021-06-29;182553;506851;2124;0;0;34380394;20062972;82010;28;8
FR;0;2021-06-30;203854;482955;2010;21;2;34584248;20545927;84020;49;10
FR;0;2021-07-01;231140;457846;2221;5;1;34815388;21003773;86241;54;11
FR;0;2021-07-02;228377;520208;2119;5;3;35043765;21523981;88360;59;14
FR;0;2021-07-03;141956;368726;909;3;1;35185721;21892707;89269;62;15
FR;0;2021-07-04;56694;141248;265;0;0;35242415;22033955;89534;62;15
FR;0;2021-07-05;168258;419284;1668;8;2;35410673;22453239;91202;70;17
FR;0;2021-07-06;196596;474803;1828;45;8;35607269;22928042;93030;115;25
FR;0;2021-07-07;212990;439304;1877;24;5;35820259;23367346;94907;139;30
FR;0;2021-07-08;231470;424187;2089;20;7;36051729;23791533;96996;159;37
FR;0;2021-07-09;228369;510819;2182;4;2;36280098;24302352;99178;163;39
FR;0;2021-07-10;148542;339898;982;1;1;36428640;24642250;100160;164;40
FR;0;2021-07-11;60152;110143;282;0;0;36488792;24752393;100442;164;40
FR;0;2021-07-12;168981;478190;1757;4;0;36657773;25230583;102199;168;40
FR;0;2021-07-13;287085;527433;2045;8;2;36944858;25758016;104244;176;42
FR;0;2021-07-14;180913;157709;434;0;0;37125771;25915725;104678;176;42
FR;0;2021-07-15;346918;502453;2097;1;0;37472689;26418178;106775;177;42
FR;0;2021-07-16;379932;495922;2021;3;1;37852621;26914100;108796;180;43
FR;0;2021-07-17;259655;319788;876;1;0;38112276;27233888;109672;181;43
FR;0;2021-07-18;109669;114779;310;0;0;38221945;27348667;109982;181;43
FR;0;2021-07-19;285335;424974;1628;3;0;38507280;27773641;111610;184;43
FR;0;2021-07-20;376748;452362;1722;0;0;38884028;28226003;113332;184;43
FR;0;2021-07-21;395644;407864;1549;4;2;39279672;28633867;114881;188;45
FR;0;2021-07-22;440906;388090;1714;4;2;39720578;29021957;116595;192;47
FR;0;2021-07-23;440162;423125;1880;4;2;40160740;29445082;118475;196;49
FR;0;2021-07-24;285186;269603;803;1;0;40445926;29714685;119278;197;49
FR;0;2021-07-25;121059;80047;230;0;0;40566985;29794732;119508;197;49
FR;0;2021-07-26;347287;323162;1615;3;2;40914272;30117894;121123;200;51
FR;0;2021-07-27;463917;320254;1696;4;2;41378189;30438148;122819;204;53
FR;0;2021-07-28;459317;289980;1634;4;2;41837506;30728128;124453;208;55
FR;0;2021-07-29;489694;276895;1794;2;1;42327200;31005023;126247;210;56
FR;0;2021-07-30;461656;302845;1935;5;2;42788856;31307868;128182;215;58
FR;0;2021-07-31;285348;185075;914;1;0;43074204;31492943;129096;216;58
FR;0;2021-08-01;111945;49991;253;0;0;43186149;31542934;129349;216;58
FR;0;2021-08-02;341250;234578;1599;2;0;43527399;31777512;130948;218;58
FR;0;2021-08-03;398438;245037;1718;2;1;43925837;32022549;132666;220;59
FR;0;2021-08-04;384673;210083;1591;6;3;44310510;32232632;134257;226;62
FR;0;2021-08-05;365998;228881;1709;0;0;44676508;32461513;135966;226;62
FR;0;2021-08-06;359593;271660;1834;4;1;45036101;32733173;137800;230;63
FR;0;2021-08-07;213050;178370;755;4;3;45249151;32911543;138555;234;66
FR;0;2021-08-08;74140;63234;270;0;0;45323291;32974777;138825;234;66
FR;0;2021-08-09;258603;259492;1542;4;3;45581894;33234269;140367;238;69
FR;0;2021-08-10;306633;277979;1656;2;1;45888527;33512248;142023;240;70
FR;0;2021-08-11;279576;260207;1441;5;1;46168103;33772455;143464;245;71
FR;0;2021-08-12;271412;278637;1661;3;1;46439515;34051092;145125;248;72
FR;0;2021-08-13;252052;277951;1591;3;2;46691567;34329043;146716;251;74
FR;0;2021-08-14;145294;197328;739;0;0;46836861;34526371;147455;251;74
FR;0;2021-08-15;39316;50125;216;1;0;46876177;34576496;147671;252;74
FR;0;2021-08-16;186058;318117;1539;0;0;47062235;34894613;149210;252;74
FR;0;2021-08-17;215568;336522;1635;7;1;47277803;35231135;150845;259;75
FR;0;2021-08-18;198959;324741;1594;7;4;47476762;35555876;152439;266;79
FR;0;2021-08-19;191918;325784;1636;1;0;47668680;35881660;154075;267;79
FR;0;2021-08-20;186370;366426;1813;3;2;47855050;36248086;155888;270;81
FR;0;2021-08-21;104765;238167;704;0;0;47959815;36486253;156592;270;81
FR;0;2021-08-22;31892;87202;253;1;1;47991707;36573455;156845;271;82
FR;0;2021-08-23;140904;357264;1560;3;1;48132611;36930719;158405;274;83
FR;0;2021-08-24;162411;376905;1847;5;1;48295022;37307624;160252;279;84
FR;0;2021-08-25;151071;350876;2028;8;3;48446093;37658500;162280;287;87
FR;0;2021-08-26;142769;342889;2555;10;1;48588862;38001389;164835;297;88
FR;0;2021-08-27;148375;388273;2789;11;3;48737237;38389662;167624;308;91
FR;0;2021-08-28;90617;249581;1405;0;0;48827854;38639243;169029;308;91
FR;0;2021-08-29;27303;83338;516;1;0;48855157;38722581;169545;309;91
FR;0;2021-08-30;117337;324885;4706;6;6018;48972494;39047466;174251;315;6109
FR;0;2021-08-31;128721;334639;10179;19;11858;49101215;39382105;184430;334;17967
FR;0;2021-09-01;135813;285707;22421;7;24318;49237028;39667812;206851;341;42285
FR;0;2021-09-02;112688;247294;26512;13;28883;49349716;39915106;233363;354;71168
FR;0;2021-09-03;118220;292726;29956;23;32970;49467936;40207832;263319;377;104138
FR;0;2021-09-04;89838;217746;12583;12;14083;49557774;40425578;275902;389;118221
FR;0;2021-09-05;21346;44861;4391;2;4733;49579120;40470439;280293;391;122954
FR;0;2021-09-06;75346;180781;31946;16;34234;49654466;40651220;312239;407;157188
FR;0;2021-09-07;80142;181270;33238;40;36125;49734608;40832490;345477;447;193313
FR;0;2021-09-08;90010;206215;29654;27;32462;49824618;41038705;375131;474;225775
FR;0;2021-09-09;76728;165434;33043;26;36529;49901346;41204139;408174;500;262304
FR;0;2021-09-10;95716;203713;35718;26;40524;49997062;41407852;443892;526;302828
FR;0;2021-09-11;66874;169236;12135;19;14321;50063936;41577088;456027;545;317149
FR;0;2021-09-12;12802;32086;2768;1;3160;50076738;41609174;458795;546;320309
FR;0;2021-09-13;64398;126364;41209;32;44084;50141136;41735538;500004;578;364393
FR;0;2021-09-14;73361;129142;56349;78;62087;50214497;41864680;556353;656;426480
FR;0;2021-09-15;76438;167896;55631;58;54780;50290935;42032576;611984;714;481260
FR;0;2021-09-16;63776;114570;60036;85;60035;50354711;42147146;672020;799;541295
FR;0;2021-09-17;74996;156846;53830;71;57245;50429707;42303992;725850;870;598540
FR;0;2021-09-18;48202;139595;15597;25;17285;50477909;42443587;741447;895;615825
FR;0;2021-09-19;7869;23716;2435;1;2619;50485778;42467303;743882;896;618444
FR;0;2021-09-20;44465;93934;50029;73;50262;50530243;42561237;793911;969;668706
FR;0;2021-09-21;45818;98455;62733;76;63390;50576061;42659692;856644;1045;732096
FR;0;2021-09-22;48624;142323;55335;83;55362;50624685;42802015;911979;1128;787458
FR;0;2021-09-23;43204;92028;62358;94;63478;50667889;42894043;974337;1222;850936
FR;0;2021-09-24;52239;133326;54531;109;59112;50720128;43027369;1028868;1331;910048
FR;0;2021-09-25;35196;115529;16266;37;18259;50755324;43142898;1045134;1368;928307
FR;0;2021-09-26;5527;17801;2266;5;2327;50760851;43160699;1047400;1373;930634
FR;0;2021-09-27;33929;76972;47179;97;48146;50794780;43237671;1094579;1470;978780
FR;0;2021-09-28;36457;75282;54938;88;56497;50831237;43312953;1149517;1558;1035277
FR;0;2021-09-29;44322;100836;53323;112;54816;50875559;43413789;1202840;1670;1090093
FR;0;2021-09-30;36278;72849;57011;96;59490;50911837;43486638;1259851;1766;1149583
FR;0;2021-10-01;61546;100928;57782;108;63707;50973383;43587566;1317633;1874;1213290
FR;0;2021-10-02;39427;78379;20953;38;23321;51012810;43665945;1338586;1912;1236611
FR;0;2021-10-03;5273;10527;2524;4;2538;51018083;43676472;1341110;1916;1239149
FR;0;2021-10-04;35006;58563;52610;84;54783;51053089;43735035;1393720;2000;1293932
FR;0;2021-10-05;33655;64343;60969;135;64939;51086744;43799378;1454689;2135;1358871
FR;0;2021-10-06;42513;79291;65694;113;68235;51129257;43878669;1520383;2248;1427106
FR;0;2021-10-07;30442;62181;65385;90;68678;51159699;43940850;1585768;2338;1495784
FR;0;2021-10-08;48773;91832;77721;110;84623;51208472;44032682;1663489;2448;1580407
FR;0;2021-10-09;33635;60902;31526;36;33872;51242107;44093584;1695015;2484;1614279
FR;0;2021-10-10;4648;7446;3187;9;3483;51246755;44101030;1698202;2493;1617762
FR;0;2021-10-11;30586;49885;61020;105;64018;51277341;44150915;1759222;2598;1681780
FR;0;2021-10-12;31444;54434;70567;139;75840;51308785;44205349;1829789;2737;1757620
FR;0;2021-10-13;40030;62814;74401;136;79259;51348815;44268163;1904190;2873;1836879
FR;0;2021-10-14;30253;52916;68726;116;73766;51379068;44321079;1972916;2989;1910645
FR;0;2021-10-15;44748;75281;93218;191;102906;51423816;44396360;2066134;3180;2013551
FR;0;2021-10-16;31281;44094;36685;44;39615;51455097;44440454;2102819;3224;2053166
FR;0;2021-10-17;3830;5269;3592;2;3690;51458927;44445723;2106411;3226;2056856
FR;0;2021-10-18;28435;42473;67472;133;71339;51487362;44488196;2173883;3359;2128195
FR;0;2021-10-19;27062;44715;76382;140;81607;51514424;44532911;2250265;3499;2209802
FR;0;2021-10-20;35219;52487;96910;180;101480;51549643;44585398;2347175;3679;2311282
FR;0;2021-10-21;25977;45202;83924;112;89108;51575620;44630600;2431099;3791;2400390
FR;0;2021-10-22;38220;62415;104868;200;112501;51613840;44693015;2535967;3991;2512891
FR;0;2021-10-23;26976;41239;45438;57;48604;51640816;44734254;2581405;4048;2561495
FR;0;2021-10-24;2913;4798;3679;6;3936;51643729;44739052;2585084;4054;2565431
FR;0;2021-10-25;25983;36339;82309;144;86606;51669712;44775391;2667393;4198;2652037
FR;0;2021-10-26;23696;35101;87210;166;92315;51693408;44810492;2754603;4364;2744352
FR;0;2021-10-27;30023;46428;108969;257;114625;51723431;44856920;2863572;4621;2858977
FR;0;2021-10-28;23453;34915;88661;153;94399;51746884;44891835;2952233;4774;2953376
FR;0;2021-10-29;31525;51419;117287;204;125266;51778409;44943254;3069520;4978;3078642
FR;0;2021-10-30;20536;33189;50325;77;53357;51798945;44976443;3119845;5055;3131999
FR;0;2021-10-31;2480;3756;3585;3;3870;51801425;44980199;3123430;5058;3135869
FR;0;2021-11-01;8238;4824;3203;3;3557;51809663;44985023;3126633;5061;3139426
FR;0;2021-11-02;25359;40095;93538;157;99487;51835022;45025118;3220171;5218;3238913
FR;0;2021-11-03;29808;47944;118848;218;125792;51864830;45073062;3339019;5436;3364705
FR;0;2021-11-04;23685;37516;107506;217;114338;51888515;45110578;3446525;5653;3479043
FR;0;2021-11-05;32297;52925;141594;234;151265;51920812;45163503;3588119;5887;3630308
FR;0;2021-11-06;21498;34572;64846;123;68237;51942310;45198075;3652965;6010;3698545
FR;0;2021-11-07;2380;4223;5180;6;5589;51944690;45202298;3658145;6016;3704134
FR;0;2021-11-08;20475;37835;127146;227;134204;51965165;45240133;3785291;6243;3838338
FR;0;2021-11-09;22204;44808;161637;341;172144;51987369;45284941;3946928;6584;4010482
FR;0;2021-11-10;31419;55132;186937;446;198699;52018788;45340073;4133865;7030;4209181
FR;0;2021-11-11;4382;6750;12934;28;13933;52023170;45346823;4146799;7058;4223114
FR;0;2021-11-12;29005;55138;183725;252;197272;52052175;45401961;4330524;7310;4420386
FR;0;2021-11-13;20320;32726;80678;118;86298;52072495;45434687;4411202;7428;4506684
FR;0;2021-11-14;2338;3932;7165;6;7868;52074833;45438619;4418367;7434;4514552
FR;0;2021-11-15;20380;38781;160798;313;171471;52095213;45477400;4579165;7747;4686023
FR;0;2021-11-16;23420;44068;200326;391;214901;52118633;45521468;4779491;8138;4900924
FR;0;2021-11-17;30384;50471;199783;407;212799;52149017;45571939;4979274;8545;5113723
FR;0;2021-11-18;23368;45108;191584;468;205416;52172385;45617047;5170858;9013;5319139
FR;0;2021-11-19;33564;61398;243138;548;262071;52205949;45678445;5413996;9561;5581210
FR;0;2021-11-20;25368;36788;102121;206;109672;52231317;45715233;5516117;9767;5690882
FR;0;2021-11-21;2623;4557;9643;18;10639;52233940;45719790;5525760;9785;5701521
FR;0;2021-11-22;22745;33363;180296;470;194766;52256685;45753153;5706056;10255;5896287
FR;0;2021-11-23;25577;45718;229307;548;247730;52282262;45798871;5935363;10803;6144017
FR;0;2021-11-24;31772;53847;224740;717;243150;52314034;45852718;6160103;11520;6387167
FR;0;2021-11-25;25436;49185;255844;739;277627;52339470;45901903;6415947;12259;6664794
FR;0;2021-11-26;33217;74699;379394;864;414518;52372687;45976602;6795341;13123;7079312
FR;0;2021-11-27;23344;49734;214855;389;236593;52396031;46026336;7010196;13512;7315905
FR;0;2021-11-28;3481;10585;56732;66;63340;52399512;46036921;7066928;13578;7379245
FR;0;2021-11-29;19390;54251;341389;863;371569;52418902;46091172;7408317;14441;7750814
FR;0;2021-11-30;24735;72167;457295;988;500655;52443637;46163339;7865612;15429;8251469
FR;0;2021-12-01;26945;75974;468986;1159;511200;52470582;46239313;8334598;16588;8762669
FR;0;2021-12-02;22012;71849;526991;1280;574718;52492594;46311162;8861589;17868;9337387
FR;0;2021-12-03;25502;92563;596254;1419;651002;52518096;46403725;9457843;19287;9988389
FR;0;2021-12-04;18302;60544;336171;690;369705;52536398;46464269;9794014;19977;10358094
FR;0;2021-12-05;4144;16262;95754;157;107058;52540542;46480531;9889768;20134;10465152
FR;0;2021-12-06;24436;73222;493039;1174;539858;52564978;46553753;10382807;21308;11005010
FR;0;2021-12-07;23346;91803;645262;1769;706195;52588324;46645556;11028069;23077;11711205
FR;0;2021-12-08;25365;92504;591462;1873;647395;52613689;46738060;11619531;24950;12358600
FR;0;2021-12-09;24008;94359;662963;2179;726228;52637697;46832419;12282494;27129;13084828
FR;0;2021-12-10;27897;111172;735937;2076;805995;52665594;46943591;13018431;29205;13890823
FR;0;2021-12-11;20229;76100;435125;986;480336;52685823;47019691;13453556;30191;14371159
FR;0;2021-12-12;5625;23289;142270;262;159217;52691448;47042980;13595826;30453;14530376
FR;0;2021-12-13;21242;91363;587523;1698;649195;52712690;47134343;14183349;32151;15179571
FR;0;2021-12-14;27694;118763;765386;2652;847385;52740384;47253106;14948735;34803;16026956
FR;0;2021-12-15;28273;114636;694185;2263;768938;52768657;47367742;15642920;37066;16795894
FR;0;2021-12-16;27959;116075;763888;2555;844270;52796616;47483817;16406808;39621;17640164
FR;0;2021-12-17;31576;128820;807736;2709;891998;52828192;47612637;17214544;42330;18532162
FR;0;2021-12-18;24920;81786;469912;1178;522162;52853112;47694423;17684456;43508;19054324
FR;0;2021-12-19;8748;28841;169355;377;191129;52861860;47723264;17853811;43885;19245453
FR;0;2021-12-20;31658;97599;591349;1787;658637;52893518;47820863;18445160;45672;19904090
FR;0;2021-12-21;39237;112409;682307;2391;759477;52932755;47933272;19127467;48063;20663567
FR;0;2021-12-22;39476;99693;575659;2167;642054;52972231;48032965;19703126;50230;21305621
FR;0;2021-12-23;33751;79767;440903;1654;494323;53005982;48112732;20144029;51884;21799944
FR;0;2021-12-24;10669;26082;110979;396;126648;53016651;48138814;20255008;52280;21926592
FR;0;2021-12-25;770;3530;7573;25;9029;53017421;48142344;20262581;52305;21935621
FR;0;2021-12-26;4698;11908;52075;141;60129;53022119;48154252;20314656;52446;21995750
FR;0;2021-12-27;30416;84111;453451;1366;509083;53052535;48238363;20768107;53812;22504833
FR;0;2021-12-28;38323;99113;564079;1767;632180;53090858;48337476;21332186;55579;23137013
FR;0;2021-12-29;39850;88480;501121;1686;560932;53130708;48425956;21833307;57265;23697945
FR;0;2021-12-30;35893;75169;420967;1519;471100;53166601;48501125;22254274;58784;24169045
FR;0;2021-12-31;12039;25216;116839;406;131621;53178640;48526341;22371113;59190;24300666
FR;0;2022-01-01;1440;3206;8500;36;9931;53180080;48529547;22379613;59226;24310597
FR;0;2022-01-02;6089;13017;58401;125;66943;53186169;48542564;22438014;59351;24377540
FR;0;2022-01-03;33690;90033;494708;1593;551522;53219859;48632597;22932722;60944;24929062
FR;0;2022-01-04;41230;110981;641285;2303;714253;53261089;48743578;23574007;63247;25643315
FR;0;2022-01-05;60559;103461;569050;1984;634073;53321648;48847039;24143057;65231;26277388
FR;0;2022-01-06;44114;110223;638894;2694;711353;53365762;48957262;24781951;67925;26988741
FR;0;2022-01-07;50716;123170;710915;2807;790360;53416478;49080432;25492866;70732;27779101
FR;0;2022-01-08;44979;80337;423783;1210;472854;53461457;49160769;25916649;71942;28251955
FR;0;2022-01-09;15597;26693;128549;300;145689;53477054;49187462;26045198;72242;28397644
FR;0;2022-01-10;35184;90102;469208;1810;522343;53512238;49277564;26514406;74052;28919987
FR;0;2022-01-11;41701;100389;548141;2307;608419;53553939;49377953;27062547;76359;29528406
FR;0;2022-01-12;60237;95613;452574;1965;504236;53614176;49473566;27515121;78324;30032642
FR;0;2022-01-13;38063;92431;487259;2083;540967;53652239;49565997;28002380;80407;30573609
FR;0;2022-01-14;42470;103313;568493;2286;628957;53694709;49669310;28570873;82693;31202566
FR;0;2022-01-15;39351;65875;340096;985;377556;53734060;49735185;28910969;83678;31580122
FR;0;2022-01-16;11385;19298;87388;216;99448;53745445;49754483;28998357;83894;31679570
FR;0;2022-01-17;24639;60127;320217;1381;354137;53770084;49814610;29318574;85275;32033707
FR;0;2022-01-18;28128;68615;361006;1799;397513;53798212;49883225;29679580;87074;32431220
FR;0;2022-01-19;43119;67110;281217;1450;311058;53841331;49950335;29960797;88524;32742278
FR;0;2022-01-20;23497;59573;298919;1741;328448;53864828;50009908;30259716;90265;33070726
FR;0;2022-01-21;28075;68805;366285;2086;401133;53892903;50078713;30626001;92351;33471859
FR;0;2022-01-22;27608;47998;218764;838;241749;53920511;50126711;30844765;93189;33713608
FR;0;2022-01-23;6706;13037;48650;171;55174;53927217;50139748;30893415;93360;33768782
FR;0;2022-01-24;16213;47412;217250;1136;239322;53943430;50187160;31110665;94496;34008104
FR;0;2022-01-25;18919;54401;242982;1547;267043;53962349;50241561;31353647;96043;34275147
FR;0;2022-01-26;28126;60294;209224;1296;229368;53990475;50301855;31562871;97339;34504515
FR;0;2022-01-27;16292;46100;207586;1272;225833;54006767;50347955;31770457;98611;34730348
FR;0;2022-01-28;21503;76259;289990;1574;321444;54028270;50424214;32060447;100185;35051792
FR;0;2022-01-29;18408;52850;184090;686;204576;54046678;50477064;32244537;100871;35256368
FR;0;2022-01-30;4464;14538;39126;124;45088;54051142;50491602;32283663;100995;35301456
FR;0;2022-01-31;11227;43860;148158;738;164793;54062369;50535462;32431821;101733;35466249
FR;0;2022-02-01;12949;48193;174068;1141;191370;54075318;50583655;32605889;102874;35657619
FR;0;2022-02-02;20140;65966;171472;1033;190133;54095458;50649621;32777361;103907;35847752
FR;0;2022-02-03;11012;44256;157491;984;173298;54106470;50693877;32934852;104891;36021050
FR;0;2022-02-04;14526;66503;239179;1262;264163;54120996;50760380;33174031;106153;36285213
FR;0;2022-02-05;12837;51458;153523;522;172343;54133833;50811838;33327554;106675;36457556
FR;0;2022-02-06;2706;12227;28870;101;33824;54136539;50824065;33356424;106776;36491380
FR;0;2022-02-07;9435;46737;156826;586;176325;54145974;50870802;33513250;107362;36667705
FR;0;2022-02-08;9625;42777;166565;868;184339;54155599;50913579;33679815;108230;36852044
FR;0;2022-02-09;14196;57984;172298;869;192979;54169795;50971563;33852113;109099;37045023
FR;0;2022-02-10;8283;38515;150160;878;166614;54178078;51010078;34002273;109977;37211637
FR;0;2022-02-11;10771;55518;218445;1098;243023;54188849;51065596;34220718;111075;37454660
FR;0;2022-02-12;8355;40889;134696;461;151713;54197204;51106485;34355414;111536;37606373
FR;0;2022-02-13;1896;8582;26552;85;30908;54199100;51115067;34381966;111621;37637281
FR;0;2022-02-14;6917;35136;148321;478;166318;54206017;51150203;34530287;112099;37803599
FR;0;2022-02-15;6866;35572;146916;750;162473;54212883;51185775;34677203;112849;37966072
FR;0;2022-02-16;9309;42759;132487;719;146687;54222192;51228534;34809690;113568;38112759
FR;0;2022-02-17;5388;24005;87257;584;94808;54227580;51252539;34896947;114152;38207567
FR;0;2022-02-18;6922;33390;119605;804;129271;54234502;51285929;35016552;114956;38336838
FR;0;2022-02-19;5357;24482;70008;370;77313;54239859;51310411;35086560;115326;38414151
FR;0;2022-02-20;1138;4620;12152;38;13926;54240997;51315031;35098712;115364;38428077
FR;0;2022-02-21;4030;17786;61919;351;67146;54245027;51332817;35160631;115715;38495223
FR;0;2022-02-22;4379;18516;60786;575;64417;54249406;51351333;35221417;116290;38559640
FR;0;2022-02-23;6518;27232;66470;591;71870;54255924;51378565;35287887;116881;38631510
FR;0;2022-02-24;3755;15266;50384;518;53201;54259679;51393831;35338271;117399;38684711
FR;0;2022-02-25;5214;23729;76285;803;80009;54264893;51417560;35414556;118202;38764720
FR;0;2022-02-26;3973;17703;47393;358;51458;54268866;51435263;35461949;118560;38816178
FR;0;2022-02-27;870;2988;8023;47;8934;54269736;51438251;35469972;118607;38825112
FR;0;2022-02-28;3073;12318;40452;354;42886;54272809;51450569;35510424;118961;38867998
FR;0;2022-03-01;3204;12264;44140;433;44776;54276013;51462833;35554564;119394;38912774
FR;0;2022-03-02;5106;17506;47092;438;49003;54281119;51480339;35601656;119832;38961777
FR;0;2022-03-03;2693;8979;29835;363;29932;54283812;51489318;35631491;120195;38991709
FR;0;2022-03-04;3191;12220;40264;650;39397;54287003;51501538;35671755;120845;39031106
FR;0;2022-03-05;3037;9215;24935;310;25086;54290040;51510753;35696690;121155;39056192
FR;0;2022-03-06;510;1383;3193;43;3431;54290550;51512136;35699883;121198;39059623
FR;0;2022-03-07;2063;5494;18402;314;17664;54292613;51517630;35718285;121512;39077287
FR;0;2022-03-08;1986;5917;19413;359;17874;54294599;51523547;35737698;121871;39095161
FR;0;2022-03-09;3465;10315;22152;405;21233;54298064;51533862;35759850;122276;39116394
FR;0;2022-03-10;1720;5282;16916;342;15722;54299784;51539144;35776766;122618;39132116
FR;0;2022-03-11;2346;7316;24476;540;22236;54302130;51546460;35801242;123158;39154352
FR;0;2022-03-12;2656;6718;17151;304;16502;54304786;51553178;35818393;123462;39170854
FR;0;2022-03-13;387;783;2309;145;2260;54305173;51553961;35820702;123607;39173114
FR;0;2022-03-14;1473;4170;14940;4404;13795;54306646;51558131;35835642;128011;39186909
FR;0;2022-03-15;1601;4405;16246;7549;14352;54308247;51562536;35851888;135560;39201261
FR;0;2022-03-16;2949;7102;19384;13128;18048;54311196;51569638;35871272;148688;39219309
FR;0;2022-03-17;1377;3745;13098;10836;11939;54312573;51573383;35884370;159524;39231248
FR;0;2022-03-18;2207;5551;19952;18277;18040;54314780;51578934;35904322;177801;39249288
FR;0;2022-03-19;2283;4724;13107;9396;12408;54317063;51583658;35917429;187197;39261696
FR;0;2022-03-20;293;710;1913;1066;1922;54317356;51584368;35919342;188263;39263618
FR;0;2022-03-21;1344;3143;12697;14929;11918;54318700;51587511;35932039;203192;39275536
FR;0;2022-03-22;1465;3598;13760;20518;12516;54320165;51591109;35945799;223710;39288052
FR;0;2022-03-23;2644;6118;17669;23134;17176;54322809;51597227;35963468;246844;39305228
FR;0;2022-03-24;1357;2937;11553;17571;10624;54324166;51600164;35975021;264415;39315852
FR;0;2022-03-25;2049;4855;18511;27740;16840;54326215;51605019;35993532;292155;39332692
FR;0;2022-03-26;2218;4352;12063;12658;11500;54328433;51609371;36005595;304813;39344192
FR;0;2022-03-27;354;681;1892;1479;1925;54328787;51610052;36007487;306292;39346117
FR;0;2022-03-28;1415;3002;11094;17452;10585;54330202;51613054;36018581;323744;39356702
FR;0;2022-03-29;1424;3235;12878;27531;12022;54331626;51616289;36031459;351275;39368724
FR;0;2022-03-30;2814;5379;15637;27343;15032;54334440;51621668;36047096;378618;39383756
FR;0;2022-03-31;1599;3185;12930;24886;12260;54336039;51624853;36060026;403504;39396016
FR;0;2022-04-01;2111;4319;19992;30815;18606;54338150;51629172;36080018;434319;39414622
FR;0;2022-04-02;1498;2614;9034;10101;8695;54339648;51631786;36089052;444420;39423317
FR;0;2022-04-03;275;499;1557;1168;1573;54339923;51632285;36090609;445588;39424890
FR;0;2022-04-04;1386;2595;12299;19070;11484;54341309;51634880;36102908;464658;39436374
FR;0;2022-04-05;1599;2946;14269;33984;13115;54342908;51637826;36117177;498642;39449489
FR;0;2022-04-06;2042;3659;13464;26335;12719;54344950;51641485;36130641;524977;39462208
FR;0;2022-04-07;1433;2887;13597;33668;12804;54346383;51644372;36144238;558645;39475012
FR;0;2022-04-08;2019;4075;19139;43656;17756;54348402;51648447;36163377;602301;39492768
FR;0;2022-04-09;1347;2651;9295;13542;8842;54349749;51651098;36172672;615843;39501610
FR;0;2022-04-10;278;562;1971;1992;1980;54350027;51651660;36174643;617835;39503590
FR;0;2022-04-11;1192;2461;11824;23643;11427;54351219;51654121;36186467;641478;39515017
FR;0;2022-04-12;1573;2778;13935;40599;13309;54352792;51656899;36200402;682077;39528326
FR;0;2022-04-13;1858;3437;13330;32793;12927;54354650;51660336;36213732;714870;39541253
FR;0;2022-04-14;1439;2677;13091;36005;12937;54356089;51663013;36226823;750875;39554190
FR;0;2022-04-15;1789;3296;15529;35299;14772;54357878;51666309;36242352;786174;39568962
FR;0;2022-04-16;1032;1812;6369;8517;6221;54358910;51668121;36248721;794691;39575183
FR;0;2022-04-17;185;317;991;1163;1030;54359095;51668438;36249712;795854;39576213
FR;0;2022-04-18;154;448;2742;1050;2760;54359249;51668886;36252454;796904;39578973
FR;0;2022-04-19;1475;2912;12859;29429;12364;54360724;51671798;36265313;826333;39591337
FR;0;2022-04-20;1914;3340;13215;28847;12882;54362638;51675138;36278528;855180;39604219
FR;0;2022-04-21;1476;2738;12449;34802;12469;54364114;51677876;36290977;889982;39616688
FR;0;2022-04-22;1826;3472;16405;37448;15775;54365940;51681348;36307382;927430;39632463
FR;0;2022-04-23;1126;2038;7365;10640;7215;54367066;51683386;36314747;938070;39639678
FR;0;2022-04-24;246;442;1470;1579;1404;54367312;51683828;36316217;939649;39641082
FR;0;2022-04-25;1260;2450;10652;20896;10443;54368572;51686278;36326869;960545;39651525
FR;0;2022-04-26;1569;2951;13609;38330;13054;54370141;51689229;36340478;998875;39664579
FR;0;2022-04-27;1912;3004;11458;30563;11512;54372053;51692233;36351936;1029438;39676091
FR;0;2022-04-28;1522;2646;12458;35770;12174;54373575;51694879;36364394;1065208;39688265
FR;0;2022-04-29;1954;3439;15469;36892;14818;54375529;51698318;36379863;1102100;39703083
FR;0;2022-04-30;1185;1800;6883;9672;6714;54376714;51700118;36386746;1111772;39709797
FR;0;2022-05-01;188;301;890;961;886;54376902;51700419;36387636;1112733;39710683
FR;0;2022-05-02;1186;2186;11021;17847;10795;54378088;51702605;36398657;1130580;39721478
FR;0;2022-05-03;1741;2898;13520;34294;13351;54379829;51705503;36412177;1164874;39734829
FR;0;2022-05-04;1814;2965;11951;25326;12052;54381643;51708468;36424128;1190200;39746881
FR;0;2022-05-05;1620;2636;12484;33047;12272;54383263;51711104;36436612;1223247;39759153
FR;0;2022-05-06;2050;3511;15185;36438;14653;54385313;51714615;36451797;1259685;39773806
FR;0;2022-05-07;1181;1756;6410;9583;6399;54386494;51716371;36458207;1269268;39780205
FR;0;2022-05-08;257;387;1164;1529;1221;54386751;51716758;36459371;1270797;39781426
FR;0;2022-05-09;1253;2124;9848;19985;9710;54388004;51718882;36469219;1290782;39791136
FR;0;2022-05-10;1635;2862;13341;38536;12874;54389639;51721744;36482560;1329318;39804010
FR;0;2022-05-11;1927;2702;10617;27600;10518;54391566;51724446;36493177;1356918;39814528
FR;0;2022-05-12;1511;2493;11142;35185;10770;54393077;51726939;36504319;1392103;39825298
FR;0;2022-05-13;1920;3095;13616;37525;13193;54394997;51730034;36517935;1429628;39838491
FR;0;2022-05-14;1123;1588;5876;10698;5726;54396120;51731622;36523811;1440326;39844217
FR;0;2022-05-15;265;415;1243;1428;1321;54396385;51732037;36525054;1441754;39845538
FR;0;2022-05-16;1146;1921;8554;20752;8540;54397531;51733958;36533608;1462506;39854078
FR;0;2022-05-17;1527;2487;11692;37339;11271;54399058;51736445;36545300;1499845;39865349
FR;0;2022-05-18;1735;2512;9448;26878;9418;54400793;51738957;36554748;1526723;39874767
FR;0;2022-05-19;1378;2512;10393;35072;10435;54402171;51741469;36565141;1561795;39885202
FR;0;2022-05-20;1828;2976;13101;39010;12599;54403999;51744445;36578242;1600805;39897801
FR;0;2022-05-21;1130;1665;5617;9769;5482;54405129;51746110;36583859;1610574;39903283
FR;0;2022-05-22;227;322;1004;1383;985;54405356;51746432;36584863;1611957;39904268
FR;0;2022-05-23;1107;1958;8745;19943;8659;54406463;51748390;36593608;1631900;39912927
FR;0;2022-05-24;1484;2671;11179;38027;11004;54407947;51751061;36604787;1669927;39923931
FR;0;2022-05-25;1760;2719;9171;24463;9277;54409707;51753780;36613958;1694390;39933208
FR;0;2022-05-26;168;309;1256;1115;1293;54409875;51754089;36615214;1695505;39934501
FR;0;2022-05-27;1315;2294;8524;21127;8299;54411190;51756383;36623738;1716632;39942800
FR;0;2022-05-28;644;1223;3729;6752;3800;54411834;51757606;36627467;1723384;39946600
FR;0;2022-05-29;140;303;739;905;755;54411974;51757909;36628206;1724289;39947355
FR;0;2022-05-30;972;1869;6767;18953;6742;54412946;51759778;36634973;1743242;39954097
FR;0;2022-05-31;1442;2359;9612;35199;9452;54414388;51762137;36644585;1778441;39963549
FR;0;2022-06-01;1511;2561;8641;23857;8507;54415899;51764698;36653226;1802298;39972056
FR;0;2022-06-02;1349;2376;9451;34916;9032;54417248;51767074;36662677;1837214;39981088
FR;0;2022-06-03;1583;2863;10978;38300;10529;54418831;51769937;36673655;1875514;39991617
FR;0;2022-06-04;913;1464;4373;8964;4463;54419744;51771401;36678028;1884478;39996080
FR;0;2022-06-05;148;307;805;1049;813;54419892;51771708;36678833;1885527;39996893
FR;0;2022-06-06;155;292;1103;1160;1105;54420047;51772000;36679936;1886687;39997998
FR;0;2022-06-07;1282;2455;9100;35040;8683;54421329;51774455;36689036;1921727;40006681
FR;0;2022-06-08;1475;2493;7903;28214;7718;54422804;51776948;36696939;1949941;40014399
FR;0;2022-06-09;1219;2232;8647;38660;8295;54424023;51779180;36705586;1988601;40022694
FR;0;2022-06-10;1511;2658;10633;44051;10259;54425534;51781838;36716219;2032652;40032953
FR;0;2022-06-11;894;1629;4737;11463;4782;54426428;51783467;36720956;2044115;40037735
FR;0;2022-06-12;165;392;961;1696;1021;54426593;51783859;36721917;2045811;40038756
FR;0;2022-06-13;995;1799;6014;22584;5888;54427588;51785658;36727931;2068395;40044644
FR;0;2022-06-14;1197;2232;9059;43595;8466;54428785;51787890;36736990;2111990;40053110
FR;0;2022-06-15;1342;2089;7169;29422;6943;54430127;51789979;36744159;2141412;40060053
