fra;vaccin;jour;n_dose1;n_dose2;n_dose3;n_dose4;n_rappel;n_cum_dose1;n_cum_dose2;n_cum_dose3;n_cum_dose4;n_cum_rappel
FR;1;2020-12-27;595;0;0;0;0;595;0;0;0;0
FR;1;2020-12-28;649;0;0;0;0;1244;0;0;0;0
FR;1;2020-12-29;368;0;0;0;0;1612;0;0;0;0
FR;1;2020-12-30;433;0;0;0;0;2045;0;0;0;0
FR;1;2020-12-31;360;0;0;0;0;2405;0;0;0;0
FR;1;2021-01-01;1108;0;0;0;0;3513;0;0;0;0
FR;1;2021-01-02;348;1;0;0;0;3861;1;0;0;0
FR;1;2021-01-03;394;0;0;0;0;4255;1;0;0;0
FR;1;2021-01-04;2074;0;0;0;0;6329;1;0;0;0
FR;1;2021-01-05;6838;2;0;0;0;13167;3;0;0;0
FR;1;2021-01-06;12277;5;0;0;0;25444;8;0;0;0
FR;1;2021-01-07;29430;3;0;0;0;54874;11;0;0;0
FR;1;2021-01-08;37106;2;0;0;0;91980;13;0;0;0
FR;1;2021-01-09;11206;2;0;0;0;103186;15;0;0;0
FR;1;2021-01-10;5987;0;0;0;0;109173;15;0;0;0
FR;1;2021-01-11;39914;7;0;0;0;149087;22;0;0;0
FR;1;2021-01-12;62097;7;0;0;0;211184;29;0;0;0
FR;1;2021-01-13;65038;16;0;0;0;276222;45;0;0;0
FR;1;2021-01-14;81422;24;0;0;0;357644;69;0;0;0
FR;1;2021-01-15;68578;7;0;0;0;426222;76;0;0;0
FR;1;2021-01-16;19891;75;0;0;0;446113;151;0;0;0
FR;1;2021-01-17;10895;45;0;0;0;457008;196;0;0;0
FR;1;2021-01-18;82737;168;0;0;0;539745;364;0;0;0
FR;1;2021-01-19;125882;143;0;0;0;665627;507;0;0;0
FR;1;2021-01-20;132355;167;0;0;0;797982;674;0;0;0
FR;1;2021-01-21;153015;143;0;0;0;950997;817;0;0;0
FR;1;2021-01-22;115904;177;0;0;0;1066901;994;0;0;0
FR;1;2021-01-23;36591;56;0;0;0;1103492;1050;0;0;0
FR;1;2021-01-24;9577;48;0;0;0;1113069;1098;0;0;0
FR;1;2021-01-25;74394;1228;0;0;0;1187463;2326;0;0;0
FR;1;2021-01-26;96419;3157;1;0;0;1283882;5483;1;0;0
FR;1;2021-01-27;103613;5716;0;0;0;1387495;11199;1;0;0
FR;1;2021-01-28;120565;14456;0;0;0;1508060;25655;1;0;0
FR;1;2021-01-29;88861;17382;0;0;0;1596921;43037;1;0;0
FR;1;2021-01-30;27970;4223;0;0;0;1624891;47260;1;0;0
FR;1;2021-01-31;5174;1714;0;0;0;1630065;48974;1;0;0
FR;1;2021-02-01;49686;21095;0;0;0;1679751;70069;1;0;0
FR;1;2021-02-02;67774;34714;0;0;0;1747525;104783;1;0;0
FR;1;2021-02-03;67039;37110;0;0;0;1814564;141893;1;0;0
FR;1;2021-02-04;77088;50214;0;0;0;1891652;192107;1;0;0
FR;1;2021-02-05;63394;45439;0;0;0;1955046;237546;1;0;0
FR;1;2021-02-06;19391;10511;0;0;0;1974437;248057;1;0;0
FR;1;2021-02-07;3652;5041;0;0;0;1978089;253098;1;0;0
FR;1;2021-02-08;36474;46146;0;0;0;2014563;299244;1;0;0
FR;1;2021-02-09;50777;72591;0;0;0;2065340;371835;1;0;0
FR;1;2021-02-10;52020;76865;0;0;0;2117360;448700;1;0;0
FR;1;2021-02-11;63332;99060;0;0;0;2180692;547760;1;0;0
FR;1;2021-02-12;55825;74096;0;0;0;2236517;621856;1;0;0
FR;1;2021-02-13;15444;19319;0;0;0;2251961;641175;1;0;0
FR;1;2021-02-14;3739;7249;0;0;0;2255700;648424;1;0;0
FR;1;2021-02-15;24121;73577;0;0;0;2279821;722001;1;0;0
FR;1;2021-02-16;32744;96715;0;0;0;2312565;818716;1;0;0
FR;1;2021-02-17;35077;98804;1;0;0;2347642;917520;2;0;0
FR;1;2021-02-18;49392;113577;0;0;0;2397034;1031097;2;0;0
FR;1;2021-02-19;45351;86416;1;0;0;2442385;1117513;3;0;0
FR;1;2021-02-20;13374;26957;0;0;0;2455759;1144470;3;0;0
FR;1;2021-02-21;2448;6306;0;0;0;2458207;1150776;3;0;0
FR;1;2021-02-22;24695;69479;2;0;0;2482902;1220255;5;0;0
FR;1;2021-02-23;37405;80455;1;0;0;2520307;1300710;6;0;0
FR;1;2021-02-24;40652;77701;1;0;0;2560959;1378411;7;0;0
FR;1;2021-02-25;50123;87828;1;0;0;2611082;1466239;8;0;0
FR;1;2021-02-26;47170;67809;0;0;0;2658252;1534048;8;0;0
FR;1;2021-02-27;15664;20972;0;0;0;2673916;1555020;8;0;0
FR;1;2021-02-28;3550;4392;1;0;0;2677466;1559412;9;0;0
FR;1;2021-03-01;40120;49138;1;0;0;2717586;1608550;10;0;0
FR;1;2021-03-02;55931;61539;2;0;0;2773517;1670089;12;0;0
FR;1;2021-03-03;61165;60517;0;0;0;2834682;1730606;12;0;0
FR;1;2021-03-04;72947;65085;3;0;0;2907629;1795691;15;0;0
FR;1;2021-03-05;74716;59114;3;0;0;2982345;1854805;18;0;0
FR;1;2021-03-06;82421;16061;2;0;0;3064766;1870866;20;0;0
FR;1;2021-03-07;63696;5327;1;0;0;3128462;1876193;21;0;0
FR;1;2021-03-08;60130;42367;2;0;0;3188592;1918560;23;0;0
FR;1;2021-03-09;85932;48179;1;0;0;3274524;1966739;24;0;0
FR;1;2021-03-10;90832;48013;5;0;0;3365356;2014752;29;0;0
FR;1;2021-03-11;104989;53843;1;0;0;3470345;2068595;30;0;0
FR;1;2021-03-12;104065;45153;0;0;0;3574410;2113748;30;0;0
FR;1;2021-03-13;89166;12711;1;0;0;3663576;2126459;31;0;0
FR;1;2021-03-14;44435;3012;1;0;0;3708011;2129471;32;0;0
FR;1;2021-03-15;95448;29042;3;0;0;3803459;2158513;35;0;0
FR;1;2021-03-16;123556;34840;4;0;0;3927015;2193353;39;0;0
FR;1;2021-03-17;129243;34693;4;0;0;4056258;2228046;43;0;0
FR;1;2021-03-18;142822;39685;5;0;0;4199080;2267731;48;0;0
FR;1;2021-03-19;136195;32794;2;0;0;4335275;2300525;50;0;0
FR;1;2021-03-20;75965;10140;1;0;0;4411240;2310665;51;0;0
FR;1;2021-03-21;26469;2455;1;0;0;4437709;2313120;52;0;0
FR;1;2021-03-22;114659;31087;2;0;0;4552368;2344207;54;0;0
FR;1;2021-03-23;142956;38165;1;0;0;4695324;2382372;55;0;0
FR;1;2021-03-24;141935;38752;0;0;0;4837259;2421124;55;0;0
FR;1;2021-03-25;164949;39546;4;0;0;5002208;2460670;59;0;0
FR;1;2021-03-26;166346;37454;4;0;0;5168554;2498124;63;0;0
FR;1;2021-03-27;110855;15250;1;0;0;5279409;2513374;64;0;0
FR;1;2021-03-28;42282;3724;3;0;0;5321691;2517098;67;0;0
FR;1;2021-03-29;129776;49845;4;0;0;5451467;2566943;71;0;0
FR;1;2021-03-30;167638;63482;4;0;0;5619105;2630425;75;0;0
FR;1;2021-03-31;170862;66903;4;0;0;5789967;2697328;79;0;0
FR;1;2021-04-01;194656;79468;11;0;0;5984623;2776796;90;0;0
FR;1;2021-04-02;164388;84346;7;0;0;6149011;2861142;97;0;0
FR;1;2021-04-03;88210;58084;5;0;0;6237221;2919226;102;0;0
FR;1;2021-04-04;33433;17729;0;0;0;6270654;2936955;102;0;0
FR;1;2021-04-05;46353;10122;11;0;0;6317007;2947077;113;0;0
FR;1;2021-04-06;160204;101030;16;0;0;6477211;3048107;129;0;0
FR;1;2021-04-07;196892;108062;16;0;0;6674103;3156169;145;0;0
FR;1;2021-04-08;221978;112287;13;0;0;6896081;3268456;158;0;0
FR;1;2021-04-09;214478;107376;21;0;0;7110559;3375832;179;0;0
FR;1;2021-04-10;117130;73337;14;0;0;7227689;3449169;193;0;0
FR;1;2021-04-11;40803;30239;6;0;0;7268492;3479408;199;0;0
FR;1;2021-04-12;168316;103684;45;0;0;7436808;3583092;244;0;0
FR;1;2021-04-13;203699;128042;96;1;0;7640507;3711134;340;1;0
FR;1;2021-04-14;208488;122626;203;0;0;7848995;3833760;543;1;0
FR;1;2021-04-15;221556;126670;311;0;0;8070551;3960430;854;1;0
FR;1;2021-04-16;205967;124981;307;0;0;8276518;4085411;1161;1;0
FR;1;2021-04-17;122047;67388;102;0;0;8398565;4152799;1263;1;0
FR;1;2021-04-18;35915;20996;39;0;0;8434480;4173795;1302;1;0
FR;1;2021-04-19;163624;121745;429;0;0;8598104;4295540;1731;1;0
FR;1;2021-04-20;189310;148586;530;0;0;8787414;4444126;2261;1;0
FR;1;2021-04-21;193869;146628;754;0;0;8981283;4590754;3015;1;0
FR;1;2021-04-22;208857;162577;777;0;0;9190140;4753331;3792;1;0
FR;1;2021-04-23;198893;156771;667;0;0;9389033;4910102;4459;1;0
FR;1;2021-04-24;126292;95432;145;0;0;9515325;5005534;4604;1;0
FR;1;2021-04-25;53544;30087;46;0;0;9568869;5035621;4650;1;0
FR;1;2021-04-26;181048;138118;537;0;0;9749917;5173739;5187;1;0
FR;1;2021-04-27;221274;161756;898;0;0;9971191;5335495;6085;1;0
FR;1;2021-04-28;238193;154943;1308;1;1;10209384;5490438;7393;2;1
FR;1;2021-04-29;270191;159923;1205;0;0;10479575;5650361;8598;2;1
FR;1;2021-04-30;271898;147950;1069;0;0;10751473;5798311;9667;2;1
FR;1;2021-05-01;141061;40676;172;0;0;10892534;5838987;9839;2;1
FR;1;2021-05-02;81448;28119;80;0;0;10973982;5867106;9919;2;1
FR;1;2021-05-03;250635;146157;797;0;0;11224617;6013263;10716;2;1
FR;1;2021-05-04;265723;186778;1197;0;0;11490340;6200041;11913;2;1
FR;1;2021-05-05;283721;184446;1262;0;0;11774061;6384487;13175;2;1
FR;1;2021-05-06;309810;182914;1493;0;0;12083871;6567401;14668;2;1
FR;1;2021-05-07;283985;195504;1125;0;0;12367856;6762905;15793;2;1
FR;1;2021-05-08;191618;48309;283;0;0;12559474;6811214;16076;2;1
FR;1;2021-05-09;114007;36119;236;0;0;12673481;6847333;16312;2;1
FR;1;2021-05-10;257975;193979;1178;0;0;12931456;7041312;17490;2;1
FR;1;2021-05-11;318753;211081;1461;0;0;13250209;7252393;18951;2;1
FR;1;2021-05-12;356486;185663;1397;0;0;13606695;7438056;20348;2;1
FR;1;2021-05-13;283342;47720;398;0;0;13890037;7485776;20746;2;1
FR;1;2021-05-14;370394;128609;985;0;0;14260431;7614385;21731;2;1
FR;1;2021-05-15;297866;66067;402;0;0;14558297;7680452;22133;2;1
FR;1;2021-05-16;157708;15533;158;0;0;14716005;7695985;22291;2;1
FR;1;2021-05-17;318796;116492;1434;0;0;15034801;7812477;23725;2;1
FR;1;2021-05-18;383006;111117;1793;0;0;15417807;7923594;25518;2;1
FR;1;2021-05-19;395139;102666;2167;0;0;15812946;8026260;27685;2;1
FR;1;2021-05-20;421621;96151;2037;0;0;16234567;8122411;29722;2;1
FR;1;2021-05-21;399680;97226;1752;0;0;16634247;8219637;31474;2;1
FR;1;2021-05-22;275617;41997;601;0;0;16909864;8261634;32075;2;1
FR;1;2021-05-23;122944;11179;224;0;0;17032808;8272813;32299;2;1
FR;1;2021-05-24;243946;26249;564;0;0;17276754;8299062;32863;2;1
FR;1;2021-05-25;366014;131670;2103;1;0;17642768;8430732;34966;3;1
FR;1;2021-05-26;380703;125596;1983;0;0;18023471;8556328;36949;3;1
FR;1;2021-05-27;406017;127994;1968;0;0;18429488;8684322;38917;3;1
FR;1;2021-05-28;365903;145288;1693;0;0;18795391;8829610;40610;3;1
FR;1;2021-05-29;253779;80870;524;0;0;19049170;8910480;41134;3;1
FR;1;2021-05-30;100893;22528;156;0;0;19150063;8933008;41290;3;1
FR;1;2021-05-31;314172;148835;1279;1;1;19464235;9081843;42569;4;2
FR;1;2021-06-01;361097;166579;1720;1;1;19825332;9248422;44289;5;3
FR;1;2021-06-02;364134;153101;1785;0;0;20189466;9401523;46074;5;3
FR;1;2021-06-03;389831;147602;1643;0;0;20579297;9549125;47717;5;3
FR;1;2021-06-04;363272;175568;1486;1;1;20942569;9724693;49203;6;4
FR;1;2021-06-05;258415;112673;596;0;0;21200984;9837366;49799;6;4
FR;1;2021-06-06;126709;37528;215;0;0;21327693;9874894;50014;6;4
FR;1;2021-06-07;299681;207897;1357;0;0;21627374;10082791;51371;6;4
FR;1;2021-06-08;330449;220768;1630;0;0;21957823;10303559;53001;6;4
FR;1;2021-06-09;336271;212331;1600;0;0;22294094;10515890;54601;6;4
FR;1;2021-06-10;343566;202055;1605;0;0;22637660;10717945;56206;6;4
FR;1;2021-06-11;311646;235287;1287;0;0;22949306;10953232;57493;6;4
FR;1;2021-06-12;243975;150648;430;0;0;23193281;11103880;57923;6;4
FR;1;2021-06-13;100298;61001;188;0;0;23293579;11164881;58111;6;4
FR;1;2021-06-14;207633;289001;1312;1;0;23501212;11453882;59423;7;4
FR;1;2021-06-15;256593;282245;1386;1;0;23757805;11736127;60809;8;4
FR;1;2021-06-16;273438;270576;1259;1;0;24031243;12006703;62068;9;4
FR;1;2021-06-17;268014;244464;1228;1;0;24299257;12251167;63296;10;4
FR;1;2021-06-18;260365;295659;1146;1;0;24559622;12546826;64442;11;4
FR;1;2021-06-19;193401;209460;384;0;0;24753023;12756286;64826;11;4
FR;1;2021-06-20;69633;89121;117;0;0;24822656;12845407;64943;11;4
FR;1;2021-06-21;172160;319832;924;1;1;24994816;13165239;65867;12;5
FR;1;2021-06-22;185639;347779;1093;10;2;25180455;13513018;66960;22;7
FR;1;2021-06-23;203988;339409;1046;0;0;25384443;13852427;68006;22;7
FR;1;2021-06-24;203331;281961;1161;0;0;25587774;14134388;69167;22;7
FR;1;2021-06-25;182432;371766;1196;0;0;25770206;14506154;70363;22;7
FR;1;2021-06-26;131307;278283;500;0;0;25901513;14784437;70863;22;7
FR;1;2021-06-27;52361;122948;143;0;0;25953874;14907385;71006;22;7
FR;1;2021-06-28;136466;368278;1055;0;0;26090340;15275663;72061;22;7
FR;1;2021-06-29;154709;390504;1845;0;0;26245049;15666167;73906;22;7
FR;1;2021-06-30;179840;378542;1661;4;2;26424889;16044709;75567;26;9
FR;1;2021-07-01;201042;332169;1886;5;1;26625931;16376878;77453;31;10
FR;1;2021-07-02;193029;367674;1764;5;3;26818960;16744552;79217;36;13
FR;1;2021-07-03;124314;280459;704;3;1;26943274;17025011;79921;39;14
FR;1;2021-07-04;53890;113684;244;0;0;26997164;17138695;80165;39;14
FR;1;2021-07-05;153507;356081;1498;8;2;27150671;17494776;81663;47;16
FR;1;2021-07-06;173168;382533;1597;44;8;27323839;17877309;83260;91;24
FR;1;2021-07-07;190392;362574;1654;24;5;27514231;18239883;84914;115;29
FR;1;2021-07-08;201233;323107;1825;20;8;27715464;18562990;86739;135;37
FR;1;2021-07-09;189618;387191;1851;3;2;27905082;18950181;88590;138;39
FR;1;2021-07-10;129821;281111;814;1;1;28034903;19231292;89404;139;40
FR;1;2021-07-11;57603;102485;260;0;0;28092506;19333777;89664;139;40
FR;1;2021-07-12;149407;416999;1573;4;0;28241913;19750776;91237;143;40
FR;1;2021-07-13;234007;439475;1803;7;2;28475920;20190251;93040;150;42
FR;1;2021-07-14;171630;151574;415;0;0;28647550;20341825;93455;150;42
FR;1;2021-07-15;279339;424798;1855;1;0;28926889;20766623;95310;151;42
FR;1;2021-07-16;290118;401272;1709;3;1;29217007;21167895;97019;154;43
FR;1;2021-07-17;217229;282124;754;1;0;29434236;21450019;97773;155;43
FR;1;2021-07-18;101948;107311;288;0;0;29536184;21557330;98061;155;43
FR;1;2021-07-19;238015;379395;1495;3;0;29774199;21936725;99556;158;43
FR;1;2021-07-20;305517;380929;1466;0;0;30079716;22317654;101022;158;43
FR;1;2021-07-21;333044;353589;1411;4;2;30412760;22671243;102433;162;45
FR;1;2021-07-22;364342;319515;1499;3;2;30777102;22990758;103932;165;47
FR;1;2021-07-23;347574;343751;1582;4;2;31124676;23334509;105514;169;49
FR;1;2021-07-24;238884;241080;695;1;0;31363560;23575589;106209;170;49
FR;1;2021-07-25;112722;76059;214;0;0;31476282;23651648;106423;170;49
FR;1;2021-07-26;298956;290297;1495;2;2;31775238;23941945;107918;172;51
FR;1;2021-07-27;385641;268915;1457;4;2;32160879;24210860;109375;176;53
FR;1;2021-07-28;390044;251606;1460;4;2;32550923;24462466;110835;180;55
FR;1;2021-07-29;405944;228411;1537;2;1;32956867;24690877;112372;182;56
FR;1;2021-07-30;370478;247116;1632;4;1;33327345;24937993;114004;186;57
FR;1;2021-07-31;243321;165117;792;1;0;33570666;25103110;114796;187;57
FR;1;2021-08-01;105486;47230;232;0;0;33676152;25150340;115028;187;57
FR;1;2021-08-02;296847;213305;1473;2;0;33972999;25363645;116501;189;57
FR;1;2021-08-03;331000;209326;1544;2;1;34303999;25572971;118045;191;58
FR;1;2021-08-04;327647;184445;1435;5;3;34631646;25757416;119480;196;61
FR;1;2021-08-05;300978;193592;1478;0;0;34932624;25951008;120958;196;61
FR;1;2021-08-06;290680;224646;1558;3;1;35223304;26175654;122516;199;62
FR;1;2021-08-07;182538;158827;654;4;3;35405842;26334481;123170;203;65
FR;1;2021-08-08;68794;59151;246;0;0;35474636;26393632;123416;203;65
FR;1;2021-08-09;222555;236113;1436;4;3;35697191;26629745;124852;207;68
FR;1;2021-08-10;252388;240989;1485;2;1;35949579;26870734;126337;209;69
FR;1;2021-08-11;235924;232575;1267;5;1;36185503;27103309;127604;214;70
FR;1;2021-08-12;220459;240311;1482;3;1;36405962;27343620;129086;217;71
FR;1;2021-08-13;201537;238522;1351;2;2;36607499;27582142;130437;219;73
FR;1;2021-08-14;122782;174173;645;0;0;36730281;27756315;131082;219;73
FR;1;2021-08-15;34631;46123;195;1;0;36764912;27802438;131277;220;73
FR;1;2021-08-16;156642;289945;1420;0;0;36921554;28092383;132697;220;73
FR;1;2021-08-17;171338;291778;1418;4;1;37092892;28384161;134115;224;74
FR;1;2021-08-18;161199;287199;1382;6;3;37254091;28671360;135497;230;77
FR;1;2021-08-19;148714;277579;1392;1;0;37402805;28948939;136889;231;77
FR;1;2021-08-20;140254;308468;1518;2;2;37543059;29257407;138407;233;79
FR;1;2021-08-21;84190;213264;584;0;0;37627249;29470671;138991;233;79
FR;1;2021-08-22;28526;82686;228;0;0;37655775;29553357;139219;233;79
FR;1;2021-08-23;118528;321236;1416;2;1;37774303;29874593;140635;235;80
FR;1;2021-08-24;126516;319952;1591;5;1;37900819;30194545;142226;240;81
FR;1;2021-08-25;121344;306595;1772;8;3;38022163;30501140;143998;248;84
FR;1;2021-08-26;106452;286164;2154;10;1;38128615;30787304;146152;258;85
FR;1;2021-08-27;107447;321152;2298;8;3;38236062;31108456;148450;266;88
FR;1;2021-08-28;70910;220674;1100;0;0;38306972;31329130;149550;266;88
FR;1;2021-08-29;24123;78126;461;1;0;38331095;31407256;150011;267;88
FR;1;2021-08-30;96771;286540;4307;6;5163;38427866;31693796;154318;273;5251
FR;1;2021-08-31;97954;276503;9265;14;10199;38525820;31970299;163583;287;15450
FR;1;2021-09-01;111266;245263;21082;7;21975;38637086;32215562;184665;294;37425
FR;1;2021-09-02;84251;198049;24498;11;25377;38721337;32413611;209163;305;62802
FR;1;2021-09-03;82055;227664;26928;21;27921;38803392;32641275;236091;326;90723
FR;1;2021-09-04;71438;189701;11135;11;11609;38874830;32830976;247226;337;102332
FR;1;2021-09-05;18578;41194;4117;2;4280;38893408;32872170;251343;339;106612
FR;1;2021-09-06;59244;151700;30160;15;31038;38952652;33023870;281503;354;137650
FR;1;2021-09-07;56388;139735;30191;27;31045;39009040;33163605;311694;381;168695
FR;1;2021-09-08;70085;173823;26903;20;27738;39079125;33337428;338597;401;196433
FR;1;2021-09-09;53277;124448;28579;23;29530;39132402;33461876;367176;424;225963
FR;1;2021-09-10;65221;152031;30409;21;31457;39197623;33613907;397585;445;257420
FR;1;2021-09-11;51826;146589;9714;13;10211;39249449;33760496;407299;458;267631
FR;1;2021-09-12;10697;29250;2479;2;2625;39260146;33789746;409778;460;270256
FR;1;2021-09-13;51242;104610;38707;28;39682;39311388;33894356;448485;488;309938
FR;1;2021-09-14;53073;96108;51215;65;52564;39364461;33990464;499700;553;362502
FR;1;2021-09-15;60156;139216;50421;56;46879;39424617;34129680;550121;609;409381
FR;1;2021-09-16;46401;81389;53249;72;49384;39471018;34211069;603370;681;458765
FR;1;2021-09-17;53004;109372;45005;60;42569;39524022;34320441;648375;741;501334
FR;1;2021-09-18;37777;118445;11785;19;11244;39561799;34438886;660160;760;512578
FR;1;2021-09-19;6464;21034;2030;1;1967;39568263;34459920;662190;761;514545
FR;1;2021-09-20;36363;74876;46131;66;43996;39604626;34534796;708321;827;558541
FR;1;2021-09-21;34040;68146;56166;71;52479;39638666;34602942;764487;898;611020
FR;1;2021-09-22;38641;118379;49779;77;46696;39677307;34721321;814266;975;657716
FR;1;2021-09-23;31834;62682;54413;86;50641;39709141;34784003;868679;1061;708357
FR;1;2021-09-24;36599;89762;43606;92;41828;39745740;34873765;912285;1153;750185
FR;1;2021-09-25;27560;96507;12293;27;12150;39773300;34970272;924578;1180;762335
FR;1;2021-09-26;4347;15218;1766;4;1703;39777647;34985490;926344;1184;764038
FR;1;2021-09-27;27279;60237;42857;89;41522;39804926;35045727;969201;1273;805560
FR;1;2021-09-28;26803;49429;47105;75;44270;39831729;35095156;1016306;1348;849830
FR;1;2021-09-29;35792;80314;47208;86;45456;39867521;35175470;1063514;1434;895286
FR;1;2021-09-30;25886;46236;47440;80;45260;39893407;35221706;1110954;1514;940546
FR;1;2021-10-01;46616;64673;44833;83;44364;39940023;35286379;1155787;1597;984910
FR;1;2021-10-02;32117;62244;16093;32;16276;39972140;35348623;1171880;1629;1001186
FR;1;2021-10-03;4294;8607;2026;3;2036;39976434;35357230;1173906;1632;1003222
FR;1;2021-10-04;28493;44371;47062;78;46872;40004927;35401601;1220968;1710;1050094
FR;1;2021-10-05;23809;41566;49780;116;49081;40028736;35443167;1270748;1826;1099175
FR;1;2021-10-06;34080;61157;57388;102;57034;40062816;35504324;1328136;1928;1156209
FR;1;2021-10-07;20772;39662;52955;75;51766;40083588;35543986;1381091;2003;1207975
FR;1;2021-10-08;34605;59482;60316;83;60979;40118193;35603468;1441407;2086;1268954
FR;1;2021-10-09;27290;47908;25455;29;25954;40145483;35651376;1466862;2115;1294908
FR;1;2021-10-10;3568;5714;2741;7;2841;40149051;35657090;1469603;2122;1297749
FR;1;2021-10-11;24534;38151;54537;88;55134;40173585;35695241;1524140;2210;1352883
FR;1;2021-10-12;22894;36537;57995;126;59008;40196479;35731778;1582135;2336;1411891
FR;1;2021-10-13;32651;47684;64126;124;65566;40229130;35779462;1646261;2460;1477457
FR;1;2021-10-14;21508;34640;53705;102;54213;40250638;35814102;1699966;2562;1531670
FR;1;2021-10-15;32407;48631;72278;165;74895;40283045;35862733;1772244;2727;1606565
FR;1;2021-10-16;25851;35232;34845;45;36367;40308896;35897965;1807089;2772;1642932
FR;1;2021-10-17;3078;4036;3403;2;3311;40311974;35902001;1810492;2774;1646243
FR;1;2021-10-18;22386;34342;66781;131;69612;40334360;35936343;1877273;2905;1715855
FR;1;2021-10-19;20400;33027;75607;136;79477;40354760;35969370;1952880;3041;1795332
FR;1;2021-10-20;29688;43985;96104;176;99666;40384448;36013355;2048984;3217;1894998
FR;1;2021-10-21;19409;35022;83084;107;86936;40403857;36048377;2132068;3324;1981934
FR;1;2021-10-22;29467;47400;103665;195;109508;40433324;36095777;2235733;3519;2091442
FR;1;2021-10-23;22911;34991;44835;57;47328;40456235;36130768;2280568;3576;2138770
FR;1;2021-10-24;2365;3872;3577;6;3740;40458600;36134640;2284145;3582;2142510
FR;1;2021-10-25;22348;30718;81965;143;85715;40480948;36165358;2366110;3725;2228225
FR;1;2021-10-26;19239;27580;86032;162;90220;40500187;36192938;2452142;3887;2318445
FR;1;2021-10-27;26062;39623;107723;252;112545;40526249;36232561;2559865;4139;2430990
FR;1;2021-10-28;18476;26925;86866;150;91517;40544725;36259486;2646731;4289;2522507
FR;1;2021-10-29;25809;39779;114749;201;121431;40570534;36299265;2761480;4490;2643938
FR;1;2021-10-30;17523;28547;49320;75;51901;40588057;36327812;2810800;4565;2695839
FR;1;2021-10-31;2044;3216;3440;2;3680;40590101;36331028;2814240;4567;2699519
FR;1;2021-11-01;7379;4107;3012;3;3256;40597480;36335135;2817252;4570;2702775
FR;1;2021-11-02;21509;33080;92310;157;97615;40618989;36368215;2909562;4727;2800390
FR;1;2021-11-03;26001;41306;117403;215;123713;40644990;36409521;3026965;4942;2924103
FR;1;2021-11-04;19356;30198;105691;212;111762;40664346;36439719;3132656;5154;3035865
FR;1;2021-11-05;26761;42042;138672;227;147208;40691107;36481761;3271328;5381;3183073
FR;1;2021-11-06;18697;29758;63419;123;66368;40709804;36511519;3334747;5504;3249441
FR;1;2021-11-07;1773;3376;4944;6;5296;40711577;36514895;3339691;5510;3254737
FR;1;2021-11-08;17384;32256;125879;224;132398;40728961;36547151;3465570;5734;3387135
FR;1;2021-11-09;19066;37634;159173;336;168828;40748027;36584785;3624743;6070;3555963
FR;1;2021-11-10;28449;48786;181774;440;192247;40776476;36633571;3806517;6510;3748210
FR;1;2021-11-11;3413;5600;12164;26;12961;40779889;36639171;3818681;6536;3761171
FR;1;2021-11-12;25839;46823;174710;241;186277;40805728;36685994;3993391;6777;3947448
FR;1;2021-11-13;18594;29190;76780;111;81717;40824322;36715184;4070171;6888;4029165
FR;1;2021-11-14;1992;3355;6807;5;7386;40826314;36718539;4076978;6893;4036551
FR;1;2021-11-15;18439;34827;156270;303;166021;40844753;36753366;4233248;7196;4202572
FR;1;2021-11-16;20869;37798;191956;377;204669;40865622;36791164;4425204;7573;4407241
FR;1;2021-11-17;28338;45630;193111;399;204862;40893960;36836794;4618315;7972;4612103
FR;1;2021-11-18;20897;37710;182334;458;194275;40914857;36874504;4800649;8430;4806378
FR;1;2021-11-19;30706;53284;230092;529;246459;40945563;36927788;5030741;8959;5052837
FR;1;2021-11-20;23602;33213;96919;200;103548;40969165;36961001;5127660;9159;5156385
FR;1;2021-11-21;2301;4031;9087;18;9979;40971466;36965032;5136747;9177;5166364
FR;1;2021-11-22;21267;30338;175758;465;189242;40992733;36995370;5312505;9642;5355606
FR;1;2021-11-23;23727;40969;221031;538;237651;41016460;37036339;5533536;10180;5593257
FR;1;2021-11-24;30163;49619;217228;703;234307;41046623;37085958;5750764;10883;5827564
FR;1;2021-11-25;23390;43688;244300;719;263824;41070013;37129646;5995064;11602;6091388
FR;1;2021-11-26;30457;66428;356623;834;388320;41100470;37196074;6351687;12436;6479708
FR;1;2021-11-27;21644;45146;202521;372;222482;41122114;37241220;6554208;12808;6702190
FR;1;2021-11-28;3132;9689;54743;63;61037;41125246;37250909;6608951;12871;6763227
FR;1;2021-11-29;17772;49399;326224;841;354158;41143018;37300308;6935175;13712;7117385
FR;1;2021-11-30;22451;64720;430971;948;470523;41165469;37365028;7366146;14660;7587908
FR;1;2021-12-01;24072;69117;442675;1129;481466;41189541;37434145;7808821;15789;8069374
FR;1;2021-12-02;19766;64206;489202;1224;532596;41209307;37498351;8298023;17013;8601970
FR;1;2021-12-03;22685;81669;542548;1303;591476;41231992;37580020;8840571;18316;9193446
FR;1;2021-12-04;16334;53839;298994;652;328802;41248326;37633859;9139565;18968;9522248
FR;1;2021-12-05;3621;13913;81481;143;91060;41251947;37647772;9221046;19111;9613308
FR;1;2021-12-06;16619;62675;415259;1062;454946;41268566;37710447;9636305;20173;10068254
FR;1;2021-12-07;19690;75698;522727;1531;572269;41288256;37786145;10159032;21704;10640523
FR;1;2021-12-08;21440;75432;458173;1541;501847;41309696;37861577;10617205;23245;11142370
FR;1;2021-12-09;19285;73905;492698;1626;540531;41328981;37935482;11109903;24871;11682901
FR;1;2021-12-10;22345;87498;547180;1583;599762;41351326;38022980;11657083;26454;12282663
FR;1;2021-12-11;16485;58914;302650;746;335398;41367811;38081894;11959733;27200;12618061
FR;1;2021-12-12;4328;15946;83156;179;94071;41372139;38097840;12042889;27379;12712132
FR;1;2021-12-13;15395;63639;366765;1095;406113;41387534;38161479;12409654;28474;13118245
FR;1;2021-12-14;19906;80107;464480;1738;514950;41407440;38241586;12874134;30212;13633195
FR;1;2021-12-15;21225;77137;408856;1307;452905;41428665;38318723;13282990;31519;14086100
FR;1;2021-12-16;19838;77228;451607;1575;500401;41448503;38395951;13734597;33094;14586501
FR;1;2021-12-17;22386;86587;479722;1735;530832;41470889;38482538;14214319;34829;15117333
FR;1;2021-12-18;17564;54630;257532;730;288453;41488453;38537168;14471851;35559;15405786
FR;1;2021-12-19;5533;17183;79117;194;90776;41493986;38554351;14550968;35753;15496562
FR;1;2021-12-20;20720;62999;316049;1080;355123;41514706;38617350;14867017;36833;15851685
FR;1;2021-12-21;26037;73028;372566;1420;417929;41540743;38690378;15239583;38253;16269614
FR;1;2021-12-22;24844;65709;310441;1214;349413;41565587;38756087;15550024;39467;16619027
FR;1;2021-12-23;21152;52205;241343;948;272942;41586739;38808292;15791367;40415;16891969
FR;1;2021-12-24;7050;18227;67091;256;77032;41593789;38826519;15858458;40671;16969001
FR;1;2021-12-25;494;2757;5565;15;6536;41594283;38829276;15864023;40686;16975537
FR;1;2021-12-26;2746;7583;26914;68;31445;41597029;38836859;15890937;40754;17006982
FR;1;2021-12-27;18052;53222;234973;707;265638;41615081;38890081;16125910;41461;17272620
FR;1;2021-12-28;23186;61771;291903;1024;330069;41638267;38951852;16417813;42485;17602689
FR;1;2021-12-29;22155;55411;254868;917;288095;41660422;39007263;16672681;43402;17890784
FR;1;2021-12-30;21168;46045;212054;857;239521;41681590;39053308;16884735;44259;18130305
FR;1;2021-12-31;7249;16475;61809;229;70315;41688839;39069783;16946544;44488;18200620
FR;1;2022-01-01;770;2478;5638;29;6571;41689609;39072261;16952182;44517;18207191
FR;1;2022-01-02;3031;8066;28852;50;33515;41692640;39080327;16981034;44567;18240706
FR;1;2022-01-03;18858;52021;228031;783;257297;41711498;39132348;17209065;45350;18498003
FR;1;2022-01-04;24606;64490;299109;1234;337102;41736104;39196838;17508174;46584;18835105
FR;1;2022-01-05;28934;63492;274707;1097;309999;41765038;39260330;17782881;47681;19145104
FR;1;2022-01-06;26331;65797;306728;1392;346362;41791369;39326127;18089609;49073;19491466
FR;1;2022-01-07;31153;74302;349675;1534;393721;41822522;39400429;18439284;50607;19885187
FR;1;2022-01-08;23291;51362;222442;694;251076;41845813;39451791;18661726;51301;20136263
FR;1;2022-01-09;7072;17225;65998;162;76156;41852885;39469016;18727724;51463;20212419
FR;1;2022-01-10;21226;53490;236619;951;266864;41874111;39522506;18964343;52414;20479283
FR;1;2022-01-11;26351;62611;282132;1276;317658;41900462;39585117;19246475;53690;20796941
FR;1;2022-01-12;28538;61841;246090;1103;277847;41929000;39646958;19492565;54793;21074788
FR;1;2022-01-13;24289;59634;262622;1250;295969;41953289;39706592;19755187;56043;21370757
FR;1;2022-01-14;27681;66403;313818;1364;351099;41980970;39772995;20069005;57407;21721856
FR;1;2022-01-15;19236;44284;199230;618;223815;42000206;39817279;20268235;58025;21945671
FR;1;2022-01-16;5131;13005;51480;135;59570;42005337;39830284;20319715;58160;22005241
FR;1;2022-01-17;16663;39608;184729;779;206785;42022000;39869892;20504444;58939;22212026
FR;1;2022-01-18;19185;45455;212291;1149;236915;42041185;39915347;20716735;60088;22448941
FR;1;2022-01-19;20058;43752;175989;894;197113;42061243;39959099;20892724;60982;22646054
FR;1;2022-01-20;16511;40204;183506;1136;204574;42077754;39999303;21076230;62118;22850628
FR;1;2022-01-21;19625;46905;228823;1398;253240;42097379;40046208;21305053;63516;23103868
FR;1;2022-01-22;13824;33076;144439;578;161325;42111203;40079284;21449492;64094;23265193
FR;1;2022-01-23;3340;8827;33387;130;38324;42114543;40088111;21482879;64224;23303517
FR;1;2022-01-24;11692;32523;142109;705;158207;42126235;40120634;21624988;64929;23461724
FR;1;2022-01-25;14062;37783;163290;1049;181486;42140297;40158417;21788278;65978;23643210
FR;1;2022-01-26;14780;36613;150126;927;166164;42155077;40195030;21938404;66905;23809374
FR;1;2022-01-27;12248;32543;143318;878;157785;42167325;40227573;22081722;67783;23967159
FR;1;2022-01-28;16174;53814;198179;1143;222422;42183499;40281387;22279901;68926;24189581
FR;1;2022-01-29;10238;35436;135151;520;151530;42193737;40316823;22415052;69446;24341111
FR;1;2022-01-30;2471;9335;29653;84;34460;42196208;40326158;22444705;69530;24375571
FR;1;2022-01-31;8702;32312;104270;530;117377;42204910;40358470;22548975;70060;24492948
FR;1;2022-02-01;9957;35808;126959;861;141122;42214867;40394278;22675934;70921;24634070
FR;1;2022-02-02;11087;40766;130227;776;145759;42225954;40435044;22806161;71697;24779829
FR;1;2022-02-03;8650;32974;116895;780;130285;42234604;40468018;22923056;72477;24910114
FR;1;2022-02-04;11332;47856;172460;963;192728;42245936;40515874;23095516;73440;25102842
FR;1;2022-02-05;7681;33923;117528;391;133035;42253617;40549797;23213044;73831;25235877
FR;1;2022-02-06;1686;8068;22724;83;26901;42255303;40557865;23235768;73914;25262778
FR;1;2022-02-07;6961;35217;119000;449;134931;42262264;40593082;23354768;74363;25397709
FR;1;2022-02-08;7479;31371;125557;692;140525;42269743;40624453;23480325;75055;25538234
FR;1;2022-02-09;8366;35783;135154;692;152345;42278109;40660236;23615479;75747;25690579
FR;1;2022-02-10;6515;28839;116219;672;129924;42284624;40689075;23731698;76419;25820503
FR;1;2022-02-11;8516;41149;165001;873;185193;42293140;40730224;23896699;77292;26005696
FR;1;2022-02-12;5250;27489;106646;378;120813;42298390;40757713;24003345;77670;26126509
FR;1;2022-02-13;1211;5685;21685;61;25296;42299601;40763398;24025030;77731;26151805
FR;1;2022-02-14;5324;26999;117971;389;132986;42304925;40790397;24143001;78120;26284791
FR;1;2022-02-15;5538;27936;118743;609;132312;42310463;40818333;24261744;78729;26417103
FR;1;2022-02-16;5604;27858;110293;591;122880;42316067;40846191;24372037;79320;26539983
FR;1;2022-02-17;4366;18848;73035;484;80066;42320433;40865039;24445072;79804;26620049
FR;1;2022-02-18;5443;26280;99085;667;108002;42325876;40891319;24544157;80471;26728051
FR;1;2022-02-19;3501;17047;59434;303;66002;42329377;40908366;24603591;80774;26794053
FR;1;2022-02-20;775;3205;10674;35;12294;42330152;40911571;24614265;80809;26806347
FR;1;2022-02-21;3307;14420;52749;286;57585;42333459;40925991;24667014;81095;26863932
FR;1;2022-02-22;3657;15293;51823;496;55536;42337116;40941284;24718837;81591;26919468
FR;1;2022-02-23;4131;17445;57375;508;62452;42341247;40958729;24776212;82099;26981920
FR;1;2022-02-24;3202;12514;43511;431;46270;42344449;40971243;24819723;82530;27028190
FR;1;2022-02-25;4337;19207;64779;691;68617;42348786;40990450;24884502;83221;27096807
FR;1;2022-02-26;2665;12497;41308;305;45060;42351451;41002947;24925810;83526;27141867
FR;1;2022-02-27;632;2160;7106;42;7968;42352083;41005107;24932916;83568;27149835
FR;1;2022-02-28;2534;9948;34873;300;37289;42354617;41015055;24967789;83868;27187124
FR;1;2022-03-01;2554;10152;38350;373;39250;42357171;41025207;25006139;84241;27226374
FR;1;2022-03-02;3353;11732;41640;388;43681;42360524;41036939;25047779;84629;27270055
FR;1;2022-03-03;2226;7303;25857;297;26164;42362750;41044242;25073636;84926;27296219
FR;1;2022-03-04;2602;10100;35247;568;34713;42365352;41054342;25108883;85494;27330932
FR;1;2022-03-05;1628;6261;21874;273;22254;42366980;41060603;25130757;85767;27353186
FR;1;2022-03-06;337;924;2904;37;3098;42367317;41061527;25133661;85804;27356284
FR;1;2022-03-07;1304;4494;16296;241;15751;42368621;41066021;25149957;86045;27372035
FR;1;2022-03-08;1470;4970;16954;301;15771;42370091;41070991;25166911;86346;27387806
FR;1;2022-03-09;1817;6296;19527;362;18880;42371908;41077287;25186438;86708;27406686
FR;1;2022-03-10;1227;4050;14700;291;13713;42373135;41081337;25201138;86999;27420399
FR;1;2022-03-11;1651;6054;21500;477;19633;42374786;41087391;25222638;87476;27440032
FR;1;2022-03-12;1195;4555;15259;274;14795;42375981;41091946;25237897;87750;27454827
FR;1;2022-03-13;228;588;2008;114;1956;42376209;41092534;25239905;87864;27456783
FR;1;2022-03-14;1027;3450;13049;3872;12177;42377236;41095984;25252954;91736;27468960
FR;1;2022-03-15;1196;3664;13883;6843;12340;42378432;41099648;25266837;98579;27481300
FR;1;2022-03-16;1543;4530;16185;11502;15269;42379975;41104178;25283022;110081;27496569
FR;1;2022-03-17;1054;2949;10822;9576;9901;42381029;41107127;25293844;119657;27506470
FR;1;2022-03-18;1607;4544;17438;16419;15848;42382636;41111671;25311282;136076;27522318
FR;1;2022-03-19;1082;3103;11745;8438;11198;42383718;41114774;25323027;144514;27533516
FR;1;2022-03-20;203;496;1554;997;1580;42383921;41115270;25324581;145511;27535096
FR;1;2022-03-21;1004;2534;10080;13347;9444;42384925;41117804;25334661;158858;27544540
FR;1;2022-03-22;1130;2913;11380;18614;10371;42386055;41120717;25346041;177472;27554911
FR;1;2022-03-23;1378;3700;13007;19956;12556;42387433;41124417;25359048;197428;27567467
FR;1;2022-03-24;996;2345;9381;15791;8627;42388429;41126762;25368429;213219;27576094
FR;1;2022-03-25;1418;3778;15695;25109;14332;42389847;41130540;25384124;238328;27590426
FR;1;2022-03-26;1071;2721;10512;11351;10153;42390918;41133261;25394636;249679;27600579
FR;1;2022-03-27;222;516;1684;1349;1732;42391140;41133777;25396320;251028;27602311
FR;1;2022-03-28;987;2186;9097;15563;8705;42392127;41135963;25405417;266591;27611016
FR;1;2022-03-29;1073;2561;10841;24454;10201;42393200;41138524;25416258;291045;27621217
FR;1;2022-03-30;1516;3251;13081;23568;12599;42394716;41141775;25429339;314613;27633816
FR;1;2022-03-31;1157;2342;10375;20740;9862;42395873;41144117;25439714;335353;27643678
FR;2;2020-12-27;0;0;0;0;0;0;0;0;0;0
FR;2;2020-12-28;0;0;0;0;0;0;0;0;0;0
FR;2;2020-12-29;0;0;0;0;0;0;0;0;0;0
FR;2;2020-12-30;0;0;0;0;0;0;0;0;0;0
FR;2;2020-12-31;0;0;0;0;0;0;0;0;0;0
FR;2;2021-01-01;0;0;0;0;0;0;0;0;0;0
FR;2;2021-01-02;0;0;0;0;0;0;0;0;0;0
FR;2;2021-01-03;0;0;0;0;0;0;0;0;0;0
FR;2;2021-01-04;0;0;0;0;0;0;0;0;0;0
FR;2;2021-01-05;0;0;0;0;0;0;0;0;0;0
FR;2;2021-01-06;0;0;0;0;0;0;0;0;0;0
FR;2;2021-01-07;0;0;0;0;0;0;0;0;0;0
FR;2;2021-01-08;0;0;0;0;0;0;0;0;0;0
FR;2;2021-01-09;0;0;0;0;0;0;0;0;0;0
FR;2;2021-01-10;0;0;0;0;0;0;0;0;0;0
FR;2;2021-01-11;0;0;0;0;0;0;0;0;0;0
FR;2;2021-01-12;0;0;0;0;0;0;0;0;0;0
FR;2;2021-01-13;0;0;0;0;0;0;0;0;0;0
FR;2;2021-01-14;1702;0;0;0;0;1702;0;0;0;0
FR;2;2021-01-15;390;0;0;0;0;2092;0;0;0;0
FR;2;2021-01-16;312;0;0;0;0;2404;0;0;0;0
FR;2;2021-01-17;80;0;0;0;0;2484;0;0;0;0
FR;2;2021-01-18;3072;0;0;0;0;5556;0;0;0;0
FR;2;2021-01-19;4674;0;0;0;0;10230;0;0;0;0
FR;2;2021-01-20;5133;3;0;0;0;15363;3;0;0;0
FR;2;2021-01-21;5332;4;0;0;0;20695;7;0;0;0
FR;2;2021-01-22;5114;1;0;0;0;25809;8;0;0;0
FR;2;2021-01-23;1863;0;0;0;0;27672;8;0;0;0
FR;2;2021-01-24;160;1;0;0;0;27832;9;0;0;0
FR;2;2021-01-25;3810;1;0;0;0;31642;10;0;0;0
FR;2;2021-01-26;3914;0;0;0;0;35556;10;0;0;0
FR;2;2021-01-27;3595;1;0;0;0;39151;11;0;0;0
FR;2;2021-01-28;3740;1;0;0;0;42891;12;0;0;0
FR;2;2021-01-29;3286;2;0;0;0;46177;14;0;0;0
FR;2;2021-01-30;1129;1;0;0;0;47306;15;0;0;0
FR;2;2021-01-31;45;1;0;0;0;47351;16;0;0;0
FR;2;2021-02-01;3399;2;0;0;0;50750;18;0;0;0
FR;2;2021-02-02;4485;8;0;0;0;55235;26;0;0;0
FR;2;2021-02-03;5215;5;0;0;0;60450;31;0;0;0
FR;2;2021-02-04;4926;6;0;0;0;65376;37;0;0;0
FR;2;2021-02-05;4809;13;0;0;0;70185;50;0;0;0
FR;2;2021-02-06;2037;9;0;0;0;72222;59;0;0;0
FR;2;2021-02-07;97;4;0;0;0;72319;63;0;0;0
FR;2;2021-02-08;7549;16;0;0;0;79868;79;0;0;0
FR;2;2021-02-09;8418;25;0;0;0;88286;104;0;0;0
FR;2;2021-02-10;9336;55;0;0;0;97622;159;0;0;0
FR;2;2021-02-11;10271;79;0;0;0;107893;238;0;0;0
FR;2;2021-02-12;10046;248;0;0;0;117939;486;0;0;0
FR;2;2021-02-13;3116;227;0;0;0;121055;713;0;0;0
FR;2;2021-02-14;349;2;0;0;0;121404;715;0;0;0
FR;2;2021-02-15;3453;3079;0;0;0;124857;3794;0;0;0
FR;2;2021-02-16;5065;3928;0;0;0;129922;7722;0;0;0
FR;2;2021-02-17;4249;4422;0;0;0;134171;12144;0;0;0
FR;2;2021-02-18;5399;5100;0;0;0;139570;17244;0;0;0
FR;2;2021-02-19;5320;4349;0;0;0;144890;21593;0;0;0
FR;2;2021-02-20;1864;1507;0;0;0;146754;23100;0;0;0
FR;2;2021-02-21;239;86;0;0;0;146993;23186;0;0;0
FR;2;2021-02-22;3610;3723;0;0;0;150603;26909;0;0;0
FR;2;2021-02-23;4951;3689;0;0;0;155554;30598;0;0;0
FR;2;2021-02-24;5007;3462;0;0;0;160561;34060;0;0;0
FR;2;2021-02-25;5479;3440;0;0;0;166040;37500;0;0;0
FR;2;2021-02-26;4355;3134;0;0;0;170395;40634;0;0;0
FR;2;2021-02-27;1622;1045;0;0;0;172017;41679;0;0;0
FR;2;2021-02-28;176;32;0;0;0;172193;41711;0;0;0
FR;2;2021-03-01;5171;3751;0;0;0;177364;45462;0;0;0
FR;2;2021-03-02;6526;4720;0;0;0;183890;50182;0;0;0
FR;2;2021-03-03;6531;4893;0;0;0;190421;55075;0;0;0
FR;2;2021-03-04;8393;3972;0;0;0;198814;59047;0;0;0
FR;2;2021-03-05;8023;4064;0;0;0;206837;63111;0;0;0
FR;2;2021-03-06;4782;1684;0;0;0;211619;64795;0;0;0
FR;2;2021-03-07;2371;31;0;0;0;213990;64826;0;0;0
FR;2;2021-03-08;4163;8313;0;0;0;218153;73139;0;0;0
FR;2;2021-03-09;7482;8445;1;0;0;225635;81584;1;0;0
FR;2;2021-03-10;7092;9108;0;0;0;232727;90692;1;0;0
FR;2;2021-03-11;9370;9194;1;0;0;242097;99886;2;0;0
FR;2;2021-03-12;7968;8181;0;0;0;250065;108067;2;0;0
FR;2;2021-03-13;10045;2525;0;0;0;260110;110592;2;0;0
FR;2;2021-03-14;4838;402;0;0;0;264948;110994;2;0;0
FR;2;2021-03-15;10904;3485;0;0;0;275852;114479;2;0;0
FR;2;2021-03-16;16753;4637;1;0;0;292605;119116;3;0;0
FR;2;2021-03-17;20217;3960;0;0;0;312822;123076;3;0;0
FR;2;2021-03-18;23361;4916;0;0;0;336183;127992;3;0;0
FR;2;2021-03-19;23295;4539;0;0;0;359478;132531;3;0;0
FR;2;2021-03-20;25438;1541;0;0;0;384916;134072;3;0;0
FR;2;2021-03-21;17668;146;0;0;0;402584;134218;3;0;0
FR;2;2021-03-22;17780;3092;0;0;0;420364;137310;3;0;0
FR;2;2021-03-23;22681;4196;0;0;0;443045;141506;3;0;0
FR;2;2021-03-24;23952;4987;0;0;0;466997;146493;3;0;0
FR;2;2021-03-25;26734;5039;1;0;0;493731;151532;4;0;0
FR;2;2021-03-26;26973;4264;0;0;0;520704;155796;4;0;0
FR;2;2021-03-27;15913;1318;0;0;0;536617;157114;4;0;0
FR;2;2021-03-28;10560;106;0;0;0;547177;157220;4;0;0
FR;2;2021-03-29;18980;4280;0;0;0;566157;161500;4;0;0
FR;2;2021-03-30;24570;6016;0;0;0;590727;167516;4;0;0
FR;2;2021-03-31;28547;5941;0;0;0;619274;173457;4;0;0
FR;2;2021-04-01;34540;8487;1;0;0;653814;181944;5;0;0
FR;2;2021-04-02;29973;7664;0;0;0;683787;189608;5;0;0
FR;2;2021-04-03;16951;3614;0;0;0;700738;193222;5;0;0
FR;2;2021-04-04;9304;931;2;0;0;710042;194153;7;0;0
FR;2;2021-04-05;12437;811;0;0;0;722479;194964;7;0;0
FR;2;2021-04-06;27134;6939;0;0;0;749613;201903;7;0;0
FR;2;2021-04-07;30923;7165;1;0;0;780536;209068;8;0;0
FR;2;2021-04-08;36877;8796;1;0;0;817413;217864;9;0;0
FR;2;2021-04-09;33823;8586;28;0;0;851236;226450;37;0;0
FR;2;2021-04-10;19677;8983;1;0;0;870913;235433;38;0;0
FR;2;2021-04-11;7939;4262;1;0;0;878852;239695;39;0;0
FR;2;2021-04-12;17119;11213;0;0;0;895971;250908;39;0;0
FR;2;2021-04-13;19445;16348;1;0;0;915416;267256;40;0;0
FR;2;2021-04-14;18056;16271;7;0;0;933472;283527;47;0;0
FR;2;2021-04-15;22183;20761;26;0;0;955655;304288;73;0;0
FR;2;2021-04-16;20704;20046;45;0;0;976359;324334;118;0;0
FR;2;2021-04-17;13250;22441;5;0;0;989609;346775;123;0;0
FR;2;2021-04-18;5907;14387;6;0;0;995516;361162;129;0;0
FR;2;2021-04-19;16826;16245;24;0;0;1012342;377407;153;0;0
FR;2;2021-04-20;19312;21547;38;0;0;1031654;398954;191;0;0
FR;2;2021-04-21;20280;21658;76;0;0;1051934;420612;267;0;0
FR;2;2021-04-22;23804;24842;41;0;0;1075738;445454;308;0;0
FR;2;2021-04-23;24509;25339;76;0;0;1100247;470793;384;0;0
FR;2;2021-04-24;25299;15081;102;0;0;1125546;485874;486;0;0
FR;2;2021-04-25;9592;8592;5;0;0;1135138;494466;491;0;0
FR;2;2021-04-26;17154;17202;21;0;0;1152292;511668;512;0;0
FR;2;2021-04-27;19238;24276;40;0;0;1171530;535944;552;0;0
FR;2;2021-04-28;22330;26177;112;0;0;1193860;562121;664;0;0
FR;2;2021-04-29;25462;30128;69;0;0;1219322;592249;733;0;0
FR;2;2021-04-30;25530;27746;49;1;0;1244852;619995;782;1;0
FR;2;2021-05-01;14979;9866;6;0;0;1259831;629861;788;1;0
FR;2;2021-05-02;6634;9174;2;0;0;1266465;639035;790;1;0
FR;2;2021-05-03;20012;19291;40;0;0;1286477;658326;830;1;0
FR;2;2021-05-04;18280;29031;33;0;0;1304757;687357;863;1;0
FR;2;2021-05-05;18358;29375;48;0;0;1323115;716732;911;1;0
FR;2;2021-05-06;23533;35232;131;0;0;1346648;751964;1042;1;0
FR;2;2021-05-07;25320;33201;97;0;0;1371968;785165;1139;1;0
FR;2;2021-05-08;21332;9708;14;0;0;1393300;794873;1153;1;0
FR;2;2021-05-09;13161;7880;7;0;0;1406461;802753;1160;1;0
FR;2;2021-05-10;32934;22181;48;0;0;1439395;824934;1208;1;0
FR;2;2021-05-11;43589;21053;101;0;0;1482984;845987;1309;1;0
FR;2;2021-05-12;50033;19875;143;0;0;1533017;865862;1452;1;0
FR;2;2021-05-13;51286;5768;31;0;0;1584303;871630;1483;1;0
FR;2;2021-05-14;61337;12920;132;0;0;1645640;884550;1615;1;0
FR;2;2021-05-15;65918;7139;39;0;0;1711558;891689;1654;1;0
FR;2;2021-05-16;43577;2568;10;0;0;1755135;894257;1664;1;0
FR;2;2021-05-17;44739;12563;113;0;0;1799874;906820;1777;1;0
FR;2;2021-05-18;54632;12234;191;0;0;1854506;919054;1968;1;0
FR;2;2021-05-19;57159;10600;281;0;0;1911665;929654;2249;1;0
FR;2;2021-05-20;63427;10843;286;0;0;1975092;940497;2535;1;0
FR;2;2021-05-21;64282;11654;230;0;0;2039374;952151;2765;1;0
FR;2;2021-05-22;61475;4504;65;0;0;2100849;956655;2830;1;0
FR;2;2021-05-23;37529;569;22;0;0;2138378;957224;2852;1;0
FR;2;2021-05-24;17232;2032;33;0;0;2155610;959256;2885;1;0
FR;2;2021-05-25;21099;12230;239;0;0;2176709;971486;3124;1;0
FR;2;2021-05-26;19925;11444;229;0;0;2196634;982930;3353;1;0
FR;2;2021-05-27;22987;12660;181;0;0;2219621;995590;3534;1;0
FR;2;2021-05-28;29384;14949;190;0;0;2249005;1010539;3724;1;0
FR;2;2021-05-29;30412;8177;57;0;0;2279417;1018716;3781;1;0
FR;2;2021-05-30;4646;1813;6;0;0;2284063;1020529;3787;1;0
FR;2;2021-05-31;28581;18716;183;0;0;2312644;1039245;3970;1;0
FR;2;2021-06-01;45706;20022;221;0;0;2358350;1059267;4191;1;0
FR;2;2021-06-02;37458;19296;181;0;0;2395808;1078563;4372;1;0
FR;2;2021-06-03;51261;23353;161;0;0;2447069;1101916;4533;1;0
FR;2;2021-06-04;65504;24048;215;0;0;2512573;1125964;4748;1;0
FR;2;2021-06-05;34596;24024;51;0;0;2547169;1149988;4799;1;0
FR;2;2021-06-06;4946;6199;10;0;0;2552115;1156187;4809;1;0
FR;2;2021-06-07;28159;23056;146;0;0;2580274;1179243;4955;1;0
FR;2;2021-06-08;46370;22924;143;0;0;2626644;1202167;5098;1;0
FR;2;2021-06-09;34277;20917;107;0;0;2660921;1223084;5205;1;0
FR;2;2021-06-10;42631;19137;95;1;0;2703552;1242221;5300;2;0
FR;2;2021-06-11;55277;25228;133;0;0;2758829;1267449;5433;2;0
FR;2;2021-06-12;30556;19779;53;0;0;2789385;1287228;5486;2;0
FR;2;2021-06-13;3327;9182;13;0;0;2792712;1296410;5499;2;0
FR;2;2021-06-14;25294;24163;92;0;0;2818006;1320573;5591;2;0
FR;2;2021-06-15;39025;22853;154;0;0;2857031;1343426;5745;2;0
FR;2;2021-06-16;30154;21456;134;0;0;2887185;1364882;5879;2;0
FR;2;2021-06-17;36897;25867;150;0;0;2924082;1390749;6029;2;0
FR;2;2021-06-18;46841;28794;122;0;0;2970923;1419543;6151;2;0
FR;2;2021-06-19;24523;24893;39;0;0;2995446;1444436;6190;2;0
FR;2;2021-06-20;3737;10062;10;0;0;2999183;1454498;6200;2;0
FR;2;2021-06-21;17520;42835;87;0;0;3016703;1497333;6287;2;0
FR;2;2021-06-22;28353;49541;110;0;0;3045056;1546874;6397;2;0
FR;2;2021-06-23;21784;49565;106;1;1;3066840;1596439;6503;3;1
FR;2;2021-06-24;28370;50290;133;0;0;3095210;1646729;6636;3;1
FR;2;2021-06-25;33393;60378;126;0;0;3128603;1707107;6762;3;1
FR;2;2021-06-26;16368;59238;54;1;0;3144971;1766345;6816;4;1
FR;2;2021-06-27;2564;29322;22;1;0;3147535;1795667;6838;5;1
FR;2;2021-06-28;12633;54339;80;0;0;3160168;1850006;6918;5;1
FR;2;2021-06-29;19837;59878;178;0;0;3180005;1909884;7096;5;1
FR;2;2021-06-30;16315;57844;251;17;0;3196320;1967728;7347;22;1
FR;2;2021-07-01;20472;59885;227;0;0;3216792;2027613;7574;22;1
FR;2;2021-07-02;24067;62121;183;0;0;3240859;2089734;7757;22;1
FR;2;2021-07-03;12106;57078;153;0;0;3252965;2146812;7910;22;1
FR;2;2021-07-04;1957;23309;18;0;0;3254922;2170121;7928;22;1
FR;2;2021-07-05;9166;29359;106;0;0;3264088;2199480;8034;22;1
FR;2;2021-07-06;14569;36192;134;0;0;3278657;2235672;8168;22;1
FR;2;2021-07-07;14398;33665;138;0;0;3293055;2269337;8306;22;1
FR;2;2021-07-08;19709;40290;162;0;0;3312764;2309627;8468;22;1
FR;2;2021-07-09;27088;54258;202;1;1;3339852;2363885;8670;23;2
FR;2;2021-07-10;13380;33659;107;0;0;3353232;2397544;8777;23;2
FR;2;2021-07-11;1801;4336;16;0;0;3355033;2401880;8793;23;2
FR;2;2021-07-12;12959;37263;118;0;0;3367992;2439143;8911;23;2
FR;2;2021-07-13;37107;53230;150;0;0;3405099;2492373;9061;23;2
FR;2;2021-07-14;6601;3570;15;0;0;3411700;2495943;9076;23;2
FR;2;2021-07-15;47220;47027;156;0;0;3458920;2542970;9232;23;2
FR;2;2021-07-16;64303;55822;187;0;0;3523223;2598792;9419;23;2
FR;2;2021-07-17;31589;23931;96;0;0;3554812;2622723;9515;23;2
FR;2;2021-07-18;6086;4895;19;0;0;3560898;2627618;9534;23;2
FR;2;2021-07-19;32982;28685;93;0;0;3593880;2656303;9627;23;2
FR;2;2021-07-20;51982;44562;155;0;0;3645862;2700865;9782;23;2
FR;2;2021-07-21;45243;34783;93;0;0;3691105;2735648;9875;23;2
FR;2;2021-07-22;56266;41115;128;1;0;3747371;2776763;10003;24;2
FR;2;2021-07-23;68271;49093;170;0;0;3815642;2825856;10173;24;2
FR;2;2021-07-24;36161;21577;82;0;0;3851803;2847433;10255;24;2
FR;2;2021-07-25;6736;2658;10;0;0;3858539;2850091;10265;24;2
FR;2;2021-07-26;36286;22467;91;1;0;3894825;2872558;10356;25;2
FR;2;2021-07-27;62342;34626;180;0;0;3957167;2907184;10536;25;2
FR;2;2021-07-28;55278;26460;133;0;0;4012445;2933644;10669;25;2
FR;2;2021-07-29;68434;32774;189;0;0;4080879;2966418;10858;25;2
FR;2;2021-07-30;74417;37775;222;1;1;4155296;3004193;11080;26;3
FR;2;2021-07-31;34744;16173;104;0;0;4190040;3020366;11184;26;3
FR;2;2021-08-01;5393;2292;19;0;0;4195433;3022658;11203;26;3
FR;2;2021-08-02;35848;16205;101;0;0;4231281;3038863;11304;26;3
FR;2;2021-08-03;55947;28283;142;0;0;4287228;3067146;11446;26;3
FR;2;2021-08-04;46615;20861;128;0;0;4333843;3088007;11574;26;3
FR;2;2021-08-05;54600;31581;215;0;0;4388443;3119588;11789;26;3
FR;2;2021-08-06;58065;42382;242;1;0;4446508;3161970;12031;27;3
FR;2;2021-08-07;25130;17600;89;0;0;4471638;3179570;12120;27;3
FR;2;2021-08-08;3831;3671;21;0;0;4475469;3183241;12141;27;3
FR;2;2021-08-09;29281;21134;91;0;0;4504750;3204375;12232;27;3
FR;2;2021-08-10;44977;33513;152;0;0;4549727;3237888;12384;27;3
FR;2;2021-08-11;35258;25163;150;0;0;4584985;3263051;12534;27;3
FR;2;2021-08-12;41874;35733;162;0;0;4626859;3298784;12696;27;3
FR;2;2021-08-13;42578;37012;218;0;0;4669437;3335796;12914;27;3
FR;2;2021-08-14;18502;22266;93;0;0;4687939;3358062;13007;27;3
FR;2;2021-08-15;3791;3814;17;0;0;4691730;3361876;13024;27;3
FR;2;2021-08-16;25070;27221;110;0;0;4716800;3389097;13134;27;3
FR;2;2021-08-17;38246;43482;205;2;0;4755046;3432579;13339;29;3
FR;2;2021-08-18;32242;36385;192;1;1;4787288;3468964;13531;30;4
FR;2;2021-08-19;37423;46601;224;0;0;4824711;3515565;13755;30;4
FR;2;2021-08-20;40550;55582;269;1;0;4865261;3571147;14024;31;4
FR;2;2021-08-21;18112;24296;113;0;0;4883373;3595443;14137;31;4
FR;2;2021-08-22;2901;4325;22;1;1;4886274;3599768;14159;32;5
FR;2;2021-08-23;19237;35150;131;1;1;4905511;3634918;14290;33;6
FR;2;2021-08-24;31933;56027;234;0;0;4937444;3690945;14524;33;6
FR;2;2021-08-25;25925;43422;250;0;0;4963369;3734367;14774;33;6
FR;2;2021-08-26;32339;55773;387;0;0;4995708;3790140;15161;33;6
FR;2;2021-08-27;36992;65562;477;3;1;5032700;3855702;15638;36;7
FR;2;2021-08-28;17808;28459;300;0;0;5050508;3884161;15938;36;7
FR;2;2021-08-29;2654;5032;47;0;0;5053162;3889193;15985;36;7
FR;2;2021-08-30;18407;37750;399;0;761;5071569;3926943;16384;36;768
FR;2;2021-08-31;28071;57502;881;4;1533;5099640;3984445;17265;40;2301
FR;2;2021-09-01;21582;39818;1305;0;2084;5121222;4024263;18570;40;4385
FR;2;2021-09-02;25474;48592;1957;2;3271;5146696;4072855;20527;42;7656
FR;2;2021-09-03;33403;64466;2986;3;4813;5180099;4137321;23513;45;12469
FR;2;2021-09-04;16822;27676;1441;1;2342;5196921;4164997;24954;46;14811
FR;2;2021-09-05;2257;3619;263;0;412;5199178;4168616;25217;46;15223
FR;2;2021-09-06;14029;28733;1768;1;2929;5213207;4197349;26985;47;18152
FR;2;2021-09-07;21095;41046;3019;13;4843;5234302;4238395;30004;60;22995
FR;2;2021-09-08;17236;31909;2729;6;4438;5251538;4270304;32733;66;27433
FR;2;2021-09-09;20968;40431;4426;3;6718;5272506;4310735;37159;69;34151
FR;2;2021-09-10;28186;51091;5278;4;8774;5300692;4361826;42437;73;42925
FR;2;2021-09-11;13649;22329;2401;5;3915;5314341;4384155;44838;78;46840
FR;2;2021-09-12;1821;2796;282;0;502;5316162;4386951;45120;78;47342
FR;2;2021-09-13;11655;21453;2465;4;3993;5327817;4408404;47585;82;51335
FR;2;2021-09-14;18564;32772;5080;13;9002;5346381;4441176;52665;95;60337
FR;2;2021-09-15;14908;28284;5163;3;7779;5361289;4469460;57828;98;68116
FR;2;2021-09-16;16063;32751;6731;14;10514;5377352;4502211;64559;112;78630
FR;2;2021-09-17;20907;47068;8773;10;14559;5398259;4549279;73332;122;93189
FR;2;2021-09-18;9852;20917;3801;6;6022;5408111;4570196;77133;128;99211
FR;2;2021-09-19;1164;2657;395;0;650;5409275;4572853;77528;128;99861
FR;2;2021-09-20;7486;18803;3850;7;6148;5416761;4591656;81378;135;106009
FR;2;2021-09-21;11201;30008;6492;5;10736;5427962;4621664;87870;140;116745
FR;2;2021-09-22;9405;23547;5489;7;8509;5437367;4645211;93359;147;125254
FR;2;2021-09-23;10718;28864;7876;9;12630;5448085;4674075;101235;156;137884
FR;2;2021-09-24;15060;42822;10866;18;17150;5463145;4716897;112101;174;155034
FR;2;2021-09-25;7257;18706;3959;10;6071;5470402;4735603;116060;184;161105
FR;2;2021-09-26;1078;2563;494;0;637;5471480;4738166;116554;184;161742
FR;2;2021-09-27;6308;16448;4285;7;6549;5477788;4754614;120839;191;168291
FR;2;2021-09-28;9240;25537;7759;13;12053;5487028;4780151;128598;204;180344
FR;2;2021-09-29;8078;20206;6065;25;9251;5495106;4800357;134663;229;189595
FR;2;2021-09-30;9862;25777;9495;16;14071;5504968;4826134;144158;245;203666
FR;2;2021-10-01;13962;35618;12905;25;19213;5518930;4861752;157063;270;222879
FR;2;2021-10-02;6869;15863;4843;6;6992;5525799;4877615;161906;276;229871
FR;2;2021-10-03;841;1963;490;1;519;5526640;4879578;162396;277;230390
FR;2;2021-10-04;5816;13923;5512;5;7855;5532456;4893501;167908;282;238245
FR;2;2021-10-05;9047;22532;11119;19;15705;5541503;4916033;179027;301;253950
FR;2;2021-10-06;7777;17743;8236;11;11060;5549280;4933776;187263;312;265010
FR;2;2021-10-07;9193;22182;12369;15;16814;5558473;4955958;199632;327;281824
FR;2;2021-10-08;13420;32023;17344;27;23512;5571893;4987981;216976;354;305336
FR;2;2021-10-09;5996;12817;6039;6;7871;5577889;5000798;223015;360;313207
FR;2;2021-10-10;881;1636;435;2;630;5578770;5002434;223450;362;313837
FR;2;2021-10-11;5601;11615;6454;17;8836;5584371;5014049;229904;379;322673
FR;2;2021-10-12;8032;17752;12532;13;16723;5592403;5031801;242436;392;339396
FR;2;2021-10-13;6936;14852;10244;11;13599;5599339;5046653;252680;403;352995
FR;2;2021-10-14;8312;17924;14984;13;19437;5607651;5064577;267664;416;372432
FR;2;2021-10-15;11842;26259;20893;26;27924;5619493;5090836;288557;442;400356
FR;2;2021-10-16;5136;8729;1815;0;3205;5624629;5099565;290372;442;403561
FR;2;2021-10-17;650;1196;183;0;377;5625279;5100761;290555;442;403938
FR;2;2021-10-18;4555;7434;660;2;1680;5629834;5108195;291215;444;405618
FR;2;2021-10-19;6236;9912;728;5;2066;5636070;5118107;291943;449;407684
FR;2;2021-10-20;5159;8114;756;3;1685;5641229;5126221;292699;452;409369
FR;2;2021-10-21;6086;9968;777;5;2090;5647315;5136189;293476;457;411459
FR;2;2021-10-22;8442;14543;1140;4;2858;5655757;5150732;294616;461;414317
FR;2;2021-10-23;3840;5998;580;0;1237;5659597;5156730;295196;461;415554
FR;2;2021-10-24;493;882;99;0;199;5660090;5157612;295295;461;415753
FR;2;2021-10-25;3358;5387;296;1;827;5663448;5162999;295591;462;416580
FR;2;2021-10-26;4172;7249;1118;4;1994;5667620;5170248;296709;466;418574
FR;2;2021-10-27;3671;6633;1191;5;2000;5671291;5176881;297900;471;420574
FR;2;2021-10-28;4594;7692;1724;3;2734;5675885;5184573;299624;474;423308
FR;2;2021-10-29;5406;11076;2428;4;3663;5681291;5195649;302052;478;426971
FR;2;2021-10-30;2748;4428;971;1;1426;5684039;5200077;303023;479;428397
FR;2;2021-10-31;364;551;138;1;187;5684403;5200628;303161;480;428584
FR;2;2021-11-01;411;556;170;0;261;5684814;5201184;303331;480;428845
FR;2;2021-11-02;3285;6768;1177;0;1757;5688099;5207952;304508;480;430602
FR;2;2021-11-03;3332;6255;1380;2;1964;5691431;5214207;305888;482;432566
FR;2;2021-11-04;3984;7108;1756;4;2487;5695415;5221315;307644;486;435053
FR;2;2021-11-05;5221;10494;2862;5;3939;5700636;5231809;310506;491;438992
FR;2;2021-11-06;2589;4657;1396;0;1802;5703225;5236466;311902;491;440794
FR;2;2021-11-07;507;869;215;0;288;5703732;5237335;312117;491;441082
FR;2;2021-11-08;2575;5381;1199;3;1683;5706307;5242716;313316;494;442765
FR;2;2021-11-09;2748;6957;2389;6;3171;5709055;5249673;315705;500;445936
FR;2;2021-11-10;2582;5711;5087;6;6257;5711637;5255384;320792;506;452193
FR;2;2021-11-11;432;735;730;2;909;5712069;5256119;321522;508;453102
FR;2;2021-11-12;2946;8109;8958;8;10891;5715015;5264228;330480;516;463993
FR;2;2021-11-13;1529;3366;3864;7;4521;5716544;5267594;334344;523;468514
FR;2;2021-11-14;253;614;345;1;488;5716797;5268208;334689;524;469002
FR;2;2021-11-15;1618;3714;4432;9;5324;5718415;5271922;339121;533;474326
FR;2;2021-11-16;2181;5955;8285;14;10062;5720596;5277877;347406;547;484388
FR;2;2021-11-17;1736;4574;6614;8;7831;5722332;5282451;354020;555;492219
FR;2;2021-11-18;2186;5945;9166;11;10985;5724518;5288396;363186;566;503204
FR;2;2021-11-19;2696;7792;12954;19;15459;5727214;5296188;376140;585;518663
FR;2;2021-11-20;1565;3317;5164;5;6061;5728779;5299505;381304;590;524724
FR;2;2021-11-21;246;522;539;0;665;5729025;5300027;381843;590;525389
FR;2;2021-11-22;1274;2633;4466;5;5398;5730299;5302660;386309;595;530787
FR;2;2021-11-23;1612;4321;8183;9;9886;5731911;5306981;394492;604;540673
FR;2;2021-11-24;1420;3808;7455;15;8710;5733331;5310789;401947;619;549383
FR;2;2021-11-25;1809;4900;11441;21;13635;5735140;5315689;413388;640;563018
FR;2;2021-11-26;2533;7779;22642;31;26058;5737673;5323468;436030;671;589076
FR;2;2021-11-27;1497;4135;12254;18;13989;5739170;5327603;448284;689;603065
FR;2;2021-11-28;292;844;1965;3;2292;5739462;5328447;450249;692;605357
FR;2;2021-11-29;1444;4386;15070;23;17232;5740906;5332833;465319;715;622589
FR;2;2021-11-30;1910;6763;26218;36;29974;5742816;5339596;491537;751;652563
FR;2;2021-12-01;1899;6094;26181;29;29495;5744715;5345690;517718;780;682058
FR;2;2021-12-02;1909;6831;37679;52;41920;5746624;5352521;555397;832;723978
FR;2;2021-12-03;2549;10089;53583;112;59290;5749173;5362610;608980;944;783268
FR;2;2021-12-04;1847;6273;37083;38;40739;5751020;5368883;646063;982;824007
FR;2;2021-12-05;458;2291;14248;13;15991;5751478;5371174;660311;995;839998
FR;2;2021-12-06;2453;9892;77672;109;84729;5753931;5381066;737983;1104;924727
FR;2;2021-12-07;3441;15332;122405;238;133676;5757372;5396398;860388;1342;1058403
FR;2;2021-12-08;3715;16041;133162;330;145349;5761087;5412439;993550;1672;1203752
FR;2;2021-12-09;4544;19600;170127;554;185462;5765631;5432039;1163677;2226;1389214
FR;2;2021-12-10;4667;22805;188595;489;206014;5770298;5454844;1352272;2715;1595228
FR;2;2021-12-11;3681;16604;132417;238;144833;5773979;5471448;1484689;2953;1740061
FR;2;2021-12-12;1257;7140;59071;83;65128;5775236;5478588;1543760;3036;1805189
FR;2;2021-12-13;5523;26852;220637;604;242916;5780759;5505440;1764397;3640;2048105
FR;2;2021-12-14;7017;37502;300695;910;332142;5787776;5542942;2065092;4550;2380247
FR;2;2021-12-15;6559;36228;285151;955;315737;5794335;5579170;2350243;5505;2695984
FR;2;2021-12-16;7765;37927;312085;981;343677;5802100;5617097;2662328;6486;3039661
FR;2;2021-12-17;8683;41211;327813;975;360861;5810783;5658308;2990141;7461;3400522
FR;2;2021-12-18;6517;26568;212310;448;233615;5817300;5684876;3202451;7909;3634137
FR;2;2021-12-19;2602;11509;90195;184;100386;5819902;5696385;3292646;8093;3734523
FR;2;2021-12-20;9550;33603;275128;707;303302;5829452;5729988;3567774;8800;4037825
FR;2;2021-12-21;11555;38297;309565;970;341320;5841007;5768285;3877339;9770;4379145
FR;2;2021-12-22;10452;32880;265066;952;292463;5851459;5801165;4142405;10722;4671608
FR;2;2021-12-23;9428;26712;199439;700;221245;5860887;5827877;4341844;11422;4892853
FR;2;2021-12-24;2780;7507;43841;140;49563;5863667;5835384;4385685;11562;4942416
FR;2;2021-12-25;201;705;2000;10;2501;5863868;5836089;4387685;11572;4944917
FR;2;2021-12-26;1322;4212;25143;71;28679;5865190;5840301;4412828;11643;4973596
FR;2;2021-12-27;8077;29924;218372;658;243284;5873267;5870225;4631200;12301;5216880
FR;2;2021-12-28;9842;36347;272055;741;301946;5883109;5906572;4903255;13042;5518826
FR;2;2021-12-29;9492;32290;246091;766;272662;5892601;5938862;5149346;13808;5791488
FR;2;2021-12-30;9450;28132;208797;662;231458;5902051;5966994;5358143;14470;6022946
FR;2;2021-12-31;3009;8397;54973;177;61242;5905060;5975391;5413116;14647;6084188
FR;2;2022-01-01;227;690;2848;7;3336;5905287;5976081;5415964;14654;6087524
FR;2;2022-01-02;1505;4851;29505;74;33392;5906792;5980932;5445469;14728;6120916
FR;2;2022-01-03;9578;35340;266491;807;293842;5916370;6016272;5711960;15535;6414758
FR;2;2022-01-04;12838;45344;342048;1067;376923;5929208;6061616;6054008;16602;6791681
FR;2;2022-01-05;11270;38664;294121;884;323788;5940478;6100280;6348129;17486;7115469
FR;2;2022-01-06;13651;43456;331903;1296;364661;5954129;6143736;6680032;18782;7480130
FR;2;2022-01-07;14225;47614;361055;1268;396373;5968354;6191350;7041087;20050;7876503
FR;2;2022-01-08;7946;28139;201243;514;221663;5976300;6219489;7242330;20564;8098166
FR;2;2022-01-09;2749;9033;62513;137;69536;5979049;6228522;7304843;20701;8167702
FR;2;2022-01-10;10086;31918;232429;857;255030;5989135;6260440;7537272;21558;8422732
FR;2;2022-01-11;11463;36256;265853;1030;290550;6000598;6296696;7803125;22588;8713282
FR;2;2022-01-12;8755;29840;206283;861;226159;6009353;6326536;8009408;23449;8939441
FR;2;2022-01-13;9383;31334;224449;830;244795;6018736;6357870;8233857;24279;9184236
FR;2;2022-01-14;9739;35691;254497;919;277669;6028475;6393561;8488354;25198;9461905
FR;2;2022-01-15;5353;19443;140757;358;153623;6033828;6413004;8629111;25556;9615528
FR;2;2022-01-16;1513;5539;35862;80;39850;6035341;6418543;8664973;25636;9655378
FR;2;2022-01-17;5546;19309;135376;601;147243;6040887;6437852;8800349;26237;9802621
FR;2;2022-01-18;6416;21542;148594;647;160473;6047303;6459394;8948943;26884;9963094
FR;2;2022-01-19;4385;16376;105072;552;113683;6051688;6475770;9054015;27436;10076777
FR;2;2022-01-20;4865;17588;115259;601;123657;6056553;6493358;9169274;28037;10200434
FR;2;2022-01-21;5190;20059;137314;677;147732;6061743;6513417;9306588;28714;10348166
FR;2;2022-01-22;3026;10975;74248;259;80326;6064769;6524392;9380836;28973;10428492
FR;2;2022-01-23;722;2740;15233;41;16840;6065491;6527132;9396069;29014;10445332
FR;2;2022-01-24;3290;12839;75052;428;81008;6068781;6539971;9471121;29442;10526340
FR;2;2022-01-25;3573;14436;79601;495;85443;6072354;6554407;9550722;29937;10611783
FR;2;2022-01-26;2514;10655;58952;363;62983;6074868;6565062;9609674;30300;10674766
FR;2;2022-01-27;2683;11212;64153;388;67885;6077551;6576274;9673827;30688;10742651
FR;2;2022-01-28;3540;18441;91701;430;98962;6081091;6594715;9765528;31118;10841613
FR;2;2022-01-29;1890;9265;48831;163;52917;6082981;6603980;9814359;31281;10894530
FR;2;2022-01-30;466;2252;9453;37;10611;6083447;6606232;9823812;31318;10905141
FR;2;2022-01-31;1885;9610;43810;208;47340;6085332;6615842;9867622;31526;10952481
FR;2;2022-02-01;1907;10050;47014;278;50100;6087239;6625892;9914636;31804;11002581
FR;2;2022-02-02;1602;9031;41091;251;44159;6088841;6634923;9955727;32055;11046740
FR;2;2022-02-03;1715;8936;40500;204;42901;6090556;6643859;9996227;32259;11089641
FR;2;2022-02-04;2149;15225;66611;297;71337;6092705;6659084;10062838;32556;11160978
FR;2;2022-02-05;1360;8542;35929;131;39229;6094065;6667626;10098767;32687;11200207
FR;2;2022-02-06;274;1786;6122;16;6897;6094339;6669412;10104889;32703;11207104
FR;2;2022-02-07;1343;9613;37739;133;41301;6095682;6679025;10142628;32836;11248405
FR;2;2022-02-08;1295;9802;40923;173;43703;6096977;6688827;10183551;33009;11292108
FR;2;2022-02-09;1160;8802;37028;172;40444;6098137;6697629;10220579;33181;11332552
FR;2;2022-02-10;1015;7969;33826;203;36493;6099152;6705598;10254405;33384;11369045
FR;2;2022-02-11;1390;12074;53332;222;57676;6100542;6717672;10307737;33606;11426721
FR;2;2022-02-12;750;6523;27982;83;30799;6101292;6724195;10335719;33689;11457520
FR;2;2022-02-13;198;1333;4832;20;5572;6101490;6725528;10340551;33709;11463092
FR;2;2022-02-14;834;6721;30252;89;33217;6102324;6732249;10370803;33798;11496309
FR;2;2022-02-15;772;6444;28039;140;29978;6103096;6738693;10398842;33938;11526287
FR;2;2022-02-16;653;5335;22031;123;23588;6103749;6744028;10420873;34061;11549875
FR;2;2022-02-17;512;3766;14139;98;14602;6104261;6747794;10435012;34159;11564477
FR;2;2022-02-18;721;5356;20424;133;21118;6104982;6753150;10455436;34292;11585595
FR;2;2022-02-19;427;3042;10526;66;11237;6105409;6756192;10465962;34358;11596832
FR;2;2022-02-20;101;510;1455;3;1602;6105510;6756702;10467417;34361;11598434
FR;2;2022-02-21;416;2678;9107;65;9482;6105926;6759380;10476524;34426;11607916
FR;2;2022-02-22;390;2560;8886;75;8787;6106316;6761940;10485410;34501;11616703
FR;2;2022-02-23;430;2594;8978;82;9258;6106746;6764534;10494388;34583;11625961
FR;2;2022-02-24;312;2024;6791;81;6818;6107058;6766558;10501179;34664;11632779
FR;2;2022-02-25;454;3188;11405;108;11268;6107512;6769746;10512584;34772;11644047
FR;2;2022-02-26;291;1886;6032;49;6337;6107803;6771632;10518616;34821;11650384
FR;2;2022-02-27;73;311;903;5;945;6107876;6771943;10519519;34826;11651329
FR;2;2022-02-28;326;1673;5509;50;5515;6108202;6773616;10525028;34876;11656844
FR;2;2022-03-01;268;1548;5463;44;5178;6108470;6775164;10530491;34920;11662022
FR;2;2022-03-02;296;1428;5232;43;5073;6108766;6776592;10535723;34963;11667095
FR;2;2022-03-03;223;1092;3687;40;3464;6108989;6777684;10539410;35003;11670559
FR;2;2022-03-04;230;1455;4843;73;4488;6109219;6779139;10544253;35076;11675047
FR;2;2022-03-05;167;892;2969;31;2707;6109386;6780031;10547222;35107;11677754
FR;2;2022-03-06;36;176;269;5;309;6109422;6780207;10547491;35112;11678063
FR;2;2022-03-07;152;650;1978;68;1769;6109574;6780857;10549469;35180;11679832
FR;2;2022-03-08;140;648;2258;49;1891;6109714;6781505;10551727;35229;11681723
FR;2;2022-03-09;149;690;2328;36;2028;6109863;6782195;10554055;35265;11683751
FR;2;2022-03-10;115;584;1656;34;1429;6109978;6782779;10555711;35299;11685180
FR;2;2022-03-11;166;746;2759;57;2357;6110144;6783525;10558470;35356;11687537
FR;2;2022-03-12;140;474;1779;27;1547;6110284;6783999;10560249;35383;11689084
FR;2;2022-03-13;25;73;201;29;202;6110309;6784072;10560450;35412;11689286
FR;2;2022-03-14;119;449;1537;529;1268;6110428;6784521;10561987;35941;11690554
FR;2;2022-03-15;141;409;1688;687;1301;6110569;6784930;10563675;36628;11691855
FR;2;2022-03-16;136;446;1960;1610;1536;6110705;6785376;10565635;38238;11693391
FR;2;2022-03-17;92;405;1388;1190;1127;6110797;6785781;10567023;39428;11694518
FR;2;2022-03-18;139;481;1999;1786;1637;6110936;6786262;10569022;41214;11696155
FR;2;2022-03-19;106;318;1206;935;1012;6111042;6786580;10570228;42149;11697167
FR;2;2022-03-20;12;71;173;58;147;6111054;6786651;10570401;42207;11697314
FR;2;2022-03-21;94;289;1167;1475;1030;6111148;6786940;10571568;43682;11698344
FR;2;2022-03-22;113;372;1499;1826;1258;6111261;6787312;10573067;45508;11699602
FR;2;2022-03-23;135;325;1624;3019;1407;6111396;6787637;10574691;48527;11701009
FR;2;2022-03-24;105;275;1151;1534;956;6111501;6787912;10575842;50061;11701965
FR;2;2022-03-25;112;349;1740;2433;1422;6111613;6788261;10577582;52494;11703387
FR;2;2022-03-26;67;239;1176;1217;924;6111680;6788500;10578758;53711;11704311
FR;2;2022-03-27;18;36;147;93;125;6111698;6788536;10578905;53804;11704436
FR;2;2022-03-28;88;268;1106;1568;961;6111786;6788804;10580011;55372;11705397
FR;2;2022-03-29;100;241;1291;2428;1072;6111886;6789045;10581302;57800;11706469
FR;2;2022-03-30;84;281;1440;3054;1263;6111970;6789326;10582742;60854;11707732
FR;2;2022-03-31;95;250;1170;2007;975;6112065;6789576;10583912;62861;11708707
FR;3;2020-12-27;0;0;0;0;0;0;0;0;0;0
FR;3;2020-12-28;0;0;0;0;0;0;0;0;0;0
FR;3;2020-12-29;0;0;0;0;0;0;0;0;0;0
FR;3;2020-12-30;0;0;0;0;0;0;0;0;0;0
FR;3;2020-12-31;0;0;0;0;0;0;0;0;0;0
FR;3;2021-01-01;0;0;0;0;0;0;0;0;0;0
FR;3;2021-01-02;0;0;0;0;0;0;0;0;0;0
FR;3;2021-01-03;0;0;0;0;0;0;0;0;0;0
FR;3;2021-01-04;0;0;0;0;0;0;0;0;0;0
FR;3;2021-01-05;0;0;0;0;0;0;0;0;0;0
FR;3;2021-01-06;0;0;0;0;0;0;0;0;0;0
FR;3;2021-01-07;0;0;0;0;0;0;0;0;0;0
FR;3;2021-01-08;0;0;0;0;0;0;0;0;0;0
FR;3;2021-01-09;0;0;0;0;0;0;0;0;0;0
FR;3;2021-01-10;0;0;0;0;0;0;0;0;0;0
FR;3;2021-01-11;0;0;0;0;0;0;0;0;0;0
FR;3;2021-01-12;0;0;0;0;0;0;0;0;0;0
FR;3;2021-01-13;0;0;0;0;0;0;0;0;0;0
FR;3;2021-01-14;0;0;0;0;0;0;0;0;0;0
FR;3;2021-01-15;0;0;0;0;0;0;0;0;0;0
FR;3;2021-01-16;0;0;0;0;0;0;0;0;0;0
FR;3;2021-01-17;0;0;0;0;0;0;0;0;0;0
FR;3;2021-01-18;0;0;0;0;0;0;0;0;0;0
FR;3;2021-01-19;0;0;0;0;0;0;0;0;0;0
FR;3;2021-01-20;0;0;0;0;0;0;0;0;0;0
FR;3;2021-01-21;0;0;0;0;0;0;0;0;0;0
FR;3;2021-01-22;0;0;0;0;0;0;0;0;0;0
FR;3;2021-01-23;0;0;0;0;0;0;0;0;0;0
FR;3;2021-01-24;0;0;0;0;0;0;0;0;0;0
FR;3;2021-01-25;0;0;0;0;0;0;0;0;0;0
FR;3;2021-01-26;0;0;0;0;0;0;0;0;0;0
FR;3;2021-01-27;0;0;0;0;0;0;0;0;0;0
FR;3;2021-01-28;0;0;0;0;0;0;0;0;0;0
FR;3;2021-01-29;0;0;0;0;0;0;0;0;0;0
FR;3;2021-01-30;0;0;0;0;0;0;0;0;0;0
FR;3;2021-01-31;0;0;0;0;0;0;0;0;0;0
FR;3;2021-02-01;0;0;0;0;0;0;0;0;0;0
FR;3;2021-02-02;0;0;0;0;0;0;0;0;0;0
FR;3;2021-02-03;0;0;0;0;0;0;0;0;0;0
FR;3;2021-02-04;0;0;0;0;0;0;0;0;0;0
FR;3;2021-02-05;0;0;0;0;0;0;0;0;0;0
FR;3;2021-02-06;1702;0;0;0;0;1702;0;0;0;0
FR;3;2021-02-07;1422;0;0;0;0;3124;0;0;0;0
FR;3;2021-02-08;2779;0;0;0;0;5903;0;0;0;0
FR;3;2021-02-09;6780;0;0;0;0;12683;0;0;0;0
FR;3;2021-02-10;9601;0;0;0;0;22284;0;0;0;0
FR;3;2021-02-11;13607;0;0;0;0;35891;0;0;0;0
FR;3;2021-02-12;13393;0;0;0;0;49284;0;0;0;0
FR;3;2021-02-13;3778;0;0;0;0;53062;0;0;0;0
FR;3;2021-02-14;972;0;0;0;0;54034;0;0;0;0
FR;3;2021-02-15;10476;0;0;0;0;64510;0;0;0;0
FR;3;2021-02-16;12541;0;0;0;0;77051;0;0;0;0
FR;3;2021-02-17;11147;0;0;0;0;88198;0;0;0;0
FR;3;2021-02-18;14933;0;0;0;0;103131;0;0;0;0
FR;3;2021-02-19;14358;1;0;0;0;117489;1;0;0;0
FR;3;2021-02-20;3329;0;0;0;0;120818;1;0;0;0
FR;3;2021-02-21;618;0;0;0;0;121436;1;0;0;0
FR;3;2021-02-22;9160;0;0;0;0;130596;1;0;0;0
FR;3;2021-02-23;11394;1;0;0;0;141990;2;0;0;0
FR;3;2021-02-24;14298;0;0;0;0;156288;2;0;0;0
FR;3;2021-02-25;44927;0;0;0;0;201215;2;0;0;0
FR;3;2021-02-26;61881;2;0;0;0;263096;4;0;0;0
FR;3;2021-02-27;34800;5;0;0;0;297896;9;0;0;0
FR;3;2021-02-28;2463;0;0;0;0;300359;9;0;0;0
FR;3;2021-03-01;20503;9;0;0;0;320862;18;0;0;0
FR;3;2021-03-02;38859;17;0;0;0;359721;35;0;0;0
FR;3;2021-03-03;48725;16;0;0;0;408446;51;0;0;0
FR;3;2021-03-04;82210;19;0;0;0;490656;70;0;0;0
FR;3;2021-03-05;118120;37;0;0;0;608776;107;0;0;0
FR;3;2021-03-06;120708;49;1;0;0;729484;156;1;0;0
FR;3;2021-03-07;55173;26;0;0;0;784657;182;1;0;0
FR;3;2021-03-08;42805;23;0;0;0;827462;205;1;0;0
FR;3;2021-03-09;78968;39;0;0;0;906430;244;1;0;0
FR;3;2021-03-10;80960;42;0;0;0;987390;286;1;0;0
FR;3;2021-03-11;128410;48;0;0;0;1115800;334;1;0;0
FR;3;2021-03-12;182712;75;0;0;0;1298512;409;1;0;0
FR;3;2021-03-13;132137;57;0;0;0;1430649;466;1;0;0
FR;3;2021-03-14;14054;4;0;0;0;1444703;470;1;0;0
FR;3;2021-03-15;52218;40;0;0;0;1496921;510;1;0;0
FR;3;2021-03-16;1207;16;0;0;0;1498128;526;1;0;0
FR;3;2021-03-17;940;17;0;0;0;1499068;543;1;0;0
FR;3;2021-03-18;1563;9;0;0;0;1500631;552;1;0;0
FR;3;2021-03-19;70441;44;0;0;0;1571072;596;1;0;0
FR;3;2021-03-20;65224;40;0;0;0;1636296;636;1;0;0
FR;3;2021-03-21;5754;4;0;0;0;1642050;640;1;0;0
FR;3;2021-03-22;37492;36;0;0;0;1679542;676;1;0;0
FR;3;2021-03-23;84647;60;0;0;0;1764189;736;1;0;0
FR;3;2021-03-24;90927;90;0;0;0;1855116;826;1;0;0
FR;3;2021-03-25;150039;122;0;0;0;2005155;948;1;0;0
FR;3;2021-03-26;165407;149;0;0;0;2170562;1097;1;0;0
FR;3;2021-03-27;68453;94;0;0;0;2239015;1191;1;0;0
FR;3;2021-03-28;6468;19;0;0;0;2245483;1210;1;0;0
FR;3;2021-03-29;54150;68;0;0;0;2299633;1278;1;0;0
FR;3;2021-03-30;93154;96;0;0;0;2392787;1374;1;0;0
FR;3;2021-03-31;63517;84;0;0;0;2456304;1458;1;0;0
FR;3;2021-04-01;86116;101;0;0;0;2542420;1559;1;0;0
FR;3;2021-04-02;86882;145;0;0;0;2629302;1704;1;0;0
FR;3;2021-04-03;35866;113;0;0;0;2665168;1817;1;0;0
FR;3;2021-04-04;3569;14;0;0;0;2668737;1831;1;0;0
FR;3;2021-04-05;4481;26;0;0;0;2673218;1857;1;0;0
FR;3;2021-04-06;29738;78;0;0;0;2702956;1935;1;0;0
FR;3;2021-04-07;32333;70;0;0;0;2735289;2005;1;0;0
FR;3;2021-04-08;78804;235;0;0;0;2814093;2240;1;0;0
FR;3;2021-04-09;161745;409;0;0;0;2975838;2649;1;0;0
FR;3;2021-04-10;75750;331;0;0;0;3051588;2980;1;0;0
FR;3;2021-04-11;7307;44;0;0;0;3058895;3024;1;0;0
FR;3;2021-04-12;51464;200;0;0;0;3110359;3224;1;0;0
FR;3;2021-04-13;86215;312;0;0;0;3196574;3536;1;0;0
FR;3;2021-04-14;67832;337;0;0;0;3264406;3873;1;0;0
FR;3;2021-04-15;93219;365;0;0;0;3357625;4238;1;0;0
FR;3;2021-04-16;112513;565;0;0;0;3470138;4803;1;0;0
FR;3;2021-04-17;53311;318;1;0;0;3523449;5121;2;0;0
FR;3;2021-04-18;9741;32;0;0;0;3533190;5153;2;0;0
FR;3;2021-04-19;25101;234;0;0;0;3558291;5387;2;0;0
FR;3;2021-04-20;45667;391;0;0;0;3603958;5778;2;0;0
FR;3;2021-04-21;38960;458;0;0;0;3642918;6236;2;0;0
FR;3;2021-04-22;54697;776;0;0;0;3697615;7012;2;0;0
FR;3;2021-04-23;70477;1009;0;0;0;3768092;8021;2;0;0
FR;3;2021-04-24;37240;971;0;0;0;3805332;8992;2;0;0
FR;3;2021-04-25;6200;156;0;0;0;3811532;9148;2;0;0
FR;3;2021-04-26;19781;646;0;0;0;3831313;9794;2;0;0
FR;3;2021-04-27;34467;1247;0;0;0;3865780;11041;2;0;0
FR;3;2021-04-28;28955;1925;0;0;0;3894735;12966;2;0;0
FR;3;2021-04-29;45371;5946;0;0;0;3940106;18912;2;0;0
FR;3;2021-04-30;55451;8912;1;0;0;3995557;27824;3;0;0
FR;3;2021-05-01;9507;1963;0;0;0;4005064;29787;3;0;0
FR;3;2021-05-02;3069;491;0;0;0;4008133;30278;3;0;0
FR;3;2021-05-03;13053;3882;0;0;0;4021186;34160;3;0;0
FR;3;2021-05-04;23107;8394;0;0;0;4044293;42554;3;0;0
FR;3;2021-05-05;18746;10568;0;0;0;4063039;53122;3;0;0
FR;3;2021-05-06;34613;20870;0;0;0;4097652;73992;3;0;0
FR;3;2021-05-07;44196;28369;0;0;0;4141848;102361;3;0;0
FR;3;2021-05-08;6776;8837;0;0;0;4148624;111198;3;0;0
FR;3;2021-05-09;1792;2653;0;0;0;4150416;113851;3;0;0
FR;3;2021-05-10;14984;12548;0;0;0;4165400;126399;3;0;0
FR;3;2021-05-11;27090;25707;0;0;0;4192490;152106;3;0;0
FR;3;2021-05-12;17262;27430;0;0;0;4209752;179536;3;0;0
FR;3;2021-05-13;2275;3479;0;0;0;4212027;183015;3;0;0
FR;3;2021-05-14;14510;25703;0;0;0;4226537;208718;3;0;0
FR;3;2021-05-15;7228;20726;0;0;0;4233765;229444;3;0;0
FR;3;2021-05-16;973;2674;0;0;0;4234738;232118;3;0;0
FR;3;2021-05-17;7954;19905;0;0;0;4242692;252023;3;0;0
FR;3;2021-05-18;13402;29614;0;0;0;4256094;281637;3;0;0
FR;3;2021-05-19;9260;31792;0;0;0;4265354;313429;3;0;0
FR;3;2021-05-20;12800;53164;3;0;0;4278154;366593;6;0;0
FR;3;2021-05-21;12759;65465;2;0;0;4290913;432058;8;0;0
FR;3;2021-05-22;4958;33259;1;0;0;4295871;465317;9;0;0
FR;3;2021-05-23;649;2661;0;0;0;4296520;467978;9;0;0
FR;3;2021-05-24;875;4922;0;0;0;4297395;472900;9;0;0
FR;3;2021-05-25;5293;45148;1;0;0;4302688;518048;10;0;0
FR;3;2021-05-26;4966;51012;1;0;0;4307654;569060;11;0;0
FR;3;2021-05-27;6318;77760;3;0;0;4313972;646820;14;0;0
FR;3;2021-05-28;7539;99006;2;0;0;4321511;745826;16;0;0
FR;3;2021-05-29;3344;60232;1;0;0;4324855;806058;17;0;0
FR;3;2021-05-30;544;8230;0;0;0;4325399;814288;17;0;0
FR;3;2021-05-31;2429;35937;3;0;0;4327828;850225;20;0;0
FR;3;2021-06-01;3394;64746;10;0;0;4331222;914971;30;0;0
FR;3;2021-06-02;2721;58281;6;0;0;4333943;973252;36;0;0
FR;3;2021-06-03;3489;87490;10;0;0;4337432;1060742;46;0;0
FR;3;2021-06-04;4103;105027;22;0;0;4341535;1165769;68;0;0
FR;3;2021-06-05;1969;52207;4;0;0;4343504;1217976;72;0;0
FR;3;2021-06-06;503;5397;1;0;0;4344007;1223373;73;0;0
FR;3;2021-06-07;1461;31137;11;0;0;4345468;1254510;84;0;0
FR;3;2021-06-08;2043;47222;18;0;0;4347511;1301732;102;0;0
FR;3;2021-06-09;1782;42352;13;0;0;4349293;1344084;115;0;0
FR;3;2021-06-10;2240;67906;17;0;0;4351533;1411990;132;0;0
FR;3;2021-06-11;2467;96706;34;0;0;4354000;1508696;166;0;0
FR;3;2021-06-12;1171;40814;6;0;0;4355171;1549510;172;0;0
FR;3;2021-06-13;275;3818;3;0;0;4355446;1553328;175;0;0
FR;3;2021-06-14;1035;42623;17;0;0;4356481;1595951;192;0;0
FR;3;2021-06-15;1362;80613;20;0;0;4357843;1676564;212;0;0
FR;3;2021-06-16;1252;65713;19;0;0;4359095;1742277;231;0;0
FR;3;2021-06-17;1654;101766;41;0;0;4360749;1844043;272;0;0
FR;3;2021-06-18;1867;117846;61;0;0;4362616;1961889;333;0;0
FR;3;2021-06-19;800;39360;22;0;0;4363416;2001249;355;0;0
FR;3;2021-06-20;158;3389;0;0;0;4363574;2004638;355;0;0
FR;3;2021-06-21;761;39261;16;0;0;4364335;2043899;371;0;0
FR;3;2021-06-22;1060;69956;52;0;0;4365395;2113855;423;0;0
FR;3;2021-06-23;939;50805;38;0;0;4366334;2164660;461;0;0
FR;3;2021-06-24;1303;77132;48;0;0;4367637;2241792;509;0;0
FR;3;2021-06-25;1399;89903;73;0;0;4369036;2331695;582;0;0
FR;3;2021-06-26;624;33127;29;0;0;4369660;2364822;611;0;0
FR;3;2021-06-27;163;4013;1;0;0;4369823;2368835;612;0;0
FR;3;2021-06-28;646;30421;27;0;0;4370469;2399256;639;0;0
FR;3;2021-06-29;851;56133;95;0;0;4371320;2455389;734;0;0
FR;3;2021-06-30;897;45061;93;0;0;4372217;2500450;827;0;0
FR;3;2021-07-01;1159;65636;108;0;0;4373376;2566086;935;0;0
FR;3;2021-07-02;1291;90353;170;0;0;4374667;2656439;1105;0;0
FR;3;2021-07-03;600;31170;52;0;0;4375267;2687609;1157;0;0
FR;3;2021-07-04;140;4277;3;0;0;4375407;2691886;1160;0;0
FR;3;2021-07-05;605;33909;60;0;0;4376012;2725795;1220;0;0
FR;3;2021-07-06;953;56061;88;0;0;4376965;2781856;1308;0;0
FR;3;2021-07-07;868;43045;79;0;0;4377833;2824901;1387;0;0
FR;3;2021-07-08;1123;60708;99;0;0;4378956;2885609;1486;0;0
FR;3;2021-07-09;1258;68800;128;0;0;4380214;2954409;1614;0;0
FR;3;2021-07-10;639;25043;59;0;0;4380853;2979452;1673;0;0
FR;3;2021-07-11;127;3310;4;0;0;4380980;2982762;1677;0;0
FR;3;2021-07-12;658;23891;59;0;0;4381638;3006653;1736;0;0
FR;3;2021-07-13;1643;34736;90;0;0;4383281;3041389;1826;0;0
FR;3;2021-07-14;260;2648;2;0;0;4383541;3044037;1828;0;0
FR;3;2021-07-15;1930;30675;85;0;0;4385471;3074712;1913;0;0
FR;3;2021-07-16;2518;38870;122;0;0;4387989;3113582;2035;0;0
FR;3;2021-07-17;1042;13752;26;0;0;4389031;3127334;2061;0;0
FR;3;2021-07-18;261;2620;3;0;0;4389292;3129954;2064;0;0
FR;3;2021-07-19;1270;17222;37;0;0;4390562;3147176;2101;0;0
FR;3;2021-07-20;1819;27157;98;0;0;4392381;3174333;2199;0;0
FR;3;2021-07-21;1643;19731;44;0;0;4394024;3194064;2243;0;0
FR;3;2021-07-22;1846;27771;82;0;0;4395870;3221835;2325;0;0
FR;3;2021-07-23;2211;30453;117;0;0;4398081;3252288;2442;0;0
FR;3;2021-07-24;819;7011;25;0;0;4398900;3259299;2467;0;0
FR;3;2021-07-25;208;1356;1;0;0;4399108;3260655;2468;0;0
FR;3;2021-07-26;919;10716;28;0;0;4400027;3271371;2496;0;0
FR;3;2021-07-27;1164;16957;56;0;0;4401191;3288328;2552;0;0
FR;3;2021-07-28;985;12116;40;0;0;4402176;3300444;2592;0;0
FR;3;2021-07-29;1126;15854;63;0;0;4403302;3316298;2655;0;0
FR;3;2021-07-30;1123;18114;79;0;0;4404425;3334412;2734;0;0
FR;3;2021-07-31;406;3743;15;0;0;4404831;3338155;2749;0;0
FR;3;2021-08-01;111;484;1;0;0;4404942;3338639;2750;0;0
FR;3;2021-08-02;416;5160;22;0;0;4405358;3343799;2772;0;0
FR;3;2021-08-03;485;7602;27;0;0;4405843;3351401;2799;0;0
FR;3;2021-08-04;434;4900;26;0;0;4406277;3356301;2825;0;0
FR;3;2021-08-05;427;3747;12;0;0;4406704;3360048;2837;0;0
FR;3;2021-08-06;450;4800;30;0;0;4407154;3364848;2867;0;0
FR;3;2021-08-07;213;1919;11;0;0;4407367;3366767;2878;0;0
FR;3;2021-08-08;243;431;2;0;0;4407610;3367198;2880;0;0
FR;3;2021-08-09;310;2520;11;0;0;4407920;3369718;2891;0;0
FR;3;2021-08-10;357;3891;15;0;0;4408277;3373609;2906;0;0
FR;3;2021-08-11;284;2727;15;0;0;4408561;3376336;2921;0;0
FR;3;2021-08-12;273;2635;12;0;0;4408834;3378971;2933;0;0
FR;3;2021-08-13;274;2266;16;0;0;4409108;3381237;2949;0;0
FR;3;2021-08-14;167;925;1;0;0;4409275;3382162;2950;0;0
FR;3;2021-08-15;55;168;0;0;0;4409330;3382330;2950;0;0
FR;3;2021-08-16;122;1093;8;0;0;4409452;3383423;2958;0;0
FR;3;2021-08-17;186;1510;8;0;0;4409638;3384933;2966;0;0
FR;3;2021-08-18;191;1375;10;0;0;4409829;3386308;2976;0;0
FR;3;2021-08-19;161;1436;10;0;0;4409990;3387744;2986;0;0
FR;3;2021-08-20;162;1638;16;0;0;4410152;3389382;3002;0;0
FR;3;2021-08-21;93;587;2;0;0;4410245;3389969;3004;0;0
FR;3;2021-08-22;38;187;1;0;0;4410283;3390156;3005;0;0
FR;3;2021-08-23;139;940;7;0;0;4410422;3391096;3012;0;0
FR;3;2021-08-24;123;966;10;0;0;4410545;3392062;3022;0;0
FR;3;2021-08-25;135;851;2;0;0;4410680;3392913;3024;0;0
FR;3;2021-08-26;168;875;9;0;0;4410848;3393788;3033;0;0
FR;3;2021-08-27;171;967;9;0;0;4411019;3394755;3042;0;0
FR;3;2021-08-28;95;370;4;0;0;4411114;3395125;3046;0;0
FR;3;2021-08-29;124;134;1;0;0;4411238;3395259;3047;0;0
FR;3;2021-08-30;94;600;0;0;137;4411332;3395859;3047;0;137
FR;3;2021-08-31;125;717;7;0;158;4411457;3396576;3054;0;295
FR;3;2021-09-01;113;483;5;0;126;4411570;3397059;3059;0;421
FR;3;2021-09-02;99;636;22;0;123;4411669;3397695;3081;0;544
FR;3;2021-09-03;112;592;17;0;131;4411781;3398287;3098;0;675
FR;3;2021-09-04;51;299;3;0;59;4411832;3398586;3101;0;734
FR;3;2021-09-05;51;69;5;0;30;4411883;3398655;3106;0;764
FR;3;2021-09-06;111;405;4;0;151;4411994;3399060;3110;0;915
FR;3;2021-09-07;118;481;14;0;133;4412112;3399541;3124;0;1048
FR;3;2021-09-08;114;370;2;0;105;4412226;3399911;3126;0;1153
FR;3;2021-09-09;87;400;8;0;117;4412313;3400311;3134;0;1270
FR;3;2021-09-10;98;426;3;0;105;4412411;3400737;3137;0;1375
FR;3;2021-09-11;73;234;4;0;65;4412484;3400971;3141;0;1440
FR;3;2021-09-12;36;49;1;0;17;4412520;3401020;3142;0;1457
FR;3;2021-09-13;65;331;7;0;112;4412585;3401351;3149;0;1569
FR;3;2021-09-14;66;294;6;0;107;4412651;3401645;3155;0;1676
FR;3;2021-09-15;58;263;3;0;6;4412709;3401908;3158;0;1682
FR;3;2021-09-16;59;342;5;0;5;4412768;3402250;3163;0;1687
FR;3;2021-09-17;49;349;3;0;7;4412817;3402599;3166;0;1694
FR;3;2021-09-18;34;178;1;0;1;4412851;3402777;3167;0;1695
FR;3;2021-09-19;27;32;2;0;1;4412878;3402809;3169;0;1696
FR;3;2021-09-20;76;211;0;0;1;4412954;3403020;3169;0;1697
FR;3;2021-09-21;55;290;6;0;7;4413009;3403310;3175;0;1704
FR;3;2021-09-22;61;230;6;0;7;4413070;3403540;3181;0;1711
FR;3;2021-09-23;34;275;10;0;6;4413104;3403815;3191;0;1717
FR;3;2021-09-24;23;317;12;0;19;4413127;3404132;3203;0;1736
FR;3;2021-09-25;28;156;3;0;3;4413155;3404288;3206;0;1739
FR;3;2021-09-26;15;55;1;0;1;4413170;3404343;3207;0;1740
FR;3;2021-09-27;38;290;3;0;5;4413208;3404633;3210;0;1745
FR;3;2021-09-28;49;259;6;0;10;4413257;3404892;3216;0;1755
FR;3;2021-09-29;32;224;10;0;13;4413289;3405116;3226;0;1768
FR;3;2021-09-30;37;200;8;0;10;4413326;3405316;3234;0;1778
FR;3;2021-10-01;17;170;5;0;6;4413343;3405486;3239;0;1784
FR;3;2021-10-02;14;93;0;0;0;4413357;3405579;3239;0;1784
FR;3;2021-10-03;18;20;1;0;2;4413375;3405599;3240;0;1786
FR;3;2021-10-04;28;164;4;0;4;4413403;3405763;3244;0;1790
FR;3;2021-10-05;15;156;10;0;13;4413418;3405919;3254;0;1803
FR;3;2021-10-06;29;163;7;0;8;4413447;3406082;3261;0;1811
FR;3;2021-10-07;17;146;6;0;6;4413464;3406228;3267;0;1817
FR;3;2021-10-08;20;146;10;0;9;4413484;3406374;3277;0;1826
FR;3;2021-10-09;11;73;1;0;1;4413495;3406447;3278;0;1827
FR;3;2021-10-10;8;16;2;0;2;4413503;3406463;3280;0;1829
FR;3;2021-10-11;13;126;4;0;5;4413516;3406589;3284;0;1834
FR;3;2021-10-12;16;116;4;0;4;4413532;3406705;3288;0;1838
FR;3;2021-10-13;22;118;7;0;5;4413554;3406823;3295;0;1843
FR;3;2021-10-14;16;162;3;0;4;4413570;3406985;3298;0;1847
FR;3;2021-10-15;21;155;8;0;11;4413591;3407140;3306;0;1858
FR;3;2021-10-16;10;80;6;0;8;4413601;3407220;3312;0;1866
FR;3;2021-10-17;9;24;0;0;0;4413610;3407244;3312;0;1866
FR;3;2021-10-18;17;131;2;0;1;4413627;3407375;3314;0;1867
FR;3;2021-10-19;16;129;19;0;21;4413643;3407504;3333;0;1888
FR;3;2021-10-20;18;136;5;0;6;4413661;3407640;3338;0;1894
FR;3;2021-10-21;22;137;17;0;13;4413683;3407777;3355;0;1907
FR;3;2021-10-22;17;128;16;0;20;4413700;3407905;3371;0;1927
FR;3;2021-10-23;11;59;2;0;1;4413711;3407964;3373;0;1928
FR;3;2021-10-24;7;27;0;0;0;4413718;3407991;3373;0;1928
FR;3;2021-10-25;21;154;6;0;6;4413739;3408145;3379;0;1934
FR;3;2021-10-26;17;119;22;0;19;4413756;3408264;3401;0;1953
FR;3;2021-10-27;15;117;9;0;9;4413771;3408381;3410;0;1962
FR;3;2021-10-28;19;129;33;0;36;4413790;3408510;3443;0;1998
FR;3;2021-10-29;10;124;64;0;54;4413800;3408634;3507;0;2052
FR;3;2021-10-30;8;73;11;1;10;4413808;3408707;3518;1;2062
FR;3;2021-10-31;5;23;1;0;1;4413813;3408730;3519;1;2063
FR;3;2021-11-01;5;21;2;0;1;4413818;3408751;3521;1;2064
FR;3;2021-11-02;9;110;8;0;10;4413827;3408861;3529;1;2074
FR;3;2021-11-03;19;125;9;0;9;4413846;3408986;3538;1;2083
FR;3;2021-11-04;15;98;3;0;2;4413861;3409084;3541;1;2085
FR;3;2021-11-05;16;148;8;1;5;4413877;3409232;3549;2;2090
FR;3;2021-11-06;6;67;3;0;3;4413883;3409299;3552;2;2093
FR;3;2021-11-07;6;21;1;0;1;4413889;3409320;3553;2;2094
FR;3;2021-11-08;9;144;7;0;5;4413898;3409464;3560;2;2099
FR;3;2021-11-09;9;156;5;0;5;4413907;3409620;3565;2;2104
FR;3;2021-11-10;11;190;13;0;14;4413918;3409810;3578;2;2118
FR;3;2021-11-11;5;53;3;0;3;4413923;3409863;3581;2;2121
FR;3;2021-11-12;9;165;6;0;4;4413932;3410028;3587;2;2125
FR;3;2021-11-13;5;80;8;0;10;4413937;3410108;3595;2;2135
FR;3;2021-11-14;2;20;0;0;0;4413939;3410128;3595;2;2135
FR;3;2021-11-15;3;195;9;0;9;4413942;3410323;3604;2;2144
FR;3;2021-11-16;2;169;11;0;10;4413944;3410492;3615;2;2154
FR;3;2021-11-17;5;185;10;0;7;4413949;3410677;3625;2;2161
FR;3;2021-11-18;10;186;10;0;11;4413959;3410863;3635;2;2172
FR;3;2021-11-19;5;238;22;0;27;4413964;3411101;3657;2;2199
FR;3;2021-11-20;5;119;5;0;5;4413969;3411220;3662;2;2204
FR;3;2021-11-21;3;30;3;0;3;4413972;3411250;3665;2;2207
FR;3;2021-11-22;10;243;10;0;10;4413982;3411493;3675;2;2217
FR;3;2021-11-23;6;236;15;0;14;4413988;3411729;3690;2;2231
FR;3;2021-11-24;5;253;9;0;17;4413993;3411982;3699;2;2248
FR;3;2021-11-25;9;289;11;0;10;4414002;3412271;3710;2;2258
FR;3;2021-11-26;5;381;33;0;30;4414007;3412652;3743;2;2288
FR;3;2021-11-27;5;179;19;0;20;4414012;3412831;3762;2;2308
FR;3;2021-11-28;2;61;7;0;7;4414014;3412892;3769;2;2315
FR;3;2021-11-29;4;334;19;0;20;4414018;3413226;3788;2;2335
FR;3;2021-11-30;4;427;26;0;29;4414022;3413653;3814;2;2364
FR;3;2021-12-01;18;471;32;0;33;4414040;3414124;3846;2;2397
FR;3;2021-12-02;9;500;33;0;36;4414049;3414624;3879;2;2433
FR;3;2021-12-03;3;579;37;0;38;4414052;3415203;3916;2;2471
FR;3;2021-12-04;3;284;26;0;28;4414055;3415487;3942;2;2499
FR;3;2021-12-05;1;83;5;0;5;4414056;3415570;3947;2;2504
FR;3;2021-12-06;5;518;14;0;16;4414061;3416088;3961;2;2520
FR;3;2021-12-07;4;618;20;0;24;4414065;3416706;3981;2;2544
FR;3;2021-12-08;3;546;29;0;29;4414068;3417252;4010;2;2573
FR;3;2021-12-09;3;605;17;0;22;4414071;3417857;4027;2;2595
FR;3;2021-12-10;9;637;29;0;25;4414080;3418494;4056;2;2620
FR;3;2021-12-11;4;395;10;0;9;4414084;3418889;4066;2;2629
FR;3;2021-12-12;1;122;3;0;3;4414085;3419011;4069;2;2632
FR;3;2021-12-13;2;609;19;0;20;4414087;3419620;4088;2;2652
FR;3;2021-12-14;7;771;18;0;21;4414094;3420391;4106;2;2673
FR;3;2021-12-15;7;733;17;0;21;4414101;3421124;4123;2;2694
FR;3;2021-12-16;9;738;19;0;18;4414110;3421862;4142;2;2712
FR;3;2021-12-17;4;810;18;0;19;4414114;3422672;4160;2;2731
FR;3;2021-12-18;4;416;4;0;5;4414118;3423088;4164;2;2736
FR;3;2021-12-19;3;208;2;0;2;4414121;3423296;4166;2;2738
FR;3;2021-12-20;8;731;23;0;28;4414129;3424027;4189;2;2766
FR;3;2021-12-21;3;816;10;0;14;4414132;3424843;4199;2;2780
FR;3;2021-12-22;6;764;9;0;11;4414138;3425607;4208;2;2791
FR;3;2021-12-23;1;657;9;0;8;4414139;3426264;4217;2;2799
FR;3;2021-12-24;2;276;3;0;6;4414141;3426540;4220;2;2805
FR;3;2021-12-25;0;25;0;0;0;4414141;3426565;4220;2;2805
FR;3;2021-12-26;0;95;1;0;1;4414141;3426660;4221;2;2806
FR;3;2021-12-27;7;544;17;0;19;4414148;3427204;4238;2;2825
FR;3;2021-12-28;1;695;6;0;5;4414149;3427899;4244;2;2830
FR;3;2021-12-29;4;575;14;0;16;4414153;3428474;4258;2;2846
FR;3;2021-12-30;1;605;7;0;10;4414154;3429079;4265;2;2856
FR;3;2021-12-31;0;208;5;0;6;4414154;3429287;4270;2;2862
FR;3;2022-01-01;0;27;0;0;2;4414154;3429314;4270;2;2864
FR;3;2022-01-02;0;82;0;0;0;4414154;3429396;4270;2;2864
FR;3;2022-01-03;3;564;17;0;20;4414157;3429960;4287;2;2884
FR;3;2022-01-04;6;625;9;0;8;4414163;3430585;4296;2;2892
FR;3;2022-01-05;3;557;10;0;14;4414166;3431142;4306;2;2906
FR;3;2022-01-06;4;554;9;0;12;4414170;3431696;4315;2;2918
FR;3;2022-01-07;2;577;11;0;14;4414172;3432273;4326;2;2932
FR;3;2022-01-08;2;286;4;0;5;4414174;3432559;4330;2;2937
FR;3;2022-01-09;0;118;0;0;0;4414174;3432677;4330;2;2937
FR;3;2022-01-10;2;481;12;0;12;4414176;3433158;4342;2;2949
FR;3;2022-01-11;2;535;1;0;1;4414178;3433693;4343;2;2950
FR;3;2022-01-12;3;449;9;0;10;4414181;3434142;4352;2;2960
FR;3;2022-01-13;3;427;11;0;12;4414184;3434569;4363;2;2972
FR;3;2022-01-14;3;483;10;0;12;4414187;3435052;4373;2;2984
FR;3;2022-01-15;0;299;2;0;3;4414187;3435351;4375;2;2987
FR;3;2022-01-16;0;116;1;0;1;4414187;3435467;4376;2;2988
FR;3;2022-01-17;2;352;8;0;10;4414189;3435819;4384;2;2998
FR;3;2022-01-18;2;419;1;0;2;4414191;3436238;4385;2;3000
FR;3;2022-01-19;1;351;5;0;10;4414192;3436589;4390;2;3010
FR;3;2022-01-20;1;380;5;0;3;4414193;3436969;4395;2;3013
FR;3;2022-01-21;2;376;5;0;8;4414195;3437345;4400;2;3021
FR;3;2022-01-22;2;233;1;0;3;4414197;3437578;4401;2;3024
FR;3;2022-01-23;0;82;0;0;1;4414197;3437660;4401;2;3025
FR;3;2022-01-24;2;352;1;0;6;4414199;3438012;4402;2;3031
FR;3;2022-01-25;0;194;0;0;0;4414199;3438206;4402;2;3031
FR;3;2022-01-26;0;89;0;0;0;4414199;3438295;4402;2;3031
FR;3;2022-01-27;0;60;0;0;0;4414199;3438355;4402;2;3031
FR;3;2022-01-28;0;134;0;0;0;4414199;3438489;4402;2;3031
FR;3;2022-01-29;0;110;0;0;0;4414199;3438599;4402;2;3031
FR;3;2022-01-30;0;51;0;0;0;4414199;3438650;4402;2;3031
FR;3;2022-01-31;0;98;0;0;0;4414199;3438748;4402;2;3031
FR;3;2022-02-01;0;110;0;0;1;4414199;3438858;4402;2;3032
FR;3;2022-02-02;0;98;0;0;0;4414199;3438956;4402;2;3032
FR;3;2022-02-03;0;101;0;0;0;4414199;3439057;4402;2;3032
FR;3;2022-02-04;0;124;0;0;0;4414199;3439181;4402;2;3032
FR;3;2022-02-05;0;73;0;0;0;4414199;3439254;4402;2;3032
FR;3;2022-02-06;0;11;0;0;0;4414199;3439265;4402;2;3032
FR;3;2022-02-07;0;89;0;0;1;4414199;3439354;4402;2;3033
FR;3;2022-02-08;0;0;0;0;0;4414199;3439354;4402;2;3033
FR;3;2022-02-09;0;0;0;0;0;4414199;3439354;4402;2;3033
FR;3;2022-02-10;0;0;0;0;0;4414199;3439354;4402;2;3033
FR;3;2022-02-11;0;0;0;0;0;4414199;3439354;4402;2;3033
FR;3;2022-02-12;0;0;0;0;0;4414199;3439354;4402;2;3033
FR;3;2022-02-13;0;0;0;0;0;4414199;3439354;4402;2;3033
FR;3;2022-02-14;0;0;0;0;0;4414199;3439354;4402;2;3033
FR;3;2022-02-15;0;0;0;0;0;4414199;3439354;4402;2;3033
FR;3;2022-02-16;0;0;0;0;0;4414199;3439354;4402;2;3033
FR;3;2022-02-17;0;0;0;0;0;4414199;3439354;4402;2;3033
FR;3;2022-02-18;0;0;0;0;0;4414199;3439354;4402;2;3033
FR;3;2022-02-19;0;0;0;0;0;4414199;3439354;4402;2;3033
FR;3;2022-02-20;0;0;0;0;0;4414199;3439354;4402;2;3033
FR;3;2022-02-21;2;0;0;0;0;4414201;3439354;4402;2;3033
FR;3;2022-02-22;0;0;0;0;0;4414201;3439354;4402;2;3033
FR;3;2022-02-23;0;0;0;0;0;4414201;3439354;4402;2;3033
FR;3;2022-02-24;0;0;0;0;0;4414201;3439354;4402;2;3033
FR;3;2022-02-25;0;0;0;0;0;4414201;3439354;4402;2;3033
FR;3;2022-02-26;0;0;0;0;0;4414201;3439354;4402;2;3033
FR;3;2022-02-27;0;0;0;0;0;4414201;3439354;4402;2;3033
FR;3;2022-02-28;1;0;0;0;0;4414202;3439354;4402;2;3033
FR;3;2022-03-01;1;0;0;0;0;4414203;3439354;4402;2;3033
FR;3;2022-03-02;0;0;0;0;0;4414203;3439354;4402;2;3033
FR;3;2022-03-03;0;0;0;0;0;4414203;3439354;4402;2;3033
FR;3;2022-03-04;0;0;0;0;0;4414203;3439354;4402;2;3033
FR;3;2022-03-05;0;0;0;0;0;4414203;3439354;4402;2;3033
FR;3;2022-03-06;1;0;0;0;0;4414204;3439354;4402;2;3033
FR;3;2022-03-07;0;0;0;0;0;4414204;3439354;4402;2;3033
FR;3;2022-03-08;1;0;0;0;0;4414205;3439354;4402;2;3033
FR;3;2022-03-09;0;0;0;0;0;4414205;3439354;4402;2;3033
FR;3;2022-03-10;0;0;0;0;0;4414205;3439354;4402;2;3033
FR;3;2022-03-11;0;0;0;0;0;4414205;3439354;4402;2;3033
FR;3;2022-03-12;0;0;0;0;0;4414205;3439354;4402;2;3033
FR;3;2022-03-13;0;0;0;0;0;4414205;3439354;4402;2;3033
FR;3;2022-03-14;0;0;0;0;0;4414205;3439354;4402;2;3033
FR;3;2022-03-15;0;0;0;0;0;4414205;3439354;4402;2;3033
FR;3;2022-03-16;0;0;0;0;0;4414205;3439354;4402;2;3033
FR;3;2022-03-17;0;0;0;0;0;4414205;3439354;4402;2;3033
FR;3;2022-03-18;0;0;0;0;0;4414205;3439354;4402;2;3033
FR;3;2022-03-19;0;0;0;0;0;4414205;3439354;4402;2;3033
FR;3;2022-03-20;1;0;0;0;0;4414206;3439354;4402;2;3033
FR;3;2022-03-21;0;0;0;0;0;4414206;3439354;4402;2;3033
FR;3;2022-03-22;0;0;0;0;0;4414206;3439354;4402;2;3033
FR;3;2022-03-23;1;0;0;0;0;4414207;3439354;4402;2;3033
FR;3;2022-03-24;0;0;0;0;0;4414207;3439354;4402;2;3033
FR;3;2022-03-25;1;0;0;0;0;4414208;3439354;4402;2;3033
FR;3;2022-03-26;0;0;0;0;0;4414208;3439354;4402;2;3033
FR;3;2022-03-27;0;0;0;0;0;4414208;3439354;4402;2;3033
FR;3;2022-03-28;0;0;0;0;0;4414208;3439354;4402;2;3033
FR;3;2022-03-29;0;0;0;0;0;4414208;3439354;4402;2;3033
FR;3;2022-03-30;0;0;0;0;0;4414208;3439354;4402;2;3033
FR;3;2022-03-31;0;0;0;0;0;4414208;3439354;4402;2;3033
FR;4;2020-12-27;0;0;0;0;0;0;0;0;0;0
FR;4;2020-12-28;0;0;0;0;0;0;0;0;0;0
FR;4;2020-12-29;0;0;0;0;0;0;0;0;0;0
FR;4;2020-12-30;0;0;0;0;0;0;0;0;0;0
FR;4;2020-12-31;0;0;0;0;0;0;0;0;0;0
FR;4;2021-01-01;0;0;0;0;0;0;0;0;0;0
FR;4;2021-01-02;0;0;0;0;0;0;0;0;0;0
FR;4;2021-01-03;0;0;0;0;0;0;0;0;0;0
FR;4;2021-01-04;0;0;0;0;0;0;0;0;0;0
FR;4;2021-01-05;0;0;0;0;0;0;0;0;0;0
FR;4;2021-01-06;0;0;0;0;0;0;0;0;0;0
FR;4;2021-01-07;0;0;0;0;0;0;0;0;0;0
FR;4;2021-01-08;0;0;0;0;0;0;0;0;0;0
FR;4;2021-01-09;0;0;0;0;0;0;0;0;0;0
FR;4;2021-01-10;0;0;0;0;0;0;0;0;0;0
FR;4;2021-01-11;0;0;0;0;0;0;0;0;0;0
FR;4;2021-01-12;0;0;0;0;0;0;0;0;0;0
FR;4;2021-01-13;0;0;0;0;0;0;0;0;0;0
FR;4;2021-01-14;0;0;0;0;0;0;0;0;0;0
FR;4;2021-01-15;0;0;0;0;0;0;0;0;0;0
FR;4;2021-01-16;0;0;0;0;0;0;0;0;0;0
FR;4;2021-01-17;0;0;0;0;0;0;0;0;0;0
FR;4;2021-01-18;0;0;0;0;0;0;0;0;0;0
FR;4;2021-01-19;0;0;0;0;0;0;0;0;0;0
FR;4;2021-01-20;0;0;0;0;0;0;0;0;0;0
FR;4;2021-01-21;0;0;0;0;0;0;0;0;0;0
FR;4;2021-01-22;0;0;0;0;0;0;0;0;0;0
FR;4;2021-01-23;0;0;0;0;0;0;0;0;0;0
FR;4;2021-01-24;0;0;0;0;0;0;0;0;0;0
FR;4;2021-01-25;0;0;0;0;0;0;0;0;0;0
FR;4;2021-01-26;0;0;0;0;0;0;0;0;0;0
FR;4;2021-01-27;0;0;0;0;0;0;0;0;0;0
FR;4;2021-01-28;0;0;0;0;0;0;0;0;0;0
FR;4;2021-01-29;0;0;0;0;0;0;0;0;0;0
FR;4;2021-01-30;0;0;0;0;0;0;0;0;0;0
FR;4;2021-01-31;0;0;0;0;0;0;0;0;0;0
FR;4;2021-02-01;0;0;0;0;0;0;0;0;0;0
FR;4;2021-02-02;0;0;0;0;0;0;0;0;0;0
FR;4;2021-02-03;0;0;0;0;0;0;0;0;0;0
FR;4;2021-02-04;0;0;0;0;0;0;0;0;0;0
FR;4;2021-02-05;0;0;0;0;0;0;0;0;0;0
FR;4;2021-02-06;0;0;0;0;0;0;0;0;0;0
FR;4;2021-02-07;0;0;0;0;0;0;0;0;0;0
FR;4;2021-02-08;0;0;0;0;0;0;0;0;0;0
FR;4;2021-02-09;0;0;0;0;0;0;0;0;0;0
FR;4;2021-02-10;0;0;0;0;0;0;0;0;0;0
FR;4;2021-02-11;0;0;0;0;0;0;0;0;0;0
FR;4;2021-02-12;0;0;0;0;0;0;0;0;0;0
FR;4;2021-02-13;0;0;0;0;0;0;0;0;0;0
FR;4;2021-02-14;0;0;0;0;0;0;0;0;0;0
FR;4;2021-02-15;0;0;0;0;0;0;0;0;0;0
FR;4;2021-02-16;0;0;0;0;0;0;0;0;0;0
FR;4;2021-02-17;0;0;0;0;0;0;0;0;0;0
FR;4;2021-02-18;0;0;0;0;0;0;0;0;0;0
FR;4;2021-02-19;0;0;0;0;0;0;0;0;0;0
FR;4;2021-02-20;0;0;0;0;0;0;0;0;0;0
FR;4;2021-02-21;0;0;0;0;0;0;0;0;0;0
FR;4;2021-02-22;0;0;0;0;0;0;0;0;0;0
FR;4;2021-02-23;0;0;0;0;0;0;0;0;0;0
FR;4;2021-02-24;0;0;0;0;0;0;0;0;0;0
FR;4;2021-02-25;0;0;0;0;0;0;0;0;0;0
FR;4;2021-02-26;0;0;0;0;0;0;0;0;0;0
FR;4;2021-02-27;0;0;0;0;0;0;0;0;0;0
FR;4;2021-02-28;0;0;0;0;0;0;0;0;0;0
FR;4;2021-03-01;0;0;0;0;0;0;0;0;0;0
FR;4;2021-03-02;0;0;0;0;0;0;0;0;0;0
FR;4;2021-03-03;0;0;0;0;0;0;0;0;0;0
FR;4;2021-03-04;0;0;0;0;0;0;0;0;0;0
FR;4;2021-03-05;0;0;0;0;0;0;0;0;0;0
FR;4;2021-03-06;0;0;0;0;0;0;0;0;0;0
FR;4;2021-03-07;0;0;0;0;0;0;0;0;0;0
FR;4;2021-03-08;0;0;0;0;0;0;0;0;0;0
FR;4;2021-03-09;0;0;0;0;0;0;0;0;0;0
FR;4;2021-03-10;0;0;0;0;0;0;0;0;0;0
FR;4;2021-03-11;0;0;0;0;0;0;0;0;0;0
FR;4;2021-03-12;0;0;0;0;0;0;0;0;0;0
FR;4;2021-03-13;0;0;0;0;0;0;0;0;0;0
FR;4;2021-03-14;0;0;0;0;0;0;0;0;0;0
FR;4;2021-03-15;0;0;0;0;0;0;0;0;0;0
FR;4;2021-03-16;0;0;0;0;0;0;0;0;0;0
FR;4;2021-03-17;0;0;0;0;0;0;0;0;0;0
FR;4;2021-03-18;0;0;0;0;0;0;0;0;0;0
FR;4;2021-03-19;0;0;0;0;0;0;0;0;0;0
FR;4;2021-03-20;0;0;0;0;0;0;0;0;0;0
FR;4;2021-03-21;0;0;0;0;0;0;0;0;0;0
FR;4;2021-03-22;0;0;0;0;0;0;0;0;0;0
FR;4;2021-03-23;0;0;0;0;0;0;0;0;0;0
FR;4;2021-03-24;0;0;0;0;0;0;0;0;0;0
FR;4;2021-03-25;0;0;0;0;0;0;0;0;0;0
FR;4;2021-03-26;0;0;0;0;0;0;0;0;0;0
FR;4;2021-03-27;0;0;0;0;0;0;0;0;0;0
FR;4;2021-03-28;0;0;0;0;0;0;0;0;0;0
FR;4;2021-03-29;0;0;0;0;0;0;0;0;0;0
FR;4;2021-03-30;0;0;0;0;0;0;0;0;0;0
FR;4;2021-03-31;0;0;0;0;0;0;0;0;0;0
FR;4;2021-04-01;0;0;0;0;0;0;0;0;0;0
FR;4;2021-04-02;0;0;0;0;0;0;0;0;0;0
FR;4;2021-04-03;0;0;0;0;0;0;0;0;0;0
FR;4;2021-04-04;0;0;0;0;0;0;0;0;0;0
FR;4;2021-04-05;0;0;0;0;0;0;0;0;0;0
FR;4;2021-04-06;0;0;0;0;0;0;0;0;0;0
FR;4;2021-04-07;0;0;0;0;0;0;0;0;0;0
FR;4;2021-04-08;0;0;0;0;0;0;0;0;0;0
FR;4;2021-04-09;0;0;0;0;0;0;0;0;0;0
FR;4;2021-04-10;0;0;0;0;0;0;0;0;0;0
FR;4;2021-04-11;0;0;0;0;0;0;0;0;0;0
FR;4;2021-04-12;0;0;0;0;0;0;0;0;0;0
FR;4;2021-04-13;0;0;0;0;0;0;0;0;0;0
FR;4;2021-04-14;0;0;0;0;0;0;0;0;0;0
FR;4;2021-04-15;0;0;0;0;0;0;0;0;0;0
FR;4;2021-04-16;0;0;0;0;0;0;0;0;0;0
FR;4;2021-04-17;0;0;0;0;0;0;0;0;0;0
FR;4;2021-04-18;0;0;0;0;0;0;0;0;0;0
FR;4;2021-04-19;0;0;0;0;0;0;0;0;0;0
FR;4;2021-04-20;0;0;0;0;0;0;0;0;0;0
FR;4;2021-04-21;0;0;0;0;0;0;0;0;0;0
FR;4;2021-04-22;0;0;0;0;0;0;0;0;0;0
FR;4;2021-04-23;4089;0;0;0;0;4089;0;0;0;0
FR;4;2021-04-24;1569;0;0;0;0;5658;0;0;0;0
FR;4;2021-04-25;124;0;0;0;0;5782;0;0;0;0
FR;4;2021-04-26;2868;1;0;0;0;8650;1;0;0;0
FR;4;2021-04-27;9520;3;0;0;0;18170;4;0;0;0
FR;4;2021-04-28;9904;6;0;0;0;28074;10;0;0;0
FR;4;2021-04-29;15989;8;0;0;0;44063;18;0;0;0
FR;4;2021-04-30;19223;10;0;0;0;63286;28;0;0;0
FR;4;2021-05-01;1989;6;0;0;0;65275;34;0;0;0
FR;4;2021-05-02;481;0;0;0;0;65756;34;0;0;0
FR;4;2021-05-03;5057;2;0;0;0;70813;36;0;0;0
FR;4;2021-05-04;8396;10;0;0;0;79209;46;0;0;0
FR;4;2021-05-05;6179;7;0;0;0;85388;53;0;0;0
FR;4;2021-05-06;11379;11;0;0;0;96767;64;0;0;0
FR;4;2021-05-07;19115;9;0;0;0;115882;73;0;0;0
FR;4;2021-05-08;2375;6;0;0;0;118257;79;0;0;0
FR;4;2021-05-09;685;3;0;0;0;118942;82;0;0;0
FR;4;2021-05-10;7234;5;1;0;0;126176;87;1;0;0
FR;4;2021-05-11;14310;11;0;0;0;140486;98;1;0;0
FR;4;2021-05-12;10157;15;0;0;0;150643;113;1;0;0
FR;4;2021-05-13;1578;3;0;0;0;152221;116;1;0;0
FR;4;2021-05-14;7753;6;0;0;0;159974;122;1;0;0
FR;4;2021-05-15;3712;8;1;0;0;163686;130;2;0;0
FR;4;2021-05-16;418;1;0;0;0;164104;131;2;0;0
FR;4;2021-05-17;4473;6;0;0;0;168577;137;2;0;0
FR;4;2021-05-18;8743;9;0;0;0;177320;146;2;0;0
FR;4;2021-05-19;5686;7;0;0;0;183006;153;2;0;0
FR;4;2021-05-20;9476;7;0;0;0;192482;160;2;0;0
FR;4;2021-05-21;12782;29;0;0;0;205264;189;2;0;0
FR;4;2021-05-22;5051;15;0;0;0;210315;204;2;0;0
FR;4;2021-05-23;494;4;0;0;0;210809;208;2;0;0
FR;4;2021-05-24;1049;7;0;0;0;211858;215;2;0;0
FR;4;2021-05-25;7618;15;0;0;0;219476;230;2;0;0
FR;4;2021-05-26;7720;16;0;0;0;227196;246;2;0;0
FR;4;2021-05-27;14327;35;0;0;0;241523;281;2;0;0
FR;4;2021-05-28;26577;82;1;0;0;268100;363;3;0;0
FR;4;2021-05-29;11381;18;0;0;0;279481;381;3;0;0
FR;4;2021-05-30;970;6;0;0;0;280451;387;3;0;0
FR;4;2021-05-31;12684;21;0;0;0;293135;408;3;0;0
FR;4;2021-06-01;20242;46;1;0;0;313377;454;4;0;0
FR;4;2021-06-02;14514;33;0;0;0;327891;487;4;0;0
FR;4;2021-06-03;19400;24;1;0;0;347291;511;5;0;0
FR;4;2021-06-04;22504;47;0;0;0;369795;558;5;0;0
FR;4;2021-06-05;9712;32;0;0;0;379507;590;5;0;0
FR;4;2021-06-06;1037;0;0;0;0;380544;590;5;0;0
FR;4;2021-06-07;9223;19;0;0;0;389767;609;5;0;0
FR;4;2021-06-08;14606;31;0;0;0;404373;640;5;0;0
FR;4;2021-06-09;12200;25;0;0;0;416573;665;5;0;0
FR;4;2021-06-10;15394;30;0;0;0;431967;695;5;0;0
FR;4;2021-06-11;16973;55;0;0;0;448940;750;5;0;0
FR;4;2021-06-12;7441;27;0;0;0;456381;777;5;0;0
FR;4;2021-06-13;907;2;0;0;0;457288;779;5;0;0
FR;4;2021-06-14;6646;25;0;0;0;463934;804;5;0;0
FR;4;2021-06-15;10878;37;0;0;0;474812;841;5;0;0
FR;4;2021-06-16;8901;14;0;0;0;483713;855;5;0;0
FR;4;2021-06-17;10893;36;0;0;0;494606;891;5;0;0
FR;4;2021-06-18;12416;45;0;0;0;507022;936;5;0;0
FR;4;2021-06-19;5565;25;0;0;0;512587;961;5;0;0
FR;4;2021-06-20;814;5;0;0;0;513401;966;5;0;0
FR;4;2021-06-21;5079;20;0;0;0;518480;986;5;0;0
FR;4;2021-06-22;7903;27;2;0;0;526383;1013;7;0;0
FR;4;2021-06-23;7089;39;2;0;0;533472;1052;9;0;0
FR;4;2021-06-24;8643;45;1;0;0;542115;1097;10;0;0
FR;4;2021-06-25;10165;39;2;0;0;552280;1136;12;0;0
FR;4;2021-06-26;4839;21;0;0;0;557119;1157;12;0;0
FR;4;2021-06-27;758;3;0;0;0;557877;1160;12;0;0
FR;4;2021-06-28;4813;16;1;0;0;562690;1176;13;0;0
FR;4;2021-06-29;7095;27;2;0;0;569785;1203;15;0;0
FR;4;2021-06-30;6706;40;2;0;0;576491;1243;17;0;0
FR;4;2021-07-01;8184;40;0;0;0;584675;1283;17;0;0
FR;4;2021-07-02;9412;52;1;0;0;594087;1335;18;0;0
FR;4;2021-07-03;4840;19;0;0;0;598927;1354;18;0;0
FR;4;2021-07-04;685;5;0;0;0;599612;1359;18;0;0
FR;4;2021-07-05;4765;19;2;0;0;604377;1378;20;0;0
FR;4;2021-07-06;7712;28;4;0;0;612089;1406;24;0;0
FR;4;2021-07-07;7061;34;2;0;0;619150;1440;26;0;0
FR;4;2021-07-08;9215;38;2;0;0;628365;1478;28;0;0
FR;4;2021-07-09;10270;33;1;0;0;638635;1511;29;0;0
FR;4;2021-07-10;4634;14;2;0;0;643269;1525;31;0;0
FR;4;2021-07-11;579;4;1;0;0;643848;1529;32;0;0
FR;4;2021-07-12;5868;29;0;0;0;649716;1558;32;0;0
FR;4;2021-07-13;14226;29;0;0;0;663942;1587;32;0;0
FR;4;2021-07-14;2280;14;0;0;0;666222;1601;32;0;0
FR;4;2021-07-15;18226;36;0;0;0;684448;1637;32;0;0
FR;4;2021-07-16;22814;70;2;0;0;707262;1707;34;0;0
FR;4;2021-07-17;9734;20;0;0;0;716996;1727;34;0;0
FR;4;2021-07-18;1350;4;0;0;0;718346;1731;34;0;0
FR;4;2021-07-19;12969;28;1;0;0;731315;1759;35;0;0
FR;4;2021-07-20;17322;26;1;0;0;748637;1785;36;0;0
FR;4;2021-07-21;15598;33;0;0;0;764235;1818;36;0;0
FR;4;2021-07-22;18230;43;2;0;0;782465;1861;38;0;0
FR;4;2021-07-23;20399;57;7;0;0;802864;1918;45;0;0
FR;4;2021-07-24;9271;32;0;0;0;812135;1950;45;0;0
FR;4;2021-07-25;1342;8;0;0;0;813477;1958;45;0;0
FR;4;2021-07-26;11021;20;0;0;0;824498;1978;45;0;0
FR;4;2021-07-27;14649;35;3;0;0;839147;2013;48;0;0
FR;4;2021-07-28;12910;25;2;0;0;852057;2038;50;0;0
FR;4;2021-07-29;14063;54;4;0;0;866120;2092;54;0;0
FR;4;2021-07-30;15468;45;2;0;0;881588;2137;56;0;0
FR;4;2021-07-31;6813;14;2;0;0;888401;2151;58;0;0
FR;4;2021-08-01;902;1;0;0;0;889303;2152;58;0;0
FR;4;2021-08-02;7890;29;0;0;0;897193;2181;58;0;0
FR;4;2021-08-03;10786;32;2;0;0;907979;2213;60;0;0
FR;4;2021-08-04;9719;29;0;0;0;917698;2242;60;0;0
FR;4;2021-08-05;9801;41;0;0;0;927499;2283;60;0;0
FR;4;2021-08-06;10169;31;3;0;0;937668;2314;63;0;0
FR;4;2021-08-07;5077;30;1;0;0;942745;2344;64;0;0
FR;4;2021-08-08;1212;13;0;0;0;943957;2357;64;0;0
FR;4;2021-08-09;6319;30;0;0;0;950276;2387;64;0;0
FR;4;2021-08-10;8738;20;0;0;0;959014;2407;64;0;0
FR;4;2021-08-11;7923;33;3;0;0;966937;2440;67;0;0
FR;4;2021-08-12;8577;29;1;0;0;975514;2469;68;0;0
FR;4;2021-08-13;7536;24;0;1;0;983050;2493;68;1;0
FR;4;2021-08-14;3780;20;0;0;0;986830;2513;68;1;0
FR;4;2021-08-15;767;5;0;0;0;987597;2518;68;1;0
FR;4;2021-08-16;3999;16;0;0;0;991596;2534;68;1;0
FR;4;2021-08-17;5611;15;1;0;0;997207;2549;69;1;0
FR;4;2021-08-18;5152;34;0;0;0;1002359;2583;69;1;0
FR;4;2021-08-19;5470;34;3;0;0;1007829;2617;72;1;0
FR;4;2021-08-20;5199;23;1;0;0;1013028;2640;73;1;0
FR;4;2021-08-21;2303;21;1;0;0;1015331;2661;74;1;0
FR;4;2021-08-22;400;2;0;0;0;1015731;2663;74;1;0
FR;4;2021-08-23;2912;18;1;0;0;1018643;2681;75;1;0
FR;4;2021-08-24;3737;15;0;0;0;1022380;2696;75;1;0
FR;4;2021-08-25;3528;25;0;0;0;1025908;2721;75;1;0
FR;4;2021-08-26;3698;20;1;0;0;1029606;2741;76;1;0
FR;4;2021-08-27;3597;31;2;0;0;1033203;2772;78;1;0
FR;4;2021-08-28;1720;10;1;0;0;1034923;2782;79;1;0
FR;4;2021-08-29;386;7;1;0;0;1035309;2789;80;1;0
FR;4;2021-08-30;2000;24;0;0;14;1037309;2813;80;1;14
FR;4;2021-08-31;2473;20;0;0;13;1039782;2833;80;1;27
FR;4;2021-09-01;2070;38;1;0;21;1041852;2871;81;1;48
FR;4;2021-09-02;2299;31;4;0;18;1044151;2902;85;1;66
FR;4;2021-09-03;2351;44;5;0;32;1046502;2946;90;1;98
FR;4;2021-09-04;1370;17;0;0;5;1047872;2963;90;1;103
FR;4;2021-09-05;428;2;0;0;2;1048300;2965;90;1;105
FR;4;2021-09-06;1701;61;0;0;23;1050001;3026;90;1;128
FR;4;2021-09-07;1671;18;0;0;8;1051672;3044;90;1;136
FR;4;2021-09-08;1277;26;3;1;19;1052949;3070;93;2;155
FR;4;2021-09-09;1384;23;2;0;9;1054333;3093;95;2;164
FR;4;2021-09-10;1513;31;2;0;23;1055846;3124;97;2;187
FR;4;2021-09-11;734;11;0;0;3;1056580;3135;97;2;190
FR;4;2021-09-12;167;4;0;0;2;1056747;3139;97;2;192
FR;4;2021-09-13;1308;21;1;0;15;1058055;3160;98;2;207
FR;4;2021-09-14;1490;9;2;0;6;1059545;3169;100;2;213
FR;4;2021-09-15;1087;26;1;0;24;1060632;3195;101;2;237
FR;4;2021-09-16;1094;22;2;0;15;1061726;3217;103;2;252
FR;4;2021-09-17;889;21;1;0;12;1062615;3238;104;2;264
FR;4;2021-09-18;459;5;1;0;4;1063074;3243;105;2;268
FR;4;2021-09-19;181;2;0;0;1;1063255;3245;105;2;269
FR;4;2021-09-20;442;18;0;0;12;1063697;3263;105;2;281
FR;4;2021-09-21;420;11;0;0;7;1064117;3274;105;2;288
FR;4;2021-09-22;372;20;2;0;14;1064489;3294;107;2;302
FR;4;2021-09-23;474;13;1;0;12;1064963;3307;108;2;314
FR;4;2021-09-24;407;13;2;0;9;1065370;3320;110;2;323
FR;4;2021-09-25;281;9;1;0;4;1065651;3329;111;2;327
FR;4;2021-09-26;71;2;0;0;1;1065722;3331;111;2;328
FR;4;2021-09-27;259;10;1;0;8;1065981;3341;112;2;336
FR;4;2021-09-28;314;8;0;0;8;1066295;3349;112;2;344
FR;4;2021-09-29;370;19;1;0;13;1066665;3368;113;2;357
FR;4;2021-09-30;357;39;0;0;20;1067022;3407;113;2;377
FR;4;2021-10-01;398;49;0;0;43;1067420;3456;113;2;420
FR;4;2021-10-02;192;22;1;0;13;1067612;3478;114;2;433
FR;4;2021-10-03;83;1;0;0;0;1067695;3479;114;2;433
FR;4;2021-10-04;352;19;1;0;15;1068047;3498;115;2;448
FR;4;2021-10-05;272;19;2;0;15;1068319;3517;117;2;463
FR;4;2021-10-06;242;22;1;0;18;1068561;3539;118;2;481
FR;4;2021-10-07;251;26;2;0;14;1068812;3565;120;2;495
FR;4;2021-10-08;351;22;2;0;18;1069163;3587;122;2;513
FR;4;2021-10-09;191;6;6;0;7;1069354;3593;128;2;520
FR;4;2021-10-10;93;3;2;0;3;1069447;3596;130;2;523
FR;4;2021-10-11;243;14;1;0;13;1069690;3610;131;2;536
FR;4;2021-10-12;202;14;0;0;13;1069892;3624;131;2;549
FR;4;2021-10-13;217;28;1;0;25;1070109;3652;132;2;574
FR;4;2021-10-14;304;20;4;0;14;1070413;3672;136;2;588
FR;4;2021-10-15;318;24;5;0;25;1070731;3696;141;2;613
FR;4;2021-10-16;163;6;2;0;6;1070894;3702;143;2;619
FR;4;2021-10-17;70;2;0;0;1;1070964;3704;143;2;620
FR;4;2021-10-18;275;16;1;0;12;1071239;3720;144;2;632
FR;4;2021-10-19;205;14;2;0;15;1071444;3734;146;2;647
FR;4;2021-10-20;224;27;3;0;14;1071668;3761;149;2;661
FR;4;2021-10-21;230;17;0;0;13;1071898;3778;149;2;674
FR;4;2021-10-22;206;26;2;0;21;1072104;3804;151;2;695
FR;4;2021-10-23;115;16;1;0;15;1072219;3820;152;2;710
FR;4;2021-10-24;37;4;0;0;1;1072256;3824;152;2;711
FR;4;2021-10-25;205;7;2;0;9;1072461;3831;154;2;720
FR;4;2021-10-26;194;13;0;0;11;1072655;3844;154;2;731
FR;4;2021-10-27;188;11;4;0;11;1072843;3855;158;2;742
FR;4;2021-10-28;180;18;4;0;21;1073023;3873;162;2;763
FR;4;2021-10-29;218;16;2;0;14;1073241;3889;164;2;777
FR;4;2021-10-30;100;2;1;0;2;1073341;3891;165;2;779
FR;4;2021-10-31;55;3;2;0;3;1073396;3894;167;2;782
FR;4;2021-11-01;74;27;4;0;24;1073470;3921;171;2;806
FR;4;2021-11-02;150;20;2;0;21;1073620;3941;173;2;827
FR;4;2021-11-03;125;20;8;1;18;1073745;3961;181;3;845
FR;4;2021-11-04;173;13;1;0;10;1073918;3974;182;3;855
FR;4;2021-11-05;123;17;1;0;16;1074041;3991;183;3;871
FR;4;2021-11-06;77;6;1;0;6;1074118;3997;184;3;877
FR;4;2021-11-07;73;2;2;0;4;1074191;3999;186;3;881
FR;4;2021-11-08;158;16;1;0;16;1074349;4015;187;3;897
FR;4;2021-11-09;150;14;3;0;16;1074499;4029;190;3;913
FR;4;2021-11-10;110;27;6;0;29;1074609;4056;196;3;942
FR;4;2021-11-11;80;9;0;0;9;1074689;4065;196;3;951
FR;4;2021-11-12;94;18;2;0;18;1074783;4083;198;3;969
FR;4;2021-11-13;72;15;2;0;14;1074855;4098;200;3;983
FR;4;2021-11-14;52;5;3;0;7;1074907;4103;203;3;990
FR;4;2021-11-15;93;26;2;0;24;1075000;4129;205;3;1014
FR;4;2021-11-16;98;12;2;0;14;1075098;4141;207;3;1028
FR;4;2021-11-17;111;29;4;0;29;1075209;4170;211;3;1057
FR;4;2021-11-18;95;34;11;0;39;1075304;4204;222;3;1096
FR;4;2021-11-19;78;19;3;0;20;1075382;4223;225;3;1116
FR;4;2021-11-20;60;6;1;0;6;1075442;4229;226;3;1122
FR;4;2021-11-21;61;7;2;0;9;1075503;4236;228;3;1131
FR;4;2021-11-22;99;27;6;0;29;1075602;4263;234;3;1160
FR;4;2021-11-23;71;30;5;0;27;1075673;4293;239;3;1187
FR;4;2021-11-24;84;23;9;0;22;1075757;4316;248;3;1209
FR;4;2021-11-25;83;29;14;0;31;1075840;4345;262;3;1240
FR;4;2021-11-26;78;42;12;0;44;1075918;4387;274;3;1284
FR;4;2021-11-27;31;23;17;0;26;1075949;4410;291;3;1310
FR;4;2021-11-28;46;8;0;0;7;1075995;4418;291;3;1317
FR;4;2021-11-29;80;31;14;0;38;1076075;4449;305;3;1355
FR;4;2021-11-30;57;36;13;0;40;1076132;4485;318;3;1395
FR;4;2021-12-01;69;60;19;0;67;1076201;4545;337;3;1462
FR;4;2021-12-02;95;47;17;0;50;1076296;4592;354;3;1512
FR;4;2021-12-03;98;36;15;0;44;1076394;4628;369;3;1556
FR;4;2021-12-04;67;31;19;0;44;1076461;4659;388;3;1600
FR;4;2021-12-05;55;5;1;0;6;1076516;4664;389;3;1606
FR;4;2021-12-06;91;45;21;0;60;1076607;4709;410;3;1666
FR;4;2021-12-07;76;33;10;0;33;1076683;4742;420;3;1699
FR;4;2021-12-08;64;28;18;0;33;1076747;4770;438;3;1732
FR;4;2021-12-09;57;32;10;0;38;1076804;4802;448;3;1770
FR;4;2021-12-10;59;62;21;0;67;1076863;4864;469;3;1837
FR;4;2021-12-11;24;33;7;0;33;1076887;4897;476;3;1870
FR;4;2021-12-12;21;10;3;0;13;1076908;4907;479;3;1883
FR;4;2021-12-13;64;39;13;0;48;1076972;4946;492;3;1931
FR;4;2021-12-14;53;43;14;0;51;1077025;4989;506;3;1982
FR;4;2021-12-15;55;61;29;0;81;1077080;5050;535;3;2063
FR;4;2021-12-16;29;43;19;0;55;1077109;5093;554;3;2118
FR;4;2021-12-17;36;54;12;0;59;1077145;5147;566;3;2177
FR;4;2021-12-18;47;29;2;0;30;1077192;5176;568;3;2207
FR;4;2021-12-19;15;4;1;0;4;1077207;5180;569;3;2211
FR;4;2021-12-20;34;38;12;0;43;1077241;5218;581;3;2254
FR;4;2021-12-21;24;30;14;0;35;1077265;5248;595;3;2289
FR;4;2021-12-22;35;35;11;0;36;1077300;5283;606;3;2325
FR;4;2021-12-23;38;43;8;0;47;1077338;5326;614;3;2372
FR;4;2021-12-24;22;25;10;0;29;1077360;5351;624;3;2401
FR;4;2021-12-25;6;3;3;0;4;1077366;5354;627;3;2405
FR;4;2021-12-26;4;3;1;0;2;1077370;5357;628;3;2407
FR;4;2021-12-27;26;42;9;0;43;1077396;5399;637;3;2450
FR;4;2021-12-28;24;28;8;0;29;1077420;5427;645;3;2479
FR;4;2021-12-29;44;23;10;0;27;1077464;5450;655;3;2506
FR;4;2021-12-30;36;16;12;0;19;1077500;5466;667;3;2525
FR;4;2021-12-31;18;4;8;0;10;1077518;5470;675;3;2535
FR;4;2022-01-01;4;3;4;0;5;1077522;5473;679;3;2540
FR;4;2022-01-02;38;4;14;0;17;1077560;5477;693;3;2557
FR;4;2022-01-03;36;49;19;1;54;1077596;5526;712;4;2611
FR;4;2022-01-04;25;24;11;1;25;1077621;5550;723;5;2636
FR;4;2022-01-05;40;19;16;0;19;1077661;5569;739;5;2655
FR;4;2022-01-06;41;18;20;0;30;1077702;5587;759;5;2685
FR;4;2022-01-07;18;18;15;0;18;1077720;5605;774;5;2703
FR;4;2022-01-08;7;5;9;0;11;1077727;5610;783;5;2714
FR;4;2022-01-09;15;1;1;0;2;1077742;5611;784;5;2716
FR;4;2022-01-10;34;21;16;0;32;1077776;5632;800;5;2748
FR;4;2022-01-11;21;29;12;0;31;1077797;5661;812;5;2779
FR;4;2022-01-12;29;16;12;0;17;1077826;5677;824;5;2796
FR;4;2022-01-13;46;17;26;0;33;1077872;5694;850;5;2829
FR;4;2022-01-14;19;26;12;0;28;1077891;5720;862;5;2857
FR;4;2022-01-15;10;6;7;0;11;1077901;5726;869;5;2868
FR;4;2022-01-16;9;8;10;0;17;1077910;5734;879;5;2885
FR;4;2022-01-17;22;17;11;0;22;1077932;5751;890;5;2907
FR;4;2022-01-18;15;13;7;0;17;1077947;5764;897;5;2924
FR;4;2022-01-19;26;20;9;0;27;1077973;5784;906;5;2951
FR;4;2022-01-20;29;34;13;0;37;1078002;5818;919;5;2988
FR;4;2022-01-21;6;12;18;1;15;1078008;5830;937;6;3003
FR;4;2022-01-22;27;9;2;0;9;1078035;5839;939;6;3012
FR;4;2022-01-23;5;2;4;0;6;1078040;5841;943;6;3018
FR;4;2022-01-24;13;20;8;0;27;1078053;5861;951;6;3045
FR;4;2022-01-25;19;30;8;1;34;1078072;5891;959;7;3079
FR;4;2022-01-26;17;15;6;1;16;1078089;5906;965;8;3095
FR;4;2022-01-27;15;18;5;0;21;1078104;5924;970;8;3116
FR;4;2022-01-28;12;22;7;0;24;1078116;5946;977;8;3140
FR;4;2022-01-29;14;5;3;0;7;1078130;5951;980;8;3147
FR;4;2022-01-30;16;2;0;0;2;1078146;5953;980;8;3149
FR;4;2022-01-31;17;25;6;0;28;1078163;5978;986;8;3177
FR;4;2022-02-01;9;18;11;0;18;1078172;5996;997;8;3195
FR;4;2022-02-02;16;11;9;2;15;1078188;6007;1006;10;3210
FR;4;2022-02-03;10;19;9;0;22;1078198;6026;1015;10;3232
FR;4;2022-02-04;5;4;7;0;8;1078203;6030;1022;10;3240
FR;4;2022-02-05;6;14;1;0;13;1078209;6044;1023;10;3253
FR;4;2022-02-06;5;2;1;0;2;1078214;6046;1024;10;3255
FR;4;2022-02-07;10;17;6;0;17;1078224;6063;1030;10;3272
FR;4;2022-02-08;13;18;12;1;19;1078237;6081;1042;11;3291
FR;4;2022-02-09;13;11;7;0;14;1078250;6092;1049;11;3305
FR;4;2022-02-10;18;22;8;0;22;1078268;6114;1057;11;3327
FR;4;2022-02-11;17;14;7;0;18;1078285;6128;1064;11;3345
FR;4;2022-02-12;23;5;0;0;3;1078308;6133;1064;11;3348
FR;4;2022-02-13;7;3;3;0;6;1078315;6136;1067;11;3354
FR;4;2022-02-14;16;10;7;0;13;1078331;6146;1074;11;3367
FR;4;2022-02-15;14;7;0;0;6;1078345;6153;1074;11;3373
FR;4;2022-02-16;10;8;9;0;13;1078355;6161;1083;11;3386
FR;4;2022-02-17;8;3;4;0;5;1078363;6164;1087;11;3391
FR;4;2022-02-18;16;13;6;0;17;1078379;6177;1093;11;3408
FR;4;2022-02-19;16;2;1;0;3;1078395;6179;1094;11;3411
FR;4;2022-02-20;6;2;0;0;1;1078401;6181;1094;11;3412
FR;4;2022-02-21;22;3;2;0;3;1078423;6184;1096;11;3415
FR;4;2022-02-22;8;4;8;0;8;1078431;6188;1104;11;3423
FR;4;2022-02-23;15;6;6;0;6;1078446;6194;1110;11;3429
FR;4;2022-02-24;7;3;2;0;3;1078453;6197;1112;11;3432
FR;4;2022-02-25;15;4;7;0;5;1078468;6201;1119;11;3437
FR;4;2022-02-26;24;3;0;0;3;1078492;6204;1119;11;3440
FR;4;2022-02-27;8;0;0;0;0;1078500;6204;1119;11;3440
FR;4;2022-02-28;13;3;2;0;3;1078513;6207;1121;11;3443
FR;4;2022-03-01;5;2;7;0;3;1078518;6209;1128;11;3446
FR;4;2022-03-02;8;2;3;0;4;1078526;6211;1131;11;3450
FR;4;2022-03-03;10;2;1;0;1;1078536;6213;1132;11;3451
FR;4;2022-03-04;6;5;2;1;4;1078542;6218;1134;12;3455
FR;4;2022-03-05;8;2;0;0;2;1078550;6220;1134;12;3457
FR;4;2022-03-06;2;0;1;0;1;1078552;6220;1135;12;3458
FR;4;2022-03-07;8;4;1;0;3;1078560;6224;1136;12;3461
FR;4;2022-03-08;13;1;0;0;1;1078573;6225;1136;12;3462
FR;4;2022-03-09;7;3;2;0;4;1078580;6228;1138;12;3466
FR;4;2022-03-10;4;0;4;0;1;1078584;6228;1142;12;3467
FR;4;2022-03-11;6;2;5;0;1;1078590;6230;1147;12;3468
FR;4;2022-03-12;9;2;0;0;0;1078599;6232;1147;12;3468
FR;4;2022-03-13;4;0;0;0;0;1078603;6232;1147;12;3468
FR;4;2022-03-14;3;0;0;0;0;1078606;6232;1147;12;3468
FR;4;2022-03-15;3;2;1;0;0;1078609;6234;1148;12;3468
FR;4;2022-03-16;4;1;3;0;2;1078613;6235;1151;12;3470
FR;4;2022-03-17;0;1;3;0;2;1078613;6236;1154;12;3472
FR;4;2022-03-18;6;0;0;0;0;1078619;6236;1154;12;3472
FR;4;2022-03-19;1;0;0;0;0;1078620;6236;1154;12;3472
FR;4;2022-03-20;2;0;0;0;0;1078622;6236;1154;12;3472
FR;4;2022-03-21;5;0;0;0;0;1078627;6236;1154;12;3472
FR;4;2022-03-22;0;1;0;0;1;1078627;6237;1154;12;3473
FR;4;2022-03-23;4;3;2;0;5;1078631;6240;1156;12;3478
FR;4;2022-03-24;2;2;0;1;1;1078633;6242;1156;13;3479
FR;4;2022-03-25;2;0;1;0;0;1078635;6242;1157;13;3479
FR;4;2022-03-26;5;5;0;0;5;1078640;6247;1157;13;3484
FR;4;2022-03-27;0;0;0;0;0;1078640;6247;1157;13;3484
FR;4;2022-03-28;3;1;0;0;0;1078643;6248;1157;13;3484
FR;4;2022-03-29;4;0;3;1;0;1078647;6248;1160;14;3484
FR;4;2022-03-30;0;1;0;0;1;1078647;6249;1160;14;3485
FR;4;2022-03-31;1;1;1;0;1;1078648;6250;1161;14;3486
FR;5;2020-12-27;0;0;0;0;0;0;0;0;0;0
FR;5;2020-12-28;0;0;0;0;0;0;0;0;0;0
FR;5;2020-12-29;0;0;0;0;0;0;0;0;0;0
FR;5;2020-12-30;0;0;0;0;0;0;0;0;0;0
FR;5;2020-12-31;0;0;0;0;0;0;0;0;0;0
FR;5;2021-01-01;0;0;0;0;0;0;0;0;0;0
FR;5;2021-01-02;0;0;0;0;0;0;0;0;0;0
FR;5;2021-01-03;0;0;0;0;0;0;0;0;0;0
FR;5;2021-01-04;0;0;0;0;0;0;0;0;0;0
FR;5;2021-01-05;0;0;0;0;0;0;0;0;0;0
FR;5;2021-01-06;0;0;0;0;0;0;0;0;0;0
FR;5;2021-01-07;0;0;0;0;0;0;0;0;0;0
FR;5;2021-01-08;0;0;0;0;0;0;0;0;0;0
FR;5;2021-01-09;0;0;0;0;0;0;0;0;0;0
FR;5;2021-01-10;0;0;0;0;0;0;0;0;0;0
FR;5;2021-01-11;0;0;0;0;0;0;0;0;0;0
FR;5;2021-01-12;0;0;0;0;0;0;0;0;0;0
FR;5;2021-01-13;0;0;0;0;0;0;0;0;0;0
FR;5;2021-01-14;0;0;0;0;0;0;0;0;0;0
FR;5;2021-01-15;0;0;0;0;0;0;0;0;0;0
FR;5;2021-01-16;0;0;0;0;0;0;0;0;0;0
FR;5;2021-01-17;0;0;0;0;0;0;0;0;0;0
FR;5;2021-01-18;0;0;0;0;0;0;0;0;0;0
FR;5;2021-01-19;0;0;0;0;0;0;0;0;0;0
FR;5;2021-01-20;0;0;0;0;0;0;0;0;0;0
FR;5;2021-01-21;0;0;0;0;0;0;0;0;0;0
FR;5;2021-01-22;0;0;0;0;0;0;0;0;0;0
FR;5;2021-01-23;0;0;0;0;0;0;0;0;0;0
FR;5;2021-01-24;0;0;0;0;0;0;0;0;0;0
FR;5;2021-01-25;0;0;0;0;0;0;0;0;0;0
FR;5;2021-01-26;0;0;0;0;0;0;0;0;0;0
FR;5;2021-01-27;0;0;0;0;0;0;0;0;0;0
FR;5;2021-01-28;0;0;0;0;0;0;0;0;0;0
FR;5;2021-01-29;0;0;0;0;0;0;0;0;0;0
FR;5;2021-01-30;0;0;0;0;0;0;0;0;0;0
FR;5;2021-01-31;0;0;0;0;0;0;0;0;0;0
FR;5;2021-02-01;0;0;0;0;0;0;0;0;0;0
FR;5;2021-02-02;0;0;0;0;0;0;0;0;0;0
FR;5;2021-02-03;0;0;0;0;0;0;0;0;0;0
FR;5;2021-02-04;0;0;0;0;0;0;0;0;0;0
FR;5;2021-02-05;0;0;0;0;0;0;0;0;0;0
FR;5;2021-02-06;0;0;0;0;0;0;0;0;0;0
FR;5;2021-02-07;0;0;0;0;0;0;0;0;0;0
FR;5;2021-02-08;0;0;0;0;0;0;0;0;0;0
FR;5;2021-02-09;0;0;0;0;0;0;0;0;0;0
FR;5;2021-02-10;0;0;0;0;0;0;0;0;0;0
FR;5;2021-02-11;0;0;0;0;0;0;0;0;0;0
FR;5;2021-02-12;0;0;0;0;0;0;0;0;0;0
FR;5;2021-02-13;0;0;0;0;0;0;0;0;0;0
FR;5;2021-02-14;0;0;0;0;0;0;0;0;0;0
FR;5;2021-02-15;0;0;0;0;0;0;0;0;0;0
FR;5;2021-02-16;0;0;0;0;0;0;0;0;0;0
FR;5;2021-02-17;0;0;0;0;0;0;0;0;0;0
FR;5;2021-02-18;0;0;0;0;0;0;0;0;0;0
FR;5;2021-02-19;0;0;0;0;0;0;0;0;0;0
FR;5;2021-02-20;0;0;0;0;0;0;0;0;0;0
FR;5;2021-02-21;0;0;0;0;0;0;0;0;0;0
FR;5;2021-02-22;0;0;0;0;0;0;0;0;0;0
FR;5;2021-02-23;0;0;0;0;0;0;0;0;0;0
FR;5;2021-02-24;0;0;0;0;0;0;0;0;0;0
FR;5;2021-02-25;0;0;0;0;0;0;0;0;0;0
FR;5;2021-02-26;0;0;0;0;0;0;0;0;0;0
FR;5;2021-02-27;0;0;0;0;0;0;0;0;0;0
FR;5;2021-02-28;0;0;0;0;0;0;0;0;0;0
FR;5;2021-03-01;0;0;0;0;0;0;0;0;0;0
FR;5;2021-03-02;0;0;0;0;0;0;0;0;0;0
FR;5;2021-03-03;0;0;0;0;0;0;0;0;0;0
FR;5;2021-03-04;0;0;0;0;0;0;0;0;0;0
FR;5;2021-03-05;0;0;0;0;0;0;0;0;0;0
FR;5;2021-03-06;0;0;0;0;0;0;0;0;0;0
FR;5;2021-03-07;0;0;0;0;0;0;0;0;0;0
FR;5;2021-03-08;0;0;0;0;0;0;0;0;0;0
FR;5;2021-03-09;0;0;0;0;0;0;0;0;0;0
FR;5;2021-03-10;0;0;0;0;0;0;0;0;0;0
FR;5;2021-03-11;0;0;0;0;0;0;0;0;0;0
FR;5;2021-03-12;0;0;0;0;0;0;0;0;0;0
FR;5;2021-03-13;0;0;0;0;0;0;0;0;0;0
FR;5;2021-03-14;0;0;0;0;0;0;0;0;0;0
FR;5;2021-03-15;0;0;0;0;0;0;0;0;0;0
FR;5;2021-03-16;0;0;0;0;0;0;0;0;0;0
FR;5;2021-03-17;0;0;0;0;0;0;0;0;0;0
FR;5;2021-03-18;0;0;0;0;0;0;0;0;0;0
FR;5;2021-03-19;0;0;0;0;0;0;0;0;0;0
FR;5;2021-03-20;0;0;0;0;0;0;0;0;0;0
FR;5;2021-03-21;0;0;0;0;0;0;0;0;0;0
FR;5;2021-03-22;0;0;0;0;0;0;0;0;0;0
FR;5;2021-03-23;0;0;0;0;0;0;0;0;0;0
FR;5;2021-03-24;0;0;0;0;0;0;0;0;0;0
FR;5;2021-03-25;0;0;0;0;0;0;0;0;0;0
FR;5;2021-03-26;0;0;0;0;0;0;0;0;0;0
FR;5;2021-03-27;0;0;0;0;0;0;0;0;0;0
FR;5;2021-03-28;0;0;0;0;0;0;0;0;0;0
FR;5;2021-03-29;0;0;0;0;0;0;0;0;0;0
FR;5;2021-03-30;0;0;0;0;0;0;0;0;0;0
FR;5;2021-03-31;0;0;0;0;0;0;0;0;0;0
FR;5;2021-04-01;0;0;0;0;0;0;0;0;0;0
FR;5;2021-04-02;0;0;0;0;0;0;0;0;0;0
FR;5;2021-04-03;0;0;0;0;0;0;0;0;0;0
FR;5;2021-04-04;0;0;0;0;0;0;0;0;0;0
FR;5;2021-04-05;0;0;0;0;0;0;0;0;0;0
FR;5;2021-04-06;0;0;0;0;0;0;0;0;0;0
FR;5;2021-04-07;0;0;0;0;0;0;0;0;0;0
FR;5;2021-04-08;0;0;0;0;0;0;0;0;0;0
FR;5;2021-04-09;0;0;0;0;0;0;0;0;0;0
FR;5;2021-04-10;0;0;0;0;0;0;0;0;0;0
FR;5;2021-04-11;0;0;0;0;0;0;0;0;0;0
FR;5;2021-04-12;0;0;0;0;0;0;0;0;0;0
FR;5;2021-04-13;0;0;0;0;0;0;0;0;0;0
FR;5;2021-04-14;0;0;0;0;0;0;0;0;0;0
FR;5;2021-04-15;0;0;0;0;0;0;0;0;0;0
FR;5;2021-04-16;0;0;0;0;0;0;0;0;0;0
FR;5;2021-04-17;0;0;0;0;0;0;0;0;0;0
FR;5;2021-04-18;0;0;0;0;0;0;0;0;0;0
FR;5;2021-04-19;0;0;0;0;0;0;0;0;0;0
FR;5;2021-04-20;0;0;0;0;0;0;0;0;0;0
FR;5;2021-04-21;0;0;0;0;0;0;0;0;0;0
FR;5;2021-04-22;0;0;0;0;0;0;0;0;0;0
FR;5;2021-04-23;0;0;0;0;0;0;0;0;0;0
FR;5;2021-04-24;0;0;0;0;0;0;0;0;0;0
FR;5;2021-04-25;0;0;0;0;0;0;0;0;0;0
FR;5;2021-04-26;0;0;0;0;0;0;0;0;0;0
FR;5;2021-04-27;0;0;0;0;0;0;0;0;0;0
FR;5;2021-04-28;0;0;0;0;0;0;0;0;0;0
FR;5;2021-04-29;0;0;0;0;0;0;0;0;0;0
FR;5;2021-04-30;0;0;0;0;0;0;0;0;0;0
FR;5;2021-05-01;0;0;0;0;0;0;0;0;0;0
FR;5;2021-05-02;0;0;0;0;0;0;0;0;0;0
FR;5;2021-05-03;0;0;0;0;0;0;0;0;0;0
FR;5;2021-05-04;0;0;0;0;0;0;0;0;0;0
FR;5;2021-05-05;0;0;0;0;0;0;0;0;0;0
FR;5;2021-05-06;0;0;0;0;0;0;0;0;0;0
FR;5;2021-05-07;0;0;0;0;0;0;0;0;0;0
FR;5;2021-05-08;0;0;0;0;0;0;0;0;0;0
FR;5;2021-05-09;0;0;0;0;0;0;0;0;0;0
FR;5;2021-05-10;0;0;0;0;0;0;0;0;0;0
FR;5;2021-05-11;0;0;0;0;0;0;0;0;0;0
FR;5;2021-05-12;0;0;0;0;0;0;0;0;0;0
FR;5;2021-05-13;0;0;0;0;0;0;0;0;0;0
FR;5;2021-05-14;0;0;0;0;0;0;0;0;0;0
FR;5;2021-05-15;0;0;0;0;0;0;0;0;0;0
FR;5;2021-05-16;0;0;0;0;0;0;0;0;0;0
FR;5;2021-05-17;0;0;0;0;0;0;0;0;0;0
FR;5;2021-05-18;0;0;0;0;0;0;0;0;0;0
FR;5;2021-05-19;0;0;0;0;0;0;0;0;0;0
FR;5;2021-05-20;0;0;0;0;0;0;0;0;0;0
FR;5;2021-05-21;0;0;0;0;0;0;0;0;0;0
FR;5;2021-05-22;0;0;0;0;0;0;0;0;0;0
FR;5;2021-05-23;0;0;0;0;0;0;0;0;0;0
FR;5;2021-05-24;0;0;0;0;0;0;0;0;0;0
FR;5;2021-05-25;0;0;0;0;0;0;0;0;0;0
FR;5;2021-05-26;0;0;0;0;0;0;0;0;0;0
FR;5;2021-05-27;0;0;0;0;0;0;0;0;0;0
FR;5;2021-05-28;0;0;0;0;0;0;0;0;0;0
FR;5;2021-05-29;0;0;0;0;0;0;0;0;0;0
FR;5;2021-05-30;0;0;0;0;0;0;0;0;0;0
FR;5;2021-05-31;0;0;0;0;0;0;0;0;0;0
FR;5;2021-06-01;0;0;0;0;0;0;0;0;0;0
FR;5;2021-06-02;0;0;0;0;0;0;0;0;0;0
FR;5;2021-06-03;0;0;0;0;0;0;0;0;0;0
FR;5;2021-06-04;0;0;0;0;0;0;0;0;0;0
FR;5;2021-06-05;0;0;0;0;0;0;0;0;0;0
FR;5;2021-06-06;0;0;0;0;0;0;0;0;0;0
FR;5;2021-06-07;0;0;0;0;0;0;0;0;0;0
FR;5;2021-06-08;0;0;0;0;0;0;0;0;0;0
FR;5;2021-06-09;0;0;0;0;0;0;0;0;0;0
FR;5;2021-06-10;0;0;0;0;0;0;0;0;0;0
FR;5;2021-06-11;0;0;0;0;0;0;0;0;0;0
FR;5;2021-06-12;0;0;0;0;0;0;0;0;0;0
FR;5;2021-06-13;0;0;0;0;0;0;0;0;0;0
FR;5;2021-06-14;0;0;0;0;0;0;0;0;0;0
FR;5;2021-06-15;0;0;0;0;0;0;0;0;0;0
FR;5;2021-06-16;0;0;0;0;0;0;0;0;0;0
FR;5;2021-06-17;0;0;0;0;0;0;0;0;0;0
FR;5;2021-06-18;0;0;0;0;0;0;0;0;0;0
FR;5;2021-06-19;0;0;0;0;0;0;0;0;0;0
FR;5;2021-06-20;0;0;0;0;0;0;0;0;0;0
FR;5;2021-06-21;0;0;0;0;0;0;0;0;0;0
FR;5;2021-06-22;0;0;0;0;0;0;0;0;0;0
FR;5;2021-06-23;0;0;0;0;0;0;0;0;0;0
FR;5;2021-06-24;0;0;0;0;0;0;0;0;0;0
FR;5;2021-06-25;0;0;0;0;0;0;0;0;0;0
FR;5;2021-06-26;0;0;0;0;0;0;0;0;0;0
FR;5;2021-06-27;0;0;0;0;0;0;0;0;0;0
FR;5;2021-06-28;0;0;0;0;0;0;0;0;0;0
FR;5;2021-06-29;0;0;0;0;0;0;0;0;0;0
FR;5;2021-06-30;0;0;0;0;0;0;0;0;0;0
FR;5;2021-07-01;0;0;0;0;0;0;0;0;0;0
FR;5;2021-07-02;0;0;0;0;0;0;0;0;0;0
FR;5;2021-07-03;0;0;0;0;0;0;0;0;0;0
FR;5;2021-07-04;0;0;0;0;0;0;0;0;0;0
FR;5;2021-07-05;0;0;0;0;0;0;0;0;0;0
FR;5;2021-07-06;0;0;0;0;0;0;0;0;0;0
FR;5;2021-07-07;0;0;0;0;0;0;0;0;0;0
FR;5;2021-07-08;0;0;0;0;0;0;0;0;0;0
FR;5;2021-07-09;0;0;0;0;0;0;0;0;0;0
FR;5;2021-07-10;0;0;0;0;0;0;0;0;0;0
FR;5;2021-07-11;0;0;0;0;0;0;0;0;0;0
FR;5;2021-07-12;0;0;0;0;0;0;0;0;0;0
FR;5;2021-07-13;0;0;0;0;0;0;0;0;0;0
FR;5;2021-07-14;0;0;0;0;0;0;0;0;0;0
FR;5;2021-07-15;0;0;0;0;0;0;0;0;0;0
FR;5;2021-07-16;0;0;0;0;0;0;0;0;0;0
FR;5;2021-07-17;0;0;0;0;0;0;0;0;0;0
FR;5;2021-07-18;0;0;0;0;0;0;0;0;0;0
FR;5;2021-07-19;0;0;0;0;0;0;0;0;0;0
FR;5;2021-07-20;0;0;0;0;0;0;0;0;0;0
FR;5;2021-07-21;0;0;0;0;0;0;0;0;0;0
FR;5;2021-07-22;0;0;0;0;0;0;0;0;0;0
FR;5;2021-07-23;0;0;0;0;0;0;0;0;0;0
FR;5;2021-07-24;0;0;0;0;0;0;0;0;0;0
FR;5;2021-07-25;0;0;0;0;0;0;0;0;0;0
FR;5;2021-07-26;0;0;0;0;0;0;0;0;0;0
FR;5;2021-07-27;0;0;0;0;0;0;0;0;0;0
FR;5;2021-07-28;0;0;0;0;0;0;0;0;0;0
FR;5;2021-07-29;0;0;0;0;0;0;0;0;0;0
FR;5;2021-07-30;0;0;0;0;0;0;0;0;0;0
FR;5;2021-07-31;0;0;0;0;0;0;0;0;0;0
FR;5;2021-08-01;0;0;0;0;0;0;0;0;0;0
FR;5;2021-08-02;0;0;0;0;0;0;0;0;0;0
FR;5;2021-08-03;0;0;0;0;0;0;0;0;0;0
FR;5;2021-08-04;0;0;0;0;0;0;0;0;0;0
FR;5;2021-08-05;0;0;0;0;0;0;0;0;0;0
FR;5;2021-08-06;0;0;0;0;0;0;0;0;0;0
FR;5;2021-08-07;0;0;0;0;0;0;0;0;0;0
FR;5;2021-08-08;0;0;0;0;0;0;0;0;0;0
FR;5;2021-08-09;0;0;0;0;0;0;0;0;0;0
FR;5;2021-08-10;0;0;0;0;0;0;0;0;0;0
FR;5;2021-08-11;0;0;0;0;0;0;0;0;0;0
FR;5;2021-08-12;0;0;0;0;0;0;0;0;0;0
FR;5;2021-08-13;0;0;0;0;0;0;0;0;0;0
FR;5;2021-08-14;0;0;0;0;0;0;0;0;0;0
FR;5;2021-08-15;0;0;0;0;0;0;0;0;0;0
FR;5;2021-08-16;0;0;0;0;0;0;0;0;0;0
FR;5;2021-08-17;0;0;0;0;0;0;0;0;0;0
FR;5;2021-08-18;0;0;0;0;0;0;0;0;0;0
FR;5;2021-08-19;0;0;0;0;0;0;0;0;0;0
FR;5;2021-08-20;0;0;0;0;0;0;0;0;0;0
FR;5;2021-08-21;0;0;0;0;0;0;0;0;0;0
FR;5;2021-08-22;0;0;0;0;0;0;0;0;0;0
FR;5;2021-08-23;0;0;0;0;0;0;0;0;0;0
FR;5;2021-08-24;0;0;0;0;0;0;0;0;0;0
FR;5;2021-08-25;0;0;0;0;0;0;0;0;0;0
FR;5;2021-08-26;0;0;0;0;0;0;0;0;0;0
FR;5;2021-08-27;0;0;0;0;0;0;0;0;0;0
FR;5;2021-08-28;0;0;0;0;0;0;0;0;0;0
FR;5;2021-08-29;0;0;0;0;0;0;0;0;0;0
FR;5;2021-08-30;0;0;0;0;0;0;0;0;0;0
FR;5;2021-08-31;0;0;0;0;0;0;0;0;0;0
FR;5;2021-09-01;0;0;0;0;0;0;0;0;0;0
FR;5;2021-09-02;0;0;0;0;0;0;0;0;0;0
FR;5;2021-09-03;0;0;0;0;0;0;0;0;0;0
FR;5;2021-09-04;0;0;0;0;0;0;0;0;0;0
FR;5;2021-09-05;0;0;0;0;0;0;0;0;0;0
FR;5;2021-09-06;0;0;0;0;0;0;0;0;0;0
FR;5;2021-09-07;0;0;0;0;0;0;0;0;0;0
FR;5;2021-09-08;0;0;0;0;0;0;0;0;0;0
FR;5;2021-09-09;0;0;0;0;0;0;0;0;0;0
FR;5;2021-09-10;0;0;0;0;0;0;0;0;0;0
FR;5;2021-09-11;0;0;0;0;0;0;0;0;0;0
FR;5;2021-09-12;0;0;0;0;0;0;0;0;0;0
FR;5;2021-09-13;0;0;0;0;0;0;0;0;0;0
FR;5;2021-09-14;0;0;0;0;0;0;0;0;0;0
FR;5;2021-09-15;0;0;0;0;0;0;0;0;0;0
FR;5;2021-09-16;0;0;0;0;0;0;0;0;0;0
FR;5;2021-09-17;0;0;0;0;0;0;0;0;0;0
FR;5;2021-09-18;0;0;0;0;0;0;0;0;0;0
FR;5;2021-09-19;0;0;0;0;0;0;0;0;0;0
FR;5;2021-09-20;0;0;0;0;0;0;0;0;0;0
FR;5;2021-09-21;0;0;0;0;0;0;0;0;0;0
FR;5;2021-09-22;0;0;0;0;0;0;0;0;0;0
FR;5;2021-09-23;0;0;0;0;0;0;0;0;0;0
FR;5;2021-09-24;0;0;0;0;0;0;0;0;0;0
FR;5;2021-09-25;0;0;0;0;0;0;0;0;0;0
FR;5;2021-09-26;0;0;0;0;0;0;0;0;0;0
FR;5;2021-09-27;0;0;0;0;0;0;0;0;0;0
FR;5;2021-09-28;0;0;0;0;0;0;0;0;0;0
FR;5;2021-09-29;0;0;0;0;0;0;0;0;0;0
FR;5;2021-09-30;0;0;0;0;0;0;0;0;0;0
FR;5;2021-10-01;0;0;0;0;0;0;0;0;0;0
FR;5;2021-10-02;0;0;0;0;0;0;0;0;0;0
FR;5;2021-10-03;0;0;0;0;0;0;0;0;0;0
FR;5;2021-10-04;0;0;0;0;0;0;0;0;0;0
FR;5;2021-10-05;0;0;0;0;0;0;0;0;0;0
FR;5;2021-10-06;0;0;0;0;0;0;0;0;0;0
FR;5;2021-10-07;0;0;0;0;0;0;0;0;0;0
FR;5;2021-10-08;0;0;0;0;0;0;0;0;0;0
FR;5;2021-10-09;0;0;0;0;0;0;0;0;0;0
FR;5;2021-10-10;0;0;0;0;0;0;0;0;0;0
FR;5;2021-10-11;0;0;0;0;0;0;0;0;0;0
FR;5;2021-10-12;0;0;0;0;0;0;0;0;0;0
FR;5;2021-10-13;0;0;0;0;0;0;0;0;0;0
FR;5;2021-10-14;0;0;0;0;0;0;0;0;0;0
FR;5;2021-10-15;0;0;0;0;0;0;0;0;0;0
FR;5;2021-10-16;0;0;0;0;0;0;0;0;0;0
FR;5;2021-10-17;0;0;0;0;0;0;0;0;0;0
FR;5;2021-10-18;0;0;0;0;0;0;0;0;0;0
FR;5;2021-10-19;0;0;0;0;0;0;0;0;0;0
FR;5;2021-10-20;0;0;0;0;0;0;0;0;0;0
FR;5;2021-10-21;0;0;0;0;0;0;0;0;0;0
FR;5;2021-10-22;0;0;0;0;0;0;0;0;0;0
FR;5;2021-10-23;0;0;0;0;0;0;0;0;0;0
FR;5;2021-10-24;0;0;0;0;0;0;0;0;0;0
FR;5;2021-10-25;0;0;0;0;0;0;0;0;0;0
FR;5;2021-10-26;0;0;0;0;0;0;0;0;0;0
FR;5;2021-10-27;0;0;0;0;0;0;0;0;0;0
FR;5;2021-10-28;0;0;0;0;0;0;0;0;0;0
FR;5;2021-10-29;0;0;0;0;0;0;0;0;0;0
FR;5;2021-10-30;0;0;0;0;0;0;0;0;0;0
FR;5;2021-10-31;0;0;0;0;0;0;0;0;0;0
FR;5;2021-11-01;0;0;0;0;0;0;0;0;0;0
FR;5;2021-11-02;0;0;0;0;0;0;0;0;0;0
FR;5;2021-11-03;0;0;0;0;0;0;0;0;0;0
FR;5;2021-11-04;0;0;0;0;0;0;0;0;0;0
FR;5;2021-11-05;0;0;0;0;0;0;0;0;0;0
FR;5;2021-11-06;0;0;0;0;0;0;0;0;0;0
FR;5;2021-11-07;0;0;0;0;0;0;0;0;0;0
FR;5;2021-11-08;0;0;0;0;0;0;0;0;0;0
FR;5;2021-11-09;0;0;0;0;0;0;0;0;0;0
FR;5;2021-11-10;0;0;0;0;0;0;0;0;0;0
FR;5;2021-11-11;0;0;0;0;0;0;0;0;0;0
FR;5;2021-11-12;0;0;0;0;0;0;0;0;0;0
FR;5;2021-11-13;0;0;0;0;0;0;0;0;0;0
FR;5;2021-11-14;0;0;0;0;0;0;0;0;0;0
FR;5;2021-11-15;0;0;0;0;0;0;0;0;0;0
FR;5;2021-11-16;0;0;0;0;0;0;0;0;0;0
FR;5;2021-11-17;0;0;0;0;0;0;0;0;0;0
FR;5;2021-11-18;0;0;0;0;0;0;0;0;0;0
FR;5;2021-11-19;0;0;0;0;0;0;0;0;0;0
FR;5;2021-11-20;0;0;0;0;0;0;0;0;0;0
FR;5;2021-11-21;0;0;0;0;0;0;0;0;0;0
FR;5;2021-11-22;0;0;0;0;0;0;0;0;0;0
FR;5;2021-11-23;0;0;0;0;0;0;0;0;0;0
FR;5;2021-11-24;0;0;0;0;0;0;0;0;0;0
FR;5;2021-11-25;0;0;0;0;0;0;0;0;0;0
FR;5;2021-11-26;0;0;0;0;0;0;0;0;0;0
FR;5;2021-11-27;0;0;0;0;0;0;0;0;0;0
FR;5;2021-11-28;0;0;0;0;0;0;0;0;0;0
FR;5;2021-11-29;0;0;0;0;0;0;0;0;0;0
FR;5;2021-11-30;0;0;0;0;0;0;0;0;0;0
FR;5;2021-12-01;0;0;0;0;0;0;0;0;0;0
FR;5;2021-12-02;0;0;0;0;0;0;0;0;0;0
FR;5;2021-12-03;0;0;0;0;0;0;0;0;0;0
FR;5;2021-12-04;0;0;0;0;0;0;0;0;0;0
FR;5;2021-12-05;0;0;0;0;0;0;0;0;0;0
FR;5;2021-12-06;0;0;0;0;0;0;0;0;0;0
FR;5;2021-12-07;0;0;0;0;0;0;0;0;0;0
FR;5;2021-12-08;0;0;0;0;0;0;0;0;0;0
FR;5;2021-12-09;0;0;0;0;0;0;0;0;0;0
FR;5;2021-12-10;0;0;0;0;0;0;0;0;0;0
FR;5;2021-12-11;0;0;0;0;0;0;0;0;0;0
FR;5;2021-12-12;0;0;0;0;0;0;0;0;0;0
FR;5;2021-12-13;0;0;0;0;0;0;0;0;0;0
FR;5;2021-12-14;28;45;77;0;88;28;45;77;0;88
FR;5;2021-12-15;195;44;37;0;49;223;89;114;0;137
FR;5;2021-12-16;180;21;44;0;48;403;110;158;0;185
FR;5;2021-12-17;310;16;72;0;74;713;126;230;0;259
FR;5;2021-12-18;762;24;22;0;29;1475;150;252;0;288
FR;5;2021-12-19;586;15;15;0;17;2061;165;267;0;305
FR;5;2021-12-20;1220;31;35;0;38;3281;196;302;0;343
FR;5;2021-12-21;1534;22;54;1;60;4815;218;356;1;403
FR;5;2021-12-22;4069;40;37;0;46;8884;258;393;1;449
FR;5;2021-12-23;3040;16;21;0;25;11924;274;414;1;474
FR;5;2021-12-24;759;18;9;0;15;12683;292;423;1;489
FR;5;2021-12-25;61;5;1;0;2;12744;297;424;1;491
FR;5;2021-12-26;623;6;3;0;4;13367;303;427;1;495
FR;5;2021-12-27;4080;25;21;0;23;17447;328;448;1;518
FR;5;2021-12-28;5199;23;41;1;43;22646;351;489;2;561
FR;5;2021-12-29;8101;34;65;2;68;30747;385;554;4;629
FR;5;2021-12-30;5171;18;33;0;39;35918;403;587;4;668
FR;5;2021-12-31;1553;8;10;0;11;37471;411;597;4;679
FR;5;2022-01-01;185;1;2;0;2;37656;412;599;4;681
FR;5;2022-01-02;1489;1;1;0;1;39145;413;600;4;682
FR;5;2022-01-03;3053;36;33;0;32;42198;449;633;4;714
FR;5;2022-01-04;3034;39;33;0;42;45232;488;666;4;756
FR;5;2022-01-05;19311;203;97;1;108;64543;691;763;5;864
FR;5;2022-01-06;3739;133;122;0;142;68282;824;885;5;1006
FR;5;2022-01-07;5006;200;48;2;56;73288;1024;933;7;1062
FR;5;2022-01-08;13648;513;45;0;52;86936;1537;978;7;1114
FR;5;2022-01-09;5755;399;15;0;20;92691;1936;993;7;1134
FR;5;2022-01-10;3452;326;25;0;29;96143;2262;1018;7;1163
FR;5;2022-01-11;3667;284;38;0;41;99810;2546;1056;7;1204
FR;5;2022-01-12;22650;3003;90;0;113;122460;5549;1146;7;1317
FR;5;2022-01-13;4033;622;30;0;32;126493;6171;1176;7;1349
FR;5;2022-01-14;4842;581;43;0;50;131335;6752;1219;7;1399
FR;5;2022-01-15;14678;1746;38;3;49;146013;8498;1257;10;1448
FR;5;2022-01-16;4727;666;3;0;5;150740;9164;1260;10;1453
FR;5;2022-01-17;2294;715;26;0;29;153034;9879;1286;10;1482
FR;5;2022-01-18;2429;869;30;0;40;155463;10748;1316;10;1522
FR;5;2022-01-19;18479;6418;74;2;142;173942;17166;1390;12;1664
FR;5;2022-01-20;1919;1067;24;0;33;175861;18233;1414;12;1697
FR;5;2022-01-21;3074;1369;47;1;59;178935;19602;1461;13;1756
FR;5;2022-01-22;10721;3454;33;1;43;189656;23056;1494;14;1799
FR;5;2022-01-23;2627;1413;5;0;8;192283;24469;1499;14;1807
FR;5;2022-01-24;1157;1340;19;0;23;193440;25809;1518;14;1830
FR;5;2022-01-25;1218;1548;19;2;29;194658;27357;1537;16;1859
FR;5;2022-01-26;10744;12014;50;1;89;205402;39371;1587;17;1948
FR;5;2022-01-27;1291;1690;10;0;17;206693;41061;1597;17;1965
FR;5;2022-01-28;1695;3347;16;0;19;208388;44408;1613;17;1984
FR;5;2022-01-29;6237;8040;68;0;96;214625;52448;1681;17;2080
FR;5;2022-01-30;1509;2950;5;0;18;216134;55398;1686;17;2098
FR;5;2022-01-31;587;1772;23;0;24;216721;57170;1709;17;2122
FR;5;2022-02-01;709;1702;10;0;15;217430;58872;1719;17;2137
FR;5;2022-02-02;6952;15653;52;0;94;224382;74525;1771;17;2231
FR;5;2022-02-03;486;1688;13;0;11;224868;76213;1784;17;2242
FR;5;2022-02-04;937;3001;19;0;31;225805;79214;1803;17;2273
FR;5;2022-02-05;3531;8914;23;0;37;229336;88128;1826;17;2310
FR;5;2022-02-06;736;2397;10;0;19;230072;90525;1836;17;2329
FR;5;2022-02-07;882;1595;22;0;24;230954;92120;1858;17;2353
FR;5;2022-02-08;719;1283;18;0;19;231673;93403;1876;17;2372
FR;5;2022-02-09;4533;12874;44;0;76;236206;106277;1920;17;2448
FR;5;2022-02-10;645;1058;13;0;14;236851;107335;1933;17;2462
FR;5;2022-02-11;793;2026;16;0;21;237644;109361;1949;17;2483
FR;5;2022-02-12;2285;6810;32;0;52;239929;116171;1981;17;2535
FR;5;2022-02-13;465;1539;8;0;8;240394;117710;1989;17;2543
FR;5;2022-02-14;678;1288;10;0;13;241072;118998;1999;17;2556
FR;5;2022-02-15;482;883;9;0;14;241554;119881;2008;17;2570
FR;5;2022-02-16;2977;9122;41;1;58;244531;129003;2049;18;2628
FR;5;2022-02-17;435;803;6;0;7;244966;129806;2055;18;2635
FR;5;2022-02-18;648;1407;13;0;17;245614;131213;2068;18;2652
FR;5;2022-02-19;1370;4314;16;0;28;246984;135527;2084;18;2680
FR;5;2022-02-20;247;879;6;0;8;247231;136406;2090;18;2688
FR;5;2022-02-21;220;605;2;0;4;247451;137011;2092;18;2692
FR;5;2022-02-22;259;544;17;0;17;247710;137555;2109;18;2709
FR;5;2022-02-23;1907;6920;22;1;42;249617;144475;2131;19;2751
FR;5;2022-02-24;181;371;5;1;5;249798;144846;2136;20;2756
FR;5;2022-02-25;333;949;13;0;12;250131;145795;2149;20;2768
FR;5;2022-02-26;970;3065;10;0;14;251101;148860;2159;20;2782
FR;5;2022-02-27;146;506;0;0;3;251247;149366;2159;20;2785
FR;5;2022-02-28;160;369;1;0;1;251407;149735;2160;20;2786
FR;5;2022-03-01;123;278;6;0;7;251530;150013;2166;20;2793
FR;5;2022-03-02;1236;4146;28;3;40;252766;154159;2194;23;2833
FR;5;2022-03-03;117;249;6;0;9;252883;154408;2200;23;2842
FR;5;2022-03-04;192;482;13;0;13;253075;154890;2213;23;2855
FR;5;2022-03-05;675;1990;8;0;16;253750;156880;2221;23;2871
FR;5;2022-03-06;107;260;0;0;0;253857;157140;2221;23;2871
FR;5;2022-03-07;70;228;4;0;3;253927;157368;2225;23;2874
FR;5;2022-03-08;46;128;7;1;7;253973;157496;2232;24;2881
FR;5;2022-03-09;905;3075;23;0;35;254878;160571;2255;24;2916
FR;5;2022-03-10;81;200;7;0;10;254959;160771;2262;24;2926
FR;5;2022-03-11;145;368;14;1;15;255104;161139;2276;25;2941
FR;5;2022-03-12;758;1613;12;1;29;255862;162752;2288;26;2970
FR;5;2022-03-13;76;99;0;0;0;255938;162851;2288;26;2970
FR;5;2022-03-14;67;116;7;1;7;256005;162967;2295;27;2977
FR;5;2022-03-15;81;99;3;0;6;256086;163066;2298;27;2983
FR;5;2022-03-16;880;1822;15;3;34;256966;164888;2313;30;3017
FR;5;2022-03-17;66;122;8;4;10;257032;165010;2321;34;3027
FR;5;2022-03-18;170;318;13;3;18;257202;165328;2334;37;3045
FR;5;2022-03-19;748;1160;12;5;32;257950;166488;2346;42;3077
FR;5;2022-03-20;44;92;1;0;1;257994;166580;2347;42;3078
FR;5;2022-03-21;71;115;10;6;15;258065;166695;2357;48;3093
FR;5;2022-03-22;55;114;8;6;8;258120;166809;2365;54;3101
FR;5;2022-03-23;800;1459;13;8;35;258920;168268;2378;62;3136
FR;5;2022-03-24;67;89;8;7;7;258987;168357;2386;69;3143
FR;5;2022-03-25;220;287;14;8;17;259207;168644;2400;77;3160
FR;5;2022-03-26;703;848;12;6;26;259910;169492;2412;83;3186
FR;5;2022-03-27;74;78;0;0;3;259984;169570;2412;83;3189
FR;5;2022-03-28;80;91;1;2;3;260064;169661;2413;85;3192
FR;5;2022-03-29;67;82;10;4;12;260131;169743;2423;89;3204
FR;5;2022-03-30;815;1107;13;13;28;260946;170850;2436;102;3232
FR;5;2022-03-31;93;117;1;4;5;261039;170967;2437;106;3237
FR;6;2020-12-27;0;0;0;0;0;0;0;0;0;0
FR;6;2020-12-28;0;0;0;0;0;0;0;0;0;0
FR;6;2020-12-29;0;0;0;0;0;0;0;0;0;0
FR;6;2020-12-30;0;0;0;0;0;0;0;0;0;0
FR;6;2020-12-31;0;0;0;0;0;0;0;0;0;0
FR;6;2021-01-01;0;0;0;0;0;0;0;0;0;0
FR;6;2021-01-02;0;0;0;0;0;0;0;0;0;0
FR;6;2021-01-03;0;0;0;0;0;0;0;0;0;0
FR;6;2021-01-04;0;0;0;0;0;0;0;0;0;0
FR;6;2021-01-05;0;0;0;0;0;0;0;0;0;0
FR;6;2021-01-06;0;0;0;0;0;0;0;0;0;0
FR;6;2021-01-07;0;0;0;0;0;0;0;0;0;0
FR;6;2021-01-08;0;0;0;0;0;0;0;0;0;0
FR;6;2021-01-09;0;0;0;0;0;0;0;0;0;0
FR;6;2021-01-10;0;0;0;0;0;0;0;0;0;0
FR;6;2021-01-11;0;0;0;0;0;0;0;0;0;0
FR;6;2021-01-12;0;0;0;0;0;0;0;0;0;0
FR;6;2021-01-13;0;0;0;0;0;0;0;0;0;0
FR;6;2021-01-14;0;0;0;0;0;0;0;0;0;0
FR;6;2021-01-15;0;0;0;0;0;0;0;0;0;0
FR;6;2021-01-16;0;0;0;0;0;0;0;0;0;0
FR;6;2021-01-17;0;0;0;0;0;0;0;0;0;0
FR;6;2021-01-18;0;0;0;0;0;0;0;0;0;0
FR;6;2021-01-19;0;0;0;0;0;0;0;0;0;0
FR;6;2021-01-20;0;0;0;0;0;0;0;0;0;0
FR;6;2021-01-21;0;0;0;0;0;0;0;0;0;0
FR;6;2021-01-22;0;0;0;0;0;0;0;0;0;0
FR;6;2021-01-23;0;0;0;0;0;0;0;0;0;0
FR;6;2021-01-24;0;0;0;0;0;0;0;0;0;0
FR;6;2021-01-25;0;0;0;0;0;0;0;0;0;0
FR;6;2021-01-26;0;0;0;0;0;0;0;0;0;0
FR;6;2021-01-27;0;0;0;0;0;0;0;0;0;0
FR;6;2021-01-28;0;0;0;0;0;0;0;0;0;0
FR;6;2021-01-29;0;0;0;0;0;0;0;0;0;0
FR;6;2021-01-30;0;0;0;0;0;0;0;0;0;0
FR;6;2021-01-31;0;0;0;0;0;0;0;0;0;0
FR;6;2021-02-01;0;0;0;0;0;0;0;0;0;0
FR;6;2021-02-02;0;0;0;0;0;0;0;0;0;0
FR;6;2021-02-03;0;0;0;0;0;0;0;0;0;0
FR;6;2021-02-04;0;0;0;0;0;0;0;0;0;0
FR;6;2021-02-05;0;0;0;0;0;0;0;0;0;0
FR;6;2021-02-06;0;0;0;0;0;0;0;0;0;0
FR;6;2021-02-07;0;0;0;0;0;0;0;0;0;0
FR;6;2021-02-08;0;0;0;0;0;0;0;0;0;0
FR;6;2021-02-09;0;0;0;0;0;0;0;0;0;0
FR;6;2021-02-10;0;0;0;0;0;0;0;0;0;0
FR;6;2021-02-11;0;0;0;0;0;0;0;0;0;0
FR;6;2021-02-12;0;0;0;0;0;0;0;0;0;0
FR;6;2021-02-13;0;0;0;0;0;0;0;0;0;0
FR;6;2021-02-14;0;0;0;0;0;0;0;0;0;0
FR;6;2021-02-15;0;0;0;0;0;0;0;0;0;0
FR;6;2021-02-16;0;0;0;0;0;0;0;0;0;0
FR;6;2021-02-17;0;0;0;0;0;0;0;0;0;0
FR;6;2021-02-18;0;0;0;0;0;0;0;0;0;0
FR;6;2021-02-19;0;0;0;0;0;0;0;0;0;0
FR;6;2021-02-20;0;0;0;0;0;0;0;0;0;0
FR;6;2021-02-21;0;0;0;0;0;0;0;0;0;0
FR;6;2021-02-22;0;0;0;0;0;0;0;0;0;0
FR;6;2021-02-23;0;0;0;0;0;0;0;0;0;0
FR;6;2021-02-24;0;0;0;0;0;0;0;0;0;0
FR;6;2021-02-25;0;0;0;0;0;0;0;0;0;0
FR;6;2021-02-26;0;0;0;0;0;0;0;0;0;0
FR;6;2021-02-27;0;0;0;0;0;0;0;0;0;0
FR;6;2021-02-28;0;0;0;0;0;0;0;0;0;0
FR;6;2021-03-01;0;0;0;0;0;0;0;0;0;0
FR;6;2021-03-02;0;0;0;0;0;0;0;0;0;0
FR;6;2021-03-03;0;0;0;0;0;0;0;0;0;0
FR;6;2021-03-04;0;0;0;0;0;0;0;0;0;0
FR;6;2021-03-05;0;0;0;0;0;0;0;0;0;0
FR;6;2021-03-06;0;0;0;0;0;0;0;0;0;0
FR;6;2021-03-07;0;0;0;0;0;0;0;0;0;0
FR;6;2021-03-08;0;0;0;0;0;0;0;0;0;0
FR;6;2021-03-09;0;0;0;0;0;0;0;0;0;0
FR;6;2021-03-10;0;0;0;0;0;0;0;0;0;0
FR;6;2021-03-11;0;0;0;0;0;0;0;0;0;0
FR;6;2021-03-12;0;0;0;0;0;0;0;0;0;0
FR;6;2021-03-13;0;0;0;0;0;0;0;0;0;0
FR;6;2021-03-14;0;0;0;0;0;0;0;0;0;0
FR;6;2021-03-15;0;0;0;0;0;0;0;0;0;0
FR;6;2021-03-16;0;0;0;0;0;0;0;0;0;0
FR;6;2021-03-17;0;0;0;0;0;0;0;0;0;0
FR;6;2021-03-18;0;0;0;0;0;0;0;0;0;0
FR;6;2021-03-19;0;0;0;0;0;0;0;0;0;0
FR;6;2021-03-20;0;0;0;0;0;0;0;0;0;0
FR;6;2021-03-21;0;0;0;0;0;0;0;0;0;0
FR;6;2021-03-22;0;0;0;0;0;0;0;0;0;0
FR;6;2021-03-23;0;0;0;0;0;0;0;0;0;0
FR;6;2021-03-24;0;0;0;0;0;0;0;0;0;0
FR;6;2021-03-25;0;0;0;0;0;0;0;0;0;0
FR;6;2021-03-26;0;0;0;0;0;0;0;0;0;0
FR;6;2021-03-27;0;0;0;0;0;0;0;0;0;0
FR;6;2021-03-28;0;0;0;0;0;0;0;0;0;0
FR;6;2021-03-29;0;0;0;0;0;0;0;0;0;0
FR;6;2021-03-30;0;0;0;0;0;0;0;0;0;0
FR;6;2021-03-31;0;0;0;0;0;0;0;0;0;0
FR;6;2021-04-01;0;0;0;0;0;0;0;0;0;0
FR;6;2021-04-02;0;0;0;0;0;0;0;0;0;0
FR;6;2021-04-03;0;0;0;0;0;0;0;0;0;0
FR;6;2021-04-04;0;0;0;0;0;0;0;0;0;0
FR;6;2021-04-05;0;0;0;0;0;0;0;0;0;0
FR;6;2021-04-06;0;0;0;0;0;0;0;0;0;0
FR;6;2021-04-07;0;0;0;0;0;0;0;0;0;0
FR;6;2021-04-08;0;0;0;0;0;0;0;0;0;0
FR;6;2021-04-09;0;0;0;0;0;0;0;0;0;0
FR;6;2021-04-10;0;0;0;0;0;0;0;0;0;0
FR;6;2021-04-11;0;0;0;0;0;0;0;0;0;0
FR;6;2021-04-12;0;0;0;0;0;0;0;0;0;0
FR;6;2021-04-13;0;0;0;0;0;0;0;0;0;0
FR;6;2021-04-14;0;0;0;0;0;0;0;0;0;0
FR;6;2021-04-15;0;0;0;0;0;0;0;0;0;0
FR;6;2021-04-16;0;0;0;0;0;0;0;0;0;0
FR;6;2021-04-17;0;0;0;0;0;0;0;0;0;0
FR;6;2021-04-18;0;0;0;0;0;0;0;0;0;0
FR;6;2021-04-19;0;0;0;0;0;0;0;0;0;0
FR;6;2021-04-20;0;0;0;0;0;0;0;0;0;0
FR;6;2021-04-21;0;0;0;0;0;0;0;0;0;0
FR;6;2021-04-22;0;0;0;0;0;0;0;0;0;0
FR;6;2021-04-23;0;0;0;0;0;0;0;0;0;0
FR;6;2021-04-24;0;0;0;0;0;0;0;0;0;0
FR;6;2021-04-25;0;0;0;0;0;0;0;0;0;0
FR;6;2021-04-26;0;0;0;0;0;0;0;0;0;0
FR;6;2021-04-27;0;0;0;0;0;0;0;0;0;0
FR;6;2021-04-28;0;0;0;0;0;0;0;0;0;0
FR;6;2021-04-29;0;0;0;0;0;0;0;0;0;0
FR;6;2021-04-30;0;0;0;0;0;0;0;0;0;0
FR;6;2021-05-01;0;0;0;0;0;0;0;0;0;0
FR;6;2021-05-02;0;0;0;0;0;0;0;0;0;0
FR;6;2021-05-03;0;0;0;0;0;0;0;0;0;0
FR;6;2021-05-04;0;0;0;0;0;0;0;0;0;0
FR;6;2021-05-05;0;0;0;0;0;0;0;0;0;0
FR;6;2021-05-06;0;0;0;0;0;0;0;0;0;0
FR;6;2021-05-07;0;0;0;0;0;0;0;0;0;0
FR;6;2021-05-08;0;0;0;0;0;0;0;0;0;0
FR;6;2021-05-09;0;0;0;0;0;0;0;0;0;0
FR;6;2021-05-10;0;0;0;0;0;0;0;0;0;0
FR;6;2021-05-11;0;0;0;0;0;0;0;0;0;0
FR;6;2021-05-12;0;0;0;0;0;0;0;0;0;0
FR;6;2021-05-13;0;0;0;0;0;0;0;0;0;0
FR;6;2021-05-14;0;0;0;0;0;0;0;0;0;0
FR;6;2021-05-15;0;0;0;0;0;0;0;0;0;0
FR;6;2021-05-16;0;0;0;0;0;0;0;0;0;0
FR;6;2021-05-17;0;0;0;0;0;0;0;0;0;0
FR;6;2021-05-18;0;0;0;0;0;0;0;0;0;0
FR;6;2021-05-19;0;0;0;0;0;0;0;0;0;0
FR;6;2021-05-20;0;0;0;0;0;0;0;0;0;0
FR;6;2021-05-21;0;0;0;0;0;0;0;0;0;0
FR;6;2021-05-22;0;0;0;0;0;0;0;0;0;0
FR;6;2021-05-23;0;0;0;0;0;0;0;0;0;0
FR;6;2021-05-24;0;0;0;0;0;0;0;0;0;0
FR;6;2021-05-25;0;0;0;0;0;0;0;0;0;0
FR;6;2021-05-26;0;0;0;0;0;0;0;0;0;0
FR;6;2021-05-27;0;0;0;0;0;0;0;0;0;0
FR;6;2021-05-28;0;0;0;0;0;0;0;0;0;0
FR;6;2021-05-29;0;0;0;0;0;0;0;0;0;0
FR;6;2021-05-30;0;0;0;0;0;0;0;0;0;0
FR;6;2021-05-31;0;0;0;0;0;0;0;0;0;0
FR;6;2021-06-01;0;0;0;0;0;0;0;0;0;0
FR;6;2021-06-02;0;0;0;0;0;0;0;0;0;0
FR;6;2021-06-03;0;0;0;0;0;0;0;0;0;0
FR;6;2021-06-04;0;0;0;0;0;0;0;0;0;0
FR;6;2021-06-05;0;0;0;0;0;0;0;0;0;0
FR;6;2021-06-06;0;0;0;0;0;0;0;0;0;0
FR;6;2021-06-07;0;0;0;0;0;0;0;0;0;0
FR;6;2021-06-08;0;0;0;0;0;0;0;0;0;0
FR;6;2021-06-09;0;0;0;0;0;0;0;0;0;0
FR;6;2021-06-10;0;0;0;0;0;0;0;0;0;0
FR;6;2021-06-11;0;0;0;0;0;0;0;0;0;0
FR;6;2021-06-12;0;0;0;0;0;0;0;0;0;0
FR;6;2021-06-13;0;0;0;0;0;0;0;0;0;0
FR;6;2021-06-14;0;0;0;0;0;0;0;0;0;0
FR;6;2021-06-15;0;0;0;0;0;0;0;0;0;0
FR;6;2021-06-16;0;0;0;0;0;0;0;0;0;0
FR;6;2021-06-17;0;0;0;0;0;0;0;0;0;0
FR;6;2021-06-18;0;0;0;0;0;0;0;0;0;0
FR;6;2021-06-19;0;0;0;0;0;0;0;0;0;0
FR;6;2021-06-20;0;0;0;0;0;0;0;0;0;0
FR;6;2021-06-21;0;0;0;0;0;0;0;0;0;0
FR;6;2021-06-22;0;0;0;0;0;0;0;0;0;0
FR;6;2021-06-23;0;0;0;0;0;0;0;0;0;0
FR;6;2021-06-24;0;0;0;0;0;0;0;0;0;0
FR;6;2021-06-25;0;0;0;0;0;0;0;0;0;0
FR;6;2021-06-26;0;0;0;0;0;0;0;0;0;0
FR;6;2021-06-27;0;0;0;0;0;0;0;0;0;0
FR;6;2021-06-28;0;0;0;0;0;0;0;0;0;0
FR;6;2021-06-29;0;0;0;0;0;0;0;0;0;0
FR;6;2021-06-30;0;0;0;0;0;0;0;0;0;0
FR;6;2021-07-01;0;0;0;0;0;0;0;0;0;0
FR;6;2021-07-02;0;0;0;0;0;0;0;0;0;0
FR;6;2021-07-03;0;0;0;0;0;0;0;0;0;0
FR;6;2021-07-04;0;0;0;0;0;0;0;0;0;0
FR;6;2021-07-05;0;0;0;0;0;0;0;0;0;0
FR;6;2021-07-06;0;0;0;0;0;0;0;0;0;0
FR;6;2021-07-07;0;0;0;0;0;0;0;0;0;0
FR;6;2021-07-08;0;0;0;0;0;0;0;0;0;0
FR;6;2021-07-09;0;0;0;0;0;0;0;0;0;0
FR;6;2021-07-10;0;0;0;0;0;0;0;0;0;0
FR;6;2021-07-11;0;0;0;0;0;0;0;0;0;0
FR;6;2021-07-12;0;0;0;0;0;0;0;0;0;0
FR;6;2021-07-13;0;0;0;0;0;0;0;0;0;0
FR;6;2021-07-14;0;0;0;0;0;0;0;0;0;0
FR;6;2021-07-15;0;0;0;0;0;0;0;0;0;0
FR;6;2021-07-16;0;0;0;0;0;0;0;0;0;0
FR;6;2021-07-17;0;0;0;0;0;0;0;0;0;0
FR;6;2021-07-18;0;0;0;0;0;0;0;0;0;0
FR;6;2021-07-19;0;0;0;0;0;0;0;0;0;0
FR;6;2021-07-20;0;0;0;0;0;0;0;0;0;0
FR;6;2021-07-21;0;0;0;0;0;0;0;0;0;0
FR;6;2021-07-22;0;0;0;0;0;0;0;0;0;0
FR;6;2021-07-23;0;0;0;0;0;0;0;0;0;0
FR;6;2021-07-24;0;0;0;0;0;0;0;0;0;0
FR;6;2021-07-25;0;0;0;0;0;0;0;0;0;0
FR;6;2021-07-26;0;0;0;0;0;0;0;0;0;0
FR;6;2021-07-27;0;0;0;0;0;0;0;0;0;0
FR;6;2021-07-28;0;0;0;0;0;0;0;0;0;0
FR;6;2021-07-29;0;0;0;0;0;0;0;0;0;0
FR;6;2021-07-30;0;0;0;0;0;0;0;0;0;0
FR;6;2021-07-31;0;0;0;0;0;0;0;0;0;0
FR;6;2021-08-01;0;0;0;0;0;0;0;0;0;0
FR;6;2021-08-02;0;0;0;0;0;0;0;0;0;0
FR;6;2021-08-03;0;0;0;0;0;0;0;0;0;0
FR;6;2021-08-04;0;0;0;0;0;0;0;0;0;0
FR;6;2021-08-05;0;0;0;0;0;0;0;0;0;0
FR;6;2021-08-06;0;0;0;0;0;0;0;0;0;0
FR;6;2021-08-07;0;0;0;0;0;0;0;0;0;0
FR;6;2021-08-08;0;0;0;0;0;0;0;0;0;0
FR;6;2021-08-09;0;0;0;0;0;0;0;0;0;0
FR;6;2021-08-10;0;0;0;0;0;0;0;0;0;0
FR;6;2021-08-11;0;0;0;0;0;0;0;0;0;0
FR;6;2021-08-12;0;0;0;0;0;0;0;0;0;0
FR;6;2021-08-13;0;0;0;0;0;0;0;0;0;0
FR;6;2021-08-14;0;0;0;0;0;0;0;0;0;0
FR;6;2021-08-15;0;0;0;0;0;0;0;0;0;0
FR;6;2021-08-16;0;0;0;0;0;0;0;0;0;0
FR;6;2021-08-17;0;0;0;0;0;0;0;0;0;0
FR;6;2021-08-18;0;0;0;0;0;0;0;0;0;0
FR;6;2021-08-19;0;0;0;0;0;0;0;0;0;0
FR;6;2021-08-20;0;0;0;0;0;0;0;0;0;0
FR;6;2021-08-21;0;0;0;0;0;0;0;0;0;0
FR;6;2021-08-22;0;0;0;0;0;0;0;0;0;0
FR;6;2021-08-23;0;0;0;0;0;0;0;0;0;0
FR;6;2021-08-24;0;0;0;0;0;0;0;0;0;0
FR;6;2021-08-25;0;0;0;0;0;0;0;0;0;0
FR;6;2021-08-26;0;0;0;0;0;0;0;0;0;0
FR;6;2021-08-27;0;0;0;0;0;0;0;0;0;0
FR;6;2021-08-28;0;0;0;0;0;0;0;0;0;0
FR;6;2021-08-29;0;0;0;0;0;0;0;0;0;0
FR;6;2021-08-30;0;0;0;0;0;0;0;0;0;0
FR;6;2021-08-31;0;0;0;0;0;0;0;0;0;0
FR;6;2021-09-01;0;0;0;0;0;0;0;0;0;0
FR;6;2021-09-02;0;0;0;0;0;0;0;0;0;0
FR;6;2021-09-03;0;0;0;0;0;0;0;0;0;0
FR;6;2021-09-04;0;0;0;0;0;0;0;0;0;0
FR;6;2021-09-05;0;0;0;0;0;0;0;0;0;0
FR;6;2021-09-06;0;0;0;0;0;0;0;0;0;0
FR;6;2021-09-07;0;0;0;0;0;0;0;0;0;0
FR;6;2021-09-08;0;0;0;0;0;0;0;0;0;0
FR;6;2021-09-09;0;0;0;0;0;0;0;0;0;0
FR;6;2021-09-10;0;0;0;0;0;0;0;0;0;0
FR;6;2021-09-11;0;0;0;0;0;0;0;0;0;0
FR;6;2021-09-12;0;0;0;0;0;0;0;0;0;0
FR;6;2021-09-13;0;0;0;0;0;0;0;0;0;0
FR;6;2021-09-14;0;0;0;0;0;0;0;0;0;0
FR;6;2021-09-15;0;0;0;0;0;0;0;0;0;0
FR;6;2021-09-16;0;0;0;0;0;0;0;0;0;0
FR;6;2021-09-17;0;0;0;0;0;0;0;0;0;0
FR;6;2021-09-18;0;0;0;0;0;0;0;0;0;0
FR;6;2021-09-19;0;0;0;0;0;0;0;0;0;0
FR;6;2021-09-20;0;0;0;0;0;0;0;0;0;0
FR;6;2021-09-21;0;0;0;0;0;0;0;0;0;0
FR;6;2021-09-22;0;0;0;0;0;0;0;0;0;0
FR;6;2021-09-23;0;0;0;0;0;0;0;0;0;0
FR;6;2021-09-24;0;0;0;0;0;0;0;0;0;0
FR;6;2021-09-25;0;0;0;0;0;0;0;0;0;0
FR;6;2021-09-26;0;0;0;0;0;0;0;0;0;0
FR;6;2021-09-27;0;0;0;0;0;0;0;0;0;0
FR;6;2021-09-28;0;0;0;0;0;0;0;0;0;0
FR;6;2021-09-29;0;0;0;0;0;0;0;0;0;0
FR;6;2021-09-30;0;0;0;0;0;0;0;0;0;0
FR;6;2021-10-01;0;0;0;0;0;0;0;0;0;0
FR;6;2021-10-02;0;0;0;0;0;0;0;0;0;0
FR;6;2021-10-03;0;0;0;0;0;0;0;0;0;0
FR;6;2021-10-04;0;0;0;0;0;0;0;0;0;0
FR;6;2021-10-05;0;0;0;0;0;0;0;0;0;0
FR;6;2021-10-06;0;0;0;0;0;0;0;0;0;0
FR;6;2021-10-07;0;0;0;0;0;0;0;0;0;0
FR;6;2021-10-08;0;0;0;0;0;0;0;0;0;0
FR;6;2021-10-09;0;0;0;0;0;0;0;0;0;0
FR;6;2021-10-10;0;0;0;0;0;0;0;0;0;0
FR;6;2021-10-11;0;0;0;0;0;0;0;0;0;0
FR;6;2021-10-12;0;0;0;0;0;0;0;0;0;0
FR;6;2021-10-13;0;0;0;0;0;0;0;0;0;0
FR;6;2021-10-14;0;0;0;0;0;0;0;0;0;0
FR;6;2021-10-15;0;0;0;0;0;0;0;0;0;0
FR;6;2021-10-16;0;0;0;0;0;0;0;0;0;0
FR;6;2021-10-17;0;0;0;0;0;0;0;0;0;0
FR;6;2021-10-18;0;0;0;0;0;0;0;0;0;0
FR;6;2021-10-19;0;0;0;0;0;0;0;0;0;0
FR;6;2021-10-20;0;0;0;0;0;0;0;0;0;0
FR;6;2021-10-21;0;0;0;0;0;0;0;0;0;0
FR;6;2021-10-22;0;0;0;0;0;0;0;0;0;0
FR;6;2021-10-23;0;0;0;0;0;0;0;0;0;0
FR;6;2021-10-24;0;0;0;0;0;0;0;0;0;0
FR;6;2021-10-25;0;0;0;0;0;0;0;0;0;0
FR;6;2021-10-26;0;0;0;0;0;0;0;0;0;0
FR;6;2021-10-27;0;0;0;0;0;0;0;0;0;0
FR;6;2021-10-28;0;0;0;0;0;0;0;0;0;0
FR;6;2021-10-29;0;0;0;0;0;0;0;0;0;0
FR;6;2021-10-30;0;0;0;0;0;0;0;0;0;0
FR;6;2021-10-31;0;0;0;0;0;0;0;0;0;0
FR;6;2021-11-01;0;0;0;0;0;0;0;0;0;0
FR;6;2021-11-02;0;0;0;0;0;0;0;0;0;0
FR;6;2021-11-03;0;0;0;0;0;0;0;0;0;0
FR;6;2021-11-04;0;0;0;0;0;0;0;0;0;0
FR;6;2021-11-05;0;0;0;0;0;0;0;0;0;0
FR;6;2021-11-06;0;0;0;0;0;0;0;0;0;0
FR;6;2021-11-07;0;0;0;0;0;0;0;0;0;0
FR;6;2021-11-08;0;0;0;0;0;0;0;0;0;0
FR;6;2021-11-09;0;0;0;0;0;0;0;0;0;0
FR;6;2021-11-10;0;0;0;0;0;0;0;0;0;0
FR;6;2021-11-11;0;0;0;0;0;0;0;0;0;0
FR;6;2021-11-12;0;0;0;0;0;0;0;0;0;0
FR;6;2021-11-13;0;0;0;0;0;0;0;0;0;0
FR;6;2021-11-14;0;0;0;0;0;0;0;0;0;0
FR;6;2021-11-15;0;0;0;0;0;0;0;0;0;0
FR;6;2021-11-16;0;0;0;0;0;0;0;0;0;0
FR;6;2021-11-17;0;0;0;0;0;0;0;0;0;0
FR;6;2021-11-18;0;0;0;0;0;0;0;0;0;0
FR;6;2021-11-19;0;0;0;0;0;0;0;0;0;0
FR;6;2021-11-20;0;0;0;0;0;0;0;0;0;0
FR;6;2021-11-21;0;0;0;0;0;0;0;0;0;0
FR;6;2021-11-22;0;0;0;0;0;0;0;0;0;0
FR;6;2021-11-23;0;0;0;0;0;0;0;0;0;0
FR;6;2021-11-24;0;0;0;0;0;0;0;0;0;0
FR;6;2021-11-25;0;0;0;0;0;0;0;0;0;0
FR;6;2021-11-26;0;0;0;0;0;0;0;0;0;0
FR;6;2021-11-27;0;0;0;0;0;0;0;0;0;0
FR;6;2021-11-28;0;0;0;0;0;0;0;0;0;0
FR;6;2021-11-29;0;0;0;0;0;0;0;0;0;0
FR;6;2021-11-30;0;0;0;0;0;0;0;0;0;0
FR;6;2021-12-01;0;0;0;0;0;0;0;0;0;0
FR;6;2021-12-02;0;0;0;0;0;0;0;0;0;0
FR;6;2021-12-03;0;0;0;0;0;0;0;0;0;0
FR;6;2021-12-04;0;0;0;0;0;0;0;0;0;0
FR;6;2021-12-05;0;0;0;0;0;0;0;0;0;0
FR;6;2021-12-06;0;0;0;0;0;0;0;0;0;0
FR;6;2021-12-07;0;0;0;0;0;0;0;0;0;0
FR;6;2021-12-08;0;0;0;0;0;0;0;0;0;0
FR;6;2021-12-09;0;0;0;0;0;0;0;0;0;0
FR;6;2021-12-10;0;0;0;0;0;0;0;0;0;0
FR;6;2021-12-11;0;0;0;0;0;0;0;0;0;0
FR;6;2021-12-12;0;0;0;0;0;0;0;0;0;0
FR;6;2021-12-13;0;0;0;0;0;0;0;0;0;0
FR;6;2021-12-14;0;0;0;0;0;0;0;0;0;0
FR;6;2021-12-15;0;0;0;0;0;0;0;0;0;0
FR;6;2021-12-16;0;0;0;0;0;0;0;0;0;0
FR;6;2021-12-17;0;0;0;0;0;0;0;0;0;0
FR;6;2021-12-18;0;0;0;0;0;0;0;0;0;0
FR;6;2021-12-19;0;0;0;0;0;0;0;0;0;0
FR;6;2021-12-20;0;0;0;0;0;0;0;0;0;0
FR;6;2021-12-21;0;0;0;0;0;0;0;0;0;0
FR;6;2021-12-22;0;0;0;0;0;0;0;0;0;0
FR;6;2021-12-23;0;0;0;0;0;0;0;0;0;0
FR;6;2021-12-24;0;0;0;0;0;0;0;0;0;0
FR;6;2021-12-25;0;0;0;0;0;0;0;0;0;0
FR;6;2021-12-26;0;0;0;0;0;0;0;0;0;0
FR;6;2021-12-27;0;0;0;0;0;0;0;0;0;0
FR;6;2021-12-28;0;0;0;0;0;0;0;0;0;0
FR;6;2021-12-29;0;0;0;0;0;0;0;0;0;0
FR;6;2021-12-30;0;0;0;0;0;0;0;0;0;0
FR;6;2021-12-31;0;0;0;0;0;0;0;0;0;0
FR;6;2022-01-01;0;0;0;0;0;0;0;0;0;0
FR;6;2022-01-02;0;0;0;0;0;0;0;0;0;0
FR;6;2022-01-03;0;0;0;0;0;0;0;0;0;0
FR;6;2022-01-04;0;0;0;0;0;0;0;0;0;0
FR;6;2022-01-05;0;0;0;0;0;0;0;0;0;0
FR;6;2022-01-06;0;0;0;0;0;0;0;0;0;0
FR;6;2022-01-07;0;0;0;0;0;0;0;0;0;0
FR;6;2022-01-08;0;0;0;0;0;0;0;0;0;0
FR;6;2022-01-09;0;0;0;0;0;0;0;0;0;0
FR;6;2022-01-10;0;0;0;0;0;0;0;0;0;0
FR;6;2022-01-11;0;0;0;0;0;0;0;0;0;0
FR;6;2022-01-12;0;0;0;0;0;0;0;0;0;0
FR;6;2022-01-13;0;0;0;0;0;0;0;0;0;0
FR;6;2022-01-14;0;0;0;0;0;0;0;0;0;0
FR;6;2022-01-15;0;0;0;0;0;0;0;0;0;0
FR;6;2022-01-16;0;0;0;0;0;0;0;0;0;0
FR;6;2022-01-17;0;0;0;0;0;0;0;0;0;0
FR;6;2022-01-18;0;0;0;0;0;0;0;0;0;0
FR;6;2022-01-19;0;0;0;0;0;0;0;0;0;0
FR;6;2022-01-20;0;0;0;0;0;0;0;0;0;0
FR;6;2022-01-21;0;0;0;0;0;0;0;0;0;0
FR;6;2022-01-22;0;0;0;0;0;0;0;0;0;0
FR;6;2022-01-23;0;0;0;0;0;0;0;0;0;0
FR;6;2022-01-24;0;0;0;0;0;0;0;0;0;0
FR;6;2022-01-25;0;0;0;0;0;0;0;0;0;0
FR;6;2022-01-26;0;0;0;0;0;0;0;0;0;0
FR;6;2022-01-27;0;0;0;0;0;0;0;0;0;0
FR;6;2022-01-28;0;0;0;0;0;0;0;0;0;0
FR;6;2022-01-29;0;0;0;0;0;0;0;0;0;0
FR;6;2022-01-30;0;0;0;0;0;0;0;0;0;0
FR;6;2022-01-31;0;0;0;0;0;0;0;0;0;0
FR;6;2022-02-01;0;0;0;0;0;0;0;0;0;0
FR;6;2022-02-02;0;0;0;0;0;0;0;0;0;0
FR;6;2022-02-03;0;0;0;0;0;0;0;0;0;0
FR;6;2022-02-04;0;0;0;0;0;0;0;0;0;0
FR;6;2022-02-05;0;0;0;0;0;0;0;0;0;0
FR;6;2022-02-06;0;0;0;0;0;0;0;0;0;0
FR;6;2022-02-07;0;0;0;0;0;0;0;0;0;0
FR;6;2022-02-08;0;0;0;0;0;0;0;0;0;0
FR;6;2022-02-09;0;0;0;0;0;0;0;0;0;0
FR;6;2022-02-10;0;0;0;0;0;0;0;0;0;0
FR;6;2022-02-11;0;0;0;0;0;0;0;0;0;0
FR;6;2022-02-12;0;0;0;0;0;0;0;0;0;0
FR;6;2022-02-13;0;0;0;0;0;0;0;0;0;0
FR;6;2022-02-14;0;0;0;0;0;0;0;0;0;0
FR;6;2022-02-15;0;0;0;0;0;0;0;0;0;0
FR;6;2022-02-16;0;0;0;0;0;0;0;0;0;0
FR;6;2022-02-17;0;0;0;0;0;0;0;0;0;0
FR;6;2022-02-18;0;0;0;0;0;0;0;0;0;0
FR;6;2022-02-19;0;0;0;0;0;0;0;0;0;0
FR;6;2022-02-20;0;0;0;0;0;0;0;0;0;0
FR;6;2022-02-21;0;0;0;0;0;0;0;0;0;0
FR;6;2022-02-22;0;0;0;0;0;0;0;0;0;0
FR;6;2022-02-23;0;0;0;0;0;0;0;0;0;0
FR;6;2022-02-24;0;0;0;0;0;0;0;0;0;0
FR;6;2022-02-25;0;0;0;0;0;0;0;0;0;0
FR;6;2022-02-26;0;0;0;0;0;0;0;0;0;0
FR;6;2022-02-27;0;0;0;0;0;0;0;0;0;0
FR;6;2022-02-28;0;0;0;0;0;0;0;0;0;0
FR;6;2022-03-01;0;0;0;0;0;0;0;0;0;0
FR;6;2022-03-02;96;9;2;0;7;96;9;2;0;7
FR;6;2022-03-03;0;0;0;0;0;96;9;2;0;7
FR;6;2022-03-04;91;4;0;0;4;187;13;2;0;11
FR;6;2022-03-05;390;23;2;0;14;577;36;4;0;25
FR;6;2022-03-06;7;1;0;0;0;584;37;4;0;25
FR;6;2022-03-07;336;19;0;0;13;920;56;4;0;38
FR;6;2022-03-08;230;14;0;0;5;1150;70;4;0;43
FR;6;2022-03-09;519;29;2;0;21;1669;99;6;0;64
FR;6;2022-03-10;207;18;0;1;12;1876;117;6;1;76
FR;6;2022-03-11;328;21;6;0;21;2204;138;12;1;97
FR;6;2022-03-12;516;25;1;0;20;2720;163;13;1;117
FR;6;2022-03-13;40;2;0;0;1;2760;165;13;1;118
FR;6;2022-03-14;201;4;2;0;3;2961;169;15;1;121
FR;6;2022-03-15;112;11;2;0;9;3073;180;17;1;130
FR;6;2022-03-16;310;16;1;1;14;3383;196;18;2;144
FR;6;2022-03-17;117;6;1;2;4;3500;202;19;4;148
FR;6;2022-03-18;213;11;0;0;6;3713;213;19;4;154
FR;6;2022-03-19;303;20;2;0;10;4016;233;21;4;164
FR;6;2022-03-20;15;5;0;0;1;4031;238;21;4;165
FR;6;2022-03-21;131;22;1;0;4;4162;260;22;4;169
FR;6;2022-03-22;97;8;0;0;2;4259;268;22;4;171
FR;6;2022-03-23;225;108;3;0;14;4484;376;25;4;185
FR;6;2022-03-24;99;14;1;3;4;4583;390;26;7;189
FR;6;2022-03-25;203;141;2;1;15;4786;531;28;8;204
FR;6;2022-03-26;331;296;7;1;19;5117;827;35;9;223
FR;6;2022-03-27;32;30;1;0;1;5149;857;36;9;224
FR;6;2022-03-28;200;207;8;1;17;5349;1064;44;10;241
FR;6;2022-03-29;126;188;12;2;12;5475;1252;56;12;253
FR;6;2022-03-30;298;475;9;2;21;5773;1727;65;14;274
FR;6;2022-03-31;120;138;8;0;10;5893;1865;73;14;284
FR;0;2020-12-27;595;0;0;0;0;595;0;0;0;0
FR;0;2020-12-28;649;0;0;0;0;1244;0;0;0;0
FR;0;2020-12-29;368;0;0;0;0;1612;0;0;0;0
FR;0;2020-12-30;433;0;0;0;0;2045;0;0;0;0
FR;0;2020-12-31;360;0;0;0;0;2405;0;0;0;0
FR;0;2021-01-01;1108;0;0;0;0;3513;0;0;0;0
FR;0;2021-01-02;348;1;0;0;0;3861;1;0;0;0
FR;0;2021-01-03;394;0;0;0;0;4255;1;0;0;0
FR;0;2021-01-04;2074;0;0;0;0;6329;1;0;0;0
FR;0;2021-01-05;6838;2;0;0;0;13167;3;0;0;0
FR;0;2021-01-06;12277;5;0;0;0;25444;8;0;0;0
FR;0;2021-01-07;29430;3;0;0;0;54874;11;0;0;0
FR;0;2021-01-08;37106;2;0;0;0;91980;13;0;0;0
FR;0;2021-01-09;11206;2;0;0;0;103186;15;0;0;0
FR;0;2021-01-10;5987;0;0;0;0;109173;15;0;0;0
FR;0;2021-01-11;39914;7;0;0;0;149087;22;0;0;0
FR;0;2021-01-12;62097;7;0;0;0;211184;29;0;0;0
FR;0;2021-01-13;65038;16;0;0;0;276222;45;0;0;0
FR;0;2021-01-14;83124;24;0;0;0;359346;69;0;0;0
FR;0;2021-01-15;68968;7;0;0;0;428314;76;0;0;0
FR;0;2021-01-16;20203;75;0;0;0;448517;151;0;0;0
FR;0;2021-01-17;10975;45;0;0;0;459492;196;0;0;0
FR;0;2021-01-18;85809;168;0;0;0;545301;364;0;0;0
FR;0;2021-01-19;130556;143;0;0;0;675857;507;0;0;0
FR;0;2021-01-20;137488;170;0;0;0;813345;677;0;0;0
FR;0;2021-01-21;158347;147;0;0;0;971692;824;0;0;0
FR;0;2021-01-22;121018;178;0;0;0;1092710;1002;0;0;0
FR;0;2021-01-23;38454;56;0;0;0;1131164;1058;0;0;0
FR;0;2021-01-24;9737;49;0;0;0;1140901;1107;0;0;0
FR;0;2021-01-25;78204;1229;0;0;0;1219105;2336;0;0;0
FR;0;2021-01-26;100333;3157;1;0;0;1319438;5493;1;0;0
FR;0;2021-01-27;107208;5717;0;0;0;1426646;11210;1;0;0
FR;0;2021-01-28;124305;14457;0;0;0;1550951;25667;1;0;0
FR;0;2021-01-29;92147;17384;0;0;0;1643098;43051;1;0;0
FR;0;2021-01-30;29099;4224;0;0;0;1672197;47275;1;0;0
FR;0;2021-01-31;5219;1715;0;0;0;1677416;48990;1;0;0
FR;0;2021-02-01;53085;21097;0;0;0;1730501;70087;1;0;0
FR;0;2021-02-02;72259;34722;0;0;0;1802760;104809;1;0;0
FR;0;2021-02-03;72254;37115;0;0;0;1875014;141924;1;0;0
FR;0;2021-02-04;82014;50220;0;0;0;1957028;192144;1;0;0
FR;0;2021-02-05;68203;45452;0;0;0;2025231;237596;1;0;0
FR;0;2021-02-06;23130;10520;0;0;0;2048361;248116;1;0;0
FR;0;2021-02-07;5171;5045;0;0;0;2053532;253161;1;0;0
FR;0;2021-02-08;46802;46162;0;0;0;2100334;299323;1;0;0
FR;0;2021-02-09;65975;72616;0;0;0;2166309;371939;1;0;0
FR;0;2021-02-10;70957;76920;0;0;0;2237266;448859;1;0;0
FR;0;2021-02-11;87210;99139;0;0;0;2324476;547998;1;0;0
FR;0;2021-02-12;79264;74344;0;0;0;2403740;622342;1;0;0
FR;0;2021-02-13;22338;19546;0;0;0;2426078;641888;1;0;0
FR;0;2021-02-14;5060;7251;0;0;0;2431138;649139;1;0;0
FR;0;2021-02-15;38050;76656;0;0;0;2469188;725795;1;0;0
FR;0;2021-02-16;50350;100643;0;0;0;2519538;826438;1;0;0
FR;0;2021-02-17;50473;103226;1;0;0;2570011;929664;2;0;0
FR;0;2021-02-18;69724;118677;0;0;0;2639735;1048341;2;0;0
FR;0;2021-02-19;65029;90766;1;0;0;2704764;1139107;3;0;0
FR;0;2021-02-20;18567;28464;0;0;0;2723331;1167571;3;0;0
FR;0;2021-02-21;3305;6392;0;0;0;2726636;1173963;3;0;0
FR;0;2021-02-22;37465;73202;2;0;0;2764101;1247165;5;0;0
FR;0;2021-02-23;53750;84145;1;0;0;2817851;1331310;6;0;0
FR;0;2021-02-24;59957;81163;1;0;0;2877808;1412473;7;0;0
FR;0;2021-02-25;100529;91268;1;0;0;2978337;1503741;8;0;0
FR;0;2021-02-26;113406;70945;0;0;0;3091743;1574686;8;0;0
FR;0;2021-02-27;52086;22022;0;0;0;3143829;1596708;8;0;0
FR;0;2021-02-28;6189;4424;1;0;0;3150018;1601132;9;0;0
FR;0;2021-03-01;65794;52898;1;0;0;3215812;1654030;10;0;0
FR;0;2021-03-02;101316;66276;2;0;0;3317128;1720306;12;0;0
FR;0;2021-03-03;116421;65426;0;0;0;3433549;1785732;12;0;0
FR;0;2021-03-04;163550;69076;3;0;0;3597099;1854808;15;0;0
FR;0;2021-03-05;200859;63215;3;0;0;3797958;1918023;18;0;0
FR;0;2021-03-06;207911;17794;3;0;0;4005869;1935817;21;0;0
FR;0;2021-03-07;121240;5384;1;0;0;4127109;1941201;22;0;0
FR;0;2021-03-08;107098;50703;2;0;0;4234207;1991904;24;0;0
FR;0;2021-03-09;172382;56663;2;0;0;4406589;2048567;26;0;0
FR;0;2021-03-10;178884;57163;5;0;0;4585473;2105730;31;0;0
FR;0;2021-03-11;242769;63085;2;0;0;4828242;2168815;33;0;0
FR;0;2021-03-12;294745;53409;0;0;0;5122987;2222224;33;0;0
FR;0;2021-03-13;231349;15293;1;0;0;5354336;2237517;34;0;0
FR;0;2021-03-14;63327;3418;1;0;0;5417663;2240935;35;0;0
FR;0;2021-03-15;158570;32567;3;0;0;5576233;2273502;38;0;0
FR;0;2021-03-16;141516;39493;5;0;0;5717749;2312995;43;0;0
FR;0;2021-03-17;150400;38670;4;0;0;5868149;2351665;47;0;0
FR;0;2021-03-18;167746;44610;5;0;0;6035895;2396275;52;0;0
FR;0;2021-03-19;229931;37377;2;0;0;6265826;2433652;54;0;0
FR;0;2021-03-20;166627;11721;1;0;0;6432453;2445373;55;0;0
FR;0;2021-03-21;49891;2605;1;0;0;6482344;2447978;56;0;0
FR;0;2021-03-22;169931;34215;2;0;0;6652275;2482193;58;0;0
FR;0;2021-03-23;250284;42421;1;0;0;6902559;2524614;59;0;0
FR;0;2021-03-24;256814;43829;0;0;0;7159373;2568443;59;0;0
FR;0;2021-03-25;341722;44707;5;0;0;7501095;2613150;64;0;0
FR;0;2021-03-26;358726;41867;4;0;0;7859821;2655017;68;0;0
FR;0;2021-03-27;195221;16662;1;0;0;8055042;2671679;69;0;0
FR;0;2021-03-28;59310;3849;3;0;0;8114352;2675528;72;0;0
FR;0;2021-03-29;202906;54193;4;0;0;8317258;2729721;76;0;0
FR;0;2021-03-30;285362;69594;4;0;0;8602620;2799315;80;0;0
FR;0;2021-03-31;262926;72928;4;0;0;8865546;2872243;84;0;0
FR;0;2021-04-01;315312;88056;12;0;0;9180858;2960299;96;0;0
FR;0;2021-04-02;281243;92155;7;0;0;9462101;3052454;103;0;0
FR;0;2021-04-03;141027;61811;5;0;0;9603128;3114265;108;0;0
FR;0;2021-04-04;46306;18674;2;0;0;9649434;3132939;110;0;0
FR;0;2021-04-05;63271;10959;11;0;0;9712705;3143898;121;0;0
FR;0;2021-04-06;217076;108047;16;0;0;9929781;3251945;137;0;0
FR;0;2021-04-07;260148;115297;17;0;0;10189929;3367242;154;0;0
FR;0;2021-04-08;337659;121318;14;0;0;10527588;3488560;168;0;0
FR;0;2021-04-09;410046;116372;49;0;0;10937634;3604932;217;0;0
FR;0;2021-04-10;212557;82651;15;0;0;11150191;3687583;232;0;0
FR;0;2021-04-11;56049;34545;7;0;0;11206240;3722128;239;0;0
FR;0;2021-04-12;236899;115097;45;0;0;11443139;3837225;284;0;0
FR;0;2021-04-13;309359;144702;97;1;0;11752498;3981927;381;1;0
FR;0;2021-04-14;294376;139234;210;0;0;12046874;4121161;591;1;0
FR;0;2021-04-15;336958;147796;337;0;0;12383832;4268957;928;1;0
FR;0;2021-04-16;339184;145592;352;0;0;12723016;4414549;1280;1;0
FR;0;2021-04-17;188608;90147;108;0;0;12911624;4504696;1388;1;0
FR;0;2021-04-18;51563;35415;45;0;0;12963187;4540111;1433;1;0
FR;0;2021-04-19;205551;138224;453;0;0;13168738;4678335;1886;1;0
FR;0;2021-04-20;254289;170524;568;0;0;13423027;4848859;2454;1;0
FR;0;2021-04-21;253109;168744;830;0;0;13676136;5017603;3284;1;0
FR;0;2021-04-22;287358;188195;818;0;0;13963494;5205798;4102;1;0
FR;0;2021-04-23;297968;183119;743;0;0;14261462;5388917;4845;1;0
FR;0;2021-04-24;190400;111484;247;0;0;14451862;5500401;5092;1;0
FR;0;2021-04-25;69460;38835;51;0;0;14521322;5539236;5143;1;0
FR;0;2021-04-26;220851;155967;558;0;0;14742173;5695203;5701;1;0
FR;0;2021-04-27;284499;187282;938;0;0;15026672;5882485;6639;1;0
FR;0;2021-04-28;299382;183051;1420;1;1;15326054;6065536;8059;2;1
FR;0;2021-04-29;357013;196005;1274;0;0;15683067;6261541;9333;2;1
FR;0;2021-04-30;372102;184618;1119;1;0;16055169;6446159;10452;3;1
FR;0;2021-05-01;167536;52511;178;0;0;16222705;6498670;10630;3;1
FR;0;2021-05-02;91632;37784;82;0;0;16314337;6536454;10712;3;1
FR;0;2021-05-03;288757;169332;837;0;0;16603094;6705786;11549;3;1
FR;0;2021-05-04;315506;224213;1230;0;0;16918600;6929999;12779;3;1
FR;0;2021-05-05;327004;224396;1310;0;0;17245604;7154395;14089;3;1
FR;0;2021-05-06;379335;239027;1624;0;0;17624939;7393422;15713;3;1
FR;0;2021-05-07;372616;257084;1222;0;0;17997555;7650506;16935;3;1
FR;0;2021-05-08;222101;66860;297;0;0;18219656;7717366;17232;3;1
FR;0;2021-05-09;129645;46655;243;0;0;18349301;7764021;17475;3;1
FR;0;2021-05-10;313127;228713;1227;0;0;18662428;7992734;18702;3;1
FR;0;2021-05-11;403742;257852;1562;0;0;19066170;8250586;20264;3;1
FR;0;2021-05-12;433938;232983;1540;0;0;19500108;8483569;21804;3;1
FR;0;2021-05-13;338481;56970;429;0;0;19838589;8540539;22233;3;1
FR;0;2021-05-14;453994;167238;1117;0;0;20292583;8707777;23350;3;1
FR;0;2021-05-15;374724;93940;442;0;0;20667307;8801717;23792;3;1
FR;0;2021-05-16;202676;20776;168;0;0;20869983;8822493;23960;3;1
FR;0;2021-05-17;375962;148966;1547;0;0;21245945;8971459;25507;3;1
FR;0;2021-05-18;459783;152974;1984;0;0;21705728;9124433;27491;3;1
FR;0;2021-05-19;467244;145065;2448;0;0;22172972;9269498;29939;3;1
FR;0;2021-05-20;507324;160165;2326;0;0;22680296;9429663;32265;3;1
FR;0;2021-05-21;489503;174374;1984;0;0;23169799;9604037;34249;3;1
FR;0;2021-05-22;347101;79775;667;0;0;23516900;9683812;34916;3;1
FR;0;2021-05-23;161616;14413;246;0;0;23678516;9698225;35162;3;1
FR;0;2021-05-24;263102;33210;597;0;0;23941618;9731435;35759;3;1
FR;0;2021-05-25;400024;189063;2343;1;0;24341642;9920498;38102;4;1
FR;0;2021-05-26;413314;188068;2213;0;0;24754956;10108566;40315;4;1
FR;0;2021-05-27;449649;218450;2152;0;0;25204605;10327016;42467;4;1
FR;0;2021-05-28;429403;259325;1886;0;0;25634008;10586341;44353;4;1
FR;0;2021-05-29;298916;149297;582;0;0;25932924;10735638;44935;4;1
FR;0;2021-05-30;107053;32577;162;0;0;26039977;10768215;45097;4;1
FR;0;2021-05-31;357866;203509;1465;1;1;26397843;10971724;46562;5;2
FR;0;2021-06-01;430439;251393;1952;1;1;26828282;11223117;48514;6;3
FR;0;2021-06-02;418827;230711;1972;0;0;27247109;11453828;50486;6;3
FR;0;2021-06-03;463981;258469;1815;0;0;27711090;11712297;52301;6;3
FR;0;2021-06-04;455383;304690;1723;1;1;28166473;12016987;54024;7;4
FR;0;2021-06-05;304692;188936;651;0;0;28471165;12205923;54675;7;4
FR;0;2021-06-06;133195;49124;226;0;0;28604360;12255047;54901;7;4
FR;0;2021-06-07;338524;262109;1514;0;0;28942884;12517156;56415;7;4
FR;0;2021-06-08;393468;290945;1791;0;0;29336352;12808101;58206;7;4
FR;0;2021-06-09;384530;275625;1720;0;0;29720882;13083726;59926;7;4
FR;0;2021-06-10;403831;289128;1717;1;0;30124713;13372854;61643;8;4
FR;0;2021-06-11;386363;357276;1454;0;0;30511076;13730130;63097;8;4
FR;0;2021-06-12;283143;211268;489;0;0;30794219;13941398;63586;8;4
FR;0;2021-06-13;104807;74003;204;0;0;30899026;14015401;63790;8;4
FR;0;2021-06-14;240608;355812;1421;1;0;31139634;14371213;65211;9;4
FR;0;2021-06-15;307858;385748;1560;1;0;31447492;14756961;66771;10;4
FR;0;2021-06-16;313745;357759;1412;1;0;31761237;15114720;68183;11;4
FR;0;2021-06-17;317458;372133;1419;1;0;32078695;15486853;69602;12;4
FR;0;2021-06-18;321489;442344;1329;1;0;32400184;15929197;70931;13;4
FR;0;2021-06-19;224289;273738;445;0;0;32624473;16202935;71376;13;4
FR;0;2021-06-20;74342;102577;127;0;0;32698815;16305512;71503;13;4
FR;0;2021-06-21;195520;401948;1027;1;1;32894335;16707460;72530;14;5
FR;0;2021-06-22;222955;467303;1257;10;2;33117290;17174763;73787;24;7
FR;0;2021-06-23;233800;439818;1192;1;1;33351090;17614581;74979;25;8
FR;0;2021-06-24;241647;409428;1343;0;0;33592737;18024009;76322;25;8
FR;0;2021-06-25;227389;522086;1397;0;0;33820126;18546095;77719;25;8
FR;0;2021-06-26;153138;370669;583;1;0;33973264;18916764;78302;26;8
FR;0;2021-06-27;55846;156286;166;1;0;34029110;19073050;78468;27;8
FR;0;2021-06-28;154558;453054;1163;0;0;34183668;19526104;79631;27;8
FR;0;2021-06-29;182492;506542;2120;0;0;34366160;20032646;81751;27;8
FR;0;2021-06-30;203758;481487;2007;21;2;34569918;20514133;83758;48;10
FR;0;2021-07-01;230857;457730;2221;5;1;34800775;20971863;85979;53;11
FR;0;2021-07-02;227799;520200;2118;5;3;35028574;21492063;88097;58;14
FR;0;2021-07-03;141860;368726;909;3;1;35170434;21860789;89006;61;15
FR;0;2021-07-04;56672;141275;265;0;0;35227106;22002064;89271;61;15
FR;0;2021-07-05;168043;419368;1666;8;2;35395149;22421432;90937;69;17
FR;0;2021-07-06;196402;474814;1823;44;8;35591551;22896246;92760;113;25
FR;0;2021-07-07;212719;439318;1873;24;5;35804270;23335564;94633;137;30
FR;0;2021-07-08;231280;424143;2088;20;8;36035550;23759707;96721;157;38
FR;0;2021-07-09;228234;510282;2182;4;3;36263784;24269989;98903;161;41
FR;0;2021-07-10;148474;339827;982;1;1;36412258;24609816;99885;162;42
FR;0;2021-07-11;60110;110135;281;0;0;36472368;24719951;100166;162;42
FR;0;2021-07-12;168892;478182;1750;4;0;36641260;25198133;101916;166;42
FR;0;2021-07-13;286983;527470;2043;7;2;36928243;25725603;103959;173;44
FR;0;2021-07-14;180771;157806;432;0;0;37109014;25883409;104391;173;44
FR;0;2021-07-15;346715;502536;2096;1;0;37455729;26385945;106487;174;44
FR;0;2021-07-16;379753;496034;2020;3;1;37835482;26881979;108507;177;45
FR;0;2021-07-17;259594;319827;876;1;0;38095076;27201806;109383;178;45
FR;0;2021-07-18;109645;114830;310;0;0;38204721;27316636;109693;178;45
FR;0;2021-07-19;285236;425330;1626;3;0;38489957;27741966;111319;181;45
FR;0;2021-07-20;376640;452674;1720;0;0;38866597;28194640;113039;181;45
FR;0;2021-07-21;395528;408136;1548;4;2;39262125;28602776;114587;185;47
FR;0;2021-07-22;440684;388444;1711;4;2;39702809;28991220;116298;189;49
FR;0;2021-07-23;438455;423354;1876;4;2;40141264;29414574;118174;193;51
FR;0;2021-07-24;285135;269700;802;1;0;40426399;29684274;118976;194;51
FR;0;2021-07-25;121008;80081;225;0;0;40547407;29764355;119201;194;51
FR;0;2021-07-26;347182;323500;1614;3;2;40894589;30087855;120815;197;53
FR;0;2021-07-27;463796;320533;1696;4;2;41358385;30408388;122511;201;55
FR;0;2021-07-28;459217;290207;1635;4;2;41817602;30698595;124146;205;57
FR;0;2021-07-29;489567;277093;1793;2;1;42307169;30975688;125939;207;58
FR;0;2021-07-30;461486;303050;1935;5;2;42768655;31278738;127874;212;60
FR;0;2021-07-31;285284;185047;913;1;0;43053939;31463785;128787;213;60
FR;0;2021-08-01;111892;50007;252;0;0;43165831;31513792;129039;213;60
FR;0;2021-08-02;341001;234699;1596;2;0;43506832;31748491;130635;215;60
FR;0;2021-08-03;398218;245243;1715;2;1;43905050;31993734;132350;217;61
FR;0;2021-08-04;384415;210235;1589;5;3;44289465;32203969;133939;222;64
FR;0;2021-08-05;365806;228961;1705;0;0;44655271;32432930;135644;222;64
FR;0;2021-08-06;359364;271859;1833;4;1;45014635;32704789;137477;226;65
FR;0;2021-08-07;212958;178376;755;4;3;45227593;32883165;138232;230;68
FR;0;2021-08-08;74080;63266;269;0;0;45301673;32946431;138501;230;68
FR;0;2021-08-09;258465;259797;1538;4;3;45560138;33206228;140039;234;71
FR;0;2021-08-10;306460;278413;1652;2;1;45866598;33484641;141691;236;72
FR;0;2021-08-11;279389;260498;1435;5;1;46145987;33745139;143126;241;73
FR;0;2021-08-12;271183;278708;1657;3;1;46417170;34023847;144783;244;74
FR;0;2021-08-13;251925;277824;1585;3;2;46669095;34301671;146368;247;76
FR;0;2021-08-14;145231;197384;739;0;0;46814326;34499055;147107;247;76
FR;0;2021-08-15;39244;50110;212;1;0;46853570;34549165;147319;248;76
FR;0;2021-08-16;185833;318275;1538;0;0;47039403;34867440;148857;248;76
FR;0;2021-08-17;215381;336785;1632;6;1;47254784;35204225;150489;254;77
FR;0;2021-08-18;198784;324993;1584;7;4;47453568;35529218;152073;261;81
FR;0;2021-08-19;191768;325650;1629;1;0;47645336;35854868;153702;262;81
FR;0;2021-08-20;186165;365711;1804;3;2;47831501;36220579;155506;265;83
FR;0;2021-08-21;104698;238168;700;0;0;47936199;36458747;156206;265;83
FR;0;2021-08-22;31865;87200;251;1;1;47968064;36545947;156457;266;84
FR;0;2021-08-23;140816;357344;1555;3;2;48108880;36903291;158012;269;86
FR;0;2021-08-24;162309;376960;1835;5;1;48271189;37280251;159847;274;87
FR;0;2021-08-25;150932;350893;2024;8;3;48422121;37631144;161871;282;90
FR;0;2021-08-26;142657;342832;2551;10;1;48564778;37973976;164422;292;91
FR;0;2021-08-27;148207;387712;2786;11;4;48712985;38361688;167208;303;95
FR;0;2021-08-28;90533;249513;1405;0;0;48803518;38611201;168613;303;95
FR;0;2021-08-29;27287;83299;510;1;0;48830805;38694500;169123;304;95
FR;0;2021-08-30;117272;324914;4706;6;6075;48948077;39019414;173829;310;6170
FR;0;2021-08-31;128623;334742;10153;18;11903;49076700;39354156;183982;328;18073
FR;0;2021-09-01;135031;285602;22393;7;24206;49211731;39639758;206375;335;42279
FR;0;2021-09-02;112123;247308;26481;13;28789;49323854;39887066;232856;348;71068
FR;0;2021-09-03;117921;292766;29936;24;32897;49441775;40179832;262792;372;103965
FR;0;2021-09-04;89681;217693;12579;12;14015;49531456;40397525;275371;384;117980
FR;0;2021-09-05;21314;44884;4385;2;4724;49552770;40442409;279756;386;122704
FR;0;2021-09-06;75085;180899;31932;16;34141;49627855;40623308;311688;402;156845
FR;0;2021-09-07;79272;181280;33224;40;36029;49707127;40804588;344912;442;192874
FR;0;2021-09-08;88712;206128;29637;27;32300;49795839;41010716;374549;469;225174
FR;0;2021-09-09;75716;165302;33015;26;36374;49871555;41176018;407564;495;261548
FR;0;2021-09-10;95018;203579;35692;25;40359;49966573;41379597;443256;520;301907
FR;0;2021-09-11;66282;169163;12119;18;14194;50032855;41548760;455375;538;316101
FR;0;2021-09-12;12721;32099;2762;2;3146;50045576;41580859;458137;540;319247
FR;0;2021-09-13;64270;126415;41180;32;43802;50109846;41707274;499317;572;363049
FR;0;2021-09-14;73193;129183;56303;78;61679;50183039;41836457;555620;650;424728
FR;0;2021-09-15;76209;167789;55588;59;54688;50259248;42004246;611208;709;479416
FR;0;2021-09-16;63617;114504;59987;86;59918;50322865;42118750;671195;795;539334
FR;0;2021-09-17;74849;156810;53782;70;57147;50397714;42275560;724977;865;596481
FR;0;2021-09-18;48122;139545;15588;25;17271;50445836;42415105;740565;890;613752
FR;0;2021-09-19;7836;23725;2427;1;2619;50453672;42438830;742992;891;616371
FR;0;2021-09-20;44367;93908;49981;73;50157;50498039;42532738;792973;964;666528
FR;0;2021-09-21;45716;98455;62664;76;63229;50543755;42631193;855637;1040;729757
FR;0;2021-09-22;48479;142176;55276;84;55226;50592234;42773369;910913;1124;784983
FR;0;2021-09-23;43060;91834;62300;95;63289;50635294;42865203;973213;1219;848272
FR;0;2021-09-24;52089;132914;54486;110;59006;50687383;42998117;1027699;1329;907278
FR;0;2021-09-25;35126;115378;16256;37;18228;50722509;43113495;1043955;1366;925506
FR;0;2021-09-26;5511;17838;2261;4;2342;50728020;43131333;1046216;1370;927848
FR;0;2021-09-27;33884;76985;47146;96;48084;50761904;43208318;1093362;1466;975932
FR;0;2021-09-28;36406;75233;54870;88;56341;50798310;43283551;1148232;1554;1032273
FR;0;2021-09-29;44272;100763;53284;111;54733;50842582;43384314;1201516;1665;1087006
FR;0;2021-09-30;36142;72252;56943;96;59361;50878724;43456566;1258459;1761;1146367
FR;0;2021-10-01;60993;100510;57743;108;63626;50939717;43557076;1316202;1869;1209993
FR;0;2021-10-02;39192;78222;20937;38;23281;50978909;43635298;1337139;1907;1233274
FR;0;2021-10-03;5236;10591;2517;4;2557;50984145;43645889;1339656;1911;1235831
FR;0;2021-10-04;34689;58477;52579;83;54746;51018834;43704366;1392235;1994;1290577
FR;0;2021-10-05;33143;64273;60911;135;64814;51051977;43768639;1453146;2129;1355391
FR;0;2021-10-06;42128;79085;65632;113;68120;51094105;43847724;1518778;2242;1423511
FR;0;2021-10-07;30233;62016;65332;90;68600;51124338;43909740;1584110;2332;1492111
FR;0;2021-10-08;48396;91673;77672;110;84518;51172734;44001413;1661782;2442;1576629
FR;0;2021-10-09;33488;60804;31501;35;33833;51206222;44062217;1693283;2477;1610462
FR;0;2021-10-10;4550;7369;3180;9;3476;51210772;44069586;1696463;2486;1613938
FR;0;2021-10-11;30391;49906;60996;105;63988;51241163;44119492;1757459;2591;1677926
FR;0;2021-10-12;31144;54419;70531;139;75748;51272307;44173911;1827990;2730;1753674
FR;0;2021-10-13;39826;62682;74378;135;79195;51312133;44236593;1902368;2865;1832869
FR;0;2021-10-14;30140;52746;68696;115;73668;51342273;44289339;1971064;2980;1906537
FR;0;2021-10-15;44588;75069;93184;191;102855;51386861;44364408;2064248;3171;2009392
FR;0;2021-10-16;31160;44047;36668;45;39586;51418021;44408455;2100916;3216;2048978
FR;0;2021-10-17;3807;5258;3586;2;3689;51421828;44413713;2104502;3218;2052667
FR;0;2021-10-18;27233;41923;67444;133;71305;51449061;44455636;2171946;3351;2123972
FR;0;2021-10-19;26857;43082;76356;141;81579;51475918;44498718;2248302;3492;2205551
FR;0;2021-10-20;35089;52262;96868;179;101371;51511007;44550980;2345170;3671;2306922
FR;0;2021-10-21;25747;45144;83878;112;89052;51536754;44596124;2429048;3783;2395974
FR;0;2021-10-22;38132;62097;104823;199;112407;51574886;44658221;2533871;3982;2508381
FR;0;2021-10-23;26877;41064;45418;57;48581;51601763;44699285;2579289;4039;2556962
FR;0;2021-10-24;2902;4785;3676;6;3940;51604665;44704070;2582965;4045;2560902
FR;0;2021-10-25;25932;36266;82269;144;86557;51630597;44740336;2665234;4189;2647459
FR;0;2021-10-26;23622;34961;87172;166;92244;51654219;44775297;2752406;4355;2739703
FR;0;2021-10-27;29936;46384;108927;257;114565;51684155;44821681;2861333;4612;2854268
FR;0;2021-10-28;23269;34764;88627;153;94308;51707424;44856445;2949960;4765;2948576
FR;0;2021-10-29;31443;50995;117243;205;125162;51738867;44907440;3067203;4970;3073738
FR;0;2021-10-30;20379;33050;50303;77;53339;51759246;44940490;3117506;5047;3127077
FR;0;2021-10-31;2468;3793;3581;3;3871;51761714;44944283;3121087;5050;3130948
FR;0;2021-11-01;7869;4711;3188;3;3542;51769583;44948994;3124275;5053;3134490
FR;0;2021-11-02;24953;39978;93497;157;99403;51794536;44988972;3217772;5210;3233893
FR;0;2021-11-03;29477;47706;118800;218;125704;51824013;45036678;3336572;5428;3359597
FR;0;2021-11-04;23528;37417;107451;216;114261;51847541;45074095;3444023;5644;3473858
FR;0;2021-11-05;32121;52701;141543;233;151168;51879662;45126796;3585566;5877;3625026
FR;0;2021-11-06;21369;34488;64819;123;68179;51901031;45161284;3650385;6000;3693205
FR;0;2021-11-07;2359;4268;5162;6;5589;51903390;45165552;3655547;6006;3698794
FR;0;2021-11-08;20126;37797;127086;227;134102;51923516;45203349;3782633;6233;3832896
FR;0;2021-11-09;21973;44761;161570;342;172020;51945489;45248110;3944203;6575;4004916
FR;0;2021-11-10;31152;54714;186880;446;198547;51976641;45302824;4131083;7021;4203463
FR;0;2021-11-11;3930;6397;12897;28;13882;51980571;45309221;4143980;7049;4217345
FR;0;2021-11-12;28888;55115;183676;249;197190;52009459;45364336;4327656;7298;4414535
FR;0;2021-11-13;20200;32651;80654;118;86262;52029659;45396987;4408310;7416;4500797
FR;0;2021-11-14;2299;3994;7155;6;7881;52031958;45400981;4415465;7422;4508678
FR;0;2021-11-15;20153;38762;160713;312;171378;52052111;45439743;4576178;7734;4680056
FR;0;2021-11-16;23150;43934;200254;391;214755;52075261;45483677;4776432;8125;4894811
FR;0;2021-11-17;30190;50418;199739;407;212729;52105451;45534095;4976171;8532;5107540
FR;0;2021-11-18;23188;43875;191521;469;205310;52128639;45577970;5167692;9001;5312850
FR;0;2021-11-19;33485;61333;243071;548;261965;52162124;45639303;5410763;9549;5574815
FR;0;2021-11-20;25232;36655;102089;205;109620;52187356;45675958;5512852;9754;5684435
FR;0;2021-11-21;2611;4590;9631;18;10656;52189967;45680548;5522483;9772;5695091
FR;0;2021-11-22;22650;33241;180240;470;194679;52212617;45713789;5702723;10242;5889770
FR;0;2021-11-23;25416;45556;229234;547;247578;52238033;45759345;5931957;10789;6137348
FR;0;2021-11-24;31672;53703;224701;718;243056;52269705;45813048;6156658;11507;6380404
FR;0;2021-11-25;25291;48906;255766;740;277500;52294996;45861954;6412424;12247;6657904
FR;0;2021-11-26;33073;74630;379310;865;414452;52328069;45936584;6791734;13112;7072356
FR;0;2021-11-27;23177;49483;214811;390;236517;52351246;45986067;7006545;13502;7308873
FR;0;2021-11-28;3472;10602;56715;66;63343;52354718;45996669;7063260;13568;7372216
FR;0;2021-11-29;19300;54150;341327;864;371448;52374018;46050819;7404587;14432;7743664
FR;0;2021-11-30;24422;71946;457228;984;500566;52398440;46122765;7861815;15416;8244230
FR;0;2021-12-01;26058;75742;468907;1158;511061;52424498;46198507;8330722;16574;8755291
FR;0;2021-12-02;21779;71584;526931;1276;574602;52446277;46270091;8857653;17850;9329893
FR;0;2021-12-03;25335;92373;596183;1415;650848;52471612;46362464;9453836;19265;9980741
FR;0;2021-12-04;18251;60427;336122;690;369613;52489863;46422891;9789958;19955;10350354
FR;0;2021-12-05;4135;16292;95735;156;107062;52493998;46439183;9885693;20111;10457416
FR;0;2021-12-06;19168;73130;492966;1171;539751;52513166;46512313;10378659;21282;10997167
FR;0;2021-12-07;23211;91681;645162;1769;706002;52536377;46603994;11023821;23051;11703169
FR;0;2021-12-08;25222;92047;591382;1871;647258;52561599;46696041;11615203;24922;12350427
FR;0;2021-12-09;23889;94142;662852;2180;726053;52585488;46790183;12278055;27102;13076480
FR;0;2021-12-10;27080;111002;735825;2072;805868;52612568;46901185;13013880;29174;13882348
FR;0;2021-12-11;20194;75946;435084;984;480273;52632762;46977131;13448964;30158;14362621
FR;0;2021-12-12;5607;23218;142233;262;159215;52638369;47000349;13591197;30420;14521836
FR;0;2021-12-13;20984;91139;587434;1699;649097;52659353;47091488;14178631;32119;15170933
FR;0;2021-12-14;27011;118468;765284;2648;847252;52686364;47209956;14943915;34767;16018185
FR;0;2021-12-15;28041;114203;694090;2262;768793;52714405;47324159;15638005;37029;16786978
FR;0;2021-12-16;27821;115957;763774;2556;844199;52742226;47440116;16401779;39585;17631177
FR;0;2021-12-17;31419;128678;807637;2710;891845;52773645;47568794;17209416;42295;18523022
FR;0;2021-12-18;24894;81667;469870;1178;522132;52798539;47650461;17679286;43473;19045154
FR;0;2021-12-19;8739;28919;169330;378;191185;52807278;47679380;17848616;43851;19236339
FR;0;2021-12-20;31532;97402;591247;1787;658534;52838810;47776782;18439863;45638;19894873
FR;0;2021-12-21;39153;112193;682209;2391;759358;52877963;47888975;19122072;48029;20654231
FR;0;2021-12-22;39406;99428;575564;2166;641969;52917369;47988403;19697636;50195;21296200
FR;0;2021-12-23;33659;79633;440820;1648;494267;52951028;48068036;20138456;51843;21790467
FR;0;2021-12-24;10613;26053;110954;396;126645;52961641;48094089;20249410;52239;21917112
FR;0;2021-12-25;762;3495;7569;25;9043;52962403;48097584;20256979;52264;21926155
FR;0;2021-12-26;4695;11899;52062;139;60131;52967098;48109483;20309041;52403;21986286
FR;0;2021-12-27;30242;83757;453392;1365;509007;52997340;48193240;20762433;53768;22495293
FR;0;2021-12-28;38252;98864;564013;1766;632092;53035592;48292104;21326446;55534;23127385
FR;0;2021-12-29;39796;88333;501048;1685;560868;53075388;48380437;21827494;57219;23688253
FR;0;2021-12-30;35826;74816;420903;1519;471047;53111214;48455253;22248397;58738;24159300
FR;0;2021-12-31;11829;25092;116805;406;131584;53123043;48480345;22365202;59144;24290884
FR;0;2022-01-01;1186;3199;8492;36;9916;53124229;48483544;22373694;59180;24300800
FR;0;2022-01-02;6063;13004;58372;124;66925;53130292;48496548;22432066;59304;24367725
FR;0;2022-01-03;31528;88010;494591;1591;551245;53161820;48584558;22926657;60895;24918970
FR;0;2022-01-04;40509;110522;641210;2302;714100;53202329;48695080;23567867;63197;25633070
FR;0;2022-01-05;59558;102935;568951;1982;633928;53261887;48798015;24136818;65179;26266998
FR;0;2022-01-06;43766;109958;638782;2688;711207;53305653;48907973;24775600;67867;26978205
FR;0;2022-01-07;50404;122711;710804;2804;790182;53356057;49030684;25486404;70671;27768387
FR;0;2022-01-08;44894;80305;423743;1208;472807;53400951;49110989;25910147;71879;28241194
FR;0;2022-01-09;15591;26776;128527;299;145714;53416542;49137765;26038674;72178;28386908
FR;0;2022-01-10;34800;86236;469101;1808;521967;53451342;49224001;26507775;73986;28908875
FR;0;2022-01-11;41504;99715;548036;2306;608281;53492846;49323716;27055811;76292;29517156
FR;0;2022-01-12;59975;95149;452484;1964;504146;53552821;49418865;27508295;78256;30021302
FR;0;2022-01-13;37754;92034;487138;2080;540841;53590575;49510899;27995433;80336;30562143
FR;0;2022-01-14;42284;103184;568380;2283;628858;53632859;49614083;28563813;82619;31191001
FR;0;2022-01-15;39277;65778;340034;979;377501;53672136;49679861;28903847;83598;31568502
FR;0;2022-01-16;11380;19334;87356;215;99443;53683516;49699195;28991203;83813;31667945
FR;0;2022-01-17;24527;60001;320150;1380;354089;53708043;49759196;29311353;85193;32022034
FR;0;2022-01-18;28047;68298;360923;1796;397447;53736090;49827494;29672276;86989;32419481
FR;0;2022-01-19;42949;66917;281149;1448;310975;53779039;49894411;29953425;88437;32730456
FR;0;2022-01-20;23325;59273;298807;1737;328304;53802364;49953684;30252232;90174;33058760
FR;0;2022-01-21;27897;68721;366207;2077;401054;53830261;50022405;30618439;92251;33459814
FR;0;2022-01-22;27600;47747;218723;838;241706;53857861;50070152;30837162;93089;33701520
FR;0;2022-01-23;6694;13064;48629;171;55179;53864555;50083216;30885791;93260;33756699
FR;0;2022-01-24;16154;47074;217189;1133;239271;53880709;50130290;31102980;94393;33995970
FR;0;2022-01-25;18872;53991;242918;1547;266992;53899581;50184281;31345898;95940;34262962
FR;0;2022-01-26;28055;59386;209134;1292;229252;53927636;50243667;31555032;97232;34492214
FR;0;2022-01-27;16237;45523;207486;1266;225708;53943873;50289190;31762518;98498;34717922
FR;0;2022-01-28;21421;75758;289903;1573;321427;53965294;50364948;32052421;100071;35039349
FR;0;2022-01-29;18379;52856;184053;683;204550;53983673;50417804;32236474;100754;35243899
FR;0;2022-01-30;4462;14590;39111;121;45091;53988135;50432394;32275585;100875;35288990
FR;0;2022-01-31;11191;43817;148109;738;164769;53999326;50476211;32423694;101613;35453759
FR;0;2022-02-01;12582;47688;173994;1139;191256;54011908;50523899;32597688;102752;35645015
FR;0;2022-02-02;19657;65559;171379;1029;190027;54031565;50589458;32769067;103781;35835042
FR;0;2022-02-03;10861;43718;157417;984;173219;54042426;50633176;32926484;104765;36008261
FR;0;2022-02-04;14423;66210;239097;1260;264104;54056849;50699386;33165581;106025;36272365
FR;0;2022-02-05;12578;51466;153481;522;172314;54069427;50750852;33319062;106547;36444679
FR;0;2022-02-06;2701;12264;28857;99;33819;54072128;50763116;33347919;106646;36478498
FR;0;2022-02-07;9196;46531;156767;582;176274;54081324;50809647;33504686;107228;36654772
FR;0;2022-02-08;9506;42474;166510;866;184266;54090830;50852121;33671196;108094;36839038
FR;0;2022-02-09;14072;57470;172233;864;192879;54104902;50909591;33843429;108958;37031917
FR;0;2022-02-10;8193;37888;150066;875;166453;54113095;50947479;33993495;109833;37198370
FR;0;2022-02-11;10716;55263;218356;1095;242908;54123811;51002742;34211851;110928;37441278
FR;0;2022-02-12;8308;40827;134660;461;151667;54132119;51043569;34346511;111389;37592945
FR;0;2022-02-13;1881;8560;26528;81;30882;54134000;51052129;34373039;111470;37623827
FR;0;2022-02-14;6852;35018;148240;478;166229;54140852;51087147;34521279;111948;37790056
FR;0;2022-02-15;6806;35270;146791;749;162310;54147658;51122417;34668070;112697;37952366
FR;0;2022-02-16;9244;42323;132374;715;146539;54156902;51164740;34800444;113412;38098905
FR;0;2022-02-17;5321;23420;87184;582;94680;54162223;51188160;34887628;113994;38193585
FR;0;2022-02-18;6828;33056;119528;800;129154;54169051;51221216;35007156;114794;38322739
FR;0;2022-02-19;5314;24405;69977;369;77270;54174365;51245621;35077133;115163;38400009
FR;0;2022-02-20;1129;4596;12135;38;13905;54175494;51250217;35089268;115201;38413914
FR;0;2022-02-21;3967;17706;61860;351;67074;54179461;51267923;35151128;115552;38480988
FR;0;2022-02-22;4314;18401;60734;571;64348;54183775;51286324;35211862;116123;38545336
FR;0;2022-02-23;6483;26965;66381;591;71758;54190258;51313289;35278243;116714;38617094
FR;0;2022-02-24;3702;14912;50309;513;53096;54193960;51328201;35328552;117227;38670190
FR;0;2022-02-25;5139;23348;76204;799;79902;54199099;51351549;35404756;118026;38750092
FR;0;2022-02-26;3950;17451;47350;354;51414;54203049;51369000;35452106;118380;38801506
FR;0;2022-02-27;859;2977;8009;47;8916;54203908;51371977;35460115;118427;38810422
FR;0;2022-02-28;3034;11993;40385;350;42808;54206942;51383970;35500500;118777;38853230
FR;0;2022-03-01;2951;11980;43826;417;44438;54209893;51395950;35544326;119194;38897668
FR;0;2022-03-02;4989;17317;46905;434;48805;54214882;51413267;35591231;119628;38946473
FR;0;2022-03-03;2576;8646;29551;337;29638;54217458;51421913;35620782;119965;38976111
FR;0;2022-03-04;3121;12046;40105;642;39222;54220579;51433959;35660887;120607;39015333
FR;0;2022-03-05;2868;9168;24853;304;24993;54223447;51443127;35685740;120911;39040326
FR;0;2022-03-06;490;1361;3174;42;3408;54223937;51444488;35688914;120953;39043734
FR;0;2022-03-07;1870;5395;18279;309;17539;54225807;51449883;35707193;121262;39061273
FR;0;2022-03-08;1900;5761;19219;351;17675;54227707;51455644;35726412;121613;39078948
FR;0;2022-03-09;3397;10093;21882;398;20968;54231104;51465737;35748294;122011;39099916
FR;0;2022-03-10;1634;4852;16367;326;15165;54232738;51470589;35764661;122337;39115081
FR;0;2022-03-11;2296;7191;24284;535;22027;54235034;51477780;35788945;122872;39137108
FR;0;2022-03-12;2618;6669;17051;302;16391;54237652;51484449;35805996;123174;39153499
FR;0;2022-03-13;373;762;2209;143;2159;54238025;51485211;35808205;123317;39155658
FR;0;2022-03-14;1417;4019;14595;4402;13455;54239442;51489230;35822800;127719;39169113
FR;0;2022-03-15;1533;4185;15577;7530;13656;54240975;51493415;35838377;135249;39182769
FR;0;2022-03-16;2873;6815;18164;13116;16855;54243848;51500230;35856541;148365;39199624
FR;0;2022-03-17;1329;3483;12222;10772;11044;54245177;51503713;35868763;159137;39210668
FR;0;2022-03-18;2135;5354;19450;18208;17509;54247312;51509067;35888213;177345;39228177
FR;0;2022-03-19;2240;4601;12965;9378;12252;54249552;51513668;35901178;186723;39240429
FR;0;2022-03-20;277;664;1728;1055;1729;54249829;51514332;35902906;187778;39242158
FR;0;2022-03-21;1305;2960;11258;14828;10493;54251134;51517292;35914164;202606;39252651
FR;0;2022-03-22;1395;3408;12887;20446;11640;54252529;51520700;35927051;223052;39264291
FR;0;2022-03-23;2543;5595;14649;22983;14017;54255072;51526295;35941700;246035;39278308
FR;0;2022-03-24;1269;2725;10541;17336;9595;54256341;51529020;35952241;263371;39287903
FR;0;2022-03-25;1956;4555;17452;27551;15786;54258297;51533575;35969693;290922;39303689
FR;0;2022-03-26;2177;4109;11707;12575;11127;54260474;51537684;35981400;303497;39314816
FR;0;2022-03-27;346;660;1832;1442;1861;54260820;51538344;35983232;304939;39316677
FR;0;2022-03-28;1358;2753;10212;17134;9686;54262178;51541097;35993444;322073;39326363
FR;0;2022-03-29;1370;3072;12157;26889;11297;54263548;51544169;36005601;348962;39337660
FR;0;2022-03-30;2713;5115;14543;26637;13912;54266261;51549284;36020144;375599;39351572
FR;0;2022-03-31;1466;2848;11555;22751;10853;54267727;51552132;36031699;398350;39362425
