fra;vaccin;jour;n_dose1;n_dose2;n_dose3;n_dose4;n_rappel;n_cum_dose1;n_cum_dose2;n_cum_dose3;n_cum_dose4;n_cum_rappel
FR;1;2020-12-27;610;0;0;0;0;610;0;0;0;0
FR;1;2020-12-28;686;1;0;0;0;1296;1;0;0;0
FR;1;2020-12-29;385;0;0;0;0;1681;1;0;0;0
FR;1;2020-12-30;444;0;0;0;0;2125;1;0;0;0
FR;1;2020-12-31;444;1;0;0;0;2569;2;0;0;0
FR;1;2021-01-01;1161;2;0;0;0;3730;4;0;0;0
FR;1;2021-01-02;365;3;0;0;0;4095;7;0;0;0
FR;1;2021-01-03;405;0;0;0;0;4500;7;0;0;0
FR;1;2021-01-04;2116;4;0;0;0;6616;11;0;0;0
FR;1;2021-01-05;7755;3;0;0;0;14371;14;0;0;0
FR;1;2021-01-06;12457;17;0;0;0;26828;31;0;0;0
FR;1;2021-01-07;29468;19;0;0;0;56296;50;0;0;0
FR;1;2021-01-08;37151;20;0;0;0;93447;70;0;0;0
FR;1;2021-01-09;11212;8;0;0;0;104659;78;0;0;0
FR;1;2021-01-10;6008;7;0;0;0;110667;85;0;0;0
FR;1;2021-01-11;39942;26;0;0;0;150609;111;0;0;0
FR;1;2021-01-12;62144;20;0;0;0;212753;131;0;0;0
FR;1;2021-01-13;65128;46;0;0;0;277881;177;0;0;0
FR;1;2021-01-14;81457;167;0;0;0;359338;344;0;0;0
FR;1;2021-01-15;68613;68;0;0;0;427951;412;0;0;0
FR;1;2021-01-16;19901;72;0;0;0;447852;484;0;0;0
FR;1;2021-01-17;10903;49;0;0;0;458755;533;0;0;0
FR;1;2021-01-18;82832;170;0;0;0;541587;703;0;0;0
FR;1;2021-01-19;125923;191;0;0;0;667510;894;0;0;0
FR;1;2021-01-20;132421;182;0;0;0;799931;1076;0;0;0
FR;1;2021-01-21;153065;176;0;0;0;952996;1252;0;0;0
FR;1;2021-01-22;115951;222;0;0;0;1068947;1474;0;0;0
FR;1;2021-01-23;36610;69;0;0;0;1105557;1543;0;0;0
FR;1;2021-01-24;9583;102;0;0;0;1115140;1645;0;0;0
FR;1;2021-01-25;74427;1349;0;0;0;1189567;2994;0;0;0
FR;1;2021-01-26;96456;3525;1;0;0;1286023;6519;1;0;0
FR;1;2021-01-27;103648;6193;0;0;0;1389671;12712;1;0;0
FR;1;2021-01-28;120610;15780;0;0;0;1510281;28492;1;0;0
FR;1;2021-01-29;88893;18311;0;0;0;1599174;46803;1;0;0
FR;1;2021-01-30;27994;4430;0;0;0;1627168;51233;1;0;0
FR;1;2021-01-31;5189;1832;0;0;0;1632357;53065;1;0;0
FR;1;2021-02-01;49728;22209;0;0;0;1682085;75274;1;0;0
FR;1;2021-02-02;67821;37068;0;0;0;1749906;112342;1;0;0
FR;1;2021-02-03;67087;39264;0;0;0;1816993;151606;1;0;0
FR;1;2021-02-04;77142;53474;0;0;0;1894135;205080;1;0;0
FR;1;2021-02-05;63424;47057;0;0;0;1957559;252137;1;0;0
FR;1;2021-02-06;19425;11146;0;0;0;1976984;263283;1;0;0
FR;1;2021-02-07;3666;5733;0;0;0;1980650;269016;1;0;0
FR;1;2021-02-08;36500;47934;0;0;0;2017150;316950;1;0;0
FR;1;2021-02-09;50809;76637;0;0;0;2067959;393587;1;0;0
FR;1;2021-02-10;52070;81368;0;0;0;2120029;474955;1;0;0
FR;1;2021-02-11;63381;103781;0;0;0;2183410;578736;1;0;0
FR;1;2021-02-12;55867;75218;0;0;0;2239277;653954;1;0;0
FR;1;2021-02-13;15463;19320;0;0;0;2254740;673274;1;0;0
FR;1;2021-02-14;3747;7342;0;0;0;2258487;680616;1;0;0
FR;1;2021-02-15;24157;73637;0;0;0;2282644;754253;1;0;0
FR;1;2021-02-16;32777;96229;0;0;0;2315421;850482;1;0;0
FR;1;2021-02-17;35127;101557;20;0;0;2350548;952039;21;0;0
FR;1;2021-02-18;49445;117311;0;0;0;2399993;1069350;21;0;0
FR;1;2021-02-19;45382;87316;1;0;0;2445375;1156666;22;0;0
FR;1;2021-02-20;13391;27160;0;0;0;2458766;1183826;22;0;0
FR;1;2021-02-21;2460;6074;0;0;0;2461226;1189900;22;0;0
FR;1;2021-02-22;24720;69402;2;0;0;2485946;1259302;24;0;0
FR;1;2021-02-23;37430;81411;1;0;0;2523376;1340713;25;0;0
FR;1;2021-02-24;40699;78956;1;0;0;2564075;1419669;26;0;0
FR;1;2021-02-25;50158;87985;1;0;0;2614233;1507654;27;0;0
FR;1;2021-02-26;47222;67650;1;0;0;2661455;1575304;28;0;0
FR;1;2021-02-27;15678;21219;1;0;0;2677133;1596523;29;0;0
FR;1;2021-02-28;3562;4169;2;0;0;2680695;1600692;31;0;0
FR;1;2021-03-01;40197;50075;1;0;0;2720892;1650767;32;0;0
FR;1;2021-03-02;55983;62342;3;0;0;2776875;1713109;35;0;0
FR;1;2021-03-03;61246;60591;0;0;0;2838121;1773700;35;0;0
FR;1;2021-03-04;73000;67644;3;0;0;2911121;1841344;38;0;0
FR;1;2021-03-05;74769;58746;3;0;0;2985890;1900090;41;0;0
FR;1;2021-03-06;82459;15812;2;0;0;3068349;1915902;43;0;0
FR;1;2021-03-07;63724;4364;1;0;0;3132073;1920266;44;0;0
FR;1;2021-03-08;60180;41467;2;0;0;3192253;1961733;46;0;0
FR;1;2021-03-09;85998;47721;1;0;0;3278251;2009454;47;0;0
FR;1;2021-03-10;90927;47856;5;0;0;3369178;2057310;52;0;0
FR;1;2021-03-11;105088;54511;1;0;0;3474266;2111821;53;0;0
FR;1;2021-03-12;104133;45012;1;0;0;3578399;2156833;54;0;0
FR;1;2021-03-13;89207;12624;1;0;0;3667606;2169457;55;0;0
FR;1;2021-03-14;44457;2767;1;0;0;3712063;2172224;56;0;0
FR;1;2021-03-15;95521;28297;3;0;0;3807584;2200521;59;0;0
FR;1;2021-03-16;123595;34321;5;0;0;3931179;2234842;64;0;0
FR;1;2021-03-17;129311;33762;4;0;0;4060490;2268604;68;0;0
FR;1;2021-03-18;142902;39341;5;0;0;4203392;2307945;73;0;0
FR;1;2021-03-19;136258;32238;2;0;0;4339650;2340183;75;0;0
FR;1;2021-03-20;76011;9830;1;0;0;4415661;2350013;76;0;0
FR;1;2021-03-21;26515;2098;1;0;0;4442176;2352111;77;0;0
FR;1;2021-03-22;114767;30458;2;0;0;4556943;2382569;79;0;0
FR;1;2021-03-23;143042;38049;1;0;0;4699985;2420618;80;0;0
FR;1;2021-03-24;142007;38443;0;0;0;4841992;2459061;80;0;0
FR;1;2021-03-25;165006;39771;4;0;0;5006998;2498832;84;0;0
FR;1;2021-03-26;166398;37506;5;1;0;5173396;2536338;89;1;0
FR;1;2021-03-27;110882;15431;1;0;0;5284278;2551769;90;1;0
FR;1;2021-03-28;42305;4261;3;0;0;5326583;2556030;93;1;0
FR;1;2021-03-29;129824;49237;4;0;0;5456407;2605267;97;1;0
FR;1;2021-03-30;167722;63717;5;0;0;5624129;2668984;102;1;0
FR;1;2021-03-31;170944;67697;4;0;0;5795073;2736681;106;1;0
FR;1;2021-04-01;194837;82990;10;0;0;5989910;2819671;116;1;0
FR;1;2021-04-02;164457;86192;7;0;0;6154367;2905863;123;1;0
FR;1;2021-04-03;88249;58106;6;0;0;6242616;2963969;129;1;0
FR;1;2021-04-04;33650;17730;0;0;0;6276266;2981699;129;1;0
FR;1;2021-04-05;46409;9731;11;0;0;6322675;2991430;140;1;0
FR;1;2021-04-06;160318;104373;17;0;0;6482993;3095803;157;1;0
FR;1;2021-04-07;196991;108075;16;0;0;6679984;3203878;173;1;0
FR;1;2021-04-08;222137;113681;13;0;0;6902121;3317559;186;1;0
FR;1;2021-04-09;214565;107807;21;0;0;7116686;3425366;207;1;0
FR;1;2021-04-10;117185;73210;14;0;0;7233871;3498576;221;1;0
FR;1;2021-04-11;40896;29944;6;0;0;7274767;3528520;227;1;0
FR;1;2021-04-12;168475;104405;46;0;0;7443242;3632925;273;1;0
FR;1;2021-04-13;203809;127896;97;1;0;7647051;3760821;370;2;0
FR;1;2021-04-14;208629;122786;208;0;0;7855680;3883607;578;2;0
FR;1;2021-04-15;221687;127823;312;0;0;8077367;4011430;890;2;0
FR;1;2021-04-16;206071;125441;309;0;0;8283438;4136871;1199;2;0
FR;1;2021-04-17;122092;67176;103;0;0;8405530;4204047;1302;2;0
FR;1;2021-04-18;35965;20969;41;0;0;8441495;4225016;1343;2;0
FR;1;2021-04-19;163756;121597;432;0;0;8605251;4346613;1775;2;0
FR;1;2021-04-20;189433;149380;531;0;0;8794684;4495993;2306;2;0
FR;1;2021-04-21;194006;147275;759;0;0;8988690;4643268;3065;2;0
FR;1;2021-04-22;209041;164002;777;0;0;9197731;4807270;3842;2;0
FR;1;2021-04-23;198960;157589;671;0;0;9396691;4964859;4513;2;0
FR;1;2021-04-24;126334;95699;148;0;0;9523025;5060558;4661;2;0
FR;1;2021-04-25;53631;30035;46;0;0;9576656;5090593;4707;2;0
FR;1;2021-04-26;181149;139451;542;0;0;9757805;5230044;5249;2;0
FR;1;2021-04-27;221373;162283;900;0;0;9979178;5392327;6149;2;0
FR;1;2021-04-28;238300;155713;1314;1;1;10217478;5548040;7463;3;1
FR;1;2021-04-29;270293;161051;1211;0;0;10487771;5709091;8674;3;1
FR;1;2021-04-30;271998;148582;1071;0;0;10759769;5857673;9745;3;1
FR;1;2021-05-01;141152;40594;173;0;0;10900921;5898267;9918;3;1
FR;1;2021-05-02;81550;28154;81;0;0;10982471;5926421;9999;3;1
FR;1;2021-05-03;250787;143741;803;0;0;11233258;6070162;10802;3;1
FR;1;2021-05-04;265882;187483;1200;0;0;11499140;6257645;12002;3;1
FR;1;2021-05-05;283883;185596;1267;0;0;11783023;6443241;13269;3;1
FR;1;2021-05-06;309971;183929;1501;0;0;12092994;6627170;14770;3;1
FR;1;2021-05-07;284104;196114;1126;0;0;12377098;6823284;15896;3;1
FR;1;2021-05-08;191661;50422;285;0;0;12568759;6873706;16181;3;1
FR;1;2021-05-09;114056;34963;236;0;0;12682815;6908669;16417;3;1
FR;1;2021-05-10;258212;194557;1186;0;0;12941027;7103226;17603;3;1
FR;1;2021-05-11;318890;210975;1465;0;0;13259917;7314201;19068;3;1
FR;1;2021-05-12;356630;185863;1399;0;0;13616547;7500064;20467;3;1
FR;1;2021-05-13;283448;47468;401;0;0;13899995;7547532;20868;3;1
FR;1;2021-05-14;370501;128522;994;0;0;14270496;7676054;21862;3;1
FR;1;2021-05-15;298091;66143;403;0;0;14568587;7742197;22265;3;1
FR;1;2021-05-16;157777;15485;158;0;0;14726364;7757682;22423;3;1
FR;1;2021-05-17;318932;116165;1441;0;0;15045296;7873847;23864;3;1
FR;1;2021-05-18;383335;111417;1799;0;0;15428631;7985264;25663;3;1
FR;1;2021-05-19;395271;102006;2183;0;0;15823902;8087270;27846;3;1
FR;1;2021-05-20;421809;95881;2048;0;0;16245711;8183151;29894;3;1
FR;1;2021-05-21;399806;97281;1764;0;0;16645517;8280432;31658;3;1
FR;1;2021-05-22;275688;41912;602;0;0;16921205;8322344;32260;3;1
FR;1;2021-05-23;123013;11026;224;0;0;17044218;8333370;32484;3;1
FR;1;2021-05-24;244011;26249;569;0;0;17288229;8359619;33053;3;1
FR;1;2021-05-25;366224;131558;2114;1;0;17654453;8491177;35167;4;1
FR;1;2021-05-26;380815;126690;1993;0;0;18035268;8617867;37160;4;1
FR;1;2021-05-27;406151;128101;1977;0;0;18441419;8745968;39137;4;1
FR;1;2021-05-28;366029;145426;1700;0;0;18807448;8891394;40837;4;1
FR;1;2021-05-29;253830;80973;527;0;0;19061278;8972367;41364;4;1
FR;1;2021-05-30;100974;22574;157;0;0;19162252;8994941;41521;4;1
FR;1;2021-05-31;314317;148955;1282;1;1;19476569;9143896;42803;5;2
FR;1;2021-06-01;361632;166555;1727;1;1;19838201;9310451;44530;6;3
FR;1;2021-06-02;365390;153842;1796;0;0;20203591;9464293;46326;6;3
FR;1;2021-06-03;391422;147470;1653;0;0;20595013;9611763;47979;6;3
FR;1;2021-06-04;364116;175674;1495;1;1;20959129;9787437;49474;7;4
FR;1;2021-06-05;258510;112709;596;0;0;21217639;9900146;50070;7;4
FR;1;2021-06-06;126809;37542;215;0;0;21344448;9937688;50285;7;4
FR;1;2021-06-07;301105;207788;1365;0;0;21645553;10145476;51650;7;4
FR;1;2021-06-08;330842;220860;1642;0;0;21976395;10366336;53292;7;4
FR;1;2021-06-09;336587;211619;1612;0;0;22312982;10577955;54904;7;4
FR;1;2021-06-10;343893;201156;1613;0;0;22656875;10779111;56517;7;4
FR;1;2021-06-11;311897;234851;1299;1;0;22968772;11013962;57816;8;4
FR;1;2021-06-12;244079;150623;436;0;0;23212851;11164585;58252;8;4
FR;1;2021-06-13;100368;61000;188;0;0;23313219;11225585;58440;8;4
FR;1;2021-06-14;207847;288025;1318;1;0;23521066;11513610;59758;9;4
FR;1;2021-06-15;256859;281598;1397;1;0;23777925;11795208;61155;10;4
FR;1;2021-06-16;273649;270585;1263;1;0;24051574;12065793;62418;11;4
FR;1;2021-06-17;268218;244881;1236;1;0;24319792;12310674;63654;12;4
FR;1;2021-06-18;260599;295438;1153;1;0;24580391;12606112;64807;13;4
FR;1;2021-06-19;193452;209509;388;0;0;24773843;12815621;65195;13;4
FR;1;2021-06-20;69709;89100;120;0;0;24843552;12904721;65315;13;4
FR;1;2021-06-21;172373;319727;933;1;1;25015925;13224448;66248;14;5
FR;1;2021-06-22;185867;347901;1102;10;1;25201792;13572349;67350;24;6
FR;1;2021-06-23;204202;339517;1049;0;0;25405994;13911866;68399;24;6
FR;1;2021-06-24;203530;282053;1174;0;0;25609524;14193919;69573;24;6
FR;1;2021-06-25;182664;371770;1198;0;0;25792188;14565689;70771;24;6
FR;1;2021-06-26;131395;278400;504;0;0;25923583;14844089;71275;24;6
FR;1;2021-06-27;52408;122901;145;0;0;25975991;14966990;71420;24;6
FR;1;2021-06-28;136656;368208;1064;0;0;26112647;15335198;72484;24;6
FR;1;2021-06-29;154894;390953;1848;0;0;26267541;15726151;74332;24;6
FR;1;2021-06-30;180055;381934;1666;4;2;26447596;16108085;75998;28;8
FR;1;2021-07-01;201475;332319;1887;5;1;26649071;16440404;77885;33;9
FR;1;2021-07-02;193884;367449;1765;5;2;26842955;16807853;79650;38;11
FR;1;2021-07-03;124476;280425;704;3;1;26967431;17088278;80354;41;12
FR;1;2021-07-04;53964;113699;244;0;0;27021395;17201977;80598;41;12
FR;1;2021-07-05;153961;355920;1500;8;2;27175356;17557897;82098;49;14
FR;1;2021-07-06;173505;382366;1603;45;8;27348861;17940263;83701;94;22
FR;1;2021-07-07;190833;362483;1658;25;4;27539694;18302746;85359;119;26
FR;1;2021-07-08;201566;323074;1826;20;6;27741260;18625820;87185;139;32
FR;1;2021-07-09;189978;387802;1854;3;2;27931238;19013622;89039;142;34
FR;1;2021-07-10;129954;281160;816;1;1;28061192;19294782;89855;143;35
FR;1;2021-07-11;57678;102528;262;0;0;28118870;19397310;90117;143;35
FR;1;2021-07-12;149913;416925;1584;4;0;28268783;19814235;91701;147;35
FR;1;2021-07-13;234276;439250;1806;8;1;28503059;20253485;93507;155;36
FR;1;2021-07-14;171920;151426;418;0;0;28674979;20404911;93925;155;36
FR;1;2021-07-15;279681;424459;1858;1;0;28954660;20829370;95783;156;36
FR;1;2021-07-16;290436;400863;1711;3;1;29245096;21230233;97494;159;37
FR;1;2021-07-17;217346;282038;755;1;0;29462442;21512271;98249;160;37
FR;1;2021-07-18;102002;107226;288;0;0;29564444;21619497;98537;160;37
FR;1;2021-07-19;238205;378710;1497;3;0;29802649;21998207;100034;163;37
FR;1;2021-07-20;305755;380176;1469;0;0;30108404;22378383;101503;163;37
FR;1;2021-07-21;333279;352982;1412;4;2;30441683;22731365;102915;167;39
FR;1;2021-07-22;364677;318810;1502;3;2;30806360;23050175;104417;170;41
FR;1;2021-07-23;349400;343140;1588;4;1;31155760;23393315;106005;174;42
FR;1;2021-07-24;238960;240819;697;1;0;31394720;23634134;106702;175;42
FR;1;2021-07-25;112800;76019;223;0;0;31507520;23710153;106925;175;42
FR;1;2021-07-26;299138;289591;1495;2;2;31806658;23999744;108420;177;44
FR;1;2021-07-27;385833;268155;1459;4;2;32192491;24267899;109879;181;46
FR;1;2021-07-28;390199;251083;1462;4;1;32582690;24518982;111341;185;47
FR;1;2021-07-29;406135;227866;1540;2;0;32988825;24746848;112881;187;47
FR;1;2021-07-30;370739;246689;1638;4;1;33359564;24993537;114519;191;48
FR;1;2021-07-31;243383;165111;793;1;0;33602947;25158648;115312;192;48
FR;1;2021-08-01;105589;47210;233;0;0;33708536;25205858;115545;192;48
FR;1;2021-08-02;297402;212947;1479;2;0;34005938;25418805;117024;194;48
FR;1;2021-08-03;331333;208851;1557;2;1;34337271;25627656;118581;196;49
FR;1;2021-08-04;328032;184002;1439;5;3;34665303;25811658;120020;201;52
FR;1;2021-08-05;301279;193268;1482;0;0;34966582;26004926;121502;201;52
FR;1;2021-08-06;290980;224263;1560;3;1;35257562;26229189;123062;204;53
FR;1;2021-08-07;182662;158795;654;5;2;35440224;26387984;123716;209;55
FR;1;2021-08-08;68887;59105;252;0;0;35509111;26447089;123968;209;55
FR;1;2021-08-09;222785;235405;1444;4;3;35731896;26682494;125412;213;58
FR;1;2021-08-10;252738;240122;1492;2;1;35984634;26922616;126904;215;59
FR;1;2021-08-11;236231;231925;1271;5;1;36220865;27154541;128175;220;60
FR;1;2021-08-12;220783;239917;1487;3;0;36441648;27394458;129662;223;60
FR;1;2021-08-13;201720;238586;1360;2;2;36643368;27633044;131022;225;62
FR;1;2021-08-14;122861;174061;646;0;0;36766229;27807105;131668;225;62
FR;1;2021-08-15;34704;46123;200;1;0;36800933;27853228;131868;226;62
FR;1;2021-08-16;156963;289519;1423;0;0;36957896;28142747;133291;226;62
FR;1;2021-08-17;171612;291167;1422;5;0;37129508;28433914;134713;231;62
FR;1;2021-08-18;161431;286823;1392;6;3;37290939;28720737;136105;237;65
FR;1;2021-08-19;148947;277543;1403;1;0;37439886;28998280;137508;238;65
FR;1;2021-08-20;140507;309055;1532;2;2;37580393;29307335;139040;240;67
FR;1;2021-08-21;84275;213209;589;0;0;37664668;29520544;139629;240;67
FR;1;2021-08-22;28580;82693;233;0;0;37693248;29603237;139862;240;67
FR;1;2021-08-23;118661;321029;1422;2;1;37811909;29924266;141284;242;68
FR;1;2021-08-24;126664;319737;1603;5;1;37938573;30244003;142887;247;69
FR;1;2021-08-25;121527;306506;1779;8;2;38060100;30550509;144666;255;71
FR;1;2021-08-26;106630;286116;2161;10;0;38166730;30836625;146827;265;71
FR;1;2021-08-27;107654;321665;2301;9;3;38274384;31158290;149128;274;74
FR;1;2021-08-28;71020;220699;1101;0;0;38345404;31378989;150229;274;74
FR;1;2021-08-29;24151;78191;469;1;0;38369555;31457180;150698;275;74
FR;1;2021-08-30;96895;286357;4312;6;5006;38466450;31743537;155010;281;5080
FR;1;2021-08-31;98116;276302;9294;15;10098;38564566;32019839;164304;296;15178
FR;1;2021-09-01;112344;245327;21118;7;22133;38676910;32265166;185422;303;37311
FR;1;2021-09-02;86769;197939;24528;18;25501;38763679;32463105;209950;321;62812
FR;1;2021-09-03;82421;227541;26953;21;28027;38846100;32690646;236903;342;90839
FR;1;2021-09-04;71630;189719;11141;11;11691;38917730;32880365;248044;353;102530
FR;1;2021-09-05;18613;41157;4124;2;4278;38936343;32921522;252168;355;106808
FR;1;2021-09-06;59808;151483;30181;15;31196;38996151;33073005;282349;370;138004
FR;1;2021-09-07;57395;139678;30209;30;31213;39053546;33212683;312558;400;169217
FR;1;2021-09-08;72339;173798;26925;22;27926;39125885;33386481;339483;422;197143
FR;1;2021-09-09;54483;124478;28621;24;29709;39180368;33510959;368104;446;226852
FR;1;2021-09-10;66214;152096;30449;24;31650;39246582;33663055;398553;470;258502
FR;1;2021-09-11;52687;146632;9729;14;10341;39299269;33809687;408282;484;268843
FR;1;2021-09-12;10796;29273;2486;1;2649;39310065;33838960;410768;485;271492
FR;1;2021-09-13;51507;104471;38750;31;40031;39361572;33943431;449518;516;311523
FR;1;2021-09-14;53340;96032;51277;67;53144;39414912;34039463;500795;583;364667
FR;1;2021-09-15;60569;139266;50491;55;47045;39475481;34178729;551286;638;411712
FR;1;2021-09-16;46632;81414;53344;70;49578;39522113;34260143;604630;708;461290
FR;1;2021-09-17;53220;109354;45068;61;42677;39575333;34369497;649698;769;503967
FR;1;2021-09-18;37876;118497;11796;19;11274;39613209;34487994;661494;788;515241
FR;1;2021-09-19;6531;21040;2040;1;1983;39619740;34509034;663534;789;517224
FR;1;2021-09-20;36535;74880;46226;65;44178;39656275;34583914;709760;854;561402
FR;1;2021-09-21;34187;68138;56260;70;52705;39690462;34652052;766020;924;614107
FR;1;2021-09-22;38826;118614;49871;76;46896;39729288;34770666;815891;1000;661003
FR;1;2021-09-23;32024;62921;54498;85;50890;39761312;34833587;870389;1085;711893
FR;1;2021-09-24;36782;90056;43665;89;41927;39798094;34923643;914054;1174;753820
FR;1;2021-09-25;27647;96702;12305;27;12180;39825741;35020345;926359;1201;766000
FR;1;2021-09-26;4378;15195;1774;5;1696;39830119;35035540;928133;1206;767696
FR;1;2021-09-27;27350;60228;42911;89;41632;39857469;35095768;971044;1295;809328
FR;1;2021-09-28;26911;49455;47191;76;44458;39884380;35145223;1018235;1371;853786
FR;1;2021-09-29;35922;80331;47275;87;45582;39920302;35225554;1065510;1458;899368
FR;1;2021-09-30;26072;46896;47523;81;45445;39946374;35272450;1113033;1539;944813
FR;1;2021-10-01;47294;66959;44889;83;44589;39993668;35339409;1157922;1622;989402
FR;1;2021-10-02;32383;62417;16112;32;16317;40026051;35401826;1174034;1654;1005719
FR;1;2021-10-03;4342;8561;2039;3;2033;40030393;35410387;1176073;1657;1007752
FR;1;2021-10-04;28970;44443;47102;79;46957;40059363;35454830;1223175;1736;1054709
FR;1;2021-10-05;24566;41665;49881;116;49311;40083929;35496495;1273056;1852;1104020
FR;1;2021-10-06;34651;61407;57497;102;57229;40118580;35557902;1330553;1954;1161249
FR;1;2021-10-07;21077;39913;53040;75;51963;40139657;35597815;1383593;2029;1213212
FR;1;2021-10-08;35659;59661;60394;83;61132;40175316;35657476;1443987;2112;1274344
FR;1;2021-10-09;27463;48014;25495;29;26017;40202779;35705490;1469482;2141;1300361
FR;1;2021-10-10;3722;5811;2754;7;2861;40206501;35711301;1472236;2148;1303222
FR;1;2021-10-11;24852;38247;54582;88;55253;40231353;35749548;1526818;2236;1358475
FR;1;2021-10-12;23374;36594;58067;127;59193;40254727;35786142;1584885;2363;1417668
FR;1;2021-10-13;32960;47844;64166;124;65678;40287687;35833986;1649051;2487;1483346
FR;1;2021-10-14;21710;34797;53761;103;54347;40309397;35868783;1702812;2590;1537693
FR;1;2021-10-15;32746;48801;72326;165;74997;40342143;35917584;1775138;2755;1612690
FR;1;2021-10-16;26009;35301;34867;44;36411;40368152;35952885;1810005;2799;1649101
FR;1;2021-10-17;3155;4050;3413;2;3316;40371307;35956935;1813418;2801;1652417
FR;1;2021-10-18;24260;34892;66832;131;69702;40395567;35991827;1880250;2932;1722119
FR;1;2021-10-19;20685;35580;75655;135;79560;40416252;36027407;1955905;3067;1801679
FR;1;2021-10-20;29882;44238;96174;178;99848;40446134;36071645;2052079;3245;1901527
FR;1;2021-10-21;19777;35062;83174;107;87017;40465911;36106707;2135253;3352;1988544
FR;1;2021-10-22;29729;47790;103735;196;109679;40495640;36154497;2238988;3548;2098223
FR;1;2021-10-23;23031;35143;44867;57;47375;40518671;36189640;2283855;3605;2145598
FR;1;2021-10-24;2381;3843;3582;6;3723;40521052;36193483;2287437;3611;2149321
FR;1;2021-10-25;22482;30765;82017;143;85807;40543534;36224248;2369454;3754;2235128
FR;1;2021-10-26;19332;27681;86103;162;90325;40562866;36251929;2455557;3916;2325453
FR;1;2021-10-27;26192;39644;107802;252;112693;40589058;36291573;2563359;4168;2438146
FR;1;2021-10-28;18779;27142;86949;150;91687;40607837;36318715;2650308;4318;2529833
FR;1;2021-10-29;25926;40283;114822;201;121618;40633763;36358998;2765130;4519;2651451
FR;1;2021-10-30;17693;28723;49361;74;51949;40651456;36387721;2814491;4593;2703400
FR;1;2021-10-31;2060;3174;3449;2;3685;40653516;36390895;2817940;4595;2707085
FR;1;2021-11-01;7983;4266;3027;3;3285;40661499;36395161;2820967;4598;2710370
FR;1;2021-11-02;22883;33244;92392;156;97814;40684382;36428405;2913359;4754;2808184
FR;1;2021-11-03;26604;41601;117499;215;123861;40710986;36470006;3030858;4969;2932045
FR;1;2021-11-04;19599;30334;105801;213;111928;40730585;36500340;3136659;5182;3043973
FR;1;2021-11-05;27008;42343;138771;229;147419;40757593;36542683;3275430;5411;3191392
FR;1;2021-11-06;18847;29833;63479;123;66486;40776440;36572516;3338909;5534;3257878
FR;1;2021-11-07;1810;3289;4974;6;5302;40778250;36575805;3343883;5540;3263180
FR;1;2021-11-08;17845;32274;125996;224;132618;40796095;36608079;3469879;5764;3395798
FR;1;2021-11-09;19486;37666;159289;334;169072;40815581;36645745;3629168;6098;3564870
FR;1;2021-11-10;28865;49166;181892;440;192499;40844446;36694911;3811060;6538;3757369
FR;1;2021-11-11;4170;5945;12225;26;13017;40848616;36700856;3823285;6564;3770386
FR;1;2021-11-12;26009;46882;174807;244;186473;40874625;36747738;3998092;6808;3956859
FR;1;2021-11-13;18729;29175;76828;111;81769;40893354;36776913;4074920;6919;4038628
FR;1;2021-11-14;2043;3261;6820;5;7357;40895397;36780174;4081740;6924;4045985
FR;1;2021-11-15;18758;34820;156412;304;166232;40914155;36814994;4238152;7228;4212217
FR;1;2021-11-16;21348;37933;192111;379;204977;40935503;36852927;4430263;7607;4417194
FR;1;2021-11-17;28646;45629;193221;398;205021;40964149;36898556;4623484;8005;4622215
FR;1;2021-11-18;21128;39565;182486;458;194536;40985277;36938121;4805970;8463;4816751
FR;1;2021-11-19;30877;53405;230235;532;246700;41016154;36991526;5036205;8995;5063451
FR;1;2021-11-20;23759;33245;96982;201;103611;41039913;37024771;5133187;9196;5167062
FR;1;2021-11-21;2328;3927;9111;19;9938;41042241;37028698;5142298;9215;5177000
FR;1;2021-11-22;21409;30410;175892;465;189427;41063650;37059108;5318190;9680;5366427
FR;1;2021-11-23;24015;41059;221178;540;237910;41087665;37100167;5539368;10220;5604337
FR;1;2021-11-24;30284;49749;217333;701;234493;41117949;37149916;5756701;10921;5838830
FR;1;2021-11-25;23719;44106;244458;718;264114;41141668;37194022;6001159;11639;6102944
FR;1;2021-11-26;30624;66758;356792;835;388521;41172292;37260780;6357951;12474;6491465
FR;1;2021-11-27;21945;45356;202615;371;222620;41194237;37306136;6560566;12845;6714085
FR;1;2021-11-28;3168;9613;54783;63;61015;41197405;37315749;6615349;12908;6775100
FR;1;2021-11-29;17880;49547;326364;840;354435;41215285;37365296;6941713;13748;7129535
FR;1;2021-11-30;22785;64958;431125;952;470749;41238070;37430254;7372838;14700;7600284
FR;1;2021-12-01;25338;69307;442870;1130;481738;41263408;37499561;7815708;15830;8082022
FR;1;2021-12-02;20067;64572;489370;1228;532874;41283475;37564133;8305078;17058;8614896
FR;1;2021-12-03;22898;82571;542757;1309;591765;41306373;37646704;8847835;18367;9206661
FR;1;2021-12-04;16395;53944;299082;652;328930;41322768;37700648;9146917;19019;9535591
FR;1;2021-12-05;3633;13854;81521;143;91051;41326401;37714502;9228438;19162;9626642
FR;1;2021-12-06;25820;62662;415428;1065;455162;41352221;37777164;9643866;20227;10081804
FR;1;2021-12-07;19999;75650;522946;1535;572544;41372220;37852814;10166812;21762;10654348
FR;1;2021-12-08;21700;75767;458385;1544;502095;41393920;37928581;10625197;23306;11156443
FR;1;2021-12-09;19446;74086;492910;1625;540847;41413366;38002667;11118107;24931;11697290
FR;1;2021-12-10;23305;87743;547376;1585;600011;41436671;38090410;11665483;26516;12297301
FR;1;2021-12-11;16534;59230;302737;749;335480;41453205;38149640;11968220;27265;12632781
FR;1;2021-12-12;4372;15959;83211;179;94044;41457577;38165599;12051431;27444;12726825
FR;1;2021-12-13;15750;63650;366957;1094;406239;41473327;38229249;12418388;28538;13133064
FR;1;2021-12-14;20853;80375;464729;1746;515196;41494180;38309624;12883117;30284;13648260
FR;1;2021-12-15;21606;77530;409058;1309;453127;41515786;38387154;13292175;31593;14101387
FR;1;2021-12-16;20041;77367;451841;1578;500605;41535827;38464521;13744016;33171;14601992
FR;1;2021-12-17;22612;86653;479920;1735;530963;41558439;38551174;14223936;34906;15132955
FR;1;2021-12-18;17600;54698;257608;730;288512;41576039;38605872;14481544;35636;15421467
FR;1;2021-12-19;5549;17028;79171;194;90709;41581588;38622900;14560715;35830;15512176
FR;1;2021-12-20;20932;63167;316221;1080;355298;41602520;38686067;14876936;36910;15867474
FR;1;2021-12-21;26326;73125;372724;1423;418077;41628846;38759192;15249660;38333;16285551
FR;1;2021-12-22;24977;65924;310618;1216;349591;41653823;38825116;15560278;39549;16635142
FR;1;2021-12-23;21268;52313;241479;956;273034;41675091;38877429;15801757;40505;16908176
FR;1;2021-12-24;7123;18350;67152;258;77064;41682214;38895779;15868909;40763;16985240
FR;1;2021-12-25;506;2873;5584;15;6538;41682720;38898652;15874493;40778;16991778
FR;1;2021-12-26;2748;7591;26934;71;31456;41685468;38906243;15901427;40849;17023234
FR;1;2021-12-27;18305;53593;235103;705;265758;41703773;38959836;16136530;41554;17288992
FR;1;2021-12-28;23295;62042;292029;1026;330210;41727068;39021878;16428559;42580;17619202
FR;1;2021-12-29;22215;55558;254988;920;288209;41749283;39077436;16683547;43500;17907411
FR;1;2021-12-30;21239;46563;212155;858;239630;41770522;39123999;16895702;44358;18147041
FR;1;2021-12-31;7465;16599;61868;229;70408;41777987;39140598;16957570;44587;18217449
FR;1;2022-01-01;1154;2486;5656;30;6574;41779141;39143084;16963226;44617;18224023
FR;1;2022-01-02;3081;8060;28889;50;33523;41782222;39151144;16992115;44667;18257546
FR;1;2022-01-03;24382;54271;228229;786;257700;41806604;39205415;17220344;45453;18515246
FR;1;2022-01-04;26046;65102;299247;1238;337286;41832650;39270517;17519591;46691;18852532
FR;1;2022-01-05;30434;64359;274867;1099;310235;41863084;39334876;17794458;47790;19162767
FR;1;2022-01-06;26809;66269;306878;1399;346526;41889893;39401145;18101336;49189;19509293
FR;1;2022-01-07;31558;75087;349828;1538;393977;41921451;39476232;18451164;50727;19903270
FR;1;2022-01-08;23386;51399;222490;698;251116;41944837;39527631;18673654;51425;20154386
FR;1;2022-01-09;7088;17146;66023;163;76140;41951925;39544777;18739677;51588;20230526
FR;1;2022-01-10;21776;60717;236795;954;267628;41973701;39605494;18976472;52542;20498154
FR;1;2022-01-11;26755;63517;282280;1277;317811;42000456;39669011;19258752;53819;20815965
FR;1;2022-01-12;28930;62550;246247;1105;278027;42029386;39731561;19504999;54924;21093992
FR;1;2022-01-13;24757;60247;262791;1253;296125;42054143;39791808;19767790;56177;21390117
FR;1;2022-01-14;27962;66782;313994;1366;351263;42082105;39858590;20081784;57543;21741380
FR;1;2022-01-15;19359;44442;199306;619;223860;42101464;39903032;20281090;58162;21965240
FR;1;2022-01-16;5156;12996;51526;135;59567;42106620;39916028;20332616;58297;22024807
FR;1;2022-01-17;16861;39794;184820;781;206845;42123481;39955822;20517436;59078;22231652
FR;1;2022-01-18;19447;46001;212414;1154;237039;42142928;40001823;20729850;60232;22468691
FR;1;2022-01-19;20300;44004;176102;897;197192;42163228;40045827;20905952;61129;22665883
FR;1;2022-01-20;16835;40631;183670;1137;204743;42180063;40086458;21089622;62266;22870626
FR;1;2022-01-21;19912;47101;228943;1405;253345;42199975;40133559;21318565;63671;23123971
FR;1;2022-01-22;13841;33362;144491;578;161384;42213816;40166921;21463056;64249;23285355
FR;1;2022-01-23;3371;8777;33425;132;38322;42217187;40175698;21496481;64381;23323677
FR;1;2022-01-24;11804;32987;142206;709;158251;42228991;40208685;21638687;65090;23481928
FR;1;2022-01-25;14209;38237;163397;1047;181565;42243200;40246922;21802084;66137;23663493
FR;1;2022-01-26;14860;37678;150250;932;166350;42258060;40284600;21952334;67069;23829843
FR;1;2022-01-27;12332;33263;143450;889;157987;42270392;40317863;22095784;67958;23987830
FR;1;2022-01-28;16319;56830;198310;1143;222424;42286711;40374693;22294094;69101;24210254
FR;1;2022-01-29;10268;35503;135203;524;151545;42296979;40410196;22429297;69625;24361799
FR;1;2022-01-30;2482;9277;29681;86;34462;42299461;40419473;22458978;69711;24396261
FR;1;2022-01-31;8758;32506;104336;533;117384;42308219;40451979;22563314;70244;24513645
FR;1;2022-02-01;10968;36516;127069;864;141263;42319187;40488495;22690383;71108;24654908
FR;1;2022-02-02;11970;41628;130346;782;145846;42331157;40530123;22820729;71890;24800754
FR;1;2022-02-03;9233;34031;117007;784;130358;42340390;40564154;22937736;72674;24931112
FR;1;2022-02-04;11519;48194;172577;967;192776;42351909;40612348;23110313;73641;25123888
FR;1;2022-02-05;7995;33956;117579;391;133050;42359904;40646304;23227892;74032;25256938
FR;1;2022-02-06;1704;8011;22750;85;26912;42361608;40654315;23250642;74117;25283850
FR;1;2022-02-07;7308;35435;119080;457;134965;42368916;40689750;23369722;74574;25418815
FR;1;2022-02-08;7755;31935;125637;693;140625;42376671;40721685;23495359;75267;25559440
FR;1;2022-02-09;8651;36513;135246;697;152491;42385322;40758198;23630605;75964;25711931
FR;1;2022-02-10;7018;30033;116369;674;130155;42392340;40788231;23746974;76638;25842086
FR;1;2022-02-11;8654;41532;165135;878;185358;42400994;40829763;23912109;77516;26027444
FR;1;2022-02-12;5325;27602;106702;379;120887;42406319;40857365;24018811;77895;26148331
FR;1;2022-02-13;1230;5717;21717;66;25333;42407549;40863082;24040528;77961;26173664
FR;1;2022-02-14;5453;27208;118075;392;133102;42413002;40890290;24158603;78353;26306766
FR;1;2022-02-15;5778;28847;118917;610;132549;42418780;40919137;24277520;78963;26439315
FR;1;2022-02-16;5751;28473;110415;596;123047;42424531;40947610;24387935;79559;26562362
FR;1;2022-02-17;4609;19722;73136;487;80241;42429140;40967332;24461071;80046;26642603
FR;1;2022-02-18;5605;26778;99197;670;108156;42434745;40994110;24560268;80716;26750759
FR;1;2022-02-19;3550;17173;59474;304;66055;42438295;41011283;24619742;81020;26816814
FR;1;2022-02-20;789;3252;10705;36;12332;42439084;41014535;24630447;81056;26829146
FR;1;2022-02-21;3422;14585;52823;286;57669;42442506;41029120;24683270;81342;26886815
FR;1;2022-02-22;3789;15529;51911;500;55648;42446295;41044649;24735181;81842;26942463
FR;1;2022-02-23;4230;17808;57469;508;62570;42450525;41062457;24792650;82350;27005033
FR;1;2022-02-24;3341;13052;43612;436;46401;42453866;41075509;24836262;82786;27051434
FR;1;2022-02-25;4470;19875;64920;696;68791;42458336;41095384;24901182;83482;27120225
FR;1;2022-02-26;2693;12799;41368;310;45121;42461029;41108183;24942550;83792;27165346
FR;1;2022-02-27;644;2188;7127;42;7992;42461673;41110371;24949677;83834;27173338
FR;1;2022-02-28;2612;10475;34954;306;37379;42464285;41120846;24984631;84140;27210717
FR;1;2022-03-01;3536;10747;38695;390;39650;42467821;41131593;25023326;84530;27250367
FR;1;2022-03-02;3658;12176;41852;397;43922;42471479;41143769;25065178;84927;27294289
FR;1;2022-03-03;2450;7967;26174;326;26512;42473929;41151736;25091352;85253;27320801
FR;1;2022-03-04;2685;10443;35429;590;34923;42476614;41162179;25126781;85843;27355724
FR;1;2022-03-05;1819;6357;21964;277;22360;42478433;41168536;25148745;86120;27378084
FR;1;2022-03-06;358;955;2916;38;3119;42478791;41169491;25151661;86158;27381203
FR;1;2022-03-07;1737;4712;16433;245;15900;42480528;41174203;25168094;86403;27397103
FR;1;2022-03-08;1671;5252;17166;308;15993;42482199;41179455;25185260;86711;27413096
FR;1;2022-03-09;1979;6678;19804;368;19164;42484178;41186133;25205064;87079;27432260
FR;1;2022-03-10;1404;4959;15274;307;14313;42485582;41191092;25220338;87386;27446573
FR;1;2022-03-11;1752;6397;21702;483;19855;42487334;41197489;25242040;87869;27466428
FR;1;2022-03-12;1238;4649;15359;280;14909;42488572;41202138;25257399;88149;27481337
FR;1;2022-03-13;245;610;2119;119;2064;42488817;41202748;25259518;88268;27483401
FR;1;2022-03-14;1140;3673;13399;3879;12521;42489957;41206421;25272917;92147;27495922
FR;1;2022-03-15;1387;5725;14650;6862;13246;42491344;41212146;25287567;99009;27509168
FR;1;2022-03-16;1684;5067;17391;11517;16454;42493028;41217213;25304958;110526;27525622
FR;1;2022-03-17;1170;3430;11723;9648;10821;42494198;41220643;25316681;120174;27536443
FR;1;2022-03-18;1724;4924;17962;16502;16400;42495922;41225567;25334643;136676;27552843
FR;1;2022-03-19;1122;3298;11889;8455;11357;42497044;41228865;25346532;145131;27564200
FR;1;2022-03-20;224;558;1724;1014;1758;42497268;41229423;25348256;146145;27565958
FR;1;2022-03-21;1086;2759;11492;13448;10840;42498354;41232182;25359748;159593;27576798
FR;1;2022-03-22;1228;3205;12253;18701;11243;42499582;41235387;25372001;178294;27588041
FR;1;2022-03-23;1501;4340;16024;20110;15707;42501083;41239727;25388025;198404;27603748
FR;1;2022-03-24;1113;2747;10393;16049;9655;42502196;41242474;25398418;214453;27613403
FR;1;2022-03-25;1533;4353;16739;25299;15392;42503729;41246827;25415157;239752;27628795
FR;1;2022-03-26;1107;3011;10854;11450;10515;42504836;41249838;25426011;251202;27639310
FR;1;2022-03-27;233;543;1749;1381;1802;42505069;41250381;25427760;252583;27641112
FR;1;2022-03-28;1079;2482;9973;15883;9596;42506148;41252863;25437733;268466;27650708
FR;1;2022-03-29;1139;2738;11550;25087;10913;42507287;41255601;25449283;293553;27661621
FR;1;2022-03-30;1625;3583;14164;24170;13695;42508912;41259184;25463447;317723;27675316
FR;1;2022-03-31;1278;3009;11687;22635;11195;42510190;41262193;25475134;340358;27686511
FR;1;2022-04-01;2228;4018;18459;28507;17330;42512418;41266211;25493593;368865;27703841
FR;1;2022-04-02;908;1880;8189;9220;7936;42513326;41268091;25501782;378085;27711777
FR;1;2022-04-03;200;379;1432;1056;1433;42513526;41268470;25503214;379141;27713210
FR;1;2022-04-04;1814;2454;11363;17657;10752;42515340;41270924;25514577;396798;27723962
FR;1;2022-04-05;1612;2692;12994;31171;12019;42516952;41273616;25527571;427969;27735981
FR;1;2022-04-06;1609;2973;12195;23913;11625;42518561;41276589;25539766;451882;27747606
FR;1;2022-04-07;1268;2699;12340;31055;11806;42519829;41279288;25552106;482937;27759412
FR;1;2022-04-08;1609;3606;17551;40576;16458;42521438;41282894;25569657;523513;27775870
FR;1;2022-04-09;817;1992;8403;12496;8101;42522255;41284886;25578060;536009;27783971
FR;1;2022-04-10;197;557;1834;1852;1878;42522452;41285443;25579894;537861;27785849
FR;1;2022-04-11;1057;2232;10963;22319;10673;42523509;41287675;25590857;560180;27796522
FR;1;2022-04-12;1298;2614;12817;38103;12304;42524807;41290289;25603674;598283;27808826
FR;1;2022-04-13;1252;2840;12268;30603;11996;42526059;41293129;25615942;628886;27820822
FR;1;2022-04-14;1219;2508;12083;33562;12087;42527278;41295637;25628025;662448;27832909
FR;1;2022-04-15;1480;2931;14389;33201;13765;42528758;41298568;25642414;695649;27846674
FR;1;2022-04-16;658;1403;5840;7985;5765;42529416;41299971;25648254;703634;27852439
FR;1;2022-04-17;155;283;929;1119;974;42529571;41300254;25649183;704753;27853413
FR;1;2022-04-18;164;464;2632;999;2656;42529735;41300718;25651815;705752;27856069
FR;1;2022-04-19;1232;2581;11776;27893;11507;42530967;41303299;25663591;733645;27867576
FR;1;2022-04-20;1332;2623;12171;26827;12009;42532299;41305922;25675762;760472;27879585
FR;1;2022-04-21;1235;2453;11527;33161;11709;42533534;41308375;25687289;793633;27891294
FR;1;2022-04-22;1510;3068;15201;35471;14783;42535044;41311443;25702490;829104;27906077
FR;1;2022-04-23;760;1579;6730;9889;6636;42535804;41313022;25709220;838993;27912713
FR;1;2022-04-24;196;371;1373;1520;1326;42536000;41313393;25710593;840513;27914039
FR;1;2022-04-25;1035;2125;9849;19688;9749;42537035;41315518;25720442;860201;27923788
FR;1;2022-04-26;1343;2617;12590;36541;12195;42538378;41318135;25733032;896742;27935983
FR;1;2022-04-27;1323;2403;10642;29165;10779;42539701;41320538;25743674;925907;27946762
FR;1;2022-04-28;1277;2384;11559;34239;11399;42540978;41322922;25755233;960146;27958161
FR;1;2022-04-29;1611;3815;14393;35495;13831;42542589;41326737;25769626;995641;27971992
FR;1;2022-04-30;827;1553;6447;9162;6289;42543416;41328290;25776073;1004803;27978281
FR;1;2022-05-01;176;284;829;947;822;42543592;41328574;25776902;1005750;27979103
FR;1;2022-05-02;1568;2579;10370;16904;10279;42545160;41331153;25787272;1022654;27989382
FR;1;2022-05-03;1506;2845;12702;32877;12594;42546666;41333998;25799974;1055531;28001976
FR;1;2022-05-04;1346;2721;11224;23798;11381;42548012;41336719;25811198;1079329;28013357
FR;1;2022-05-05;1458;2587;12169;31792;12094;42549470;41339306;25823367;1111121;28025451
FR;1;2022-05-06;1809;3226;14222;34874;13789;42551279;41342532;25837589;1145995;28039240
FR;1;2022-05-07;852;1466;5974;9089;6008;42552131;41343998;25843563;1155084;28045248
FR;1;2022-05-08;189;327;1059;1470;1121;42552320;41344325;25844622;1156554;28046369
FR;1;2022-05-09;1109;2003;9241;19249;9154;42553429;41346328;25853863;1175803;28055523
FR;1;2022-05-10;1460;2772;12601;37028;12199;42554889;41349100;25866464;1212831;28067722
FR;1;2022-05-11;1429;2440;9904;26011;9849;42556318;41351540;25876368;1238842;28077571
FR;1;2022-05-12;1307;2399;10507;33530;10209;42557625;41353939;25886875;1272372;28087780
FR;1;2022-05-13;1600;2787;12754;35707;12400;42559225;41356726;25899629;1308079;28100180
FR;1;2022-05-14;778;1315;5480;10210;5364;42560003;41358041;25905109;1318289;28105544
FR;1;2022-05-15;220;412;1182;1349;1249;42560223;41358453;25906291;1319638;28106793
FR;1;2022-05-16;967;1762;8068;20061;8120;42561190;41360215;25914359;1339699;28114913
FR;1;2022-05-17;1285;2282;11113;36147;10720;42562475;41362497;25925472;1375846;28125633
FR;1;2022-05-18;1301;2114;9032;25695;8983;42563776;41364611;25934504;1401541;28134616
FR;1;2022-05-19;1193;2385;9841;33979;9935;42564969;41366996;25944345;1435520;28144551
FR;1;2022-05-20;1559;2746;12516;37622;12099;42566528;41369742;25956861;1473142;28156650
FR;1;2022-05-21;774;1372;5245;9373;5164;42567302;41371114;25962106;1482515;28161814
FR;1;2022-05-22;191;287;948;1392;948;42567493;41371401;25963054;1483907;28162762
FR;1;2022-05-23;967;1876;8368;19404;8344;42568460;41373277;25971422;1503311;28171106
FR;1;2022-05-24;1283;2442;10716;37223;10585;42569743;41375719;25982138;1540534;28181691
FR;1;2022-05-25;1269;2283;8789;23660;8949;42571012;41378002;25990927;1564194;28190640
FR;1;2022-05-26;167;369;1575;1147;1569;42571179;41378371;25992502;1565341;28192209
FR;1;2022-05-27;1104;2170;8776;20435;8526;42572283;41380541;26001278;1585776;28200735
FR;1;2022-05-28;481;1041;3684;6529;3722;42572764;41381582;26004962;1592305;28204457
FR;1;2022-05-29;119;257;706;890;717;42572883;41381839;26005668;1593195;28205174
FR;1;2022-05-30;828;1721;6557;18529;6586;42573711;41383560;26012225;1611724;28211760
FR;1;2022-05-31;1265;2211;9240;34361;9109;42574976;41385771;26021465;1646085;28220869
FR;1;2022-06-01;1300;2587;10431;23446;10293;42576276;41388358;26031896;1669531;28231162
FR;1;2022-06-02;1217;2301;10666;34114;10233;42577493;41390659;26042562;1703645;28241395
FR;1;2022-06-03;1435;2728;12690;37082;12111;42578928;41393387;26055252;1740727;28253506
FR;1;2022-06-04;679;1258;4744;8675;4822;42579607;41394645;26059996;1749402;28258328
FR;1;2022-06-05;129;286;808;1047;830;42579736;41394931;26060804;1750449;28259158
FR;1;2022-06-06;309;1057;2010;1182;2024;42580045;41395988;26062814;1751631;28261182
FR;1;2022-06-07;1139;2290;9175;34031;8835;42581184;41398278;26071989;1785662;28270017
FR;1;2022-06-08;1101;2225;8665;27533;8548;42582285;41400503;26080654;1813195;28278565
FR;1;2022-06-09;1059;2138;9975;37525;9658;42583344;41402641;26090629;1850720;28288223
FR;1;2022-06-10;1328;2557;12389;43089;11964;42584672;41405198;26103018;1893809;28300187
FR;1;2022-06-11;654;1442;5136;11080;5184;42585326;41406640;26108154;1904889;28305371
FR;1;2022-06-12;151;368;1013;1683;1069;42585477;41407008;26109167;1906572;28306440
FR;1;2022-06-13;900;1819;7006;22216;6863;42586377;41408827;26116173;1928788;28313303
FR;1;2022-06-14;1082;2165;9834;42819;9236;42587459;41410992;26126007;1971607;28322539
FR;1;2022-06-15;1066;1947;8772;29362;8451;42588525;41412939;26134779;2000969;28330990
FR;1;2022-06-16;931;1811;9390;38459;8867;42589456;41414750;26144169;2039428;28339857
FR;1;2022-06-17;1208;2536;11862;44763;11350;42590664;41417286;26156031;2084191;28351207
FR;1;2022-06-18;560;1262;4315;10543;4252;42591224;41418548;26160346;2094734;28355459
FR;1;2022-06-19;137;324;1002;1543;1081;42591361;41418872;26161348;2096277;28356540
FR;1;2022-06-20;854;1690;8489;25033;8152;42592215;41420562;26169837;2121310;28364692
FR;1;2022-06-21;1097;2129;9755;47734;8847;42593312;41422691;26179592;2169044;28373539
FR;1;2022-06-22;1024;2030;8430;37105;7938;42594336;41424721;26188022;2206149;28381477
FR;1;2022-06-23;1047;2155;10114;52772;9394;42595383;41426876;26198136;2258921;28390871
FR;1;2022-06-24;1246;2699;12904;65924;11688;42596629;41429575;26211040;2324845;28402559
FR;1;2022-06-25;680;1501;5922;18915;5704;42597309;41431076;26216962;2343760;28408263
FR;1;2022-06-26;166;403;1816;3492;1708;42597475;41431479;26218778;2347252;28409971
FR;1;2022-06-27;936;1762;9899;45957;9124;42598411;41433241;26228677;2393209;28419095
FR;1;2022-06-28;1203;2565;13827;86479;12392;42599614;41435806;26242504;2479688;28431487
FR;1;2022-06-29;1231;2280;11472;67350;10539;42600845;41438086;26253976;2547038;28442026
FR;1;2022-06-30;1277;2427;13505;89940;11814;42602122;41440513;26267481;2636978;28453840
FR;1;2022-07-01;1631;3464;20268;109180;17931;42603753;41443977;26287749;2746158;28471771
FR;1;2022-07-02;759;1521;8014;33766;7247;42604512;41445498;26295763;2779924;28479018
FR;1;2022-07-03;226;478;1940;6115;1755;42604738;41445976;26297703;2786039;28480773
FR;1;2022-07-04;1246;2788;13895;75387;12313;42605984;41448764;26311598;2861426;28493086
FR;1;2022-07-05;1406;2785;17663;126309;15117;42607390;41451549;26329261;2987735;28508203
FR;1;2022-07-06;1337;2375;14874;93671;12895;42608727;41453924;26344135;3081406;28521098
FR;1;2022-07-07;1428;2525;16911;119366;13982;42610155;41456449;26361046;3200772;28535080
FR;1;2022-07-08;1525;2811;19595;129955;15958;42611680;41459260;26380641;3330727;28551038
FR;1;2022-07-09;660;1268;7302;36003;6345;42612340;41460528;26387943;3366730;28557383
FR;1;2022-07-10;235;478;2239;6684;2034;42612575;41461006;26390182;3373414;28559417
FR;1;2022-07-11;1195;2201;14311;84386;11920;42613770;41463207;26404493;3457800;28571337
FR;1;2022-07-12;1547;2762;19441;137310;15875;42615317;41465969;26423934;3595110;28587212
FR;1;2022-07-13;1398;2381;14761;89787;12603;42616715;41468350;26438695;3684897;28599815
FR;1;2022-07-14;156;336;1859;5282;1769;42616871;41468686;26440554;3690179;28601584
FR;1;2022-07-15;1253;2292;14352;80558;11997;42618124;41470978;26454906;3770737;28613581
FR;1;2022-07-16;505;1039;5630;23941;4883;42618629;41472017;26460536;3794678;28618464
FR;1;2022-07-17;157;361;1655;4458;1498;42618786;41472378;26462191;3799136;28619962
FR;1;2022-07-18;969;2020;11290;59263;9557;42619755;41474398;26473481;3858399;28629519
FR;1;2022-07-19;1221;2114;14683;99369;11714;42620976;41476512;26488164;3957768;28641233
FR;1;2022-07-20;1163;1983;12344;74332;10257;42622139;41478495;26500508;4032100;28651490
FR;1;2022-07-21;1118;1932;12398;84464;9976;42623257;41480427;26512906;4116564;28661466
FR;1;2022-07-22;1233;2188;14079;85855;11408;42624490;41482615;26526985;4202419;28672874
FR;1;2022-07-23;530;1081;5227;21288;4605;42625020;41483696;26532212;4223707;28677479
FR;1;2022-07-24;147;300;1324;3695;1164;42625167;41483996;26533536;4227402;28678643
FR;1;2022-07-25;883;1618;9063;46093;7509;42626050;41485614;26542599;4273495;28686152
FR;1;2022-07-26;1122;1954;12666;81926;10323;42627172;41487568;26555265;4355421;28696475
FR;1;2022-07-27;1012;1710;9734;58396;8112;42628184;41489278;26564999;4413817;28704587
FR;1;2022-07-28;976;1690;9839;61856;7834;42629160;41490968;26574838;4475673;28712421
FR;1;2022-07-29;1110;1793;10420;62889;8346;42630270;41492761;26585258;4538562;28720767
FR;1;2022-07-30;390;704;3339;14474;2843;42630660;41493465;26588597;4553036;28723610
FR;1;2022-07-31;137;255;900;2328;766;42630797;41493720;26589497;4555364;28724376
FR;1;2022-08-01;704;1232;7232;28946;6089;42631501;41494952;26596729;4584310;28730465
FR;1;2022-08-02;889;1458;8206;53976;6600;42632390;41496410;26604935;4638286;28737065
FR;1;2022-08-03;714;1081;6130;37012;4911;42633104;41497491;26611065;4675298;28741976
FR;1;2022-08-04;638;1066;6248;41382;5036;42633742;41498557;26617313;4716680;28747012
FR;1;2022-08-05;732;1185;6743;43015;5400;42634474;41499742;26624056;4759695;28752412
FR;1;2022-08-06;270;459;1987;8991;1660;42634744;41500201;26626043;4768686;28754072
FR;1;2022-08-07;85;141;519;1551;435;42634829;41500342;26626562;4770237;28754507
FR;1;2022-08-08;477;813;3778;21202;3103;42635306;41501155;26630340;4791439;28757610
FR;1;2022-08-09;605;1012;5670;38442;4545;42635911;41502167;26636010;4829881;28762155
FR;1;2022-08-10;522;973;4421;26874;3615;42636433;41503140;26640431;4856755;28765770
FR;1;2022-08-11;535;897;4294;28132;3562;42636968;41504037;26644725;4884887;28769332
FR;1;2022-08-12;586;1015;4539;27146;3749;42637554;41505052;26649264;4912033;28773081
FR;1;2022-08-13;173;346;1245;5100;1060;42637727;41505398;26650509;4917133;28774141
FR;1;2022-08-14;62;111;272;866;231;42637789;41505509;26650781;4917999;28774372
FR;1;2022-08-15;68;153;558;539;520;42637857;41505662;26651339;4918538;28774892
FR;1;2022-08-16;520;916;3775;21461;3203;42638377;41506578;26655114;4939999;28778095
FR;1;2022-08-17;521;867;3751;22080;3180;42638898;41507445;26658865;4962079;28781275
FR;1;2022-08-18;534;860;3897;25406;3100;42639432;41508305;26662762;4987485;28784375
FR;1;2022-08-19;527;1030;4354;26501;3588;42639959;41509335;26667116;5013986;28787963
FR;1;2022-08-20;229;395;1281;5359;1094;42640188;41509730;26668397;5019345;28789057
FR;1;2022-08-21;80;109;281;987;249;42640268;41509839;26668678;5020332;28789306
FR;1;2022-08-22;468;872;3126;14914;2698;42640736;41510711;26671804;5035246;28792004
FR;1;2022-08-23;631;1045;4138;28307;3475;42641367;41511756;26675942;5063553;28795479
FR;1;2022-08-24;549;819;3388;19048;2758;42641916;41512575;26679330;5082601;28798237
FR;1;2022-08-25;558;913;3805;22891;3187;42642474;41513488;26683135;5105492;28801424
FR;1;2022-08-26;744;1116;4338;25140;3553;42643218;41514604;26687473;5130632;28804977
FR;1;2022-08-27;215;426;1321;5295;1189;42643433;41515030;26688794;5135927;28806166
FR;1;2022-08-28;109;144;295;890;276;42643542;41515174;26689089;5136817;28806442
FR;1;2022-08-29;498;846;2970;14206;2509;42644040;41516020;26692059;5151023;28808951
FR;1;2022-08-30;735;1085;4609;27673;3764;42644775;41517105;26696668;5178696;28812715
FR;1;2022-08-31;570;806;3093;17180;2606;42645345;41517911;26699761;5195876;28815321
FR;1;2022-09-01;647;879;4266;21823;3622;42645992;41518790;26704027;5217699;28818943
FR;1;2022-09-02;763;1025;4859;27826;4058;42646755;41519815;26708886;5245525;28823001
FR;1;2022-09-03;306;492;1822;5862;1580;42647061;41520307;26710708;5251387;28824581
FR;1;2022-09-04;102;133;339;838;332;42647163;41520440;26711047;5252225;28824913
FR;1;2022-09-05;551;622;2969;15670;2474;42647714;41521062;26714016;5267895;28827387
FR;1;2022-09-06;709;909;4478;30968;3623;42648423;41521971;26718494;5298863;28831010
FR;1;2022-09-07;525;670;2906;16387;2409;42648948;41522641;26721400;5315250;28833419
FR;1;2022-09-08;559;768;3677;24155;3018;42649507;41523409;26725077;5339405;28836437
FR;1;2022-09-09;755;950;4249;26747;3541;42650262;41524359;26729326;5366152;28839978
FR;1;2022-09-10;311;455;1663;5567;1465;42650573;41524814;26730989;5371719;28841443
FR;1;2022-09-11;100;116;306;642;288;42650673;41524930;26731295;5372361;28841731
FR;1;2022-09-12;442;543;2540;12885;2159;42651115;41525473;26733835;5385246;28843890
FR;1;2022-09-13;565;779;3838;25641;3290;42651680;41526252;26737673;5410887;28847180
FR;1;2022-09-14;566;683;2838;15593;2366;42652246;41526935;26740511;5426480;28849546
FR;1;2022-09-15;495;687;3286;22959;2766;42652741;41527622;26743797;5449439;28852312
FR;1;2022-09-16;711;917;3989;25235;3354;42653452;41528539;26747786;5474674;28855666
FR;1;2022-09-17;289;398;1380;5954;1208;42653741;41528937;26749166;5480628;28856874
FR;1;2022-09-18;94;119;310;919;278;42653835;41529056;26749476;5481547;28857152
FR;1;2022-09-19;357;549;2110;12804;1806;42654192;41529605;26751586;5494351;28858958
FR;1;2022-09-20;545;784;3615;25667;3023;42654737;41530389;26755201;5520018;28861981
FR;1;2022-09-21;461;671;2602;15825;2236;42655198;41531060;26757803;5535843;28864217
FR;1;2022-09-22;526;731;3233;22856;2634;42655724;41531791;26761036;5558699;28866851
FR;1;2022-09-23;742;913;4323;28033;3604;42656466;41532704;26765359;5586732;28870455
FR;1;2022-09-24;345;523;1569;6685;1349;42656811;41533227;26766928;5593417;28871804
FR;1;2022-09-25;74;143;316;1070;288;42656885;41533370;26767244;5594487;28872092
FR;1;2022-09-26;367;617;2138;12896;1881;42657252;41533987;26769382;5607383;28873973
FR;1;2022-09-27;531;746;3424;24958;2752;42657783;41534733;26772806;5632341;28876725
FR;1;2022-09-28;503;705;2430;14903;2194;42658286;41535438;26775236;5647244;28878919
FR;1;2022-09-29;491;673;2944;20193;2462;42658777;41536111;26778180;5667437;28881381
FR;1;2022-09-30;656;947;3719;24263;3098;42659433;41537058;26781899;5691700;28884479
FR;1;2022-10-01;311;517;1585;5452;1353;42659744;41537575;26783484;5697152;28885832
FR;1;2022-10-02;44;108;197;561;196;42659788;41537683;26783681;5697713;28886028
FR;1;2022-10-03;371;521;1891;9934;1651;42660159;41538204;26785572;5707647;28887679
FR;1;2022-10-04;526;644;2610;18831;2177;42660685;41538848;26788182;5726478;28889856
FR;1;2022-10-05;407;645;1939;11016;1716;42661092;41539493;26790121;5737494;28891572
FR;1;2022-10-06;423;582;2363;15641;1941;42661515;41540075;26792484;5753135;28893513
FR;1;2022-10-07;528;709;2545;15940;2168;42662043;41540784;26795029;5769075;28895681
FR;1;2022-10-08;219;290;807;3127;698;42662262;41541074;26795836;5772202;28896379
FR;1;2022-10-09;70;83;136;453;125;42662332;41541157;26795972;5772655;28896504
FR;1;2022-10-10;273;362;906;4860;838;42662605;41541519;26796878;5777515;28897342
FR;1;2022-10-11;308;406;1177;7891;1046;42662913;41541925;26798055;5785406;28898388
FR;1;2022-10-12;306;398;925;5037;931;42663219;41542323;26798980;5790443;28899319
FR;1;2022-10-13;302;357;960;5893;815;42663521;41542680;26799940;5796336;28900134
FR;1;2022-10-14;385;476;1060;6547;921;42663906;41543156;26801000;5802883;28901055
FR;1;2022-10-15;177;222;408;1794;395;42664083;41543378;26801408;5804677;28901450
FR;1;2022-10-16;40;51;84;266;96;42664123;41543429;26801492;5804943;28901546
FR;1;2022-10-17;205;267;490;2347;461;42664328;41543696;26801982;5807290;28902007
FR;2;2020-12-27;0;0;0;0;0;0;0;0;0;0
FR;2;2020-12-28;0;0;0;0;0;0;0;0;0;0
FR;2;2020-12-29;0;0;0;0;0;0;0;0;0;0
FR;2;2020-12-30;0;0;0;0;0;0;0;0;0;0
FR;2;2020-12-31;0;0;0;0;0;0;0;0;0;0
FR;2;2021-01-01;0;0;0;0;0;0;0;0;0;0
FR;2;2021-01-02;0;0;0;0;0;0;0;0;0;0
FR;2;2021-01-03;0;0;0;0;0;0;0;0;0;0
FR;2;2021-01-04;0;0;0;0;0;0;0;0;0;0
FR;2;2021-01-05;0;0;0;0;0;0;0;0;0;0
FR;2;2021-01-06;0;0;0;0;0;0;0;0;0;0
FR;2;2021-01-07;0;0;0;0;0;0;0;0;0;0
FR;2;2021-01-08;0;0;0;0;0;0;0;0;0;0
FR;2;2021-01-09;0;0;0;0;0;0;0;0;0;0
FR;2;2021-01-10;0;0;0;0;0;0;0;0;0;0
FR;2;2021-01-11;0;0;0;0;0;0;0;0;0;0
FR;2;2021-01-12;0;0;0;0;0;0;0;0;0;0
FR;2;2021-01-13;0;0;0;0;0;0;0;0;0;0
FR;2;2021-01-14;1662;0;0;0;0;1662;0;0;0;0
FR;2;2021-01-15;398;0;0;0;0;2060;0;0;0;0
FR;2;2021-01-16;316;0;0;0;0;2376;0;0;0;0
FR;2;2021-01-17;83;0;0;0;0;2459;0;0;0;0
FR;2;2021-01-18;3074;2;0;0;0;5533;2;0;0;0
FR;2;2021-01-19;4681;0;0;0;0;10214;2;0;0;0
FR;2;2021-01-20;5135;6;0;0;0;15349;8;0;0;0
FR;2;2021-01-21;5344;9;0;0;0;20693;17;0;0;0
FR;2;2021-01-22;5118;15;0;0;0;25811;32;0;0;0
FR;2;2021-01-23;1873;2;0;0;0;27684;34;0;0;0
FR;2;2021-01-24;163;2;0;0;0;27847;36;0;0;0
FR;2;2021-01-25;3814;3;0;0;0;31661;39;0;0;0
FR;2;2021-01-26;3924;5;0;0;0;35585;44;0;0;0
FR;2;2021-01-27;3602;4;0;0;0;39187;48;0;0;0
FR;2;2021-01-28;3753;8;0;0;0;42940;56;0;0;0
FR;2;2021-01-29;3295;3;0;0;0;46235;59;0;0;0
FR;2;2021-01-30;1130;3;0;0;0;47365;62;0;0;0
FR;2;2021-01-31;46;2;0;0;0;47411;64;0;0;0
FR;2;2021-02-01;3405;9;0;0;0;50816;73;0;0;0
FR;2;2021-02-02;4493;17;0;0;0;55309;90;0;0;0
FR;2;2021-02-03;5220;7;0;0;0;60529;97;0;0;0
FR;2;2021-02-04;4939;11;0;0;0;65468;108;0;0;0
FR;2;2021-02-05;4815;15;0;0;0;70283;123;0;0;0
FR;2;2021-02-06;2043;15;0;0;0;72326;138;0;0;0
FR;2;2021-02-07;102;4;0;0;0;72428;142;0;0;0
FR;2;2021-02-08;7556;24;0;0;0;79984;166;0;0;0
FR;2;2021-02-09;8426;27;0;0;0;88410;193;0;0;0
FR;2;2021-02-10;9342;60;0;0;0;97752;253;0;0;0
FR;2;2021-02-11;10288;122;0;0;0;108040;375;0;0;0
FR;2;2021-02-12;10056;269;0;0;0;118096;644;0;0;0
FR;2;2021-02-13;3120;225;0;0;0;121216;869;0;0;0
FR;2;2021-02-14;355;9;0;0;0;121571;878;0;0;0
FR;2;2021-02-15;3460;3112;0;0;0;125031;3990;0;0;0
FR;2;2021-02-16;5073;4117;0;0;0;130104;8107;0;0;0
FR;2;2021-02-17;4258;4527;0;0;0;134362;12634;0;0;0
FR;2;2021-02-18;5403;5160;0;0;0;139765;17794;0;0;0
FR;2;2021-02-19;5327;4463;0;0;0;145092;22257;0;0;0
FR;2;2021-02-20;1870;1516;0;0;0;146962;23773;0;0;0
FR;2;2021-02-21;244;95;0;0;0;147206;23868;0;0;0
FR;2;2021-02-22;3613;3765;0;0;0;150819;27633;0;0;0
FR;2;2021-02-23;4954;3723;0;0;0;155773;31356;0;0;0
FR;2;2021-02-24;5015;3529;0;0;0;160788;34885;0;0;0
FR;2;2021-02-25;5493;3474;0;0;0;166281;38359;0;0;0
FR;2;2021-02-26;4363;3166;0;0;0;170644;41525;0;0;0
FR;2;2021-02-27;1626;1061;0;0;0;172270;42586;0;0;0
FR;2;2021-02-28;178;20;0;0;0;172448;42606;0;0;0
FR;2;2021-03-01;5186;3756;0;0;0;177634;46362;0;0;0
FR;2;2021-03-02;6536;4717;0;0;0;184170;51079;0;0;0
FR;2;2021-03-03;6539;4944;0;0;0;190709;56023;0;0;0
FR;2;2021-03-04;8409;4156;0;0;0;199118;60179;0;0;0
FR;2;2021-03-05;8035;4053;0;0;0;207153;64232;0;0;0
FR;2;2021-03-06;4787;1680;0;0;0;211940;65912;0;0;0
FR;2;2021-03-07;2372;29;0;0;0;214312;65941;0;0;0
FR;2;2021-03-08;4166;8378;0;0;0;218478;74319;0;0;0
FR;2;2021-03-09;7491;8568;1;0;0;225969;82887;1;0;0
FR;2;2021-03-10;7103;9202;0;0;0;233072;92089;1;0;0
FR;2;2021-03-11;9376;9321;1;0;0;242448;101410;2;0;0
FR;2;2021-03-12;7979;8326;0;0;0;250427;109736;2;0;0
FR;2;2021-03-13;10054;2581;0;0;0;260481;112317;2;0;0
FR;2;2021-03-14;4841;384;0;0;0;265322;112701;2;0;0
FR;2;2021-03-15;10913;3483;0;0;0;276235;116184;2;0;0
FR;2;2021-03-16;16766;4676;1;0;0;293001;120860;3;0;0
FR;2;2021-03-17;20239;3994;0;0;0;313240;124854;3;0;0
FR;2;2021-03-18;23372;5066;0;0;0;336612;129920;3;0;0
FR;2;2021-03-19;23309;4639;0;0;0;359921;134559;3;0;0
FR;2;2021-03-20;25452;1589;0;0;0;385373;136148;3;0;0
FR;2;2021-03-21;17671;154;0;0;0;403044;136302;3;0;0
FR;2;2021-03-22;17787;3207;0;0;0;420831;139509;3;0;0
FR;2;2021-03-23;22696;4255;0;0;0;443527;143764;3;0;0
FR;2;2021-03-24;23956;5032;0;0;0;467483;148796;3;0;0
FR;2;2021-03-25;26751;5196;1;0;0;494234;153992;4;0;0
FR;2;2021-03-26;26985;4227;0;0;0;521219;158219;4;0;0
FR;2;2021-03-27;15920;1354;0;0;0;537139;159573;4;0;0
FR;2;2021-03-28;10562;136;0;0;0;547701;159709;4;0;0
FR;2;2021-03-29;18995;4314;0;0;0;566696;164023;4;0;0
FR;2;2021-03-30;24588;6083;0;0;0;591284;170106;4;0;0
FR;2;2021-03-31;28561;5919;0;0;0;619845;176025;4;0;0
FR;2;2021-04-01;34551;8547;1;0;0;654396;184572;5;0;0
FR;2;2021-04-02;29984;7705;0;0;0;684380;192277;5;0;0
FR;2;2021-04-03;16955;4112;0;0;0;701335;196389;5;0;0
FR;2;2021-04-04;9306;1192;2;0;0;710641;197581;7;0;0
FR;2;2021-04-05;12445;799;0;0;0;723086;198380;7;0;0
FR;2;2021-04-06;27154;7207;0;0;0;750240;205587;7;0;0
FR;2;2021-04-07;30931;7140;1;0;0;781171;212727;8;0;0
FR;2;2021-04-08;36893;8623;1;0;0;818064;221350;9;0;0
FR;2;2021-04-09;33846;8416;28;0;0;851910;229766;37;0;0
FR;2;2021-04-10;19684;9217;1;0;0;871594;238983;38;0;0
FR;2;2021-04-11;7942;4250;1;0;0;879536;243233;39;0;0
FR;2;2021-04-12;17127;11038;0;0;0;896663;254271;39;0;0
FR;2;2021-04-13;19457;16074;1;0;0;916120;270345;40;0;0
FR;2;2021-04-14;18066;16405;7;0;0;934186;286750;47;0;0
FR;2;2021-04-15;22199;21523;27;0;0;956385;308273;74;0;0
FR;2;2021-04-16;20710;20440;45;0;0;977095;328713;119;0;0
FR;2;2021-04-17;13256;22488;5;0;0;990351;351201;124;0;0
FR;2;2021-04-18;5910;14398;6;0;0;996261;365599;130;0;0
FR;2;2021-04-19;16843;16346;24;0;0;1013104;381945;154;0;0
FR;2;2021-04-20;19325;21680;38;0;0;1032429;403625;192;0;0
FR;2;2021-04-21;20290;21783;76;0;0;1052719;425408;268;0;0
FR;2;2021-04-22;23819;24907;41;0;0;1076538;450315;309;0;0
FR;2;2021-04-23;24528;25406;76;0;0;1101066;475721;385;0;0
FR;2;2021-04-24;25305;15064;104;0;0;1126371;490785;489;0;0
FR;2;2021-04-25;9595;8610;5;0;0;1135966;499395;494;0;0
FR;2;2021-04-26;17164;17474;21;0;0;1153130;516869;515;0;0
FR;2;2021-04-27;19244;24129;40;0;0;1172374;540998;555;0;0
FR;2;2021-04-28;22338;26346;112;0;0;1194712;567344;667;0;0
FR;2;2021-04-29;25471;30310;69;0;0;1220183;597654;736;0;0
FR;2;2021-04-30;25533;27902;49;1;0;1245716;625556;785;1;0
FR;2;2021-05-01;14987;9864;6;0;0;1260703;635420;791;1;0
FR;2;2021-05-02;6639;9171;2;0;0;1267342;644591;793;1;0
FR;2;2021-05-03;20021;19177;40;0;0;1287363;663768;833;1;0
FR;2;2021-05-04;18283;29132;33;0;0;1305646;692900;866;1;0
FR;2;2021-05-05;18374;29433;48;0;0;1324020;722333;914;1;0
FR;2;2021-05-06;23544;35330;132;0;0;1347564;757663;1046;1;0
FR;2;2021-05-07;25334;33224;97;0;0;1372898;790887;1143;1;0
FR;2;2021-05-08;21342;10330;14;0;0;1394240;801217;1157;1;0
FR;2;2021-05-09;13166;7715;7;0;0;1407406;808932;1164;1;0
FR;2;2021-05-10;32940;21900;50;0;0;1440346;830832;1214;1;0
FR;2;2021-05-11;43606;20959;101;0;0;1483952;851791;1315;1;0
FR;2;2021-05-12;50053;19715;143;0;0;1534005;871506;1458;1;0
FR;2;2021-05-13;51295;5671;31;0;0;1585300;877177;1489;1;0
FR;2;2021-05-14;61353;12895;132;0;0;1646653;890072;1621;1;0
FR;2;2021-05-15;65934;7122;39;0;0;1712587;897194;1660;1;0
FR;2;2021-05-16;43587;2571;10;0;0;1756174;899765;1670;1;0
FR;2;2021-05-17;44750;12489;114;0;0;1800924;912254;1784;1;0
FR;2;2021-05-18;54644;12270;191;0;0;1855568;924524;1975;1;0
FR;2;2021-05-19;57176;10536;281;0;0;1912744;935060;2256;1;0
FR;2;2021-05-20;63440;10808;288;0;0;1976184;945868;2544;1;0
FR;2;2021-05-21;64296;11622;230;0;0;2040480;957490;2774;1;0
FR;2;2021-05-22;61485;4519;65;0;0;2101965;962009;2839;1;0
FR;2;2021-05-23;37534;575;22;0;0;2139499;962584;2861;1;0
FR;2;2021-05-24;17242;2037;35;0;0;2156741;964621;2896;1;0
FR;2;2021-05-25;21114;12220;240;0;0;2177855;976841;3136;1;0
FR;2;2021-05-26;19939;11481;230;0;0;2197794;988322;3366;1;0
FR;2;2021-05-27;22997;12648;182;0;0;2220791;1000970;3548;1;0
FR;2;2021-05-28;29392;15002;190;0;0;2250183;1015972;3738;1;0
FR;2;2021-05-29;30420;8185;57;0;0;2280603;1024157;3795;1;0
FR;2;2021-05-30;4647;1817;6;0;0;2285250;1025974;3801;1;0
FR;2;2021-05-31;28589;18737;184;0;0;2313839;1044711;3985;1;0
FR;2;2021-06-01;45731;19929;224;0;0;2359570;1064640;4209;1;0
FR;2;2021-06-02;37474;19274;182;0;0;2397044;1083914;4391;1;0
FR;2;2021-06-03;51278;23174;161;0;0;2448322;1107088;4552;1;0
FR;2;2021-06-04;65511;24068;217;0;0;2513833;1131156;4769;1;0
FR;2;2021-06-05;34601;24071;52;0;0;2548434;1155227;4821;1;0
FR;2;2021-06-06;4956;6193;10;0;0;2553390;1161420;4831;1;0
FR;2;2021-06-07;28174;23015;150;0;0;2581564;1184435;4981;1;0
FR;2;2021-06-08;46376;22916;143;0;0;2627940;1207351;5124;1;0
FR;2;2021-06-09;34291;20946;107;0;0;2662231;1228297;5231;1;0
FR;2;2021-06-10;42640;19133;95;1;0;2704871;1247430;5326;2;0
FR;2;2021-06-11;55299;25161;134;0;0;2760170;1272591;5460;2;0
FR;2;2021-06-12;30561;19783;53;0;0;2790731;1292374;5513;2;0
FR;2;2021-06-13;3331;9194;13;0;0;2794062;1301568;5526;2;0
FR;2;2021-06-14;25300;24132;92;0;0;2819362;1325700;5618;2;0
FR;2;2021-06-15;39046;22833;154;0;0;2858408;1348533;5772;2;0
FR;2;2021-06-16;30163;21396;135;0;0;2888571;1369929;5907;2;0
FR;2;2021-06-17;36912;25812;150;0;0;2925483;1395741;6057;2;0
FR;2;2021-06-18;46859;28852;123;0;0;2972342;1424593;6180;2;0
FR;2;2021-06-19;24525;24903;39;0;0;2996867;1449496;6219;2;0
FR;2;2021-06-20;3742;10064;9;0;0;3000609;1459560;6228;2;0
FR;2;2021-06-21;17529;42843;88;0;0;3018138;1502403;6316;2;0
FR;2;2021-06-22;28361;49574;110;0;0;3046499;1551977;6426;2;0
FR;2;2021-06-23;21790;49587;107;1;1;3068289;1601564;6533;3;1
FR;2;2021-06-24;28376;50285;134;0;0;3096665;1651849;6667;3;1
FR;2;2021-06-25;33401;60426;128;0;0;3130066;1712275;6795;3;1
FR;2;2021-06-26;16386;59307;54;1;0;3146452;1771582;6849;4;1
FR;2;2021-06-27;2566;29313;22;1;0;3149018;1800895;6871;5;1
FR;2;2021-06-28;12640;54331;84;0;0;3161658;1855226;6955;5;1
FR;2;2021-06-29;19853;59952;178;0;0;3181511;1915178;7133;5;1
FR;2;2021-06-30;16330;57987;253;17;0;3197841;1973165;7386;22;1
FR;2;2021-07-01;20492;59878;228;0;0;3218333;2033043;7614;22;1
FR;2;2021-07-02;24080;62144;184;0;0;3242413;2095187;7798;22;1
FR;2;2021-07-03;12117;57115;153;0;0;3254530;2152302;7951;22;1
FR;2;2021-07-04;1959;23305;18;0;0;3256489;2175607;7969;22;1
FR;2;2021-07-05;9177;29338;106;0;0;3265666;2204945;8075;22;1
FR;2;2021-07-06;14582;36241;135;0;0;3280248;2241186;8210;22;1
FR;2;2021-07-07;14414;33657;139;0;0;3294662;2274843;8349;22;1
FR;2;2021-07-08;19722;40314;162;0;0;3314384;2315157;8511;22;1
FR;2;2021-07-09;27101;54312;202;1;0;3341485;2369469;8713;23;1
FR;2;2021-07-10;13386;33692;107;0;0;3354871;2403161;8820;23;1
FR;2;2021-07-11;1809;4355;16;0;0;3356680;2407516;8836;23;1
FR;2;2021-07-12;12969;37296;119;0;0;3369649;2444812;8955;23;1
FR;2;2021-07-13;37113;53179;152;0;0;3406762;2497991;9107;23;1
FR;2;2021-07-14;6626;3547;15;0;0;3413388;2501538;9122;23;1
FR;2;2021-07-15;47241;47027;156;0;0;3460629;2548565;9278;23;1
FR;2;2021-07-16;64316;55791;188;0;0;3524945;2604356;9466;23;1
FR;2;2021-07-17;31599;23926;96;0;0;3556544;2628282;9562;23;1
FR;2;2021-07-18;6088;4837;19;0;0;3562632;2633119;9581;23;1
FR;2;2021-07-19;33004;28628;94;0;0;3595636;2661747;9675;23;1
FR;2;2021-07-20;51997;44531;155;0;0;3647633;2706278;9830;23;1
FR;2;2021-07-21;45254;34703;93;0;0;3692887;2740981;9923;23;1
FR;2;2021-07-22;56280;41085;128;1;0;3749167;2782066;10051;24;1
FR;2;2021-07-23;68296;48993;170;0;0;3817463;2831059;10221;24;1
FR;2;2021-07-24;36176;21601;82;0;0;3853639;2852660;10303;24;1
FR;2;2021-07-25;6749;2623;10;0;0;3860388;2855283;10313;24;1
FR;2;2021-07-26;36315;22390;91;1;0;3896703;2877673;10404;25;1
FR;2;2021-07-27;62387;34587;180;0;0;3959090;2912260;10584;25;1
FR;2;2021-07-28;55320;26429;132;0;0;4014410;2938689;10716;25;1
FR;2;2021-07-29;68475;32804;189;0;0;4082885;2971493;10905;25;1
FR;2;2021-07-30;74463;37800;222;1;0;4157348;3009293;11127;26;1
FR;2;2021-07-31;34770;16207;104;0;0;4192118;3025500;11231;26;1
FR;2;2021-08-01;5413;2258;19;0;0;4197531;3027758;11250;26;1
FR;2;2021-08-02;35882;16187;101;0;0;4233413;3043945;11351;26;1
FR;2;2021-08-03;55985;28281;142;0;0;4289398;3072226;11493;26;1
FR;2;2021-08-04;46635;20843;128;1;0;4336033;3093069;11621;27;1
FR;2;2021-08-05;54635;31570;215;0;0;4390668;3124639;11836;27;1
FR;2;2021-08-06;58094;42399;242;1;0;4448762;3167038;12078;28;1
FR;2;2021-08-07;25149;17623;89;0;0;4473911;3184661;12167;28;1
FR;2;2021-08-08;3838;3652;21;0;0;4477749;3188313;12188;28;1
FR;2;2021-08-09;29307;21076;92;0;0;4507056;3209389;12280;28;1
FR;2;2021-08-10;45007;33484;155;0;0;4552063;3242873;12435;28;1
FR;2;2021-08-11;35274;25164;151;0;0;4587337;3268037;12586;28;1
FR;2;2021-08-12;41903;35704;163;0;0;4629240;3303741;12749;28;1
FR;2;2021-08-13;42602;37254;218;0;0;4671842;3340995;12967;28;1
FR;2;2021-08-14;18519;22174;94;0;0;4690361;3363169;13061;28;1
FR;2;2021-08-15;3854;3805;17;0;0;4694215;3366974;13078;28;1
FR;2;2021-08-16;25090;27146;111;0;0;4719305;3394120;13189;28;1
FR;2;2021-08-17;38260;43421;205;2;0;4757565;3437541;13394;30;1
FR;2;2021-08-18;32252;36367;195;1;1;4789817;3473908;13589;31;2
FR;2;2021-08-19;37434;46578;224;0;0;4827251;3520486;13813;31;2
FR;2;2021-08-20;40567;55639;271;1;0;4867818;3576125;14084;32;2
FR;2;2021-08-21;18120;24309;116;0;0;4885938;3600434;14200;32;2
FR;2;2021-08-22;2907;4325;22;1;1;4888845;3604759;14222;33;3
FR;2;2021-08-23;19248;35156;131;1;0;4908093;3639915;14353;34;3
FR;2;2021-08-24;31947;56051;236;0;0;4940040;3695966;14589;34;3
FR;2;2021-08-25;25934;43458;250;0;0;4965974;3739424;14839;34;3
FR;2;2021-08-26;32361;55814;388;0;0;4998335;3795238;15227;34;3
FR;2;2021-08-27;37003;65668;477;2;0;5035338;3860906;15704;36;3
FR;2;2021-08-28;17819;28525;300;0;0;5053157;3889431;16004;36;3
FR;2;2021-08-29;2656;5016;47;0;0;5055813;3894447;16051;36;3
FR;2;2021-08-30;18415;37742;400;0;760;5074228;3932189;16451;36;763
FR;2;2021-08-31;28076;57498;887;4;1549;5102304;3989687;17338;40;2312
FR;2;2021-09-01;21592;39868;1309;0;2115;5123896;4029555;18647;40;4427
FR;2;2021-09-02;25485;48660;1962;2;3347;5149381;4078215;20609;42;7774
FR;2;2021-09-03;33411;64539;2988;3;4868;5182792;4142754;23597;45;12642
FR;2;2021-09-04;16832;27738;1442;1;2375;5199624;4170492;25039;46;15017
FR;2;2021-09-05;2262;3609;266;0;412;5201886;4174101;25305;46;15429
FR;2;2021-09-06;14043;28708;1770;1;2942;5215929;4202809;27075;47;18371
FR;2;2021-09-07;21106;41096;3021;13;4911;5237035;4243905;30096;60;23282
FR;2;2021-09-08;17247;31923;2734;6;4492;5254282;4275828;32830;66;27774
FR;2;2021-09-09;20978;40474;4435;3;6811;5275260;4316302;37265;69;34585
FR;2;2021-09-10;28201;51259;5285;4;8911;5303461;4367561;42550;73;43496
FR;2;2021-09-11;13654;22423;2404;5;3969;5317115;4389984;44954;78;47465
FR;2;2021-09-12;1824;2775;291;0;510;5318939;4392759;45245;78;47975
FR;2;2021-09-13;11659;21442;2473;4;4032;5330598;4414201;47718;82;52007
FR;2;2021-09-14;18573;32747;5088;13;9053;5349171;4446948;52806;95;61060
FR;2;2021-09-15;14913;28265;5169;3;7768;5364084;4475213;57975;98;68828
FR;2;2021-09-16;16079;32776;6737;12;10525;5380163;4507989;64712;110;79353
FR;2;2021-09-17;20914;47136;8780;10;14607;5401077;4555125;73492;120;93960
FR;2;2021-09-18;9858;20953;3803;6;6032;5410935;4576078;77295;126;99992
FR;2;2021-09-19;1166;2606;396;0;633;5412101;4578684;77691;126;100625
FR;2;2021-09-20;7499;18731;3855;7;6142;5419600;4597415;81546;133;106767
FR;2;2021-09-21;11214;30005;6495;5;10747;5430814;4627420;88041;138;117514
FR;2;2021-09-22;9408;23540;5490;6;8520;5440222;4650960;93531;144;126034
FR;2;2021-09-23;10728;28906;7881;10;12650;5450950;4679866;101412;154;138684
FR;2;2021-09-24;15071;42919;10876;18;17233;5466021;4722785;112288;172;155917
FR;2;2021-09-25;7258;18781;3965;9;6111;5473279;4741566;116253;181;162028
FR;2;2021-09-26;1079;2550;495;0;629;5474358;4744116;116748;181;162657
FR;2;2021-09-27;6313;16416;4285;8;6536;5480671;4760532;121033;189;169193
FR;2;2021-09-28;9240;25547;7769;14;12073;5489911;4786079;128802;203;181266
FR;2;2021-09-29;8081;20208;6067;25;9257;5497992;4806287;134869;228;190523
FR;2;2021-09-30;9864;25829;9506;16;14101;5507856;4832116;144375;244;204624
FR;2;2021-10-01;13975;35718;12918;25;19305;5521831;4867834;157293;269;223929
FR;2;2021-10-02;6874;15916;4849;7;7030;5528705;4883750;162142;276;230959
FR;2;2021-10-03;841;1919;492;1;505;5529546;4885669;162634;277;231464
FR;2;2021-10-04;5824;13904;5515;5;7857;5535370;4899573;168149;282;239321
FR;2;2021-10-05;9058;22549;11121;19;15729;5544428;4922122;179270;301;255050
FR;2;2021-10-06;7783;17744;8242;11;11078;5552211;4939866;187512;312;266128
FR;2;2021-10-07;9202;22204;12383;15;16863;5561413;4962070;199895;327;282991
FR;2;2021-10-08;13429;32099;17349;27;23573;5574842;4994169;217244;354;306564
FR;2;2021-10-09;6000;12847;6042;6;7898;5580842;5007016;223286;360;314462
FR;2;2021-10-10;885;1605;436;2;614;5581727;5008621;223722;362;315076
FR;2;2021-10-11;5607;11562;6455;17;8830;5587334;5020183;230177;379;323906
FR;2;2021-10-12;8031;17784;12548;13;16772;5595365;5037967;242725;392;340678
FR;2;2021-10-13;6943;14851;10255;12;13633;5602308;5052818;252980;404;354311
FR;2;2021-10-14;8314;17934;14996;13;19461;5610622;5070752;267976;417;373772
FR;2;2021-10-15;11852;26304;20903;26;27971;5622474;5097056;288879;443;401743
FR;2;2021-10-16;5139;8738;1819;0;3218;5627613;5105794;290698;443;404961
FR;2;2021-10-17;651;1162;184;0;366;5628264;5106956;290882;443;405327
FR;2;2021-10-18;4563;7361;664;2;1643;5632827;5114317;291546;445;406970
FR;2;2021-10-19;6238;9867;732;5;2043;5639065;5124184;292278;450;409013
FR;2;2021-10-20;5170;8070;758;3;1683;5644235;5132254;293036;453;410696
FR;2;2021-10-21;6090;9971;779;5;2101;5650325;5142225;293815;458;412797
FR;2;2021-10-22;8450;14593;1148;4;2883;5658775;5156818;294963;462;415680
FR;2;2021-10-23;3845;5999;586;0;1235;5662620;5162817;295549;462;416915
FR;2;2021-10-24;494;888;100;0;206;5663114;5163705;295649;462;417121
FR;2;2021-10-25;3357;5348;306;1;824;5666471;5169053;295955;463;417945
FR;2;2021-10-26;4176;7254;1130;4;2021;5670647;5176307;297085;467;419966
FR;2;2021-10-27;3676;6602;1193;5;1993;5674323;5182909;298278;472;421959
FR;2;2021-10-28;4597;7695;1735;3;2748;5678920;5190604;300013;475;424707
FR;2;2021-10-29;5413;11090;2436;4;3677;5684333;5201694;302449;479;428384
FR;2;2021-10-30;2749;4445;976;1;1437;5687082;5206139;303425;480;429821
FR;2;2021-10-31;364;531;139;1;190;5687446;5206670;303564;481;430011
FR;2;2021-11-01;428;548;178;0;264;5687874;5207218;303742;481;430275
FR;2;2021-11-02;3293;6759;1183;0;1763;5691167;5213977;304925;481;432038
FR;2;2021-11-03;3340;6237;1386;2;1967;5694507;5220214;306311;483;434005
FR;2;2021-11-04;3986;7080;1767;4;2495;5698493;5227294;308078;487;436500
FR;2;2021-11-05;5233;10501;2867;5;3956;5703726;5237795;310945;492;440456
FR;2;2021-11-06;2594;4681;1403;0;1817;5706320;5242476;312348;492;442273
FR;2;2021-11-07;505;867;220;0;289;5706825;5243343;312568;492;442562
FR;2;2021-11-08;2578;5357;1203;3;1676;5709403;5248700;313771;495;444238
FR;2;2021-11-09;2750;6920;2402;5;3181;5712153;5255620;316173;500;447419
FR;2;2021-11-10;2589;5684;5111;6;6285;5714742;5261304;321284;506;453704
FR;2;2021-11-11;444;751;746;2;927;5715186;5262055;322030;508;454631
FR;2;2021-11-12;2953;8099;8972;8;10915;5718139;5270154;331002;516;465546
FR;2;2021-11-13;1539;3383;3870;7;4541;5719678;5273537;334872;523;470087
FR;2;2021-11-14;257;590;351;1;482;5719935;5274127;335223;524;470569
FR;2;2021-11-15;1622;3664;4445;8;5327;5721557;5277791;339668;532;475896
FR;2;2021-11-16;2184;5895;8307;14;10073;5723741;5283686;347975;546;485969
FR;2;2021-11-17;1741;4539;6628;8;7850;5725482;5288225;354603;554;493819
FR;2;2021-11-18;2192;5934;9180;10;11013;5727674;5294159;363783;564;504832
FR;2;2021-11-19;2700;7777;12973;19;15474;5730374;5301936;376756;583;520306
FR;2;2021-11-20;1565;3340;5175;5;6084;5731939;5305276;381931;588;526390
FR;2;2021-11-21;247;512;541;0;661;5732186;5305788;382472;588;527051
FR;2;2021-11-22;1278;2595;4479;5;5404;5733464;5308383;386951;593;532455
FR;2;2021-11-23;1617;4296;8199;9;9912;5735081;5312679;395150;602;542367
FR;2;2021-11-24;1418;3762;7475;14;8728;5736499;5316441;402625;616;551095
FR;2;2021-11-25;1813;4880;11468;21;13664;5738312;5321321;414093;637;564759
FR;2;2021-11-26;2540;7754;22669;31;26075;5740852;5329075;436762;668;590834
FR;2;2021-11-27;1497;4162;12270;18;14035;5742349;5333237;449032;686;604869
FR;2;2021-11-28;292;842;1972;3;2296;5742641;5334079;451004;689;607165
FR;2;2021-11-29;1447;4366;15090;23;17257;5744088;5338445;466094;712;624422
FR;2;2021-11-30;1912;6688;26242;36;29995;5746000;5345133;492336;748;654417
FR;2;2021-12-01;1915;6060;26202;31;29521;5747915;5351193;518538;779;683938
FR;2;2021-12-02;1913;6805;37714;52;41961;5749828;5357998;556252;831;725899
FR;2;2021-12-03;2556;10092;53620;111;59364;5752384;5368090;609872;942;785263
FR;2;2021-12-04;1848;6294;37115;38;40805;5754232;5374384;646987;980;826068
FR;2;2021-12-05;458;2253;14259;14;15990;5754690;5376637;661246;994;842058
FR;2;2021-12-06;2486;9882;77712;109;84769;5757176;5386519;738958;1103;926827
FR;2;2021-12-07;3455;15320;122445;238;133760;5760631;5401839;861403;1341;1060587
FR;2;2021-12-08;3726;16014;133197;330;145386;5764357;5417853;994600;1671;1205973
FR;2;2021-12-09;4547;19646;170208;555;185600;5768904;5437499;1164808;2226;1391573
FR;2;2021-12-10;4675;22850;188671;490;206159;5773579;5460349;1353479;2716;1597732
FR;2;2021-12-11;3685;16634;132444;239;144889;5777264;5476983;1485923;2955;1742621
FR;2;2021-12-12;1257;7135;59097;83;65156;5778521;5484118;1545020;3038;1807777
FR;2;2021-12-13;5528;26845;220698;605;242990;5784049;5510963;1765718;3643;2050767
FR;2;2021-12-14;7016;37474;300779;908;332226;5791065;5548437;2066497;4551;2382993
FR;2;2021-12-15;6555;36249;285232;957;315862;5797620;5584686;2351729;5508;2698855
FR;2;2021-12-16;7766;37933;312139;979;343751;5805386;5622619;2663868;6487;3042606
FR;2;2021-12-17;8681;41232;327886;976;360971;5814067;5663851;2991754;7463;3403577
FR;2;2021-12-18;6515;26559;212347;448;233656;5820582;5690410;3204101;7911;3637233
FR;2;2021-12-19;2603;11436;90210;182;100352;5823185;5701846;3294311;8093;3737585
FR;2;2021-12-20;9545;33564;275223;706;303377;5832730;5735410;3569534;8799;4040962
FR;2;2021-12-21;11563;38323;309628;968;341434;5844293;5773733;3879162;9767;4382396
FR;2;2021-12-22;10458;32809;265115;952;292474;5854751;5806542;4144277;10719;4674870
FR;2;2021-12-23;9426;26687;199509;701;221304;5864177;5833229;4343786;11420;4896174
FR;2;2021-12-24;2783;7485;43859;140;49561;5866960;5840714;4387645;11560;4945735
FR;2;2021-12-25;201;682;2002;10;2485;5867161;5841396;4389647;11570;4948220
FR;2;2021-12-26;1319;4211;25156;71;28681;5868480;5845607;4414803;11641;4976901
FR;2;2021-12-27;8077;29922;218414;659;243340;5876557;5875529;4633217;12300;5220241
FR;2;2021-12-28;9837;36327;272095;742;301997;5886394;5911856;4905312;13042;5522238
FR;2;2021-12-29;9497;32262;246134;765;272697;5895891;5944118;5151446;13807;5794935
FR;2;2021-12-30;9461;28103;208830;663;231456;5905352;5972221;5360276;14470;6026391
FR;2;2021-12-31;3010;8349;54991;176;61235;5908362;5980570;5415267;14646;6087626
FR;2;2022-01-01;230;693;2854;7;3352;5908592;5981263;5418121;14653;6090978
FR;2;2022-01-02;1505;4855;29513;75;33402;5910097;5986118;5447634;14728;6124380
FR;2;2022-01-03;9593;35405;266532;806;293902;5919690;6021523;5714166;15534;6418282
FR;2;2022-01-04;12851;45414;342088;1068;377016;5932541;6066937;6056254;16602;6795298
FR;2;2022-01-05;11272;38658;294189;884;323834;5943813;6105595;6350443;17486;7119132
FR;2;2022-01-06;13654;43500;331947;1298;364738;5957467;6149095;6682390;18784;7483870
FR;2;2022-01-07;14225;47640;361094;1270;396449;5971692;6196735;7043484;20054;7880319
FR;2;2022-01-08;7948;28147;201262;515;221702;5979640;6224882;7244746;20569;8102021
FR;2;2022-01-09;2749;8979;62524;137;69512;5982389;6233861;7307270;20706;8171533
FR;2;2022-01-10;10097;31919;232478;858;255051;5992486;6265780;7539748;21564;8426584
FR;2;2022-01-11;11469;36251;265919;1029;290618;6003955;6302031;7805667;22593;8717202
FR;2;2022-01-12;8765;29813;206320;863;226171;6012720;6331844;8011987;23456;8943373
FR;2;2022-01-13;9387;31344;224493;832;244841;6022107;6363188;8236480;24288;9188214
FR;2;2022-01-14;9741;35614;254539;920;277658;6031848;6398802;8491019;25208;9465872
FR;2;2022-01-15;5359;19452;140779;363;153635;6037207;6418254;8631798;25571;9619507
FR;2;2022-01-16;1512;5481;35887;81;39831;6038719;6423735;8667685;25652;9659338
FR;2;2022-01-17;5546;19279;135414;601;147258;6044265;6443014;8803099;26253;9806596
FR;2;2022-01-18;6421;21499;148631;648;160461;6050686;6464513;8951730;26901;9967057
FR;2;2022-01-19;4395;16323;105102;551;113703;6055081;6480836;9056832;27452;10080760
FR;2;2022-01-20;4871;17593;115295;603;123693;6059952;6498429;9172127;28055;10204453
FR;2;2022-01-21;5197;20062;137349;679;147772;6065149;6518491;9309476;28734;10352225
FR;2;2022-01-22;3030;10950;74262;260;80324;6068179;6529441;9383738;28994;10432549
FR;2;2022-01-23;724;2716;15241;41;16831;6068903;6532157;9398979;29035;10449380
FR;2;2022-01-24;3289;12817;75078;430;81031;6072192;6544974;9474057;29465;10530411
FR;2;2022-01-25;3574;14417;79625;496;85453;6075766;6559391;9553682;29961;10615864
FR;2;2022-01-26;2515;10699;58975;363;63024;6078281;6570090;9612657;30324;10678888
FR;2;2022-01-27;2681;11348;64177;388;67932;6080962;6581438;9676834;30712;10746820
FR;2;2022-01-28;3550;18299;91719;429;98918;6084512;6599737;9768553;31141;10845738
FR;2;2022-01-29;1894;9245;48851;164;52932;6086406;6608982;9817404;31305;10898670
FR;2;2022-01-30;464;2226;9454;38;10601;6086870;6611208;9826858;31343;10909271
FR;2;2022-01-31;1888;9565;43830;208;47331;6088758;6620773;9870688;31551;10956602
FR;2;2022-02-01;1916;10042;47030;279;50105;6090674;6630815;9917718;31830;11006707
FR;2;2022-02-02;1614;9002;41118;250;44161;6092288;6639817;9958836;32080;11050868
FR;2;2022-02-03;1725;8947;40523;205;42925;6094013;6648764;9999359;32285;11093793
FR;2;2022-02-04;2151;15194;66646;299;71341;6096164;6663958;10066005;32584;11165134
FR;2;2022-02-05;1360;8525;35945;132;39230;6097524;6672483;10101950;32716;11204364
FR;2;2022-02-06;275;1762;6127;16;6899;6097799;6674245;10108077;32732;11211263
FR;2;2022-02-07;1351;9565;37755;134;41295;6099150;6683810;10145832;32866;11252558
FR;2;2022-02-08;1299;9832;40952;173;43746;6100449;6693642;10186784;33039;11296304
FR;2;2022-02-09;1160;8838;37038;174;40462;6101609;6702480;10223822;33213;11336766
FR;2;2022-02-10;1028;7996;33837;204;36509;6102637;6710476;10257659;33417;11373275
FR;2;2022-02-11;1391;12085;53344;223;57697;6104028;6722561;10311003;33640;11430972
FR;2;2022-02-12;754;6533;27985;85;30804;6104782;6729094;10338988;33725;11461776
FR;2;2022-02-13;200;1340;4836;20;5577;6104982;6730434;10343824;33745;11467353
FR;2;2022-02-14;835;6731;30272;90;33231;6105817;6737165;10374096;33835;11500584
FR;2;2022-02-15;774;6471;28049;141;29992;6106591;6743636;10402145;33976;11530576
FR;2;2022-02-16;657;5361;22064;123;23629;6107248;6748997;10424209;34099;11554205
FR;2;2022-02-17;518;3783;14151;98;14617;6107766;6752780;10438360;34197;11568822
FR;2;2022-02-18;723;5368;20439;134;21128;6108489;6758148;10458799;34331;11589950
FR;2;2022-02-19;430;3056;10531;66;11245;6108919;6761204;10469330;34397;11601195
FR;2;2022-02-20;102;516;1460;3;1608;6109021;6761720;10470790;34400;11602803
FR;2;2022-02-21;422;2685;9122;65;9499;6109443;6764405;10479912;34465;11612302
FR;2;2022-02-22;390;2567;8892;76;8795;6109833;6766972;10488804;34541;11621097
FR;2;2022-02-23;432;2604;8991;82;9267;6110265;6769576;10497795;34623;11630364
FR;2;2022-02-24;314;2036;6800;81;6828;6110579;6771612;10504595;34704;11637192
FR;2;2022-02-25;457;3206;11418;107;11282;6111036;6774818;10516013;34811;11648474
FR;2;2022-02-26;297;1892;6035;49;6342;6111333;6776710;10522048;34860;11654816
FR;2;2022-02-27;76;313;907;5;950;6111409;6777023;10522955;34865;11655766
FR;2;2022-02-28;330;1688;5523;53;5531;6111739;6778711;10528478;34918;11661297
FR;2;2022-03-01;277;1568;5479;46;5196;6112016;6780279;10533957;34964;11666493
FR;2;2022-03-02;298;1445;5246;45;5090;6112314;6781724;10539203;35009;11671583
FR;2;2022-03-03;225;1111;3708;42;3485;6112539;6782835;10542911;35051;11675068
FR;2;2022-03-04;243;1468;4857;74;4505;6112782;6784303;10547768;35125;11679573
FR;2;2022-03-05;174;906;2979;32;2723;6112956;6785209;10550747;35157;11682296
FR;2;2022-03-06;42;183;280;5;320;6112998;6785392;10551027;35162;11682616
FR;2;2022-03-07;156;658;1987;70;1777;6113154;6786050;10553014;35232;11684393
FR;2;2022-03-08;144;668;2273;51;1906;6113298;6786718;10555287;35283;11686299
FR;2;2022-03-09;154;708;2348;37;2050;6113452;6787426;10557635;35320;11688349
FR;2;2022-03-10;123;603;1694;35;1469;6113575;6788029;10559329;35355;11689818
FR;2;2022-03-11;172;756;2768;57;2367;6113747;6788785;10562097;35412;11692185
FR;2;2022-03-12;149;484;1785;27;1554;6113896;6789269;10563882;35439;11693739
FR;2;2022-03-13;25;75;203;30;204;6113921;6789344;10564085;35469;11693943
FR;2;2022-03-14;128;470;1567;529;1297;6114049;6789814;10565652;35998;11695240
FR;2;2022-03-15;138;439;1712;690;1332;6114187;6790253;10567364;36688;11696572
FR;2;2022-03-16;142;476;2013;1615;1593;6114329;6790729;10569377;38303;11698165
FR;2;2022-03-17;93;413;1408;1193;1144;6114422;6791142;10570785;39496;11699309
FR;2;2022-03-18;146;496;2023;1792;1666;6114568;6791638;10572808;41288;11700975
FR;2;2022-03-19;108;321;1210;941;1015;6114676;6791959;10574018;42229;11701990
FR;2;2022-03-20;13;77;191;59;168;6114689;6792036;10574209;42288;11702158
FR;2;2022-03-21;96;307;1214;1483;1077;6114785;6792343;10575423;43771;11703235
FR;2;2022-03-22;118;388;1530;1830;1291;6114903;6792731;10576953;45601;11704526
FR;2;2022-03-23;139;361;1674;3032;1470;6115042;6793092;10578627;48633;11705996
FR;2;2022-03-24;116;293;1183;1547;1001;6115158;6793385;10579810;50180;11706997
FR;2;2022-03-25;119;361;1805;2449;1475;6115277;6793746;10581615;52629;11708472
FR;2;2022-03-26;79;247;1204;1222;952;6115356;6793993;10582819;53851;11709424
FR;2;2022-03-27;19;36;153;100;132;6115375;6794029;10582972;53951;11709556
FR;2;2022-03-28;94;288;1137;1601;995;6115469;6794317;10584109;55552;11710551
FR;2;2022-03-29;108;258;1324;2467;1104;6115577;6794575;10585433;58019;11711655
FR;2;2022-03-30;91;312;1487;3184;1319;6115668;6794887;10586920;61203;11712974
FR;2;2022-03-31;104;284;1275;2331;1090;6115772;6795171;10588195;63534;11714064
FR;2;2022-04-01;123;323;1567;2348;1322;6115895;6795494;10589762;65882;11715386
FR;2;2022-04-02;76;161;845;891;737;6115971;6795655;10590607;66773;11716123
FR;2;2022-04-03;16;53;128;113;142;6115987;6795708;10590735;66886;11716265
FR;2;2022-04-04;113;238;987;1438;796;6116100;6795946;10591722;68324;11717061
FR;2;2022-04-05;143;294;1314;2905;1141;6116243;6796240;10593036;71229;11718202
FR;2;2022-04-06;89;259;1305;2520;1129;6116332;6796499;10594341;73749;11719331
FR;2;2022-04-07;120;224;1300;2682;1040;6116452;6796723;10595641;76431;11720371
FR;2;2022-04-08;125;336;1630;3322;1324;6116577;6797059;10597271;79753;11721695
FR;2;2022-04-09;90;219;899;1046;731;6116667;6797278;10598170;80799;11722426
FR;2;2022-04-10;37;48;143;162;119;6116704;6797326;10598313;80961;11722545
FR;2;2022-04-11;88;195;889;1559;779;6116792;6797521;10599202;82520;11723324
FR;2;2022-04-12;176;270;1182;2769;1061;6116968;6797791;10600384;85289;11724385
FR;2;2022-04-13;146;230;1124;2456;986;6117114;6798021;10601508;87745;11725371
FR;2;2022-04-14;115;222;1085;2676;917;6117229;6798243;10602593;90421;11726288
FR;2;2022-04-15;114;249;1213;2289;1067;6117343;6798492;10603806;92710;11727355
FR;2;2022-04-16;67;108;548;549;459;6117410;6798600;10604354;93259;11727814
FR;2;2022-04-17;15;26;57;53;53;6117425;6798626;10604411;93312;11727867
FR;2;2022-04-18;12;35;120;70;115;6117437;6798661;10604531;93382;11727982
FR;2;2022-04-19;112;237;1117;1714;949;6117549;6798898;10605648;95096;11728931
FR;2;2022-04-20;95;241;1106;2157;931;6117644;6799139;10606754;97253;11729862
FR;2;2022-04-21;111;231;981;1911;837;6117755;6799370;10607735;99164;11730699
FR;2;2022-04-22;99;274;1242;2090;1023;6117854;6799644;10608977;101254;11731722
FR;2;2022-04-23;67;156;644;762;573;6117921;6799800;10609621;102016;11732295
FR;2;2022-04-24;12;29;101;68;79;6117933;6799829;10609722;102084;11732374
FR;2;2022-04-25;103;204;820;1314;710;6118036;6800033;10610542;103398;11733084
FR;2;2022-04-26;108;184;1041;2017;878;6118144;6800217;10611583;105415;11733962
FR;2;2022-04-27;98;178;860;1783;764;6118242;6800395;10612443;107198;11734726
FR;2;2022-04-28;93;214;950;1929;843;6118335;6800609;10613393;109127;11735569
FR;2;2022-04-29;81;280;1130;1695;1040;6118416;6800889;10614523;110822;11736609
FR;2;2022-04-30;65;126;470;538;429;6118481;6801015;10614993;111360;11737038
FR;2;2022-05-01;23;24;84;48;85;6118504;6801039;10615077;111408;11737123
FR;2;2022-05-02;116;232;762;1214;660;6118620;6801271;10615839;112622;11737783
FR;2;2022-05-03;148;233;999;1775;938;6118768;6801504;10616838;114397;11738721
FR;2;2022-05-04;90;225;923;1809;866;6118858;6801729;10617761;116206;11739587
FR;2;2022-05-05;127;197;851;1717;768;6118985;6801926;10618612;117923;11740355
FR;2;2022-05-06;133;246;1099;1848;1014;6119118;6802172;10619711;119771;11741369
FR;2;2022-05-07;40;98;470;504;406;6119158;6802270;10620181;120275;11741775
FR;2;2022-05-08;47;54;107;71;102;6119205;6802324;10620288;120346;11741877
FR;2;2022-05-09;101;174;654;984;604;6119306;6802498;10620942;121330;11742481
FR;2;2022-05-10;120;249;938;1840;893;6119426;6802747;10621880;123170;11743374
FR;2;2022-05-11;100;176;811;1873;791;6119526;6802923;10622691;125043;11744165
FR;2;2022-05-12;111;173;844;2093;802;6119637;6803096;10623535;127136;11744967
FR;2;2022-05-13;100;232;969;2096;898;6119737;6803328;10624504;129232;11745865
FR;2;2022-05-14;76;117;451;554;409;6119813;6803445;10624955;129786;11746274
FR;2;2022-05-15;24;39;94;87;108;6119837;6803484;10625049;129873;11746382
FR;2;2022-05-16;103;170;599;923;536;6119940;6803654;10625648;130796;11746918
FR;2;2022-05-17;95;184;689;1685;657;6120035;6803838;10626337;132481;11747575
FR;2;2022-05-18;80;181;641;1431;646;6120115;6804019;10626978;133912;11748221
FR;2;2022-05-19;70;160;708;1831;750;6120185;6804179;10627686;135743;11748971
FR;2;2022-05-20;107;179;873;1700;777;6120292;6804358;10628559;137443;11749748
FR;2;2022-05-21;48;96;397;517;338;6120340;6804454;10628956;137960;11750086
FR;2;2022-05-22;8;23;69;37;57;6120348;6804477;10629025;137997;11750143
FR;2;2022-05-23;86;133;498;931;469;6120434;6804610;10629523;138928;11750612
FR;2;2022-05-24;87;163;627;1620;615;6120521;6804773;10630150;140548;11751227
FR;2;2022-05-25;72;145;538;1148;492;6120593;6804918;10630688;141696;11751719
FR;2;2022-05-26;11;31;77;42;85;6120604;6804949;10630765;141738;11751804
FR;2;2022-05-27;44;123;456;817;438;6120648;6805072;10631221;142555;11752242
FR;2;2022-05-28;28;60;221;244;221;6120676;6805132;10631442;142799;11752463
FR;2;2022-05-29;13;34;43;25;51;6120689;6805166;10631485;142824;11752514
FR;2;2022-05-30;65;108;424;755;409;6120754;6805274;10631909;143579;11752923
FR;2;2022-05-31;76;135;563;1276;510;6120830;6805409;10632472;144855;11753433
FR;2;2022-06-01;59;157;562;1074;541;6120889;6805566;10633034;145929;11753974
FR;2;2022-06-02;92;175;625;1412;591;6120981;6805741;10633659;147341;11754565
FR;2;2022-06-03;71;155;666;1604;593;6121052;6805896;10634325;148945;11755158
FR;2;2022-06-04;69;93;282;433;269;6121121;6805989;10634607;149378;11755427
FR;2;2022-06-05;12;17;62;57;47;6121133;6806006;10634669;149435;11755474
FR;2;2022-06-06;11;33;92;75;92;6121144;6806039;10634761;149510;11755566
FR;2;2022-06-07;99;219;666;1533;576;6121243;6806258;10635427;151043;11756142
FR;2;2022-06-08;70;118;475;1165;411;6121313;6806376;10635902;152208;11756553
FR;2;2022-06-09;93;166;612;1921;570;6121406;6806542;10636514;154129;11757123
FR;2;2022-06-10;91;167;650;1682;621;6121497;6806709;10637164;155811;11757744
FR;2;2022-06-11;43;84;286;528;258;6121540;6806793;10637450;156339;11758002
FR;2;2022-06-12;18;38;58;78;60;6121558;6806831;10637508;156417;11758062
FR;2;2022-06-13;39;119;393;952;378;6121597;6806950;10637901;157369;11758440
FR;2;2022-06-14;68;156;599;2087;537;6121665;6807106;10638500;159456;11758977
FR;2;2022-06-15;77;104;520;1500;444;6121742;6807210;10639020;160956;11759421
FR;2;2022-06-16;127;127;495;1411;422;6121869;6807337;10639515;162367;11759843
FR;2;2022-06-17;72;136;586;1817;514;6121941;6807473;10640101;164184;11760357
FR;2;2022-06-18;75;92;224;578;196;6122016;6807565;10640325;164762;11760553
FR;2;2022-06-19;11;16;53;71;41;6122027;6807581;10640378;164833;11760594
FR;2;2022-06-20;62;125;401;1027;392;6122089;6807706;10640779;165860;11760986
FR;2;2022-06-21;107;115;524;2123;453;6122196;6807821;10641303;167983;11761439
FR;2;2022-06-22;39;107;462;1889;414;6122235;6807928;10641765;169872;11761853
FR;2;2022-06-23;56;108;537;2281;452;6122291;6808036;10642302;172153;11762305
FR;2;2022-06-24;66;122;708;3198;570;6122357;6808158;10643010;175351;11762875
FR;2;2022-06-25;30;90;295;987;252;6122387;6808248;10643305;176338;11763127
FR;2;2022-06-26;30;27;131;194;97;6122417;6808275;10643436;176532;11763224
FR;2;2022-06-27;79;137;580;2472;481;6122496;6808412;10644016;179004;11763705
FR;2;2022-06-28;110;140;812;4815;650;6122606;6808552;10644828;183819;11764355
FR;2;2022-06-29;71;149;775;4407;636;6122677;6808701;10645603;188226;11764991
FR;2;2022-06-30;72;133;832;5177;618;6122749;6808834;10646435;193403;11765609
FR;2;2022-07-01;112;158;1148;6692;847;6122861;6808992;10647583;200095;11766456
FR;2;2022-07-02;68;132;474;1976;392;6122929;6809124;10648057;202071;11766848
FR;2;2022-07-03;23;30;146;334;130;6122952;6809154;10648203;202405;11766978
FR;2;2022-07-04;120;180;775;3774;611;6123072;6809334;10648978;206179;11767589
FR;2;2022-07-05;118;186;1121;6816;828;6123190;6809520;10650099;212995;11768417
FR;2;2022-07-06;92;148;949;5808;695;6123282;6809668;10651048;218803;11769112
FR;2;2022-07-07;81;185;1021;6498;750;6123363;6809853;10652069;225301;11769862
FR;2;2022-07-08;65;122;1092;7031;755;6123428;6809975;10653161;232332;11770617
FR;2;2022-07-09;34;61;418;1869;299;6123462;6810036;10653579;234201;11770916
FR;2;2022-07-10;6;17;96;315;82;6123468;6810053;10653675;234516;11770998
FR;2;2022-07-11;68;119;682;3815;540;6123536;6810172;10654357;238331;11771538
FR;2;2022-07-12;101;178;1052;6505;808;6123637;6810350;10655409;244836;11772346
FR;2;2022-07-13;63;126;880;4662;592;6123700;6810476;10656289;249498;11772938
FR;2;2022-07-14;6;13;88;248;59;6123706;6810489;10656377;249746;11772997
FR;2;2022-07-15;61;129;739;3790;560;6123767;6810618;10657116;253536;11773557
FR;2;2022-07-16;27;54;289;1029;242;6123794;6810672;10657405;254565;11773799
FR;2;2022-07-17;5;12;77;201;66;6123799;6810684;10657482;254766;11773865
FR;2;2022-07-18;57;103;514;2509;384;6123856;6810787;10657996;257275;11774249
FR;2;2022-07-19;66;132;769;4247;555;6123922;6810919;10658765;261522;11774804
FR;2;2022-07-20;59;118;580;3179;430;6123981;6811037;10659345;264701;11775234
FR;2;2022-07-21;60;109;671;3678;485;6124041;6811146;10660016;268379;11775719
FR;2;2022-07-22;51;98;697;3528;505;6124092;6811244;10660713;271907;11776224
FR;2;2022-07-23;39;96;290;1173;229;6124131;6811340;10661003;273080;11776453
FR;2;2022-07-24;14;23;68;201;67;6124145;6811363;10661071;273281;11776520
FR;2;2022-07-25;50;71;404;1936;299;6124195;6811434;10661475;275217;11776819
FR;2;2022-07-26;57;133;607;3423;478;6124252;6811567;10662082;278640;11777297
FR;2;2022-07-27;42;81;456;2782;361;6124294;6811648;10662538;281422;11777658
FR;2;2022-07-28;29;75;449;2476;356;6124323;6811723;10662987;283898;11778014
FR;2;2022-07-29;68;87;535;2855;347;6124391;6811810;10663522;286753;11778361
FR;2;2022-07-30;21;38;162;774;110;6124412;6811848;10663684;287527;11778471
FR;2;2022-07-31;6;13;27;104;21;6124418;6811861;10663711;287631;11778492
FR;2;2022-08-01;38;103;323;1261;259;6124456;6811964;10664034;288892;11778751
FR;2;2022-08-02;49;73;324;2060;246;6124505;6812037;10664358;290952;11778997
FR;2;2022-08-03;29;52;258;1610;187;6124534;6812089;10664616;292562;11779184
FR;2;2022-08-04;40;63;306;1686;240;6124574;6812152;10664922;294248;11779424
FR;2;2022-08-05;33;94;327;1879;235;6124607;6812246;10665249;296127;11779659
FR;2;2022-08-06;22;40;106;365;82;6124629;6812286;10665355;296492;11779741
FR;2;2022-08-07;7;8;14;69;16;6124636;6812294;10665369;296561;11779757
FR;2;2022-08-08;19;35;216;876;144;6124655;6812329;10665585;297437;11779901
FR;2;2022-08-09;28;51;278;1475;238;6124683;6812380;10665863;298912;11780139
FR;2;2022-08-10;15;21;213;1126;150;6124698;6812401;10666076;300038;11780289
FR;2;2022-08-11;21;41;174;1037;117;6124719;6812442;10666250;301075;11780406
FR;2;2022-08-12;36;48;184;1042;140;6124755;6812490;10666434;302117;11780546
FR;2;2022-08-13;8;19;46;149;52;6124763;6812509;10666480;302266;11780598
FR;2;2022-08-14;1;2;12;52;11;6124764;6812511;10666492;302318;11780609
FR;2;2022-08-15;0;5;32;22;21;6124764;6812516;10666524;302340;11780630
FR;2;2022-08-16;27;32;144;672;120;6124791;6812548;10666668;303012;11780750
FR;2;2022-08-17;16;26;108;738;87;6124807;6812574;10666776;303750;11780837
FR;2;2022-08-18;13;28;159;835;106;6124820;6812602;10666935;304585;11780943
FR;2;2022-08-19;8;38;116;703;86;6124828;6812640;10667051;305288;11781029
FR;2;2022-08-20;6;26;56;196;47;6124834;6812666;10667107;305484;11781076
FR;2;2022-08-21;4;14;15;19;13;6124838;6812680;10667122;305503;11781089
FR;2;2022-08-22;10;24;116;395;73;6124848;6812704;10667238;305898;11781162
FR;2;2022-08-23;11;40;134;671;112;6124859;6812744;10667372;306569;11781274
FR;2;2022-08-24;11;27;86;466;78;6124870;6812771;10667458;307035;11781352
FR;2;2022-08-25;8;31;109;481;69;6124878;6812802;10667567;307516;11781421
FR;2;2022-08-26;15;45;117;720;91;6124893;6812847;10667684;308236;11781512
FR;2;2022-08-27;10;18;47;156;42;6124903;6812865;10667731;308392;11781554
FR;2;2022-08-28;1;5;5;15;7;6124904;6812870;10667736;308407;11781561
FR;2;2022-08-29;24;42;91;400;85;6124928;6812912;10667827;308807;11781646
FR;2;2022-08-30;31;54;154;787;119;6124959;6812966;10667981;309594;11781765
FR;2;2022-08-31;19;34;85;391;79;6124978;6813000;10668066;309985;11781844
FR;2;2022-09-01;19;42;139;600;122;6124997;6813042;10668205;310585;11781966
FR;2;2022-09-02;32;54;145;744;156;6125029;6813096;10668350;311329;11782122
FR;2;2022-09-03;17;20;83;204;67;6125046;6813116;10668433;311533;11782189
FR;2;2022-09-04;8;5;9;31;10;6125054;6813121;10668442;311564;11782199
FR;2;2022-09-05;28;28;123;367;95;6125082;6813149;10668565;311931;11782294
FR;2;2022-09-06;43;61;158;761;153;6125125;6813210;10668723;312692;11782447
FR;2;2022-09-07;21;20;74;375;49;6125146;6813230;10668797;313067;11782496
FR;2;2022-09-08;31;57;108;636;99;6125177;6813287;10668905;313703;11782595
FR;2;2022-09-09;17;24;126;750;74;6125194;6813311;10669031;314453;11782669
FR;2;2022-09-10;14;23;56;117;48;6125208;6813334;10669087;314570;11782717
FR;2;2022-09-11;9;5;10;11;12;6125217;6813339;10669097;314581;11782729
FR;2;2022-09-12;19;30;68;340;55;6125236;6813369;10669165;314921;11782784
FR;2;2022-09-13;15;34;126;670;99;6125251;6813403;10669291;315591;11782883
FR;2;2022-09-14;19;21;81;479;59;6125270;6813424;10669372;316070;11782942
FR;2;2022-09-15;21;42;124;486;101;6125291;6813466;10669496;316556;11783043
FR;2;2022-09-16;18;30;122;563;89;6125309;6813496;10669618;317119;11783132
FR;2;2022-09-17;5;19;56;160;52;6125314;6813515;10669674;317279;11783184
FR;2;2022-09-18;4;7;13;36;10;6125318;6813522;10669687;317315;11783194
FR;2;2022-09-19;26;24;114;353;87;6125344;6813546;10669801;317668;11783281
FR;2;2022-09-20;27;27;117;624;84;6125371;6813573;10669918;318292;11783365
FR;2;2022-09-21;15;30;99;393;78;6125386;6813603;10670017;318685;11783443
FR;2;2022-09-22;16;39;121;581;93;6125402;6813642;10670138;319266;11783536
FR;2;2022-09-23;21;38;133;555;110;6125423;6813680;10670271;319821;11783646
FR;2;2022-09-24;10;8;50;189;35;6125433;6813688;10670321;320010;11783681
FR;2;2022-09-25;9;11;14;29;11;6125442;6813699;10670335;320039;11783692
FR;2;2022-09-26;21;40;103;445;79;6125463;6813739;10670438;320484;11783771
FR;2;2022-09-27;29;46;156;899;105;6125492;6813785;10670594;321383;11783876
FR;2;2022-09-28;14;31;93;421;73;6125506;6813816;10670687;321804;11783949
FR;2;2022-09-29;26;47;113;614;109;6125532;6813863;10670800;322418;11784058
FR;2;2022-09-30;24;44;110;518;83;6125556;6813907;10670910;322936;11784141
FR;2;2022-10-01;10;19;46;123;31;6125566;6813926;10670956;323059;11784172
FR;2;2022-10-02;0;5;8;21;5;6125566;6813931;10670964;323080;11784177
FR;2;2022-10-03;21;23;79;288;62;6125587;6813954;10671043;323368;11784239
FR;2;2022-10-04;15;20;98;604;62;6125602;6813974;10671141;323972;11784301
FR;2;2022-10-05;20;29;73;488;67;6125622;6814003;10671214;324460;11784368
FR;2;2022-10-06;29;23;72;444;73;6125651;6814026;10671286;324904;11784441
FR;2;2022-10-07;21;28;85;497;63;6125672;6814054;10671371;325401;11784504
FR;2;2022-10-08;12;8;18;108;19;6125684;6814062;10671389;325509;11784523
FR;2;2022-10-09;1;8;15;17;11;6125685;6814070;10671404;325526;11784534
FR;2;2022-10-10;18;23;41;222;43;6125703;6814093;10671445;325748;11784577
FR;2;2022-10-11;12;12;44;252;37;6125715;6814105;10671489;326000;11784614
FR;2;2022-10-12;8;18;49;275;36;6125723;6814123;10671538;326275;11784650
FR;2;2022-10-13;10;13;41;222;35;6125733;6814136;10671579;326497;11784685
FR;2;2022-10-14;11;25;31;225;36;6125744;6814161;10671610;326722;11784721
FR;2;2022-10-15;4;8;20;109;13;6125748;6814169;10671630;326831;11784734
FR;2;2022-10-16;0;1;3;10;5;6125748;6814170;10671633;326841;11784739
FR;2;2022-10-17;14;17;27;110;22;6125762;6814187;10671660;326951;11784761
FR;3;2020-12-27;0;0;0;0;0;0;0;0;0;0
FR;3;2020-12-28;0;0;0;0;0;0;0;0;0;0
FR;3;2020-12-29;0;0;0;0;0;0;0;0;0;0
FR;3;2020-12-30;0;0;0;0;0;0;0;0;0;0
FR;3;2020-12-31;0;0;0;0;0;0;0;0;0;0
FR;3;2021-01-01;0;0;0;0;0;0;0;0;0;0
FR;3;2021-01-02;0;0;0;0;0;0;0;0;0;0
FR;3;2021-01-03;0;0;0;0;0;0;0;0;0;0
FR;3;2021-01-04;0;0;0;0;0;0;0;0;0;0
FR;3;2021-01-05;0;0;0;0;0;0;0;0;0;0
FR;3;2021-01-06;0;0;0;0;0;0;0;0;0;0
FR;3;2021-01-07;0;0;0;0;0;0;0;0;0;0
FR;3;2021-01-08;0;0;0;0;0;0;0;0;0;0
FR;3;2021-01-09;0;0;0;0;0;0;0;0;0;0
FR;3;2021-01-10;0;0;0;0;0;0;0;0;0;0
FR;3;2021-01-11;0;0;0;0;0;0;0;0;0;0
FR;3;2021-01-12;0;0;0;0;0;0;0;0;0;0
FR;3;2021-01-13;0;0;0;0;0;0;0;0;0;0
FR;3;2021-01-14;0;0;0;0;0;0;0;0;0;0
FR;3;2021-01-15;0;0;0;0;0;0;0;0;0;0
FR;3;2021-01-16;0;0;0;0;0;0;0;0;0;0
FR;3;2021-01-17;0;0;0;0;0;0;0;0;0;0
FR;3;2021-01-18;0;0;0;0;0;0;0;0;0;0
FR;3;2021-01-19;0;0;0;0;0;0;0;0;0;0
FR;3;2021-01-20;0;0;0;0;0;0;0;0;0;0
FR;3;2021-01-21;0;0;0;0;0;0;0;0;0;0
FR;3;2021-01-22;0;0;0;0;0;0;0;0;0;0
FR;3;2021-01-23;0;0;0;0;0;0;0;0;0;0
FR;3;2021-01-24;0;0;0;0;0;0;0;0;0;0
FR;3;2021-01-25;0;0;0;0;0;0;0;0;0;0
FR;3;2021-01-26;0;0;0;0;0;0;0;0;0;0
FR;3;2021-01-27;0;0;0;0;0;0;0;0;0;0
FR;3;2021-01-28;0;0;0;0;0;0;0;0;0;0
FR;3;2021-01-29;0;0;0;0;0;0;0;0;0;0
FR;3;2021-01-30;0;0;0;0;0;0;0;0;0;0
FR;3;2021-01-31;0;0;0;0;0;0;0;0;0;0
FR;3;2021-02-01;0;0;0;0;0;0;0;0;0;0
FR;3;2021-02-02;0;0;0;0;0;0;0;0;0;0
FR;3;2021-02-03;0;0;0;0;0;0;0;0;0;0
FR;3;2021-02-04;0;0;0;0;0;0;0;0;0;0
FR;3;2021-02-05;0;0;0;0;0;0;0;0;0;0
FR;3;2021-02-06;1552;0;0;0;0;1552;0;0;0;0
FR;3;2021-02-07;1423;1;0;0;0;2975;1;0;0;0
FR;3;2021-02-08;2787;1;0;0;0;5762;2;0;0;0
FR;3;2021-02-09;6785;0;0;0;0;12547;2;0;0;0
FR;3;2021-02-10;9611;0;0;0;0;22158;2;0;0;0
FR;3;2021-02-11;13618;1;0;0;0;35776;3;0;0;0
FR;3;2021-02-12;13407;0;0;0;0;49183;3;0;0;0
FR;3;2021-02-13;3798;1;0;0;0;52981;4;0;0;0
FR;3;2021-02-14;975;1;0;0;0;53956;5;0;0;0
FR;3;2021-02-15;10492;2;0;0;0;64448;7;0;0;0
FR;3;2021-02-16;12550;4;0;0;0;76998;11;0;0;0
FR;3;2021-02-17;11158;1;0;0;0;88156;12;0;0;0
FR;3;2021-02-18;14942;2;0;0;0;103098;14;0;0;0
FR;3;2021-02-19;14362;1;0;0;0;117460;15;0;0;0
FR;3;2021-02-20;3330;0;0;0;0;120790;15;0;0;0
FR;3;2021-02-21;619;0;0;0;0;121409;15;0;0;0
FR;3;2021-02-22;9167;0;0;0;0;130576;15;0;0;0
FR;3;2021-02-23;11399;3;0;0;0;141975;18;0;0;0
FR;3;2021-02-24;14305;1;0;0;0;156280;19;0;0;0
FR;3;2021-02-25;44932;3;0;0;0;201212;22;0;0;0
FR;3;2021-02-26;61889;9;0;0;0;263101;31;0;0;0
FR;3;2021-02-27;34807;11;0;0;0;297908;42;0;0;0
FR;3;2021-02-28;2463;0;0;0;0;300371;42;0;0;0
FR;3;2021-03-01;20518;18;0;0;0;320889;60;0;0;0
FR;3;2021-03-02;38873;22;0;0;0;359762;82;0;0;0
FR;3;2021-03-03;48746;16;0;0;0;408508;98;0;0;0
FR;3;2021-03-04;82222;24;0;0;0;490730;122;0;0;0
FR;3;2021-03-05;118129;43;0;0;0;608859;165;0;0;0
FR;3;2021-03-06;120718;63;1;0;0;729577;228;1;0;0
FR;3;2021-03-07;55181;25;0;0;0;784758;253;1;0;0
FR;3;2021-03-08;42813;24;0;0;0;827571;277;1;0;0
FR;3;2021-03-09;78974;52;0;0;0;906545;329;1;0;0
FR;3;2021-03-10;80980;59;0;0;0;987525;388;1;0;0
FR;3;2021-03-11;128440;59;0;0;0;1115965;447;1;0;0
FR;3;2021-03-12;182720;110;0;0;0;1298685;557;1;0;0
FR;3;2021-03-13;132158;79;0;0;0;1430843;636;1;0;0
FR;3;2021-03-14;14057;5;0;0;0;1444900;641;1;0;0
FR;3;2021-03-15;52234;68;0;0;0;1497134;709;1;0;0
FR;3;2021-03-16;1216;45;0;0;0;1498350;754;1;0;0
FR;3;2021-03-17;947;51;0;0;0;1499297;805;1;0;0
FR;3;2021-03-18;1571;31;0;0;0;1500868;836;1;0;0
FR;3;2021-03-19;70454;53;0;0;0;1571322;889;1;0;0
FR;3;2021-03-20;65238;44;0;0;0;1636560;933;1;0;0
FR;3;2021-03-21;5759;8;0;0;0;1642319;941;1;0;0
FR;3;2021-03-22;37507;44;0;0;0;1679826;985;1;0;0
FR;3;2021-03-23;84661;78;0;0;0;1764487;1063;1;0;0
FR;3;2021-03-24;90950;95;0;0;0;1855437;1158;1;0;0
FR;3;2021-03-25;150063;137;0;0;0;2005500;1295;1;0;0
FR;3;2021-03-26;165427;156;0;0;0;2170927;1451;1;0;0
FR;3;2021-03-27;68462;102;0;0;0;2239389;1553;1;0;0
FR;3;2021-03-28;6479;20;0;0;0;2245868;1573;1;0;0
FR;3;2021-03-29;54168;76;0;0;0;2300036;1649;1;0;0
FR;3;2021-03-30;93180;101;0;0;0;2393216;1750;1;0;0
FR;3;2021-03-31;63541;109;0;0;0;2456757;1859;1;0;0
FR;3;2021-04-01;86133;114;0;0;0;2542890;1973;1;0;0
FR;3;2021-04-02;86911;178;0;0;0;2629801;2151;1;0;0
FR;3;2021-04-03;35875;129;0;0;0;2665676;2280;1;0;0
FR;3;2021-04-04;3576;19;0;0;0;2669252;2299;1;0;0
FR;3;2021-04-05;4491;38;0;0;0;2673743;2337;1;0;0
FR;3;2021-04-06;29758;95;0;0;0;2703501;2432;1;0;0
FR;3;2021-04-07;32344;98;0;0;0;2735845;2530;1;0;0
FR;3;2021-04-08;78822;254;0;0;0;2814667;2784;1;0;0
FR;3;2021-04-09;161755;433;0;0;0;2976422;3217;1;0;0
FR;3;2021-04-10;75762;359;0;0;0;3052184;3576;1;0;0
FR;3;2021-04-11;7312;46;0;0;0;3059496;3622;1;0;0
FR;3;2021-04-12;51482;217;0;0;0;3110978;3839;1;0;0
FR;3;2021-04-13;86232;346;0;0;0;3197210;4185;1;0;0
FR;3;2021-04-14;67845;366;0;0;0;3265055;4551;1;0;0
FR;3;2021-04-15;93233;390;0;0;0;3358288;4941;1;0;0
FR;3;2021-04-16;112522;600;0;0;0;3470810;5541;1;0;0
FR;3;2021-04-17;53318;340;1;0;0;3524128;5881;2;0;0
FR;3;2021-04-18;9747;44;0;0;0;3533875;5925;2;0;0
FR;3;2021-04-19;25112;268;0;0;0;3558987;6193;2;0;0
FR;3;2021-04-20;45673;421;0;0;0;3604660;6614;2;0;0
FR;3;2021-04-21;38985;508;0;0;0;3643645;7122;2;0;0
FR;3;2021-04-22;54713;831;0;0;0;3698358;7953;2;0;0
FR;3;2021-04-23;70490;1059;0;0;0;3768848;9012;2;0;0
FR;3;2021-04-24;37250;1065;0;0;0;3806098;10077;2;0;0
FR;3;2021-04-25;6212;155;0;0;0;3812310;10232;2;0;0
FR;3;2021-04-26;19788;684;0;0;0;3832098;10916;2;0;0
FR;3;2021-04-27;34482;1298;0;0;0;3866580;12214;2;0;0
FR;3;2021-04-28;28967;1995;0;0;0;3895547;14209;2;0;0
FR;3;2021-04-29;45386;6056;0;0;0;3940933;20265;2;0;0
FR;3;2021-04-30;55464;9025;1;0;0;3996397;29290;3;0;0
FR;3;2021-05-01;9516;2032;0;0;0;4005913;31322;3;0;0
FR;3;2021-05-02;3076;476;0;0;0;4008989;31798;3;0;0
FR;3;2021-05-03;13063;3897;0;0;0;4022052;35695;3;0;0
FR;3;2021-05-04;23114;8445;0;0;0;4045166;44140;3;0;0
FR;3;2021-05-05;18760;10743;0;0;0;4063926;54883;3;0;0
FR;3;2021-05-06;34629;21118;0;0;0;4098555;76001;3;0;0
FR;3;2021-05-07;44203;28720;0;0;0;4142758;104721;3;0;0
FR;3;2021-05-08;6785;9200;0;0;0;4149543;113921;3;0;0
FR;3;2021-05-09;1795;2649;0;0;0;4151338;116570;3;0;0
FR;3;2021-05-10;14996;12823;0;0;0;4166334;129393;3;0;0
FR;3;2021-05-11;27098;26095;0;0;0;4193432;155488;3;0;0
FR;3;2021-05-12;17268;27922;0;0;0;4210700;183410;3;0;0
FR;3;2021-05-13;2285;3496;0;0;0;4212985;186906;3;0;0
FR;3;2021-05-14;14520;25985;0;0;0;4227505;212891;3;0;0
FR;3;2021-05-15;7235;20974;0;0;0;4234740;233865;3;0;0
FR;3;2021-05-16;977;2650;0;0;0;4235717;236515;3;0;0
FR;3;2021-05-17;7965;20083;0;0;0;4243682;256598;3;0;0
FR;3;2021-05-18;13414;30019;0;0;0;4257096;286617;3;0;0
FR;3;2021-05-19;9274;30906;0;0;0;4266370;317523;3;0;0
FR;3;2021-05-20;12806;53633;3;0;0;4279176;371156;6;0;0
FR;3;2021-05-21;12766;65991;2;0;0;4291942;437147;8;0;0
FR;3;2021-05-22;4963;33633;1;0;0;4296905;470780;9;0;0
FR;3;2021-05-23;651;2655;0;0;0;4297556;473435;9;0;0
FR;3;2021-05-24;883;4842;0;0;0;4298439;478277;9;0;0
FR;3;2021-05-25;5311;46235;1;0;0;4303750;524512;10;0;0
FR;3;2021-05-26;4978;51834;1;0;0;4308728;576346;11;0;0
FR;3;2021-05-27;6334;78713;3;0;0;4315062;655059;14;0;0
FR;3;2021-05-28;7542;99921;2;0;0;4322604;754980;16;0;0
FR;3;2021-05-29;3349;60858;1;0;0;4325953;815838;17;0;0
FR;3;2021-05-30;549;8148;0;0;0;4326502;823986;17;0;0
FR;3;2021-05-31;2441;35614;3;0;0;4328943;859600;20;0;0
FR;3;2021-06-01;3411;64838;10;0;0;4332354;924438;30;0;0
FR;3;2021-06-02;2733;58696;6;0;0;4335087;983134;36;0;0
FR;3;2021-06-03;3495;87254;10;0;0;4338582;1070388;46;0;0
FR;3;2021-06-04;4117;105649;22;0;0;4342699;1176037;68;0;0
FR;3;2021-06-05;1983;52483;4;0;0;4344682;1228520;72;0;0
FR;3;2021-06-06;509;5311;1;0;0;4345191;1233831;73;0;0
FR;3;2021-06-07;1482;30802;11;0;0;4346673;1264633;84;0;0
FR;3;2021-06-08;2061;47364;18;0;0;4348734;1311997;102;0;0
FR;3;2021-06-09;1793;41942;13;0;0;4350527;1353939;115;0;0
FR;3;2021-06-10;2254;67760;17;0;0;4352781;1421699;132;0;0
FR;3;2021-06-11;2483;96647;34;0;0;4355264;1518346;166;0;0
FR;3;2021-06-12;1176;40657;6;0;0;4356440;1559003;172;0;0
FR;3;2021-06-13;283;3665;3;0;0;4356723;1562668;175;0;0
FR;3;2021-06-14;1047;42412;17;0;0;4357770;1605080;192;0;0
FR;3;2021-06-15;1374;80458;20;0;0;4359144;1685538;212;0;0
FR;3;2021-06-16;1261;65548;20;0;0;4360405;1751086;232;0;0
FR;3;2021-06-17;1666;102118;41;0;0;4362071;1853204;273;0;0
FR;3;2021-06-18;1870;118279;62;0;0;4363941;1971483;335;0;0
FR;3;2021-06-19;802;39447;22;0;0;4364743;2010930;357;0;0
FR;3;2021-06-20;161;3240;0;0;0;4364904;2014170;357;0;0
FR;3;2021-06-21;772;39102;16;0;0;4365676;2053272;373;0;0
FR;3;2021-06-22;1065;70027;52;0;0;4366741;2123299;425;0;0
FR;3;2021-06-23;943;50830;39;0;0;4367684;2174129;464;0;0
FR;3;2021-06-24;1310;77218;48;0;0;4368994;2251347;512;0;0
FR;3;2021-06-25;1409;90542;73;0;0;4370403;2341889;585;0;0
FR;3;2021-06-26;631;33109;29;0;0;4371034;2374998;614;0;0
FR;3;2021-06-27;166;3853;1;0;0;4371200;2378851;615;0;0
FR;3;2021-06-28;653;30127;27;0;0;4371853;2408978;642;0;0
FR;3;2021-06-29;857;56462;95;0;0;4372710;2465440;737;0;0
FR;3;2021-06-30;905;45156;93;0;0;4373615;2510596;830;0;0
FR;3;2021-07-01;1164;65949;108;0;0;4374779;2576545;938;0;0
FR;3;2021-07-02;1305;90487;170;0;0;4376084;2667032;1108;0;0
FR;3;2021-07-03;602;31185;51;0;0;4376686;2698217;1159;0;0
FR;3;2021-07-04;144;4056;3;0;0;4376830;2702273;1162;0;0
FR;3;2021-07-05;612;33695;60;0;0;4377442;2735968;1222;0;0
FR;3;2021-07-06;963;55978;88;0;0;4378405;2791946;1310;0;0
FR;3;2021-07-07;871;42983;80;0;0;4379276;2834929;1390;0;0
FR;3;2021-07-08;1127;60765;99;0;0;4380403;2895694;1489;0;0
FR;3;2021-07-09;1260;68879;128;0;0;4381663;2964573;1617;0;0
FR;3;2021-07-10;643;25040;59;0;0;4382306;2989613;1676;0;0
FR;3;2021-07-11;131;3207;4;0;0;4382437;2992820;1680;0;0
FR;3;2021-07-12;662;23722;59;0;0;4383099;3016542;1739;0;0
FR;3;2021-07-13;1647;34550;90;0;0;4384746;3051092;1829;0;0
FR;3;2021-07-14;269;2510;2;0;0;4385015;3053602;1831;0;0
FR;3;2021-07-15;1941;30506;85;0;0;4386956;3084108;1916;0;0
FR;3;2021-07-16;2520;38721;122;0;0;4389476;3122829;2038;0;0
FR;3;2021-07-17;1051;13726;26;0;0;4390527;3136555;2064;0;0
FR;3;2021-07-18;266;2563;3;0;0;4390793;3139118;2067;0;0
FR;3;2021-07-19;1278;16992;37;0;0;4392071;3156110;2104;0;0
FR;3;2021-07-20;1823;26994;98;0;0;4393894;3183104;2202;0;0
FR;3;2021-07-21;1651;19575;44;0;0;4395545;3202679;2246;0;0
FR;3;2021-07-22;1856;27673;83;0;0;4397401;3230352;2329;0;0
FR;3;2021-07-23;2216;30304;117;0;0;4399617;3260656;2446;0;0
FR;3;2021-07-24;826;6958;25;0;0;4400443;3267614;2471;0;0
FR;3;2021-07-25;210;1300;1;0;0;4400653;3268914;2472;0;0
FR;3;2021-07-26;930;10564;28;0;0;4401583;3279478;2500;0;0
FR;3;2021-07-27;1169;16863;56;0;0;4402752;3296341;2556;0;0
FR;3;2021-07-28;989;12032;40;0;0;4403741;3308373;2596;0;0
FR;3;2021-07-29;1127;15734;63;0;0;4404868;3324107;2659;0;0
FR;3;2021-07-30;1128;18010;79;0;0;4405996;3342117;2738;0;0
FR;3;2021-07-31;406;3732;15;0;0;4406402;3345849;2753;0;0
FR;3;2021-08-01;116;457;1;0;0;4406518;3346306;2754;0;0
FR;3;2021-08-02;421;5057;22;0;0;4406939;3351363;2776;0;0
FR;3;2021-08-03;496;7500;27;0;0;4407435;3358863;2803;0;0
FR;3;2021-08-04;438;4849;26;0;0;4407873;3363712;2829;0;0
FR;3;2021-08-05;431;3673;13;0;0;4408304;3367385;2842;0;0
FR;3;2021-08-06;456;4730;30;0;0;4408760;3372115;2872;0;0
FR;3;2021-08-07;214;1898;11;0;0;4408974;3374013;2883;0;0
FR;3;2021-08-08;250;425;2;0;0;4409224;3374438;2885;0;0
FR;3;2021-08-09;318;2414;11;0;0;4409542;3376852;2896;0;0
FR;3;2021-08-10;368;3788;15;0;0;4409910;3380640;2911;0;0
FR;3;2021-08-11;291;2680;15;0;0;4410201;3383320;2926;0;0
FR;3;2021-08-12;277;2600;12;0;0;4410478;3385920;2938;0;0
FR;3;2021-08-13;278;2264;16;0;0;4410756;3388184;2954;0;0
FR;3;2021-08-14;172;892;1;0;0;4410928;3389076;2955;0;0
FR;3;2021-08-15;56;176;0;0;0;4410984;3389252;2955;0;0
FR;3;2021-08-16;124;1038;8;0;0;4411108;3390290;2963;0;0
FR;3;2021-08-17;189;1451;8;0;0;4411297;3391741;2971;0;0
FR;3;2021-08-18;204;1319;10;0;0;4411501;3393060;2981;0;0
FR;3;2021-08-19;165;1388;10;0;0;4411666;3394448;2991;0;0
FR;3;2021-08-20;167;1605;16;0;0;4411833;3396053;3007;0;0
FR;3;2021-08-21;93;586;2;0;0;4411926;3396639;3009;0;0
FR;3;2021-08-22;42;190;1;0;0;4411968;3396829;3010;0;0
FR;3;2021-08-23;141;903;7;0;0;4412109;3397732;3017;0;0
FR;3;2021-08-24;125;932;10;0;0;4412234;3398664;3027;0;0
FR;3;2021-08-25;137;827;3;0;0;4412371;3399491;3030;0;0
FR;3;2021-08-26;172;838;9;0;0;4412543;3400329;3039;0;0
FR;3;2021-08-27;178;943;9;0;0;4412721;3401272;3048;0;0
FR;3;2021-08-28;101;372;4;0;0;4412822;3401644;3052;0;0
FR;3;2021-08-29;128;132;1;0;0;4412950;3401776;3053;0;0
FR;3;2021-08-30;100;574;0;0;117;4413050;3402350;3053;0;117
FR;3;2021-08-31;133;696;7;0;141;4413183;3403046;3060;0;258
FR;3;2021-09-01;121;462;5;0;112;4413304;3403508;3065;0;370
FR;3;2021-09-02;100;614;22;0;108;4413404;3404122;3087;0;478
FR;3;2021-09-03;116;568;17;0;120;4413520;3404690;3104;0;598
FR;3;2021-09-04;55;298;3;0;53;4413575;3404988;3107;0;651
FR;3;2021-09-05;51;67;5;0;26;4413626;3405055;3112;0;677
FR;3;2021-09-06;118;379;4;0;138;4413744;3405434;3116;0;815
FR;3;2021-09-07;124;442;14;0;119;4413868;3405876;3130;0;934
FR;3;2021-09-08;121;349;2;0;93;4413989;3406225;3132;0;1027
FR;3;2021-09-09;94;383;8;0;105;4414083;3406608;3140;0;1132
FR;3;2021-09-10;101;408;3;0;97;4414184;3407016;3143;0;1229
FR;3;2021-09-11;76;233;4;0;65;4414260;3407249;3147;0;1294
FR;3;2021-09-12;37;47;1;0;16;4414297;3407296;3148;0;1310
FR;3;2021-09-13;73;307;7;0;101;4414370;3407603;3155;0;1411
FR;3;2021-09-14;75;279;6;0;97;4414445;3407882;3161;0;1508
FR;3;2021-09-15;62;256;3;0;6;4414507;3408138;3164;0;1514
FR;3;2021-09-16;65;322;6;0;6;4414572;3408460;3170;0;1520
FR;3;2021-09-17;52;330;3;0;7;4414624;3408790;3173;0;1527
FR;3;2021-09-18;37;175;1;0;1;4414661;3408965;3174;0;1528
FR;3;2021-09-19;28;31;2;0;1;4414689;3408996;3176;0;1529
FR;3;2021-09-20;81;195;0;0;1;4414770;3409191;3176;0;1530
FR;3;2021-09-21;60;281;6;0;7;4414830;3409472;3182;0;1537
FR;3;2021-09-22;65;234;6;0;7;4414895;3409706;3188;0;1544
FR;3;2021-09-23;37;263;11;0;7;4414932;3409969;3199;0;1551
FR;3;2021-09-24;28;321;12;0;18;4414960;3410290;3211;0;1569
FR;3;2021-09-25;31;143;3;0;3;4414991;3410433;3214;0;1572
FR;3;2021-09-26;16;59;1;0;1;4415007;3410492;3215;0;1573
FR;3;2021-09-27;48;289;3;0;5;4415055;3410781;3218;0;1578
FR;3;2021-09-28;49;248;6;0;8;4415104;3411029;3224;0;1586
FR;3;2021-09-29;37;223;10;0;15;4415141;3411252;3234;0;1601
FR;3;2021-09-30;40;201;8;0;10;4415181;3411453;3242;0;1611
FR;3;2021-10-01;23;162;6;0;7;4415204;3411615;3248;0;1618
FR;3;2021-10-02;17;85;0;0;0;4415221;3411700;3248;0;1618
FR;3;2021-10-03;19;18;1;0;2;4415240;3411718;3249;0;1620
FR;3;2021-10-04;33;159;4;0;4;4415273;3411877;3253;0;1624
FR;3;2021-10-05;17;148;10;0;12;4415290;3412025;3263;0;1636
FR;3;2021-10-06;32;148;8;0;9;4415322;3412173;3271;0;1645
FR;3;2021-10-07;19;134;6;0;6;4415341;3412307;3277;0;1651
FR;3;2021-10-08;25;138;10;0;9;4415366;3412445;3287;0;1660
FR;3;2021-10-09;16;72;1;0;1;4415382;3412517;3288;0;1661
FR;3;2021-10-10;13;18;2;0;3;4415395;3412535;3290;0;1664
FR;3;2021-10-11;16;117;4;0;5;4415411;3412652;3294;0;1669
FR;3;2021-10-12;20;103;5;0;5;4415431;3412755;3299;0;1674
FR;3;2021-10-13;25;117;9;0;7;4415456;3412872;3308;0;1681
FR;3;2021-10-14;18;151;3;0;4;4415474;3413023;3311;0;1685
FR;3;2021-10-15;23;145;8;0;12;4415497;3413168;3319;0;1697
FR;3;2021-10-16;13;74;6;0;8;4415510;3413242;3325;0;1705
FR;3;2021-10-17;12;25;0;0;0;4415522;3413267;3325;0;1705
FR;3;2021-10-18;18;116;2;0;2;4415540;3413383;3327;0;1707
FR;3;2021-10-19;16;116;19;0;21;4415556;3413499;3346;0;1728
FR;3;2021-10-20;26;126;6;0;7;4415582;3413625;3352;0;1735
FR;3;2021-10-21;28;129;17;0;13;4415610;3413754;3369;0;1748
FR;3;2021-10-22;24;110;16;0;19;4415634;3413864;3385;0;1767
FR;3;2021-10-23;17;55;2;0;1;4415651;3413919;3387;0;1768
FR;3;2021-10-24;7;36;0;0;0;4415658;3413955;3387;0;1768
FR;3;2021-10-25;24;146;7;0;7;4415682;3414101;3394;0;1775
FR;3;2021-10-26;25;99;22;0;19;4415707;3414200;3416;0;1794
FR;3;2021-10-27;18;99;9;0;9;4415725;3414299;3425;0;1803
FR;3;2021-10-28;22;117;33;0;36;4415747;3414416;3458;0;1839
FR;3;2021-10-29;12;104;64;0;54;4415759;3414520;3522;0;1893
FR;3;2021-10-30;11;63;11;1;10;4415770;3414583;3533;1;1903
FR;3;2021-10-31;8;25;1;0;1;4415778;3414608;3534;1;1904
FR;3;2021-11-01;10;22;2;0;1;4415788;3414630;3536;1;1905
FR;3;2021-11-02;10;102;10;0;12;4415798;3414732;3546;1;1917
FR;3;2021-11-03;19;111;10;0;10;4415817;3414843;3556;1;1927
FR;3;2021-11-04;20;91;5;0;4;4415837;3414934;3561;1;1931
FR;3;2021-11-05;19;124;9;1;6;4415856;3415058;3570;2;1937
FR;3;2021-11-06;10;59;3;0;3;4415866;3415117;3573;2;1940
FR;3;2021-11-07;6;22;1;0;1;4415872;3415139;3574;2;1941
FR;3;2021-11-08;11;136;7;0;5;4415883;3415275;3581;2;1946
FR;3;2021-11-09;13;133;5;0;5;4415896;3415408;3586;2;1951
FR;3;2021-11-10;14;160;14;0;15;4415910;3415568;3600;2;1966
FR;3;2021-11-11;11;49;3;0;3;4415921;3415617;3603;2;1969
FR;3;2021-11-12;15;132;6;0;4;4415936;3415749;3609;2;1973
FR;3;2021-11-13;7;68;9;0;10;4415943;3415817;3618;2;1983
FR;3;2021-11-14;3;24;1;0;1;4415946;3415841;3619;2;1984
FR;3;2021-11-15;5;172;10;0;11;4415951;3416013;3629;2;1995
FR;3;2021-11-16;7;137;11;0;10;4415958;3416150;3640;2;2005
FR;3;2021-11-17;7;150;11;0;8;4415965;3416300;3651;2;2013
FR;3;2021-11-18;15;149;10;0;11;4415980;3416449;3661;2;2024
FR;3;2021-11-19;11;196;22;0;27;4415991;3416645;3683;2;2051
FR;3;2021-11-20;6;105;6;0;6;4415997;3416750;3689;2;2057
FR;3;2021-11-21;3;26;4;0;4;4416000;3416776;3693;2;2061
FR;3;2021-11-22;11;201;11;0;11;4416011;3416977;3704;2;2072
FR;3;2021-11-23;9;198;15;0;14;4416020;3417175;3719;2;2086
FR;3;2021-11-24;9;201;9;0;17;4416029;3417376;3728;2;2103
FR;3;2021-11-25;12;231;11;0;11;4416041;3417607;3739;2;2114
FR;3;2021-11-26;9;301;35;0;33;4416050;3417908;3774;2;2147
FR;3;2021-11-27;8;141;20;0;21;4416058;3418049;3794;2;2168
FR;3;2021-11-28;3;60;7;0;7;4416061;3418109;3801;2;2175
FR;3;2021-11-29;5;253;21;0;22;4416066;3418362;3822;2;2197
FR;3;2021-11-30;7;338;29;0;32;4416073;3418700;3851;2;2229
FR;3;2021-12-01;30;370;37;0;39;4416103;3419070;3888;2;2268
FR;3;2021-12-02;9;388;33;0;36;4416112;3419458;3921;2;2304
FR;3;2021-12-03;4;433;37;0;38;4416116;3419891;3958;2;2342
FR;3;2021-12-04;3;233;26;0;28;4416119;3420124;3984;2;2370
FR;3;2021-12-05;1;66;5;0;5;4416120;3420190;3989;2;2375
FR;3;2021-12-06;6;404;14;0;15;4416126;3420594;4003;2;2390
FR;3;2021-12-07;4;476;20;0;24;4416130;3421070;4023;2;2414
FR;3;2021-12-08;7;433;29;0;30;4416137;3421503;4052;2;2444
FR;3;2021-12-09;3;493;17;0;22;4416140;3421996;4069;2;2466
FR;3;2021-12-10;10;506;29;0;25;4416150;3422502;4098;2;2491
FR;3;2021-12-11;4;330;10;0;9;4416154;3422832;4108;2;2500
FR;3;2021-12-12;1;108;3;0;3;4416155;3422940;4111;2;2503
FR;3;2021-12-13;2;483;19;0;21;4416157;3423423;4130;2;2524
FR;3;2021-12-14;8;622;18;0;21;4416165;3424045;4148;2;2545
FR;3;2021-12-15;9;596;17;0;21;4416174;3424641;4165;2;2566
FR;3;2021-12-16;10;604;19;0;18;4416184;3425245;4184;2;2584
FR;3;2021-12-17;5;687;18;0;19;4416189;3425932;4202;2;2603
FR;3;2021-12-18;4;372;4;0;5;4416193;3426304;4206;2;2608
FR;3;2021-12-19;3;193;2;0;2;4416196;3426497;4208;2;2610
FR;3;2021-12-20;8;627;23;0;28;4416204;3427124;4231;2;2638
FR;3;2021-12-21;3;714;10;0;13;4416207;3427838;4241;2;2651
FR;3;2021-12-22;10;667;9;0;10;4416217;3428505;4250;2;2661
FR;3;2021-12-23;3;583;8;0;8;4416220;3429088;4258;2;2669
FR;3;2021-12-24;2;246;3;0;6;4416222;3429334;4261;2;2675
FR;3;2021-12-25;0;25;0;0;0;4416222;3429359;4261;2;2675
FR;3;2021-12-26;0;92;1;0;1;4416222;3429451;4262;2;2676
FR;3;2021-12-27;7;492;17;0;20;4416229;3429943;4279;2;2696
FR;3;2021-12-28;3;633;6;0;5;4416232;3430576;4285;2;2701
FR;3;2021-12-29;4;526;14;0;16;4416236;3431102;4299;2;2717
FR;3;2021-12-30;3;547;7;0;10;4416239;3431649;4306;2;2727
FR;3;2021-12-31;0;192;5;0;7;4416239;3431841;4311;2;2734
FR;3;2022-01-01;0;26;0;0;2;4416239;3431867;4311;2;2736
FR;3;2022-01-02;0;80;0;0;0;4416239;3431947;4311;2;2736
FR;3;2022-01-03;4;528;17;0;21;4416243;3432475;4328;2;2757
FR;3;2022-01-04;6;573;9;0;8;4416249;3433048;4337;2;2765
FR;3;2022-01-05;5;518;10;0;14;4416254;3433566;4347;2;2779
FR;3;2022-01-06;6;495;9;0;10;4416260;3434061;4356;2;2789
FR;3;2022-01-07;2;522;11;0;13;4416262;3434583;4367;2;2802
FR;3;2022-01-08;4;263;4;0;5;4416266;3434846;4371;2;2807
FR;3;2022-01-09;0;117;0;0;0;4416266;3434963;4371;2;2807
FR;3;2022-01-10;2;452;12;0;12;4416268;3435415;4383;2;2819
FR;3;2022-01-11;3;486;1;0;1;4416271;3435901;4384;2;2820
FR;3;2022-01-12;2;412;9;0;10;4416273;3436313;4393;2;2830
FR;3;2022-01-13;3;405;11;0;12;4416276;3436718;4404;2;2842
FR;3;2022-01-14;3;445;10;0;13;4416279;3437163;4414;2;2855
FR;3;2022-01-15;0;288;2;0;3;4416279;3437451;4416;2;2858
FR;3;2022-01-16;1;110;1;0;1;4416280;3437561;4417;2;2859
FR;3;2022-01-17;2;334;8;0;9;4416282;3437895;4425;2;2868
FR;3;2022-01-18;2;379;1;0;2;4416284;3438274;4426;2;2870
FR;3;2022-01-19;2;335;5;0;10;4416286;3438609;4431;2;2880
FR;3;2022-01-20;1;362;5;0;3;4416287;3438971;4436;2;2883
FR;3;2022-01-21;4;353;5;0;7;4416291;3439324;4441;2;2890
FR;3;2022-01-22;2;229;1;0;2;4416293;3439553;4442;2;2892
FR;3;2022-01-23;0;80;0;0;1;4416293;3439633;4442;2;2893
FR;3;2022-01-24;2;329;1;0;6;4416295;3439962;4443;2;2899
FR;3;2022-01-25;0;180;0;0;0;4416295;3440142;4443;2;2899
FR;3;2022-01-26;0;80;0;0;0;4416295;3440222;4443;2;2899
FR;3;2022-01-27;0;54;0;0;0;4416295;3440276;4443;2;2899
FR;3;2022-01-28;0;123;0;0;0;4416295;3440399;4443;2;2899
FR;3;2022-01-29;0;101;0;0;0;4416295;3440500;4443;2;2899
FR;3;2022-01-30;0;51;0;0;0;4416295;3440551;4443;2;2899
FR;3;2022-01-31;0;93;0;0;0;4416295;3440644;4443;2;2899
FR;3;2022-02-01;0;100;0;0;1;4416295;3440744;4443;2;2900
FR;3;2022-02-02;0;86;0;0;0;4416295;3440830;4443;2;2900
FR;3;2022-02-03;0;96;0;0;0;4416295;3440926;4443;2;2900
FR;3;2022-02-04;0;117;0;0;0;4416295;3441043;4443;2;2900
FR;3;2022-02-05;0;71;0;0;0;4416295;3441114;4443;2;2900
FR;3;2022-02-06;0;11;0;0;0;4416295;3441125;4443;2;2900
FR;3;2022-02-07;0;81;0;0;0;4416295;3441206;4443;2;2900
FR;3;2022-02-08;0;0;0;0;0;4416295;3441206;4443;2;2900
FR;3;2022-02-09;0;0;0;0;0;4416295;3441206;4443;2;2900
FR;3;2022-02-10;0;0;0;0;0;4416295;3441206;4443;2;2900
FR;3;2022-02-11;0;0;0;0;0;4416295;3441206;4443;2;2900
FR;3;2022-02-12;0;0;0;0;0;4416295;3441206;4443;2;2900
FR;3;2022-02-13;0;0;0;0;0;4416295;3441206;4443;2;2900
FR;3;2022-02-14;0;0;0;0;0;4416295;3441206;4443;2;2900
FR;3;2022-02-15;0;0;0;0;0;4416295;3441206;4443;2;2900
FR;3;2022-02-16;0;0;0;0;0;4416295;3441206;4443;2;2900
FR;3;2022-02-17;0;0;0;0;0;4416295;3441206;4443;2;2900
FR;3;2022-02-18;0;0;0;0;0;4416295;3441206;4443;2;2900
FR;3;2022-02-19;0;0;0;0;0;4416295;3441206;4443;2;2900
FR;3;2022-02-20;0;0;0;0;0;4416295;3441206;4443;2;2900
FR;3;2022-02-21;2;0;0;0;0;4416297;3441206;4443;2;2900
FR;3;2022-02-22;0;0;0;0;0;4416297;3441206;4443;2;2900
FR;3;2022-02-23;0;0;0;0;0;4416297;3441206;4443;2;2900
FR;3;2022-02-24;0;0;0;0;0;4416297;3441206;4443;2;2900
FR;3;2022-02-25;0;0;0;0;0;4416297;3441206;4443;2;2900
FR;3;2022-02-26;0;0;0;0;0;4416297;3441206;4443;2;2900
FR;3;2022-02-27;0;0;0;0;0;4416297;3441206;4443;2;2900
FR;3;2022-02-28;1;0;0;0;0;4416298;3441206;4443;2;2900
FR;3;2022-03-01;1;0;0;0;0;4416299;3441206;4443;2;2900
FR;3;2022-03-02;0;0;0;0;0;4416299;3441206;4443;2;2900
FR;3;2022-03-03;0;0;0;0;0;4416299;3441206;4443;2;2900
FR;3;2022-03-04;0;0;0;0;0;4416299;3441206;4443;2;2900
FR;3;2022-03-05;0;0;0;0;0;4416299;3441206;4443;2;2900
FR;3;2022-03-06;1;0;0;0;0;4416300;3441206;4443;2;2900
FR;3;2022-03-07;0;0;0;0;0;4416300;3441206;4443;2;2900
FR;3;2022-03-08;1;0;0;0;0;4416301;3441206;4443;2;2900
FR;3;2022-03-09;0;0;0;0;0;4416301;3441206;4443;2;2900
FR;3;2022-03-10;0;0;0;0;0;4416301;3441206;4443;2;2900
FR;3;2022-03-11;0;0;0;0;0;4416301;3441206;4443;2;2900
FR;3;2022-03-12;0;0;0;0;0;4416301;3441206;4443;2;2900
FR;3;2022-03-13;0;0;0;0;0;4416301;3441206;4443;2;2900
FR;3;2022-03-14;0;0;0;0;0;4416301;3441206;4443;2;2900
FR;3;2022-03-15;0;0;0;0;0;4416301;3441206;4443;2;2900
FR;3;2022-03-16;0;0;0;0;0;4416301;3441206;4443;2;2900
FR;3;2022-03-17;0;0;0;0;0;4416301;3441206;4443;2;2900
FR;3;2022-03-18;0;0;0;0;0;4416301;3441206;4443;2;2900
FR;3;2022-03-19;0;0;0;0;0;4416301;3441206;4443;2;2900
FR;3;2022-03-20;1;0;0;0;0;4416302;3441206;4443;2;2900
FR;3;2022-03-21;0;0;0;0;0;4416302;3441206;4443;2;2900
FR;3;2022-03-22;0;0;0;0;0;4416302;3441206;4443;2;2900
FR;3;2022-03-23;1;0;0;0;0;4416303;3441206;4443;2;2900
FR;3;2022-03-24;0;0;0;0;0;4416303;3441206;4443;2;2900
FR;3;2022-03-25;1;0;0;0;0;4416304;3441206;4443;2;2900
FR;3;2022-03-26;0;0;0;0;0;4416304;3441206;4443;2;2900
FR;3;2022-03-27;0;0;0;0;0;4416304;3441206;4443;2;2900
FR;3;2022-03-28;0;0;0;0;0;4416304;3441206;4443;2;2900
FR;3;2022-03-29;0;0;0;0;0;4416304;3441206;4443;2;2900
FR;3;2022-03-30;0;0;0;0;0;4416304;3441206;4443;2;2900
FR;3;2022-03-31;0;0;0;0;0;4416304;3441206;4443;2;2900
FR;3;2022-04-01;0;0;0;0;0;4416304;3441206;4443;2;2900
FR;3;2022-04-02;0;0;0;0;0;4416304;3441206;4443;2;2900
FR;3;2022-04-03;0;0;0;0;0;4416304;3441206;4443;2;2900
FR;3;2022-04-04;0;0;0;0;0;4416304;3441206;4443;2;2900
FR;3;2022-04-05;0;0;0;0;0;4416304;3441206;4443;2;2900
FR;3;2022-04-06;0;0;0;0;0;4416304;3441206;4443;2;2900
FR;3;2022-04-07;0;0;0;0;0;4416304;3441206;4443;2;2900
FR;3;2022-04-08;0;0;0;0;0;4416304;3441206;4443;2;2900
FR;3;2022-04-09;0;0;0;0;0;4416304;3441206;4443;2;2900
FR;3;2022-04-10;0;0;0;0;0;4416304;3441206;4443;2;2900
FR;3;2022-04-11;0;0;0;0;0;4416304;3441206;4443;2;2900
FR;3;2022-04-12;0;0;0;0;0;4416304;3441206;4443;2;2900
FR;3;2022-04-13;0;0;0;0;0;4416304;3441206;4443;2;2900
FR;3;2022-04-14;0;0;0;0;0;4416304;3441206;4443;2;2900
FR;3;2022-04-15;1;0;0;0;0;4416305;3441206;4443;2;2900
FR;3;2022-04-16;0;0;0;0;0;4416305;3441206;4443;2;2900
FR;3;2022-04-17;0;0;0;0;0;4416305;3441206;4443;2;2900
FR;3;2022-04-18;0;0;0;0;0;4416305;3441206;4443;2;2900
FR;3;2022-04-19;0;0;0;0;0;4416305;3441206;4443;2;2900
FR;3;2022-04-20;0;0;0;0;0;4416305;3441206;4443;2;2900
FR;3;2022-04-21;0;0;0;0;0;4416305;3441206;4443;2;2900
FR;3;2022-04-22;0;0;0;0;0;4416305;3441206;4443;2;2900
FR;3;2022-04-23;0;0;0;0;0;4416305;3441206;4443;2;2900
FR;3;2022-04-24;0;0;0;0;0;4416305;3441206;4443;2;2900
FR;3;2022-04-25;0;0;0;0;0;4416305;3441206;4443;2;2900
FR;3;2022-04-26;0;0;0;0;0;4416305;3441206;4443;2;2900
FR;3;2022-04-27;0;0;0;0;0;4416305;3441206;4443;2;2900
FR;3;2022-04-28;0;0;0;0;0;4416305;3441206;4443;2;2900
FR;3;2022-04-29;0;0;0;0;0;4416305;3441206;4443;2;2900
FR;3;2022-04-30;0;0;0;0;0;4416305;3441206;4443;2;2900
FR;3;2022-05-01;0;0;0;0;0;4416305;3441206;4443;2;2900
FR;3;2022-05-02;0;0;0;0;0;4416305;3441206;4443;2;2900
FR;3;2022-05-03;0;0;0;0;0;4416305;3441206;4443;2;2900
FR;3;2022-05-04;0;0;0;0;0;4416305;3441206;4443;2;2900
FR;3;2022-05-05;0;0;0;0;0;4416305;3441206;4443;2;2900
FR;3;2022-05-06;0;0;0;0;0;4416305;3441206;4443;2;2900
FR;3;2022-05-07;0;0;0;0;0;4416305;3441206;4443;2;2900
FR;3;2022-05-08;0;0;0;0;0;4416305;3441206;4443;2;2900
FR;3;2022-05-09;0;0;0;0;0;4416305;3441206;4443;2;2900
FR;3;2022-05-10;0;0;0;0;0;4416305;3441206;4443;2;2900
FR;3;2022-05-11;0;0;0;0;0;4416305;3441206;4443;2;2900
FR;3;2022-05-12;0;0;0;0;0;4416305;3441206;4443;2;2900
FR;3;2022-05-13;0;0;0;0;0;4416305;3441206;4443;2;2900
FR;3;2022-05-14;1;0;0;0;0;4416306;3441206;4443;2;2900
FR;3;2022-05-15;0;0;0;0;0;4416306;3441206;4443;2;2900
FR;3;2022-05-16;0;0;0;0;0;4416306;3441206;4443;2;2900
FR;3;2022-05-17;0;0;0;0;0;4416306;3441206;4443;2;2900
FR;3;2022-05-18;0;0;0;0;0;4416306;3441206;4443;2;2900
FR;3;2022-05-19;0;0;0;0;0;4416306;3441206;4443;2;2900
FR;3;2022-05-20;0;0;0;0;0;4416306;3441206;4443;2;2900
FR;3;2022-05-21;0;0;0;0;0;4416306;3441206;4443;2;2900
FR;3;2022-05-22;0;0;0;0;0;4416306;3441206;4443;2;2900
FR;3;2022-05-23;0;0;0;0;0;4416306;3441206;4443;2;2900
FR;3;2022-05-24;0;0;0;0;0;4416306;3441206;4443;2;2900
FR;3;2022-05-25;0;0;0;0;0;4416306;3441206;4443;2;2900
FR;3;2022-05-26;0;0;0;0;0;4416306;3441206;4443;2;2900
FR;3;2022-05-27;0;0;0;0;0;4416306;3441206;4443;2;2900
FR;3;2022-05-28;0;0;0;0;0;4416306;3441206;4443;2;2900
FR;3;2022-05-29;0;0;0;0;0;4416306;3441206;4443;2;2900
FR;3;2022-05-30;0;0;0;0;0;4416306;3441206;4443;2;2900
FR;3;2022-05-31;0;0;0;0;0;4416306;3441206;4443;2;2900
FR;3;2022-06-01;0;0;0;0;0;4416306;3441206;4443;2;2900
FR;3;2022-06-02;0;0;0;0;0;4416306;3441206;4443;2;2900
FR;3;2022-06-03;0;0;0;0;0;4416306;3441206;4443;2;2900
FR;3;2022-06-04;0;0;0;0;0;4416306;3441206;4443;2;2900
FR;3;2022-06-05;0;0;0;0;0;4416306;3441206;4443;2;2900
FR;3;2022-06-06;0;0;0;0;0;4416306;3441206;4443;2;2900
FR;3;2022-06-07;0;0;0;0;0;4416306;3441206;4443;2;2900
FR;3;2022-06-08;0;0;0;0;0;4416306;3441206;4443;2;2900
FR;3;2022-06-09;0;0;0;0;0;4416306;3441206;4443;2;2900
FR;3;2022-06-10;0;0;0;0;0;4416306;3441206;4443;2;2900
FR;3;2022-06-11;0;0;0;0;0;4416306;3441206;4443;2;2900
FR;3;2022-06-12;0;0;0;0;0;4416306;3441206;4443;2;2900
FR;3;2022-06-13;1;0;0;0;0;4416307;3441206;4443;2;2900
FR;3;2022-06-14;0;0;0;0;0;4416307;3441206;4443;2;2900
FR;3;2022-06-15;0;0;0;0;0;4416307;3441206;4443;2;2900
FR;3;2022-06-16;0;0;0;0;0;4416307;3441206;4443;2;2900
FR;3;2022-06-17;0;0;0;0;0;4416307;3441206;4443;2;2900
FR;3;2022-06-18;0;0;0;0;0;4416307;3441206;4443;2;2900
FR;3;2022-06-19;0;0;0;0;0;4416307;3441206;4443;2;2900
FR;3;2022-06-20;0;0;0;0;0;4416307;3441206;4443;2;2900
FR;3;2022-06-21;0;0;0;0;0;4416307;3441206;4443;2;2900
FR;3;2022-06-22;0;0;0;0;0;4416307;3441206;4443;2;2900
FR;3;2022-06-23;0;0;0;0;0;4416307;3441206;4443;2;2900
FR;3;2022-06-24;0;0;0;0;0;4416307;3441206;4443;2;2900
FR;3;2022-06-25;0;0;0;0;0;4416307;3441206;4443;2;2900
FR;3;2022-06-26;0;0;0;0;0;4416307;3441206;4443;2;2900
FR;3;2022-06-27;0;0;0;0;0;4416307;3441206;4443;2;2900
FR;3;2022-06-28;0;0;0;0;0;4416307;3441206;4443;2;2900
FR;3;2022-06-29;1;0;0;0;0;4416308;3441206;4443;2;2900
FR;3;2022-06-30;0;0;0;0;0;4416308;3441206;4443;2;2900
FR;3;2022-07-01;0;0;0;0;0;4416308;3441206;4443;2;2900
FR;3;2022-07-02;0;0;0;0;0;4416308;3441206;4443;2;2900
FR;3;2022-07-03;0;0;0;0;0;4416308;3441206;4443;2;2900
FR;3;2022-07-04;0;0;0;0;0;4416308;3441206;4443;2;2900
FR;3;2022-07-05;0;0;0;0;0;4416308;3441206;4443;2;2900
FR;3;2022-07-06;0;0;0;0;0;4416308;3441206;4443;2;2900
FR;3;2022-07-07;0;0;0;0;0;4416308;3441206;4443;2;2900
FR;3;2022-07-08;0;0;0;0;0;4416308;3441206;4443;2;2900
FR;3;2022-07-09;0;0;0;0;0;4416308;3441206;4443;2;2900
FR;3;2022-07-10;0;0;0;0;0;4416308;3441206;4443;2;2900
FR;3;2022-07-11;0;0;0;0;0;4416308;3441206;4443;2;2900
FR;3;2022-07-12;0;0;0;0;0;4416308;3441206;4443;2;2900
FR;3;2022-07-13;0;0;0;0;0;4416308;3441206;4443;2;2900
FR;3;2022-07-14;0;0;0;0;0;4416308;3441206;4443;2;2900
FR;3;2022-07-15;0;0;0;0;0;4416308;3441206;4443;2;2900
FR;3;2022-07-16;0;0;0;0;0;4416308;3441206;4443;2;2900
FR;3;2022-07-17;0;0;0;0;0;4416308;3441206;4443;2;2900
FR;3;2022-07-18;0;0;0;0;0;4416308;3441206;4443;2;2900
FR;3;2022-07-19;0;0;0;0;0;4416308;3441206;4443;2;2900
FR;3;2022-07-20;0;0;0;0;0;4416308;3441206;4443;2;2900
FR;3;2022-07-21;0;0;0;0;0;4416308;3441206;4443;2;2900
FR;3;2022-07-22;0;0;0;0;0;4416308;3441206;4443;2;2900
FR;3;2022-07-23;0;0;0;0;0;4416308;3441206;4443;2;2900
FR;3;2022-07-24;0;0;0;0;0;4416308;3441206;4443;2;2900
FR;3;2022-07-25;0;0;0;0;0;4416308;3441206;4443;2;2900
FR;3;2022-07-26;0;0;0;0;0;4416308;3441206;4443;2;2900
FR;3;2022-07-27;0;0;0;0;0;4416308;3441206;4443;2;2900
FR;3;2022-07-28;0;0;0;0;0;4416308;3441206;4443;2;2900
FR;3;2022-07-29;0;0;0;0;0;4416308;3441206;4443;2;2900
FR;3;2022-07-30;0;0;0;0;0;4416308;3441206;4443;2;2900
FR;3;2022-07-31;0;0;0;0;0;4416308;3441206;4443;2;2900
FR;3;2022-08-01;0;0;0;0;0;4416308;3441206;4443;2;2900
FR;3;2022-08-02;0;0;0;0;0;4416308;3441206;4443;2;2900
FR;3;2022-08-03;0;0;0;0;0;4416308;3441206;4443;2;2900
FR;3;2022-08-04;0;0;0;0;0;4416308;3441206;4443;2;2900
FR;3;2022-08-05;0;0;0;0;0;4416308;3441206;4443;2;2900
FR;3;2022-08-06;0;0;0;0;0;4416308;3441206;4443;2;2900
FR;3;2022-08-07;0;0;0;0;0;4416308;3441206;4443;2;2900
FR;3;2022-08-08;0;0;0;0;0;4416308;3441206;4443;2;2900
FR;3;2022-08-09;0;0;0;0;0;4416308;3441206;4443;2;2900
FR;3;2022-08-10;0;0;0;0;0;4416308;3441206;4443;2;2900
FR;3;2022-08-11;0;0;0;0;0;4416308;3441206;4443;2;2900
FR;3;2022-08-12;0;0;0;0;0;4416308;3441206;4443;2;2900
FR;3;2022-08-13;0;0;0;0;0;4416308;3441206;4443;2;2900
FR;3;2022-08-14;0;0;0;0;0;4416308;3441206;4443;2;2900
FR;3;2022-08-15;0;0;0;0;0;4416308;3441206;4443;2;2900
FR;3;2022-08-16;0;0;0;0;0;4416308;3441206;4443;2;2900
FR;3;2022-08-17;0;0;0;0;0;4416308;3441206;4443;2;2900
FR;3;2022-08-18;0;0;0;0;0;4416308;3441206;4443;2;2900
FR;3;2022-08-19;0;0;0;0;0;4416308;3441206;4443;2;2900
FR;3;2022-08-20;0;0;0;0;0;4416308;3441206;4443;2;2900
FR;3;2022-08-21;0;0;0;0;0;4416308;3441206;4443;2;2900
FR;3;2022-08-22;0;0;0;0;0;4416308;3441206;4443;2;2900
FR;3;2022-08-23;0;0;0;0;0;4416308;3441206;4443;2;2900
FR;3;2022-08-24;0;0;0;0;0;4416308;3441206;4443;2;2900
FR;3;2022-08-25;0;0;0;0;0;4416308;3441206;4443;2;2900
FR;3;2022-08-26;0;0;0;0;0;4416308;3441206;4443;2;2900
FR;3;2022-08-27;0;0;0;0;0;4416308;3441206;4443;2;2900
FR;3;2022-08-28;0;0;0;0;0;4416308;3441206;4443;2;2900
FR;3;2022-08-29;0;0;0;0;0;4416308;3441206;4443;2;2900
FR;3;2022-08-30;0;0;0;0;0;4416308;3441206;4443;2;2900
FR;3;2022-08-31;0;0;0;0;0;4416308;3441206;4443;2;2900
FR;3;2022-09-01;0;0;0;0;0;4416308;3441206;4443;2;2900
FR;3;2022-09-02;0;0;0;0;0;4416308;3441206;4443;2;2900
FR;3;2022-09-03;0;0;0;0;0;4416308;3441206;4443;2;2900
FR;3;2022-09-04;0;0;0;0;0;4416308;3441206;4443;2;2900
FR;3;2022-09-05;0;0;0;0;0;4416308;3441206;4443;2;2900
FR;3;2022-09-06;0;0;0;0;0;4416308;3441206;4443;2;2900
FR;3;2022-09-07;0;0;0;0;0;4416308;3441206;4443;2;2900
FR;3;2022-09-08;0;0;0;0;0;4416308;3441206;4443;2;2900
FR;3;2022-09-09;0;0;0;0;0;4416308;3441206;4443;2;2900
FR;3;2022-09-10;0;0;0;0;0;4416308;3441206;4443;2;2900
FR;3;2022-09-11;0;0;0;0;0;4416308;3441206;4443;2;2900
FR;3;2022-09-12;0;0;0;0;0;4416308;3441206;4443;2;2900
FR;3;2022-09-13;0;0;0;0;0;4416308;3441206;4443;2;2900
FR;3;2022-09-14;0;0;0;0;0;4416308;3441206;4443;2;2900
FR;3;2022-09-15;0;0;0;0;0;4416308;3441206;4443;2;2900
FR;3;2022-09-16;0;0;0;0;0;4416308;3441206;4443;2;2900
FR;3;2022-09-17;0;0;0;0;0;4416308;3441206;4443;2;2900
FR;3;2022-09-18;0;0;0;0;0;4416308;3441206;4443;2;2900
FR;3;2022-09-19;0;0;0;0;0;4416308;3441206;4443;2;2900
FR;3;2022-09-20;0;0;0;0;0;4416308;3441206;4443;2;2900
FR;3;2022-09-21;0;0;0;0;0;4416308;3441206;4443;2;2900
FR;3;2022-09-22;0;0;0;0;0;4416308;3441206;4443;2;2900
FR;3;2022-09-23;0;0;0;0;0;4416308;3441206;4443;2;2900
FR;3;2022-09-24;0;0;0;0;0;4416308;3441206;4443;2;2900
FR;3;2022-09-25;0;0;0;0;0;4416308;3441206;4443;2;2900
FR;3;2022-09-26;0;0;0;0;0;4416308;3441206;4443;2;2900
FR;3;2022-09-27;0;0;0;0;0;4416308;3441206;4443;2;2900
FR;3;2022-09-28;0;0;0;0;0;4416308;3441206;4443;2;2900
FR;3;2022-09-29;0;0;0;0;0;4416308;3441206;4443;2;2900
FR;3;2022-09-30;0;0;0;0;0;4416308;3441206;4443;2;2900
FR;3;2022-10-01;0;0;0;0;0;4416308;3441206;4443;2;2900
FR;3;2022-10-02;0;0;0;0;0;4416308;3441206;4443;2;2900
FR;3;2022-10-03;0;0;0;0;0;4416308;3441206;4443;2;2900
FR;3;2022-10-04;0;0;0;0;0;4416308;3441206;4443;2;2900
FR;3;2022-10-05;0;0;0;0;0;4416308;3441206;4443;2;2900
FR;3;2022-10-06;0;0;0;0;0;4416308;3441206;4443;2;2900
FR;3;2022-10-07;0;0;0;0;0;4416308;3441206;4443;2;2900
FR;3;2022-10-08;0;0;0;0;0;4416308;3441206;4443;2;2900
FR;3;2022-10-09;0;0;0;0;0;4416308;3441206;4443;2;2900
FR;3;2022-10-10;0;0;0;0;0;4416308;3441206;4443;2;2900
FR;3;2022-10-11;0;0;0;0;0;4416308;3441206;4443;2;2900
FR;3;2022-10-12;0;0;0;0;0;4416308;3441206;4443;2;2900
FR;3;2022-10-13;0;0;0;0;0;4416308;3441206;4443;2;2900
FR;3;2022-10-14;0;0;0;0;0;4416308;3441206;4443;2;2900
FR;3;2022-10-15;0;0;0;0;0;4416308;3441206;4443;2;2900
FR;3;2022-10-16;0;0;0;0;0;4416308;3441206;4443;2;2900
FR;3;2022-10-17;0;0;0;0;0;4416308;3441206;4443;2;2900
FR;4;2020-12-27;0;0;0;0;0;0;0;0;0;0
FR;4;2020-12-28;0;0;0;0;0;0;0;0;0;0
FR;4;2020-12-29;0;0;0;0;0;0;0;0;0;0
FR;4;2020-12-30;0;0;0;0;0;0;0;0;0;0
FR;4;2020-12-31;0;0;0;0;0;0;0;0;0;0
FR;4;2021-01-01;0;0;0;0;0;0;0;0;0;0
FR;4;2021-01-02;0;0;0;0;0;0;0;0;0;0
FR;4;2021-01-03;0;0;0;0;0;0;0;0;0;0
FR;4;2021-01-04;0;0;0;0;0;0;0;0;0;0
FR;4;2021-01-05;0;0;0;0;0;0;0;0;0;0
FR;4;2021-01-06;0;0;0;0;0;0;0;0;0;0
FR;4;2021-01-07;0;0;0;0;0;0;0;0;0;0
FR;4;2021-01-08;0;0;0;0;0;0;0;0;0;0
FR;4;2021-01-09;0;0;0;0;0;0;0;0;0;0
FR;4;2021-01-10;0;0;0;0;0;0;0;0;0;0
FR;4;2021-01-11;0;0;0;0;0;0;0;0;0;0
FR;4;2021-01-12;0;0;0;0;0;0;0;0;0;0
FR;4;2021-01-13;0;0;0;0;0;0;0;0;0;0
FR;4;2021-01-14;0;0;0;0;0;0;0;0;0;0
FR;4;2021-01-15;0;0;0;0;0;0;0;0;0;0
FR;4;2021-01-16;0;0;0;0;0;0;0;0;0;0
FR;4;2021-01-17;0;0;0;0;0;0;0;0;0;0
FR;4;2021-01-18;0;0;0;0;0;0;0;0;0;0
FR;4;2021-01-19;0;0;0;0;0;0;0;0;0;0
FR;4;2021-01-20;0;0;0;0;0;0;0;0;0;0
FR;4;2021-01-21;0;0;0;0;0;0;0;0;0;0
FR;4;2021-01-22;0;0;0;0;0;0;0;0;0;0
FR;4;2021-01-23;0;0;0;0;0;0;0;0;0;0
FR;4;2021-01-24;0;0;0;0;0;0;0;0;0;0
FR;4;2021-01-25;0;0;0;0;0;0;0;0;0;0
FR;4;2021-01-26;0;0;0;0;0;0;0;0;0;0
FR;4;2021-01-27;0;0;0;0;0;0;0;0;0;0
FR;4;2021-01-28;0;0;0;0;0;0;0;0;0;0
FR;4;2021-01-29;0;0;0;0;0;0;0;0;0;0
FR;4;2021-01-30;0;0;0;0;0;0;0;0;0;0
FR;4;2021-01-31;0;0;0;0;0;0;0;0;0;0
FR;4;2021-02-01;0;0;0;0;0;0;0;0;0;0
FR;4;2021-02-02;0;0;0;0;0;0;0;0;0;0
FR;4;2021-02-03;0;0;0;0;0;0;0;0;0;0
FR;4;2021-02-04;0;0;0;0;0;0;0;0;0;0
FR;4;2021-02-05;0;0;0;0;0;0;0;0;0;0
FR;4;2021-02-06;0;0;0;0;0;0;0;0;0;0
FR;4;2021-02-07;0;0;0;0;0;0;0;0;0;0
FR;4;2021-02-08;0;0;0;0;0;0;0;0;0;0
FR;4;2021-02-09;0;0;0;0;0;0;0;0;0;0
FR;4;2021-02-10;0;0;0;0;0;0;0;0;0;0
FR;4;2021-02-11;0;0;0;0;0;0;0;0;0;0
FR;4;2021-02-12;0;0;0;0;0;0;0;0;0;0
FR;4;2021-02-13;0;0;0;0;0;0;0;0;0;0
FR;4;2021-02-14;0;0;0;0;0;0;0;0;0;0
FR;4;2021-02-15;0;0;0;0;0;0;0;0;0;0
FR;4;2021-02-16;0;0;0;0;0;0;0;0;0;0
FR;4;2021-02-17;0;0;0;0;0;0;0;0;0;0
FR;4;2021-02-18;0;0;0;0;0;0;0;0;0;0
FR;4;2021-02-19;0;0;0;0;0;0;0;0;0;0
FR;4;2021-02-20;0;0;0;0;0;0;0;0;0;0
FR;4;2021-02-21;0;0;0;0;0;0;0;0;0;0
FR;4;2021-02-22;0;0;0;0;0;0;0;0;0;0
FR;4;2021-02-23;0;0;0;0;0;0;0;0;0;0
FR;4;2021-02-24;0;0;0;0;0;0;0;0;0;0
FR;4;2021-02-25;0;0;0;0;0;0;0;0;0;0
FR;4;2021-02-26;0;0;0;0;0;0;0;0;0;0
FR;4;2021-02-27;0;0;0;0;0;0;0;0;0;0
FR;4;2021-02-28;0;0;0;0;0;0;0;0;0;0
FR;4;2021-03-01;0;0;0;0;0;0;0;0;0;0
FR;4;2021-03-02;0;0;0;0;0;0;0;0;0;0
FR;4;2021-03-03;0;0;0;0;0;0;0;0;0;0
FR;4;2021-03-04;0;0;0;0;0;0;0;0;0;0
FR;4;2021-03-05;0;0;0;0;0;0;0;0;0;0
FR;4;2021-03-06;0;0;0;0;0;0;0;0;0;0
FR;4;2021-03-07;0;0;0;0;0;0;0;0;0;0
FR;4;2021-03-08;0;0;0;0;0;0;0;0;0;0
FR;4;2021-03-09;0;0;0;0;0;0;0;0;0;0
FR;4;2021-03-10;0;0;0;0;0;0;0;0;0;0
FR;4;2021-03-11;0;0;0;0;0;0;0;0;0;0
FR;4;2021-03-12;0;0;0;0;0;0;0;0;0;0
FR;4;2021-03-13;0;0;0;0;0;0;0;0;0;0
FR;4;2021-03-14;0;0;0;0;0;0;0;0;0;0
FR;4;2021-03-15;0;0;0;0;0;0;0;0;0;0
FR;4;2021-03-16;0;0;0;0;0;0;0;0;0;0
FR;4;2021-03-17;0;0;0;0;0;0;0;0;0;0
FR;4;2021-03-18;0;0;0;0;0;0;0;0;0;0
FR;4;2021-03-19;0;0;0;0;0;0;0;0;0;0
FR;4;2021-03-20;0;0;0;0;0;0;0;0;0;0
FR;4;2021-03-21;0;0;0;0;0;0;0;0;0;0
FR;4;2021-03-22;0;0;0;0;0;0;0;0;0;0
FR;4;2021-03-23;0;0;0;0;0;0;0;0;0;0
FR;4;2021-03-24;0;0;0;0;0;0;0;0;0;0
FR;4;2021-03-25;0;0;0;0;0;0;0;0;0;0
FR;4;2021-03-26;0;0;0;0;0;0;0;0;0;0
FR;4;2021-03-27;0;0;0;0;0;0;0;0;0;0
FR;4;2021-03-28;0;0;0;0;0;0;0;0;0;0
FR;4;2021-03-29;0;0;0;0;0;0;0;0;0;0
FR;4;2021-03-30;0;0;0;0;0;0;0;0;0;0
FR;4;2021-03-31;0;0;0;0;0;0;0;0;0;0
FR;4;2021-04-01;0;0;0;0;0;0;0;0;0;0
FR;4;2021-04-02;0;0;0;0;0;0;0;0;0;0
FR;4;2021-04-03;0;0;0;0;0;0;0;0;0;0
FR;4;2021-04-04;0;0;0;0;0;0;0;0;0;0
FR;4;2021-04-05;0;0;0;0;0;0;0;0;0;0
FR;4;2021-04-06;0;0;0;0;0;0;0;0;0;0
FR;4;2021-04-07;0;0;0;0;0;0;0;0;0;0
FR;4;2021-04-08;0;0;0;0;0;0;0;0;0;0
FR;4;2021-04-09;0;0;0;0;0;0;0;0;0;0
FR;4;2021-04-10;0;0;0;0;0;0;0;0;0;0
FR;4;2021-04-11;0;0;0;0;0;0;0;0;0;0
FR;4;2021-04-12;0;0;0;0;0;0;0;0;0;0
FR;4;2021-04-13;0;0;0;0;0;0;0;0;0;0
FR;4;2021-04-14;0;0;0;0;0;0;0;0;0;0
FR;4;2021-04-15;0;0;0;0;0;0;0;0;0;0
FR;4;2021-04-16;0;0;0;0;0;0;0;0;0;0
FR;4;2021-04-17;0;0;0;0;0;0;0;0;0;0
FR;4;2021-04-18;0;0;0;0;0;0;0;0;0;0
FR;4;2021-04-19;0;0;0;0;0;0;0;0;0;0
FR;4;2021-04-20;0;0;0;0;0;0;0;0;0;0
FR;4;2021-04-21;0;0;0;0;0;0;0;0;0;0
FR;4;2021-04-22;0;0;0;0;0;0;0;0;0;0
FR;4;2021-04-23;3821;0;0;0;0;3821;0;0;0;0
FR;4;2021-04-24;1569;1;0;0;0;5390;1;0;0;0
FR;4;2021-04-25;125;0;0;0;0;5515;1;0;0;0
FR;4;2021-04-26;2869;1;0;0;0;8384;2;0;0;0
FR;4;2021-04-27;9521;3;0;0;0;17905;5;0;0;0
FR;4;2021-04-28;9907;6;0;0;0;27812;11;0;0;0
FR;4;2021-04-29;15991;8;0;0;0;43803;19;0;0;0
FR;4;2021-04-30;19233;10;0;0;0;63036;29;0;0;0
FR;4;2021-05-01;1993;6;0;0;0;65029;35;0;0;0
FR;4;2021-05-02;483;0;0;0;0;65512;35;0;0;0
FR;4;2021-05-03;5064;2;0;0;0;70576;37;0;0;0
FR;4;2021-05-04;8405;11;0;0;0;78981;48;0;0;0
FR;4;2021-05-05;6189;7;0;0;0;85170;55;0;0;0
FR;4;2021-05-06;11385;11;0;0;0;96555;66;0;0;0
FR;4;2021-05-07;19124;9;0;0;0;115679;75;0;0;0
FR;4;2021-05-08;2378;6;0;0;0;118057;81;0;0;0
FR;4;2021-05-09;688;3;0;0;0;118745;84;0;0;0
FR;4;2021-05-10;7244;5;1;0;0;125989;89;1;0;0
FR;4;2021-05-11;14322;12;0;0;0;140311;101;1;0;0
FR;4;2021-05-12;10173;15;0;0;0;150484;116;1;0;0
FR;4;2021-05-13;1583;4;0;0;0;152067;120;1;0;0
FR;4;2021-05-14;7766;7;0;0;0;159833;127;1;0;0
FR;4;2021-05-15;3720;8;1;0;0;163553;135;2;0;0
FR;4;2021-05-16;417;1;0;0;0;163970;136;2;0;0
FR;4;2021-05-17;4478;6;0;0;0;168448;142;2;0;0
FR;4;2021-05-18;8763;10;0;0;0;177211;152;2;0;0
FR;4;2021-05-19;5694;7;0;0;0;182905;159;2;0;0
FR;4;2021-05-20;9485;8;0;0;0;192390;167;2;0;0
FR;4;2021-05-21;12806;30;0;0;0;205196;197;2;0;0
FR;4;2021-05-22;5059;15;0;0;0;210255;212;2;0;0
FR;4;2021-05-23;494;4;0;0;0;210749;216;2;0;0
FR;4;2021-05-24;1058;7;0;0;0;211807;223;2;0;0
FR;4;2021-05-25;7632;16;0;0;0;219439;239;2;0;0
FR;4;2021-05-26;7728;16;0;0;0;227167;255;2;0;0
FR;4;2021-05-27;14334;35;0;0;0;241501;290;2;0;0
FR;4;2021-05-28;26591;82;1;0;0;268092;372;3;0;0
FR;4;2021-05-29;11385;18;0;0;0;279477;390;3;0;0
FR;4;2021-05-30;973;6;0;0;0;280450;396;3;0;0
FR;4;2021-05-31;12694;21;0;0;0;293144;417;3;0;0
FR;4;2021-06-01;20264;48;1;0;0;313408;465;4;0;0
FR;4;2021-06-02;14520;33;0;0;0;327928;498;4;0;0
FR;4;2021-06-03;19428;24;1;0;0;347356;522;5;0;0
FR;4;2021-06-04;22514;47;0;0;0;369870;569;5;0;0
FR;4;2021-06-05;9714;32;0;0;0;379584;601;5;0;0
FR;4;2021-06-06;1039;1;0;0;0;380623;602;5;0;0
FR;4;2021-06-07;9227;19;0;0;0;389850;621;5;0;0
FR;4;2021-06-08;14612;32;0;0;0;404462;653;5;0;0
FR;4;2021-06-09;12209;25;0;0;0;416671;678;5;0;0
FR;4;2021-06-10;15404;30;0;0;0;432075;708;5;0;0
FR;4;2021-06-11;16986;57;0;0;0;449061;765;5;0;0
FR;4;2021-06-12;7450;27;0;0;0;456511;792;5;0;0
FR;4;2021-06-13;907;3;0;0;0;457418;795;5;0;0
FR;4;2021-06-14;6649;26;0;0;0;464067;821;5;0;0
FR;4;2021-06-15;10891;37;0;0;0;474958;858;5;0;0
FR;4;2021-06-16;8908;16;0;0;0;483866;874;5;0;0
FR;4;2021-06-17;10898;37;0;0;0;494764;911;5;0;0
FR;4;2021-06-18;12423;45;0;0;0;507187;956;5;0;0
FR;4;2021-06-19;5567;25;0;0;0;512754;981;5;0;0
FR;4;2021-06-20;824;5;0;0;0;513578;986;5;0;0
FR;4;2021-06-21;5100;20;0;0;0;518678;1006;5;0;0
FR;4;2021-06-22;7911;28;2;0;0;526589;1034;7;0;0
FR;4;2021-06-23;7102;41;2;0;0;533691;1075;9;0;0
FR;4;2021-06-24;8653;46;1;0;0;542344;1121;10;0;0
FR;4;2021-06-25;10173;40;2;0;0;552517;1161;12;0;0
FR;4;2021-06-26;4847;21;0;0;0;557364;1182;12;0;0
FR;4;2021-06-27;764;4;0;0;0;558128;1186;12;0;0
FR;4;2021-06-28;4831;16;1;0;0;562959;1202;13;0;0
FR;4;2021-06-29;7110;28;2;0;0;570069;1230;15;0;0
FR;4;2021-06-30;6722;39;2;0;0;576791;1269;17;0;0
FR;4;2021-07-01;8206;42;0;0;0;584997;1311;17;0;0
FR;4;2021-07-02;9427;53;1;0;0;594424;1364;18;0;0
FR;4;2021-07-03;4846;20;0;0;0;599270;1384;18;0;0
FR;4;2021-07-04;689;5;0;0;0;599959;1389;18;0;0
FR;4;2021-07-05;4771;19;2;0;0;604730;1408;20;0;0
FR;4;2021-07-06;7725;29;4;0;0;612455;1437;24;0;0
FR;4;2021-07-07;7084;34;2;0;0;619539;1471;26;0;0
FR;4;2021-07-08;9231;39;2;0;0;628770;1510;28;0;0
FR;4;2021-07-09;10278;34;1;0;0;639048;1544;29;0;0
FR;4;2021-07-10;4638;14;2;0;0;643686;1558;31;0;0
FR;4;2021-07-11;583;4;1;0;0;644269;1562;32;0;0
FR;4;2021-07-12;5875;29;0;0;0;650144;1591;32;0;0
FR;4;2021-07-13;14232;29;0;0;0;664376;1620;32;0;0
FR;4;2021-07-14;2289;15;0;0;0;666665;1635;32;0;0
FR;4;2021-07-15;18235;36;0;0;0;684900;1671;32;0;0
FR;4;2021-07-16;22835;71;2;0;0;707735;1742;34;0;0
FR;4;2021-07-17;9738;20;0;0;0;717473;1762;34;0;0
FR;4;2021-07-18;1357;4;0;0;0;718830;1766;34;0;0
FR;4;2021-07-19;12989;30;1;0;0;731819;1796;35;0;0
FR;4;2021-07-20;17343;26;1;0;0;749162;1822;36;0;0
FR;4;2021-07-21;15616;33;0;0;0;764778;1855;36;0;0
FR;4;2021-07-22;18243;44;2;0;0;783021;1899;38;0;0
FR;4;2021-07-23;20415;57;7;0;0;803436;1956;45;0;0
FR;4;2021-07-24;9289;32;0;0;0;812725;1988;45;0;0
FR;4;2021-07-25;1354;8;0;0;0;814079;1996;45;0;0
FR;4;2021-07-26;11041;22;0;0;0;825120;2018;45;0;0
FR;4;2021-07-27;14679;35;3;0;0;839799;2053;48;0;0
FR;4;2021-07-28;12932;26;2;0;0;852731;2079;50;0;0
FR;4;2021-07-29;14088;54;4;0;0;866819;2133;54;0;0
FR;4;2021-07-30;15498;46;2;0;0;882317;2179;56;0;0
FR;4;2021-07-31;6840;14;2;0;0;889157;2193;58;0;0
FR;4;2021-08-01;906;1;0;0;0;890063;2194;58;0;0
FR;4;2021-08-02;7916;31;0;0;0;897979;2225;58;0;0
FR;4;2021-08-03;10798;31;2;0;0;908777;2256;60;0;0
FR;4;2021-08-04;9745;29;0;0;0;918522;2285;60;0;0
FR;4;2021-08-05;9823;41;0;0;0;928345;2326;60;0;0
FR;4;2021-08-06;10199;31;3;0;0;938544;2357;63;0;0
FR;4;2021-08-07;5098;30;1;0;0;943642;2387;64;0;0
FR;4;2021-08-08;1219;13;0;0;0;944861;2400;64;0;0
FR;4;2021-08-09;6346;31;0;0;0;951207;2431;64;0;0
FR;4;2021-08-10;8749;18;0;0;0;959956;2449;64;0;0
FR;4;2021-08-11;7943;34;4;0;0;967899;2483;68;0;0
FR;4;2021-08-12;8585;31;1;0;0;976484;2514;69;0;0
FR;4;2021-08-13;7557;25;0;1;0;984041;2539;69;1;0
FR;4;2021-08-14;3791;20;0;0;0;987832;2559;69;1;0
FR;4;2021-08-15;771;5;0;0;0;988603;2564;69;1;0
FR;4;2021-08-16;4008;17;0;0;0;992611;2581;69;1;0
FR;4;2021-08-17;5628;17;1;0;0;998239;2598;70;1;0
FR;4;2021-08-18;5166;37;0;0;0;1003405;2635;70;1;0
FR;4;2021-08-19;5486;33;3;0;0;1008891;2668;73;1;0
FR;4;2021-08-20;5222;25;1;0;0;1014113;2693;74;1;0
FR;4;2021-08-21;2310;21;1;0;0;1016423;2714;75;1;0
FR;4;2021-08-22;414;2;0;0;0;1016837;2716;75;1;0
FR;4;2021-08-23;2932;19;1;0;0;1019769;2735;76;1;0
FR;4;2021-08-24;3757;15;0;0;0;1023526;2750;76;1;0
FR;4;2021-08-25;3542;25;1;0;0;1027068;2775;77;1;0
FR;4;2021-08-26;3714;21;2;0;0;1030782;2796;79;1;0
FR;4;2021-08-27;3617;31;2;0;0;1034399;2827;81;1;0
FR;4;2021-08-28;1725;10;1;0;0;1036124;2837;82;1;0
FR;4;2021-08-29;384;7;1;0;0;1036508;2844;83;1;0
FR;4;2021-08-30;2009;25;0;0;15;1038517;2869;83;1;15
FR;4;2021-08-31;2485;21;0;0;14;1041002;2890;83;1;29
FR;4;2021-09-01;2083;38;1;0;21;1043085;2928;84;1;50
FR;4;2021-09-02;2306;31;4;0;18;1045391;2959;88;1;68
FR;4;2021-09-03;2363;44;5;0;36;1047754;3003;93;1;104
FR;4;2021-09-04;1373;17;0;0;8;1049127;3020;93;1;112
FR;4;2021-09-05;433;2;0;0;2;1049560;3022;93;1;114
FR;4;2021-09-06;1713;62;0;0;23;1051273;3084;93;1;137
FR;4;2021-09-07;1678;18;0;0;8;1052951;3102;93;1;145
FR;4;2021-09-08;1285;26;3;0;19;1054236;3128;96;1;164
FR;4;2021-09-09;1389;23;2;0;9;1055625;3151;98;1;173
FR;4;2021-09-10;1521;31;2;0;23;1057146;3182;100;1;196
FR;4;2021-09-11;744;11;0;0;3;1057890;3193;100;1;199
FR;4;2021-09-12;169;4;0;0;3;1058059;3197;100;1;202
FR;4;2021-09-13;1322;22;1;0;16;1059381;3219;101;1;218
FR;4;2021-09-14;1503;9;2;0;6;1060884;3228;103;1;224
FR;4;2021-09-15;1095;28;1;0;25;1061979;3256;104;1;249
FR;4;2021-09-16;1105;22;2;0;15;1063084;3278;106;1;264
FR;4;2021-09-17;896;21;1;0;12;1063980;3299;107;1;276
FR;4;2021-09-18;464;6;1;0;5;1064444;3305;108;1;281
FR;4;2021-09-19;182;3;0;0;2;1064626;3308;108;1;283
FR;4;2021-09-20;453;19;0;0;13;1065079;3327;108;1;296
FR;4;2021-09-21;432;11;0;0;7;1065511;3338;108;1;303
FR;4;2021-09-22;374;19;2;0;13;1065885;3357;110;1;316
FR;4;2021-09-23;483;16;1;0;15;1066368;3373;111;1;331
FR;4;2021-09-24;413;13;2;0;9;1066781;3386;113;1;340
FR;4;2021-09-25;280;10;1;0;5;1067061;3396;114;1;345
FR;4;2021-09-26;74;2;0;0;1;1067135;3398;114;1;346
FR;4;2021-09-27;264;10;1;0;8;1067399;3408;115;1;354
FR;4;2021-09-28;318;8;0;0;8;1067717;3416;115;1;362
FR;4;2021-09-29;375;19;1;0;13;1068092;3435;116;1;375
FR;4;2021-09-30;364;41;0;0;22;1068456;3476;116;1;397
FR;4;2021-10-01;411;56;0;0;50;1068867;3532;116;1;447
FR;4;2021-10-02;196;22;1;0;13;1069063;3554;117;1;460
FR;4;2021-10-03;85;1;0;0;0;1069148;3555;117;1;460
FR;4;2021-10-04;360;20;1;0;16;1069508;3575;118;1;476
FR;4;2021-10-05;286;19;2;0;15;1069794;3594;120;1;491
FR;4;2021-10-06;248;23;1;0;18;1070042;3617;121;1;509
FR;4;2021-10-07;265;25;2;0;13;1070307;3642;123;1;522
FR;4;2021-10-08;356;24;2;0;20;1070663;3666;125;1;542
FR;4;2021-10-09;194;6;6;0;7;1070857;3672;131;1;549
FR;4;2021-10-10;97;3;2;0;3;1070954;3675;133;1;552
FR;4;2021-10-11;249;15;1;0;14;1071203;3690;134;1;566
FR;4;2021-10-12;208;14;0;0;13;1071411;3704;134;1;579
FR;4;2021-10-13;219;28;1;0;25;1071630;3732;135;1;604
FR;4;2021-10-14;314;21;4;0;15;1071944;3753;139;1;619
FR;4;2021-10-15;322;24;5;0;25;1072266;3777;144;1;644
FR;4;2021-10-16;166;6;2;0;6;1072432;3783;146;1;650
FR;4;2021-10-17;70;2;0;0;1;1072502;3785;146;1;651
FR;4;2021-10-18;281;16;1;0;13;1072783;3801;147;1;664
FR;4;2021-10-19;215;14;2;0;15;1072998;3815;149;1;679
FR;4;2021-10-20;230;27;4;0;15;1073228;3842;153;1;694
FR;4;2021-10-21;243;17;0;0;13;1073471;3859;153;1;707
FR;4;2021-10-22;217;25;2;0;20;1073688;3884;155;1;727
FR;4;2021-10-23;116;16;1;0;15;1073804;3900;156;1;742
FR;4;2021-10-24;38;4;0;0;1;1073842;3904;156;1;743
FR;4;2021-10-25;214;7;2;0;9;1074056;3911;158;1;752
FR;4;2021-10-26;200;14;0;0;12;1074256;3925;158;1;764
FR;4;2021-10-27;196;11;4;0;11;1074452;3936;162;1;775
FR;4;2021-10-28;184;18;4;0;21;1074636;3954;166;1;796
FR;4;2021-10-29;224;15;2;0;13;1074860;3969;168;1;809
FR;4;2021-10-30;102;2;1;0;2;1074962;3971;169;1;811
FR;4;2021-10-31;57;3;2;0;3;1075019;3974;171;1;814
FR;4;2021-11-01;75;27;4;0;24;1075094;4001;175;1;838
FR;4;2021-11-02;160;21;2;0;21;1075254;4022;177;1;859
FR;4;2021-11-03;129;20;8;1;18;1075383;4042;185;2;877
FR;4;2021-11-04;185;15;1;0;12;1075568;4057;186;2;889
FR;4;2021-11-05;130;17;1;0;16;1075698;4074;187;2;905
FR;4;2021-11-06;80;6;1;0;6;1075778;4080;188;2;911
FR;4;2021-11-07;81;2;2;0;4;1075859;4082;190;2;915
FR;4;2021-11-08;160;20;1;0;20;1076019;4102;191;2;935
FR;4;2021-11-09;156;14;3;0;16;1076175;4116;194;2;951
FR;4;2021-11-10;119;30;6;0;32;1076294;4146;200;2;983
FR;4;2021-11-11;98;10;1;0;11;1076392;4156;201;2;994
FR;4;2021-11-12;105;19;2;0;18;1076497;4175;203;2;1012
FR;4;2021-11-13;74;15;2;0;14;1076571;4190;205;2;1026
FR;4;2021-11-14;55;5;4;0;8;1076626;4195;209;2;1034
FR;4;2021-11-15;99;26;2;0;24;1076725;4221;211;2;1058
FR;4;2021-11-16;105;13;2;0;15;1076830;4234;213;2;1073
FR;4;2021-11-17;119;30;4;0;30;1076949;4264;217;2;1103
FR;4;2021-11-18;100;34;14;0;43;1077049;4298;231;2;1146
FR;4;2021-11-19;87;21;3;0;22;1077136;4319;234;2;1168
FR;4;2021-11-20;77;8;1;0;8;1077213;4327;235;2;1176
FR;4;2021-11-21;68;7;2;0;9;1077281;4334;237;2;1185
FR;4;2021-11-22;106;28;9;0;33;1077387;4362;246;2;1218
FR;4;2021-11-23;76;31;6;0;29;1077463;4393;252;2;1247
FR;4;2021-11-24;88;23;11;0;24;1077551;4416;263;2;1271
FR;4;2021-11-25;93;28;16;0;32;1077644;4444;279;2;1303
FR;4;2021-11-26;84;43;12;0;45;1077728;4487;291;2;1348
FR;4;2021-11-27;41;22;15;0;25;1077769;4509;306;2;1373
FR;4;2021-11-28;50;8;0;0;7;1077819;4517;306;2;1380
FR;4;2021-11-29;90;31;16;0;40;1077909;4548;322;2;1420
FR;4;2021-11-30;75;37;12;0;41;1077984;4585;334;2;1461
FR;4;2021-12-01;88;60;19;0;67;1078072;4645;353;2;1528
FR;4;2021-12-02;107;48;20;0;54;1078179;4693;373;2;1582
FR;4;2021-12-03;100;36;15;0;44;1078279;4729;388;2;1626
FR;4;2021-12-04;72;31;18;0;44;1078351;4760;406;2;1670
FR;4;2021-12-05;62;7;1;0;7;1078413;4767;407;2;1677
FR;4;2021-12-06;109;46;19;0;59;1078522;4813;426;2;1736
FR;4;2021-12-07;81;37;9;0;36;1078603;4850;435;2;1772
FR;4;2021-12-08;70;31;17;0;38;1078673;4881;452;2;1810
FR;4;2021-12-09;63;32;10;0;38;1078736;4913;462;2;1848
FR;4;2021-12-10;63;64;20;0;68;1078799;4977;482;2;1916
FR;4;2021-12-11;28;34;7;0;34;1078827;5011;489;2;1950
FR;4;2021-12-12;26;10;3;0;13;1078853;5021;492;2;1963
FR;4;2021-12-13;72;40;14;0;49;1078925;5061;506;2;2012
FR;4;2021-12-14;59;43;17;0;54;1078984;5104;523;2;2066
FR;4;2021-12-15;66;64;28;0;84;1079050;5168;551;2;2150
FR;4;2021-12-16;33;45;19;0;58;1079083;5213;570;2;2208
FR;4;2021-12-17;39;55;12;0;60;1079122;5268;582;2;2268
FR;4;2021-12-18;49;30;2;0;31;1079171;5298;584;2;2299
FR;4;2021-12-19;15;4;1;0;4;1079186;5302;585;2;2303
FR;4;2021-12-20;43;38;10;0;41;1079229;5340;595;2;2344
FR;4;2021-12-21;29;32;16;0;38;1079258;5372;611;2;2382
FR;4;2021-12-22;37;37;10;0;38;1079295;5409;621;2;2420
FR;4;2021-12-23;39;45;8;0;49;1079334;5454;629;2;2469
FR;4;2021-12-24;23;26;10;0;30;1079357;5480;639;2;2499
FR;4;2021-12-25;6;3;3;0;4;1079363;5483;642;2;2503
FR;4;2021-12-26;5;3;1;0;2;1079368;5486;643;2;2505
FR;4;2021-12-27;31;41;9;0;43;1079399;5527;652;2;2548
FR;4;2021-12-28;25;28;7;0;29;1079424;5555;659;2;2577
FR;4;2021-12-29;52;25;11;0;30;1079476;5580;670;2;2607
FR;4;2021-12-30;44;19;12;0;22;1079520;5599;682;2;2629
FR;4;2021-12-31;18;6;8;0;11;1079538;5605;690;2;2640
FR;4;2022-01-01;5;4;4;0;6;1079543;5609;694;2;2646
FR;4;2022-01-02;40;5;16;0;20;1079583;5614;710;2;2666
FR;4;2022-01-03;43;55;22;1;62;1079626;5669;732;3;2728
FR;4;2022-01-04;37;28;15;0;33;1079663;5697;747;3;2761
FR;4;2022-01-05;51;22;19;0;25;1079714;5719;766;3;2786
FR;4;2022-01-06;49;22;24;0;38;1079763;5741;790;3;2824
FR;4;2022-01-07;29;20;15;0;20;1079792;5761;805;3;2844
FR;4;2022-01-08;11;6;10;0;12;1079803;5767;815;3;2856
FR;4;2022-01-09;18;2;3;0;4;1079821;5769;818;3;2860
FR;4;2022-01-10;47;22;19;0;36;1079868;5791;837;3;2896
FR;4;2022-01-11;27;31;12;0;35;1079895;5822;849;3;2931
FR;4;2022-01-12;33;21;13;0;23;1079928;5843;862;3;2954
FR;4;2022-01-13;53;20;27;0;38;1079981;5863;889;3;2992
FR;4;2022-01-14;23;29;13;0;32;1080004;5892;902;3;3024
FR;4;2022-01-15;13;6;8;0;12;1080017;5898;910;3;3036
FR;4;2022-01-16;12;9;14;0;22;1080029;5907;924;3;3058
FR;4;2022-01-17;26;19;12;0;25;1080055;5926;936;3;3083
FR;4;2022-01-18;16;13;8;0;18;1080071;5939;944;3;3101
FR;4;2022-01-19;31;23;12;0;33;1080102;5962;956;3;3134
FR;4;2022-01-20;32;34;13;0;39;1080134;5996;969;3;3173
FR;4;2022-01-21;11;12;19;1;16;1080145;6008;988;4;3189
FR;4;2022-01-22;30;13;2;0;13;1080175;6021;990;4;3202
FR;4;2022-01-23;7;2;4;0;6;1080182;6023;994;4;3208
FR;4;2022-01-24;14;21;8;0;27;1080196;6044;1002;4;3235
FR;4;2022-01-25;21;32;10;1;38;1080217;6076;1012;5;3273
FR;4;2022-01-26;19;16;8;1;19;1080236;6092;1020;6;3292
FR;4;2022-01-27;21;18;8;0;24;1080257;6110;1028;6;3316
FR;4;2022-01-28;13;23;8;0;26;1080270;6133;1036;6;3342
FR;4;2022-01-29;17;6;5;0;10;1080287;6139;1041;6;3352
FR;4;2022-01-30;18;3;1;0;4;1080305;6142;1042;6;3356
FR;4;2022-01-31;22;27;8;0;31;1080327;6169;1050;6;3387
FR;4;2022-02-01;12;22;12;0;23;1080339;6191;1062;6;3410
FR;4;2022-02-02;18;11;12;2;18;1080357;6202;1074;8;3428
FR;4;2022-02-03;14;23;10;0;27;1080371;6225;1084;8;3455
FR;4;2022-02-04;7;5;7;0;9;1080378;6230;1091;8;3464
FR;4;2022-02-05;7;14;1;0;13;1080385;6244;1092;8;3477
FR;4;2022-02-06;6;4;3;0;6;1080391;6248;1095;8;3483
FR;4;2022-02-07;15;19;8;0;19;1080406;6267;1103;8;3502
FR;4;2022-02-08;19;21;13;1;22;1080425;6288;1116;9;3524
FR;4;2022-02-09;17;11;8;0;15;1080442;6299;1124;9;3539
FR;4;2022-02-10;22;23;9;0;24;1080464;6322;1133;9;3563
FR;4;2022-02-11;18;15;8;0;20;1080482;6337;1141;9;3583
FR;4;2022-02-12;24;6;2;0;6;1080506;6343;1143;9;3589
FR;4;2022-02-13;7;3;3;0;6;1080513;6346;1146;9;3595
FR;4;2022-02-14;20;10;9;0;15;1080533;6356;1155;9;3610
FR;4;2022-02-15;18;7;1;0;7;1080551;6363;1156;9;3617
FR;4;2022-02-16;16;9;11;0;16;1080567;6372;1167;9;3633
FR;4;2022-02-17;11;4;4;0;6;1080578;6376;1171;9;3639
FR;4;2022-02-18;16;15;8;0;21;1080594;6391;1179;9;3660
FR;4;2022-02-19;16;4;2;0;5;1080610;6395;1181;9;3665
FR;4;2022-02-20;7;3;0;0;2;1080617;6398;1181;9;3667
FR;4;2022-02-21;23;4;4;0;6;1080640;6402;1185;9;3673
FR;4;2022-02-22;8;5;10;0;10;1080648;6407;1195;9;3683
FR;4;2022-02-23;16;6;10;0;10;1080664;6413;1205;9;3693
FR;4;2022-02-24;11;5;3;0;6;1080675;6418;1208;9;3699
FR;4;2022-02-25;15;5;7;0;6;1080690;6423;1215;9;3705
FR;4;2022-02-26;27;3;0;0;3;1080717;6426;1215;9;3708
FR;4;2022-02-27;9;0;1;0;1;1080726;6426;1216;9;3709
FR;4;2022-02-28;18;3;2;0;3;1080744;6429;1218;9;3712
FR;4;2022-03-01;7;4;7;0;5;1080751;6433;1225;9;3717
FR;4;2022-03-02;14;3;4;0;6;1080765;6436;1229;9;3723
FR;4;2022-03-03;17;5;3;0;6;1080782;6441;1232;9;3729
FR;4;2022-03-04;7;7;2;1;5;1080789;6448;1234;10;3734
FR;4;2022-03-05;9;2;0;0;2;1080798;6450;1234;10;3736
FR;4;2022-03-06;4;0;1;0;1;1080802;6450;1235;10;3737
FR;4;2022-03-07;10;4;2;0;3;1080812;6454;1237;10;3740
FR;4;2022-03-08;14;3;0;0;3;1080826;6457;1237;10;3743
FR;4;2022-03-09;8;7;2;0;7;1080834;6464;1239;10;3750
FR;4;2022-03-10;5;1;6;0;3;1080839;6465;1245;10;3753
FR;4;2022-03-11;10;4;5;0;2;1080849;6469;1250;10;3755
FR;4;2022-03-12;9;2;0;0;0;1080858;6471;1250;10;3755
FR;4;2022-03-13;6;1;1;0;2;1080864;6472;1251;10;3757
FR;4;2022-03-14;4;1;1;0;2;1080868;6473;1252;10;3759
FR;4;2022-03-15;7;6;3;0;5;1080875;6479;1255;10;3764
FR;4;2022-03-16;7;3;3;0;3;1080882;6482;1258;10;3767
FR;4;2022-03-17;3;4;1;0;5;1080885;6486;1259;10;3772
FR;4;2022-03-18;9;3;0;0;3;1080894;6489;1259;10;3775
FR;4;2022-03-19;1;1;1;0;2;1080895;6490;1260;10;3777
FR;4;2022-03-20;2;0;2;0;1;1080897;6490;1262;10;3778
FR;4;2022-03-21;6;3;1;0;4;1080903;6493;1263;10;3782
FR;4;2022-03-22;4;2;2;0;3;1080907;6495;1265;10;3785
FR;4;2022-03-23;6;4;4;0;7;1080913;6499;1269;10;3792
FR;4;2022-03-24;2;5;3;1;7;1080915;6504;1272;11;3799
FR;4;2022-03-25;3;1;2;0;1;1080918;6505;1274;11;3800
FR;4;2022-03-26;5;5;0;0;5;1080923;6510;1274;11;3805
FR;4;2022-03-27;1;0;3;0;2;1080924;6510;1277;11;3807
FR;4;2022-03-28;5;1;3;0;3;1080929;6511;1280;11;3810
FR;4;2022-03-29;9;0;4;1;0;1080938;6511;1284;12;3810
FR;4;2022-03-30;3;4;0;0;4;1080941;6515;1284;12;3814
FR;4;2022-03-31;2;3;2;1;4;1080943;6518;1286;13;3818
FR;4;2022-04-01;14;2;5;0;5;1080957;6520;1291;13;3823
FR;4;2022-04-02;4;4;0;0;3;1080961;6524;1291;13;3826
FR;4;2022-04-03;0;1;0;0;1;1080961;6525;1291;13;3827
FR;4;2022-04-04;4;4;4;0;5;1080965;6529;1295;13;3832
FR;4;2022-04-05;4;3;2;1;3;1080969;6532;1297;14;3835
FR;4;2022-04-06;6;0;0;0;0;1080975;6532;1297;14;3835
FR;4;2022-04-07;3;2;3;2;5;1080978;6534;1300;16;3840
FR;4;2022-04-08;4;1;1;0;1;1080982;6535;1301;16;3841
FR;4;2022-04-09;0;0;1;1;1;1080982;6535;1302;17;3842
FR;4;2022-04-10;1;2;0;0;2;1080983;6537;1302;17;3844
FR;4;2022-04-11;4;3;4;0;5;1080987;6540;1306;17;3849
FR;4;2022-04-12;3;1;4;0;2;1080990;6541;1310;17;3851
FR;4;2022-04-13;5;7;2;0;9;1080995;6548;1312;17;3860
FR;4;2022-04-14;6;4;2;1;5;1081001;6552;1314;18;3865
FR;4;2022-04-15;5;8;1;0;9;1081006;6560;1315;18;3874
FR;4;2022-04-16;1;0;0;0;0;1081007;6560;1315;18;3874
FR;4;2022-04-17;3;2;1;0;3;1081010;6562;1316;18;3877
FR;4;2022-04-18;2;2;6;0;4;1081012;6564;1322;18;3881
FR;4;2022-04-19;2;0;1;0;0;1081014;6564;1323;18;3881
FR;4;2022-04-20;14;4;1;0;3;1081028;6568;1324;18;3884
FR;4;2022-04-21;7;1;0;0;1;1081035;6569;1324;18;3885
FR;4;2022-04-22;1;1;2;0;2;1081036;6570;1326;18;3887
FR;4;2022-04-23;2;3;3;0;6;1081038;6573;1329;18;3893
FR;4;2022-04-24;0;2;0;0;2;1081038;6575;1329;18;3895
FR;4;2022-04-25;3;4;3;0;7;1081041;6579;1332;18;3902
FR;4;2022-04-26;5;6;1;0;6;1081046;6585;1333;18;3908
FR;4;2022-04-27;4;1;1;1;1;1081050;6586;1334;19;3909
FR;4;2022-04-28;3;5;5;0;6;1081053;6591;1339;19;3915
FR;4;2022-04-29;6;3;0;0;2;1081059;6594;1339;19;3917
FR;4;2022-04-30;2;1;1;0;2;1081061;6595;1340;19;3919
FR;4;2022-05-01;0;0;0;0;0;1081061;6595;1340;19;3919
FR;4;2022-05-02;5;16;6;0;19;1081066;6611;1346;19;3938
FR;4;2022-05-03;2;6;2;0;7;1081068;6617;1348;19;3945
FR;4;2022-05-04;7;4;1;0;4;1081075;6621;1349;19;3949
FR;4;2022-05-05;2;2;1;1;1;1081077;6623;1350;20;3950
FR;4;2022-05-06;5;3;1;0;2;1081082;6626;1351;20;3952
FR;4;2022-05-07;0;0;0;0;0;1081082;6626;1351;20;3952
FR;4;2022-05-08;1;1;0;0;1;1081083;6627;1351;20;3953
FR;4;2022-05-09;5;1;0;0;1;1081088;6628;1351;20;3954
FR;4;2022-05-10;2;1;0;2;3;1081090;6629;1351;22;3957
FR;4;2022-05-11;3;2;3;0;5;1081093;6631;1354;22;3962
FR;4;2022-05-12;6;4;1;1;5;1081099;6635;1355;23;3967
FR;4;2022-05-13;1;0;2;0;2;1081100;6635;1357;23;3969
FR;4;2022-05-14;0;2;0;0;2;1081100;6637;1357;23;3971
FR;4;2022-05-15;2;2;0;0;0;1081102;6639;1357;23;3971
FR;4;2022-05-16;5;2;2;0;2;1081107;6641;1359;23;3973
FR;4;2022-05-17;5;1;2;0;3;1081112;6642;1361;23;3976
FR;4;2022-05-18;3;6;0;0;6;1081115;6648;1361;23;3982
FR;4;2022-05-19;2;3;3;0;5;1081117;6651;1364;23;3987
FR;4;2022-05-20;4;2;3;0;2;1081121;6653;1367;23;3989
FR;4;2022-05-21;2;0;1;0;1;1081123;6653;1368;23;3990
FR;4;2022-05-22;0;0;1;0;1;1081123;6653;1369;23;3991
FR;4;2022-05-23;0;0;2;0;0;1081123;6653;1371;23;3991
FR;4;2022-05-24;2;4;0;0;4;1081125;6657;1371;23;3995
FR;4;2022-05-25;1;3;0;0;1;1081126;6660;1371;23;3996
FR;4;2022-05-26;5;0;1;0;1;1081131;6660;1372;23;3997
FR;4;2022-05-27;0;2;0;1;2;1081131;6662;1372;24;3999
FR;4;2022-05-28;1;0;0;0;0;1081132;6662;1372;24;3999
FR;4;2022-05-29;1;0;1;0;1;1081133;6662;1373;24;4000
FR;4;2022-05-30;2;4;2;0;5;1081135;6666;1375;24;4005
FR;4;2022-05-31;2;1;0;0;1;1081137;6667;1375;24;4006
FR;4;2022-06-01;3;11;7;0;15;1081140;6678;1382;24;4021
FR;4;2022-06-02;5;6;2;0;6;1081145;6684;1384;24;4027
FR;4;2022-06-03;2;5;4;1;6;1081147;6689;1388;25;4033
FR;4;2022-06-04;0;1;1;0;1;1081147;6690;1389;25;4034
FR;4;2022-06-05;0;0;0;0;0;1081147;6690;1389;25;4034
FR;4;2022-06-06;6;0;3;0;2;1081153;6690;1392;25;4036
FR;4;2022-06-07;5;2;0;1;2;1081158;6692;1392;26;4038
FR;4;2022-06-08;0;3;3;0;6;1081158;6695;1395;26;4044
FR;4;2022-06-09;1;2;0;0;1;1081159;6697;1395;26;4045
FR;4;2022-06-10;3;0;3;0;1;1081162;6697;1398;26;4046
FR;4;2022-06-11;1;0;0;0;0;1081163;6697;1398;26;4046
FR;4;2022-06-12;4;0;0;0;0;1081167;6697;1398;26;4046
FR;4;2022-06-13;5;2;3;0;2;1081172;6699;1401;26;4048
FR;4;2022-06-14;4;3;0;0;2;1081176;6702;1401;26;4050
FR;4;2022-06-15;8;0;4;0;0;1081184;6702;1405;26;4050
FR;4;2022-06-16;1;3;1;1;2;1081185;6705;1406;27;4052
FR;4;2022-06-17;6;1;0;0;1;1081191;6706;1406;27;4053
FR;4;2022-06-18;0;0;0;0;0;1081191;6706;1406;27;4053
FR;4;2022-06-19;0;0;0;0;0;1081191;6706;1406;27;4053
FR;4;2022-06-20;4;2;2;1;3;1081195;6708;1408;28;4056
FR;4;2022-06-21;5;2;3;1;3;1081200;6710;1411;29;4059
FR;4;2022-06-22;3;1;0;3;1;1081203;6711;1411;32;4060
FR;4;2022-06-23;3;3;3;0;5;1081206;6714;1414;32;4065
FR;4;2022-06-24;3;0;2;0;0;1081209;6714;1416;32;4065
FR;4;2022-06-25;1;0;1;1;1;1081210;6714;1417;33;4066
FR;4;2022-06-26;0;0;1;0;1;1081210;6714;1418;33;4067
FR;4;2022-06-27;2;2;0;3;2;1081212;6716;1418;36;4069
FR;4;2022-06-28;0;4;2;1;5;1081212;6720;1420;37;4074
FR;4;2022-06-29;1;2;0;0;2;1081213;6722;1420;37;4076
FR;4;2022-06-30;2;0;0;0;0;1081215;6722;1420;37;4076
FR;4;2022-07-01;2;4;8;0;4;1081217;6726;1428;37;4080
FR;4;2022-07-02;0;1;0;0;0;1081217;6727;1428;37;4080
FR;4;2022-07-03;0;0;0;0;0;1081217;6727;1428;37;4080
FR;4;2022-07-04;3;1;0;0;1;1081220;6728;1428;37;4081
FR;4;2022-07-05;2;0;2;0;2;1081222;6728;1430;37;4083
FR;4;2022-07-06;5;0;1;1;0;1081227;6728;1431;38;4083
FR;4;2022-07-07;1;0;2;1;0;1081228;6728;1433;39;4083
FR;4;2022-07-08;3;1;0;0;1;1081231;6729;1433;39;4084
FR;4;2022-07-09;2;2;1;0;3;1081233;6731;1434;39;4087
FR;4;2022-07-10;2;0;1;0;0;1081235;6731;1435;39;4087
FR;4;2022-07-11;2;0;2;0;0;1081237;6731;1437;39;4087
FR;4;2022-07-12;0;0;2;0;2;1081237;6731;1439;39;4089
FR;4;2022-07-13;2;2;3;0;2;1081239;6733;1442;39;4091
FR;4;2022-07-14;4;0;1;0;0;1081243;6733;1443;39;4091
FR;4;2022-07-15;8;2;0;0;2;1081251;6735;1443;39;4093
FR;4;2022-07-16;4;0;0;2;0;1081255;6735;1443;41;4093
FR;4;2022-07-17;0;0;0;0;0;1081255;6735;1443;41;4093
FR;4;2022-07-18;2;2;2;0;2;1081257;6737;1445;41;4095
FR;4;2022-07-19;4;0;1;0;1;1081261;6737;1446;41;4096
FR;4;2022-07-20;10;0;0;0;0;1081271;6737;1446;41;4096
FR;4;2022-07-21;2;1;1;0;1;1081273;6738;1447;41;4097
FR;4;2022-07-22;4;0;3;0;1;1081277;6738;1450;41;4098
FR;4;2022-07-23;1;2;0;0;1;1081278;6740;1450;41;4099
FR;4;2022-07-24;0;0;0;0;0;1081278;6740;1450;41;4099
FR;4;2022-07-25;5;0;2;0;2;1081283;6740;1452;41;4101
FR;4;2022-07-26;2;0;0;0;0;1081285;6740;1452;41;4101
FR;4;2022-07-27;2;1;0;0;0;1081287;6741;1452;41;4101
FR;4;2022-07-28;9;0;0;0;0;1081296;6741;1452;41;4101
FR;4;2022-07-29;3;0;1;0;0;1081299;6741;1453;41;4101
FR;4;2022-07-30;3;0;2;0;0;1081302;6741;1455;41;4101
FR;4;2022-07-31;0;0;0;0;0;1081302;6741;1455;41;4101
FR;4;2022-08-01;1;0;2;0;1;1081303;6741;1457;41;4102
FR;4;2022-08-02;6;0;0;0;0;1081309;6741;1457;41;4102
FR;4;2022-08-03;0;2;1;0;2;1081309;6743;1458;41;4104
FR;4;2022-08-04;3;2;0;1;2;1081312;6745;1458;42;4106
FR;4;2022-08-05;2;0;1;0;0;1081314;6745;1459;42;4106
FR;4;2022-08-06;2;0;0;0;0;1081316;6745;1459;42;4106
FR;4;2022-08-07;3;0;0;0;0;1081319;6745;1459;42;4106
FR;4;2022-08-08;1;0;1;1;1;1081320;6745;1460;43;4107
FR;4;2022-08-09;1;1;1;2;2;1081321;6746;1461;45;4109
FR;4;2022-08-10;5;1;1;0;1;1081326;6747;1462;45;4110
FR;4;2022-08-11;2;0;1;0;1;1081328;6747;1463;45;4111
FR;4;2022-08-12;4;0;1;0;0;1081332;6747;1464;45;4111
FR;4;2022-08-13;1;0;0;0;0;1081333;6747;1464;45;4111
FR;4;2022-08-14;0;0;0;0;0;1081333;6747;1464;45;4111
FR;4;2022-08-15;0;1;3;0;1;1081333;6748;1467;45;4112
FR;4;2022-08-16;0;0;1;0;1;1081333;6748;1468;45;4113
FR;4;2022-08-17;2;0;0;0;0;1081335;6748;1468;45;4113
FR;4;2022-08-18;0;0;0;0;0;1081335;6748;1468;45;4113
FR;4;2022-08-19;5;0;0;0;0;1081340;6748;1468;45;4113
FR;4;2022-08-20;1;0;0;0;0;1081341;6748;1468;45;4113
FR;4;2022-08-21;1;0;0;0;0;1081342;6748;1468;45;4113
FR;4;2022-08-22;3;9;0;0;9;1081345;6757;1468;45;4122
FR;4;2022-08-23;1;2;2;0;2;1081346;6759;1470;45;4124
FR;4;2022-08-24;3;0;0;1;0;1081349;6759;1470;46;4124
FR;4;2022-08-25;0;3;1;0;3;1081349;6762;1471;46;4127
FR;4;2022-08-26;1;0;0;1;0;1081350;6762;1471;47;4127
FR;4;2022-08-27;1;0;0;0;0;1081351;6762;1471;47;4127
FR;4;2022-08-28;0;0;0;0;0;1081351;6762;1471;47;4127
FR;4;2022-08-29;2;0;0;0;0;1081353;6762;1471;47;4127
FR;4;2022-08-30;4;0;0;0;0;1081357;6762;1471;47;4127
FR;4;2022-08-31;1;1;0;0;1;1081358;6763;1471;47;4128
FR;4;2022-09-01;1;6;2;0;5;1081359;6769;1473;47;4133
FR;4;2022-09-02;1;1;1;0;2;1081360;6770;1474;47;4135
FR;4;2022-09-03;2;0;0;0;0;1081362;6770;1474;47;4135
FR;4;2022-09-04;0;0;0;0;0;1081362;6770;1474;47;4135
FR;4;2022-09-05;2;2;0;0;2;1081364;6772;1474;47;4137
FR;4;2022-09-06;0;0;0;0;0;1081364;6772;1474;47;4137
FR;4;2022-09-07;0;0;1;1;1;1081364;6772;1475;48;4138
FR;4;2022-09-08;3;0;0;0;0;1081367;6772;1475;48;4138
FR;4;2022-09-09;2;0;0;0;0;1081369;6772;1475;48;4138
FR;4;2022-09-10;0;0;0;3;1;1081369;6772;1475;51;4139
FR;4;2022-09-11;2;0;0;0;0;1081371;6772;1475;51;4139
FR;4;2022-09-12;0;1;1;0;1;1081371;6773;1476;51;4140
FR;4;2022-09-13;1;0;0;0;0;1081372;6773;1476;51;4140
FR;4;2022-09-14;0;0;0;0;0;1081372;6773;1476;51;4140
FR;4;2022-09-15;2;0;0;0;0;1081374;6773;1476;51;4140
FR;4;2022-09-16;0;0;0;0;0;1081374;6773;1476;51;4140
FR;4;2022-09-17;2;0;0;0;0;1081376;6773;1476;51;4140
FR;4;2022-09-18;0;0;0;0;0;1081376;6773;1476;51;4140
FR;4;2022-09-19;1;0;1;0;1;1081377;6773;1477;51;4141
FR;4;2022-09-20;0;0;0;0;0;1081377;6773;1477;51;4141
FR;4;2022-09-21;2;0;0;0;0;1081379;6773;1477;51;4141
FR;4;2022-09-22;1;0;0;0;0;1081380;6773;1477;51;4141
FR;4;2022-09-23;1;3;0;0;2;1081381;6776;1477;51;4143
FR;4;2022-09-24;1;0;0;0;0;1081382;6776;1477;51;4143
FR;4;2022-09-25;0;0;0;0;0;1081382;6776;1477;51;4143
FR;4;2022-09-26;2;0;1;0;0;1081384;6776;1478;51;4143
FR;4;2022-09-27;0;0;0;1;0;1081384;6776;1478;52;4143
FR;4;2022-09-28;3;0;0;0;0;1081387;6776;1478;52;4143
FR;4;2022-09-29;2;0;0;1;0;1081389;6776;1478;53;4143
FR;4;2022-09-30;1;0;0;0;0;1081390;6776;1478;53;4143
FR;4;2022-10-01;0;1;0;0;0;1081390;6777;1478;53;4143
FR;4;2022-10-02;0;0;0;0;0;1081390;6777;1478;53;4143
FR;4;2022-10-03;1;1;0;0;0;1081391;6778;1478;53;4143
FR;4;2022-10-04;2;0;0;0;0;1081393;6778;1478;53;4143
FR;4;2022-10-05;0;1;0;0;1;1081393;6779;1478;53;4144
FR;4;2022-10-06;1;0;0;0;0;1081394;6779;1478;53;4144
FR;4;2022-10-07;1;0;1;0;0;1081395;6779;1479;53;4144
FR;4;2022-10-08;3;1;0;0;0;1081398;6780;1479;53;4144
FR;4;2022-10-09;0;0;0;0;0;1081398;6780;1479;53;4144
FR;4;2022-10-10;1;0;0;1;0;1081399;6780;1479;54;4144
FR;4;2022-10-11;1;2;0;0;1;1081400;6782;1479;54;4145
FR;4;2022-10-12;0;0;0;0;0;1081400;6782;1479;54;4145
FR;4;2022-10-13;3;0;0;0;0;1081403;6782;1479;54;4145
FR;4;2022-10-14;0;0;0;0;0;1081403;6782;1479;54;4145
FR;4;2022-10-15;0;0;0;0;0;1081403;6782;1479;54;4145
FR;4;2022-10-16;0;0;0;0;0;1081403;6782;1479;54;4145
FR;4;2022-10-17;1;0;1;0;1;1081404;6782;1480;54;4146
FR;5;2020-12-27;0;0;0;0;0;0;0;0;0;0
FR;5;2020-12-28;0;0;0;0;0;0;0;0;0;0
FR;5;2020-12-29;0;0;0;0;0;0;0;0;0;0
FR;5;2020-12-30;0;0;0;0;0;0;0;0;0;0
FR;5;2020-12-31;0;0;0;0;0;0;0;0;0;0
FR;5;2021-01-01;0;0;0;0;0;0;0;0;0;0
FR;5;2021-01-02;0;0;0;0;0;0;0;0;0;0
FR;5;2021-01-03;0;0;0;0;0;0;0;0;0;0
FR;5;2021-01-04;0;0;0;0;0;0;0;0;0;0
FR;5;2021-01-05;0;0;0;0;0;0;0;0;0;0
FR;5;2021-01-06;0;0;0;0;0;0;0;0;0;0
FR;5;2021-01-07;0;0;0;0;0;0;0;0;0;0
FR;5;2021-01-08;0;0;0;0;0;0;0;0;0;0
FR;5;2021-01-09;0;0;0;0;0;0;0;0;0;0
FR;5;2021-01-10;0;0;0;0;0;0;0;0;0;0
FR;5;2021-01-11;0;0;0;0;0;0;0;0;0;0
FR;5;2021-01-12;0;0;0;0;0;0;0;0;0;0
FR;5;2021-01-13;0;0;0;0;0;0;0;0;0;0
FR;5;2021-01-14;0;0;0;0;0;0;0;0;0;0
FR;5;2021-01-15;0;0;0;0;0;0;0;0;0;0
FR;5;2021-01-16;0;0;0;0;0;0;0;0;0;0
FR;5;2021-01-17;0;0;0;0;0;0;0;0;0;0
FR;5;2021-01-18;0;0;0;0;0;0;0;0;0;0
FR;5;2021-01-19;0;0;0;0;0;0;0;0;0;0
FR;5;2021-01-20;0;0;0;0;0;0;0;0;0;0
FR;5;2021-01-21;0;0;0;0;0;0;0;0;0;0
FR;5;2021-01-22;0;0;0;0;0;0;0;0;0;0
FR;5;2021-01-23;0;0;0;0;0;0;0;0;0;0
FR;5;2021-01-24;0;0;0;0;0;0;0;0;0;0
FR;5;2021-01-25;0;0;0;0;0;0;0;0;0;0
FR;5;2021-01-26;0;0;0;0;0;0;0;0;0;0
FR;5;2021-01-27;0;0;0;0;0;0;0;0;0;0
FR;5;2021-01-28;0;0;0;0;0;0;0;0;0;0
FR;5;2021-01-29;0;0;0;0;0;0;0;0;0;0
FR;5;2021-01-30;0;0;0;0;0;0;0;0;0;0
FR;5;2021-01-31;0;0;0;0;0;0;0;0;0;0
FR;5;2021-02-01;0;0;0;0;0;0;0;0;0;0
FR;5;2021-02-02;0;0;0;0;0;0;0;0;0;0
FR;5;2021-02-03;0;0;0;0;0;0;0;0;0;0
FR;5;2021-02-04;0;0;0;0;0;0;0;0;0;0
FR;5;2021-02-05;0;0;0;0;0;0;0;0;0;0
FR;5;2021-02-06;0;0;0;0;0;0;0;0;0;0
FR;5;2021-02-07;0;0;0;0;0;0;0;0;0;0
FR;5;2021-02-08;0;0;0;0;0;0;0;0;0;0
FR;5;2021-02-09;0;0;0;0;0;0;0;0;0;0
FR;5;2021-02-10;0;0;0;0;0;0;0;0;0;0
FR;5;2021-02-11;0;0;0;0;0;0;0;0;0;0
FR;5;2021-02-12;0;0;0;0;0;0;0;0;0;0
FR;5;2021-02-13;0;0;0;0;0;0;0;0;0;0
FR;5;2021-02-14;0;0;0;0;0;0;0;0;0;0
FR;5;2021-02-15;0;0;0;0;0;0;0;0;0;0
FR;5;2021-02-16;0;0;0;0;0;0;0;0;0;0
FR;5;2021-02-17;0;0;0;0;0;0;0;0;0;0
FR;5;2021-02-18;0;0;0;0;0;0;0;0;0;0
FR;5;2021-02-19;0;0;0;0;0;0;0;0;0;0
FR;5;2021-02-20;0;0;0;0;0;0;0;0;0;0
FR;5;2021-02-21;0;0;0;0;0;0;0;0;0;0
FR;5;2021-02-22;0;0;0;0;0;0;0;0;0;0
FR;5;2021-02-23;0;0;0;0;0;0;0;0;0;0
FR;5;2021-02-24;0;0;0;0;0;0;0;0;0;0
FR;5;2021-02-25;0;0;0;0;0;0;0;0;0;0
FR;5;2021-02-26;0;0;0;0;0;0;0;0;0;0
FR;5;2021-02-27;0;0;0;0;0;0;0;0;0;0
FR;5;2021-02-28;0;0;0;0;0;0;0;0;0;0
FR;5;2021-03-01;0;0;0;0;0;0;0;0;0;0
FR;5;2021-03-02;0;0;0;0;0;0;0;0;0;0
FR;5;2021-03-03;0;0;0;0;0;0;0;0;0;0
FR;5;2021-03-04;0;0;0;0;0;0;0;0;0;0
FR;5;2021-03-05;0;0;0;0;0;0;0;0;0;0
FR;5;2021-03-06;0;0;0;0;0;0;0;0;0;0
FR;5;2021-03-07;0;0;0;0;0;0;0;0;0;0
FR;5;2021-03-08;0;0;0;0;0;0;0;0;0;0
FR;5;2021-03-09;0;0;0;0;0;0;0;0;0;0
FR;5;2021-03-10;0;0;0;0;0;0;0;0;0;0
FR;5;2021-03-11;0;0;0;0;0;0;0;0;0;0
FR;5;2021-03-12;0;0;0;0;0;0;0;0;0;0
FR;5;2021-03-13;0;0;0;0;0;0;0;0;0;0
FR;5;2021-03-14;0;0;0;0;0;0;0;0;0;0
FR;5;2021-03-15;0;0;0;0;0;0;0;0;0;0
FR;5;2021-03-16;0;0;0;0;0;0;0;0;0;0
FR;5;2021-03-17;0;0;0;0;0;0;0;0;0;0
FR;5;2021-03-18;0;0;0;0;0;0;0;0;0;0
FR;5;2021-03-19;0;0;0;0;0;0;0;0;0;0
FR;5;2021-03-20;0;0;0;0;0;0;0;0;0;0
FR;5;2021-03-21;0;0;0;0;0;0;0;0;0;0
FR;5;2021-03-22;0;0;0;0;0;0;0;0;0;0
FR;5;2021-03-23;0;0;0;0;0;0;0;0;0;0
FR;5;2021-03-24;0;0;0;0;0;0;0;0;0;0
FR;5;2021-03-25;0;0;0;0;0;0;0;0;0;0
FR;5;2021-03-26;0;0;0;0;0;0;0;0;0;0
FR;5;2021-03-27;0;0;0;0;0;0;0;0;0;0
FR;5;2021-03-28;0;0;0;0;0;0;0;0;0;0
FR;5;2021-03-29;0;0;0;0;0;0;0;0;0;0
FR;5;2021-03-30;0;0;0;0;0;0;0;0;0;0
FR;5;2021-03-31;0;0;0;0;0;0;0;0;0;0
FR;5;2021-04-01;0;0;0;0;0;0;0;0;0;0
FR;5;2021-04-02;0;0;0;0;0;0;0;0;0;0
FR;5;2021-04-03;0;0;0;0;0;0;0;0;0;0
FR;5;2021-04-04;0;0;0;0;0;0;0;0;0;0
FR;5;2021-04-05;0;0;0;0;0;0;0;0;0;0
FR;5;2021-04-06;0;0;0;0;0;0;0;0;0;0
FR;5;2021-04-07;0;0;0;0;0;0;0;0;0;0
FR;5;2021-04-08;0;0;0;0;0;0;0;0;0;0
FR;5;2021-04-09;0;0;0;0;0;0;0;0;0;0
FR;5;2021-04-10;0;0;0;0;0;0;0;0;0;0
FR;5;2021-04-11;0;0;0;0;0;0;0;0;0;0
FR;5;2021-04-12;0;0;0;0;0;0;0;0;0;0
FR;5;2021-04-13;0;0;0;0;0;0;0;0;0;0
FR;5;2021-04-14;0;0;0;0;0;0;0;0;0;0
FR;5;2021-04-15;0;0;0;0;0;0;0;0;0;0
FR;5;2021-04-16;0;0;0;0;0;0;0;0;0;0
FR;5;2021-04-17;0;0;0;0;0;0;0;0;0;0
FR;5;2021-04-18;0;0;0;0;0;0;0;0;0;0
FR;5;2021-04-19;0;0;0;0;0;0;0;0;0;0
FR;5;2021-04-20;0;0;0;0;0;0;0;0;0;0
FR;5;2021-04-21;0;0;0;0;0;0;0;0;0;0
FR;5;2021-04-22;0;0;0;0;0;0;0;0;0;0
FR;5;2021-04-23;0;0;0;0;0;0;0;0;0;0
FR;5;2021-04-24;0;0;0;0;0;0;0;0;0;0
FR;5;2021-04-25;0;0;0;0;0;0;0;0;0;0
FR;5;2021-04-26;0;0;0;0;0;0;0;0;0;0
FR;5;2021-04-27;0;0;0;0;0;0;0;0;0;0
FR;5;2021-04-28;0;0;0;0;0;0;0;0;0;0
FR;5;2021-04-29;0;0;0;0;0;0;0;0;0;0
FR;5;2021-04-30;0;0;0;0;0;0;0;0;0;0
FR;5;2021-05-01;0;0;0;0;0;0;0;0;0;0
FR;5;2021-05-02;0;0;0;0;0;0;0;0;0;0
FR;5;2021-05-03;0;0;0;0;0;0;0;0;0;0
FR;5;2021-05-04;0;0;0;0;0;0;0;0;0;0
FR;5;2021-05-05;0;0;0;0;0;0;0;0;0;0
FR;5;2021-05-06;0;0;0;0;0;0;0;0;0;0
FR;5;2021-05-07;0;0;0;0;0;0;0;0;0;0
FR;5;2021-05-08;0;0;0;0;0;0;0;0;0;0
FR;5;2021-05-09;0;0;0;0;0;0;0;0;0;0
FR;5;2021-05-10;0;0;0;0;0;0;0;0;0;0
FR;5;2021-05-11;0;0;0;0;0;0;0;0;0;0
FR;5;2021-05-12;0;0;0;0;0;0;0;0;0;0
FR;5;2021-05-13;0;0;0;0;0;0;0;0;0;0
FR;5;2021-05-14;0;0;0;0;0;0;0;0;0;0
FR;5;2021-05-15;0;0;0;0;0;0;0;0;0;0
FR;5;2021-05-16;0;0;0;0;0;0;0;0;0;0
FR;5;2021-05-17;0;0;0;0;0;0;0;0;0;0
FR;5;2021-05-18;0;0;0;0;0;0;0;0;0;0
FR;5;2021-05-19;0;0;0;0;0;0;0;0;0;0
FR;5;2021-05-20;0;0;0;0;0;0;0;0;0;0
FR;5;2021-05-21;0;0;0;0;0;0;0;0;0;0
FR;5;2021-05-22;0;0;0;0;0;0;0;0;0;0
FR;5;2021-05-23;0;0;0;0;0;0;0;0;0;0
FR;5;2021-05-24;0;0;0;0;0;0;0;0;0;0
FR;5;2021-05-25;0;0;0;0;0;0;0;0;0;0
FR;5;2021-05-26;0;0;0;0;0;0;0;0;0;0
FR;5;2021-05-27;0;0;0;0;0;0;0;0;0;0
FR;5;2021-05-28;0;0;0;0;0;0;0;0;0;0
FR;5;2021-05-29;0;0;0;0;0;0;0;0;0;0
FR;5;2021-05-30;0;0;0;0;0;0;0;0;0;0
FR;5;2021-05-31;0;0;0;0;0;0;0;0;0;0
FR;5;2021-06-01;0;0;0;0;0;0;0;0;0;0
FR;5;2021-06-02;0;0;0;0;0;0;0;0;0;0
FR;5;2021-06-03;0;0;0;0;0;0;0;0;0;0
FR;5;2021-06-04;0;0;0;0;0;0;0;0;0;0
FR;5;2021-06-05;0;0;0;0;0;0;0;0;0;0
FR;5;2021-06-06;0;0;0;0;0;0;0;0;0;0
FR;5;2021-06-07;0;0;0;0;0;0;0;0;0;0
FR;5;2021-06-08;0;0;0;0;0;0;0;0;0;0
FR;5;2021-06-09;0;0;0;0;0;0;0;0;0;0
FR;5;2021-06-10;0;0;0;0;0;0;0;0;0;0
FR;5;2021-06-11;0;0;0;0;0;0;0;0;0;0
FR;5;2021-06-12;0;0;0;0;0;0;0;0;0;0
FR;5;2021-06-13;0;0;0;0;0;0;0;0;0;0
FR;5;2021-06-14;0;0;0;0;0;0;0;0;0;0
FR;5;2021-06-15;0;0;0;0;0;0;0;0;0;0
FR;5;2021-06-16;0;0;0;0;0;0;0;0;0;0
FR;5;2021-06-17;0;0;0;0;0;0;0;0;0;0
FR;5;2021-06-18;0;0;0;0;0;0;0;0;0;0
FR;5;2021-06-19;0;0;0;0;0;0;0;0;0;0
FR;5;2021-06-20;0;0;0;0;0;0;0;0;0;0
FR;5;2021-06-21;0;0;0;0;0;0;0;0;0;0
FR;5;2021-06-22;0;0;0;0;0;0;0;0;0;0
FR;5;2021-06-23;0;0;0;0;0;0;0;0;0;0
FR;5;2021-06-24;0;0;0;0;0;0;0;0;0;0
FR;5;2021-06-25;0;0;0;0;0;0;0;0;0;0
FR;5;2021-06-26;0;0;0;0;0;0;0;0;0;0
FR;5;2021-06-27;0;0;0;0;0;0;0;0;0;0
FR;5;2021-06-28;0;0;0;0;0;0;0;0;0;0
FR;5;2021-06-29;0;0;0;0;0;0;0;0;0;0
FR;5;2021-06-30;0;0;0;0;0;0;0;0;0;0
FR;5;2021-07-01;0;0;0;0;0;0;0;0;0;0
FR;5;2021-07-02;0;0;0;0;0;0;0;0;0;0
FR;5;2021-07-03;0;0;0;0;0;0;0;0;0;0
FR;5;2021-07-04;0;0;0;0;0;0;0;0;0;0
FR;5;2021-07-05;0;0;0;0;0;0;0;0;0;0
FR;5;2021-07-06;0;0;0;0;0;0;0;0;0;0
FR;5;2021-07-07;0;0;0;0;0;0;0;0;0;0
FR;5;2021-07-08;0;0;0;0;0;0;0;0;0;0
FR;5;2021-07-09;0;0;0;0;0;0;0;0;0;0
FR;5;2021-07-10;0;0;0;0;0;0;0;0;0;0
FR;5;2021-07-11;0;0;0;0;0;0;0;0;0;0
FR;5;2021-07-12;0;0;0;0;0;0;0;0;0;0
FR;5;2021-07-13;0;0;0;0;0;0;0;0;0;0
FR;5;2021-07-14;0;0;0;0;0;0;0;0;0;0
FR;5;2021-07-15;0;0;0;0;0;0;0;0;0;0
FR;5;2021-07-16;0;0;0;0;0;0;0;0;0;0
FR;5;2021-07-17;0;0;0;0;0;0;0;0;0;0
FR;5;2021-07-18;0;0;0;0;0;0;0;0;0;0
FR;5;2021-07-19;0;0;0;0;0;0;0;0;0;0
FR;5;2021-07-20;0;0;0;0;0;0;0;0;0;0
FR;5;2021-07-21;0;0;0;0;0;0;0;0;0;0
FR;5;2021-07-22;0;0;0;0;0;0;0;0;0;0
FR;5;2021-07-23;0;0;0;0;0;0;0;0;0;0
FR;5;2021-07-24;0;0;0;0;0;0;0;0;0;0
FR;5;2021-07-25;0;0;0;0;0;0;0;0;0;0
FR;5;2021-07-26;0;0;0;0;0;0;0;0;0;0
FR;5;2021-07-27;0;0;0;0;0;0;0;0;0;0
FR;5;2021-07-28;0;0;0;0;0;0;0;0;0;0
FR;5;2021-07-29;0;0;0;0;0;0;0;0;0;0
FR;5;2021-07-30;0;0;0;0;0;0;0;0;0;0
FR;5;2021-07-31;0;0;0;0;0;0;0;0;0;0
FR;5;2021-08-01;0;0;0;0;0;0;0;0;0;0
FR;5;2021-08-02;0;0;0;0;0;0;0;0;0;0
FR;5;2021-08-03;0;0;0;0;0;0;0;0;0;0
FR;5;2021-08-04;0;0;0;0;0;0;0;0;0;0
FR;5;2021-08-05;0;0;0;0;0;0;0;0;0;0
FR;5;2021-08-06;0;0;0;0;0;0;0;0;0;0
FR;5;2021-08-07;0;0;0;0;0;0;0;0;0;0
FR;5;2021-08-08;0;0;0;0;0;0;0;0;0;0
FR;5;2021-08-09;0;0;0;0;0;0;0;0;0;0
FR;5;2021-08-10;0;0;0;0;0;0;0;0;0;0
FR;5;2021-08-11;0;0;0;0;0;0;0;0;0;0
FR;5;2021-08-12;0;0;0;0;0;0;0;0;0;0
FR;5;2021-08-13;0;0;0;0;0;0;0;0;0;0
FR;5;2021-08-14;0;0;0;0;0;0;0;0;0;0
FR;5;2021-08-15;0;0;0;0;0;0;0;0;0;0
FR;5;2021-08-16;0;0;0;0;0;0;0;0;0;0
FR;5;2021-08-17;0;0;0;0;0;0;0;0;0;0
FR;5;2021-08-18;0;0;0;0;0;0;0;0;0;0
FR;5;2021-08-19;0;0;0;0;0;0;0;0;0;0
FR;5;2021-08-20;0;0;0;0;0;0;0;0;0;0
FR;5;2021-08-21;0;0;0;0;0;0;0;0;0;0
FR;5;2021-08-22;0;0;0;0;0;0;0;0;0;0
FR;5;2021-08-23;0;0;0;0;0;0;0;0;0;0
FR;5;2021-08-24;0;0;0;0;0;0;0;0;0;0
FR;5;2021-08-25;0;0;0;0;0;0;0;0;0;0
FR;5;2021-08-26;0;0;0;0;0;0;0;0;0;0
FR;5;2021-08-27;0;0;0;0;0;0;0;0;0;0
FR;5;2021-08-28;0;0;0;0;0;0;0;0;0;0
FR;5;2021-08-29;0;0;0;0;0;0;0;0;0;0
FR;5;2021-08-30;0;0;0;0;0;0;0;0;0;0
FR;5;2021-08-31;0;0;0;0;0;0;0;0;0;0
FR;5;2021-09-01;0;0;0;0;0;0;0;0;0;0
FR;5;2021-09-02;0;0;0;0;0;0;0;0;0;0
FR;5;2021-09-03;0;0;0;0;0;0;0;0;0;0
FR;5;2021-09-04;0;0;0;0;0;0;0;0;0;0
FR;5;2021-09-05;0;0;0;0;0;0;0;0;0;0
FR;5;2021-09-06;0;0;0;0;0;0;0;0;0;0
FR;5;2021-09-07;0;0;0;0;0;0;0;0;0;0
FR;5;2021-09-08;0;0;0;0;0;0;0;0;0;0
FR;5;2021-09-09;0;0;0;0;0;0;0;0;0;0
FR;5;2021-09-10;0;0;0;0;0;0;0;0;0;0
FR;5;2021-09-11;0;0;0;0;0;0;0;0;0;0
FR;5;2021-09-12;0;0;0;0;0;0;0;0;0;0
FR;5;2021-09-13;0;0;0;0;0;0;0;0;0;0
FR;5;2021-09-14;0;0;0;0;0;0;0;0;0;0
FR;5;2021-09-15;0;0;0;0;0;0;0;0;0;0
FR;5;2021-09-16;0;0;0;0;0;0;0;0;0;0
FR;5;2021-09-17;0;0;0;0;0;0;0;0;0;0
FR;5;2021-09-18;0;0;0;0;0;0;0;0;0;0
FR;5;2021-09-19;0;0;0;0;0;0;0;0;0;0
FR;5;2021-09-20;0;0;0;0;0;0;0;0;0;0
FR;5;2021-09-21;0;0;0;0;0;0;0;0;0;0
FR;5;2021-09-22;0;0;0;0;0;0;0;0;0;0
FR;5;2021-09-23;0;0;0;0;0;0;0;0;0;0
FR;5;2021-09-24;0;0;0;0;0;0;0;0;0;0
FR;5;2021-09-25;0;0;0;0;0;0;0;0;0;0
FR;5;2021-09-26;0;0;0;0;0;0;0;0;0;0
FR;5;2021-09-27;0;0;0;0;0;0;0;0;0;0
FR;5;2021-09-28;0;0;0;0;0;0;0;0;0;0
FR;5;2021-09-29;0;0;0;0;0;0;0;0;0;0
FR;5;2021-09-30;0;0;0;0;0;0;0;0;0;0
FR;5;2021-10-01;0;0;0;0;0;0;0;0;0;0
FR;5;2021-10-02;0;0;0;0;0;0;0;0;0;0
FR;5;2021-10-03;0;0;0;0;0;0;0;0;0;0
FR;5;2021-10-04;0;0;0;0;0;0;0;0;0;0
FR;5;2021-10-05;0;0;0;0;0;0;0;0;0;0
FR;5;2021-10-06;0;0;0;0;0;0;0;0;0;0
FR;5;2021-10-07;0;0;0;0;0;0;0;0;0;0
FR;5;2021-10-08;0;0;0;0;0;0;0;0;0;0
FR;5;2021-10-09;0;0;0;0;0;0;0;0;0;0
FR;5;2021-10-10;0;0;0;0;0;0;0;0;0;0
FR;5;2021-10-11;0;0;0;0;0;0;0;0;0;0
FR;5;2021-10-12;0;0;0;0;0;0;0;0;0;0
FR;5;2021-10-13;0;0;0;0;0;0;0;0;0;0
FR;5;2021-10-14;0;0;0;0;0;0;0;0;0;0
FR;5;2021-10-15;0;0;0;0;0;0;0;0;0;0
FR;5;2021-10-16;0;0;0;0;0;0;0;0;0;0
FR;5;2021-10-17;0;0;0;0;0;0;0;0;0;0
FR;5;2021-10-18;0;0;0;0;0;0;0;0;0;0
FR;5;2021-10-19;0;0;0;0;0;0;0;0;0;0
FR;5;2021-10-20;0;0;0;0;0;0;0;0;0;0
FR;5;2021-10-21;0;0;0;0;0;0;0;0;0;0
FR;5;2021-10-22;0;0;0;0;0;0;0;0;0;0
FR;5;2021-10-23;0;0;0;0;0;0;0;0;0;0
FR;5;2021-10-24;0;0;0;0;0;0;0;0;0;0
FR;5;2021-10-25;0;0;0;0;0;0;0;0;0;0
FR;5;2021-10-26;0;0;0;0;0;0;0;0;0;0
FR;5;2021-10-27;0;0;0;0;0;0;0;0;0;0
FR;5;2021-10-28;0;0;0;0;0;0;0;0;0;0
FR;5;2021-10-29;0;0;0;0;0;0;0;0;0;0
FR;5;2021-10-30;0;0;0;0;0;0;0;0;0;0
FR;5;2021-10-31;0;0;0;0;0;0;0;0;0;0
FR;5;2021-11-01;0;0;0;0;0;0;0;0;0;0
FR;5;2021-11-02;0;0;0;0;0;0;0;0;0;0
FR;5;2021-11-03;0;0;0;0;0;0;0;0;0;0
FR;5;2021-11-04;0;0;0;0;0;0;0;0;0;0
FR;5;2021-11-05;0;0;0;0;0;0;0;0;0;0
FR;5;2021-11-06;0;0;0;0;0;0;0;0;0;0
FR;5;2021-11-07;0;0;0;0;0;0;0;0;0;0
FR;5;2021-11-08;0;0;0;0;0;0;0;0;0;0
FR;5;2021-11-09;0;0;0;0;0;0;0;0;0;0
FR;5;2021-11-10;0;0;0;0;0;0;0;0;0;0
FR;5;2021-11-11;0;0;0;0;0;0;0;0;0;0
FR;5;2021-11-12;0;0;0;0;0;0;0;0;0;0
FR;5;2021-11-13;0;0;0;0;0;0;0;0;0;0
FR;5;2021-11-14;0;0;0;0;0;0;0;0;0;0
FR;5;2021-11-15;0;0;0;0;0;0;0;0;0;0
FR;5;2021-11-16;0;0;0;0;0;0;0;0;0;0
FR;5;2021-11-17;0;0;0;0;0;0;0;0;0;0
FR;5;2021-11-18;0;0;0;0;0;0;0;0;0;0
FR;5;2021-11-19;0;0;0;0;0;0;0;0;0;0
FR;5;2021-11-20;0;0;0;0;0;0;0;0;0;0
FR;5;2021-11-21;0;0;0;0;0;0;0;0;0;0
FR;5;2021-11-22;0;0;0;0;0;0;0;0;0;0
FR;5;2021-11-23;0;0;0;0;0;0;0;0;0;0
FR;5;2021-11-24;0;0;0;0;0;0;0;0;0;0
FR;5;2021-11-25;0;0;0;0;0;0;0;0;0;0
FR;5;2021-11-26;0;0;0;0;0;0;0;0;0;0
FR;5;2021-11-27;0;0;0;0;0;0;0;0;0;0
FR;5;2021-11-28;0;0;0;0;0;0;0;0;0;0
FR;5;2021-11-29;0;0;0;0;0;0;0;0;0;0
FR;5;2021-11-30;0;0;0;0;0;0;0;0;0;0
FR;5;2021-12-01;0;0;0;0;0;0;0;0;0;0
FR;5;2021-12-02;0;0;0;0;0;0;0;0;0;0
FR;5;2021-12-03;0;0;0;0;0;0;0;0;0;0
FR;5;2021-12-04;0;0;0;0;0;0;0;0;0;0
FR;5;2021-12-05;0;0;0;0;0;0;0;0;0;0
FR;5;2021-12-06;0;0;0;0;0;0;0;0;0;0
FR;5;2021-12-07;0;0;0;0;0;0;0;0;0;0
FR;5;2021-12-08;0;0;0;0;0;0;0;0;0;0
FR;5;2021-12-09;0;0;0;0;0;0;0;0;0;0
FR;5;2021-12-10;0;0;0;0;0;0;0;0;0;0
FR;5;2021-12-11;0;0;0;0;0;0;0;0;0;0
FR;5;2021-12-12;0;0;0;0;0;0;0;0;0;0
FR;5;2021-12-13;0;0;0;0;0;0;0;0;0;0
FR;5;2021-12-14;33;45;77;0;88;33;45;77;0;88
FR;5;2021-12-15;196;45;37;0;49;229;90;114;0;137
FR;5;2021-12-16;181;21;44;0;48;410;111;158;0;185
FR;5;2021-12-17;312;16;72;0;74;722;127;230;0;259
FR;5;2021-12-18;766;24;22;0;29;1488;151;252;0;288
FR;5;2021-12-19;586;15;15;0;17;2074;166;267;0;305
FR;5;2021-12-20;1223;31;35;0;38;3297;197;302;0;343
FR;5;2021-12-21;1535;22;54;1;60;4832;219;356;1;403
FR;5;2021-12-22;4069;40;37;0;46;8901;259;393;1;449
FR;5;2021-12-23;3042;16;21;0;25;11943;275;414;1;474
FR;5;2021-12-24;761;18;9;0;14;12704;293;423;1;488
FR;5;2021-12-25;61;5;2;0;3;12765;298;425;1;491
FR;5;2021-12-26;623;6;3;0;4;13388;304;428;1;495
FR;5;2021-12-27;4085;25;21;0;23;17473;329;449;1;518
FR;5;2021-12-28;5204;23;41;1;43;22677;352;490;2;561
FR;5;2021-12-29;8107;34;66;2;69;30784;386;556;4;630
FR;5;2021-12-30;5173;18;33;0;39;35957;404;589;4;669
FR;5;2021-12-31;1553;8;10;0;11;37510;412;599;4;680
FR;5;2022-01-01;185;2;2;0;3;37695;414;601;4;683
FR;5;2022-01-02;1489;1;1;0;1;39184;415;602;4;684
FR;5;2022-01-03;3066;36;33;0;32;42250;451;635;4;716
FR;5;2022-01-04;3033;39;33;0;42;45283;490;668;4;758
FR;5;2022-01-05;19323;203;97;1;108;64606;693;765;5;866
FR;5;2022-01-06;3746;134;122;0;142;68352;827;887;5;1008
FR;5;2022-01-07;5007;202;48;2;56;73359;1029;935;7;1064
FR;5;2022-01-08;13659;514;45;0;52;87018;1543;980;7;1116
FR;5;2022-01-09;5754;399;15;0;20;92772;1942;995;7;1136
FR;5;2022-01-10;3455;326;25;0;29;96227;2268;1020;7;1165
FR;5;2022-01-11;3671;284;38;0;41;99898;2552;1058;7;1206
FR;5;2022-01-12;22652;3005;89;0;112;122550;5557;1147;7;1318
FR;5;2022-01-13;4037;622;30;0;32;126587;6179;1177;7;1350
FR;5;2022-01-14;4843;582;44;0;51;131430;6761;1221;7;1401
FR;5;2022-01-15;14686;1746;38;3;49;146116;8507;1259;10;1450
FR;5;2022-01-16;4727;666;3;0;5;150843;9173;1262;10;1455
FR;5;2022-01-17;2297;718;26;0;29;153140;9891;1288;10;1484
FR;5;2022-01-18;2430;870;30;0;40;155570;10761;1318;10;1524
FR;5;2022-01-19;18483;6423;74;2;142;174053;17184;1392;12;1666
FR;5;2022-01-20;1920;1068;25;0;34;175973;18252;1417;12;1700
FR;5;2022-01-21;3077;1372;47;1;59;179050;19624;1464;13;1759
FR;5;2022-01-22;10720;3454;33;1;43;189770;23078;1497;14;1802
FR;5;2022-01-23;2629;1415;6;0;10;192399;24493;1503;14;1812
FR;5;2022-01-24;1160;1340;19;0;23;193559;25833;1522;14;1835
FR;5;2022-01-25;1220;1549;20;2;31;194779;27382;1542;16;1866
FR;5;2022-01-26;10751;12028;50;1;89;205530;39410;1592;17;1955
FR;5;2022-01-27;1291;1693;10;0;17;206821;41103;1602;17;1972
FR;5;2022-01-28;1699;3347;16;0;19;208520;44450;1618;17;1991
FR;5;2022-01-29;6241;8041;68;0;96;214761;52491;1686;17;2087
FR;5;2022-01-30;1509;2950;5;0;18;216270;55441;1691;17;2105
FR;5;2022-01-31;589;1773;23;0;24;216859;57214;1714;17;2129
FR;5;2022-02-01;712;1706;10;0;15;217571;58920;1724;17;2144
FR;5;2022-02-02;6958;15656;52;0;94;224529;74576;1776;17;2238
FR;5;2022-02-03;491;1690;14;0;13;225020;76266;1790;17;2251
FR;5;2022-02-04;945;3002;19;0;31;225965;79268;1809;17;2282
FR;5;2022-02-05;3535;8918;23;0;37;229500;88186;1832;17;2319
FR;5;2022-02-06;737;2397;10;0;19;230237;90583;1842;17;2338
FR;5;2022-02-07;884;1596;23;0;25;231121;92179;1865;17;2363
FR;5;2022-02-08;722;1287;18;0;20;231843;93466;1883;17;2383
FR;5;2022-02-09;4544;12878;44;0;76;236387;106344;1927;17;2459
FR;5;2022-02-10;646;1059;14;0;15;237033;107403;1941;17;2474
FR;5;2022-02-11;793;2032;16;0;21;237826;109435;1957;17;2495
FR;5;2022-02-12;2286;6812;33;0;53;240112;116247;1990;17;2548
FR;5;2022-02-13;464;1540;8;0;8;240576;117787;1998;17;2556
FR;5;2022-02-14;678;1288;10;0;13;241254;119075;2008;17;2569
FR;5;2022-02-15;482;886;9;0;14;241736;119961;2017;17;2583
FR;5;2022-02-16;2980;9123;41;1;58;244716;129084;2058;18;2641
FR;5;2022-02-17;436;809;6;0;7;245152;129893;2064;18;2648
FR;5;2022-02-18;649;1408;13;0;17;245801;131301;2077;18;2665
FR;5;2022-02-19;1373;4315;16;0;28;247174;135616;2093;18;2693
FR;5;2022-02-20;247;879;6;0;8;247421;136495;2099;18;2701
FR;5;2022-02-21;221;607;2;0;4;247642;137102;2101;18;2705
FR;5;2022-02-22;262;545;17;0;17;247904;137647;2118;18;2722
FR;5;2022-02-23;1909;6926;23;1;43;249813;144573;2141;19;2765
FR;5;2022-02-24;182;374;6;1;7;249995;144947;2147;20;2772
FR;5;2022-02-25;336;950;13;0;12;250331;145897;2160;20;2784
FR;5;2022-02-26;972;3070;11;0;15;251303;148967;2171;20;2799
FR;5;2022-02-27;150;506;0;0;3;251453;149473;2171;20;2802
FR;5;2022-02-28;162;369;1;0;1;251615;149842;2172;20;2803
FR;5;2022-03-01;130;280;6;0;7;251745;150122;2178;20;2810
FR;5;2022-03-02;1241;4156;28;3;40;252986;154278;2206;23;2850
FR;5;2022-03-03;121;251;5;0;10;253107;154529;2211;23;2860
FR;5;2022-03-04;197;488;13;0;14;253304;155017;2224;23;2874
FR;5;2022-03-05;677;1990;8;0;16;253981;157007;2232;23;2890
FR;5;2022-03-06;108;260;0;0;0;254089;157267;2232;23;2890
FR;5;2022-03-07;71;228;5;0;3;254160;157495;2237;23;2893
FR;5;2022-03-08;46;134;7;1;8;254206;157629;2244;24;2901
FR;5;2022-03-09;910;3078;24;0;36;255116;160707;2268;24;2937
FR;5;2022-03-10;82;202;8;0;12;255198;160909;2276;24;2949
FR;5;2022-03-11;148;369;13;1;15;255346;161278;2289;25;2964
FR;5;2022-03-12;758;1613;13;1;30;256104;162891;2302;26;2994
FR;5;2022-03-13;78;100;0;0;0;256182;162991;2302;26;2994
FR;5;2022-03-14;67;119;7;1;7;256249;163110;2309;27;3001
FR;5;2022-03-15;83;99;4;0;7;256332;163209;2313;27;3008
FR;5;2022-03-16;882;1827;15;3;36;257214;165036;2328;30;3044
FR;5;2022-03-17;68;123;8;4;10;257282;165159;2336;34;3054
FR;5;2022-03-18;172;318;13;4;18;257454;165477;2349;38;3072
FR;5;2022-03-19;751;1163;12;5;33;258205;166640;2361;43;3105
FR;5;2022-03-20;45;93;1;0;1;258250;166733;2362;43;3106
FR;5;2022-03-21;71;120;10;6;15;258321;166853;2372;49;3121
FR;5;2022-03-22;56;119;8;7;9;258377;166972;2380;56;3130
FR;5;2022-03-23;805;1461;14;8;36;259182;168433;2394;64;3166
FR;5;2022-03-24;70;93;8;7;7;259252;168526;2402;71;3173
FR;5;2022-03-25;222;293;14;8;18;259474;168819;2416;79;3191
FR;5;2022-03-26;707;853;12;5;26;260181;169672;2428;84;3217
FR;5;2022-03-27;75;80;0;0;3;260256;169752;2428;84;3220
FR;5;2022-03-28;81;93;1;2;3;260337;169845;2429;86;3223
FR;5;2022-03-29;71;82;10;4;12;260408;169927;2439;90;3235
FR;5;2022-03-30;823;1116;16;13;29;261231;171043;2455;103;3264
FR;5;2022-03-31;102;125;1;4;6;261333;171168;2456;107;3270
FR;5;2022-04-01;114;86;7;12;11;261447;171254;2463;119;3281
FR;5;2022-04-02;330;349;3;3;15;261777;171603;2466;122;3296
FR;5;2022-04-03;54;59;1;0;1;261831;171662;2467;122;3297
FR;5;2022-04-04;40;57;4;1;8;261871;171719;2471;123;3305
FR;5;2022-04-05;52;60;6;7;9;261923;171779;2477;130;3314
FR;5;2022-04-06;421;439;7;15;16;262344;172218;2484;145;3330
FR;5;2022-04-07;45;69;5;7;7;262389;172287;2489;152;3337
FR;5;2022-04-08;134;112;12;13;14;262523;172399;2501;165;3351
FR;5;2022-04-09;311;324;2;5;17;262834;172723;2503;170;3368
FR;5;2022-04-10;44;31;2;0;2;262878;172754;2505;170;3370
FR;5;2022-04-11;50;60;3;2;4;262928;172814;2508;172;3374
FR;5;2022-04-12;59;54;3;3;5;262987;172868;2511;175;3379
FR;5;2022-04-13;382;413;3;8;16;263369;173281;2514;183;3395
FR;5;2022-04-14;48;48;5;5;9;263417;173329;2519;188;3404
FR;5;2022-04-15;91;109;4;4;5;263508;173438;2523;192;3409
FR;5;2022-04-16;188;184;2;1;13;263696;173622;2525;193;3422
FR;5;2022-04-17;12;11;1;0;1;263708;173633;2526;193;3423
FR;5;2022-04-18;9;10;2;0;3;263717;173643;2528;193;3426
FR;5;2022-04-19;75;71;6;1;6;263792;173714;2534;194;3432
FR;5;2022-04-20;361;349;9;6;12;264153;174063;2543;200;3444
FR;5;2022-04-21;42;64;9;10;12;264195;174127;2552;210;3456
FR;5;2022-04-22;113;96;5;4;5;264308;174223;2557;214;3461
FR;5;2022-04-23;209;193;3;2;10;264517;174416;2560;216;3471
FR;5;2022-04-24;37;35;0;0;3;264554;174451;2560;216;3474
FR;5;2022-04-25;69;65;1;1;4;264623;174516;2561;217;3478
FR;5;2022-04-26;60;63;2;1;5;264683;174579;2563;218;3483
FR;5;2022-04-27;335;316;3;7;14;265018;174895;2566;225;3497
FR;5;2022-04-28;81;54;4;5;8;265099;174949;2570;230;3505
FR;5;2022-04-29;117;84;5;19;12;265216;175033;2575;249;3517
FR;5;2022-04-30;183;114;2;3;10;265399;175147;2577;252;3527
FR;5;2022-05-01;11;7;0;0;0;265410;175154;2577;252;3527
FR;5;2022-05-02;52;28;4;5;2;265462;175182;2581;257;3529
FR;5;2022-05-03;84;57;2;5;11;265546;175239;2583;262;3540
FR;5;2022-05-04;278;205;1;2;7;265824;175444;2584;264;3547
FR;5;2022-05-05;62;32;3;4;5;265886;175476;2587;268;3552
FR;5;2022-05-06;105;65;2;3;5;265991;175541;2589;271;3557
FR;5;2022-05-07;171;117;3;10;13;266162;175658;2592;281;3570
FR;5;2022-05-08;8;8;0;0;2;266170;175666;2592;281;3572
FR;5;2022-05-09;44;34;15;3;16;266214;175700;2607;284;3588
FR;5;2022-05-10;54;49;3;4;5;266268;175749;2610;288;3593
FR;5;2022-05-11;326;237;12;7;21;266594;175986;2622;295;3614
FR;5;2022-05-12;46;34;2;2;2;266640;176020;2624;297;3616
FR;5;2022-05-13;109;83;3;8;8;266749;176103;2627;305;3624
FR;5;2022-05-14;209;131;0;1;8;266958;176234;2627;306;3632
FR;5;2022-05-15;22;9;2;0;1;266980;176243;2629;306;3633
FR;5;2022-05-16;52;34;4;5;4;267032;176277;2633;311;3637
FR;5;2022-05-17;72;40;5;0;2;267104;176317;2638;311;3639
FR;5;2022-05-18;289;215;4;4;8;267393;176532;2642;315;3647
FR;5;2022-05-19;45;35;5;3;3;267438;176567;2647;318;3650
FR;5;2022-05-20;76;63;3;10;1;267514;176630;2650;328;3651
FR;5;2022-05-21;242;166;2;3;17;267756;176796;2652;331;3668
FR;5;2022-05-22;20;14;2;5;2;267776;176810;2654;336;3670
FR;5;2022-05-23;42;31;4;3;6;267818;176841;2658;339;3676
FR;5;2022-05-24;47;45;3;2;5;267865;176886;2661;341;3681
FR;5;2022-05-25;329;257;4;1;16;268194;177143;2665;342;3697
FR;5;2022-05-26;17;5;0;1;2;268211;177148;2665;343;3699
FR;5;2022-05-27;99;54;4;4;9;268310;177202;2669;347;3708
FR;5;2022-05-28;100;78;5;3;10;268410;177280;2674;350;3718
FR;5;2022-05-29;14;14;1;0;2;268424;177294;2675;350;3720
FR;5;2022-05-30;56;41;2;1;2;268480;177335;2677;351;3722
FR;5;2022-05-31;57;43;1;8;1;268537;177378;2678;359;3723
FR;5;2022-06-01;257;241;9;2;25;268794;177619;2687;361;3748
FR;5;2022-06-02;63;61;5;0;9;268857;177680;2692;361;3757
FR;5;2022-06-03;82;71;4;5;10;268939;177751;2696;366;3767
FR;5;2022-06-04;157;109;2;1;9;269096;177860;2698;367;3776
FR;5;2022-06-05;18;11;0;0;1;269114;177871;2698;367;3777
FR;5;2022-06-06;16;9;0;1;0;269130;177880;2698;368;3777
FR;5;2022-06-07;50;56;1;1;2;269180;177936;2699;369;3779
FR;5;2022-06-08;283;225;3;4;17;269463;178161;2702;373;3796
FR;5;2022-06-09;52;41;6;3;7;269515;178202;2708;376;3803
FR;5;2022-06-10;81;72;1;1;6;269596;178274;2709;377;3809
FR;5;2022-06-11;173;141;3;3;10;269769;178415;2712;380;3819
FR;5;2022-06-12;17;16;0;0;2;269786;178431;2712;380;3821
FR;5;2022-06-13;56;47;9;3;10;269842;178478;2721;383;3831
FR;5;2022-06-14;59;56;1;4;6;269901;178534;2722;387;3837
FR;5;2022-06-15;266;260;5;2;27;270167;178794;2727;389;3864
FR;5;2022-06-16;47;30;5;2;5;270214;178824;2732;391;3869
FR;5;2022-06-17;100;67;5;5;10;270314;178891;2737;396;3879
FR;5;2022-06-18;146;95;10;2;26;270460;178986;2747;398;3905
FR;5;2022-06-19;26;15;0;1;4;270486;179001;2747;399;3909
FR;5;2022-06-20;56;50;8;0;11;270542;179051;2755;399;3920
FR;5;2022-06-21;52;73;5;3;7;270594;179124;2760;402;3927
FR;5;2022-06-22;224;247;7;9;33;270818;179371;2767;411;3960
FR;5;2022-06-23;50;38;2;5;6;270868;179409;2769;416;3966
FR;5;2022-06-24;91;70;12;5;16;270959;179479;2781;421;3982
FR;5;2022-06-25;154;124;3;7;14;271113;179603;2784;428;3996
FR;5;2022-06-26;26;19;2;0;5;271139;179622;2786;428;4001
FR;5;2022-06-27;57;60;5;7;11;271196;179682;2791;435;4012
FR;5;2022-06-28;70;49;8;2;14;271266;179731;2799;437;4026
FR;5;2022-06-29;297;268;9;21;34;271563;179999;2808;458;4060
FR;5;2022-06-30;89;57;10;12;17;271652;180056;2818;470;4077
FR;5;2022-07-01;127;65;7;11;12;271779;180121;2825;481;4089
FR;5;2022-07-02;191;132;4;0;22;271970;180253;2829;481;4111
FR;5;2022-07-03;30;25;1;0;4;272000;180278;2830;481;4115
FR;5;2022-07-04;103;64;2;5;6;272103;180342;2832;486;4121
FR;5;2022-07-05;104;72;3;8;13;272207;180414;2835;494;4134
FR;5;2022-07-06;277;168;9;36;27;272484;180582;2844;530;4161
FR;5;2022-07-07;88;68;6;9;13;272572;180650;2850;539;4174
FR;5;2022-07-08;152;120;7;14;25;272724;180770;2857;553;4199
FR;5;2022-07-09;116;68;1;8;10;272840;180838;2858;561;4209
FR;5;2022-07-10;15;6;0;0;1;272855;180844;2858;561;4210
FR;5;2022-07-11;92;72;10;2;19;272947;180916;2868;563;4229
FR;5;2022-07-12;67;63;5;10;7;273014;180979;2873;573;4236
FR;5;2022-07-13;169;118;10;19;16;273183;181097;2883;592;4252
FR;5;2022-07-14;8;4;0;0;0;273191;181101;2883;592;4252
FR;5;2022-07-15;74;66;5;14;15;273265;181167;2888;606;4267
FR;5;2022-07-16;54;44;3;0;3;273319;181211;2891;606;4270
FR;5;2022-07-17;10;7;3;0;2;273329;181218;2894;606;4272
FR;5;2022-07-18;60;47;0;5;4;273389;181265;2894;611;4276
FR;5;2022-07-19;63;42;5;3;7;273452;181307;2899;614;4283
FR;5;2022-07-20;119;106;4;11;14;273571;181413;2903;625;4297
FR;5;2022-07-21;38;43;2;10;5;273609;181456;2905;635;4302
FR;5;2022-07-22;46;69;11;14;23;273655;181525;2916;649;4325
FR;5;2022-07-23;59;78;2;1;11;273714;181603;2918;650;4336
FR;5;2022-07-24;11;9;3;1;3;273725;181612;2921;651;4339
FR;5;2022-07-25;53;48;2;7;8;273778;181660;2923;658;4347
FR;5;2022-07-26;58;53;5;41;6;273836;181713;2928;699;4353
FR;5;2022-07-27;106;118;4;4;13;273942;181831;2932;703;4366
FR;5;2022-07-28;39;35;2;2;6;273981;181866;2934;705;4372
FR;5;2022-07-29;56;74;3;14;8;274037;181940;2937;719;4380
FR;5;2022-07-30;55;53;5;1;7;274092;181993;2942;720;4387
FR;5;2022-07-31;7;11;1;0;1;274099;182004;2943;720;4388
FR;5;2022-08-01;39;53;1;2;6;274138;182057;2944;722;4394
FR;5;2022-08-02;32;43;8;7;8;274170;182100;2952;729;4402
FR;5;2022-08-03;54;51;4;10;9;274224;182151;2956;739;4411
FR;5;2022-08-04;20;18;1;6;1;274244;182169;2957;745;4412
FR;5;2022-08-05;35;26;3;3;3;274279;182195;2960;748;4415
FR;5;2022-08-06;23;26;1;0;1;274302;182221;2961;748;4416
FR;5;2022-08-07;2;2;1;0;1;274304;182223;2962;748;4417
FR;5;2022-08-08;25;19;1;2;2;274329;182242;2963;750;4419
FR;5;2022-08-09;26;28;3;3;3;274355;182270;2966;753;4422
FR;5;2022-08-10;47;47;2;0;5;274402;182317;2968;753;4427
FR;5;2022-08-11;19;36;2;2;5;274421;182353;2970;755;4432
FR;5;2022-08-12;27;28;2;0;2;274448;182381;2972;755;4434
FR;5;2022-08-13;16;18;0;0;0;274464;182399;2972;755;4434
FR;5;2022-08-14;2;3;0;0;0;274466;182402;2972;755;4434
FR;5;2022-08-15;2;5;0;0;0;274468;182407;2972;755;4434
FR;5;2022-08-16;33;26;2;0;5;274501;182433;2974;755;4439
FR;5;2022-08-17;52;55;2;1;1;274553;182488;2976;756;4440
FR;5;2022-08-18;26;18;5;17;7;274579;182506;2981;773;4447
FR;5;2022-08-19;25;33;1;2;2;274604;182539;2982;775;4449
FR;5;2022-08-20;25;27;2;1;4;274629;182566;2984;776;4453
FR;5;2022-08-21;7;4;1;0;1;274636;182570;2985;776;4454
FR;5;2022-08-22;39;26;1;6;2;274675;182596;2986;782;4456
FR;5;2022-08-23;27;26;1;1;2;274702;182622;2987;783;4458
FR;5;2022-08-24;50;43;0;0;0;274752;182665;2987;783;4458
FR;5;2022-08-25;27;26;3;1;2;274779;182691;2990;784;4460
FR;5;2022-08-26;48;38;7;2;5;274827;182729;2997;786;4465
FR;5;2022-08-27;46;28;1;0;3;274873;182757;2998;786;4468
FR;5;2022-08-28;5;6;0;0;0;274878;182763;2998;786;4468
FR;5;2022-08-29;58;44;1;1;4;274936;182807;2999;787;4472
FR;5;2022-08-30;43;23;12;29;10;274979;182830;3011;816;4482
FR;5;2022-08-31;52;47;6;1;11;275031;182877;3017;817;4493
FR;5;2022-09-01;14;8;1;4;1;275045;182885;3018;821;4494
FR;5;2022-09-02;42;22;8;2;9;275087;182907;3026;823;4503
FR;5;2022-09-03;69;37;2;0;2;275156;182944;3028;823;4505
FR;5;2022-09-04;12;7;1;0;3;275168;182951;3029;823;4508
FR;5;2022-09-05;6;4;1;0;1;275174;182955;3030;823;4509
FR;5;2022-09-06;21;14;3;15;2;275195;182969;3033;838;4511
FR;5;2022-09-07;79;53;1;1;3;275274;183022;3034;839;4514
FR;5;2022-09-08;9;4;0;4;0;275283;183026;3034;843;4514
FR;5;2022-09-09;40;11;9;2;10;275323;183037;3043;845;4524
FR;5;2022-09-10;40;45;1;1;8;275363;183082;3044;846;4532
FR;5;2022-09-11;3;3;0;0;1;275366;183085;3044;846;4533
FR;5;2022-09-12;7;5;2;2;2;275373;183090;3046;848;4535
FR;5;2022-09-13;9;6;0;1;3;275382;183096;3046;849;4538
FR;5;2022-09-14;52;46;4;7;9;275434;183142;3050;856;4547
FR;5;2022-09-15;11;13;2;3;5;275445;183155;3052;859;4552
FR;5;2022-09-16;25;33;1;4;3;275470;183188;3053;863;4555
FR;5;2022-09-17;60;43;1;1;5;275530;183231;3054;864;4560
FR;5;2022-09-18;9;5;0;1;1;275539;183236;3054;865;4561
FR;5;2022-09-19;22;17;2;1;5;275561;183253;3056;866;4566
FR;5;2022-09-20;15;11;3;3;1;275576;183264;3059;869;4567
FR;5;2022-09-21;68;45;9;0;13;275644;183309;3068;869;4580
FR;5;2022-09-22;12;6;4;24;4;275656;183315;3072;893;4584
FR;5;2022-09-23;19;24;2;3;8;275675;183339;3074;896;4592
FR;5;2022-09-24;44;51;1;8;5;275719;183390;3075;904;4597
FR;5;2022-09-25;6;12;0;0;1;275725;183402;3075;904;4598
FR;5;2022-09-26;14;6;0;2;0;275739;183408;3075;906;4598
FR;5;2022-09-27;7;12;4;9;4;275746;183420;3079;915;4602
FR;5;2022-09-28;65;64;5;0;7;275811;183484;3084;915;4609
FR;5;2022-09-29;17;9;1;0;1;275828;183493;3085;915;4610
FR;5;2022-09-30;28;44;2;2;4;275856;183537;3087;917;4614
FR;5;2022-10-01;38;35;5;5;8;275894;183572;3092;922;4622
FR;5;2022-10-02;1;9;1;0;1;275895;183581;3093;922;4623
FR;5;2022-10-03;5;6;3;0;4;275900;183587;3096;922;4627
FR;5;2022-10-04;10;8;0;3;1;275910;183595;3096;925;4628
FR;5;2022-10-05;56;61;1;2;12;275966;183656;3097;927;4640
FR;5;2022-10-06;10;10;0;3;1;275976;183666;3097;930;4641
FR;5;2022-10-07;21;31;1;0;5;275997;183697;3098;930;4646
FR;5;2022-10-08;33;51;1;0;7;276030;183748;3099;930;4653
FR;5;2022-10-09;7;10;0;0;1;276037;183758;3099;930;4654
FR;5;2022-10-10;13;3;0;1;0;276050;183761;3099;931;4654
FR;5;2022-10-11;6;12;2;0;2;276056;183773;3101;931;4656
FR;5;2022-10-12;37;56;3;2;8;276093;183829;3104;933;4664
FR;5;2022-10-13;11;16;2;0;4;276104;183845;3106;933;4668
FR;5;2022-10-14;21;20;1;0;4;276125;183865;3107;933;4672
FR;5;2022-10-15;19;26;9;0;10;276144;183891;3116;933;4682
FR;5;2022-10-16;3;0;0;0;0;276147;183891;3116;933;4682
FR;5;2022-10-17;6;8;2;1;3;276153;183899;3118;934;4685
FR;6;2020-12-27;0;0;0;0;0;0;0;0;0;0
FR;6;2020-12-28;0;0;0;0;0;0;0;0;0;0
FR;6;2020-12-29;0;0;0;0;0;0;0;0;0;0
FR;6;2020-12-30;0;0;0;0;0;0;0;0;0;0
FR;6;2020-12-31;0;0;0;0;0;0;0;0;0;0
FR;6;2021-01-01;0;0;0;0;0;0;0;0;0;0
FR;6;2021-01-02;0;0;0;0;0;0;0;0;0;0
FR;6;2021-01-03;0;0;0;0;0;0;0;0;0;0
FR;6;2021-01-04;0;0;0;0;0;0;0;0;0;0
FR;6;2021-01-05;0;0;0;0;0;0;0;0;0;0
FR;6;2021-01-06;0;0;0;0;0;0;0;0;0;0
FR;6;2021-01-07;0;0;0;0;0;0;0;0;0;0
FR;6;2021-01-08;0;0;0;0;0;0;0;0;0;0
FR;6;2021-01-09;0;0;0;0;0;0;0;0;0;0
FR;6;2021-01-10;0;0;0;0;0;0;0;0;0;0
FR;6;2021-01-11;0;0;0;0;0;0;0;0;0;0
FR;6;2021-01-12;0;0;0;0;0;0;0;0;0;0
FR;6;2021-01-13;0;0;0;0;0;0;0;0;0;0
FR;6;2021-01-14;0;0;0;0;0;0;0;0;0;0
FR;6;2021-01-15;0;0;0;0;0;0;0;0;0;0
FR;6;2021-01-16;0;0;0;0;0;0;0;0;0;0
FR;6;2021-01-17;0;0;0;0;0;0;0;0;0;0
FR;6;2021-01-18;0;0;0;0;0;0;0;0;0;0
FR;6;2021-01-19;0;0;0;0;0;0;0;0;0;0
FR;6;2021-01-20;0;0;0;0;0;0;0;0;0;0
FR;6;2021-01-21;0;0;0;0;0;0;0;0;0;0
FR;6;2021-01-22;0;0;0;0;0;0;0;0;0;0
FR;6;2021-01-23;0;0;0;0;0;0;0;0;0;0
FR;6;2021-01-24;0;0;0;0;0;0;0;0;0;0
FR;6;2021-01-25;0;0;0;0;0;0;0;0;0;0
FR;6;2021-01-26;0;0;0;0;0;0;0;0;0;0
FR;6;2021-01-27;0;0;0;0;0;0;0;0;0;0
FR;6;2021-01-28;0;0;0;0;0;0;0;0;0;0
FR;6;2021-01-29;0;0;0;0;0;0;0;0;0;0
FR;6;2021-01-30;0;0;0;0;0;0;0;0;0;0
FR;6;2021-01-31;0;0;0;0;0;0;0;0;0;0
FR;6;2021-02-01;0;0;0;0;0;0;0;0;0;0
FR;6;2021-02-02;0;0;0;0;0;0;0;0;0;0
FR;6;2021-02-03;0;0;0;0;0;0;0;0;0;0
FR;6;2021-02-04;0;0;0;0;0;0;0;0;0;0
FR;6;2021-02-05;0;0;0;0;0;0;0;0;0;0
FR;6;2021-02-06;0;0;0;0;0;0;0;0;0;0
FR;6;2021-02-07;0;0;0;0;0;0;0;0;0;0
FR;6;2021-02-08;0;0;0;0;0;0;0;0;0;0
FR;6;2021-02-09;0;0;0;0;0;0;0;0;0;0
FR;6;2021-02-10;0;0;0;0;0;0;0;0;0;0
FR;6;2021-02-11;0;0;0;0;0;0;0;0;0;0
FR;6;2021-02-12;0;0;0;0;0;0;0;0;0;0
FR;6;2021-02-13;0;0;0;0;0;0;0;0;0;0
FR;6;2021-02-14;0;0;0;0;0;0;0;0;0;0
FR;6;2021-02-15;0;0;0;0;0;0;0;0;0;0
FR;6;2021-02-16;0;0;0;0;0;0;0;0;0;0
FR;6;2021-02-17;0;0;0;0;0;0;0;0;0;0
FR;6;2021-02-18;0;0;0;0;0;0;0;0;0;0
FR;6;2021-02-19;0;0;0;0;0;0;0;0;0;0
FR;6;2021-02-20;0;0;0;0;0;0;0;0;0;0
FR;6;2021-02-21;0;0;0;0;0;0;0;0;0;0
FR;6;2021-02-22;0;0;0;0;0;0;0;0;0;0
FR;6;2021-02-23;0;0;0;0;0;0;0;0;0;0
FR;6;2021-02-24;0;0;0;0;0;0;0;0;0;0
FR;6;2021-02-25;0;0;0;0;0;0;0;0;0;0
FR;6;2021-02-26;0;0;0;0;0;0;0;0;0;0
FR;6;2021-02-27;0;0;0;0;0;0;0;0;0;0
FR;6;2021-02-28;0;0;0;0;0;0;0;0;0;0
FR;6;2021-03-01;0;0;0;0;0;0;0;0;0;0
FR;6;2021-03-02;0;0;0;0;0;0;0;0;0;0
FR;6;2021-03-03;0;0;0;0;0;0;0;0;0;0
FR;6;2021-03-04;0;0;0;0;0;0;0;0;0;0
FR;6;2021-03-05;0;0;0;0;0;0;0;0;0;0
FR;6;2021-03-06;0;0;0;0;0;0;0;0;0;0
FR;6;2021-03-07;0;0;0;0;0;0;0;0;0;0
FR;6;2021-03-08;0;0;0;0;0;0;0;0;0;0
FR;6;2021-03-09;0;0;0;0;0;0;0;0;0;0
FR;6;2021-03-10;0;0;0;0;0;0;0;0;0;0
FR;6;2021-03-11;0;0;0;0;0;0;0;0;0;0
FR;6;2021-03-12;0;0;0;0;0;0;0;0;0;0
FR;6;2021-03-13;0;0;0;0;0;0;0;0;0;0
FR;6;2021-03-14;0;0;0;0;0;0;0;0;0;0
FR;6;2021-03-15;0;0;0;0;0;0;0;0;0;0
FR;6;2021-03-16;0;0;0;0;0;0;0;0;0;0
FR;6;2021-03-17;0;0;0;0;0;0;0;0;0;0
FR;6;2021-03-18;0;0;0;0;0;0;0;0;0;0
FR;6;2021-03-19;0;0;0;0;0;0;0;0;0;0
FR;6;2021-03-20;0;0;0;0;0;0;0;0;0;0
FR;6;2021-03-21;0;0;0;0;0;0;0;0;0;0
FR;6;2021-03-22;0;0;0;0;0;0;0;0;0;0
FR;6;2021-03-23;0;0;0;0;0;0;0;0;0;0
FR;6;2021-03-24;0;0;0;0;0;0;0;0;0;0
FR;6;2021-03-25;0;0;0;0;0;0;0;0;0;0
FR;6;2021-03-26;0;0;0;0;0;0;0;0;0;0
FR;6;2021-03-27;0;0;0;0;0;0;0;0;0;0
FR;6;2021-03-28;0;0;0;0;0;0;0;0;0;0
FR;6;2021-03-29;0;0;0;0;0;0;0;0;0;0
FR;6;2021-03-30;0;0;0;0;0;0;0;0;0;0
FR;6;2021-03-31;0;0;0;0;0;0;0;0;0;0
FR;6;2021-04-01;0;0;0;0;0;0;0;0;0;0
FR;6;2021-04-02;0;0;0;0;0;0;0;0;0;0
FR;6;2021-04-03;0;0;0;0;0;0;0;0;0;0
FR;6;2021-04-04;0;0;0;0;0;0;0;0;0;0
FR;6;2021-04-05;0;0;0;0;0;0;0;0;0;0
FR;6;2021-04-06;0;0;0;0;0;0;0;0;0;0
FR;6;2021-04-07;0;0;0;0;0;0;0;0;0;0
FR;6;2021-04-08;0;0;0;0;0;0;0;0;0;0
FR;6;2021-04-09;0;0;0;0;0;0;0;0;0;0
FR;6;2021-04-10;0;0;0;0;0;0;0;0;0;0
FR;6;2021-04-11;0;0;0;0;0;0;0;0;0;0
FR;6;2021-04-12;0;0;0;0;0;0;0;0;0;0
FR;6;2021-04-13;0;0;0;0;0;0;0;0;0;0
FR;6;2021-04-14;0;0;0;0;0;0;0;0;0;0
FR;6;2021-04-15;0;0;0;0;0;0;0;0;0;0
FR;6;2021-04-16;0;0;0;0;0;0;0;0;0;0
FR;6;2021-04-17;0;0;0;0;0;0;0;0;0;0
FR;6;2021-04-18;0;0;0;0;0;0;0;0;0;0
FR;6;2021-04-19;0;0;0;0;0;0;0;0;0;0
FR;6;2021-04-20;0;0;0;0;0;0;0;0;0;0
FR;6;2021-04-21;0;0;0;0;0;0;0;0;0;0
FR;6;2021-04-22;0;0;0;0;0;0;0;0;0;0
FR;6;2021-04-23;0;0;0;0;0;0;0;0;0;0
FR;6;2021-04-24;0;0;0;0;0;0;0;0;0;0
FR;6;2021-04-25;0;0;0;0;0;0;0;0;0;0
FR;6;2021-04-26;0;0;0;0;0;0;0;0;0;0
FR;6;2021-04-27;0;0;0;0;0;0;0;0;0;0
FR;6;2021-04-28;0;0;0;0;0;0;0;0;0;0
FR;6;2021-04-29;0;0;0;0;0;0;0;0;0;0
FR;6;2021-04-30;0;0;0;0;0;0;0;0;0;0
FR;6;2021-05-01;0;0;0;0;0;0;0;0;0;0
FR;6;2021-05-02;0;0;0;0;0;0;0;0;0;0
FR;6;2021-05-03;0;0;0;0;0;0;0;0;0;0
FR;6;2021-05-04;0;0;0;0;0;0;0;0;0;0
FR;6;2021-05-05;0;0;0;0;0;0;0;0;0;0
FR;6;2021-05-06;0;0;0;0;0;0;0;0;0;0
FR;6;2021-05-07;0;0;0;0;0;0;0;0;0;0
FR;6;2021-05-08;0;0;0;0;0;0;0;0;0;0
FR;6;2021-05-09;0;0;0;0;0;0;0;0;0;0
FR;6;2021-05-10;0;0;0;0;0;0;0;0;0;0
FR;6;2021-05-11;0;0;0;0;0;0;0;0;0;0
FR;6;2021-05-12;0;0;0;0;0;0;0;0;0;0
FR;6;2021-05-13;0;0;0;0;0;0;0;0;0;0
FR;6;2021-05-14;0;0;0;0;0;0;0;0;0;0
FR;6;2021-05-15;0;0;0;0;0;0;0;0;0;0
FR;6;2021-05-16;0;0;0;0;0;0;0;0;0;0
FR;6;2021-05-17;0;0;0;0;0;0;0;0;0;0
FR;6;2021-05-18;0;0;0;0;0;0;0;0;0;0
FR;6;2021-05-19;0;0;0;0;0;0;0;0;0;0
FR;6;2021-05-20;0;0;0;0;0;0;0;0;0;0
FR;6;2021-05-21;0;0;0;0;0;0;0;0;0;0
FR;6;2021-05-22;0;0;0;0;0;0;0;0;0;0
FR;6;2021-05-23;0;0;0;0;0;0;0;0;0;0
FR;6;2021-05-24;0;0;0;0;0;0;0;0;0;0
FR;6;2021-05-25;0;0;0;0;0;0;0;0;0;0
FR;6;2021-05-26;0;0;0;0;0;0;0;0;0;0
FR;6;2021-05-27;0;0;0;0;0;0;0;0;0;0
FR;6;2021-05-28;0;0;0;0;0;0;0;0;0;0
FR;6;2021-05-29;0;0;0;0;0;0;0;0;0;0
FR;6;2021-05-30;0;0;0;0;0;0;0;0;0;0
FR;6;2021-05-31;0;0;0;0;0;0;0;0;0;0
FR;6;2021-06-01;0;0;0;0;0;0;0;0;0;0
FR;6;2021-06-02;0;0;0;0;0;0;0;0;0;0
FR;6;2021-06-03;0;0;0;0;0;0;0;0;0;0
FR;6;2021-06-04;0;0;0;0;0;0;0;0;0;0
FR;6;2021-06-05;0;0;0;0;0;0;0;0;0;0
FR;6;2021-06-06;0;0;0;0;0;0;0;0;0;0
FR;6;2021-06-07;0;0;0;0;0;0;0;0;0;0
FR;6;2021-06-08;0;0;0;0;0;0;0;0;0;0
FR;6;2021-06-09;0;0;0;0;0;0;0;0;0;0
FR;6;2021-06-10;0;0;0;0;0;0;0;0;0;0
FR;6;2021-06-11;0;0;0;0;0;0;0;0;0;0
FR;6;2021-06-12;0;0;0;0;0;0;0;0;0;0
FR;6;2021-06-13;0;0;0;0;0;0;0;0;0;0
FR;6;2021-06-14;0;0;0;0;0;0;0;0;0;0
FR;6;2021-06-15;0;0;0;0;0;0;0;0;0;0
FR;6;2021-06-16;0;0;0;0;0;0;0;0;0;0
FR;6;2021-06-17;0;0;0;0;0;0;0;0;0;0
FR;6;2021-06-18;0;0;0;0;0;0;0;0;0;0
FR;6;2021-06-19;0;0;0;0;0;0;0;0;0;0
FR;6;2021-06-20;0;0;0;0;0;0;0;0;0;0
FR;6;2021-06-21;0;0;0;0;0;0;0;0;0;0
FR;6;2021-06-22;0;0;0;0;0;0;0;0;0;0
FR;6;2021-06-23;0;0;0;0;0;0;0;0;0;0
FR;6;2021-06-24;0;0;0;0;0;0;0;0;0;0
FR;6;2021-06-25;0;0;0;0;0;0;0;0;0;0
FR;6;2021-06-26;0;0;0;0;0;0;0;0;0;0
FR;6;2021-06-27;0;0;0;0;0;0;0;0;0;0
FR;6;2021-06-28;0;0;0;0;0;0;0;0;0;0
FR;6;2021-06-29;0;0;0;0;0;0;0;0;0;0
FR;6;2021-06-30;0;0;0;0;0;0;0;0;0;0
FR;6;2021-07-01;0;0;0;0;0;0;0;0;0;0
FR;6;2021-07-02;0;0;0;0;0;0;0;0;0;0
FR;6;2021-07-03;0;0;0;0;0;0;0;0;0;0
FR;6;2021-07-04;0;0;0;0;0;0;0;0;0;0
FR;6;2021-07-05;0;0;0;0;0;0;0;0;0;0
FR;6;2021-07-06;0;0;0;0;0;0;0;0;0;0
FR;6;2021-07-07;0;0;0;0;0;0;0;0;0;0
FR;6;2021-07-08;0;0;0;0;0;0;0;0;0;0
FR;6;2021-07-09;0;0;0;0;0;0;0;0;0;0
FR;6;2021-07-10;0;0;0;0;0;0;0;0;0;0
FR;6;2021-07-11;0;0;0;0;0;0;0;0;0;0
FR;6;2021-07-12;0;0;0;0;0;0;0;0;0;0
FR;6;2021-07-13;0;0;0;0;0;0;0;0;0;0
FR;6;2021-07-14;0;0;0;0;0;0;0;0;0;0
FR;6;2021-07-15;0;0;0;0;0;0;0;0;0;0
FR;6;2021-07-16;0;0;0;0;0;0;0;0;0;0
FR;6;2021-07-17;0;0;0;0;0;0;0;0;0;0
FR;6;2021-07-18;0;0;0;0;0;0;0;0;0;0
FR;6;2021-07-19;0;0;0;0;0;0;0;0;0;0
FR;6;2021-07-20;0;0;0;0;0;0;0;0;0;0
FR;6;2021-07-21;0;0;0;0;0;0;0;0;0;0
FR;6;2021-07-22;0;0;0;0;0;0;0;0;0;0
FR;6;2021-07-23;0;0;0;0;0;0;0;0;0;0
FR;6;2021-07-24;0;0;0;0;0;0;0;0;0;0
FR;6;2021-07-25;0;0;0;0;0;0;0;0;0;0
FR;6;2021-07-26;0;0;0;0;0;0;0;0;0;0
FR;6;2021-07-27;0;0;0;0;0;0;0;0;0;0
FR;6;2021-07-28;0;0;0;0;0;0;0;0;0;0
FR;6;2021-07-29;0;0;0;0;0;0;0;0;0;0
FR;6;2021-07-30;0;0;0;0;0;0;0;0;0;0
FR;6;2021-07-31;0;0;0;0;0;0;0;0;0;0
FR;6;2021-08-01;0;0;0;0;0;0;0;0;0;0
FR;6;2021-08-02;0;0;0;0;0;0;0;0;0;0
FR;6;2021-08-03;0;0;0;0;0;0;0;0;0;0
FR;6;2021-08-04;0;0;0;0;0;0;0;0;0;0
FR;6;2021-08-05;0;0;0;0;0;0;0;0;0;0
FR;6;2021-08-06;0;0;0;0;0;0;0;0;0;0
FR;6;2021-08-07;0;0;0;0;0;0;0;0;0;0
FR;6;2021-08-08;0;0;0;0;0;0;0;0;0;0
FR;6;2021-08-09;0;0;0;0;0;0;0;0;0;0
FR;6;2021-08-10;0;0;0;0;0;0;0;0;0;0
FR;6;2021-08-11;0;0;0;0;0;0;0;0;0;0
FR;6;2021-08-12;0;0;0;0;0;0;0;0;0;0
FR;6;2021-08-13;0;0;0;0;0;0;0;0;0;0
FR;6;2021-08-14;0;0;0;0;0;0;0;0;0;0
FR;6;2021-08-15;0;0;0;0;0;0;0;0;0;0
FR;6;2021-08-16;0;0;0;0;0;0;0;0;0;0
FR;6;2021-08-17;0;0;0;0;0;0;0;0;0;0
FR;6;2021-08-18;0;0;0;0;0;0;0;0;0;0
FR;6;2021-08-19;0;0;0;0;0;0;0;0;0;0
FR;6;2021-08-20;0;0;0;0;0;0;0;0;0;0
FR;6;2021-08-21;0;0;0;0;0;0;0;0;0;0
FR;6;2021-08-22;0;0;0;0;0;0;0;0;0;0
FR;6;2021-08-23;0;0;0;0;0;0;0;0;0;0
FR;6;2021-08-24;0;0;0;0;0;0;0;0;0;0
FR;6;2021-08-25;0;0;0;0;0;0;0;0;0;0
FR;6;2021-08-26;0;0;0;0;0;0;0;0;0;0
FR;6;2021-08-27;0;0;0;0;0;0;0;0;0;0
FR;6;2021-08-28;0;0;0;0;0;0;0;0;0;0
FR;6;2021-08-29;0;0;0;0;0;0;0;0;0;0
FR;6;2021-08-30;0;0;0;0;0;0;0;0;0;0
FR;6;2021-08-31;0;0;0;0;0;0;0;0;0;0
FR;6;2021-09-01;0;0;0;0;0;0;0;0;0;0
FR;6;2021-09-02;0;0;0;0;0;0;0;0;0;0
FR;6;2021-09-03;0;0;0;0;0;0;0;0;0;0
FR;6;2021-09-04;0;0;0;0;0;0;0;0;0;0
FR;6;2021-09-05;0;0;0;0;0;0;0;0;0;0
FR;6;2021-09-06;0;0;0;0;0;0;0;0;0;0
FR;6;2021-09-07;0;0;0;0;0;0;0;0;0;0
FR;6;2021-09-08;0;0;0;0;0;0;0;0;0;0
FR;6;2021-09-09;0;0;0;0;0;0;0;0;0;0
FR;6;2021-09-10;0;0;0;0;0;0;0;0;0;0
FR;6;2021-09-11;0;0;0;0;0;0;0;0;0;0
FR;6;2021-09-12;0;0;0;0;0;0;0;0;0;0
FR;6;2021-09-13;0;0;0;0;0;0;0;0;0;0
FR;6;2021-09-14;0;0;0;0;0;0;0;0;0;0
FR;6;2021-09-15;0;0;0;0;0;0;0;0;0;0
FR;6;2021-09-16;0;0;0;0;0;0;0;0;0;0
FR;6;2021-09-17;0;0;0;0;0;0;0;0;0;0
FR;6;2021-09-18;0;0;0;0;0;0;0;0;0;0
FR;6;2021-09-19;0;0;0;0;0;0;0;0;0;0
FR;6;2021-09-20;0;0;0;0;0;0;0;0;0;0
FR;6;2021-09-21;0;0;0;0;0;0;0;0;0;0
FR;6;2021-09-22;0;0;0;0;0;0;0;0;0;0
FR;6;2021-09-23;0;0;0;0;0;0;0;0;0;0
FR;6;2021-09-24;0;0;0;0;0;0;0;0;0;0
FR;6;2021-09-25;0;0;0;0;0;0;0;0;0;0
FR;6;2021-09-26;0;0;0;0;0;0;0;0;0;0
FR;6;2021-09-27;0;0;0;0;0;0;0;0;0;0
FR;6;2021-09-28;0;0;0;0;0;0;0;0;0;0
FR;6;2021-09-29;0;0;0;0;0;0;0;0;0;0
FR;6;2021-09-30;0;0;0;0;0;0;0;0;0;0
FR;6;2021-10-01;0;0;0;0;0;0;0;0;0;0
FR;6;2021-10-02;0;0;0;0;0;0;0;0;0;0
FR;6;2021-10-03;0;0;0;0;0;0;0;0;0;0
FR;6;2021-10-04;0;0;0;0;0;0;0;0;0;0
FR;6;2021-10-05;0;0;0;0;0;0;0;0;0;0
FR;6;2021-10-06;0;0;0;0;0;0;0;0;0;0
FR;6;2021-10-07;0;0;0;0;0;0;0;0;0;0
FR;6;2021-10-08;0;0;0;0;0;0;0;0;0;0
FR;6;2021-10-09;0;0;0;0;0;0;0;0;0;0
FR;6;2021-10-10;0;0;0;0;0;0;0;0;0;0
FR;6;2021-10-11;0;0;0;0;0;0;0;0;0;0
FR;6;2021-10-12;0;0;0;0;0;0;0;0;0;0
FR;6;2021-10-13;0;0;0;0;0;0;0;0;0;0
FR;6;2021-10-14;0;0;0;0;0;0;0;0;0;0
FR;6;2021-10-15;0;0;0;0;0;0;0;0;0;0
FR;6;2021-10-16;0;0;0;0;0;0;0;0;0;0
FR;6;2021-10-17;0;0;0;0;0;0;0;0;0;0
FR;6;2021-10-18;0;0;0;0;0;0;0;0;0;0
FR;6;2021-10-19;0;0;0;0;0;0;0;0;0;0
FR;6;2021-10-20;0;0;0;0;0;0;0;0;0;0
FR;6;2021-10-21;0;0;0;0;0;0;0;0;0;0
FR;6;2021-10-22;0;0;0;0;0;0;0;0;0;0
FR;6;2021-10-23;0;0;0;0;0;0;0;0;0;0
FR;6;2021-10-24;0;0;0;0;0;0;0;0;0;0
FR;6;2021-10-25;0;0;0;0;0;0;0;0;0;0
FR;6;2021-10-26;0;0;0;0;0;0;0;0;0;0
FR;6;2021-10-27;0;0;0;0;0;0;0;0;0;0
FR;6;2021-10-28;0;0;0;0;0;0;0;0;0;0
FR;6;2021-10-29;0;0;0;0;0;0;0;0;0;0
FR;6;2021-10-30;0;0;0;0;0;0;0;0;0;0
FR;6;2021-10-31;0;0;0;0;0;0;0;0;0;0
FR;6;2021-11-01;0;0;0;0;0;0;0;0;0;0
FR;6;2021-11-02;0;0;0;0;0;0;0;0;0;0
FR;6;2021-11-03;0;0;0;0;0;0;0;0;0;0
FR;6;2021-11-04;0;0;0;0;0;0;0;0;0;0
FR;6;2021-11-05;0;0;0;0;0;0;0;0;0;0
FR;6;2021-11-06;0;0;0;0;0;0;0;0;0;0
FR;6;2021-11-07;0;0;0;0;0;0;0;0;0;0
FR;6;2021-11-08;0;0;0;0;0;0;0;0;0;0
FR;6;2021-11-09;0;0;0;0;0;0;0;0;0;0
FR;6;2021-11-10;0;0;0;0;0;0;0;0;0;0
FR;6;2021-11-11;0;0;0;0;0;0;0;0;0;0
FR;6;2021-11-12;0;0;0;0;0;0;0;0;0;0
FR;6;2021-11-13;0;0;0;0;0;0;0;0;0;0
FR;6;2021-11-14;0;0;0;0;0;0;0;0;0;0
FR;6;2021-11-15;0;0;0;0;0;0;0;0;0;0
FR;6;2021-11-16;0;0;0;0;0;0;0;0;0;0
FR;6;2021-11-17;0;0;0;0;0;0;0;0;0;0
FR;6;2021-11-18;0;0;0;0;0;0;0;0;0;0
FR;6;2021-11-19;0;0;0;0;0;0;0;0;0;0
FR;6;2021-11-20;0;0;0;0;0;0;0;0;0;0
FR;6;2021-11-21;0;0;0;0;0;0;0;0;0;0
FR;6;2021-11-22;0;0;0;0;0;0;0;0;0;0
FR;6;2021-11-23;0;0;0;0;0;0;0;0;0;0
FR;6;2021-11-24;0;0;0;0;0;0;0;0;0;0
FR;6;2021-11-25;0;0;0;0;0;0;0;0;0;0
FR;6;2021-11-26;0;0;0;0;0;0;0;0;0;0
FR;6;2021-11-27;0;0;0;0;0;0;0;0;0;0
FR;6;2021-11-28;0;0;0;0;0;0;0;0;0;0
FR;6;2021-11-29;0;0;0;0;0;0;0;0;0;0
FR;6;2021-11-30;0;0;0;0;0;0;0;0;0;0
FR;6;2021-12-01;0;0;0;0;0;0;0;0;0;0
FR;6;2021-12-02;0;0;0;0;0;0;0;0;0;0
FR;6;2021-12-03;0;0;0;0;0;0;0;0;0;0
FR;6;2021-12-04;0;0;0;0;0;0;0;0;0;0
FR;6;2021-12-05;0;0;0;0;0;0;0;0;0;0
FR;6;2021-12-06;0;0;0;0;0;0;0;0;0;0
FR;6;2021-12-07;0;0;0;0;0;0;0;0;0;0
FR;6;2021-12-08;0;0;0;0;0;0;0;0;0;0
FR;6;2021-12-09;0;0;0;0;0;0;0;0;0;0
FR;6;2021-12-10;0;0;0;0;0;0;0;0;0;0
FR;6;2021-12-11;0;0;0;0;0;0;0;0;0;0
FR;6;2021-12-12;0;0;0;0;0;0;0;0;0;0
FR;6;2021-12-13;0;0;0;0;0;0;0;0;0;0
FR;6;2021-12-14;0;0;0;0;0;0;0;0;0;0
FR;6;2021-12-15;0;0;0;0;0;0;0;0;0;0
FR;6;2021-12-16;0;0;0;0;0;0;0;0;0;0
FR;6;2021-12-17;0;0;0;0;0;0;0;0;0;0
FR;6;2021-12-18;0;0;0;0;0;0;0;0;0;0
FR;6;2021-12-19;0;0;0;0;0;0;0;0;0;0
FR;6;2021-12-20;0;0;0;0;0;0;0;0;0;0
FR;6;2021-12-21;0;0;0;0;0;0;0;0;0;0
FR;6;2021-12-22;0;0;0;0;0;0;0;0;0;0
FR;6;2021-12-23;0;0;0;0;0;0;0;0;0;0
FR;6;2021-12-24;0;0;0;0;0;0;0;0;0;0
FR;6;2021-12-25;0;0;0;0;0;0;0;0;0;0
FR;6;2021-12-26;0;0;0;0;0;0;0;0;0;0
FR;6;2021-12-27;0;0;0;0;0;0;0;0;0;0
FR;6;2021-12-28;0;0;0;0;0;0;0;0;0;0
FR;6;2021-12-29;0;0;0;0;0;0;0;0;0;0
FR;6;2021-12-30;0;0;0;0;0;0;0;0;0;0
FR;6;2021-12-31;0;0;0;0;0;0;0;0;0;0
FR;6;2022-01-01;0;0;0;0;0;0;0;0;0;0
FR;6;2022-01-02;0;0;0;0;0;0;0;0;0;0
FR;6;2022-01-03;0;0;0;0;0;0;0;0;0;0
FR;6;2022-01-04;0;0;0;0;0;0;0;0;0;0
FR;6;2022-01-05;0;0;0;0;0;0;0;0;0;0
FR;6;2022-01-06;0;0;0;0;0;0;0;0;0;0
FR;6;2022-01-07;0;0;0;0;0;0;0;0;0;0
FR;6;2022-01-08;0;0;0;0;0;0;0;0;0;0
FR;6;2022-01-09;0;0;0;0;0;0;0;0;0;0
FR;6;2022-01-10;0;0;0;0;0;0;0;0;0;0
FR;6;2022-01-11;0;0;0;0;0;0;0;0;0;0
FR;6;2022-01-12;0;0;0;0;0;0;0;0;0;0
FR;6;2022-01-13;0;0;0;0;0;0;0;0;0;0
FR;6;2022-01-14;0;0;0;0;0;0;0;0;0;0
FR;6;2022-01-15;0;0;0;0;0;0;0;0;0;0
FR;6;2022-01-16;0;0;0;0;0;0;0;0;0;0
FR;6;2022-01-17;0;0;0;0;0;0;0;0;0;0
FR;6;2022-01-18;0;0;0;0;0;0;0;0;0;0
FR;6;2022-01-19;0;0;0;0;0;0;0;0;0;0
FR;6;2022-01-20;0;0;0;0;0;0;0;0;0;0
FR;6;2022-01-21;0;0;0;0;0;0;0;0;0;0
FR;6;2022-01-22;0;0;0;0;0;0;0;0;0;0
FR;6;2022-01-23;0;0;0;0;0;0;0;0;0;0
FR;6;2022-01-24;0;0;0;0;0;0;0;0;0;0
FR;6;2022-01-25;0;0;0;0;0;0;0;0;0;0
FR;6;2022-01-26;0;0;0;0;0;0;0;0;0;0
FR;6;2022-01-27;0;0;0;0;0;0;0;0;0;0
FR;6;2022-01-28;0;0;0;0;0;0;0;0;0;0
FR;6;2022-01-29;0;0;0;0;0;0;0;0;0;0
FR;6;2022-01-30;0;0;0;0;0;0;0;0;0;0
FR;6;2022-01-31;0;0;0;0;0;0;0;0;0;0
FR;6;2022-02-01;0;0;0;0;0;0;0;0;0;0
FR;6;2022-02-02;0;0;0;0;0;0;0;0;0;0
FR;6;2022-02-03;0;0;0;0;0;0;0;0;0;0
FR;6;2022-02-04;0;0;0;0;0;0;0;0;0;0
FR;6;2022-02-05;0;0;0;0;0;0;0;0;0;0
FR;6;2022-02-06;0;0;0;0;0;0;0;0;0;0
FR;6;2022-02-07;0;0;0;0;0;0;0;0;0;0
FR;6;2022-02-08;0;0;0;0;0;0;0;0;0;0
FR;6;2022-02-09;0;0;0;0;0;0;0;0;0;0
FR;6;2022-02-10;0;0;0;0;0;0;0;0;0;0
FR;6;2022-02-11;0;0;0;0;0;0;0;0;0;0
FR;6;2022-02-12;0;0;0;0;0;0;0;0;0;0
FR;6;2022-02-13;0;0;0;0;0;0;0;0;0;0
FR;6;2022-02-14;0;0;0;0;0;0;0;0;0;0
FR;6;2022-02-15;0;0;0;0;0;0;0;0;0;0
FR;6;2022-02-16;0;0;0;0;0;0;0;0;0;0
FR;6;2022-02-17;0;0;0;0;0;0;0;0;0;0
FR;6;2022-02-18;0;0;0;0;0;0;0;0;0;0
FR;6;2022-02-19;0;0;0;0;0;0;0;0;0;0
FR;6;2022-02-20;0;0;0;0;0;0;0;0;0;0
FR;6;2022-02-21;0;0;0;0;0;0;0;0;0;0
FR;6;2022-02-22;0;0;0;0;0;0;0;0;0;0
FR;6;2022-02-23;0;0;0;0;0;0;0;0;0;0
FR;6;2022-02-24;0;0;0;0;0;0;0;0;0;0
FR;6;2022-02-25;0;0;0;0;0;0;0;0;0;0
FR;6;2022-02-26;1;0;0;0;0;1;0;0;0;0
FR;6;2022-02-27;0;0;0;0;0;1;0;0;0;0
FR;6;2022-02-28;0;0;0;0;0;1;0;0;0;0
FR;6;2022-03-01;3;0;0;0;0;4;0;0;0;0
FR;6;2022-03-02;97;9;2;0;7;101;9;2;0;7
FR;6;2022-03-03;0;0;0;0;0;101;9;2;0;7
FR;6;2022-03-04;91;4;0;0;4;192;13;2;0;11
FR;6;2022-03-05;391;23;2;0;14;583;36;4;0;25
FR;6;2022-03-06;7;1;0;0;0;590;37;4;0;25
FR;6;2022-03-07;337;19;0;0;13;927;56;4;0;38
FR;6;2022-03-08;230;14;0;0;5;1157;70;4;0;43
FR;6;2022-03-09;519;29;2;0;21;1676;99;6;0;64
FR;6;2022-03-10;206;19;0;1;12;1882;118;6;1;76
FR;6;2022-03-11;331;22;6;0;21;2213;140;12;1;97
FR;6;2022-03-12;518;25;1;0;20;2731;165;13;1;117
FR;6;2022-03-13;40;2;0;0;1;2771;167;13;1;118
FR;6;2022-03-14;201;4;2;0;3;2972;171;15;1;121
FR;6;2022-03-15;112;11;2;0;9;3084;182;17;1;130
FR;6;2022-03-16;310;17;1;1;14;3394;199;18;2;144
FR;6;2022-03-17;117;6;1;2;4;3511;205;19;4;148
FR;6;2022-03-18;215;10;0;0;6;3726;215;19;4;154
FR;6;2022-03-19;307;19;2;0;9;4033;234;21;4;163
FR;6;2022-03-20;15;5;0;0;1;4048;239;21;4;164
FR;6;2022-03-21;132;23;1;0;4;4180;262;22;4;168
FR;6;2022-03-22;97;15;0;0;4;4277;277;22;4;172
FR;6;2022-03-23;226;108;3;0;14;4503;385;25;4;186
FR;6;2022-03-24;100;15;1;3;4;4603;400;26;7;190
FR;6;2022-03-25;203;141;2;1;15;4806;541;28;8;205
FR;6;2022-03-26;331;295;7;1;19;5137;836;35;9;224
FR;6;2022-03-27;32;30;1;0;1;5169;866;36;9;225
FR;6;2022-03-28;201;208;8;1;17;5370;1074;44;10;242
FR;6;2022-03-29;124;189;12;2;12;5494;1263;56;12;254
FR;6;2022-03-30;305;476;10;2;22;5799;1739;66;14;276
FR;6;2022-03-31;123;140;10;0;14;5922;1879;76;14;290
FR;6;2022-04-01;195;150;11;2;23;6117;2029;87;16;313
FR;6;2022-04-02;206;241;9;1;13;6323;2270;96;17;326
FR;6;2022-04-03;17;21;0;0;1;6340;2291;96;17;327
FR;6;2022-04-04;137;114;6;1;9;6477;2405;102;18;336
FR;6;2022-04-05;146;88;15;1;11;6623;2493;117;19;347
FR;6;2022-04-06;204;245;22;26;27;6827;2738;139;45;374
FR;6;2022-04-07;127;96;15;9;17;6954;2834;154;54;391
FR;6;2022-04-08;199;170;16;3;17;7153;3004;170;57;408
FR;6;2022-04-09;145;139;6;12;13;7298;3143;176;69;421
FR;6;2022-04-10;10;20;3;0;1;7308;3163;179;69;422
FR;6;2022-04-11;101;106;4;0;5;7409;3269;183;69;427
FR;6;2022-04-12;136;75;5;8;10;7545;3344;188;77;437
FR;6;2022-04-13;162;175;7;5;13;7707;3519;195;82;450
FR;6;2022-04-14;100;103;5;10;8;7807;3622;200;92;458
FR;6;2022-04-15;158;149;11;7;19;7965;3771;211;99;477
FR;6;2022-04-16;127;132;5;0;14;8092;3903;216;99;491
FR;6;2022-04-17;8;9;4;0;4;8100;3912;220;99;495
FR;6;2022-04-18;8;15;3;0;4;8108;3927;223;99;499
FR;6;2022-04-19;97;112;4;3;3;8205;4039;227;102;502
FR;6;2022-04-20;178;227;8;7;15;8383;4266;235;109;517
FR;6;2022-04-21;111;93;8;4;11;8494;4359;243;113;528
FR;6;2022-04-22;138;160;13;12;13;8632;4519;256;125;541
FR;6;2022-04-23;106;129;1;1;7;8738;4648;257;126;548
FR;6;2022-04-24;5;21;1;0;0;8743;4669;258;126;548
FR;6;2022-04-25;91;128;3;8;11;8834;4797;261;134;559
FR;6;2022-04-26;101;128;19;2;17;8935;4925;280;136;576
FR;6;2022-04-27;197;159;21;1;27;9132;5084;301;137;603
FR;6;2022-04-28;109;87;7;1;8;9241;5171;308;138;611
FR;6;2022-04-29;191;169;16;2;20;9432;5340;324;140;631
FR;6;2022-04-30;133;125;7;1;24;9565;5465;331;141;655
FR;6;2022-05-01;7;6;0;0;0;9572;5471;331;141;655
FR;6;2022-05-02;94;65;3;4;3;9666;5536;334;145;658
FR;6;2022-05-03;136;93;11;2;7;9802;5629;345;147;665
FR;6;2022-05-04;167;118;25;12;29;9969;5747;370;159;694
FR;6;2022-05-05;101;70;8;3;12;10070;5817;378;162;706
FR;6;2022-05-06;152;110;10;9;16;10222;5927;388;171;722
FR;6;2022-05-07;139;93;13;3;23;10361;6020;401;174;745
FR;6;2022-05-08;20;8;6;5;7;10381;6028;407;179;752
FR;6;2022-05-09;86;78;9;7;13;10467;6106;416;186;765
FR;6;2022-05-10;112;80;15;7;12;10579;6186;431;193;777
FR;6;2022-05-11;130;124;11;14;20;10709;6310;442;207;797
FR;6;2022-05-12;105;76;7;5;15;10814;6386;449;212;812
FR;6;2022-05-13;155;97;17;21;22;10969;6483;466;233;834
FR;6;2022-05-14;81;60;6;7;15;11050;6543;472;240;849
FR;6;2022-05-15;12;7;0;0;0;11062;6550;472;240;849
FR;6;2022-05-16;64;54;6;2;12;11126;6604;478;242;861
FR;6;2022-05-17;123;77;5;7;11;11249;6681;483;249;872
FR;6;2022-05-18;131;116;5;1;13;11380;6797;488;250;885
FR;6;2022-05-19;124;57;6;8;9;11504;6854;494;258;894
FR;6;2022-05-20;125;115;13;3;18;11629;6969;507;261;912
FR;6;2022-05-21;92;69;14;3;12;11721;7038;521;264;924
FR;6;2022-05-22;19;12;5;0;4;11740;7050;526;264;928
FR;6;2022-05-23;77;72;4;2;7;11817;7122;530;266;935
FR;6;2022-05-24;117;98;8;2;16;11934;7220;538;268;951
FR;6;2022-05-25;139;129;6;3;11;12073;7349;544;271;962
FR;6;2022-05-26;7;9;3;0;9;12080;7358;547;271;971
FR;6;2022-05-27;127;105;15;11;18;12207;7463;562;282;989
FR;6;2022-05-28;53;75;1;5;8;12260;7538;563;287;997
FR;6;2022-05-29;8;10;0;0;1;12268;7548;563;287;998
FR;6;2022-05-30;70;70;7;4;4;12338;7618;570;291;1002
FR;6;2022-05-31;87;102;10;2;14;12425;7720;580;293;1016
FR;6;2022-06-01;97;89;10;1;11;12522;7809;590;294;1027
FR;6;2022-06-02;91;60;6;3;9;12613;7869;596;297;1036
FR;6;2022-06-03;126;102;13;7;21;12739;7971;609;304;1057
FR;6;2022-06-04;63;51;10;0;12;12802;8022;619;304;1069
FR;6;2022-06-05;16;15;2;1;4;12818;8037;621;305;1073
FR;6;2022-06-06;9;6;0;0;0;12827;8043;621;305;1073
FR;6;2022-06-07;79;90;3;4;8;12906;8133;624;309;1081
FR;6;2022-06-08;92;110;13;5;20;12998;8243;637;314;1101
FR;6;2022-06-09;75;81;15;3;15;13073;8324;652;317;1116
FR;6;2022-06-10;116;93;26;10;22;13189;8417;678;327;1138
FR;6;2022-06-11;83;62;6;10;12;13272;8479;684;337;1150
FR;6;2022-06-12;6;14;1;0;2;13278;8493;685;337;1152
FR;6;2022-06-13;74;59;18;1;7;13352;8552;703;338;1159
FR;6;2022-06-14;98;100;8;5;16;13450;8652;711;343;1175
FR;6;2022-06-15;80;86;7;8;15;13530;8738;718;351;1190
FR;6;2022-06-16;53;40;11;7;14;13583;8778;729;358;1204
FR;6;2022-06-17;86;85;3;13;11;13669;8863;732;371;1215
FR;6;2022-06-18;71;61;13;0;21;13740;8924;745;371;1236
FR;6;2022-06-19;6;6;3;0;4;13746;8930;748;371;1240
FR;6;2022-06-20;42;41;4;1;6;13788;8971;752;372;1246
FR;6;2022-06-21;59;73;10;7;17;13847;9044;762;379;1263
FR;6;2022-06-22;86;85;8;2;17;13933;9129;770;381;1280
FR;6;2022-06-23;64;39;13;7;15;13997;9168;783;388;1295
FR;6;2022-06-24;77;85;7;14;20;14074;9253;790;402;1315
FR;6;2022-06-25;67;61;4;3;8;14141;9314;794;405;1323
FR;6;2022-06-26;6;7;1;0;1;14147;9321;795;405;1324
FR;6;2022-06-27;53;50;4;9;12;14200;9371;799;414;1336
FR;6;2022-06-28;68;47;6;3;15;14268;9418;805;417;1351
FR;6;2022-06-29;98;117;26;37;19;14366;9535;831;454;1370
FR;6;2022-06-30;84;60;33;10;12;14450;9595;864;464;1382
FR;6;2022-07-01;115;94;25;33;18;14565;9689;889;497;1400
FR;6;2022-07-02;58;67;26;2;37;14623;9756;915;499;1437
FR;6;2022-07-03;11;4;4;3;4;14634;9760;919;502;1441
FR;6;2022-07-04;61;43;3;23;13;14695;9803;922;525;1454
FR;6;2022-07-05;65;53;19;67;27;14760;9856;941;592;1481
FR;6;2022-07-06;94;64;7;11;12;14854;9920;948;603;1493
FR;6;2022-07-07;99;79;42;37;14;14953;9999;990;640;1507
FR;6;2022-07-08;139;87;42;27;10;15092;10086;1032;667;1517
FR;6;2022-07-09;53;51;16;29;27;15145;10137;1048;696;1544
FR;6;2022-07-10;3;7;8;0;9;15148;10144;1056;696;1553
FR;6;2022-07-11;54;44;5;4;12;15202;10188;1061;700;1565
FR;6;2022-07-12;70;72;12;23;12;15272;10260;1073;723;1577
FR;6;2022-07-13;84;65;14;21;25;15356;10325;1087;744;1602
FR;6;2022-07-14;4;3;1;0;1;15360;10328;1088;744;1603
FR;6;2022-07-15;74;59;9;57;16;15434;10387;1097;801;1619
FR;6;2022-07-16;27;31;17;0;17;15461;10418;1114;801;1636
FR;6;2022-07-17;3;7;0;0;0;15464;10425;1114;801;1636
FR;6;2022-07-18;37;62;11;14;15;15501;10487;1125;815;1651
FR;6;2022-07-19;54;48;4;19;6;15555;10535;1129;834;1657
FR;6;2022-07-20;53;70;7;22;11;15608;10605;1136;856;1668
FR;6;2022-07-21;50;60;4;7;11;15658;10665;1140;863;1679
FR;6;2022-07-22;55;74;7;26;8;15713;10739;1147;889;1687
FR;6;2022-07-23;38;40;6;10;6;15751;10779;1153;899;1693
FR;6;2022-07-24;11;14;1;3;3;15762;10793;1154;902;1696
FR;6;2022-07-25;60;44;8;12;9;15822;10837;1162;914;1705
FR;6;2022-07-26;47;64;14;6;10;15869;10901;1176;920;1715
FR;6;2022-07-27;54;78;15;11;17;15923;10979;1191;931;1732
FR;6;2022-07-28;30;48;4;6;8;15953;11027;1195;937;1740
FR;6;2022-07-29;43;71;10;38;24;15996;11098;1205;975;1764
FR;6;2022-07-30;26;48;4;15;7;16022;11146;1209;990;1771
FR;6;2022-07-31;0;1;1;0;0;16022;11147;1210;990;1771
FR;6;2022-08-01;39;36;14;8;10;16061;11183;1224;998;1781
FR;6;2022-08-02;37;46;10;14;6;16098;11229;1234;1012;1787
FR;6;2022-08-03;29;52;7;16;11;16127;11281;1241;1028;1798
FR;6;2022-08-04;25;21;4;9;6;16152;11302;1245;1037;1804
FR;6;2022-08-05;43;45;1;7;5;16195;11347;1246;1044;1809
FR;6;2022-08-06;17;27;1;3;2;16212;11374;1247;1047;1811
FR;6;2022-08-07;1;2;0;0;0;16213;11376;1247;1047;1811
FR;6;2022-08-08;24;33;1;0;1;16237;11409;1248;1047;1812
FR;6;2022-08-09;22;30;6;3;3;16259;11439;1254;1050;1815
FR;6;2022-08-10;31;36;5;9;5;16290;11475;1259;1059;1820
FR;6;2022-08-11;33;33;1;1;1;16323;11508;1260;1060;1821
FR;6;2022-08-12;50;44;6;2;15;16373;11552;1266;1062;1836
FR;6;2022-08-13;9;20;0;0;1;16382;11572;1266;1062;1837
FR;6;2022-08-14;3;1;0;0;0;16385;11573;1266;1062;1837
FR;6;2022-08-15;2;3;1;0;0;16387;11576;1267;1062;1837
FR;6;2022-08-16;35;66;21;7;7;16422;11642;1288;1069;1844
FR;6;2022-08-17;32;44;10;9;10;16454;11686;1298;1078;1854
FR;6;2022-08-18;29;55;14;4;4;16483;11741;1312;1082;1858
FR;6;2022-08-19;30;45;5;4;3;16513;11786;1317;1086;1861
FR;6;2022-08-20;26;29;3;0;8;16539;11815;1320;1086;1869
FR;6;2022-08-21;1;5;2;0;0;16540;11820;1322;1086;1869
FR;6;2022-08-22;20;42;15;1;0;16560;11862;1337;1087;1869
FR;6;2022-08-23;34;45;6;7;6;16594;11907;1343;1094;1875
FR;6;2022-08-24;34;30;6;3;6;16628;11937;1349;1097;1881
FR;6;2022-08-25;25;27;1;1;5;16653;11964;1350;1098;1886
FR;6;2022-08-26;38;44;4;4;7;16691;12008;1354;1102;1893
FR;6;2022-08-27;19;21;7;3;8;16710;12029;1361;1105;1901
FR;6;2022-08-28;6;3;0;6;1;16716;12032;1361;1111;1902
FR;6;2022-08-29;26;22;2;6;3;16742;12054;1363;1117;1905
FR;6;2022-08-30;28;35;4;12;8;16770;12089;1367;1129;1913
FR;6;2022-08-31;35;38;2;11;3;16805;12127;1369;1140;1916
FR;6;2022-09-01;16;11;5;1;4;16821;12138;1374;1141;1920
FR;6;2022-09-02;19;14;2;1;3;16840;12152;1376;1142;1923
FR;6;2022-09-03;10;3;1;5;2;16850;12155;1377;1147;1925
FR;6;2022-09-04;4;1;0;0;0;16854;12156;1377;1147;1925
FR;6;2022-09-05;8;7;0;0;0;16862;12163;1377;1147;1925
FR;6;2022-09-06;7;9;7;12;6;16869;12172;1384;1159;1931
FR;6;2022-09-07;3;8;1;0;1;16872;12180;1385;1159;1932
FR;6;2022-09-08;5;4;0;2;1;16877;12184;1385;1161;1933
FR;6;2022-09-09;7;9;2;7;3;16884;12193;1387;1168;1936
FR;6;2022-09-10;3;4;1;0;1;16887;12197;1388;1168;1937
FR;6;2022-09-11;1;3;0;0;0;16888;12200;1388;1168;1937
FR;6;2022-09-12;10;4;1;0;3;16898;12204;1389;1168;1940
FR;6;2022-09-13;7;2;3;0;2;16905;12206;1392;1168;1942
FR;6;2022-09-14;9;8;2;0;4;16914;12214;1394;1168;1946
FR;6;2022-09-15;8;13;5;5;9;16922;12227;1399;1173;1955
FR;6;2022-09-16;24;38;1;1;3;16946;12265;1400;1174;1958
FR;6;2022-09-17;24;22;0;6;5;16970;12287;1400;1180;1963
FR;6;2022-09-18;5;4;0;0;1;16975;12291;1400;1180;1964
FR;6;2022-09-19;30;30;2;1;5;17005;12321;1402;1181;1969
FR;6;2022-09-20;34;25;1;4;6;17039;12346;1403;1185;1975
FR;6;2022-09-21;21;9;3;3;7;17060;12355;1406;1188;1982
FR;6;2022-09-22;19;28;1;22;3;17079;12383;1407;1210;1985
FR;6;2022-09-23;28;41;5;9;9;17107;12424;1412;1219;1994
FR;6;2022-09-24;16;16;4;2;6;17123;12440;1416;1221;2000
FR;6;2022-09-25;3;14;0;0;1;17126;12454;1416;1221;2001
FR;6;2022-09-26;16;13;0;18;5;17142;12467;1416;1239;2006
FR;6;2022-09-27;32;19;2;3;4;17174;12486;1418;1242;2010
FR;6;2022-09-28;27;10;8;11;4;17201;12496;1426;1253;2014
FR;6;2022-09-29;13;13;10;34;6;17214;12509;1436;1287;2020
FR;6;2022-09-30;34;24;5;6;5;17248;12533;1441;1293;2025
FR;6;2022-10-01;14;12;5;8;8;17262;12545;1446;1301;2033
FR;6;2022-10-02;3;0;0;0;0;17265;12545;1446;1301;2033
FR;6;2022-10-03;11;10;3;5;4;17276;12555;1449;1306;2037
FR;6;2022-10-04;19;17;4;28;3;17295;12572;1453;1334;2040
FR;6;2022-10-05;10;12;3;2;7;17305;12584;1456;1336;2047
FR;6;2022-10-06;19;13;4;6;2;17324;12597;1460;1342;2049
FR;6;2022-10-07;27;26;5;23;10;17351;12623;1465;1365;2059
FR;6;2022-10-08;16;13;0;0;0;17367;12636;1465;1365;2059
FR;6;2022-10-09;7;3;4;18;4;17374;12639;1469;1383;2063
FR;6;2022-10-10;15;14;1;16;6;17389;12653;1470;1399;2069
FR;6;2022-10-11;21;23;3;11;8;17410;12676;1473;1410;2077
FR;6;2022-10-12;20;14;7;19;2;17430;12690;1480;1429;2079
FR;6;2022-10-13;28;14;2;36;0;17458;12704;1482;1465;2079
FR;6;2022-10-14;28;23;5;49;11;17486;12727;1487;1514;2090
FR;6;2022-10-15;13;9;0;20;4;17499;12736;1487;1534;2094
FR;6;2022-10-16;4;4;0;5;2;17503;12740;1487;1539;2096
FR;6;2022-10-17;14;13;2;10;1;17517;12753;1489;1549;2097
FR;8;2020-12-27;0;0;0;0;0;0;0;0;0;0
FR;8;2020-12-28;0;0;0;0;0;0;0;0;0;0
FR;8;2020-12-29;0;0;0;0;0;0;0;0;0;0
FR;8;2020-12-30;0;0;0;0;0;0;0;0;0;0
FR;8;2020-12-31;0;0;0;0;0;0;0;0;0;0
FR;8;2021-01-01;0;0;0;0;0;0;0;0;0;0
FR;8;2021-01-02;0;0;0;0;0;0;0;0;0;0
FR;8;2021-01-03;0;0;0;0;0;0;0;0;0;0
FR;8;2021-01-04;0;0;0;0;0;0;0;0;0;0
FR;8;2021-01-05;0;0;0;0;0;0;0;0;0;0
FR;8;2021-01-06;0;0;0;0;0;0;0;0;0;0
FR;8;2021-01-07;0;0;0;0;0;0;0;0;0;0
FR;8;2021-01-08;0;0;0;0;0;0;0;0;0;0
FR;8;2021-01-09;0;0;0;0;0;0;0;0;0;0
FR;8;2021-01-10;0;0;0;0;0;0;0;0;0;0
FR;8;2021-01-11;0;0;0;0;0;0;0;0;0;0
FR;8;2021-01-12;0;0;0;0;0;0;0;0;0;0
FR;8;2021-01-13;0;0;0;0;0;0;0;0;0;0
FR;8;2021-01-14;0;0;0;0;0;0;0;0;0;0
FR;8;2021-01-15;0;0;0;0;0;0;0;0;0;0
FR;8;2021-01-16;0;0;0;0;0;0;0;0;0;0
FR;8;2021-01-17;0;0;0;0;0;0;0;0;0;0
FR;8;2021-01-18;0;0;0;0;0;0;0;0;0;0
FR;8;2021-01-19;0;0;0;0;0;0;0;0;0;0
FR;8;2021-01-20;0;0;0;0;0;0;0;0;0;0
FR;8;2021-01-21;0;0;0;0;0;0;0;0;0;0
FR;8;2021-01-22;0;0;0;0;0;0;0;0;0;0
FR;8;2021-01-23;0;0;0;0;0;0;0;0;0;0
FR;8;2021-01-24;0;0;0;0;0;0;0;0;0;0
FR;8;2021-01-25;0;0;0;0;0;0;0;0;0;0
FR;8;2021-01-26;0;0;0;0;0;0;0;0;0;0
FR;8;2021-01-27;0;0;0;0;0;0;0;0;0;0
FR;8;2021-01-28;0;0;0;0;0;0;0;0;0;0
FR;8;2021-01-29;0;0;0;0;0;0;0;0;0;0
FR;8;2021-01-30;0;0;0;0;0;0;0;0;0;0
FR;8;2021-01-31;0;0;0;0;0;0;0;0;0;0
FR;8;2021-02-01;0;0;0;0;0;0;0;0;0;0
FR;8;2021-02-02;0;0;0;0;0;0;0;0;0;0
FR;8;2021-02-03;0;0;0;0;0;0;0;0;0;0
FR;8;2021-02-04;0;0;0;0;0;0;0;0;0;0
FR;8;2021-02-05;0;0;0;0;0;0;0;0;0;0
FR;8;2021-02-06;0;0;0;0;0;0;0;0;0;0
FR;8;2021-02-07;0;0;0;0;0;0;0;0;0;0
FR;8;2021-02-08;0;0;0;0;0;0;0;0;0;0
FR;8;2021-02-09;0;0;0;0;0;0;0;0;0;0
FR;8;2021-02-10;0;0;0;0;0;0;0;0;0;0
FR;8;2021-02-11;0;0;0;0;0;0;0;0;0;0
FR;8;2021-02-12;0;0;0;0;0;0;0;0;0;0
FR;8;2021-02-13;0;0;0;0;0;0;0;0;0;0
FR;8;2021-02-14;0;0;0;0;0;0;0;0;0;0
FR;8;2021-02-15;0;0;0;0;0;0;0;0;0;0
FR;8;2021-02-16;0;0;0;0;0;0;0;0;0;0
FR;8;2021-02-17;0;0;0;0;0;0;0;0;0;0
FR;8;2021-02-18;0;0;0;0;0;0;0;0;0;0
FR;8;2021-02-19;0;0;0;0;0;0;0;0;0;0
FR;8;2021-02-20;0;0;0;0;0;0;0;0;0;0
FR;8;2021-02-21;0;0;0;0;0;0;0;0;0;0
FR;8;2021-02-22;0;0;0;0;0;0;0;0;0;0
FR;8;2021-02-23;0;0;0;0;0;0;0;0;0;0
FR;8;2021-02-24;0;0;0;0;0;0;0;0;0;0
FR;8;2021-02-25;0;0;0;0;0;0;0;0;0;0
FR;8;2021-02-26;0;0;0;0;0;0;0;0;0;0
FR;8;2021-02-27;0;0;0;0;0;0;0;0;0;0
FR;8;2021-02-28;0;0;0;0;0;0;0;0;0;0
FR;8;2021-03-01;0;0;0;0;0;0;0;0;0;0
FR;8;2021-03-02;0;0;0;0;0;0;0;0;0;0
FR;8;2021-03-03;0;0;0;0;0;0;0;0;0;0
FR;8;2021-03-04;0;0;0;0;0;0;0;0;0;0
FR;8;2021-03-05;0;0;0;0;0;0;0;0;0;0
FR;8;2021-03-06;0;0;0;0;0;0;0;0;0;0
FR;8;2021-03-07;0;0;0;0;0;0;0;0;0;0
FR;8;2021-03-08;0;0;0;0;0;0;0;0;0;0
FR;8;2021-03-09;0;0;0;0;0;0;0;0;0;0
FR;8;2021-03-10;0;0;0;0;0;0;0;0;0;0
FR;8;2021-03-11;0;0;0;0;0;0;0;0;0;0
FR;8;2021-03-12;0;0;0;0;0;0;0;0;0;0
FR;8;2021-03-13;0;0;0;0;0;0;0;0;0;0
FR;8;2021-03-14;0;0;0;0;0;0;0;0;0;0
FR;8;2021-03-15;0;0;0;0;0;0;0;0;0;0
FR;8;2021-03-16;0;0;0;0;0;0;0;0;0;0
FR;8;2021-03-17;0;0;0;0;0;0;0;0;0;0
FR;8;2021-03-18;0;0;0;0;0;0;0;0;0;0
FR;8;2021-03-19;0;0;0;0;0;0;0;0;0;0
FR;8;2021-03-20;0;0;0;0;0;0;0;0;0;0
FR;8;2021-03-21;0;0;0;0;0;0;0;0;0;0
FR;8;2021-03-22;0;0;0;0;0;0;0;0;0;0
FR;8;2021-03-23;0;0;0;0;0;0;0;0;0;0
FR;8;2021-03-24;0;0;0;0;0;0;0;0;0;0
FR;8;2021-03-25;0;0;0;0;0;0;0;0;0;0
FR;8;2021-03-26;0;0;0;0;0;0;0;0;0;0
FR;8;2021-03-27;0;0;0;0;0;0;0;0;0;0
FR;8;2021-03-28;0;0;0;0;0;0;0;0;0;0
FR;8;2021-03-29;0;0;0;0;0;0;0;0;0;0
FR;8;2021-03-30;0;0;0;0;0;0;0;0;0;0
FR;8;2021-03-31;0;0;0;0;0;0;0;0;0;0
FR;8;2021-04-01;0;0;0;0;0;0;0;0;0;0
FR;8;2021-04-02;0;0;0;0;0;0;0;0;0;0
FR;8;2021-04-03;0;0;0;0;0;0;0;0;0;0
FR;8;2021-04-04;0;0;0;0;0;0;0;0;0;0
FR;8;2021-04-05;0;0;0;0;0;0;0;0;0;0
FR;8;2021-04-06;0;0;0;0;0;0;0;0;0;0
FR;8;2021-04-07;0;0;0;0;0;0;0;0;0;0
FR;8;2021-04-08;0;0;0;0;0;0;0;0;0;0
FR;8;2021-04-09;0;0;0;0;0;0;0;0;0;0
FR;8;2021-04-10;0;0;0;0;0;0;0;0;0;0
FR;8;2021-04-11;0;0;0;0;0;0;0;0;0;0
FR;8;2021-04-12;0;0;0;0;0;0;0;0;0;0
FR;8;2021-04-13;0;0;0;0;0;0;0;0;0;0
FR;8;2021-04-14;0;0;0;0;0;0;0;0;0;0
FR;8;2021-04-15;0;0;0;0;0;0;0;0;0;0
FR;8;2021-04-16;0;0;0;0;0;0;0;0;0;0
FR;8;2021-04-17;0;0;0;0;0;0;0;0;0;0
FR;8;2021-04-18;0;0;0;0;0;0;0;0;0;0
FR;8;2021-04-19;0;0;0;0;0;0;0;0;0;0
FR;8;2021-04-20;0;0;0;0;0;0;0;0;0;0
FR;8;2021-04-21;0;0;0;0;0;0;0;0;0;0
FR;8;2021-04-22;0;0;0;0;0;0;0;0;0;0
FR;8;2021-04-23;0;0;0;0;0;0;0;0;0;0
FR;8;2021-04-24;0;0;0;0;0;0;0;0;0;0
FR;8;2021-04-25;0;0;0;0;0;0;0;0;0;0
FR;8;2021-04-26;0;0;0;0;0;0;0;0;0;0
FR;8;2021-04-27;0;0;0;0;0;0;0;0;0;0
FR;8;2021-04-28;0;0;0;0;0;0;0;0;0;0
FR;8;2021-04-29;0;0;0;0;0;0;0;0;0;0
FR;8;2021-04-30;0;0;0;0;0;0;0;0;0;0
FR;8;2021-05-01;0;0;0;0;0;0;0;0;0;0
FR;8;2021-05-02;0;0;0;0;0;0;0;0;0;0
FR;8;2021-05-03;0;0;0;0;0;0;0;0;0;0
FR;8;2021-05-04;0;0;0;0;0;0;0;0;0;0
FR;8;2021-05-05;0;0;0;0;0;0;0;0;0;0
FR;8;2021-05-06;0;0;0;0;0;0;0;0;0;0
FR;8;2021-05-07;0;0;0;0;0;0;0;0;0;0
FR;8;2021-05-08;0;0;0;0;0;0;0;0;0;0
FR;8;2021-05-09;0;0;0;0;0;0;0;0;0;0
FR;8;2021-05-10;0;0;0;0;0;0;0;0;0;0
FR;8;2021-05-11;0;0;0;0;0;0;0;0;0;0
FR;8;2021-05-12;0;0;0;0;0;0;0;0;0;0
FR;8;2021-05-13;0;0;0;0;0;0;0;0;0;0
FR;8;2021-05-14;0;0;0;0;0;0;0;0;0;0
FR;8;2021-05-15;0;0;0;0;0;0;0;0;0;0
FR;8;2021-05-16;0;0;0;0;0;0;0;0;0;0
FR;8;2021-05-17;0;0;0;0;0;0;0;0;0;0
FR;8;2021-05-18;0;0;0;0;0;0;0;0;0;0
FR;8;2021-05-19;0;0;0;0;0;0;0;0;0;0
FR;8;2021-05-20;0;0;0;0;0;0;0;0;0;0
FR;8;2021-05-21;0;0;0;0;0;0;0;0;0;0
FR;8;2021-05-22;0;0;0;0;0;0;0;0;0;0
FR;8;2021-05-23;0;0;0;0;0;0;0;0;0;0
FR;8;2021-05-24;0;0;0;0;0;0;0;0;0;0
FR;8;2021-05-25;0;0;0;0;0;0;0;0;0;0
FR;8;2021-05-26;0;0;0;0;0;0;0;0;0;0
FR;8;2021-05-27;0;0;0;0;0;0;0;0;0;0
FR;8;2021-05-28;0;0;0;0;0;0;0;0;0;0
FR;8;2021-05-29;0;0;0;0;0;0;0;0;0;0
FR;8;2021-05-30;0;0;0;0;0;0;0;0;0;0
FR;8;2021-05-31;0;0;0;0;0;0;0;0;0;0
FR;8;2021-06-01;0;0;0;0;0;0;0;0;0;0
FR;8;2021-06-02;0;0;0;0;0;0;0;0;0;0
FR;8;2021-06-03;0;0;0;0;0;0;0;0;0;0
FR;8;2021-06-04;0;0;0;0;0;0;0;0;0;0
FR;8;2021-06-05;0;0;0;0;0;0;0;0;0;0
FR;8;2021-06-06;0;0;0;0;0;0;0;0;0;0
FR;8;2021-06-07;0;0;0;0;0;0;0;0;0;0
FR;8;2021-06-08;0;0;0;0;0;0;0;0;0;0
FR;8;2021-06-09;0;0;0;0;0;0;0;0;0;0
FR;8;2021-06-10;0;0;0;0;0;0;0;0;0;0
FR;8;2021-06-11;0;0;0;0;0;0;0;0;0;0
FR;8;2021-06-12;0;0;0;0;0;0;0;0;0;0
FR;8;2021-06-13;0;0;0;0;0;0;0;0;0;0
FR;8;2021-06-14;0;0;0;0;0;0;0;0;0;0
FR;8;2021-06-15;0;0;0;0;0;0;0;0;0;0
FR;8;2021-06-16;0;0;0;0;0;0;0;0;0;0
FR;8;2021-06-17;0;0;0;0;0;0;0;0;0;0
FR;8;2021-06-18;0;0;0;0;0;0;0;0;0;0
FR;8;2021-06-19;0;0;0;0;0;0;0;0;0;0
FR;8;2021-06-20;0;0;0;0;0;0;0;0;0;0
FR;8;2021-06-21;0;0;0;0;0;0;0;0;0;0
FR;8;2021-06-22;0;0;0;0;0;0;0;0;0;0
FR;8;2021-06-23;0;0;0;0;0;0;0;0;0;0
FR;8;2021-06-24;0;0;0;0;0;0;0;0;0;0
FR;8;2021-06-25;0;0;0;0;0;0;0;0;0;0
FR;8;2021-06-26;0;0;0;0;0;0;0;0;0;0
FR;8;2021-06-27;0;0;0;0;0;0;0;0;0;0
FR;8;2021-06-28;0;0;0;0;0;0;0;0;0;0
FR;8;2021-06-29;0;0;0;0;0;0;0;0;0;0
FR;8;2021-06-30;0;0;0;0;0;0;0;0;0;0
FR;8;2021-07-01;0;0;0;0;0;0;0;0;0;0
FR;8;2021-07-02;0;0;0;0;0;0;0;0;0;0
FR;8;2021-07-03;0;0;0;0;0;0;0;0;0;0
FR;8;2021-07-04;0;0;0;0;0;0;0;0;0;0
FR;8;2021-07-05;0;0;0;0;0;0;0;0;0;0
FR;8;2021-07-06;0;0;0;0;0;0;0;0;0;0
FR;8;2021-07-07;0;0;0;0;0;0;0;0;0;0
FR;8;2021-07-08;0;0;0;0;0;0;0;0;0;0
FR;8;2021-07-09;0;0;0;0;0;0;0;0;0;0
FR;8;2021-07-10;0;0;0;0;0;0;0;0;0;0
FR;8;2021-07-11;0;0;0;0;0;0;0;0;0;0
FR;8;2021-07-12;0;0;0;0;0;0;0;0;0;0
FR;8;2021-07-13;0;0;0;0;0;0;0;0;0;0
FR;8;2021-07-14;0;0;0;0;0;0;0;0;0;0
FR;8;2021-07-15;0;0;0;0;0;0;0;0;0;0
FR;8;2021-07-16;0;0;0;0;0;0;0;0;0;0
FR;8;2021-07-17;0;0;0;0;0;0;0;0;0;0
FR;8;2021-07-18;0;0;0;0;0;0;0;0;0;0
FR;8;2021-07-19;0;0;0;0;0;0;0;0;0;0
FR;8;2021-07-20;0;0;0;0;0;0;0;0;0;0
FR;8;2021-07-21;0;0;0;0;0;0;0;0;0;0
FR;8;2021-07-22;0;0;0;0;0;0;0;0;0;0
FR;8;2021-07-23;0;0;0;0;0;0;0;0;0;0
FR;8;2021-07-24;0;0;0;0;0;0;0;0;0;0
FR;8;2021-07-25;0;0;0;0;0;0;0;0;0;0
FR;8;2021-07-26;0;0;0;0;0;0;0;0;0;0
FR;8;2021-07-27;0;0;0;0;0;0;0;0;0;0
FR;8;2021-07-28;0;0;0;0;0;0;0;0;0;0
FR;8;2021-07-29;0;0;0;0;0;0;0;0;0;0
FR;8;2021-07-30;0;0;0;0;0;0;0;0;0;0
FR;8;2021-07-31;0;0;0;0;0;0;0;0;0;0
FR;8;2021-08-01;0;0;0;0;0;0;0;0;0;0
FR;8;2021-08-02;0;0;0;0;0;0;0;0;0;0
FR;8;2021-08-03;0;0;0;0;0;0;0;0;0;0
FR;8;2021-08-04;0;0;0;0;0;0;0;0;0;0
FR;8;2021-08-05;0;0;0;0;0;0;0;0;0;0
FR;8;2021-08-06;0;0;0;0;0;0;0;0;0;0
FR;8;2021-08-07;0;0;0;0;0;0;0;0;0;0
FR;8;2021-08-08;0;0;0;0;0;0;0;0;0;0
FR;8;2021-08-09;0;0;0;0;0;0;0;0;0;0
FR;8;2021-08-10;0;0;0;0;0;0;0;0;0;0
FR;8;2021-08-11;0;0;0;0;0;0;0;0;0;0
FR;8;2021-08-12;0;0;0;0;0;0;0;0;0;0
FR;8;2021-08-13;0;0;0;0;0;0;0;0;0;0
FR;8;2021-08-14;0;0;0;0;0;0;0;0;0;0
FR;8;2021-08-15;0;0;0;0;0;0;0;0;0;0
FR;8;2021-08-16;0;0;0;0;0;0;0;0;0;0
FR;8;2021-08-17;0;0;0;0;0;0;0;0;0;0
FR;8;2021-08-18;0;0;0;0;0;0;0;0;0;0
FR;8;2021-08-19;0;0;0;0;0;0;0;0;0;0
FR;8;2021-08-20;0;0;0;0;0;0;0;0;0;0
FR;8;2021-08-21;0;0;0;0;0;0;0;0;0;0
FR;8;2021-08-22;0;0;0;0;0;0;0;0;0;0
FR;8;2021-08-23;0;0;0;0;0;0;0;0;0;0
FR;8;2021-08-24;0;0;0;0;0;0;0;0;0;0
FR;8;2021-08-25;0;0;0;0;0;0;0;0;0;0
FR;8;2021-08-26;0;0;0;0;0;0;0;0;0;0
FR;8;2021-08-27;0;0;0;0;0;0;0;0;0;0
FR;8;2021-08-28;0;0;0;0;0;0;0;0;0;0
FR;8;2021-08-29;0;0;0;0;0;0;0;0;0;0
FR;8;2021-08-30;0;0;0;0;0;0;0;0;0;0
FR;8;2021-08-31;0;0;0;0;0;0;0;0;0;0
FR;8;2021-09-01;0;0;0;0;0;0;0;0;0;0
FR;8;2021-09-02;0;0;0;0;0;0;0;0;0;0
FR;8;2021-09-03;0;0;0;0;0;0;0;0;0;0
FR;8;2021-09-04;0;0;0;0;0;0;0;0;0;0
FR;8;2021-09-05;0;0;0;0;0;0;0;0;0;0
FR;8;2021-09-06;0;0;0;0;0;0;0;0;0;0
FR;8;2021-09-07;0;0;0;0;0;0;0;0;0;0
FR;8;2021-09-08;0;0;0;0;0;0;0;0;0;0
FR;8;2021-09-09;0;0;0;0;0;0;0;0;0;0
FR;8;2021-09-10;0;0;0;0;0;0;0;0;0;0
FR;8;2021-09-11;0;0;0;0;0;0;0;0;0;0
FR;8;2021-09-12;0;0;0;0;0;0;0;0;0;0
FR;8;2021-09-13;0;0;0;0;0;0;0;0;0;0
FR;8;2021-09-14;0;0;0;0;0;0;0;0;0;0
FR;8;2021-09-15;0;0;0;0;0;0;0;0;0;0
FR;8;2021-09-16;0;0;0;0;0;0;0;0;0;0
FR;8;2021-09-17;0;0;0;0;0;0;0;0;0;0
FR;8;2021-09-18;0;0;0;0;0;0;0;0;0;0
FR;8;2021-09-19;0;0;0;0;0;0;0;0;0;0
FR;8;2021-09-20;0;0;0;0;0;0;0;0;0;0
FR;8;2021-09-21;0;0;0;0;0;0;0;0;0;0
FR;8;2021-09-22;0;0;0;0;0;0;0;0;0;0
FR;8;2021-09-23;0;0;0;0;0;0;0;0;0;0
FR;8;2021-09-24;0;0;0;0;0;0;0;0;0;0
FR;8;2021-09-25;0;0;0;0;0;0;0;0;0;0
FR;8;2021-09-26;0;0;0;0;0;0;0;0;0;0
FR;8;2021-09-27;0;0;0;0;0;0;0;0;0;0
FR;8;2021-09-28;0;0;0;0;0;0;0;0;0;0
FR;8;2021-09-29;0;0;0;0;0;0;0;0;0;0
FR;8;2021-09-30;0;0;0;0;0;0;0;0;0;0
FR;8;2021-10-01;0;0;0;0;0;0;0;0;0;0
FR;8;2021-10-02;0;0;0;0;0;0;0;0;0;0
FR;8;2021-10-03;0;0;0;0;0;0;0;0;0;0
FR;8;2021-10-04;0;0;0;0;0;0;0;0;0;0
FR;8;2021-10-05;0;0;0;0;0;0;0;0;0;0
FR;8;2021-10-06;0;0;0;0;0;0;0;0;0;0
FR;8;2021-10-07;0;0;0;0;0;0;0;0;0;0
FR;8;2021-10-08;0;0;0;0;0;0;0;0;0;0
FR;8;2021-10-09;0;0;0;0;0;0;0;0;0;0
FR;8;2021-10-10;0;0;0;0;0;0;0;0;0;0
FR;8;2021-10-11;0;0;0;0;0;0;0;0;0;0
FR;8;2021-10-12;0;0;0;0;0;0;0;0;0;0
FR;8;2021-10-13;0;0;0;0;0;0;0;0;0;0
FR;8;2021-10-14;0;0;0;0;0;0;0;0;0;0
FR;8;2021-10-15;0;0;0;0;0;0;0;0;0;0
FR;8;2021-10-16;0;0;0;0;0;0;0;0;0;0
FR;8;2021-10-17;0;0;0;0;0;0;0;0;0;0
FR;8;2021-10-18;0;0;0;0;0;0;0;0;0;0
FR;8;2021-10-19;0;0;0;0;0;0;0;0;0;0
FR;8;2021-10-20;0;0;0;0;0;0;0;0;0;0
FR;8;2021-10-21;0;0;0;0;0;0;0;0;0;0
FR;8;2021-10-22;0;0;0;0;0;0;0;0;0;0
FR;8;2021-10-23;0;0;0;0;0;0;0;0;0;0
FR;8;2021-10-24;0;0;0;0;0;0;0;0;0;0
FR;8;2021-10-25;0;0;0;0;0;0;0;0;0;0
FR;8;2021-10-26;0;0;0;0;0;0;0;0;0;0
FR;8;2021-10-27;0;0;0;0;0;0;0;0;0;0
FR;8;2021-10-28;0;0;0;0;0;0;0;0;0;0
FR;8;2021-10-29;0;0;0;0;0;0;0;0;0;0
FR;8;2021-10-30;0;0;0;0;0;0;0;0;0;0
FR;8;2021-10-31;0;0;0;0;0;0;0;0;0;0
FR;8;2021-11-01;0;0;0;0;0;0;0;0;0;0
FR;8;2021-11-02;0;0;0;0;0;0;0;0;0;0
FR;8;2021-11-03;0;0;0;0;0;0;0;0;0;0
FR;8;2021-11-04;0;0;0;0;0;0;0;0;0;0
FR;8;2021-11-05;0;0;0;0;0;0;0;0;0;0
FR;8;2021-11-06;0;0;0;0;0;0;0;0;0;0
FR;8;2021-11-07;0;0;0;0;0;0;0;0;0;0
FR;8;2021-11-08;0;0;0;0;0;0;0;0;0;0
FR;8;2021-11-09;0;0;0;0;0;0;0;0;0;0
FR;8;2021-11-10;0;0;0;0;0;0;0;0;0;0
FR;8;2021-11-11;0;0;0;0;0;0;0;0;0;0
FR;8;2021-11-12;0;0;0;0;0;0;0;0;0;0
FR;8;2021-11-13;0;0;0;0;0;0;0;0;0;0
FR;8;2021-11-14;0;0;0;0;0;0;0;0;0;0
FR;8;2021-11-15;0;0;0;0;0;0;0;0;0;0
FR;8;2021-11-16;0;0;0;0;0;0;0;0;0;0
FR;8;2021-11-17;0;0;0;0;0;0;0;0;0;0
FR;8;2021-11-18;0;0;0;0;0;0;0;0;0;0
FR;8;2021-11-19;0;0;0;0;0;0;0;0;0;0
FR;8;2021-11-20;0;0;0;0;0;0;0;0;0;0
FR;8;2021-11-21;0;0;0;0;0;0;0;0;0;0
FR;8;2021-11-22;0;0;0;0;0;0;0;0;0;0
FR;8;2021-11-23;0;0;0;0;0;0;0;0;0;0
FR;8;2021-11-24;0;0;0;0;0;0;0;0;0;0
FR;8;2021-11-25;0;0;0;0;0;0;0;0;0;0
FR;8;2021-11-26;0;0;0;0;0;0;0;0;0;0
FR;8;2021-11-27;0;0;0;0;0;0;0;0;0;0
FR;8;2021-11-28;0;0;0;0;0;0;0;0;0;0
FR;8;2021-11-29;0;0;0;0;0;0;0;0;0;0
FR;8;2021-11-30;0;0;0;0;0;0;0;0;0;0
FR;8;2021-12-01;0;0;0;0;0;0;0;0;0;0
FR;8;2021-12-02;0;0;0;0;0;0;0;0;0;0
FR;8;2021-12-03;0;0;0;0;0;0;0;0;0;0
FR;8;2021-12-04;0;0;0;0;0;0;0;0;0;0
FR;8;2021-12-05;0;0;0;0;0;0;0;0;0;0
FR;8;2021-12-06;0;0;0;0;0;0;0;0;0;0
FR;8;2021-12-07;0;0;0;0;0;0;0;0;0;0
FR;8;2021-12-08;0;0;0;0;0;0;0;0;0;0
FR;8;2021-12-09;0;0;0;0;0;0;0;0;0;0
FR;8;2021-12-10;0;0;0;0;0;0;0;0;0;0
FR;8;2021-12-11;0;0;0;0;0;0;0;0;0;0
FR;8;2021-12-12;0;0;0;0;0;0;0;0;0;0
FR;8;2021-12-13;0;0;0;0;0;0;0;0;0;0
FR;8;2021-12-14;0;0;0;0;0;0;0;0;0;0
FR;8;2021-12-15;0;0;0;0;0;0;0;0;0;0
FR;8;2021-12-16;0;0;0;0;0;0;0;0;0;0
FR;8;2021-12-17;0;0;0;0;0;0;0;0;0;0
FR;8;2021-12-18;0;0;0;0;0;0;0;0;0;0
FR;8;2021-12-19;0;0;0;0;0;0;0;0;0;0
FR;8;2021-12-20;0;0;0;0;0;0;0;0;0;0
FR;8;2021-12-21;0;0;0;0;0;0;0;0;0;0
FR;8;2021-12-22;0;0;0;0;0;0;0;0;0;0
FR;8;2021-12-23;0;0;0;0;0;0;0;0;0;0
FR;8;2021-12-24;0;0;0;0;0;0;0;0;0;0
FR;8;2021-12-25;0;0;0;0;0;0;0;0;0;0
FR;8;2021-12-26;0;0;0;0;0;0;0;0;0;0
FR;8;2021-12-27;0;0;0;0;0;0;0;0;0;0
FR;8;2021-12-28;0;0;0;0;0;0;0;0;0;0
FR;8;2021-12-29;0;0;0;0;0;0;0;0;0;0
FR;8;2021-12-30;0;0;0;0;0;0;0;0;0;0
FR;8;2021-12-31;0;0;0;0;0;0;0;0;0;0
FR;8;2022-01-01;0;0;0;0;0;0;0;0;0;0
FR;8;2022-01-02;0;0;0;0;0;0;0;0;0;0
FR;8;2022-01-03;0;0;0;0;0;0;0;0;0;0
FR;8;2022-01-04;0;0;0;0;0;0;0;0;0;0
FR;8;2022-01-05;0;0;0;0;0;0;0;0;0;0
FR;8;2022-01-06;0;0;0;0;0;0;0;0;0;0
FR;8;2022-01-07;0;0;0;0;0;0;0;0;0;0
FR;8;2022-01-08;0;0;0;0;0;0;0;0;0;0
FR;8;2022-01-09;0;0;0;0;0;0;0;0;0;0
FR;8;2022-01-10;0;0;0;0;0;0;0;0;0;0
FR;8;2022-01-11;0;0;0;0;0;0;0;0;0;0
FR;8;2022-01-12;0;0;0;0;0;0;0;0;0;0
FR;8;2022-01-13;0;0;0;0;0;0;0;0;0;0
FR;8;2022-01-14;0;0;0;0;0;0;0;0;0;0
FR;8;2022-01-15;0;0;0;0;0;0;0;0;0;0
FR;8;2022-01-16;0;0;0;0;0;0;0;0;0;0
FR;8;2022-01-17;0;0;0;0;0;0;0;0;0;0
FR;8;2022-01-18;0;0;0;0;0;0;0;0;0;0
FR;8;2022-01-19;0;0;0;0;0;0;0;0;0;0
FR;8;2022-01-20;0;0;0;0;0;0;0;0;0;0
FR;8;2022-01-21;0;0;0;0;0;0;0;0;0;0
FR;8;2022-01-22;0;0;0;0;0;0;0;0;0;0
FR;8;2022-01-23;0;0;0;0;0;0;0;0;0;0
FR;8;2022-01-24;0;0;0;0;0;0;0;0;0;0
FR;8;2022-01-25;0;0;0;0;0;0;0;0;0;0
FR;8;2022-01-26;0;0;0;0;0;0;0;0;0;0
FR;8;2022-01-27;0;0;0;0;0;0;0;0;0;0
FR;8;2022-01-28;0;0;0;0;0;0;0;0;0;0
FR;8;2022-01-29;0;0;0;0;0;0;0;0;0;0
FR;8;2022-01-30;0;0;0;0;0;0;0;0;0;0
FR;8;2022-01-31;0;0;0;0;0;0;0;0;0;0
FR;8;2022-02-01;0;0;0;0;0;0;0;0;0;0
FR;8;2022-02-02;0;0;0;0;0;0;0;0;0;0
FR;8;2022-02-03;0;0;0;0;0;0;0;0;0;0
FR;8;2022-02-04;0;0;0;0;0;0;0;0;0;0
FR;8;2022-02-05;0;0;0;0;0;0;0;0;0;0
FR;8;2022-02-06;0;0;0;0;0;0;0;0;0;0
FR;8;2022-02-07;0;0;0;0;0;0;0;0;0;0
FR;8;2022-02-08;0;0;0;0;0;0;0;0;0;0
FR;8;2022-02-09;0;0;0;0;0;0;0;0;0;0
FR;8;2022-02-10;0;0;0;0;0;0;0;0;0;0
FR;8;2022-02-11;0;0;0;0;0;0;0;0;0;0
FR;8;2022-02-12;0;0;0;0;0;0;0;0;0;0
FR;8;2022-02-13;0;0;0;0;0;0;0;0;0;0
FR;8;2022-02-14;0;0;0;0;0;0;0;0;0;0
FR;8;2022-02-15;0;0;0;0;0;0;0;0;0;0
FR;8;2022-02-16;0;0;0;0;0;0;0;0;0;0
FR;8;2022-02-17;0;0;0;0;0;0;0;0;0;0
FR;8;2022-02-18;0;0;0;0;0;0;0;0;0;0
FR;8;2022-02-19;0;0;0;0;0;0;0;0;0;0
FR;8;2022-02-20;0;0;0;0;0;0;0;0;0;0
FR;8;2022-02-21;0;0;0;0;0;0;0;0;0;0
FR;8;2022-02-22;0;0;0;0;0;0;0;0;0;0
FR;8;2022-02-23;0;0;0;0;0;0;0;0;0;0
FR;8;2022-02-24;0;0;0;0;0;0;0;0;0;0
FR;8;2022-02-25;0;0;0;0;0;0;0;0;0;0
FR;8;2022-02-26;0;0;0;0;0;0;0;0;0;0
FR;8;2022-02-27;0;0;0;0;0;0;0;0;0;0
FR;8;2022-02-28;0;0;0;0;0;0;0;0;0;0
FR;8;2022-03-01;0;0;0;0;0;0;0;0;0;0
FR;8;2022-03-02;0;0;0;0;0;0;0;0;0;0
FR;8;2022-03-03;0;0;0;0;0;0;0;0;0;0
FR;8;2022-03-04;0;0;0;0;0;0;0;0;0;0
FR;8;2022-03-05;0;0;0;0;0;0;0;0;0;0
FR;8;2022-03-06;0;0;0;0;0;0;0;0;0;0
FR;8;2022-03-07;0;0;0;0;0;0;0;0;0;0
FR;8;2022-03-08;0;0;0;0;0;0;0;0;0;0
FR;8;2022-03-09;0;0;0;0;0;0;0;0;0;0
FR;8;2022-03-10;0;0;0;0;0;0;0;0;0;0
FR;8;2022-03-11;0;0;0;0;0;0;0;0;0;0
FR;8;2022-03-12;0;0;0;0;0;0;0;0;0;0
FR;8;2022-03-13;0;0;0;0;0;0;0;0;0;0
FR;8;2022-03-14;0;0;0;0;0;0;0;0;0;0
FR;8;2022-03-15;0;0;0;0;0;0;0;0;0;0
FR;8;2022-03-16;0;0;0;0;0;0;0;0;0;0
FR;8;2022-03-17;0;0;0;0;0;0;0;0;0;0
FR;8;2022-03-18;0;0;0;0;0;0;0;0;0;0
FR;8;2022-03-19;0;0;0;0;0;0;0;0;0;0
FR;8;2022-03-20;0;0;0;0;0;0;0;0;0;0
FR;8;2022-03-21;0;0;0;0;0;0;0;0;0;0
FR;8;2022-03-22;0;0;0;0;0;0;0;0;0;0
FR;8;2022-03-23;0;0;0;0;0;0;0;0;0;0
FR;8;2022-03-24;0;0;0;0;0;0;0;0;0;0
FR;8;2022-03-25;0;0;0;0;0;0;0;0;0;0
FR;8;2022-03-26;0;0;0;0;0;0;0;0;0;0
FR;8;2022-03-27;0;0;0;0;0;0;0;0;0;0
FR;8;2022-03-28;0;0;0;0;0;0;0;0;0;0
FR;8;2022-03-29;0;0;0;0;0;0;0;0;0;0
FR;8;2022-03-30;0;0;0;0;0;0;0;0;0;0
FR;8;2022-03-31;0;0;0;0;0;0;0;0;0;0
FR;8;2022-04-01;0;0;0;0;0;0;0;0;0;0
FR;8;2022-04-02;0;0;0;0;0;0;0;0;0;0
FR;8;2022-04-03;0;0;0;0;0;0;0;0;0;0
FR;8;2022-04-04;0;0;0;0;0;0;0;0;0;0
FR;8;2022-04-05;0;0;0;0;0;0;0;0;0;0
FR;8;2022-04-06;0;0;0;0;0;0;0;0;0;0
FR;8;2022-04-07;0;0;0;0;0;0;0;0;0;0
FR;8;2022-04-08;0;0;0;0;0;0;0;0;0;0
FR;8;2022-04-09;0;0;0;0;0;0;0;0;0;0
FR;8;2022-04-10;0;0;0;0;0;0;0;0;0;0
FR;8;2022-04-11;0;0;0;0;0;0;0;0;0;0
FR;8;2022-04-12;0;0;0;0;0;0;0;0;0;0
FR;8;2022-04-13;0;0;0;0;0;0;0;0;0;0
FR;8;2022-04-14;0;0;0;0;0;0;0;0;0;0
FR;8;2022-04-15;0;0;0;0;0;0;0;0;0;0
FR;8;2022-04-16;0;0;0;0;0;0;0;0;0;0
FR;8;2022-04-17;0;0;0;0;0;0;0;0;0;0
FR;8;2022-04-18;0;0;0;0;0;0;0;0;0;0
FR;8;2022-04-19;0;0;0;0;0;0;0;0;0;0
FR;8;2022-04-20;0;0;0;0;0;0;0;0;0;0
FR;8;2022-04-21;0;0;0;0;0;0;0;0;0;0
FR;8;2022-04-22;0;0;0;0;0;0;0;0;0;0
FR;8;2022-04-23;0;0;0;0;0;0;0;0;0;0
FR;8;2022-04-24;0;0;0;0;0;0;0;0;0;0
FR;8;2022-04-25;0;0;0;0;0;0;0;0;0;0
FR;8;2022-04-26;0;0;0;0;0;0;0;0;0;0
FR;8;2022-04-27;0;0;0;0;0;0;0;0;0;0
FR;8;2022-04-28;0;0;0;0;0;0;0;0;0;0
FR;8;2022-04-29;0;0;0;0;0;0;0;0;0;0
FR;8;2022-04-30;0;0;0;0;0;0;0;0;0;0
FR;8;2022-05-01;0;0;0;0;0;0;0;0;0;0
FR;8;2022-05-02;0;0;0;0;0;0;0;0;0;0
FR;8;2022-05-03;0;0;0;0;0;0;0;0;0;0
FR;8;2022-05-04;0;0;0;0;0;0;0;0;0;0
FR;8;2022-05-05;0;0;0;0;0;0;0;0;0;0
FR;8;2022-05-06;0;0;0;0;0;0;0;0;0;0
FR;8;2022-05-07;0;0;0;0;0;0;0;0;0;0
FR;8;2022-05-08;0;0;0;0;0;0;0;0;0;0
FR;8;2022-05-09;0;0;0;0;0;0;0;0;0;0
FR;8;2022-05-10;0;0;0;0;0;0;0;0;0;0
FR;8;2022-05-11;0;0;0;0;0;0;0;0;0;0
FR;8;2022-05-12;0;0;0;0;0;0;0;0;0;0
FR;8;2022-05-13;0;0;0;0;0;0;0;0;0;0
FR;8;2022-05-14;0;0;0;0;0;0;0;0;0;0
FR;8;2022-05-15;0;0;0;0;0;0;0;0;0;0
FR;8;2022-05-16;0;0;0;0;0;0;0;0;0;0
FR;8;2022-05-17;0;0;0;0;0;0;0;0;0;0
FR;8;2022-05-18;0;0;0;0;0;0;0;0;0;0
FR;8;2022-05-19;0;0;0;0;0;0;0;0;0;0
FR;8;2022-05-20;0;0;0;0;0;0;0;0;0;0
FR;8;2022-05-21;0;0;0;0;0;0;0;0;0;0
FR;8;2022-05-22;0;0;0;0;0;0;0;0;0;0
FR;8;2022-05-23;0;0;0;0;0;0;0;0;0;0
FR;8;2022-05-24;0;0;0;0;0;0;0;0;0;0
FR;8;2022-05-25;0;0;0;0;0;0;0;0;0;0
FR;8;2022-05-26;0;0;0;0;0;0;0;0;0;0
FR;8;2022-05-27;0;0;0;0;0;0;0;0;0;0
FR;8;2022-05-28;0;0;0;0;0;0;0;0;0;0
FR;8;2022-05-29;0;0;0;0;0;0;0;0;0;0
FR;8;2022-05-30;0;0;0;0;0;0;0;0;0;0
FR;8;2022-05-31;0;0;0;0;0;0;0;0;0;0
FR;8;2022-06-01;0;0;0;0;0;0;0;0;0;0
FR;8;2022-06-02;0;0;0;0;0;0;0;0;0;0
FR;8;2022-06-03;0;0;0;0;0;0;0;0;0;0
FR;8;2022-06-04;0;0;0;0;0;0;0;0;0;0
FR;8;2022-06-05;0;0;0;0;0;0;0;0;0;0
FR;8;2022-06-06;0;0;0;0;0;0;0;0;0;0
FR;8;2022-06-07;0;0;0;0;0;0;0;0;0;0
FR;8;2022-06-08;0;0;0;0;0;0;0;0;0;0
FR;8;2022-06-09;0;0;0;0;0;0;0;0;0;0
FR;8;2022-06-10;0;0;0;0;0;0;0;0;0;0
FR;8;2022-06-11;0;0;0;0;0;0;0;0;0;0
FR;8;2022-06-12;0;0;0;0;0;0;0;0;0;0
FR;8;2022-06-13;0;0;0;0;0;0;0;0;0;0
FR;8;2022-06-14;0;0;0;0;0;0;0;0;0;0
FR;8;2022-06-15;0;0;0;0;0;0;0;0;0;0
FR;8;2022-06-16;0;0;0;0;0;0;0;0;0;0
FR;8;2022-06-17;0;0;0;0;0;0;0;0;0;0
FR;8;2022-06-18;0;0;0;0;0;0;0;0;0;0
FR;8;2022-06-19;0;0;0;0;0;0;0;0;0;0
FR;8;2022-06-20;0;0;0;0;0;0;0;0;0;0
FR;8;2022-06-21;0;0;0;0;0;0;0;0;0;0
FR;8;2022-06-22;0;0;0;0;0;0;0;0;0;0
FR;8;2022-06-23;0;0;0;0;0;0;0;0;0;0
FR;8;2022-06-24;0;0;0;0;0;0;0;0;0;0
FR;8;2022-06-25;0;0;0;0;0;0;0;0;0;0
FR;8;2022-06-26;0;0;0;0;0;0;0;0;0;0
FR;8;2022-06-27;0;0;0;0;0;0;0;0;0;0
FR;8;2022-06-28;0;0;0;0;0;0;0;0;0;0
FR;8;2022-06-29;0;0;0;0;0;0;0;0;0;0
FR;8;2022-06-30;0;0;0;0;0;0;0;0;0;0
FR;8;2022-07-01;0;0;0;0;0;0;0;0;0;0
FR;8;2022-07-02;0;0;0;0;0;0;0;0;0;0
FR;8;2022-07-03;0;0;0;0;0;0;0;0;0;0
FR;8;2022-07-04;0;0;0;0;0;0;0;0;0;0
FR;8;2022-07-05;0;0;0;0;0;0;0;0;0;0
FR;8;2022-07-06;0;0;0;0;0;0;0;0;0;0
FR;8;2022-07-07;0;0;0;0;0;0;0;0;0;0
FR;8;2022-07-08;0;0;0;0;0;0;0;0;0;0
FR;8;2022-07-09;0;0;0;0;0;0;0;0;0;0
FR;8;2022-07-10;0;0;0;0;0;0;0;0;0;0
FR;8;2022-07-11;0;0;0;0;0;0;0;0;0;0
FR;8;2022-07-12;0;0;0;0;0;0;0;0;0;0
FR;8;2022-07-13;0;0;0;0;0;0;0;0;0;0
FR;8;2022-07-14;0;0;0;0;0;0;0;0;0;0
FR;8;2022-07-15;0;0;0;0;0;0;0;0;0;0
FR;8;2022-07-16;0;0;0;0;0;0;0;0;0;0
FR;8;2022-07-17;0;0;0;0;0;0;0;0;0;0
FR;8;2022-07-18;0;0;0;0;0;0;0;0;0;0
FR;8;2022-07-19;0;0;0;0;0;0;0;0;0;0
FR;8;2022-07-20;0;0;0;0;0;0;0;0;0;0
FR;8;2022-07-21;0;0;0;0;0;0;0;0;0;0
FR;8;2022-07-22;0;0;0;0;0;0;0;0;0;0
FR;8;2022-07-23;0;0;0;0;0;0;0;0;0;0
FR;8;2022-07-24;0;0;0;0;0;0;0;0;0;0
FR;8;2022-07-25;0;0;0;0;0;0;0;0;0;0
FR;8;2022-07-26;0;0;0;0;0;0;0;0;0;0
FR;8;2022-07-27;0;0;0;0;0;0;0;0;0;0
FR;8;2022-07-28;0;0;0;0;0;0;0;0;0;0
FR;8;2022-07-29;0;0;0;0;0;0;0;0;0;0
FR;8;2022-07-30;0;0;0;0;0;0;0;0;0;0
FR;8;2022-07-31;0;0;0;0;0;0;0;0;0;0
FR;8;2022-08-01;0;0;0;0;0;0;0;0;0;0
FR;8;2022-08-02;0;0;0;0;0;0;0;0;0;0
FR;8;2022-08-03;0;0;0;0;0;0;0;0;0;0
FR;8;2022-08-04;0;0;0;0;0;0;0;0;0;0
FR;8;2022-08-05;0;0;0;0;0;0;0;0;0;0
FR;8;2022-08-06;0;0;0;0;0;0;0;0;0;0
FR;8;2022-08-07;0;0;0;0;0;0;0;0;0;0
FR;8;2022-08-08;0;0;0;0;0;0;0;0;0;0
FR;8;2022-08-09;0;0;0;0;0;0;0;0;0;0
FR;8;2022-08-10;0;0;0;0;0;0;0;0;0;0
FR;8;2022-08-11;0;0;0;0;0;0;0;0;0;0
FR;8;2022-08-12;0;0;0;0;0;0;0;0;0;0
FR;8;2022-08-13;0;0;0;0;0;0;0;0;0;0
FR;8;2022-08-14;0;0;0;0;0;0;0;0;0;0
FR;8;2022-08-15;0;0;0;0;0;0;0;0;0;0
FR;8;2022-08-16;0;0;0;0;0;0;0;0;0;0
FR;8;2022-08-17;0;0;0;0;0;0;0;0;0;0
FR;8;2022-08-18;0;0;0;0;0;0;0;0;0;0
FR;8;2022-08-19;0;0;0;0;0;0;0;0;0;0
FR;8;2022-08-20;0;0;0;0;0;0;0;0;0;0
FR;8;2022-08-21;0;0;0;0;0;0;0;0;0;0
FR;8;2022-08-22;0;0;0;0;0;0;0;0;0;0
FR;8;2022-08-23;0;0;0;0;0;0;0;0;0;0
FR;8;2022-08-24;0;0;0;0;0;0;0;0;0;0
FR;8;2022-08-25;0;0;0;0;0;0;0;0;0;0
FR;8;2022-08-26;0;0;0;0;0;0;0;0;0;0
FR;8;2022-08-27;0;0;0;0;0;0;0;0;0;0
FR;8;2022-08-28;0;0;0;0;0;0;0;0;0;0
FR;8;2022-08-29;0;0;0;0;0;0;0;0;0;0
FR;8;2022-08-30;0;0;0;0;0;0;0;0;0;0
FR;8;2022-08-31;0;0;0;0;0;0;0;0;0;0
FR;8;2022-09-01;0;0;0;0;0;0;0;0;0;0
FR;8;2022-09-02;0;0;0;0;0;0;0;0;0;0
FR;8;2022-09-03;0;0;0;0;0;0;0;0;0;0
FR;8;2022-09-04;0;0;0;0;0;0;0;0;0;0
FR;8;2022-09-05;0;0;0;0;0;0;0;0;0;0
FR;8;2022-09-06;0;0;0;0;0;0;0;0;0;0
FR;8;2022-09-07;0;0;0;0;0;0;0;0;0;0
FR;8;2022-09-08;0;0;0;0;0;0;0;0;0;0
FR;8;2022-09-09;0;0;0;0;0;0;0;0;0;0
FR;8;2022-09-10;0;0;0;0;0;0;0;0;0;0
FR;8;2022-09-11;0;0;0;0;0;0;0;0;0;0
FR;8;2022-09-12;0;0;0;0;0;0;0;0;0;0
FR;8;2022-09-13;0;0;0;0;0;0;0;0;0;0
FR;8;2022-09-14;0;0;0;0;0;0;0;0;0;0
FR;8;2022-09-15;0;0;0;0;0;0;0;0;0;0
FR;8;2022-09-16;0;0;0;0;0;0;0;0;0;0
FR;8;2022-09-17;0;0;0;0;0;0;0;0;0;0
FR;8;2022-09-18;0;0;0;0;0;0;0;0;0;0
FR;8;2022-09-19;0;0;0;0;0;0;0;0;0;0
FR;8;2022-09-20;0;0;0;0;0;0;0;0;0;0
FR;8;2022-09-21;0;0;0;0;0;0;0;0;0;0
FR;8;2022-09-22;0;0;0;0;0;0;0;0;0;0
FR;8;2022-09-23;0;0;0;0;0;0;0;0;0;0
FR;8;2022-09-24;0;0;0;0;0;0;0;0;0;0
FR;8;2022-09-25;0;0;0;0;0;0;0;0;0;0
FR;8;2022-09-26;0;0;0;0;0;0;0;0;0;0
FR;8;2022-09-27;0;0;0;0;0;0;0;0;0;0
FR;8;2022-09-28;0;0;0;0;0;0;0;0;0;0
FR;8;2022-09-29;0;0;0;0;0;0;0;0;0;0
FR;8;2022-09-30;0;0;0;0;0;0;0;0;0;0
FR;8;2022-10-01;0;0;0;0;0;0;0;0;0;0
FR;8;2022-10-02;0;0;0;0;0;0;0;0;0;0
FR;8;2022-10-03;0;0;0;0;0;0;0;0;0;0
FR;8;2022-10-04;0;0;0;0;0;0;0;0;0;0
FR;8;2022-10-05;0;0;0;0;0;0;0;0;0;0
FR;8;2022-10-06;7;15;99;807;73;7;15;99;807;73
FR;8;2022-10-07;68;97;822;7949;692;75;112;921;8756;765
FR;8;2022-10-08;34;114;608;4018;512;109;226;1529;12774;1277
FR;8;2022-10-09;17;22;144;865;129;126;248;1673;13639;1406
FR;8;2022-10-10;111;190;1315;12495;1011;237;438;2988;26134;2417
FR;8;2022-10-11;169;255;2445;26528;1964;406;693;5433;52662;4381
FR;8;2022-10-12;141;239;1815;18043;1415;547;932;7248;70705;5796
FR;8;2022-10-13;198;264;2441;27594;1841;745;1196;9689;98299;7637
FR;8;2022-10-14;241;406;3205;35634;2499;986;1602;12894;133933;10136
FR;8;2022-10-15;95;171;1135;8566;954;1081;1773;14029;142499;11090
FR;8;2022-10-16;30;50;222;1459;195;1111;1823;14251;143958;11285
FR;8;2022-10-17;139;287;1976;20888;1504;1250;2110;16227;164846;12789
FR;9;2020-12-27;0;0;0;0;0;0;0;0;0;0
FR;9;2020-12-28;0;0;0;0;0;0;0;0;0;0
FR;9;2020-12-29;0;0;0;0;0;0;0;0;0;0
FR;9;2020-12-30;0;0;0;0;0;0;0;0;0;0
FR;9;2020-12-31;0;0;0;0;0;0;0;0;0;0
FR;9;2021-01-01;0;0;0;0;0;0;0;0;0;0
FR;9;2021-01-02;0;0;0;0;0;0;0;0;0;0
FR;9;2021-01-03;0;0;0;0;0;0;0;0;0;0
FR;9;2021-01-04;0;0;0;0;0;0;0;0;0;0
FR;9;2021-01-05;0;0;0;0;0;0;0;0;0;0
FR;9;2021-01-06;0;0;0;0;0;0;0;0;0;0
FR;9;2021-01-07;0;0;0;0;0;0;0;0;0;0
FR;9;2021-01-08;0;0;0;0;0;0;0;0;0;0
FR;9;2021-01-09;0;0;0;0;0;0;0;0;0;0
FR;9;2021-01-10;0;0;0;0;0;0;0;0;0;0
FR;9;2021-01-11;0;0;0;0;0;0;0;0;0;0
FR;9;2021-01-12;0;0;0;0;0;0;0;0;0;0
FR;9;2021-01-13;0;0;0;0;0;0;0;0;0;0
FR;9;2021-01-14;0;0;0;0;0;0;0;0;0;0
FR;9;2021-01-15;0;0;0;0;0;0;0;0;0;0
FR;9;2021-01-16;0;0;0;0;0;0;0;0;0;0
FR;9;2021-01-17;0;0;0;0;0;0;0;0;0;0
FR;9;2021-01-18;0;0;0;0;0;0;0;0;0;0
FR;9;2021-01-19;0;0;0;0;0;0;0;0;0;0
FR;9;2021-01-20;0;0;0;0;0;0;0;0;0;0
FR;9;2021-01-21;0;0;0;0;0;0;0;0;0;0
FR;9;2021-01-22;0;0;0;0;0;0;0;0;0;0
FR;9;2021-01-23;0;0;0;0;0;0;0;0;0;0
FR;9;2021-01-24;0;0;0;0;0;0;0;0;0;0
FR;9;2021-01-25;0;0;0;0;0;0;0;0;0;0
FR;9;2021-01-26;0;0;0;0;0;0;0;0;0;0
FR;9;2021-01-27;0;0;0;0;0;0;0;0;0;0
FR;9;2021-01-28;0;0;0;0;0;0;0;0;0;0
FR;9;2021-01-29;0;0;0;0;0;0;0;0;0;0
FR;9;2021-01-30;0;0;0;0;0;0;0;0;0;0
FR;9;2021-01-31;0;0;0;0;0;0;0;0;0;0
FR;9;2021-02-01;0;0;0;0;0;0;0;0;0;0
FR;9;2021-02-02;0;0;0;0;0;0;0;0;0;0
FR;9;2021-02-03;0;0;0;0;0;0;0;0;0;0
FR;9;2021-02-04;0;0;0;0;0;0;0;0;0;0
FR;9;2021-02-05;0;0;0;0;0;0;0;0;0;0
FR;9;2021-02-06;0;0;0;0;0;0;0;0;0;0
FR;9;2021-02-07;0;0;0;0;0;0;0;0;0;0
FR;9;2021-02-08;0;0;0;0;0;0;0;0;0;0
FR;9;2021-02-09;0;0;0;0;0;0;0;0;0;0
FR;9;2021-02-10;0;0;0;0;0;0;0;0;0;0
FR;9;2021-02-11;0;0;0;0;0;0;0;0;0;0
FR;9;2021-02-12;0;0;0;0;0;0;0;0;0;0
FR;9;2021-02-13;0;0;0;0;0;0;0;0;0;0
FR;9;2021-02-14;0;0;0;0;0;0;0;0;0;0
FR;9;2021-02-15;0;0;0;0;0;0;0;0;0;0
FR;9;2021-02-16;0;0;0;0;0;0;0;0;0;0
FR;9;2021-02-17;0;0;0;0;0;0;0;0;0;0
FR;9;2021-02-18;0;0;0;0;0;0;0;0;0;0
FR;9;2021-02-19;0;0;0;0;0;0;0;0;0;0
FR;9;2021-02-20;0;0;0;0;0;0;0;0;0;0
FR;9;2021-02-21;0;0;0;0;0;0;0;0;0;0
FR;9;2021-02-22;0;0;0;0;0;0;0;0;0;0
FR;9;2021-02-23;0;0;0;0;0;0;0;0;0;0
FR;9;2021-02-24;0;0;0;0;0;0;0;0;0;0
FR;9;2021-02-25;0;0;0;0;0;0;0;0;0;0
FR;9;2021-02-26;0;0;0;0;0;0;0;0;0;0
FR;9;2021-02-27;0;0;0;0;0;0;0;0;0;0
FR;9;2021-02-28;0;0;0;0;0;0;0;0;0;0
FR;9;2021-03-01;0;0;0;0;0;0;0;0;0;0
FR;9;2021-03-02;0;0;0;0;0;0;0;0;0;0
FR;9;2021-03-03;0;0;0;0;0;0;0;0;0;0
FR;9;2021-03-04;0;0;0;0;0;0;0;0;0;0
FR;9;2021-03-05;0;0;0;0;0;0;0;0;0;0
FR;9;2021-03-06;0;0;0;0;0;0;0;0;0;0
FR;9;2021-03-07;0;0;0;0;0;0;0;0;0;0
FR;9;2021-03-08;0;0;0;0;0;0;0;0;0;0
FR;9;2021-03-09;0;0;0;0;0;0;0;0;0;0
FR;9;2021-03-10;0;0;0;0;0;0;0;0;0;0
FR;9;2021-03-11;0;0;0;0;0;0;0;0;0;0
FR;9;2021-03-12;0;0;0;0;0;0;0;0;0;0
FR;9;2021-03-13;0;0;0;0;0;0;0;0;0;0
FR;9;2021-03-14;0;0;0;0;0;0;0;0;0;0
FR;9;2021-03-15;0;0;0;0;0;0;0;0;0;0
FR;9;2021-03-16;0;0;0;0;0;0;0;0;0;0
FR;9;2021-03-17;0;0;0;0;0;0;0;0;0;0
FR;9;2021-03-18;0;0;0;0;0;0;0;0;0;0
FR;9;2021-03-19;0;0;0;0;0;0;0;0;0;0
FR;9;2021-03-20;0;0;0;0;0;0;0;0;0;0
FR;9;2021-03-21;0;0;0;0;0;0;0;0;0;0
FR;9;2021-03-22;0;0;0;0;0;0;0;0;0;0
FR;9;2021-03-23;0;0;0;0;0;0;0;0;0;0
FR;9;2021-03-24;0;0;0;0;0;0;0;0;0;0
FR;9;2021-03-25;0;0;0;0;0;0;0;0;0;0
FR;9;2021-03-26;0;0;0;0;0;0;0;0;0;0
FR;9;2021-03-27;0;0;0;0;0;0;0;0;0;0
FR;9;2021-03-28;0;0;0;0;0;0;0;0;0;0
FR;9;2021-03-29;0;0;0;0;0;0;0;0;0;0
FR;9;2021-03-30;0;0;0;0;0;0;0;0;0;0
FR;9;2021-03-31;0;0;0;0;0;0;0;0;0;0
FR;9;2021-04-01;0;0;0;0;0;0;0;0;0;0
FR;9;2021-04-02;0;0;0;0;0;0;0;0;0;0
FR;9;2021-04-03;0;0;0;0;0;0;0;0;0;0
FR;9;2021-04-04;0;0;0;0;0;0;0;0;0;0
FR;9;2021-04-05;0;0;0;0;0;0;0;0;0;0
FR;9;2021-04-06;0;0;0;0;0;0;0;0;0;0
FR;9;2021-04-07;0;0;0;0;0;0;0;0;0;0
FR;9;2021-04-08;0;0;0;0;0;0;0;0;0;0
FR;9;2021-04-09;0;0;0;0;0;0;0;0;0;0
FR;9;2021-04-10;0;0;0;0;0;0;0;0;0;0
FR;9;2021-04-11;0;0;0;0;0;0;0;0;0;0
FR;9;2021-04-12;0;0;0;0;0;0;0;0;0;0
FR;9;2021-04-13;0;0;0;0;0;0;0;0;0;0
FR;9;2021-04-14;0;0;0;0;0;0;0;0;0;0
FR;9;2021-04-15;0;0;0;0;0;0;0;0;0;0
FR;9;2021-04-16;0;0;0;0;0;0;0;0;0;0
FR;9;2021-04-17;0;0;0;0;0;0;0;0;0;0
FR;9;2021-04-18;0;0;0;0;0;0;0;0;0;0
FR;9;2021-04-19;0;0;0;0;0;0;0;0;0;0
FR;9;2021-04-20;0;0;0;0;0;0;0;0;0;0
FR;9;2021-04-21;0;0;0;0;0;0;0;0;0;0
FR;9;2021-04-22;0;0;0;0;0;0;0;0;0;0
FR;9;2021-04-23;0;0;0;0;0;0;0;0;0;0
FR;9;2021-04-24;0;0;0;0;0;0;0;0;0;0
FR;9;2021-04-25;0;0;0;0;0;0;0;0;0;0
FR;9;2021-04-26;0;0;0;0;0;0;0;0;0;0
FR;9;2021-04-27;0;0;0;0;0;0;0;0;0;0
FR;9;2021-04-28;0;0;0;0;0;0;0;0;0;0
FR;9;2021-04-29;0;0;0;0;0;0;0;0;0;0
FR;9;2021-04-30;0;0;0;0;0;0;0;0;0;0
FR;9;2021-05-01;0;0;0;0;0;0;0;0;0;0
FR;9;2021-05-02;0;0;0;0;0;0;0;0;0;0
FR;9;2021-05-03;0;0;0;0;0;0;0;0;0;0
FR;9;2021-05-04;0;0;0;0;0;0;0;0;0;0
FR;9;2021-05-05;0;0;0;0;0;0;0;0;0;0
FR;9;2021-05-06;0;0;0;0;0;0;0;0;0;0
FR;9;2021-05-07;0;0;0;0;0;0;0;0;0;0
FR;9;2021-05-08;0;0;0;0;0;0;0;0;0;0
FR;9;2021-05-09;0;0;0;0;0;0;0;0;0;0
FR;9;2021-05-10;0;0;0;0;0;0;0;0;0;0
FR;9;2021-05-11;0;0;0;0;0;0;0;0;0;0
FR;9;2021-05-12;0;0;0;0;0;0;0;0;0;0
FR;9;2021-05-13;0;0;0;0;0;0;0;0;0;0
FR;9;2021-05-14;0;0;0;0;0;0;0;0;0;0
FR;9;2021-05-15;0;0;0;0;0;0;0;0;0;0
FR;9;2021-05-16;0;0;0;0;0;0;0;0;0;0
FR;9;2021-05-17;0;0;0;0;0;0;0;0;0;0
FR;9;2021-05-18;0;0;0;0;0;0;0;0;0;0
FR;9;2021-05-19;0;0;0;0;0;0;0;0;0;0
FR;9;2021-05-20;0;0;0;0;0;0;0;0;0;0
FR;9;2021-05-21;0;0;0;0;0;0;0;0;0;0
FR;9;2021-05-22;0;0;0;0;0;0;0;0;0;0
FR;9;2021-05-23;0;0;0;0;0;0;0;0;0;0
FR;9;2021-05-24;0;0;0;0;0;0;0;0;0;0
FR;9;2021-05-25;0;0;0;0;0;0;0;0;0;0
FR;9;2021-05-26;0;0;0;0;0;0;0;0;0;0
FR;9;2021-05-27;0;0;0;0;0;0;0;0;0;0
FR;9;2021-05-28;0;0;0;0;0;0;0;0;0;0
FR;9;2021-05-29;0;0;0;0;0;0;0;0;0;0
FR;9;2021-05-30;0;0;0;0;0;0;0;0;0;0
FR;9;2021-05-31;0;0;0;0;0;0;0;0;0;0
FR;9;2021-06-01;0;0;0;0;0;0;0;0;0;0
FR;9;2021-06-02;0;0;0;0;0;0;0;0;0;0
FR;9;2021-06-03;0;0;0;0;0;0;0;0;0;0
FR;9;2021-06-04;0;0;0;0;0;0;0;0;0;0
FR;9;2021-06-05;0;0;0;0;0;0;0;0;0;0
FR;9;2021-06-06;0;0;0;0;0;0;0;0;0;0
FR;9;2021-06-07;0;0;0;0;0;0;0;0;0;0
FR;9;2021-06-08;0;0;0;0;0;0;0;0;0;0
FR;9;2021-06-09;0;0;0;0;0;0;0;0;0;0
FR;9;2021-06-10;0;0;0;0;0;0;0;0;0;0
FR;9;2021-06-11;0;0;0;0;0;0;0;0;0;0
FR;9;2021-06-12;0;0;0;0;0;0;0;0;0;0
FR;9;2021-06-13;0;0;0;0;0;0;0;0;0;0
FR;9;2021-06-14;0;0;0;0;0;0;0;0;0;0
FR;9;2021-06-15;0;0;0;0;0;0;0;0;0;0
FR;9;2021-06-16;0;0;0;0;0;0;0;0;0;0
FR;9;2021-06-17;0;0;0;0;0;0;0;0;0;0
FR;9;2021-06-18;0;0;0;0;0;0;0;0;0;0
FR;9;2021-06-19;0;0;0;0;0;0;0;0;0;0
FR;9;2021-06-20;0;0;0;0;0;0;0;0;0;0
FR;9;2021-06-21;0;0;0;0;0;0;0;0;0;0
FR;9;2021-06-22;0;0;0;0;0;0;0;0;0;0
FR;9;2021-06-23;0;0;0;0;0;0;0;0;0;0
FR;9;2021-06-24;0;0;0;0;0;0;0;0;0;0
FR;9;2021-06-25;0;0;0;0;0;0;0;0;0;0
FR;9;2021-06-26;0;0;0;0;0;0;0;0;0;0
FR;9;2021-06-27;0;0;0;0;0;0;0;0;0;0
FR;9;2021-06-28;0;0;0;0;0;0;0;0;0;0
FR;9;2021-06-29;0;0;0;0;0;0;0;0;0;0
FR;9;2021-06-30;0;0;0;0;0;0;0;0;0;0
FR;9;2021-07-01;0;0;0;0;0;0;0;0;0;0
FR;9;2021-07-02;0;0;0;0;0;0;0;0;0;0
FR;9;2021-07-03;0;0;0;0;0;0;0;0;0;0
FR;9;2021-07-04;0;0;0;0;0;0;0;0;0;0
FR;9;2021-07-05;0;0;0;0;0;0;0;0;0;0
FR;9;2021-07-06;0;0;0;0;0;0;0;0;0;0
FR;9;2021-07-07;0;0;0;0;0;0;0;0;0;0
FR;9;2021-07-08;0;0;0;0;0;0;0;0;0;0
FR;9;2021-07-09;0;0;0;0;0;0;0;0;0;0
FR;9;2021-07-10;0;0;0;0;0;0;0;0;0;0
FR;9;2021-07-11;0;0;0;0;0;0;0;0;0;0
FR;9;2021-07-12;0;0;0;0;0;0;0;0;0;0
FR;9;2021-07-13;0;0;0;0;0;0;0;0;0;0
FR;9;2021-07-14;0;0;0;0;0;0;0;0;0;0
FR;9;2021-07-15;0;0;0;0;0;0;0;0;0;0
FR;9;2021-07-16;0;0;0;0;0;0;0;0;0;0
FR;9;2021-07-17;0;0;0;0;0;0;0;0;0;0
FR;9;2021-07-18;0;0;0;0;0;0;0;0;0;0
FR;9;2021-07-19;0;0;0;0;0;0;0;0;0;0
FR;9;2021-07-20;0;0;0;0;0;0;0;0;0;0
FR;9;2021-07-21;0;0;0;0;0;0;0;0;0;0
FR;9;2021-07-22;0;0;0;0;0;0;0;0;0;0
FR;9;2021-07-23;0;0;0;0;0;0;0;0;0;0
FR;9;2021-07-24;0;0;0;0;0;0;0;0;0;0
FR;9;2021-07-25;0;0;0;0;0;0;0;0;0;0
FR;9;2021-07-26;0;0;0;0;0;0;0;0;0;0
FR;9;2021-07-27;0;0;0;0;0;0;0;0;0;0
FR;9;2021-07-28;0;0;0;0;0;0;0;0;0;0
FR;9;2021-07-29;0;0;0;0;0;0;0;0;0;0
FR;9;2021-07-30;0;0;0;0;0;0;0;0;0;0
FR;9;2021-07-31;0;0;0;0;0;0;0;0;0;0
FR;9;2021-08-01;0;0;0;0;0;0;0;0;0;0
FR;9;2021-08-02;0;0;0;0;0;0;0;0;0;0
FR;9;2021-08-03;0;0;0;0;0;0;0;0;0;0
FR;9;2021-08-04;0;0;0;0;0;0;0;0;0;0
FR;9;2021-08-05;0;0;0;0;0;0;0;0;0;0
FR;9;2021-08-06;0;0;0;0;0;0;0;0;0;0
FR;9;2021-08-07;0;0;0;0;0;0;0;0;0;0
FR;9;2021-08-08;0;0;0;0;0;0;0;0;0;0
FR;9;2021-08-09;0;0;0;0;0;0;0;0;0;0
FR;9;2021-08-10;0;0;0;0;0;0;0;0;0;0
FR;9;2021-08-11;0;0;0;0;0;0;0;0;0;0
FR;9;2021-08-12;0;0;0;0;0;0;0;0;0;0
FR;9;2021-08-13;0;0;0;0;0;0;0;0;0;0
FR;9;2021-08-14;0;0;0;0;0;0;0;0;0;0
FR;9;2021-08-15;0;0;0;0;0;0;0;0;0;0
FR;9;2021-08-16;0;0;0;0;0;0;0;0;0;0
FR;9;2021-08-17;0;0;0;0;0;0;0;0;0;0
FR;9;2021-08-18;0;0;0;0;0;0;0;0;0;0
FR;9;2021-08-19;0;0;0;0;0;0;0;0;0;0
FR;9;2021-08-20;0;0;0;0;0;0;0;0;0;0
FR;9;2021-08-21;0;0;0;0;0;0;0;0;0;0
FR;9;2021-08-22;0;0;0;0;0;0;0;0;0;0
FR;9;2021-08-23;0;0;0;0;0;0;0;0;0;0
FR;9;2021-08-24;0;0;0;0;0;0;0;0;0;0
FR;9;2021-08-25;0;0;0;0;0;0;0;0;0;0
FR;9;2021-08-26;0;0;0;0;0;0;0;0;0;0
FR;9;2021-08-27;0;0;0;0;0;0;0;0;0;0
FR;9;2021-08-28;0;0;0;0;0;0;0;0;0;0
FR;9;2021-08-29;0;0;0;0;0;0;0;0;0;0
FR;9;2021-08-30;0;0;0;0;0;0;0;0;0;0
FR;9;2021-08-31;0;0;0;0;0;0;0;0;0;0
FR;9;2021-09-01;0;0;0;0;0;0;0;0;0;0
FR;9;2021-09-02;0;0;0;0;0;0;0;0;0;0
FR;9;2021-09-03;0;0;0;0;0;0;0;0;0;0
FR;9;2021-09-04;0;0;0;0;0;0;0;0;0;0
FR;9;2021-09-05;0;0;0;0;0;0;0;0;0;0
FR;9;2021-09-06;0;0;0;0;0;0;0;0;0;0
FR;9;2021-09-07;0;0;0;0;0;0;0;0;0;0
FR;9;2021-09-08;0;0;0;0;0;0;0;0;0;0
FR;9;2021-09-09;0;0;0;0;0;0;0;0;0;0
FR;9;2021-09-10;0;0;0;0;0;0;0;0;0;0
FR;9;2021-09-11;0;0;0;0;0;0;0;0;0;0
FR;9;2021-09-12;0;0;0;0;0;0;0;0;0;0
FR;9;2021-09-13;0;0;0;0;0;0;0;0;0;0
FR;9;2021-09-14;0;0;0;0;0;0;0;0;0;0
FR;9;2021-09-15;0;0;0;0;0;0;0;0;0;0
FR;9;2021-09-16;0;0;0;0;0;0;0;0;0;0
FR;9;2021-09-17;0;0;0;0;0;0;0;0;0;0
FR;9;2021-09-18;0;0;0;0;0;0;0;0;0;0
FR;9;2021-09-19;0;0;0;0;0;0;0;0;0;0
FR;9;2021-09-20;0;0;0;0;0;0;0;0;0;0
FR;9;2021-09-21;0;0;0;0;0;0;0;0;0;0
FR;9;2021-09-22;0;0;0;0;0;0;0;0;0;0
FR;9;2021-09-23;0;0;0;0;0;0;0;0;0;0
FR;9;2021-09-24;0;0;0;0;0;0;0;0;0;0
FR;9;2021-09-25;0;0;0;0;0;0;0;0;0;0
FR;9;2021-09-26;0;0;0;0;0;0;0;0;0;0
FR;9;2021-09-27;0;0;0;0;0;0;0;0;0;0
FR;9;2021-09-28;0;0;0;0;0;0;0;0;0;0
FR;9;2021-09-29;0;0;0;0;0;0;0;0;0;0
FR;9;2021-09-30;0;0;0;0;0;0;0;0;0;0
FR;9;2021-10-01;0;0;0;0;0;0;0;0;0;0
FR;9;2021-10-02;0;0;0;0;0;0;0;0;0;0
FR;9;2021-10-03;0;0;0;0;0;0;0;0;0;0
FR;9;2021-10-04;0;0;0;0;0;0;0;0;0;0
FR;9;2021-10-05;0;0;0;0;0;0;0;0;0;0
FR;9;2021-10-06;0;0;0;0;0;0;0;0;0;0
FR;9;2021-10-07;0;0;0;0;0;0;0;0;0;0
FR;9;2021-10-08;0;0;0;0;0;0;0;0;0;0
FR;9;2021-10-09;0;0;0;0;0;0;0;0;0;0
FR;9;2021-10-10;0;0;0;0;0;0;0;0;0;0
FR;9;2021-10-11;0;0;0;0;0;0;0;0;0;0
FR;9;2021-10-12;0;0;0;0;0;0;0;0;0;0
FR;9;2021-10-13;0;0;0;0;0;0;0;0;0;0
FR;9;2021-10-14;0;0;0;0;0;0;0;0;0;0
FR;9;2021-10-15;0;0;0;0;0;0;0;0;0;0
FR;9;2021-10-16;0;0;0;0;0;0;0;0;0;0
FR;9;2021-10-17;0;0;0;0;0;0;0;0;0;0
FR;9;2021-10-18;0;0;0;0;0;0;0;0;0;0
FR;9;2021-10-19;0;0;0;0;0;0;0;0;0;0
FR;9;2021-10-20;0;0;0;0;0;0;0;0;0;0
FR;9;2021-10-21;0;0;0;0;0;0;0;0;0;0
FR;9;2021-10-22;0;0;0;0;0;0;0;0;0;0
FR;9;2021-10-23;0;0;0;0;0;0;0;0;0;0
FR;9;2021-10-24;0;0;0;0;0;0;0;0;0;0
FR;9;2021-10-25;0;0;0;0;0;0;0;0;0;0
FR;9;2021-10-26;0;0;0;0;0;0;0;0;0;0
FR;9;2021-10-27;0;0;0;0;0;0;0;0;0;0
FR;9;2021-10-28;0;0;0;0;0;0;0;0;0;0
FR;9;2021-10-29;0;0;0;0;0;0;0;0;0;0
FR;9;2021-10-30;0;0;0;0;0;0;0;0;0;0
FR;9;2021-10-31;0;0;0;0;0;0;0;0;0;0
FR;9;2021-11-01;0;0;0;0;0;0;0;0;0;0
FR;9;2021-11-02;0;0;0;0;0;0;0;0;0;0
FR;9;2021-11-03;0;0;0;0;0;0;0;0;0;0
FR;9;2021-11-04;0;0;0;0;0;0;0;0;0;0
FR;9;2021-11-05;0;0;0;0;0;0;0;0;0;0
FR;9;2021-11-06;0;0;0;0;0;0;0;0;0;0
FR;9;2021-11-07;0;0;0;0;0;0;0;0;0;0
FR;9;2021-11-08;0;0;0;0;0;0;0;0;0;0
FR;9;2021-11-09;0;0;0;0;0;0;0;0;0;0
FR;9;2021-11-10;0;0;0;0;0;0;0;0;0;0
FR;9;2021-11-11;0;0;0;0;0;0;0;0;0;0
FR;9;2021-11-12;0;0;0;0;0;0;0;0;0;0
FR;9;2021-11-13;0;0;0;0;0;0;0;0;0;0
FR;9;2021-11-14;0;0;0;0;0;0;0;0;0;0
FR;9;2021-11-15;0;0;0;0;0;0;0;0;0;0
FR;9;2021-11-16;0;0;0;0;0;0;0;0;0;0
FR;9;2021-11-17;0;0;0;0;0;0;0;0;0;0
FR;9;2021-11-18;0;0;0;0;0;0;0;0;0;0
FR;9;2021-11-19;0;0;0;0;0;0;0;0;0;0
FR;9;2021-11-20;0;0;0;0;0;0;0;0;0;0
FR;9;2021-11-21;0;0;0;0;0;0;0;0;0;0
FR;9;2021-11-22;0;0;0;0;0;0;0;0;0;0
FR;9;2021-11-23;0;0;0;0;0;0;0;0;0;0
FR;9;2021-11-24;0;0;0;0;0;0;0;0;0;0
FR;9;2021-11-25;0;0;0;0;0;0;0;0;0;0
FR;9;2021-11-26;0;0;0;0;0;0;0;0;0;0
FR;9;2021-11-27;0;0;0;0;0;0;0;0;0;0
FR;9;2021-11-28;0;0;0;0;0;0;0;0;0;0
FR;9;2021-11-29;0;0;0;0;0;0;0;0;0;0
FR;9;2021-11-30;0;0;0;0;0;0;0;0;0;0
FR;9;2021-12-01;0;0;0;0;0;0;0;0;0;0
FR;9;2021-12-02;0;0;0;0;0;0;0;0;0;0
FR;9;2021-12-03;0;0;0;0;0;0;0;0;0;0
FR;9;2021-12-04;0;0;0;0;0;0;0;0;0;0
FR;9;2021-12-05;0;0;0;0;0;0;0;0;0;0
FR;9;2021-12-06;0;0;0;0;0;0;0;0;0;0
FR;9;2021-12-07;0;0;0;0;0;0;0;0;0;0
FR;9;2021-12-08;0;0;0;0;0;0;0;0;0;0
FR;9;2021-12-09;0;0;0;0;0;0;0;0;0;0
FR;9;2021-12-10;0;0;0;0;0;0;0;0;0;0
FR;9;2021-12-11;0;0;0;0;0;0;0;0;0;0
FR;9;2021-12-12;0;0;0;0;0;0;0;0;0;0
FR;9;2021-12-13;0;0;0;0;0;0;0;0;0;0
FR;9;2021-12-14;0;0;0;0;0;0;0;0;0;0
FR;9;2021-12-15;0;0;0;0;0;0;0;0;0;0
FR;9;2021-12-16;0;0;0;0;0;0;0;0;0;0
FR;9;2021-12-17;0;0;0;0;0;0;0;0;0;0
FR;9;2021-12-18;0;0;0;0;0;0;0;0;0;0
FR;9;2021-12-19;0;0;0;0;0;0;0;0;0;0
FR;9;2021-12-20;0;0;0;0;0;0;0;0;0;0
FR;9;2021-12-21;0;0;0;0;0;0;0;0;0;0
FR;9;2021-12-22;0;0;0;0;0;0;0;0;0;0
FR;9;2021-12-23;0;0;0;0;0;0;0;0;0;0
FR;9;2021-12-24;0;0;0;0;0;0;0;0;0;0
FR;9;2021-12-25;0;0;0;0;0;0;0;0;0;0
FR;9;2021-12-26;0;0;0;0;0;0;0;0;0;0
FR;9;2021-12-27;0;0;0;0;0;0;0;0;0;0
FR;9;2021-12-28;0;0;0;0;0;0;0;0;0;0
FR;9;2021-12-29;0;0;0;0;0;0;0;0;0;0
FR;9;2021-12-30;0;0;0;0;0;0;0;0;0;0
FR;9;2021-12-31;0;0;0;0;0;0;0;0;0;0
FR;9;2022-01-01;0;0;0;0;0;0;0;0;0;0
FR;9;2022-01-02;0;0;0;0;0;0;0;0;0;0
FR;9;2022-01-03;0;0;0;0;0;0;0;0;0;0
FR;9;2022-01-04;0;0;0;0;0;0;0;0;0;0
FR;9;2022-01-05;0;0;0;0;0;0;0;0;0;0
FR;9;2022-01-06;0;0;0;0;0;0;0;0;0;0
FR;9;2022-01-07;0;0;0;0;0;0;0;0;0;0
FR;9;2022-01-08;0;0;0;0;0;0;0;0;0;0
FR;9;2022-01-09;0;0;0;0;0;0;0;0;0;0
FR;9;2022-01-10;0;0;0;0;0;0;0;0;0;0
FR;9;2022-01-11;0;0;0;0;0;0;0;0;0;0
FR;9;2022-01-12;0;0;0;0;0;0;0;0;0;0
FR;9;2022-01-13;0;0;0;0;0;0;0;0;0;0
FR;9;2022-01-14;0;0;0;0;0;0;0;0;0;0
FR;9;2022-01-15;0;0;0;0;0;0;0;0;0;0
FR;9;2022-01-16;0;0;0;0;0;0;0;0;0;0
FR;9;2022-01-17;0;0;0;0;0;0;0;0;0;0
FR;9;2022-01-18;0;0;0;0;0;0;0;0;0;0
FR;9;2022-01-19;0;0;0;0;0;0;0;0;0;0
FR;9;2022-01-20;0;0;0;0;0;0;0;0;0;0
FR;9;2022-01-21;0;0;0;0;0;0;0;0;0;0
FR;9;2022-01-22;0;0;0;0;0;0;0;0;0;0
FR;9;2022-01-23;0;0;0;0;0;0;0;0;0;0
FR;9;2022-01-24;0;0;0;0;0;0;0;0;0;0
FR;9;2022-01-25;0;0;0;0;0;0;0;0;0;0
FR;9;2022-01-26;0;0;0;0;0;0;0;0;0;0
FR;9;2022-01-27;0;0;0;0;0;0;0;0;0;0
FR;9;2022-01-28;0;0;0;0;0;0;0;0;0;0
FR;9;2022-01-29;0;0;0;0;0;0;0;0;0;0
FR;9;2022-01-30;0;0;0;0;0;0;0;0;0;0
FR;9;2022-01-31;0;0;0;0;0;0;0;0;0;0
FR;9;2022-02-01;0;0;0;0;0;0;0;0;0;0
FR;9;2022-02-02;0;0;0;0;0;0;0;0;0;0
FR;9;2022-02-03;0;0;0;0;0;0;0;0;0;0
FR;9;2022-02-04;0;0;0;0;0;0;0;0;0;0
FR;9;2022-02-05;0;0;0;0;0;0;0;0;0;0
FR;9;2022-02-06;0;0;0;0;0;0;0;0;0;0
FR;9;2022-02-07;0;0;0;0;0;0;0;0;0;0
FR;9;2022-02-08;0;0;0;0;0;0;0;0;0;0
FR;9;2022-02-09;0;0;0;0;0;0;0;0;0;0
FR;9;2022-02-10;0;0;0;0;0;0;0;0;0;0
FR;9;2022-02-11;0;0;0;0;0;0;0;0;0;0
FR;9;2022-02-12;0;0;0;0;0;0;0;0;0;0
FR;9;2022-02-13;0;0;0;0;0;0;0;0;0;0
FR;9;2022-02-14;0;0;0;0;0;0;0;0;0;0
FR;9;2022-02-15;0;0;0;0;0;0;0;0;0;0
FR;9;2022-02-16;0;0;0;0;0;0;0;0;0;0
FR;9;2022-02-17;0;0;0;0;0;0;0;0;0;0
FR;9;2022-02-18;0;0;0;0;0;0;0;0;0;0
FR;9;2022-02-19;0;0;0;0;0;0;0;0;0;0
FR;9;2022-02-20;0;0;0;0;0;0;0;0;0;0
FR;9;2022-02-21;0;0;0;0;0;0;0;0;0;0
FR;9;2022-02-22;0;0;0;0;0;0;0;0;0;0
FR;9;2022-02-23;0;0;0;0;0;0;0;0;0;0
FR;9;2022-02-24;0;0;0;0;0;0;0;0;0;0
FR;9;2022-02-25;0;0;0;0;0;0;0;0;0;0
FR;9;2022-02-26;0;0;0;0;0;0;0;0;0;0
FR;9;2022-02-27;0;0;0;0;0;0;0;0;0;0
FR;9;2022-02-28;0;0;0;0;0;0;0;0;0;0
FR;9;2022-03-01;0;0;0;0;0;0;0;0;0;0
FR;9;2022-03-02;0;0;0;0;0;0;0;0;0;0
FR;9;2022-03-03;0;0;0;0;0;0;0;0;0;0
FR;9;2022-03-04;0;0;0;0;0;0;0;0;0;0
FR;9;2022-03-05;0;0;0;0;0;0;0;0;0;0
FR;9;2022-03-06;0;0;0;0;0;0;0;0;0;0
FR;9;2022-03-07;0;0;0;0;0;0;0;0;0;0
FR;9;2022-03-08;0;0;0;0;0;0;0;0;0;0
FR;9;2022-03-09;0;0;0;0;0;0;0;0;0;0
FR;9;2022-03-10;0;0;0;0;0;0;0;0;0;0
FR;9;2022-03-11;0;0;0;0;0;0;0;0;0;0
FR;9;2022-03-12;0;0;0;0;0;0;0;0;0;0
FR;9;2022-03-13;0;0;0;0;0;0;0;0;0;0
FR;9;2022-03-14;0;0;0;0;0;0;0;0;0;0
FR;9;2022-03-15;0;0;0;0;0;0;0;0;0;0
FR;9;2022-03-16;0;0;0;0;0;0;0;0;0;0
FR;9;2022-03-17;0;0;0;0;0;0;0;0;0;0
FR;9;2022-03-18;0;0;0;0;0;0;0;0;0;0
FR;9;2022-03-19;0;0;0;0;0;0;0;0;0;0
FR;9;2022-03-20;0;0;0;0;0;0;0;0;0;0
FR;9;2022-03-21;0;0;0;0;0;0;0;0;0;0
FR;9;2022-03-22;0;0;0;0;0;0;0;0;0;0
FR;9;2022-03-23;0;0;0;0;0;0;0;0;0;0
FR;9;2022-03-24;0;0;0;0;0;0;0;0;0;0
FR;9;2022-03-25;0;0;0;0;0;0;0;0;0;0
FR;9;2022-03-26;0;0;0;0;0;0;0;0;0;0
FR;9;2022-03-27;0;0;0;0;0;0;0;0;0;0
FR;9;2022-03-28;0;0;0;0;0;0;0;0;0;0
FR;9;2022-03-29;0;0;0;0;0;0;0;0;0;0
FR;9;2022-03-30;0;0;0;0;0;0;0;0;0;0
FR;9;2022-03-31;0;0;0;0;0;0;0;0;0;0
FR;9;2022-04-01;0;0;0;0;0;0;0;0;0;0
FR;9;2022-04-02;0;0;0;0;0;0;0;0;0;0
FR;9;2022-04-03;0;0;0;0;0;0;0;0;0;0
FR;9;2022-04-04;0;0;0;0;0;0;0;0;0;0
FR;9;2022-04-05;0;0;0;0;0;0;0;0;0;0
FR;9;2022-04-06;0;0;0;0;0;0;0;0;0;0
FR;9;2022-04-07;0;0;0;0;0;0;0;0;0;0
FR;9;2022-04-08;0;0;0;0;0;0;0;0;0;0
FR;9;2022-04-09;0;0;0;0;0;0;0;0;0;0
FR;9;2022-04-10;0;0;0;0;0;0;0;0;0;0
FR;9;2022-04-11;0;0;0;0;0;0;0;0;0;0
FR;9;2022-04-12;0;0;0;0;0;0;0;0;0;0
FR;9;2022-04-13;0;0;0;0;0;0;0;0;0;0
FR;9;2022-04-14;0;0;0;0;0;0;0;0;0;0
FR;9;2022-04-15;0;0;0;0;0;0;0;0;0;0
FR;9;2022-04-16;0;0;0;0;0;0;0;0;0;0
FR;9;2022-04-17;0;0;0;0;0;0;0;0;0;0
FR;9;2022-04-18;0;0;0;0;0;0;0;0;0;0
FR;9;2022-04-19;0;0;0;0;0;0;0;0;0;0
FR;9;2022-04-20;0;0;0;0;0;0;0;0;0;0
FR;9;2022-04-21;0;0;0;0;0;0;0;0;0;0
FR;9;2022-04-22;0;0;0;0;0;0;0;0;0;0
FR;9;2022-04-23;0;0;0;0;0;0;0;0;0;0
FR;9;2022-04-24;0;0;0;0;0;0;0;0;0;0
FR;9;2022-04-25;0;0;0;0;0;0;0;0;0;0
FR;9;2022-04-26;0;0;0;0;0;0;0;0;0;0
FR;9;2022-04-27;0;0;0;0;0;0;0;0;0;0
FR;9;2022-04-28;0;0;0;0;0;0;0;0;0;0
FR;9;2022-04-29;0;0;0;0;0;0;0;0;0;0
FR;9;2022-04-30;0;0;0;0;0;0;0;0;0;0
FR;9;2022-05-01;0;0;0;0;0;0;0;0;0;0
FR;9;2022-05-02;0;0;0;0;0;0;0;0;0;0
FR;9;2022-05-03;0;0;0;0;0;0;0;0;0;0
FR;9;2022-05-04;0;0;0;0;0;0;0;0;0;0
FR;9;2022-05-05;0;0;0;0;0;0;0;0;0;0
FR;9;2022-05-06;0;0;0;0;0;0;0;0;0;0
FR;9;2022-05-07;0;0;0;0;0;0;0;0;0;0
FR;9;2022-05-08;0;0;0;0;0;0;0;0;0;0
FR;9;2022-05-09;0;0;0;0;0;0;0;0;0;0
FR;9;2022-05-10;0;0;0;0;0;0;0;0;0;0
FR;9;2022-05-11;0;0;0;0;0;0;0;0;0;0
FR;9;2022-05-12;0;0;0;0;0;0;0;0;0;0
FR;9;2022-05-13;0;0;0;0;0;0;0;0;0;0
FR;9;2022-05-14;0;0;0;0;0;0;0;0;0;0
FR;9;2022-05-15;0;0;0;0;0;0;0;0;0;0
FR;9;2022-05-16;0;0;0;0;0;0;0;0;0;0
FR;9;2022-05-17;0;0;0;0;0;0;0;0;0;0
FR;9;2022-05-18;0;0;0;0;0;0;0;0;0;0
FR;9;2022-05-19;0;0;0;0;0;0;0;0;0;0
FR;9;2022-05-20;0;0;0;0;0;0;0;0;0;0
FR;9;2022-05-21;0;0;0;0;0;0;0;0;0;0
FR;9;2022-05-22;0;0;0;0;0;0;0;0;0;0
FR;9;2022-05-23;0;0;0;0;0;0;0;0;0;0
FR;9;2022-05-24;0;0;0;0;0;0;0;0;0;0
FR;9;2022-05-25;0;0;0;0;0;0;0;0;0;0
FR;9;2022-05-26;0;0;0;0;0;0;0;0;0;0
FR;9;2022-05-27;0;0;0;0;0;0;0;0;0;0
FR;9;2022-05-28;0;0;0;0;0;0;0;0;0;0
FR;9;2022-05-29;0;0;0;0;0;0;0;0;0;0
FR;9;2022-05-30;0;0;0;0;0;0;0;0;0;0
FR;9;2022-05-31;0;0;0;0;0;0;0;0;0;0
FR;9;2022-06-01;0;0;0;0;0;0;0;0;0;0
FR;9;2022-06-02;0;0;0;0;0;0;0;0;0;0
FR;9;2022-06-03;0;0;0;0;0;0;0;0;0;0
FR;9;2022-06-04;0;0;0;0;0;0;0;0;0;0
FR;9;2022-06-05;0;0;0;0;0;0;0;0;0;0
FR;9;2022-06-06;0;0;0;0;0;0;0;0;0;0
FR;9;2022-06-07;0;0;0;0;0;0;0;0;0;0
FR;9;2022-06-08;0;0;0;0;0;0;0;0;0;0
FR;9;2022-06-09;0;0;0;0;0;0;0;0;0;0
FR;9;2022-06-10;0;0;0;0;0;0;0;0;0;0
FR;9;2022-06-11;0;0;0;0;0;0;0;0;0;0
FR;9;2022-06-12;0;0;0;0;0;0;0;0;0;0
FR;9;2022-06-13;0;0;0;0;0;0;0;0;0;0
FR;9;2022-06-14;0;0;0;0;0;0;0;0;0;0
FR;9;2022-06-15;0;0;0;0;0;0;0;0;0;0
FR;9;2022-06-16;0;0;0;0;0;0;0;0;0;0
FR;9;2022-06-17;0;0;0;0;0;0;0;0;0;0
FR;9;2022-06-18;0;0;0;0;0;0;0;0;0;0
FR;9;2022-06-19;0;0;0;0;0;0;0;0;0;0
FR;9;2022-06-20;0;0;0;0;0;0;0;0;0;0
FR;9;2022-06-21;0;0;0;0;0;0;0;0;0;0
FR;9;2022-06-22;0;0;0;0;0;0;0;0;0;0
FR;9;2022-06-23;0;0;0;0;0;0;0;0;0;0
FR;9;2022-06-24;0;0;0;0;0;0;0;0;0;0
FR;9;2022-06-25;0;0;0;0;0;0;0;0;0;0
FR;9;2022-06-26;0;0;0;0;0;0;0;0;0;0
FR;9;2022-06-27;0;0;0;0;0;0;0;0;0;0
FR;9;2022-06-28;0;0;0;0;0;0;0;0;0;0
FR;9;2022-06-29;0;0;0;0;0;0;0;0;0;0
FR;9;2022-06-30;0;0;0;0;0;0;0;0;0;0
FR;9;2022-07-01;0;0;0;0;0;0;0;0;0;0
FR;9;2022-07-02;0;0;0;0;0;0;0;0;0;0
FR;9;2022-07-03;0;0;0;0;0;0;0;0;0;0
FR;9;2022-07-04;0;0;0;0;0;0;0;0;0;0
FR;9;2022-07-05;0;0;0;0;0;0;0;0;0;0
FR;9;2022-07-06;0;0;0;0;0;0;0;0;0;0
FR;9;2022-07-07;0;0;0;0;0;0;0;0;0;0
FR;9;2022-07-08;0;0;0;0;0;0;0;0;0;0
FR;9;2022-07-09;0;0;0;0;0;0;0;0;0;0
FR;9;2022-07-10;0;0;0;0;0;0;0;0;0;0
FR;9;2022-07-11;0;0;0;0;0;0;0;0;0;0
FR;9;2022-07-12;0;0;0;0;0;0;0;0;0;0
FR;9;2022-07-13;0;0;0;0;0;0;0;0;0;0
FR;9;2022-07-14;0;0;0;0;0;0;0;0;0;0
FR;9;2022-07-15;0;0;0;0;0;0;0;0;0;0
FR;9;2022-07-16;0;0;0;0;0;0;0;0;0;0
FR;9;2022-07-17;0;0;0;0;0;0;0;0;0;0
FR;9;2022-07-18;0;0;0;0;0;0;0;0;0;0
FR;9;2022-07-19;0;0;0;0;0;0;0;0;0;0
FR;9;2022-07-20;0;0;0;0;0;0;0;0;0;0
FR;9;2022-07-21;0;0;0;0;0;0;0;0;0;0
FR;9;2022-07-22;0;0;0;0;0;0;0;0;0;0
FR;9;2022-07-23;0;0;0;0;0;0;0;0;0;0
FR;9;2022-07-24;0;0;0;0;0;0;0;0;0;0
FR;9;2022-07-25;0;0;0;0;0;0;0;0;0;0
FR;9;2022-07-26;0;0;0;0;0;0;0;0;0;0
FR;9;2022-07-27;0;0;0;0;0;0;0;0;0;0
FR;9;2022-07-28;0;0;0;0;0;0;0;0;0;0
FR;9;2022-07-29;0;0;0;0;0;0;0;0;0;0
FR;9;2022-07-30;0;0;0;0;0;0;0;0;0;0
FR;9;2022-07-31;0;0;0;0;0;0;0;0;0;0
FR;9;2022-08-01;0;0;0;0;0;0;0;0;0;0
FR;9;2022-08-02;0;0;0;0;0;0;0;0;0;0
FR;9;2022-08-03;0;0;0;0;0;0;0;0;0;0
FR;9;2022-08-04;0;0;0;0;0;0;0;0;0;0
FR;9;2022-08-05;0;0;0;0;0;0;0;0;0;0
FR;9;2022-08-06;0;0;0;0;0;0;0;0;0;0
FR;9;2022-08-07;0;0;0;0;0;0;0;0;0;0
FR;9;2022-08-08;0;0;0;0;0;0;0;0;0;0
FR;9;2022-08-09;0;0;0;0;0;0;0;0;0;0
FR;9;2022-08-10;0;0;0;0;0;0;0;0;0;0
FR;9;2022-08-11;0;0;0;0;0;0;0;0;0;0
FR;9;2022-08-12;0;0;0;0;0;0;0;0;0;0
FR;9;2022-08-13;0;0;0;0;0;0;0;0;0;0
FR;9;2022-08-14;0;0;0;0;0;0;0;0;0;0
FR;9;2022-08-15;0;0;0;0;0;0;0;0;0;0
FR;9;2022-08-16;0;0;0;0;0;0;0;0;0;0
FR;9;2022-08-17;0;0;0;0;0;0;0;0;0;0
FR;9;2022-08-18;0;0;0;0;0;0;0;0;0;0
FR;9;2022-08-19;0;0;0;0;0;0;0;0;0;0
FR;9;2022-08-20;0;0;0;0;0;0;0;0;0;0
FR;9;2022-08-21;0;0;0;0;0;0;0;0;0;0
FR;9;2022-08-22;0;0;0;0;0;0;0;0;0;0
FR;9;2022-08-23;0;0;0;0;0;0;0;0;0;0
FR;9;2022-08-24;0;0;0;0;0;0;0;0;0;0
FR;9;2022-08-25;0;0;0;0;0;0;0;0;0;0
FR;9;2022-08-26;0;0;0;0;0;0;0;0;0;0
FR;9;2022-08-27;0;0;0;0;0;0;0;0;0;0
FR;9;2022-08-28;0;0;0;0;0;0;0;0;0;0
FR;9;2022-08-29;0;0;0;0;0;0;0;0;0;0
FR;9;2022-08-30;0;0;0;0;0;0;0;0;0;0
FR;9;2022-08-31;0;0;0;0;0;0;0;0;0;0
FR;9;2022-09-01;0;0;0;0;0;0;0;0;0;0
FR;9;2022-09-02;0;0;0;0;0;0;0;0;0;0
FR;9;2022-09-03;0;0;0;0;0;0;0;0;0;0
FR;9;2022-09-04;0;0;0;0;0;0;0;0;0;0
FR;9;2022-09-05;0;0;0;0;0;0;0;0;0;0
FR;9;2022-09-06;0;0;0;0;0;0;0;0;0;0
FR;9;2022-09-07;0;0;0;0;0;0;0;0;0;0
FR;9;2022-09-08;0;0;0;0;0;0;0;0;0;0
FR;9;2022-09-09;0;0;0;0;0;0;0;0;0;0
FR;9;2022-09-10;0;0;0;0;0;0;0;0;0;0
FR;9;2022-09-11;0;0;0;0;0;0;0;0;0;0
FR;9;2022-09-12;0;0;0;0;0;0;0;0;0;0
FR;9;2022-09-13;0;0;0;0;0;0;0;0;0;0
FR;9;2022-09-14;0;0;0;0;0;0;0;0;0;0
FR;9;2022-09-15;0;0;0;0;0;0;0;0;0;0
FR;9;2022-09-16;0;0;0;0;0;0;0;0;0;0
FR;9;2022-09-17;0;0;0;0;0;0;0;0;0;0
FR;9;2022-09-18;0;0;0;0;0;0;0;0;0;0
FR;9;2022-09-19;0;0;0;0;0;0;0;0;0;0
FR;9;2022-09-20;0;0;0;0;0;0;0;0;0;0
FR;9;2022-09-21;0;0;0;0;0;0;0;0;0;0
FR;9;2022-09-22;0;0;0;0;0;0;0;0;0;0
FR;9;2022-09-23;0;0;0;0;0;0;0;0;0;0
FR;9;2022-09-24;0;0;0;0;0;0;0;0;0;0
FR;9;2022-09-25;0;0;0;0;0;0;0;0;0;0
FR;9;2022-09-26;0;0;0;0;0;0;0;0;0;0
FR;9;2022-09-27;0;0;0;0;0;0;0;0;0;0
FR;9;2022-09-28;0;0;0;0;0;0;0;0;0;0
FR;9;2022-09-29;1;0;8;31;5;1;0;8;31;5
FR;9;2022-09-30;4;12;60;604;47;5;12;68;635;52
FR;9;2022-10-01;9;1;41;326;26;14;13;109;961;78
FR;9;2022-10-02;1;0;5;50;3;15;13;114;1011;81
FR;9;2022-10-03;10;16;149;1710;128;25;29;263;2721;209
FR;9;2022-10-04;19;48;354;3939;228;44;77;617;6660;437
FR;9;2022-10-05;26;19;268;2989;198;70;96;885;9649;635
FR;9;2022-10-06;22;33;398;4586;296;92;129;1283;14235;931
FR;9;2022-10-07;29;49;497;5682;383;121;178;1780;19917;1314
FR;9;2022-10-08;10;18;126;1084;84;131;196;1906;21001;1398
FR;9;2022-10-09;1;7;22;195;29;132;203;1928;21196;1427
FR;9;2022-10-10;11;24;207;2561;179;143;227;2135;23757;1606
FR;9;2022-10-11;31;40;424;5031;313;174;267;2559;28788;1919
FR;9;2022-10-12;22;23;292;2948;200;196;290;2851;31736;2119
FR;9;2022-10-13;25;43;369;3943;243;221;333;3220;35679;2362
FR;9;2022-10-14;26;24;368;4337;284;247;357;3588;40016;2646
FR;9;2022-10-15;11;8;102;1020;81;258;365;3690;41036;2727
FR;9;2022-10-16;4;1;7;113;11;262;366;3697;41149;2738
FR;9;2022-10-17;4;22;155;1814;121;266;388;3852;42963;2859
FR;0;2020-12-27;610;0;0;0;0;610;0;0;0;0
FR;0;2020-12-28;686;1;0;0;0;1296;1;0;0;0
FR;0;2020-12-29;385;0;0;0;0;1681;1;0;0;0
FR;0;2020-12-30;444;0;0;0;0;2125;1;0;0;0
FR;0;2020-12-31;444;1;0;0;0;2569;2;0;0;0
FR;0;2021-01-01;1161;2;0;0;0;3730;4;0;0;0
FR;0;2021-01-02;365;3;0;0;0;4095;7;0;0;0
FR;0;2021-01-03;405;0;0;0;0;4500;7;0;0;0
FR;0;2021-01-04;2116;4;0;0;0;6616;11;0;0;0
FR;0;2021-01-05;7755;3;0;0;0;14371;14;0;0;0
FR;0;2021-01-06;12457;17;0;0;0;26828;31;0;0;0
FR;0;2021-01-07;29468;19;0;0;0;56296;50;0;0;0
FR;0;2021-01-08;37151;20;0;0;0;93447;70;0;0;0
FR;0;2021-01-09;11212;8;0;0;0;104659;78;0;0;0
FR;0;2021-01-10;6008;7;0;0;0;110667;85;0;0;0
FR;0;2021-01-11;39942;26;0;0;0;150609;111;0;0;0
FR;0;2021-01-12;62144;20;0;0;0;212753;131;0;0;0
FR;0;2021-01-13;65128;46;0;0;0;277881;177;0;0;0
FR;0;2021-01-14;83119;167;0;0;0;361000;344;0;0;0
FR;0;2021-01-15;69011;68;0;0;0;430011;412;0;0;0
FR;0;2021-01-16;20217;72;0;0;0;450228;484;0;0;0
FR;0;2021-01-17;10986;49;0;0;0;461214;533;0;0;0
FR;0;2021-01-18;85906;172;0;0;0;547120;705;0;0;0
FR;0;2021-01-19;130604;191;0;0;0;677724;896;0;0;0
FR;0;2021-01-20;137556;188;0;0;0;815280;1084;0;0;0
FR;0;2021-01-21;158409;185;0;0;0;973689;1269;0;0;0
FR;0;2021-01-22;121069;237;0;0;0;1094758;1506;0;0;0
FR;0;2021-01-23;38483;71;0;0;0;1133241;1577;0;0;0
FR;0;2021-01-24;9746;104;0;0;0;1142987;1681;0;0;0
FR;0;2021-01-25;78241;1352;0;0;0;1221228;3033;0;0;0
FR;0;2021-01-26;100380;3530;1;0;0;1321608;6563;1;0;0
FR;0;2021-01-27;107250;6197;0;0;0;1428858;12760;1;0;0
FR;0;2021-01-28;124363;15788;0;0;0;1553221;28548;1;0;0
FR;0;2021-01-29;92188;18314;0;0;0;1645409;46862;1;0;0
FR;0;2021-01-30;29124;4433;0;0;0;1674533;51295;1;0;0
FR;0;2021-01-31;5235;1834;0;0;0;1679768;53129;1;0;0
FR;0;2021-02-01;53133;22218;0;0;0;1732901;75347;1;0;0
FR;0;2021-02-02;72314;37085;0;0;0;1805215;112432;1;0;0
FR;0;2021-02-03;72307;39271;0;0;0;1877522;151703;1;0;0
FR;0;2021-02-04;82081;53485;0;0;0;1959603;205188;1;0;0
FR;0;2021-02-05;68239;47072;0;0;0;2027842;252260;1;0;0
FR;0;2021-02-06;23020;11161;0;0;0;2050862;263421;1;0;0
FR;0;2021-02-07;5191;5738;0;0;0;2056053;269159;1;0;0
FR;0;2021-02-08;46843;47959;0;0;0;2102896;317118;1;0;0
FR;0;2021-02-09;66020;76664;0;0;0;2168916;393782;1;0;0
FR;0;2021-02-10;71023;81428;0;0;0;2239939;475210;1;0;0
FR;0;2021-02-11;87287;103904;0;0;0;2327226;579114;1;0;0
FR;0;2021-02-12;79330;75487;0;0;0;2406556;654601;1;0;0
FR;0;2021-02-13;22381;19546;0;0;0;2428937;674147;1;0;0
FR;0;2021-02-14;5077;7352;0;0;0;2434014;681499;1;0;0
FR;0;2021-02-15;38109;76751;0;0;0;2472123;758250;1;0;0
FR;0;2021-02-16;50400;100350;0;0;0;2522523;858600;1;0;0
FR;0;2021-02-17;50543;106085;20;0;0;2573066;964685;21;0;0
FR;0;2021-02-18;69790;122473;0;0;0;2642856;1087158;21;0;0
FR;0;2021-02-19;65071;91780;1;0;0;2707927;1178938;22;0;0
FR;0;2021-02-20;18591;28676;0;0;0;2726518;1207614;22;0;0
FR;0;2021-02-21;3323;6169;0;0;0;2729841;1213783;22;0;0
FR;0;2021-02-22;37500;73167;2;0;0;2767341;1286950;24;0;0
FR;0;2021-02-23;53783;85137;1;0;0;2821124;1372087;25;0;0
FR;0;2021-02-24;60019;82486;1;0;0;2881143;1454573;26;0;0
FR;0;2021-02-25;100583;91462;1;0;0;2981726;1546035;27;0;0
FR;0;2021-02-26;113474;70825;1;0;0;3095200;1616860;28;0;0
FR;0;2021-02-27;52111;22291;1;0;0;3147311;1639151;29;0;0
FR;0;2021-02-28;6203;4189;2;0;0;3153514;1643340;31;0;0
FR;0;2021-03-01;65901;53849;1;0;0;3219415;1697189;32;0;0
FR;0;2021-03-02;101392;67081;3;0;0;3320807;1764270;35;0;0
FR;0;2021-03-03;116531;65551;0;0;0;3437338;1829821;35;0;0
FR;0;2021-03-04;163631;71824;3;0;0;3600969;1901645;38;0;0
FR;0;2021-03-05;200933;62842;3;0;0;3801902;1964487;41;0;0
FR;0;2021-03-06;207964;17555;3;0;0;4009866;1982042;44;0;0
FR;0;2021-03-07;121277;4418;1;0;0;4131143;1986460;45;0;0
FR;0;2021-03-08;107159;49869;2;0;0;4238302;2036329;47;0;0
FR;0;2021-03-09;172463;56341;2;0;0;4410765;2092670;49;0;0
FR;0;2021-03-10;179010;57117;5;0;0;4589775;2149787;54;0;0
FR;0;2021-03-11;242904;63891;2;0;0;4832679;2213678;56;0;0
FR;0;2021-03-12;294832;53448;1;0;0;5127511;2267126;57;0;0
FR;0;2021-03-13;231420;15284;1;0;0;5358931;2282410;58;0;0
FR;0;2021-03-14;63355;3156;1;0;0;5422286;2285566;59;0;0
FR;0;2021-03-15;158668;31848;3;0;0;5580954;2317414;62;0;0
FR;0;2021-03-16;141577;39042;6;0;0;5722531;2356456;68;0;0
FR;0;2021-03-17;150497;37807;4;0;0;5873028;2394263;72;0;0
FR;0;2021-03-18;167845;44438;5;0;0;6040873;2438701;77;0;0
FR;0;2021-03-19;230021;36930;2;0;0;6270894;2475631;79;0;0
FR;0;2021-03-20;166701;11463;1;0;0;6437595;2487094;80;0;0
FR;0;2021-03-21;49945;2260;1;0;0;6487540;2489354;81;0;0
FR;0;2021-03-22;170061;33709;2;0;0;6657601;2523063;83;0;0
FR;0;2021-03-23;250399;42382;1;0;0;6908000;2565445;84;0;0
FR;0;2021-03-24;256913;43570;0;0;0;7164913;2609015;84;0;0
FR;0;2021-03-25;341820;45104;5;0;0;7506733;2654119;89;0;0
FR;0;2021-03-26;358810;41889;5;1;0;7865543;2696008;94;1;0
FR;0;2021-03-27;195264;16887;1;0;0;8060807;2712895;95;1;0
FR;0;2021-03-28;59346;4417;3;0;0;8120153;2717312;98;1;0
FR;0;2021-03-29;202987;53627;4;0;0;8323140;2770939;102;1;0
FR;0;2021-03-30;285490;69901;5;0;0;8608630;2840840;107;1;0
FR;0;2021-03-31;263046;73725;4;0;0;8871676;2914565;111;1;0
FR;0;2021-04-01;315522;91651;11;0;0;9187198;3006216;122;1;0
FR;0;2021-04-02;281352;94075;7;0;0;9468550;3100291;129;1;0
FR;0;2021-04-03;141079;62347;6;0;0;9609629;3162638;135;1;0
FR;0;2021-04-04;46532;18941;2;0;0;9656161;3181579;137;1;0
FR;0;2021-04-05;63345;10568;11;0;0;9719506;3192147;148;1;0
FR;0;2021-04-06;217230;111675;17;0;0;9936736;3303822;165;1;0
FR;0;2021-04-07;260266;115313;17;0;0;10197002;3419135;182;1;0
FR;0;2021-04-08;337852;122558;14;0;0;10534854;3541693;196;1;0
FR;0;2021-04-09;410166;116657;49;0;0;10945020;3658350;245;1;0
FR;0;2021-04-10;212631;82786;15;0;0;11157651;3741136;260;1;0
FR;0;2021-04-11;56150;34240;7;0;0;11213801;3775376;267;1;0
FR;0;2021-04-12;237084;115660;46;0;0;11450885;3891036;313;1;0
FR;0;2021-04-13;309498;144316;98;1;0;11760383;4035352;411;2;0
FR;0;2021-04-14;294540;139557;215;0;0;12054923;4174909;626;2;0
FR;0;2021-04-15;337120;149736;339;0;0;12392043;4324645;965;2;0
FR;0;2021-04-16;339303;146481;354;0;0;12731346;4471126;1319;2;0
FR;0;2021-04-17;188666;90004;109;0;0;12920012;4561130;1428;2;0
FR;0;2021-04-18;51622;35411;47;0;0;12971634;4596541;1475;2;0
FR;0;2021-04-19;205711;138211;456;0;0;13177345;4734752;1931;2;0
FR;0;2021-04-20;254431;171481;569;0;0;13431776;4906233;2500;2;0
FR;0;2021-04-21;253281;169566;835;0;0;13685057;5075799;3335;2;0
FR;0;2021-04-22;287573;189740;818;0;0;13972630;5265539;4153;2;0
FR;0;2021-04-23;297799;184054;747;0;0;14270429;5449593;4900;2;0
FR;0;2021-04-24;190458;111829;252;0;0;14460887;5561422;5152;2;0
FR;0;2021-04-25;69563;38800;51;0;0;14530450;5600222;5203;2;0
FR;0;2021-04-26;220970;157610;563;0;0;14751420;5757832;5766;2;0
FR;0;2021-04-27;284620;187713;940;0;0;15036040;5945545;6706;2;0
FR;0;2021-04-28;299512;184060;1426;1;1;15335552;6129605;8132;3;1
FR;0;2021-04-29;357141;197425;1280;0;0;15692693;6327030;9412;3;1
FR;0;2021-04-30;372228;185519;1121;1;0;16064921;6512549;10533;4;1
FR;0;2021-05-01;167648;52496;179;0;0;16232569;6565045;10712;4;1
FR;0;2021-05-02;91748;37801;83;0;0;16324317;6602846;10795;4;1
FR;0;2021-05-03;288935;166817;843;0;0;16613252;6769663;11638;4;1
FR;0;2021-05-04;315684;225071;1233;0;0;16928936;6994734;12871;4;1
FR;0;2021-05-05;327206;225779;1315;0;0;17256142;7220513;14186;4;1
FR;0;2021-05-06;379529;240388;1633;0;0;17635671;7460901;15819;4;1
FR;0;2021-05-07;372765;258068;1223;0;0;18008436;7718969;17042;4;1
FR;0;2021-05-08;222166;69958;299;0;0;18230602;7788927;17341;4;1
FR;0;2021-05-09;129705;45330;243;0;0;18360307;7834257;17584;4;1
FR;0;2021-05-10;313392;229285;1237;0;0;18673699;8063542;18821;4;1
FR;0;2021-05-11;403916;258041;1566;0;0;19077615;8321583;20387;4;1
FR;0;2021-05-12;434124;233515;1542;0;0;19511739;8555098;21929;4;1
FR;0;2021-05-13;338611;56639;432;0;0;19850350;8611737;22361;4;1
FR;0;2021-05-14;454140;167409;1126;0;0;20304490;8779146;23487;4;1
FR;0;2021-05-15;374980;94247;443;0;0;20679470;8873393;23930;4;1
FR;0;2021-05-16;202758;20707;168;0;0;20882228;8894100;24098;4;1
FR;0;2021-05-17;376125;148743;1555;0;0;21258353;9042843;25653;4;1
FR;0;2021-05-18;460156;153716;1990;0;0;21718509;9196559;27643;4;1
FR;0;2021-05-19;467415;143455;2464;0;0;22185924;9340014;30107;4;1
FR;0;2021-05-20;507540;160330;2339;0;0;22693464;9500344;32446;4;1
FR;0;2021-05-21;489674;174924;1996;0;0;23183138;9675268;34442;4;1
FR;0;2021-05-22;347195;80079;668;0;0;23530333;9755347;35110;4;1
FR;0;2021-05-23;161692;14260;246;0;0;23692025;9769607;35356;4;1
FR;0;2021-05-24;263194;33135;604;0;0;23955219;9802742;35960;4;1
FR;0;2021-05-25;400281;190029;2355;1;0;24355500;9992771;38315;5;1
FR;0;2021-05-26;413460;190021;2224;0;0;24768960;10182792;40539;5;1
FR;0;2021-05-27;449816;219498;2162;0;0;25218776;10402290;42701;5;1
FR;0;2021-05-28;429554;260431;1893;0;0;25648330;10662721;44594;5;1
FR;0;2021-05-29;298984;150034;585;0;0;25947314;10812755;45179;5;1
FR;0;2021-05-30;107143;32545;163;0;0;26054457;10845300;45342;5;1
FR;0;2021-05-31;358041;203327;1469;1;1;26412498;11048627;46811;6;2
FR;0;2021-06-01;431038;251370;1962;1;1;26843536;11299997;48773;7;3
FR;0;2021-06-02;420117;231845;1984;0;0;27263653;11531842;50757;7;3
FR;0;2021-06-03;465623;257922;1825;0;0;27729276;11789764;52582;7;3
FR;0;2021-06-04;456258;305438;1734;1;1;28185534;12095202;54316;8;4
FR;0;2021-06-05;304808;189295;652;0;0;28490342;12284497;54968;8;4
FR;0;2021-06-06;133313;49047;226;0;0;28623655;12333544;55194;8;4
FR;0;2021-06-07;339988;261624;1526;0;0;28963643;12595168;56720;8;4
FR;0;2021-06-08;393891;291172;1803;0;0;29357534;12886340;58523;8;4
FR;0;2021-06-09;384880;274532;1732;0;0;29742414;13160872;60255;8;4
FR;0;2021-06-10;404191;288079;1725;1;0;30146605;13448951;61980;9;4
FR;0;2021-06-11;386665;356716;1467;1;0;30533270;13805667;63447;10;4
FR;0;2021-06-12;283266;211090;495;0;0;30816536;14016757;63942;10;4
FR;0;2021-06-13;104889;73862;204;0;0;30921425;14090619;64146;10;4
FR;0;2021-06-14;240843;354595;1427;1;0;31162268;14445214;65573;11;4
FR;0;2021-06-15;308170;384926;1571;1;0;31470438;14830140;67144;12;4
FR;0;2021-06-16;313981;357545;1418;1;0;31784419;15187685;68562;13;4
FR;0;2021-06-17;317694;372848;1427;1;0;32102113;15560533;69989;14;4
FR;0;2021-06-18;321751;442614;1338;1;0;32423864;16003147;71327;15;4
FR;0;2021-06-19;224346;273884;449;0;0;32648210;16277031;71776;15;4
FR;0;2021-06-20;74436;102409;129;0;0;32722646;16379440;71905;15;4
FR;0;2021-06-21;195774;401692;1037;1;1;32918420;16781132;72942;16;5
FR;0;2021-06-22;223204;467530;1266;10;1;33141624;17248662;74208;26;6
FR;0;2021-06-23;234037;439975;1197;1;1;33375661;17688637;75405;27;7
FR;0;2021-06-24;241869;409602;1357;0;0;33617530;18098239;76762;27;7
FR;0;2021-06-25;227647;522778;1401;0;0;33845177;18621017;78163;27;7
FR;0;2021-06-26;153259;370837;587;1;0;33998436;18991854;78750;28;7
FR;0;2021-06-27;55904;156071;168;1;0;34054340;19147925;78918;29;7
FR;0;2021-06-28;154780;452682;1176;0;0;34209120;19600607;80094;29;7
FR;0;2021-06-29;182714;507395;2123;0;0;34391834;20108002;82217;29;7
FR;0;2021-06-30;204012;485116;2014;21;2;34595846;20593118;84231;50;9
FR;0;2021-07-01;231337;458188;2223;5;1;34827183;21051306;86454;55;10
FR;0;2021-07-02;228696;520133;2120;5;2;35055879;21571439;88574;60;12
FR;0;2021-07-03;142041;368745;908;3;1;35197920;21940184;89482;63;13
FR;0;2021-07-04;56756;141065;265;0;0;35254676;22081249;89747;63;13
FR;0;2021-07-05;168521;418972;1668;8;2;35423197;22500221;91415;71;15
FR;0;2021-07-06;196775;474614;1830;45;8;35619972;22974835;93245;116;23
FR;0;2021-07-07;213202;439157;1879;25;4;35833174;23413992;95124;141;27
FR;0;2021-07-08;231646;424192;2089;20;6;36064820;23838184;97213;161;33
FR;0;2021-07-09;228617;511027;2185;4;2;36293437;24349211;99398;165;35
FR;0;2021-07-10;148621;339906;984;1;1;36442058;24689117;100382;166;36
FR;0;2021-07-11;60201;110094;283;0;0;36502259;24799211;100665;166;36
FR;0;2021-07-12;169419;477972;1762;4;0;36671678;25277183;102427;170;36
FR;0;2021-07-13;287268;527008;2048;8;1;36958946;25804191;104475;178;37
FR;0;2021-07-14;181104;157498;435;0;0;37140050;25961689;104910;178;37
FR;0;2021-07-15;347098;502028;2099;1;0;37487148;26463717;107009;179;37
FR;0;2021-07-16;380107;495446;2023;3;1;37867255;26959163;109032;182;38
FR;0;2021-07-17;259734;319710;877;1;0;38126989;27278873;109909;183;38
FR;0;2021-07-18;109713;114630;310;0;0;38236702;27393503;110219;183;38
FR;0;2021-07-19;285476;424360;1629;3;0;38522178;27817863;111848;186;38
FR;0;2021-07-20;376918;451727;1723;0;0;38899096;28269590;113571;186;38
FR;0;2021-07-21;395800;407293;1549;4;2;39294896;28676883;115120;190;40
FR;0;2021-07-22;441056;387612;1715;4;2;39735952;29064495;116835;194;42
FR;0;2021-07-23;440327;422494;1882;4;1;40176279;29486989;118717;198;43
FR;0;2021-07-24;285251;269410;804;1;0;40461530;29756399;119521;199;43
FR;0;2021-07-25;121113;79950;234;0;0;40582643;29836349;119755;199;43
FR;0;2021-07-26;347424;322567;1614;3;2;40930067;30158916;121369;202;45
FR;0;2021-07-27;464068;319640;1698;4;2;41394135;30478556;123067;206;47
FR;0;2021-07-28;459440;289570;1636;4;1;41853575;30768126;124703;210;48
FR;0;2021-07-29;489825;276458;1796;2;0;42343400;31044584;126499;212;48
FR;0;2021-07-30;461828;302545;1941;5;1;42805228;31347129;128440;217;49
FR;0;2021-07-31;285399;185064;914;1;0;43090627;31532193;129354;218;49
FR;0;2021-08-01;112024;49926;253;0;0;43202651;31582119;129607;218;49
FR;0;2021-08-02;341621;234222;1602;2;0;43544272;31816341;131209;220;49
FR;0;2021-08-03;398612;244663;1728;2;1;43942884;32061004;132937;222;50
FR;0;2021-08-04;384850;209723;1593;6;3;44327734;32270727;134530;228;53
FR;0;2021-08-05;366168;228552;1710;0;0;44693902;32499279;136240;228;53
FR;0;2021-08-06;359729;271423;1835;4;1;45053631;32770702;138075;232;54
FR;0;2021-08-07;213123;178346;755;5;2;45266754;32949048;138830;237;56
FR;0;2021-08-08;74194;63195;275;0;0;45340948;33012243;139105;237;56
FR;0;2021-08-09;258756;258926;1547;4;3;45599704;33271169;140652;241;59
FR;0;2021-08-10;306862;277412;1662;2;1;45906566;33548581;142314;243;60
FR;0;2021-08-11;279739;259803;1441;5;1;46186305;33808384;143755;248;61
FR;0;2021-08-12;271548;278252;1663;3;0;46457853;34086636;145418;251;61
FR;0;2021-08-13;252157;278129;1594;3;2;46710010;34364765;147012;254;63
FR;0;2021-08-14;145343;197147;741;0;0;46855353;34561912;147753;254;63
FR;0;2021-08-15;39385;50109;217;1;0;46894738;34612021;147970;255;63
FR;0;2021-08-16;186185;317720;1542;0;0;47080923;34929741;149512;255;63
FR;0;2021-08-17;215689;336056;1636;7;0;47296612;35265797;151148;262;63
FR;0;2021-08-18;199053;324546;1597;7;4;47495665;35590343;152745;269;67
FR;0;2021-08-19;192032;325542;1640;1;0;47687697;35915885;154385;270;67
FR;0;2021-08-20;186463;366324;1820;3;2;47874160;36282209;156205;273;69
FR;0;2021-08-21;104798;238125;708;0;0;47978958;36520334;156913;273;69
FR;0;2021-08-22;31943;87210;256;1;1;48010901;36607544;157169;274;70
FR;0;2021-08-23;140982;357107;1561;3;1;48151883;36964651;158730;277;71
FR;0;2021-08-24;162493;376735;1849;5;1;48314376;37341386;160579;282;72
FR;0;2021-08-25;151140;350816;2033;8;2;48465516;37692202;162612;290;74
FR;0;2021-08-26;142877;342789;2560;10;0;48608393;38034991;165172;300;74
FR;0;2021-08-27;148452;388307;2789;11;3;48756845;38423298;167961;311;77
FR;0;2021-08-28;90665;249606;1406;0;0;48847510;38672904;169367;311;77
FR;0;2021-08-29;27319;83346;518;1;0;48874829;38756250;169885;312;77
FR;0;2021-08-30;117419;324698;4712;6;5898;48992248;39080948;174597;318;5975
FR;0;2021-08-31;128810;334517;10188;19;11802;49121058;39415465;184785;337;17777
FR;0;2021-09-01;136140;285695;22433;7;24381;49257198;39701160;207218;344;42158
FR;0;2021-09-02;114660;247244;26516;20;28974;49371858;39948404;233734;364;71132
FR;0;2021-09-03;118311;292692;29963;24;33051;49490169;40241096;263697;388;104183
FR;0;2021-09-04;89890;217772;12586;12;14127;49580059;40458868;276283;400;118310
FR;0;2021-09-05;21359;44835;4395;2;4718;49601418;40503703;280678;402;123028
FR;0;2021-09-06;75682;180632;31955;16;34299;49677100;40684335;312633;418;157327
FR;0;2021-09-07;80303;181234;33244;43;36251;49757403;40865569;345877;461;193578
FR;0;2021-09-08;90992;206096;29664;28;32530;49848395;41071665;375541;489;226108
FR;0;2021-09-09;76944;165358;33066;27;36634;49925339;41237023;408607;516;262742
FR;0;2021-09-10;96037;203794;35739;28;40681;50021376;41440817;444346;544;303423
FR;0;2021-09-11;67161;169299;12137;19;14378;50088537;41610116;456483;563;317801
FR;0;2021-09-12;12826;32099;2778;1;3178;50101363;41642215;459261;564;320979
FR;0;2021-09-13;64561;126242;41231;35;44180;50165924;41768457;500492;599;365159
FR;0;2021-09-14;73491;129067;56373;80;62300;50239415;41897524;556865;679;427459
FR;0;2021-09-15;76639;167815;55664;58;54844;50316054;42065339;612529;737;482303
FR;0;2021-09-16;63881;114534;60089;82;60124;50379935;42179873;672618;819;542427
FR;0;2021-09-17;75082;156841;53852;71;57303;50455017;42336714;726470;890;599730
FR;0;2021-09-18;48235;139631;15601;25;17312;50503252;42476345;742071;915;617042
FR;0;2021-09-19;7907;23680;2438;1;2619;50511159;42500025;744509;916;619661
FR;0;2021-09-20;44568;93825;50081;72;50334;50555727;42593850;794590;988;669995
FR;0;2021-09-21;45893;98435;62761;75;63466;50601620;42692285;857351;1063;733461
FR;0;2021-09-22;48673;142407;55369;82;55436;50650293;42834692;912720;1145;788897
FR;0;2021-09-23;43272;92106;62391;95;63562;50693565;42926798;975111;1240;852459
FR;0;2021-09-24;52294;133309;54555;107;59187;50745859;43060107;1029666;1347;911646
FR;0;2021-09-25;35216;115636;16274;36;18299;50781075;43175743;1045940;1383;929945
FR;0;2021-09-26;5547;17806;2270;5;2327;50786622;43193549;1048210;1388;932272
FR;0;2021-09-27;33975;76943;47200;97;48181;50820597;43270492;1095410;1485;980453
FR;0;2021-09-28;36518;75258;54966;90;56547;50857115;43345750;1150376;1575;1037000
FR;0;2021-09-29;44415;100781;53353;112;54867;50901530;43446531;1203729;1687;1091867
FR;0;2021-09-30;36340;72967;57037;97;59578;50937870;43519498;1260766;1784;1151445
FR;0;2021-10-01;61703;102895;57813;108;63951;50999573;43622393;1318579;1892;1215396
FR;0;2021-10-02;39470;78440;20962;39;23360;51039043;43700833;1339541;1931;1238756
FR;0;2021-10-03;5287;10499;2532;4;2540;51044330;43711332;1342073;1935;1241296
FR;0;2021-10-04;35187;58526;52622;84;54834;51079517;43769858;1394695;2019;1296130
FR;0;2021-10-05;33927;64381;61014;135;65067;51113444;43834239;1455709;2154;1361197
FR;0;2021-10-06;42714;79322;65748;113;68334;51156158;43913561;1521457;2267;1429531
FR;0;2021-10-07;30563;62276;65431;90;68845;51186721;43975837;1586888;2357;1498376
FR;0;2021-10-08;49469;91922;77755;110;84734;51236190;44067759;1664643;2467;1583110
FR;0;2021-10-09;33673;60939;31544;35;33923;51269863;44128698;1696187;2502;1617033
FR;0;2021-10-10;4717;7437;3194;9;3481;51274580;44136135;1699381;2511;1620514
FR;0;2021-10-11;30724;49941;61042;105;64102;51305304;44186076;1760423;2616;1684616
FR;0;2021-10-12;31633;54495;70620;140;75983;51336937;44240571;1831043;2756;1760599
FR;0;2021-10-13;40147;62840;74431;136;79343;51377084;44303411;1905474;2892;1839942
FR;0;2021-10-14;30356;52903;68764;116;73827;51407440;44356314;1974238;3008;1913769
FR;0;2021-10-15;44943;75274;93242;191;103005;51452383;44431588;2067480;3199;2016774
FR;0;2021-10-16;31327;44119;36694;44;39643;51483710;44475707;2104174;3243;2056417
FR;0;2021-10-17;3888;5239;3597;2;3683;51487598;44480946;2107771;3245;2060100
FR;0;2021-10-18;29122;42385;67499;133;71360;51516720;44523331;2175270;3378;2131460
FR;0;2021-10-19;27154;45577;76408;140;81639;51543874;44568908;2251678;3518;2213099
FR;0;2021-10-20;35308;52461;96942;181;101553;51579182;44621369;2348620;3699;2314652
FR;0;2021-10-21;26138;45179;83970;112;89144;51605320;44666548;2432590;3811;2403796
FR;0;2021-10-22;38420;62518;104901;200;112601;51643740;44729066;2537491;4011;2516397
FR;0;2021-10-23;27009;41213;45456;57;48626;51670749;44770279;2582947;4068;2565023
FR;0;2021-10-24;2920;4771;3682;6;3930;51673669;44775050;2586629;4074;2568953
FR;0;2021-10-25;26077;36266;82332;144;86647;51699746;44811316;2668961;4218;2655600
FR;0;2021-10-26;23733;35048;87255;166;92377;51723479;44846364;2756216;4384;2747977
FR;0;2021-10-27;30082;46356;109008;257;114706;51753561;44892720;2865224;4641;2862683
FR;0;2021-10-28;23582;34972;88721;153;94492;51777143;44927692;2953945;4794;2957175
FR;0;2021-10-29;31575;51492;117324;205;125362;51808718;44979184;3071269;4999;3082537
FR;0;2021-10-30;20555;33233;50349;76;53398;51829273;45012417;3121618;5075;3135935
FR;0;2021-10-31;2489;3733;3591;3;3879;51831762;45016150;3125209;5078;3139814
FR;0;2021-11-01;8496;4863;3211;3;3574;51840258;45021013;3128420;5081;3143388
FR;0;2021-11-02;26346;40126;93587;156;99610;51866604;45061139;3222007;5237;3242998
FR;0;2021-11-03;30092;47969;118903;218;125856;51896696;45109108;3340910;5455;3368854
FR;0;2021-11-04;23790;37520;107574;217;114439;51920486;45146628;3448484;5672;3483293
FR;0;2021-11-05;32390;52985;141648;235;151397;51952876;45199613;3590132;5907;3634690
FR;0;2021-11-06;21531;34579;64886;123;68312;51974407;45234192;3655018;6030;3703002
FR;0;2021-11-07;2402;4180;5197;6;5596;51976809;45238372;3660215;6036;3708598
FR;0;2021-11-08;20594;37787;127207;227;134319;51997403;45276159;3787422;6263;3842917
FR;0;2021-11-09;22405;44733;161699;339;172274;52019808;45320892;3949121;6602;4015191
FR;0;2021-11-10;31587;55040;187023;446;198831;52051395;45375932;4136144;7048;4214022
FR;0;2021-11-11;4723;6755;12975;28;13958;52056118;45382687;4149119;7076;4227980
FR;0;2021-11-12;29082;55132;183787;252;197410;52085200;45437819;4332906;7328;4425390
FR;0;2021-11-13;20349;32641;80709;118;86334;52105549;45470460;4413615;7446;4511724
FR;0;2021-11-14;2358;3880;7176;6;7848;52107907;45474340;4420791;7452;4519572
FR;0;2021-11-15;20484;38682;160869;312;171594;52128391;45513022;4581660;7764;4691166
FR;0;2021-11-16;23644;43978;200431;393;215075;52152035;45557000;4782091;8157;4906241
FR;0;2021-11-17;30513;50348;199864;406;212909;52182548;45607348;4981955;8563;5119150
FR;0;2021-11-18;23435;45682;191690;468;205603;52205983;45653030;5173645;9031;5324753
FR;0;2021-11-19;33675;61399;243233;551;262223;52239658;45714429;5416878;9582;5586976
FR;0;2021-11-20;25407;36698;102164;206;109709;52265065;45751127;5519042;9788;5696685
FR;0;2021-11-21;2646;4472;9658;19;10612;52267711;45755599;5528700;9807;5707297
FR;0;2021-11-22;22804;33234;180391;470;194875;52290515;45788833;5709091;10277;5902172
FR;0;2021-11-23;25717;45584;229398;549;247865;52316232;45834417;5938489;10826;6150037
FR;0;2021-11-24;31799;53735;224828;715;243262;52348031;45888152;6163317;11541;6393299
FR;0;2021-11-25;25637;49245;255953;739;277821;52373668;45937397;6419270;12280;6671120
FR;0;2021-11-26;33257;74856;379508;866;414674;52406925;46012253;6798778;13146;7085794
FR;0;2021-11-27;23491;49681;214920;389;236701;52430416;46061934;7013698;13535;7322495
FR;0;2021-11-28;3513;10523;56762;66;63325;52433929;46072457;7070460;13601;7385820
FR;0;2021-11-29;19422;54197;341491;863;371754;52453351;46126654;7411951;14464;7757574
FR;0;2021-11-30;24779;72021;457408;988;500817;52478130;46198675;7869359;15452;8258391
FR;0;2021-12-01;27371;75797;469128;1161;511365;52505501;46274472;8338487;16613;8769756
FR;0;2021-12-02;22096;71813;527137;1280;574925;52527597;46346285;8865624;17893;9344681
FR;0;2021-12-03;25558;93132;596429;1420;651211;52553155;46439417;9462053;19313;9995892
FR;0;2021-12-04;18318;60502;336241;690;369807;52571473;46499919;9798294;20003;10365699
FR;0;2021-12-05;4154;16180;95786;157;107053;52575627;46516099;9894080;20160;10472752
FR;0;2021-12-06;28421;72994;493173;1174;540005;52604048;46589093;10387253;21334;11012757
FR;0;2021-12-07;23539;91483;645420;1773;706364;52627587;46680576;11032673;23107;11719121
FR;0;2021-12-08;25503;92245;591628;1874;647549;52653090;46772821;11624301;24981;12366670
FR;0;2021-12-09;24059;94257;663145;2180;726507;52677149;46867078;12287446;27161;13093177
FR;0;2021-12-10;28053;111163;736096;2075;806263;52705202;46978241;13023542;29236;13899440
FR;0;2021-12-11;20251;76228;435198;988;480412;52725453;47054469;13458740;30224;14379852
FR;0;2021-12-12;5656;23212;142314;262;159216;52731109;47077681;13601054;30486;14539068
FR;0;2021-12-13;21352;91018;587688;1699;649299;52752461;47168699;14188742;32185;15188367
FR;0;2021-12-14;27969;118559;765620;2654;847585;52780430;47287258;14954362;34839;16035952
FR;0;2021-12-15;28432;114484;694372;2266;769143;52808862;47401742;15648734;37105;16805095
FR;0;2021-12-16;28031;115970;764062;2557;844480;52836893;47517712;16412796;39662;17649575
FR;0;2021-12-17;31649;128643;807908;2711;892087;52868542;47646355;17220704;42373;18541662
FR;0;2021-12-18;24934;81683;469983;1178;522233;52893476;47728038;17690687;43551;19063895
FR;0;2021-12-19;8756;28676;169399;376;191084;52902232;47756714;17860086;43927;19254979
FR;0;2021-12-20;31751;97427;591512;1786;658782;52933983;47854141;18451598;45713;19913761
FR;0;2021-12-21;39456;112216;682432;2392;759622;52973439;47966357;19134030;48105;20673383
FR;0;2021-12-22;39551;99477;575789;2168;642159;53012990;48065834;19709819;50273;21315542
FR;0;2021-12-23;33778;79644;441025;1657;494420;53046768;48145478;20150844;51930;21809962
FR;0;2021-12-24;10692;26125;111033;398;126675;53057460;48171603;20261877;52328;21936637
FR;0;2021-12-25;774;3588;7591;25;9030;53058234;48175191;20269468;52353;21945667
FR;0;2021-12-26;4695;11903;52095;142;60144;53062929;48187094;20321563;52495;22005811
FR;0;2021-12-27;30505;84073;453564;1364;509184;53093434;48271167;20775127;53859;22514995
FR;0;2021-12-28;38364;99053;564178;1769;632284;53131798;48370220;21339305;55628;23147279
FR;0;2021-12-29;39875;88405;501213;1687;561021;53171673;48458625;21840518;57315;23708300
FR;0;2021-12-30;35920;75250;421037;1521;471157;53207593;48533875;22261555;58836;24179457
FR;0;2021-12-31;12046;25154;116882;405;131672;53219639;48559029;22378437;59241;24311129
FR;0;2022-01-01;1574;3211;8516;37;9937;53221213;48562240;22386953;59278;24321066
FR;0;2022-01-02;6115;13001;58419;125;66946;53227328;48575241;22445372;59403;24388012
FR;0;2022-01-03;37088;90295;494833;1593;551717;53264416;48665536;22940205;60996;24939729
FR;0;2022-01-04;41973;111156;641392;2306;714385;53306389;48776692;23581597;63302;25654114
FR;0;2022-01-05;61085;103760;569182;1984;634216;53367474;48880452;24150779;65286;26288330
FR;0;2022-01-06;44264;110420;638980;2697;711454;53411738;48990872;24789759;67983;26999784
FR;0;2022-01-07;50821;123471;710996;2810;790515;53462559;49114343;25500755;70793;27790299
FR;0;2022-01-08;45008;80329;423811;1213;472887;53507567;49194672;25924566;72006;28263186
FR;0;2022-01-09;15609;26643;128565;300;145676;53523176;49221315;26053131;72306;28408862
FR;0;2022-01-10;35377;93436;469329;1812;522756;53558553;49314751;26522460;74118;28931618
FR;0;2022-01-11;41925;100569;548250;2306;608506;53600478;49415320;27070710;76424;29540124
FR;0;2022-01-12;60382;95801;452678;1968;504343;53660860;49511121;27523388;78392;30044467
FR;0;2022-01-13;38237;92638;487352;2085;541048;53699097;49603759;28010740;80477;30585515
FR;0;2022-01-14;42572;103452;568600;2286;629017;53741669;49707211;28579340;82763;31214532
FR;0;2022-01-15;39417;65934;340133;985;377559;53781086;49773145;28919473;83748;31592091
FR;0;2022-01-16;11408;19262;87431;216;99426;53792494;49792407;29006904;83964;31691517
FR;0;2022-01-17;24732;60144;320280;1382;354166;53817226;49852551;29327184;85346;32045683
FR;0;2022-01-18;28316;68762;361084;1802;397560;53845542;49921313;29688268;87148;32443243
FR;0;2022-01-19;43211;67108;281295;1450;311080;53888753;49988421;29969563;88598;32754323
FR;0;2022-01-20;23659;59688;299008;1740;328512;53912412;50048109;30268571;90338;33082835
FR;0;2022-01-21;28201;68900;366363;2086;401199;53940613;50117009;30634934;92424;33484034
FR;0;2022-01-22;27623;48008;218789;839;241766;53968236;50165017;30853723;93263;33725800
FR;0;2022-01-23;6731;12990;48676;173;55170;53974967;50178007;30902399;93436;33780970
FR;0;2022-01-24;16269;47494;217312;1139;239338;53991236;50225501;31119711;94575;34020308
FR;0;2022-01-25;19024;54415;243052;1546;267087;54010260;50279916;31362763;96121;34287395
FR;0;2022-01-26;28145;60501;209283;1297;229482;54038405;50340417;31572046;97418;34516877
FR;0;2022-01-27;16325;46376;207645;1277;225960;54054730;50386793;31779691;98695;34742837
FR;0;2022-01-28;21581;78622;290053;1572;321387;54076311;50465415;32069744;100267;35064224
FR;0;2022-01-29;18420;52896;184127;688;204583;54094731;50518311;32253871;100955;35268807
FR;0;2022-01-30;4473;14507;39141;124;45085;54099204;50532818;32293012;101079;35313892
FR;0;2022-01-31;11257;43964;148197;741;164770;54110461;50576782;32441209;101820;35478662
FR;0;2022-02-01;13608;48386;174121;1143;191407;54124069;50625168;32615330;102963;35670069
FR;0;2022-02-02;20560;66383;171528;1034;190119;54144629;50691551;32786858;103997;35860188
FR;0;2022-02-03;11463;44787;157554;989;173323;54156092;50736338;32944412;104986;36033511
FR;0;2022-02-04;14622;66512;239249;1266;264157;54170714;50802850;33183661;106252;36297668
FR;0;2022-02-05;12897;51484;153548;523;172330;54183611;50854334;33337209;106775;36469998
FR;0;2022-02-06;2722;12185;28890;101;33836;54186333;50866519;33366099;106876;36503834
FR;0;2022-02-07;9558;46696;156866;591;176304;54195891;50913215;33522965;107467;36680138
FR;0;2022-02-08;9795;43075;166620;867;184413;54205686;50956290;33689585;108334;36864551
FR;0;2022-02-09;14372;58240;172336;871;193044;54220058;51014530;33861921;109205;37057595
FR;0;2022-02-10;8714;39111;150229;878;166703;54228772;51053641;34012150;110083;37224298
FR;0;2022-02-11;10856;55664;218503;1101;243096;54239628;51109305;34230653;111184;37467394
FR;0;2022-02-12;8389;40953;134722;464;151750;54248017;51150258;34365375;111648;37619144
FR;0;2022-02-13;1901;8600;26564;86;30924;54249918;51158858;34391939;111734;37650068
FR;0;2022-02-14;6986;35237;148366;482;166361;54256904;51194095;34540305;112216;37816429
FR;0;2022-02-15;7052;36211;146976;751;162562;54263956;51230306;34687281;112967;37978991
FR;0;2022-02-16;9404;42966;132531;720;146750;54273360;51273272;34819812;113687;38125741
FR;0;2022-02-17;5574;24318;87297;585;94871;54278934;51297590;34907109;114272;38220612
FR;0;2022-02-18;6993;33569;119657;804;129322;54285927;51331159;35026766;115076;38349934
FR;0;2022-02-19;5369;24548;70023;370;77333;54291296;51355707;35096789;115446;38427267
FR;0;2022-02-20;1145;4650;12171;39;13950;54292441;51360357;35108960;115485;38441217
FR;0;2022-02-21;4090;17881;61951;351;67178;54296531;51378238;35170911;115836;38508395
FR;0;2022-02-22;4449;18646;60830;576;64470;54300980;51396884;35231741;116412;38572865
FR;0;2022-02-23;6587;27344;66493;591;71890;54307567;51424228;35298234;117003;38644755
FR;0;2022-02-24;3848;15467;50421;518;53242;54311415;51439695;35348655;117521;38697997
FR;0;2022-02-25;5278;24036;76358;803;80091;54316693;51463731;35425013;118324;38778088
FR;0;2022-02-26;3990;17764;47414;359;51481;54320683;51481495;35472427;118683;38829569
FR;0;2022-02-27;879;3007;8035;47;8946;54321562;51484502;35480462;118730;38838515
FR;0;2022-02-28;3123;12535;40480;359;42914;54324685;51497037;35520942;119089;38881429
FR;0;2022-03-01;3954;12599;44187;436;44858;54328639;51509636;35565129;119525;38926287
FR;0;2022-03-02;5308;17789;47132;445;49065;54333947;51527425;35612261;119970;38975352
FR;0;2022-03-03;2813;9334;29890;368;30013;54336760;51536759;35642151;120338;39005365
FR;0;2022-03-04;3223;12410;40301;665;39451;54339983;51549169;35682452;121003;39044816
FR;0;2022-03-05;3070;9278;24953;309;25115;54343053;51558447;35707405;121312;39069931
FR;0;2022-03-06;520;1399;3197;43;3440;54343573;51559846;35710602;121355;39073371
FR;0;2022-03-07;2311;5621;18427;315;17696;54345884;51565467;35729029;121670;39091067
FR;0;2022-03-08;2106;6071;19446;360;17915;54347990;51571538;35748475;122030;39108982
FR;0;2022-03-09;3570;10500;22180;405;21278;54351560;51582038;35770655;122435;39130260
FR;0;2022-03-10;1820;5784;16982;343;15809;54353380;51587822;35787637;122778;39146069
FR;0;2022-03-11;2413;7548;24494;541;22260;54355793;51595370;35812131;123319;39168329
FR;0;2022-03-12;2672;6773;17158;308;16513;54358465;51602143;35829289;123627;39184842
FR;0;2022-03-13;394;788;2323;149;2271;54358859;51602931;35831612;123776;39187113
FR;0;2022-03-14;1540;4267;14976;4409;13830;54360399;51607198;35846588;128185;39200943
FR;0;2022-03-15;1727;6280;16371;7552;14599;54362126;51613478;35862959;135737;39215542
FR;0;2022-03-16;3025;7390;19423;13136;18100;54365151;51620868;35882382;148873;39233642
FR;0;2022-03-17;1451;3976;13141;10847;11984;54366602;51624844;35895523;159720;39245626
FR;0;2022-03-18;2266;5751;19998;18298;18093;54368868;51630595;35915521;178018;39263719
FR;0;2022-03-19;2289;4802;13114;9401;12416;54371157;51635397;35928635;187419;39276135
FR;0;2022-03-20;300;733;1918;1073;1929;54371457;51636130;35930553;188492;39278064
FR;0;2022-03-21;1391;3212;12718;14937;11940;54372848;51639342;35943271;203429;39290004
FR;0;2022-03-22;1503;3729;13793;20538;12550;54374351;51643071;35957064;223967;39302554
FR;0;2022-03-23;2678;6274;17719;23150;17234;54377029;51649345;35974783;247117;39319788
FR;0;2022-03-24;1401;3153;11588;17607;10674;54378430;51652498;35986371;264724;39330462
FR;0;2022-03-25;2081;5149;18562;27757;16901;54380511;51657647;36004933;292481;39347363
FR;0;2022-03-26;2229;4411;12077;12678;11517;54382740;51662058;36017010;305159;39358880
FR;0;2022-03-27;360;689;1906;1481;1940;54383100;51662747;36018916;306640;39360820
FR;0;2022-03-28;1460;3072;11122;17487;10614;54384560;51665819;36030038;324127;39371434
FR;0;2022-03-29;1451;3267;12900;27561;12041;54386011;51669086;36042938;351688;39383475
FR;0;2022-03-30;2847;5491;15677;27369;15069;54388858;51674577;36058615;379057;39398544
FR;0;2022-03-31;1609;3561;12975;24971;12309;54390467;51678138;36071590;404028;39410853
FR;0;2022-04-01;2674;4579;20049;30869;18691;54393141;51682717;36091639;434897;39429544
FR;0;2022-04-02;1524;2635;9046;10115;8704;54394665;51685352;36100685;445012;39438248
FR;0;2022-04-03;287;513;1561;1169;1578;54394952;51685865;36102246;446181;39439826
FR;0;2022-04-04;2108;2867;12364;19097;11570;54397060;51688732;36114610;465278;39451396
FR;0;2022-04-05;1957;3137;14331;34085;13183;54399017;51691869;36128941;499363;39464579
FR;0;2022-04-06;2329;3916;13529;26474;12797;54401346;51695785;36142470;525837;39477376
FR;0;2022-04-07;1563;3090;13663;33755;12875;54402909;51698875;36156133;559592;39490251
FR;0;2022-04-08;2071;4225;19210;43914;17814;54404980;51703100;36175343;603506;39508065
FR;0;2022-04-09;1363;2674;9311;13560;8863;54406343;51705774;36184654;617066;39516928
FR;0;2022-04-10;289;658;1982;2014;2002;54406632;51706432;36186636;619080;39518930
FR;0;2022-04-11;1300;2596;11863;23880;11466;54407932;51709028;36198499;642960;39530396
FR;0;2022-04-12;1672;3014;14011;40883;13382;54409604;51712042;36212510;683843;39543778
FR;0;2022-04-13;1947;3665;13404;33072;13020;54411551;51715707;36225914;716915;39556798
FR;0;2022-04-14;1488;2885;13180;36254;13026;54413039;51718592;36239094;753169;39569824
FR;0;2022-04-15;1849;3446;15618;35501;14865;54414888;51722038;36254712;788670;39584689
FR;0;2022-04-16;1041;1827;6395;8535;6251;54415929;51723865;36261107;797205;39590940
FR;0;2022-04-17;193;331;992;1172;1035;54416122;51724196;36262099;798377;39591975
FR;0;2022-04-18;195;526;2763;1069;2782;54416317;51724722;36264862;799446;39594757
FR;0;2022-04-19;1518;3001;12904;29611;12465;54417835;51727723;36277766;829057;39607222
FR;0;2022-04-20;1980;3444;13295;28997;12970;54419815;51731167;36291061;858054;39620192
FR;0;2022-04-21;1506;2842;12525;35086;12570;54421321;51734009;36303586;893140;39632762
FR;0;2022-04-22;1861;3599;16463;37577;15826;54423182;51737608;36320049;930717;39648588
FR;0;2022-04-23;1144;2060;7381;10654;7232;54424326;51739668;36327430;941371;39655820
FR;0;2022-04-24;250;458;1475;1588;1410;54424576;51740126;36328905;942959;39657230
FR;0;2022-04-25;1301;2526;10676;21011;10481;54425877;51742652;36339581;963970;39667711
FR;0;2022-04-26;1617;2998;13653;38561;13101;54427494;51745650;36353234;1002531;39680812
FR;0;2022-04-27;1957;3057;11527;30957;11585;54429451;51748707;36364761;1033488;39692397
FR;0;2022-04-28;1563;2744;12525;36174;12264;54431014;51751451;36377286;1069662;39704661
FR;0;2022-04-29;2006;4351;15544;37211;14905;54433020;51755802;36392830;1106873;39719566
FR;0;2022-04-30;1210;1919;6927;9704;6754;54434230;51757721;36399757;1116577;39726320
FR;0;2022-05-01;217;321;913;995;907;54434447;51758042;36400670;1117572;39727227
FR;0;2022-05-02;1835;2920;11145;18127;10963;54436282;51760962;36411815;1135699;39738190
FR;0;2022-05-03;1876;3234;13716;34659;13557;54438158;51764196;36425531;1170358;39751747
FR;0;2022-05-04;1888;3273;12174;25621;12287;54440046;51767469;36437705;1195979;39764034
FR;0;2022-05-05;1750;2888;13032;33517;12880;54441796;51770357;36450737;1229496;39776914
FR;0;2022-05-06;2204;3650;15334;36734;14826;54444000;51774007;36466071;1266230;39791740
FR;0;2022-05-07;1202;1774;6460;9606;6450;54445202;51775781;36472531;1275836;39798190
FR;0;2022-05-08;265;398;1172;1546;1233;54445467;51776179;36473703;1277382;39799423
FR;0;2022-05-09;1345;2290;9919;20243;9788;54446812;51778469;36483622;1297625;39809211
FR;0;2022-05-10;1748;3151;13557;38881;13112;54448560;51781620;36497179;1336506;39822323
FR;0;2022-05-11;1988;2979;10741;27905;10686;54450548;51784599;36507920;1364411;39833009
FR;0;2022-05-12;1575;2686;11361;35631;11033;54452123;51787285;36519281;1400042;39844042
FR;0;2022-05-13;1965;3199;13745;37832;13330;54454088;51790484;36533026;1437874;39857372
FR;0;2022-05-14;1145;1625;5937;10772;5798;54455233;51792109;36538963;1448646;39863170
FR;0;2022-05-15;280;469;1278;1436;1358;54455513;51792578;36540241;1450082;39864528
FR;0;2022-05-16;1191;2022;8679;20991;8674;54456704;51794600;36548920;1471073;39873202
FR;0;2022-05-17;1580;2584;11814;37839;11393;54458284;51797184;36560734;1508912;39884595
FR;0;2022-05-18;1804;2632;9682;27131;9656;54460088;51799816;36570416;1536043;39894251
FR;0;2022-05-19;1434;2640;10563;35821;10702;54461522;51802456;36580979;1571864;39904953
FR;0;2022-05-20;1871;3105;13408;39335;12897;54463393;51805561;36594387;1611199;39917850
FR;0;2022-05-21;1158;1703;5659;9896;5532;54464551;51807264;36600046;1621095;39923382
FR;0;2022-05-22;238;336;1025;1434;1012;54464789;51807600;36601071;1622529;39924394
FR;0;2022-05-23;1172;2112;8876;20340;8826;54465961;51809712;36609947;1642869;39933220
FR;0;2022-05-24;1536;2752;11354;38847;11225;54467497;51812464;36621301;1681716;39944445
FR;0;2022-05-25;1810;2817;9337;24812;9469;54469307;51815281;36630638;1706528;39953914
FR;0;2022-05-26;207;414;1656;1190;1666;54469514;51815695;36632294;1707718;39955580
FR;0;2022-05-27;1374;2454;9251;21268;8993;54470888;51818149;36641545;1728986;39964573
FR;0;2022-05-28;663;1254;3911;6781;3961;54471551;51819403;36645456;1735767;39968534
FR;0;2022-05-29;155;315;751;915;772;54471706;51819718;36646207;1736682;39969306
FR;0;2022-05-30;1021;1944;6992;19289;7006;54472727;51821662;36653199;1755971;39976312
FR;0;2022-05-31;1487;2492;9814;35647;9635;54474214;51824154;36663013;1791618;39985947
FR;0;2022-06-01;1716;3085;11019;24523;10885;54475930;51827239;36674032;1816141;39996832
FR;0;2022-06-02;1468;2603;11304;35529;10848;54477398;51829842;36685336;1851670;40007680
FR;0;2022-06-03;1716;3061;13377;38699;12741;54479114;51832903;36698713;1890369;40020421
FR;0;2022-06-04;968;1512;5039;9109;5113;54480082;51834415;36703752;1899478;40025534
FR;0;2022-06-05;175;329;872;1105;882;54480257;51834744;36704624;1900583;40026416
FR;0;2022-06-06;351;1105;2105;1258;2118;54480608;51835849;36706729;1901841;40028534
FR;0;2022-06-07;1372;2657;9845;35570;9423;54481980;51838506;36716574;1937411;40037957
FR;0;2022-06-08;1546;2681;9159;28707;9002;54483526;51841187;36725733;1966118;40046959
FR;0;2022-06-09;1280;2428;10608;39452;10251;54484806;51843615;36736341;2005570;40057210
FR;0;2022-06-10;1619;2889;13069;44782;12614;54486425;51846504;36749410;2050352;40069824
FR;0;2022-06-11;954;1729;5431;11621;5464;54487379;51848233;36754841;2061973;40075288
FR;0;2022-06-12;196;436;1072;1761;1133;54487575;51848669;36755913;2063734;40076421
FR;0;2022-06-13;1075;2046;7429;23172;7260;54488650;51850715;36763342;2086906;40083681
FR;0;2022-06-14;1311;2480;10442;44915;9797;54489961;51853195;36773784;2131821;40093478
FR;0;2022-06-15;1497;2397;9308;30872;8937;54491458;51855592;36783092;2162693;40102415
FR;0;2022-06-16;1159;2011;9902;39880;9310;54492617;51857603;36792994;2202573;40111725
FR;0;2022-06-17;1472;2825;12456;46598;11886;54494089;51860428;36805450;2249171;40123611
FR;0;2022-06-18;852;1510;4562;11123;4495;54494941;51861938;36810012;2260294;40128106
FR;0;2022-06-19;180;361;1058;1615;1130;54495121;51862299;36811070;2261909;40129236
FR;0;2022-06-20;1018;1908;8904;26062;8564;54496139;51864207;36819974;2287971;40137800
FR;0;2022-06-21;1320;2392;10297;49868;9327;54497459;51866599;36830271;2337839;40147127
FR;0;2022-06-22;1376;2470;8907;39008;8403;54498835;51869069;36839178;2376847;40155530
FR;0;2022-06-23;1220;2343;10669;55065;9872;54500055;51871412;36849847;2431912;40165402
FR;0;2022-06-24;1483;2976;13633;69141;12294;54501538;51874388;36863480;2501053;40177696
FR;0;2022-06-25;932;1776;6225;19913;5979;54502470;51876164;36869705;2520966;40183675
FR;0;2022-06-26;228;456;1951;3686;1812;54502698;51876620;36871656;2524652;40185487
FR;0;2022-06-27;1127;2011;10488;48448;9630;54503825;51878631;36882144;2573100;40195117
FR;0;2022-06-28;1451;2805;14655;91300;13076;54505276;51881436;36896799;2664400;40208193
FR;0;2022-06-29;1699;2816;12282;71815;11230;54506975;51884252;36909081;2736215;40219423
FR;0;2022-06-30;1524;2677;14380;95139;12461;54508499;51886929;36923461;2831354;40231884
FR;0;2022-07-01;1987;3785;21456;115916;18812;54510486;51890714;36944917;2947270;40250696
FR;0;2022-07-02;1076;1853;8518;35744;7698;54511562;51892567;36953435;2983014;40258394
FR;0;2022-07-03;290;537;2091;6452;1893;54511852;51893104;36955526;2989466;40260287
FR;0;2022-07-04;1533;3076;14675;79189;12944;54513385;51896180;36970201;3068655;40273231
FR;0;2022-07-05;1695;3096;18808;133200;15987;54515080;51899276;36989009;3201855;40289218
FR;0;2022-07-06;1805;2755;15840;99527;13629;54516885;51902031;37004849;3301382;40302847
FR;0;2022-07-07;1697;2857;17982;125911;14759;54518582;51904888;37022831;3427293;40317606
FR;0;2022-07-08;1884;3141;20736;137027;16749;54520466;51908029;37043567;3564320;40334355
FR;0;2022-07-09;865;1450;7738;37909;6684;54521331;51909479;37051305;3602229;40341039
FR;0;2022-07-10;261;508;2344;6999;2126;54521592;51909987;37053649;3609228;40343165
FR;0;2022-07-11;1411;2436;15010;88207;12491;54523003;51912423;37068659;3697435;40355656
FR;0;2022-07-12;1785;3075;20512;143848;16704;54524788;51915498;37089171;3841283;40372360
FR;0;2022-07-13;1716;2692;15668;94489;13238;54526504;51918190;37104839;3935772;40385598
FR;0;2022-07-14;178;356;1949;5530;1829;54526682;51918546;37106788;3941302;40387427
FR;0;2022-07-15;1470;2548;15105;84419;12590;54528152;51921094;37121893;4025721;40400017
FR;0;2022-07-16;617;1168;5939;24972;5145;54528769;51922262;37127832;4050693;40405162
FR;0;2022-07-17;175;387;1735;4659;1566;54528944;51922649;37129567;4055352;40406728
FR;0;2022-07-18;1125;2234;11817;61791;9962;54530069;51924883;37141384;4117143;40416690
FR;0;2022-07-19;1408;2336;15462;103638;12283;54531477;51927219;37156846;4220781;40428973
FR;0;2022-07-20;1404;2277;12935;77544;10712;54532881;51929496;37169781;4298325;40439685
FR;0;2022-07-21;1268;2145;13076;88159;10478;54534149;51931641;37182857;4386484;40450163
FR;0;2022-07-22;1389;2429;14797;89423;11945;54535538;51934070;37197654;4475907;40462108
FR;0;2022-07-23;667;1297;5525;22472;4852;54536205;51935367;37203179;4498379;40466960
FR;0;2022-07-24;183;346;1396;3900;1237;54536388;51935713;37204575;4502279;40468197
FR;0;2022-07-25;1051;1781;9479;48048;7827;54537439;51937494;37214054;4550327;40476024
FR;0;2022-07-26;1286;2204;13292;85396;10817;54538725;51939698;37227346;4635723;40486841
FR;0;2022-07-27;1216;1988;10209;61193;8503;54539941;51941686;37237555;4696916;40495344
FR;0;2022-07-28;1083;1848;10294;64340;8204;54541024;51943534;37247849;4761256;40503548
FR;0;2022-07-29;1280;2025;10969;65796;8725;54542304;51945559;37258818;4827052;40512273
FR;0;2022-07-30;495;843;3512;15264;2967;54542799;51946402;37262330;4842316;40515240
FR;0;2022-07-31;150;280;929;2432;788;54542949;51946682;37263259;4844748;40516028
FR;0;2022-08-01;821;1424;7572;30217;6365;54543770;51948106;37270831;4874965;40522393
FR;0;2022-08-02;1013;1620;8548;56057;6860;54544783;51949726;37279379;4931022;40529253
FR;0;2022-08-03;826;1238;6400;38648;5120;54545609;51950964;37285779;4969670;40534373
FR;0;2022-08-04;726;1170;6559;43084;5285;54546335;51952134;37292338;5012754;40539658
FR;0;2022-08-05;845;1350;7075;44904;5643;54547180;51953484;37299413;5057658;40545301
FR;0;2022-08-06;334;552;2095;9359;1745;54547514;51954036;37301508;5067017;40547046
FR;0;2022-08-07;98;153;534;1620;452;54547612;51954189;37302042;5068637;40547498
FR;0;2022-08-08;546;900;3997;22081;3251;54548158;51955089;37306039;5090718;40550749
FR;0;2022-08-09;682;1122;5958;39925;4791;54548840;51956211;37311997;5130643;40555540
FR;0;2022-08-10;620;1078;4642;28009;3776;54549460;51957289;37316639;5158652;40559316
FR;0;2022-08-11;610;1007;4472;29172;3686;54550070;51958296;37321111;5187824;40563002
FR;0;2022-08-12;703;1135;4732;28190;3906;54550773;51959431;37325843;5216014;40566908
FR;0;2022-08-13;207;403;1291;5249;1113;54550980;51959834;37327134;5221263;40568021
FR;0;2022-08-14;68;117;284;918;242;54551048;51959951;37327418;5222181;40568263
FR;0;2022-08-15;72;167;594;561;542;54551120;51960118;37328012;5222742;40568805
FR;0;2022-08-16;615;1040;3943;22140;3336;54551735;51961158;37331955;5244882;40572141
FR;0;2022-08-17;623;992;3871;22828;3278;54552358;51962150;37335826;5267710;40575419
FR;0;2022-08-18;602;961;4075;26262;3217;54552960;51963111;37339901;5293972;40578636
FR;0;2022-08-19;595;1146;4476;27210;3679;54553555;51964257;37344377;5321182;40582315
FR;0;2022-08-20;287;477;1342;5556;1153;54553842;51964734;37345719;5326738;40583468
FR;0;2022-08-21;93;132;299;1006;263;54553935;51964866;37346018;5327744;40583731
FR;0;2022-08-22;540;973;3258;15316;2782;54554475;51965839;37349276;5343060;40586513
FR;0;2022-08-23;704;1158;4281;28986;3597;54555179;51966997;37353557;5372046;40590110
FR;0;2022-08-24;647;919;3480;19518;2842;54555826;51967916;37357037;5391564;40592952
FR;0;2022-08-25;618;1000;3919;23374;3266;54556444;51968916;37360956;5414938;40596218
FR;0;2022-08-26;846;1243;4466;25867;3656;54557290;51970159;37365422;5440805;40599874
FR;0;2022-08-27;291;493;1376;5454;1242;54557581;51970652;37366798;5446259;40601116
FR;0;2022-08-28;121;158;300;911;284;54557702;51970810;37367098;5447170;40601400
FR;0;2022-08-29;608;954;3064;14613;2601;54558310;51971764;37370162;5461783;40604001
FR;0;2022-08-30;841;1197;4779;28501;3901;54559151;51972961;37374941;5490284;40607902
FR;0;2022-08-31;677;926;3186;17583;2700;54559828;51973887;37378127;5507867;40610602
FR;0;2022-09-01;697;946;4413;22428;3754;54560525;51974833;37382540;5530295;40614356
FR;0;2022-09-02;857;1116;5015;28573;4228;54561382;51975949;37387555;5558868;40618584
FR;0;2022-09-03;404;552;1908;6071;1651;54561786;51976501;37389463;5564939;40620235
FR;0;2022-09-04;126;146;349;869;345;54561912;51976647;37389812;5565808;40620580
FR;0;2022-09-05;595;663;3093;16037;2572;54562507;51977310;37392905;5581845;40623152
FR;0;2022-09-06;780;993;4646;31756;3784;54563287;51978303;37397551;5613601;40626936
FR;0;2022-09-07;628;751;2983;16764;2463;54563915;51979054;37400534;5630365;40629399
FR;0;2022-09-08;607;833;3785;24797;3118;54564522;51979887;37404319;5655162;40632517
FR;0;2022-09-09;821;994;4386;27506;3628;54565343;51980881;37408705;5682668;40636145
FR;0;2022-09-10;368;527;1721;5688;1523;54565711;51981408;37410426;5688356;40637668
FR;0;2022-09-11;115;127;316;653;301;54565826;51981535;37410742;5689009;40637969
FR;0;2022-09-12;478;583;2612;13227;2220;54566304;51982118;37413354;5702236;40640189
FR;0;2022-09-13;597;821;3967;26312;3394;54566901;51982939;37417321;5728548;40643583
FR;0;2022-09-14;646;758;2925;16079;2438;54567547;51983697;37420246;5744627;40646021
FR;0;2022-09-15;537;755;3417;23453;2881;54568084;51984452;37423663;5768080;40648902
FR;0;2022-09-16;778;1018;4113;25803;3449;54568862;51985470;37427776;5793883;40652351
FR;0;2022-09-17;380;482;1437;6121;1270;54569242;51985952;37429213;5800004;40653621
FR;0;2022-09-18;112;135;323;956;290;54569354;51986087;37429536;5800960;40653911
FR;0;2022-09-19;436;620;2229;13159;1904;54569790;51986707;37431765;5814119;40655815
FR;0;2022-09-20;621;847;3736;26298;3114;54570411;51987554;37435501;5840417;40658929
FR;0;2022-09-21;567;755;2713;16221;2334;54570978;51988309;37438214;5856638;40661263
FR;0;2022-09-22;574;804;3359;23483;2734;54571552;51989113;37441573;5880121;40663997
FR;0;2022-09-23;811;1019;4463;28600;3733;54572363;51990132;37446036;5908721;40667730
FR;0;2022-09-24;416;598;1624;6884;1395;54572779;51990730;37447660;5915605;40669125
FR;0;2022-09-25;92;180;330;1099;301;54572871;51990910;37447990;5916704;40669426
FR;0;2022-09-26;420;676;2242;13361;1965;54573291;51991586;37450232;5930065;40671391
FR;0;2022-09-27;599;823;3586;25870;2865;54573890;51992409;37453818;5955935;40674256
FR;0;2022-09-28;612;810;2536;15335;2278;54574502;51993219;37456354;5971270;40676534
FR;0;2022-09-29;550;742;3076;20873;2583;54575052;51993961;37459430;5992143;40679117
FR;0;2022-09-30;747;1071;3896;25393;3237;54575799;51995032;37463326;6017536;40682354
FR;0;2022-10-01;382;585;1682;5914;1426;54576181;51995617;37465008;6023450;40683780
FR;0;2022-10-02;49;122;211;632;205;54576230;51995739;37465219;6024082;40683985
FR;0;2022-10-03;419;577;2125;11937;1849;54576649;51996316;37467344;6036019;40685834
FR;0;2022-10-04;591;737;3066;23405;2471;54577240;51997053;37470410;6059424;40688305
FR;0;2022-10-05;519;767;2284;14497;2001;54577759;51997820;37472694;6073921;40690306
FR;0;2022-10-06;511;676;2936;21487;2386;54578270;51998496;37475630;6095408;40692692
FR;0;2022-10-07;695;940;3956;30091;3321;54578965;51999436;37479586;6125499;40696013
FR;0;2022-10-08;327;495;1560;8337;1320;54579292;51999931;37481146;6133836;40697333
FR;0;2022-10-09;103;133;321;1548;299;54579395;52000064;37481467;6135384;40697632
FR;0;2022-10-10;442;616;2470;20156;2077;54579837;52000680;37483937;6155540;40699709
FR;0;2022-10-11;548;750;4095;39713;3371;54580385;52001430;37488032;6195253;40703080
FR;0;2022-10-12;534;748;3091;26324;2592;54580919;52002178;37491123;6221577;40705672
FR;0;2022-10-13;577;707;3815;37688;2938;54581496;52002885;37494938;6259265;40708610
FR;0;2022-10-14;712;974;4670;46792;3755;54582208;52003859;37499608;6306057;40712365
FR;0;2022-10-15;319;444;1674;11509;1457;54582527;52004303;37501282;6317566;40713822
FR;0;2022-10-16;81;107;316;1853;309;54582608;52004410;37501598;6319419;40714131
FR;0;2022-10-17;383;614;2653;25170;2113;54582991;52005024;37504251;6344589;40716244
