fra;vaccin;jour;n_dose1;n_dose2;n_dose3;n_dose4;n_rappel;n_cum_dose1;n_cum_dose2;n_cum_dose3;n_cum_dose4;n_cum_rappel
FR;1;2020-12-27;587;0;0;0;0;587;0;0;0;0
FR;1;2020-12-28;642;0;0;0;0;1229;0;0;0;0
FR;1;2020-12-29;368;0;0;0;0;1597;0;0;0;0
FR;1;2020-12-30;431;0;0;0;0;2028;0;0;0;0
FR;1;2020-12-31;346;0;0;0;0;2374;0;0;0;0
FR;1;2021-01-01;1173;0;0;0;0;3547;0;0;0;0
FR;1;2021-01-02;348;1;0;0;0;3895;1;0;0;0
FR;1;2021-01-03;414;0;0;0;0;4309;1;0;0;0
FR;1;2021-01-04;2083;0;0;0;0;6392;1;0;0;0
FR;1;2021-01-05;6465;2;0;0;0;12857;3;0;0;0
FR;1;2021-01-06;12198;0;0;0;0;25055;3;0;0;0
FR;1;2021-01-07;29420;2;0;0;0;54475;5;0;0;0
FR;1;2021-01-08;37187;2;0;0;0;91662;7;0;0;0
FR;1;2021-01-09;11214;2;0;0;0;102876;9;0;0;0
FR;1;2021-01-10;6030;0;0;0;0;108906;9;0;0;0
FR;1;2021-01-11;39921;5;0;0;0;148827;14;0;0;0
FR;1;2021-01-12;62102;4;0;0;0;210929;18;0;0;0
FR;1;2021-01-13;65037;13;0;0;0;275966;31;0;0;0
FR;1;2021-01-14;81419;15;0;0;0;357385;46;0;0;0
FR;1;2021-01-15;68583;3;0;0;0;425968;49;0;0;0
FR;1;2021-01-16;19892;75;0;0;0;445860;124;0;0;0
FR;1;2021-01-17;10930;45;0;0;0;456790;169;0;0;0
FR;1;2021-01-18;82751;160;0;0;0;539541;329;0;0;0
FR;1;2021-01-19;125907;138;0;0;0;665448;467;0;0;0
FR;1;2021-01-20;132400;166;0;0;0;797848;633;0;0;0
FR;1;2021-01-21;153031;141;0;0;0;950879;774;0;0;0
FR;1;2021-01-22;115892;171;0;0;0;1066771;945;0;0;0
FR;1;2021-01-23;36592;56;0;0;0;1103363;1001;0;0;0
FR;1;2021-01-24;9595;44;0;0;0;1112958;1045;0;0;0
FR;1;2021-01-25;74409;1218;0;0;0;1187367;2263;0;0;0
FR;1;2021-01-26;96434;3129;1;0;0;1283801;5392;1;0;0
FR;1;2021-01-27;103625;5597;0;0;0;1387426;10989;1;0;0
FR;1;2021-01-28;120576;14340;0;0;0;1508002;25329;1;0;0
FR;1;2021-01-29;88864;17283;0;0;0;1596866;42612;1;0;0
FR;1;2021-01-30;27965;4216;0;0;0;1624831;46828;1;0;0
FR;1;2021-01-31;5173;1685;0;0;0;1630004;48513;1;0;0
FR;1;2021-02-01;49803;21111;0;0;0;1679807;69624;1;0;0
FR;1;2021-02-02;67778;34565;0;0;0;1747585;104189;1;0;0
FR;1;2021-02-03;67038;36938;0;0;0;1814623;141127;1;0;0
FR;1;2021-02-04;77103;50026;0;0;0;1891726;191153;1;0;0
FR;1;2021-02-05;63391;45264;0;0;0;1955117;236417;1;0;0
FR;1;2021-02-06;19403;10388;0;0;0;1974520;246805;1;0;0
FR;1;2021-02-07;3667;5047;0;0;0;1978187;251852;1;0;0
FR;1;2021-02-08;36482;45931;0;0;0;2014669;297783;1;0;0
FR;1;2021-02-09;50784;72355;0;0;0;2065453;370138;1;0;0
FR;1;2021-02-10;51951;76536;0;0;0;2117404;446674;1;0;0
FR;1;2021-02-11;63322;98954;0;0;0;2180726;545628;1;0;0
FR;1;2021-02-12;55813;73937;0;0;0;2236539;619565;1;0;0
FR;1;2021-02-13;15443;19243;0;0;0;2251982;638808;1;0;0
FR;1;2021-02-14;3736;7191;0;0;0;2255718;645999;1;0;0
FR;1;2021-02-15;24121;73338;0;0;0;2279839;719337;1;0;0
FR;1;2021-02-16;32737;96719;0;0;0;2312576;816056;1;0;0
FR;1;2021-02-17;35083;98475;1;0;0;2347659;914531;2;0;0
FR;1;2021-02-18;49373;113359;0;0;0;2397032;1027890;2;0;0
FR;1;2021-02-19;45352;86269;1;0;0;2442384;1114159;3;0;0
FR;1;2021-02-20;13378;26867;0;0;0;2455762;1141026;3;0;0
FR;1;2021-02-21;2450;6292;0;0;0;2458212;1147318;3;0;0
FR;1;2021-02-22;24682;69300;2;0;0;2482894;1216618;5;0;0
FR;1;2021-02-23;37400;80283;1;0;0;2520294;1296901;6;0;0
FR;1;2021-02-24;40645;77548;1;0;0;2560939;1374449;7;0;0
FR;1;2021-02-25;50123;87863;1;0;0;2611062;1462312;8;0;0
FR;1;2021-02-26;47165;67793;0;0;0;2658227;1530105;8;0;0
FR;1;2021-02-27;15662;20903;0;0;0;2673889;1551008;8;0;0
FR;1;2021-02-28;3549;4381;1;0;0;2677438;1555389;9;0;0
FR;1;2021-03-01;40183;48939;1;0;0;2717621;1604328;10;0;0
FR;1;2021-03-02;55943;61419;2;0;0;2773564;1665747;12;0;0
FR;1;2021-03-03;61134;60562;0;0;0;2834698;1726309;12;0;0
FR;1;2021-03-04;72914;64843;3;0;0;2907612;1791152;15;0;0
FR;1;2021-03-05;74702;59177;3;0;0;2982314;1850329;18;0;0
FR;1;2021-03-06;82434;16065;2;0;0;3064748;1866394;20;0;0
FR;1;2021-03-07;63710;5390;1;0;0;3128458;1871784;21;0;0
FR;1;2021-03-08;60125;42411;2;0;0;3188583;1914195;23;0;0
FR;1;2021-03-09;85918;48249;1;0;0;3274501;1962444;24;0;0
FR;1;2021-03-10;90810;48019;5;0;0;3365311;2010463;29;0;0
FR;1;2021-03-11;104948;53788;1;0;0;3470259;2064251;30;0;0
FR;1;2021-03-12;104021;45235;0;0;0;3574280;2109486;30;0;0
FR;1;2021-03-13;89147;12708;1;0;0;3663427;2122194;31;0;0
FR;1;2021-03-14;44423;3019;1;0;0;3707850;2125213;32;0;0
FR;1;2021-03-15;95344;29092;3;0;0;3803194;2154305;35;0;0
FR;1;2021-03-16;123575;34875;4;0;0;3926769;2189180;39;0;0
FR;1;2021-03-17;129251;34810;5;0;0;4056020;2223990;44;0;0
FR;1;2021-03-18;142854;39692;4;0;0;4198874;2263682;48;0;0
FR;1;2021-03-19;136234;32859;2;0;0;4335108;2296541;50;0;0
FR;1;2021-03-20;75971;10199;1;0;0;4411079;2306740;51;0;0
FR;1;2021-03-21;26462;2486;1;0;0;4437541;2309226;52;0;0
FR;1;2021-03-22;114637;31138;1;0;0;4552178;2340364;53;0;0
FR;1;2021-03-23;142964;38140;1;0;0;4695142;2378504;54;0;0
FR;1;2021-03-24;141962;38773;0;0;0;4837104;2417277;54;0;0
FR;1;2021-03-25;164950;39553;4;0;0;5002054;2456830;58;0;0
FR;1;2021-03-26;166344;37429;4;0;0;5168398;2494259;62;0;0
FR;1;2021-03-27;110846;15242;1;0;0;5279244;2509501;63;0;0
FR;1;2021-03-28;42267;3639;3;0;0;5321511;2513140;66;0;0
FR;1;2021-03-29;129770;49904;4;0;0;5451281;2563044;70;0;0
FR;1;2021-03-30;167607;63477;4;0;0;5618888;2626521;74;0;0
FR;1;2021-03-31;170850;66810;4;0;0;5789738;2693331;78;0;0
FR;1;2021-04-01;194754;79162;11;0;0;5984492;2772493;89;0;0
FR;1;2021-04-02;164400;84245;7;0;0;6148892;2856738;96;0;0
FR;1;2021-04-03;88207;58072;5;0;0;6237099;2914810;101;0;0
FR;1;2021-04-04;33507;17729;0;0;0;6270606;2932539;101;0;0
FR;1;2021-04-05;46553;10160;11;0;0;6317159;2942699;112;0;0
FR;1;2021-04-06;160191;100742;16;0;0;6477350;3043441;128;0;0
FR;1;2021-04-07;196890;108117;16;0;0;6674240;3151558;144;0;0
FR;1;2021-04-08;221955;112272;13;0;0;6896195;3263830;157;0;0
FR;1;2021-04-09;214469;107392;20;0;0;7110664;3371222;177;0;0
FR;1;2021-04-10;117126;73370;13;0;0;7227790;3444592;190;0;0
FR;1;2021-04-11;40798;30244;6;0;0;7268588;3474836;196;0;0
FR;1;2021-04-12;168325;103639;45;0;0;7436913;3578475;241;0;0
FR;1;2021-04-13;203687;128024;95;1;0;7640600;3706499;336;1;0
FR;1;2021-04-14;208496;122650;203;0;0;7849096;3829149;539;1;0
FR;1;2021-04-15;221684;126591;309;0;0;8070780;3955740;848;1;0
FR;1;2021-04-16;205962;125001;307;0;0;8276742;4080741;1155;1;0
FR;1;2021-04-17;122040;67407;102;0;0;8398782;4148148;1257;1;0
FR;1;2021-04-18;35911;20991;39;0;0;8434693;4169139;1296;1;0
FR;1;2021-04-19;163583;121734;429;0;0;8598276;4290873;1725;1;0
FR;1;2021-04-20;189287;148595;528;0;0;8787563;4439468;2253;1;0
FR;1;2021-04-21;193859;146607;753;0;0;8981422;4586075;3006;1;0
FR;1;2021-04-22;208851;162485;777;0;0;9190273;4748560;3783;1;0
FR;1;2021-04-23;198889;156749;665;0;0;9389162;4905309;4448;1;0
FR;1;2021-04-24;126285;95422;144;0;0;9515447;5000731;4592;1;0
FR;1;2021-04-25;53539;30078;46;0;0;9568986;5030809;4638;1;0
FR;1;2021-04-26;181021;138072;535;0;0;9750007;5168881;5173;1;0
FR;1;2021-04-27;221269;161730;896;0;0;9971276;5330611;6069;1;0
FR;1;2021-04-28;238191;154914;1304;1;1;10209467;5485525;7373;2;1
FR;1;2021-04-29;270173;159896;1205;0;0;10479640;5645421;8578;2;1
FR;1;2021-04-30;271892;147954;1066;0;0;10751532;5793375;9644;2;1
FR;1;2021-05-01;141123;40676;172;0;0;10892655;5834051;9816;2;1
FR;1;2021-05-02;81580;28116;80;0;0;10974235;5862167;9896;2;1
FR;1;2021-05-03;250960;146305;795;0;0;11225195;6008472;10691;2;1
FR;1;2021-05-04;265763;186733;1195;0;0;11490958;6195205;11886;2;1
FR;1;2021-05-05;283936;184381;1262;0;0;11774894;6379586;13148;2;1
FR;1;2021-05-06;309813;182843;1490;0;0;12084707;6562429;14638;2;1
FR;1;2021-05-07;284098;195458;1125;0;0;12368805;6757887;15763;2;1
FR;1;2021-05-08;191617;48282;280;0;0;12560422;6806169;16043;2;1
FR;1;2021-05-09;114001;36136;235;0;0;12674423;6842305;16278;2;1
FR;1;2021-05-10;258176;193973;1177;0;0;12932599;7036278;17455;2;1
FR;1;2021-05-11;318799;211052;1454;0;0;13251398;7247330;18909;2;1
FR;1;2021-05-12;356545;185666;1386;0;0;13607943;7432996;20295;2;1
FR;1;2021-05-13;283355;47638;397;0;0;13891298;7480634;20692;2;1
FR;1;2021-05-14;370635;128622;980;0;0;14261933;7609256;21672;2;1
FR;1;2021-05-15;298032;66059;397;0;0;14559965;7675315;22069;2;1
FR;1;2021-05-16;157713;15539;156;0;0;14717678;7690854;22225;2;1
FR;1;2021-05-17;318876;116495;1428;0;0;15036554;7807349;23653;2;1
FR;1;2021-05-18;382986;111110;1788;0;0;15419540;7918459;25441;2;1
FR;1;2021-05-19;395150;102682;2163;0;0;15814690;8021141;27604;2;1
FR;1;2021-05-20;421691;96137;2034;0;0;16236381;8117278;29638;2;1
FR;1;2021-05-21;399736;97195;1746;0;0;16636117;8214473;31384;2;1
FR;1;2021-05-22;275596;41994;601;0;0;16911713;8256467;31985;2;1
FR;1;2021-05-23;122941;11179;224;0;0;17034654;8267646;32209;2;1
FR;1;2021-05-24;243945;26245;563;0;0;17278599;8293891;32772;2;1
FR;1;2021-05-25;366043;131699;2095;1;0;17644642;8425590;34867;3;1
FR;1;2021-05-26;380715;125570;1977;0;0;18025357;8551160;36844;3;1
FR;1;2021-05-27;406022;127990;1962;0;0;18431379;8679150;38806;3;1
FR;1;2021-05-28;365970;145297;1689;0;0;18797349;8824447;40495;3;1
FR;1;2021-05-29;253770;80855;524;0;0;19051119;8905302;41019;3;1
FR;1;2021-05-30;100886;22531;156;0;0;19152005;8927833;41175;3;1
FR;1;2021-05-31;314161;148821;1275;1;1;19466166;9076654;42450;4;2
FR;1;2021-06-01;361727;166577;1718;1;1;19827893;9243231;44168;5;3
FR;1;2021-06-02;364853;153050;1784;0;0;20192746;9396281;45952;5;3
FR;1;2021-06-03;390218;147610;1640;0;0;20582964;9543891;47592;5;3
FR;1;2021-06-04;363416;175566;1481;1;1;20946380;9719457;49073;6;4
FR;1;2021-06-05;258452;112656;595;0;0;21204832;9832113;49668;6;4
FR;1;2021-06-06;126741;37510;215;0;0;21331573;9869623;49883;6;4
FR;1;2021-06-07;300075;207910;1359;0;0;21631648;10077533;51242;6;4
FR;1;2021-06-08;330533;220768;1625;0;0;21962181;10298301;52867;6;4
FR;1;2021-06-09;336335;212355;1597;0;0;22298516;10510656;54464;6;4
FR;1;2021-06-10;344334;202113;1599;0;0;22642850;10712769;56063;6;4
FR;1;2021-06-11;311779;235279;1283;0;0;22954629;10948048;57346;6;4
FR;1;2021-06-12;244024;150641;427;0;0;23198653;11098689;57773;6;4
FR;1;2021-06-13;100298;60997;185;0;0;23298951;11159686;57958;6;4
FR;1;2021-06-14;207788;288971;1310;1;0;23506739;11448657;59268;7;4
FR;1;2021-06-15;256674;282258;1382;1;0;23763413;11730915;60650;8;4
FR;1;2021-06-16;273550;270424;1255;1;0;24036963;12001339;61905;9;4
FR;1;2021-06-17;268254;244410;1227;1;0;24305217;12245749;63132;10;4
FR;1;2021-06-18;260612;295690;1142;1;0;24565829;12541439;64274;11;4
FR;1;2021-06-19;193409;209451;384;0;0;24759238;12750890;64658;11;4
FR;1;2021-06-20;69643;89113;116;0;0;24828881;12840003;64774;11;4
FR;1;2021-06-21;172209;319824;919;1;1;25001090;13159827;65693;12;5
FR;1;2021-06-22;185684;347704;1093;10;2;25186774;13507531;66786;22;7
FR;1;2021-06-23;204077;339337;1046;0;0;25390851;13846868;67832;22;7
FR;1;2021-06-24;203389;281863;1157;0;0;25594240;14128731;68989;22;7
FR;1;2021-06-25;183273;371793;1195;0;0;25777513;14500524;70184;22;7
FR;1;2021-06-26;131301;278273;498;0;0;25908814;14778797;70682;22;7
FR;1;2021-06-27;52355;122960;142;0;0;25961169;14901757;70824;22;7
FR;1;2021-06-28;136462;368263;1052;0;0;26097631;15270020;71876;22;7
FR;1;2021-06-29;154715;390380;1845;0;0;26252346;15660400;73721;22;7
FR;1;2021-06-30;179893;378517;1659;4;2;26432239;16038917;75380;26;9
FR;1;2021-07-01;202003;332134;1886;5;1;26634242;16371051;77266;31;10
FR;1;2021-07-02;193387;367686;1761;5;3;26827629;16738737;79027;36;13
FR;1;2021-07-03;124412;280450;703;3;1;26952041;17019187;79730;39;14
FR;1;2021-07-04;53915;113674;244;0;0;27005956;17132861;79974;39;14
FR;1;2021-07-05;153935;356063;1497;8;2;27159891;17488924;81471;47;16
FR;1;2021-07-06;173515;382519;1597;43;8;27333406;17871443;83068;90;24
FR;1;2021-07-07;191130;362561;1654;23;5;27524536;18234004;84722;113;29
FR;1;2021-07-08;201442;323099;1825;20;9;27725978;18557103;86547;133;38
FR;1;2021-07-09;189734;387153;1852;3;2;27915712;18944256;88399;136;40
FR;1;2021-07-10;129862;281106;814;1;1;28045574;19225362;89213;137;41
FR;1;2021-07-11;57588;102471;260;0;0;28103162;19327833;89473;137;41
FR;1;2021-07-12;149511;416988;1573;4;0;28252673;19744821;91046;141;41
FR;1;2021-07-13;234176;439480;1803;6;2;28486849;20184301;92849;147;43
FR;1;2021-07-14;171696;151567;415;0;0;28658545;20335868;93264;147;43
FR;1;2021-07-15;279505;424807;1852;1;0;28938050;20760675;95116;148;43
FR;1;2021-07-16;290196;401305;1709;3;1;29228246;21161980;96825;151;44
FR;1;2021-07-17;217310;282118;752;1;0;29445556;21444098;97577;152;44
FR;1;2021-07-18;101986;107316;288;0;0;29547542;21551414;97865;152;44
FR;1;2021-07-19;238135;379398;1494;3;0;29785677;21930812;99359;155;44
FR;1;2021-07-20;305695;380954;1465;0;0;30091372;22311766;100824;155;44
FR;1;2021-07-21;333128;353610;1410;4;2;30424500;22665376;102234;159;46
FR;1;2021-07-22;364379;319527;1496;3;2;30788879;22984903;103730;162;48
FR;1;2021-07-23;347552;343625;1580;4;2;31136431;23328528;105310;166;50
FR;1;2021-07-24;238918;241108;695;1;0;31375349;23569636;106005;167;50
FR;1;2021-07-25;112749;76057;214;0;0;31488098;23645693;106219;167;50
FR;1;2021-07-26;299001;290325;1494;2;2;31787099;23936018;107713;169;52
FR;1;2021-07-27;385698;268925;1458;4;2;32172797;24204943;109171;173;54
FR;1;2021-07-28;390136;251655;1459;4;2;32562933;24456598;110630;177;56
FR;1;2021-07-29;406109;228507;1537;2;1;32969042;24685105;112167;179;57
FR;1;2021-07-30;370551;247108;1632;4;1;33339593;24932213;113799;183;58
FR;1;2021-07-31;243315;165097;790;1;0;33582908;25097310;114589;184;58
FR;1;2021-08-01;105551;47220;228;0;0;33688459;25144530;114817;184;58
FR;1;2021-08-02;297364;213213;1472;1;0;33985823;25357743;116289;185;58
FR;1;2021-08-03;331017;209332;1542;2;1;34316840;25567075;117831;187;59
FR;1;2021-08-04;327865;184423;1435;5;3;34644705;25751498;119266;192;62
FR;1;2021-08-05;301150;193560;1478;0;0;34945855;25945058;120744;192;62
FR;1;2021-08-06;290752;224660;1557;3;1;35236607;26169718;122301;195;63
FR;1;2021-08-07;182514;158817;654;4;3;35419121;26328535;122955;199;66
FR;1;2021-08-08;68766;59151;245;0;0;35487887;26387686;123200;199;66
FR;1;2021-08-09;222635;236139;1435;4;3;35710522;26623825;124635;203;69
FR;1;2021-08-10;252649;241022;1484;2;1;35963171;26864847;126119;205;70
FR;1;2021-08-11;236013;232584;1266;5;1;36199184;27097431;127385;210;71
FR;1;2021-08-12;220514;240221;1480;3;1;36419698;27337652;128865;213;72
FR;1;2021-08-13;201607;238439;1352;2;2;36621305;27576091;130217;215;74
FR;1;2021-08-14;122703;174168;645;0;0;36744008;27750259;130862;215;74
FR;1;2021-08-15;34619;46112;194;1;0;36778627;27796371;131056;216;74
FR;1;2021-08-16;156371;289951;1417;0;0;36934998;28086322;132473;216;74
FR;1;2021-08-17;171347;291756;1417;4;1;37106345;28378078;133890;220;75
FR;1;2021-08-18;161236;287172;1382;6;3;37267581;28665250;135272;226;78
FR;1;2021-08-19;148742;277489;1391;1;0;37416323;28942739;136663;227;78
FR;1;2021-08-20;140237;308334;1517;2;2;37556560;29251073;138180;229;80
FR;1;2021-08-21;84155;213268;584;0;0;37640715;29464341;138764;229;80
FR;1;2021-08-22;28524;82692;229;0;0;37669239;29547033;138993;229;80
FR;1;2021-08-23;118523;321193;1414;2;1;37787762;29868226;140407;231;81
FR;1;2021-08-24;126561;319947;1589;5;1;37914323;30188173;141996;236;82
FR;1;2021-08-25;121346;306612;1772;6;3;38035669;30494785;143768;242;85
FR;1;2021-08-26;106500;286140;2151;10;1;38142169;30780925;145919;252;86
FR;1;2021-08-27;107491;321065;2296;8;3;38249660;31101990;148215;260;89
FR;1;2021-08-28;70858;220661;1097;0;0;38320518;31322651;149312;260;89
FR;1;2021-08-29;24129;78108;458;1;0;38344647;31400759;149770;261;89
FR;1;2021-08-30;96601;286423;4305;6;5158;38441248;31687182;154075;267;5247
FR;1;2021-08-31;97951;276455;9264;13;10172;38539199;31963637;163339;280;15419
FR;1;2021-09-01;111457;245250;21082;7;21906;38650656;32208887;184421;287;37325
FR;1;2021-09-02;84892;198058;24489;12;25322;38735548;32406945;208910;299;62647
FR;1;2021-09-03;82375;227616;26918;21;27846;38817923;32634561;235828;320;90493
FR;1;2021-09-04;71281;189679;11128;11;11583;38889204;32824240;246956;331;102076
FR;1;2021-09-05;18595;41194;4114;2;4273;38907799;32865434;251070;333;106349
FR;1;2021-09-06;59346;151708;30149;15;30977;38967145;33017142;281219;348;137326
FR;1;2021-09-07;55853;139675;30187;26;30990;39022998;33156817;311406;374;168316
FR;1;2021-09-08;70228;173798;26896;20;27660;39093226;33330615;338302;394;195976
FR;1;2021-09-09;53376;124419;28566;23;29475;39146602;33455034;366868;417;225451
FR;1;2021-09-10;65437;151974;30397;21;31387;39212039;33607008;397265;438;256838
FR;1;2021-09-11;51711;146542;9710;12;10189;39263750;33753550;406975;450;267027
FR;1;2021-09-12;10675;29232;2478;2;2619;39274425;33782782;409453;452;269646
FR;1;2021-09-13;51280;104586;38679;28;39608;39325705;33887368;448132;480;309254
FR;1;2021-09-14;53093;96145;51175;67;52487;39378798;33983513;499307;547;361741
FR;1;2021-09-15;60382;139159;50402;55;46850;39439180;34122672;549709;602;408591
FR;1;2021-09-16;46551;81260;53227;72;49340;39485731;34203932;602936;674;457931
FR;1;2021-09-17;53109;109310;44993;61;42549;39538840;34313242;647929;735;500480
FR;1;2021-09-18;37762;118398;11783;19;11241;39576602;34431640;659712;754;511721
FR;1;2021-09-19;6469;21016;2030;2;1968;39583071;34452656;661742;756;513689
FR;1;2021-09-20;37267;74825;46117;69;43940;39620338;34527481;707859;825;557629
FR;1;2021-09-21;34043;68118;56148;73;52453;39654381;34595599;764007;898;610082
FR;1;2021-09-22;38664;118204;49763;78;46659;39693045;34713803;813770;976;656741
FR;1;2021-09-23;31874;62572;54401;86;50612;39724919;34776375;868171;1062;707353
FR;1;2021-09-24;36649;89476;43591;92;41792;39761568;34865851;911762;1154;749145
FR;1;2021-09-25;27529;96422;12290;27;12143;39789097;34962273;924052;1181;761288
FR;1;2021-09-26;4360;15211;1763;4;1700;39793457;34977484;925815;1185;762988
FR;1;2021-09-27;27310;60173;42838;89;41494;39820767;35037657;968653;1274;804482
FR;1;2021-09-28;26809;49412;47088;75;44270;39847576;35087069;1015741;1349;848752
FR;1;2021-09-29;35737;80244;47166;86;45400;39883313;35167313;1062907;1435;894152
FR;1;2021-09-30;25903;45569;47420;80;45219;39909216;35212882;1110327;1515;939371
FR;1;2021-10-01;47291;64356;44822;83;44333;39956507;35277238;1155149;1598;983704
FR;1;2021-10-02;31666;62172;16092;32;16262;39988173;35339410;1171241;1630;999966
FR;1;2021-10-03;4292;8604;2024;3;2034;39992465;35348014;1173265;1633;1002000
FR;1;2021-10-04;28338;44221;47048;78;46855;40020803;35392235;1220313;1711;1048855
FR;1;2021-10-05;23905;41523;49761;116;49050;40044708;35433758;1270074;1827;1097905
FR;1;2021-10-06;34066;61094;57376;102;57017;40078774;35494852;1327450;1929;1154922
FR;1;2021-10-07;20792;39545;52941;75;51736;40099566;35534397;1380391;2004;1206658
FR;1;2021-10-08;34628;59422;60307;83;60964;40134194;35593819;1440698;2087;1267622
FR;1;2021-10-09;27249;47804;25447;29;25936;40161443;35641623;1466145;2116;1293558
FR;1;2021-10-10;3544;5684;2737;7;2830;40164987;35647307;1468882;2123;1296388
FR;1;2021-10-11;24547;38149;54516;88;55105;40189534;35685456;1523398;2211;1351493
FR;1;2021-10-12;22926;36503;57961;125;58960;40212460;35721959;1581359;2336;1410453
FR;1;2021-10-13;32708;47639;64112;124;65547;40245168;35769598;1645471;2460;1476000
FR;1;2021-10-14;21642;34558;53690;101;54180;40266810;35804156;1699161;2561;1530180
FR;1;2021-10-15;32418;48419;72271;162;74892;40299228;35852575;1771432;2723;1605072
FR;1;2021-10-16;25813;35159;34843;45;36356;40325041;35887734;1806275;2768;1641428
FR;1;2021-10-17;3082;4005;3402;2;3307;40328123;35891739;1809677;2770;1644735
FR;1;2021-10-18;22405;33572;66773;129;69580;40350528;35925311;1876450;2899;1714315
FR;1;2021-10-19;20445;33002;75591;135;79452;40370973;35958313;1952041;3034;1793767
FR;1;2021-10-20;29785;43915;96093;176;99647;40400758;36002228;2048134;3210;1893414
FR;1;2021-10-21;19462;34963;83071;108;86912;40420220;36037191;2131205;3318;1980326
FR;1;2021-10-22;29487;47342;103652;194;109486;40449707;36084533;2234857;3512;2089812
FR;1;2021-10-23;22863;34495;44832;57;47317;40472570;36119028;2279689;3569;2137129
FR;1;2021-10-24;2365;3864;3576;6;3738;40474935;36122892;2283265;3575;2140867
FR;1;2021-10-25;22343;30631;81952;143;85701;40497278;36153523;2365217;3718;2226568
FR;1;2021-10-26;19241;27559;86018;162;90195;40516519;36181082;2451235;3880;2316763
FR;1;2021-10-27;26041;39478;107703;253;112520;40542560;36220560;2558938;4133;2429283
FR;1;2021-10-28;18475;26835;86857;150;91498;40561035;36247395;2645795;4283;2520781
FR;1;2021-10-29;25796;39672;114728;201;121400;40586831;36287067;2760523;4484;2642181
FR;1;2021-10-30;17475;28462;49312;76;51880;40604306;36315529;2809835;4560;2694061
FR;1;2021-10-31;2063;3228;3435;2;3679;40606369;36318757;2813270;4562;2697740
FR;1;2021-11-01;7151;3817;3008;3;3237;40613520;36322574;2816278;4565;2700977
FR;1;2021-11-02;21489;32971;92299;155;97578;40635009;36355545;2908577;4720;2798555
FR;1;2021-11-03;26021;41162;117393;215;123680;40661030;36396707;3025970;4935;2922235
FR;1;2021-11-04;19375;30135;105679;213;111733;40680405;36426842;3131649;5148;3033968
FR;1;2021-11-05;26814;41972;138656;227;147180;40707219;36468814;3270305;5375;3181148
FR;1;2021-11-06;18677;29737;63416;123;66360;40725896;36498551;3333721;5498;3247508
FR;1;2021-11-07;1774;3396;4942;6;5297;40727670;36501947;3338663;5504;3252805
FR;1;2021-11-08;17454;32196;125873;222;132378;40745124;36534143;3464536;5726;3385183
FR;1;2021-11-09;19048;37588;159158;336;168803;40764172;36571731;3623694;6062;3553986
FR;1;2021-11-10;28415;48700;181765;437;192209;40792587;36620431;3805459;6499;3746195
FR;1;2021-11-11;3455;5534;12156;26;12945;40796042;36625965;3817615;6525;3759140
FR;1;2021-11-12;25873;46655;174693;240;186225;40821915;36672620;3992308;6765;3945365
FR;1;2021-11-13;18547;29162;76773;110;81708;40840462;36701782;4069081;6875;4027073
FR;1;2021-11-14;1993;3338;6802;5;7373;40842455;36705120;4075883;6880;4034446
FR;1;2021-11-15;18453;34714;156258;303;165990;40860908;36739834;4232141;7183;4200436
FR;1;2021-11-16;20869;37689;191936;375;204616;40881777;36777523;4424077;7558;4405052
FR;1;2021-11-17;28351;45514;193101;398;204844;40910128;36823037;4617178;7956;4609896
FR;1;2021-11-18;20908;37614;182327;457;194243;40931036;36860651;4799505;8413;4804139
FR;1;2021-11-19;30792;53232;230069;528;246417;40961828;36913883;5029574;8941;5050556
FR;1;2021-11-20;23575;33143;96910;200;103525;40985403;36947026;5126484;9141;5154081
FR;1;2021-11-21;2296;4046;9085;18;9975;40987699;36951072;5135569;9159;5164056
FR;1;2021-11-22;21292;30311;175729;465;189200;41008991;36981383;5311298;9624;5353256
FR;1;2021-11-23;23740;40898;221014;538;237621;41032731;37022281;5532312;10162;5590877
FR;1;2021-11-24;30189;49436;217218;701;234269;41062920;37071717;5749530;10863;5825146
FR;1;2021-11-25;23413;43511;244298;719;263743;41086333;37115228;5993828;11582;6088889
FR;1;2021-11-26;30481;66359;356607;834;388280;41116814;37181587;6350435;12416;6477169
FR;1;2021-11-27;21622;45014;202512;370;222475;41138436;37226601;6552947;12786;6699644
FR;1;2021-11-28;3135;9695;54736;62;61039;41141571;37236296;6607683;12848;6760683
FR;1;2021-11-29;17784;49296;326206;841;354090;41159355;37285592;6933889;13689;7114773
FR;1;2021-11-30;22420;64571;430923;949;470457;41181775;37350163;7364812;14638;7585230
FR;1;2021-12-01;24399;69028;442642;1129;481418;41206174;37419191;7807454;15767;8066648
FR;1;2021-12-02;19783;64179;489179;1222;532559;41225957;37483370;8296633;16989;8599207
FR;1;2021-12-03;22811;81588;542514;1303;591409;41248768;37564958;8839147;18292;9190616
FR;1;2021-12-04;16334;53821;298977;652;328784;41265102;37618779;9138124;18944;9519400
FR;1;2021-12-05;3623;13927;81486;143;91069;41268725;37632706;9219610;19087;9610469
FR;1;2021-12-06;16646;62342;415243;1062;454914;41285371;37695048;9634853;20149;10065383
FR;1;2021-12-07;19724;75675;522687;1527;572209;41305095;37770723;10157540;21676;10637592
FR;1;2021-12-08;21404;75347;458168;1541;501836;41326499;37846070;10615708;23217;11139428
FR;1;2021-12-09;19307;73822;492686;1625;540483;41345806;37919892;11108394;24842;11679911
FR;1;2021-12-10;22437;87451;547164;1582;599715;41368243;38007343;11655558;26424;12279626
FR;1;2021-12-11;16512;58853;302641;745;335383;41384755;38066196;11958199;27169;12615009
FR;1;2021-12-12;4324;15908;83158;178;94075;41389079;38082104;12041357;27347;12709084
FR;1;2021-12-13;15427;63554;366764;1093;406103;41404506;38145658;12408121;28440;13115187
FR;1;2021-12-14;19855;80056;464455;1735;514921;41424361;38225714;12872576;30175;13630108
FR;1;2021-12-15;21258;77068;408852;1307;452902;41445619;38302782;13281428;31482;14083010
FR;1;2021-12-16;19888;77158;451665;1574;500446;41465507;38379940;13733093;33056;14583456
FR;1;2021-12-17;22433;86575;479751;1734;530859;41487940;38466515;14212844;34790;15114315
FR;1;2021-12-18;17581;54587;257567;730;288482;41505521;38521102;14470411;35520;15402797
FR;1;2021-12-19;5534;17208;79169;194;90844;41511055;38538310;14549580;35714;15493641
FR;1;2021-12-20;20850;62977;316274;1081;355357;41531905;38601287;14865854;36795;15848998
FR;1;2021-12-21;26052;73002;372643;1420;418005;41557957;38674289;15238497;38215;16267003
FR;1;2021-12-22;24857;65713;310460;1213;349434;41582814;38740002;15548957;39428;16616437
FR;1;2021-12-23;21163;52197;241652;947;273253;41603977;38792199;15790609;40375;16889690
FR;1;2021-12-24;7060;18242;67167;255;77123;41611037;38810441;15857776;40630;16966813
FR;1;2021-12-25;491;2733;5593;15;6568;41611528;38813174;15863369;40645;16973381
FR;1;2021-12-26;2748;7584;26934;62;31457;41614276;38820758;15890303;40707;17004838
FR;1;2021-12-27;18075;53203;235166;707;265823;41632351;38873961;16125469;41414;17270661
FR;1;2021-12-28;23196;61772;292081;1021;330240;41655547;38935733;16417550;42435;17600901
FR;1;2021-12-29;22177;55386;255002;919;288236;41677724;38991119;16672552;43354;17889137
FR;1;2021-12-30;21183;45972;212190;857;239648;41698907;39037091;16884742;44211;18128785
FR;1;2021-12-31;7245;16409;61970;228;70458;41706152;39053500;16946712;44439;18199243
FR;1;2022-01-01;808;2481;5680;30;6611;41706960;39055981;16952392;44469;18205854
FR;1;2022-01-02;3033;8065;28952;50;33615;41709993;39064046;16981344;44519;18239469
FR;1;2022-01-03;18824;51366;229388;784;258592;41728817;39115412;17210732;45303;18498061
FR;1;2022-01-04;24620;64395;299717;1235;337694;41753437;39179807;17510449;46538;18835755
FR;1;2022-01-05;28944;63360;275698;1095;310968;41782381;39243167;17786147;47633;19146723
FR;1;2022-01-06;26332;65765;307496;1391;347129;41808713;39308932;18093643;49024;19493852
FR;1;2022-01-07;31161;74248;350824;1537;394865;41839874;39383180;18444467;50561;19888717
FR;1;2022-01-08;23267;51345;222609;693;251236;41863141;39434525;18667076;51254;20139953
FR;1;2022-01-09;7074;17271;66061;161;76218;41870215;39451796;18733137;51415;20216171
FR;1;2022-01-10;21240;53437;239126;952;269352;41891455;39505233;18972263;52367;20485523
FR;1;2022-01-11;26356;62557;283170;1272;318690;41917811;39567790;19255433;53639;20804213
FR;1;2022-01-12;28540;61664;247125;1101;278859;41946351;39629454;19502558;54740;21083072
FR;1;2022-01-13;24298;59603;263558;1249;296852;41970649;39689057;19766116;55989;21379924
FR;1;2022-01-14;27633;66403;315259;1363;352537;41998282;39755460;20081375;57352;21732461
FR;1;2022-01-15;19232;44413;199557;614;224134;42017514;39799873;20280932;57966;21956595
FR;1;2022-01-16;5130;14384;51541;134;59634;42022644;39814257;20332473;58100;22016229
FR;1;2022-01-17;16672;41709;186737;775;208790;42039316;39855966;20519210;58875;22225019
FR;1;2022-01-18;19194;47375;213473;1149;238085;42058510;39903341;20732683;60024;22463104
FR;1;2022-01-19;20051;45564;177119;894;198248;42078561;39948905;20909802;60918;22661352
FR;1;2022-01-20;16516;42133;184944;1136;206013;42095077;39991038;21094746;62054;22867365
FR;1;2022-01-21;19639;48520;230629;1397;255041;42114716;40039558;21325375;63451;23122406
FR;1;2022-01-22;13810;33118;144840;578;161723;42128526;40072676;21470215;64029;23284129
FR;1;2022-01-23;3340;9623;33438;130;38383;42131866;40082299;21503653;64159;23322512
FR;1;2022-01-24;11707;34891;143464;704;159581;42143573;40117190;21647117;64863;23482093
FR;1;2022-01-25;14066;39992;164243;1045;182442;42157639;40157182;21811360;65908;23664535
FR;1;2022-01-26;14786;38485;150854;925;166869;42172425;40195667;21962214;66833;23831404
FR;1;2022-01-27;12256;34654;144031;875;158501;42184681;40230321;22106245;67708;23989905
FR;1;2022-01-28;16188;55407;198913;1143;223134;42200869;40285728;22305158;68851;24213039
FR;1;2022-01-29;10241;37258;135442;520;151835;42211110;40322986;22440600;69371;24364874
FR;1;2022-01-30;2467;10424;29669;84;34480;42213577;40333410;22470269;69455;24399354
FR;1;2022-01-31;8697;32543;104509;530;117607;42222274;40365953;22574778;69985;24516961
FR;1;2022-02-01;9896;36843;127544;854;141695;42232170;40402796;22702322;70839;24658656
FR;1;2022-02-02;11062;41789;130588;764;146117;42243232;40444585;22832910;71603;24804773
FR;1;2022-02-03;8650;34662;116948;767;130330;42251882;40479247;22949858;72370;24935103
FR;1;2022-02-04;11326;49803;172507;961;192788;42263208;40529050;23122365;73331;25127891
FR;1;2022-02-05;7662;35410;117557;391;133058;42270870;40564460;23239922;73722;25260949
FR;1;2022-02-06;1684;9058;22732;82;26921;42272554;40573518;23262654;73804;25287870
FR;1;2022-02-07;6944;35882;119007;448;134934;42279498;40609400;23381661;74252;25422804
FR;1;2022-02-08;7443;31340;125550;688;140506;42286941;40640740;23507211;74940;25563310
FR;1;2022-02-09;8347;35755;135163;688;152345;42295288;40676495;23642374;75628;25715655
FR;1;2022-02-10;6498;28791;116148;668;129844;42301786;40705286;23758522;76296;25845499
FR;1;2022-02-11;8486;41107;164911;868;185100;42310272;40746393;23923433;77164;26030599
FR;1;2022-02-12;5220;27465;106595;377;120756;42315492;40773858;24030028;77541;26151355
FR;1;2022-02-13;1205;5677;21661;61;25277;42316697;40779535;24051689;77602;26176632
FR;1;2022-02-14;5304;26959;117894;390;132904;42322001;40806494;24169583;77992;26309536
FR;1;2022-02-15;5521;27875;118527;607;132091;42327522;40834369;24288110;78599;26441627
FR;1;2022-02-16;5579;27796;110157;591;122738;42333101;40862165;24398267;79190;26564365
FR;1;2022-02-17;4334;18802;72890;480;79912;42337435;40880967;24471157;79670;26644277
FR;1;2022-02-18;5408;26215;98813;666;107717;42342843;40907182;24569970;80336;26751994
FR;1;2022-02-19;3463;17002;59257;301;65810;42346306;40924184;24629227;80637;26817804
FR;1;2022-02-20;760;3192;10633;35;12249;42347066;40927376;24639860;80672;26830053
FR;1;2022-02-21;3276;14369;52357;286;57189;42350342;40941745;24692217;80958;26887242
FR;1;2022-02-22;3625;15225;51543;488;55234;42353967;40956970;24743760;81446;26942476
FR;1;2022-02-23;4097;17382;57124;507;62182;42358064;40974352;24800884;81953;27004658
FR;1;2022-02-24;3161;12449;43216;430;45969;42361225;40986801;24844100;82383;27050627
FR;1;2022-02-25;4305;19118;64438;686;68275;42365530;41005919;24908538;83069;27118902
FR;1;2022-02-26;2643;12470;41163;302;44911;42368173;41018389;24949701;83371;27163813
FR;1;2022-02-27;627;2152;7072;41;7932;42368800;41020541;24956773;83412;27171745
FR;1;2022-02-28;2511;9881;34603;299;37010;42371311;41030422;24991376;83711;27208755
FR;1;2022-03-01;2507;9871;35571;369;36486;42373818;41040293;25026947;84080;27245241
FR;1;2022-03-02;3298;11550;39879;381;41947;42377116;41051843;25066826;84461;27287188
FR;1;2022-03-03;2190;7104;24555;295;24844;42379306;41058947;25091381;84756;27312032
FR;1;2022-03-04;2566;9890;33877;560;33341;42381872;41068837;25125258;85316;27345373
FR;1;2022-03-05;1605;6147;21375;267;21752;42383477;41074984;25146633;85583;27367125
FR;1;2022-03-06;333;901;2819;38;3006;42383810;41075885;25149452;85621;27370131
FR;1;2022-03-07;1276;4291;14799;233;14239;42385086;41080176;25164251;85854;27384370
FR;1;2022-03-08;1444;4757;15949;284;14779;42386530;41084933;25180200;86138;27399149
FR;1;2022-03-09;1754;6068;18146;335;17508;42388284;41091001;25198346;86473;27416657
FR;1;2022-03-10;1109;3664;12349;267;11398;42389393;41094665;25210695;86740;27428055
FR;2;2020-12-27;0;0;0;0;0;0;0;0;0;0
FR;2;2020-12-28;0;0;0;0;0;0;0;0;0;0
FR;2;2020-12-29;0;0;0;0;0;0;0;0;0;0
FR;2;2020-12-30;0;0;0;0;0;0;0;0;0;0
FR;2;2020-12-31;0;0;0;0;0;0;0;0;0;0
FR;2;2021-01-01;0;0;0;0;0;0;0;0;0;0
FR;2;2021-01-02;0;0;0;0;0;0;0;0;0;0
FR;2;2021-01-03;0;0;0;0;0;0;0;0;0;0
FR;2;2021-01-04;0;0;0;0;0;0;0;0;0;0
FR;2;2021-01-05;0;0;0;0;0;0;0;0;0;0
FR;2;2021-01-06;0;0;0;0;0;0;0;0;0;0
FR;2;2021-01-07;0;0;0;0;0;0;0;0;0;0
FR;2;2021-01-08;0;0;0;0;0;0;0;0;0;0
FR;2;2021-01-09;0;0;0;0;0;0;0;0;0;0
FR;2;2021-01-10;0;0;0;0;0;0;0;0;0;0
FR;2;2021-01-11;0;0;0;0;0;0;0;0;0;0
FR;2;2021-01-12;0;0;0;0;0;0;0;0;0;0
FR;2;2021-01-13;0;0;0;0;0;0;0;0;0;0
FR;2;2021-01-14;1707;0;0;0;0;1707;0;0;0;0
FR;2;2021-01-15;388;0;0;0;0;2095;0;0;0;0
FR;2;2021-01-16;309;0;0;0;0;2404;0;0;0;0
FR;2;2021-01-17;80;0;0;0;0;2484;0;0;0;0
FR;2;2021-01-18;3072;0;0;0;0;5556;0;0;0;0
FR;2;2021-01-19;4674;0;0;0;0;10230;0;0;0;0
FR;2;2021-01-20;5133;1;0;0;0;15363;1;0;0;0
FR;2;2021-01-21;5333;2;0;0;0;20696;3;0;0;0
FR;2;2021-01-22;5116;0;0;0;0;25812;3;0;0;0
FR;2;2021-01-23;1862;0;0;0;0;27674;3;0;0;0
FR;2;2021-01-24;160;1;0;0;0;27834;4;0;0;0
FR;2;2021-01-25;3809;1;0;0;0;31643;5;0;0;0
FR;2;2021-01-26;3914;0;0;0;0;35557;5;0;0;0
FR;2;2021-01-27;3594;1;0;0;0;39151;6;0;0;0
FR;2;2021-01-28;3738;0;0;0;0;42889;6;0;0;0
FR;2;2021-01-29;3286;2;0;0;0;46175;8;0;0;0
FR;2;2021-01-30;1129;1;0;0;0;47304;9;0;0;0
FR;2;2021-01-31;45;0;0;0;0;47349;9;0;0;0
FR;2;2021-02-01;3399;2;0;0;0;50748;11;0;0;0
FR;2;2021-02-02;4484;5;0;0;0;55232;16;0;0;0
FR;2;2021-02-03;5214;2;0;0;0;60446;18;0;0;0
FR;2;2021-02-04;4922;5;0;0;0;65368;23;0;0;0
FR;2;2021-02-05;4808;10;0;0;0;70176;33;0;0;0
FR;2;2021-02-06;2035;7;0;0;0;72211;40;0;0;0
FR;2;2021-02-07;97;4;0;0;0;72308;44;0;0;0
FR;2;2021-02-08;7548;16;0;0;0;79856;60;0;0;0
FR;2;2021-02-09;8417;24;0;0;0;88273;84;0;0;0
FR;2;2021-02-10;9336;55;0;0;0;97609;139;0;0;0
FR;2;2021-02-11;10270;69;0;0;0;107879;208;0;0;0
FR;2;2021-02-12;10044;243;0;0;0;117923;451;0;0;0
FR;2;2021-02-13;3115;227;0;0;0;121038;678;0;0;0
FR;2;2021-02-14;349;2;0;0;0;121387;680;0;0;0
FR;2;2021-02-15;3452;3065;0;0;0;124839;3745;0;0;0
FR;2;2021-02-16;5062;3886;0;0;0;129901;7631;0;0;0
FR;2;2021-02-17;4246;4402;0;0;0;134147;12033;0;0;0
FR;2;2021-02-18;5397;5089;0;0;0;139544;17122;0;0;0
FR;2;2021-02-19;5318;4327;0;0;0;144862;21449;0;0;0
FR;2;2021-02-20;1864;1509;0;0;0;146726;22958;0;0;0
FR;2;2021-02-21;238;86;0;0;0;146964;23044;0;0;0
FR;2;2021-02-22;3607;3718;0;0;0;150571;26762;0;0;0
FR;2;2021-02-23;4949;3691;0;0;0;155520;30453;0;0;0
FR;2;2021-02-24;5005;3462;0;0;0;160525;33915;0;0;0
FR;2;2021-02-25;5477;3435;0;0;0;166002;37350;0;0;0
FR;2;2021-02-26;4353;3131;0;0;0;170355;40481;0;0;0
FR;2;2021-02-27;1622;1043;0;0;0;171977;41524;0;0;0
FR;2;2021-02-28;174;33;0;0;0;172151;41557;0;0;0
FR;2;2021-03-01;5166;3763;0;0;0;177317;45320;0;0;0
FR;2;2021-03-02;6525;4720;0;0;0;183842;50040;0;0;0
FR;2;2021-03-03;6531;4884;0;0;0;190373;54924;0;0;0
FR;2;2021-03-04;8392;3956;0;0;0;198765;58880;0;0;0
FR;2;2021-03-05;8022;4062;0;0;0;206787;62942;0;0;0
FR;2;2021-03-06;4782;1682;0;0;0;211569;64624;0;0;0
FR;2;2021-03-07;2371;31;0;0;0;213940;64655;0;0;0
FR;2;2021-03-08;4163;8307;0;0;0;218103;72962;0;0;0
FR;2;2021-03-09;7481;8431;1;0;0;225584;81393;1;0;0
FR;2;2021-03-10;7082;9097;0;0;0;232666;90490;1;0;0
FR;2;2021-03-11;9366;9184;1;0;0;242032;99674;2;0;0
FR;2;2021-03-12;7966;8175;0;0;0;249998;107849;2;0;0
FR;2;2021-03-13;10040;2512;0;0;0;260038;110361;2;0;0
FR;2;2021-03-14;4837;402;0;0;0;264875;110763;2;0;0
FR;2;2021-03-15;10903;3490;0;0;0;275778;114253;2;0;0
FR;2;2021-03-16;16751;4635;1;0;0;292529;118888;3;0;0
FR;2;2021-03-17;20215;3960;0;0;0;312744;122848;3;0;0
FR;2;2021-03-18;23358;4892;0;0;0;336102;127740;3;0;0
FR;2;2021-03-19;23295;4526;0;0;0;359397;132266;3;0;0
FR;2;2021-03-20;25434;1537;0;0;0;384831;133803;3;0;0
FR;2;2021-03-21;17667;147;0;0;0;402498;133950;3;0;0
FR;2;2021-03-22;17776;3065;0;0;0;420274;137015;3;0;0
FR;2;2021-03-23;22681;4190;0;0;0;442955;141205;3;0;0
FR;2;2021-03-24;23950;4983;0;0;0;466905;146188;3;0;0
FR;2;2021-03-25;26729;5036;1;0;0;493634;151224;4;0;0
FR;2;2021-03-26;26969;4262;0;0;0;520603;155486;4;0;0
FR;2;2021-03-27;15912;1307;0;0;0;536515;156793;4;0;0
FR;2;2021-03-28;10560;96;0;0;0;547075;156889;4;0;0
FR;2;2021-03-29;18979;4281;0;0;0;566054;161170;4;0;0
FR;2;2021-03-30;24567;6011;0;0;0;590621;167181;4;0;0
FR;2;2021-03-31;28545;5949;0;0;0;619166;173130;4;0;0
FR;2;2021-04-01;34535;8487;1;0;0;653701;181617;5;0;0
FR;2;2021-04-02;29971;7665;0;0;0;683672;189282;5;0;0
FR;2;2021-04-03;16949;3583;0;0;0;700621;192865;5;0;0
FR;2;2021-04-04;9304;922;2;0;0;709925;193787;7;0;0
FR;2;2021-04-05;12434;815;0;0;0;722359;194602;7;0;0
FR;2;2021-04-06;27132;6928;0;0;0;749491;201530;7;0;0
FR;2;2021-04-07;30921;7157;1;0;0;780412;208687;8;0;0
FR;2;2021-04-08;36873;8804;1;0;0;817285;217491;9;0;0
FR;2;2021-04-09;33821;8587;28;0;0;851106;226078;37;0;0
FR;2;2021-04-10;19675;8966;1;0;0;870781;235044;38;0;0
FR;2;2021-04-11;7937;4266;1;0;0;878718;239310;39;0;0
FR;2;2021-04-12;17118;11238;0;0;0;895836;250548;39;0;0
FR;2;2021-04-13;19442;16408;1;0;0;915278;266956;40;0;0
FR;2;2021-04-14;18052;16266;7;0;0;933330;283222;47;0;0
FR;2;2021-04-15;22176;20750;26;0;0;955506;303972;73;0;0
FR;2;2021-04-16;20702;20042;45;0;0;976208;324014;118;0;0
FR;2;2021-04-17;13248;22437;5;0;0;989456;346451;123;0;0
FR;2;2021-04-18;5907;14390;5;0;0;995363;360841;128;0;0
FR;2;2021-04-19;16824;16232;24;0;0;1012187;377073;152;0;0
FR;2;2021-04-20;19310;21542;38;0;0;1031497;398615;190;0;0
FR;2;2021-04-21;20278;21649;76;0;0;1051775;420264;266;0;0
FR;2;2021-04-22;23798;24834;41;0;0;1075573;445098;307;0;0
FR;2;2021-04-23;24504;25330;76;0;0;1100077;470428;383;0;0
FR;2;2021-04-24;25295;15078;102;0;0;1125372;485506;485;0;0
FR;2;2021-04-25;9592;8589;5;0;0;1134964;494095;490;0;0
FR;2;2021-04-26;17150;17189;20;0;0;1152114;511284;510;0;0
FR;2;2021-04-27;19238;24278;40;0;0;1171352;535562;550;0;0
FR;2;2021-04-28;22330;26168;112;0;0;1193682;561730;662;0;0
FR;2;2021-04-29;25460;30111;69;0;0;1219142;591841;731;0;0
FR;2;2021-04-30;25529;27749;49;1;0;1244671;619590;780;1;0
FR;2;2021-05-01;14977;9860;6;0;0;1259648;629450;786;1;0
FR;2;2021-05-02;6634;9174;2;0;0;1266282;638624;788;1;0
FR;2;2021-05-03;20011;19300;40;0;0;1286293;657924;828;1;0
FR;2;2021-05-04;18277;29022;33;0;0;1304570;686946;861;1;0
FR;2;2021-05-05;18355;29371;47;0;0;1322925;716317;908;1;0
FR;2;2021-05-06;23530;35235;131;0;0;1346455;751552;1039;1;0
FR;2;2021-05-07;25319;33201;97;0;0;1371774;784753;1136;1;0
FR;2;2021-05-08;21332;9696;14;0;0;1393106;794449;1150;1;0
FR;2;2021-05-09;13160;7884;7;0;0;1406266;802333;1157;1;0
FR;2;2021-05-10;32932;22185;47;0;0;1439198;824518;1204;1;0
FR;2;2021-05-11;43587;21051;101;0;0;1482785;845569;1305;1;0
FR;2;2021-05-12;50033;19877;141;0;0;1532818;865446;1446;1;0
FR;2;2021-05-13;51283;5763;31;0;0;1584101;871209;1477;1;0
FR;2;2021-05-14;61333;12920;131;0;0;1645434;884129;1608;1;0
FR;2;2021-05-15;65918;7140;39;0;0;1711352;891269;1647;1;0
FR;2;2021-05-16;43575;2567;10;0;0;1754927;893836;1657;1;0
FR;2;2021-05-17;44736;12561;113;0;0;1799663;906397;1770;1;0
FR;2;2021-05-18;54629;12234;191;0;0;1854292;918631;1961;1;0
FR;2;2021-05-19;57156;10599;280;0;0;1911448;929230;2241;1;0
FR;2;2021-05-20;63426;10841;286;0;0;1974874;940071;2527;1;0
FR;2;2021-05-21;64278;11648;229;0;0;2039152;951719;2756;1;0
FR;2;2021-05-22;61474;4499;65;0;0;2100626;956218;2821;1;0
FR;2;2021-05-23;37528;568;22;0;0;2138154;956786;2843;1;0
FR;2;2021-05-24;17229;2030;33;0;0;2155383;958816;2876;1;0
FR;2;2021-05-25;21097;12233;238;0;0;2176480;971049;3114;1;0
FR;2;2021-05-26;19925;11444;229;0;0;2196405;982493;3343;1;0
FR;2;2021-05-27;22983;12647;181;0;0;2219388;995140;3524;1;0
FR;2;2021-05-28;29381;14952;190;0;0;2248769;1010092;3714;1;0
FR;2;2021-05-29;30410;8175;57;0;0;2279179;1018267;3771;1;0
FR;2;2021-05-30;4646;1809;6;0;0;2283825;1020076;3777;1;0
FR;2;2021-05-31;28577;18714;183;0;0;2312402;1038790;3960;1;0
FR;2;2021-06-01;45702;20027;221;0;0;2358104;1058817;4181;1;0
FR;2;2021-06-02;37463;19291;180;0;0;2395567;1078108;4361;1;0
FR;2;2021-06-03;51260;23356;161;0;0;2446827;1101464;4522;1;0
FR;2;2021-06-04;65501;24048;215;0;0;2512328;1125512;4737;1;0
FR;2;2021-06-05;34591;24022;51;0;0;2546919;1149534;4788;1;0
FR;2;2021-06-06;4946;6196;10;0;0;2551865;1155730;4798;1;0
FR;2;2021-06-07;28161;23059;145;0;0;2580026;1178789;4943;1;0
FR;2;2021-06-08;46368;22922;143;0;0;2626394;1201711;5086;1;0
FR;2;2021-06-09;34278;20910;107;0;0;2660672;1222621;5193;1;0
FR;2;2021-06-10;42629;19135;95;1;0;2703301;1241756;5288;2;0
FR;2;2021-06-11;55273;25220;133;0;0;2758574;1266976;5421;2;0
FR;2;2021-06-12;30553;19782;53;0;0;2789127;1286758;5474;2;0
FR;2;2021-06-13;3327;9181;13;0;0;2792454;1295939;5487;2;0
FR;2;2021-06-14;25294;24159;92;0;0;2817748;1320098;5579;2;0
FR;2;2021-06-15;39021;22852;154;0;0;2856769;1342950;5733;2;0
FR;2;2021-06-16;30152;21454;134;0;0;2886921;1364404;5867;2;0
FR;2;2021-06-17;36893;25868;150;0;0;2923814;1390272;6017;2;0
FR;2;2021-06-18;46838;28787;121;0;0;2970652;1419059;6138;2;0
FR;2;2021-06-19;24521;24891;39;0;0;2995173;1443950;6177;2;0
FR;2;2021-06-20;3737;10060;10;0;0;2998910;1454010;6187;2;0
FR;2;2021-06-21;17518;42829;87;0;0;3016428;1496839;6274;2;0
FR;2;2021-06-22;28353;49534;110;0;0;3044781;1546373;6384;2;0
FR;2;2021-06-23;21779;49568;106;1;1;3066560;1595941;6490;3;1
FR;2;2021-06-24;28368;50283;133;0;0;3094928;1646224;6623;3;1
FR;2;2021-06-25;33391;60371;125;0;0;3128319;1706595;6748;3;1
FR;2;2021-06-26;16368;59235;54;1;0;3144687;1765830;6802;4;1
FR;2;2021-06-27;2564;29321;22;1;0;3147251;1795151;6824;5;1
FR;2;2021-06-28;12629;54337;80;0;0;3159880;1849488;6904;5;1
FR;2;2021-06-29;19837;59873;178;0;0;3179717;1909361;7082;5;1
FR;2;2021-06-30;16315;57837;251;17;0;3196032;1967198;7333;22;1
FR;2;2021-07-01;20479;59878;226;0;0;3216511;2027076;7559;22;1
FR;2;2021-07-02;24068;62115;183;0;0;3240579;2089191;7742;22;1
FR;2;2021-07-03;12107;57072;153;0;0;3252686;2146263;7895;22;1
FR;2;2021-07-04;1956;23308;18;0;0;3254642;2169571;7913;22;1
FR;2;2021-07-05;9162;29354;106;0;0;3263804;2198925;8019;22;1
FR;2;2021-07-06;14566;36194;134;0;0;3278370;2235119;8153;22;1
FR;2;2021-07-07;14398;33661;138;0;0;3292768;2268780;8291;22;1
FR;2;2021-07-08;19701;40282;162;0;0;3312469;2309062;8453;22;1
FR;2;2021-07-09;27085;54255;202;1;1;3339554;2363317;8655;23;2
FR;2;2021-07-10;13378;33658;107;0;0;3352932;2396975;8762;23;2
FR;2;2021-07-11;1801;4336;16;0;0;3354733;2401311;8778;23;2
FR;2;2021-07-12;12960;37257;118;0;0;3367693;2438568;8896;23;2
FR;2;2021-07-13;37101;53235;150;0;0;3404794;2491803;9046;23;2
FR;2;2021-07-14;6599;3573;15;0;0;3411393;2495376;9061;23;2
FR;2;2021-07-15;47213;47026;156;0;0;3458606;2542402;9217;23;2
FR;2;2021-07-16;64303;55819;187;0;0;3522909;2598221;9404;23;2
FR;2;2021-07-17;31584;23931;96;0;0;3554493;2622152;9500;23;2
FR;2;2021-07-18;6085;4900;19;0;0;3560578;2627052;9519;23;2
FR;2;2021-07-19;32980;28694;93;0;0;3593558;2655746;9612;23;2
FR;2;2021-07-20;51976;44558;155;0;0;3645534;2700304;9767;23;2
FR;2;2021-07-21;45243;34778;93;0;0;3690777;2735082;9860;23;2
FR;2;2021-07-22;56267;41104;128;1;0;3747044;2776186;9988;24;2
FR;2;2021-07-23;68272;49096;170;0;0;3815316;2825282;10158;24;2
FR;2;2021-07-24;36154;21573;82;0;0;3851470;2846855;10240;24;2
FR;2;2021-07-25;6735;2671;10;0;0;3858205;2849526;10250;24;2
FR;2;2021-07-26;36280;22472;91;1;0;3894485;2871998;10341;25;2
FR;2;2021-07-27;62341;34630;180;0;0;3956826;2906628;10521;25;2
FR;2;2021-07-28;55269;26462;133;0;0;4012095;2933090;10654;25;2
FR;2;2021-07-29;68424;32769;189;0;0;4080519;2965859;10843;25;2
FR;2;2021-07-30;74405;37777;222;1;1;4154924;3003636;11065;26;3
FR;2;2021-07-31;34736;16172;104;0;0;4189660;3019808;11169;26;3
FR;2;2021-08-01;5387;2295;19;0;0;4195047;3022103;11188;26;3
FR;2;2021-08-02;35843;16199;101;0;0;4230890;3038302;11289;26;3
FR;2;2021-08-03;55945;28280;142;0;0;4286835;3066582;11431;26;3
FR;2;2021-08-04;46656;20861;128;0;0;4333491;3087443;11559;26;3
FR;2;2021-08-05;54620;31577;215;0;0;4388111;3119020;11774;26;3
FR;2;2021-08-06;58060;42387;242;1;0;4446171;3161407;12016;27;3
FR;2;2021-08-07;25128;17598;89;0;0;4471299;3179005;12105;27;3
FR;2;2021-08-08;3829;3668;21;0;0;4475128;3182673;12126;27;3
FR;2;2021-08-09;29278;21142;91;0;0;4504406;3203815;12217;27;3
FR;2;2021-08-10;44974;33517;152;0;0;4549380;3237332;12369;27;3
FR;2;2021-08-11;35251;25161;150;0;0;4584631;3262493;12519;27;3
FR;2;2021-08-12;41869;35732;162;0;0;4626500;3298225;12681;27;3
FR;2;2021-08-13;42577;36962;218;0;0;4669077;3335187;12899;27;3
FR;2;2021-08-14;18500;22281;93;0;0;4687577;3357468;12992;27;3
FR;2;2021-08-15;3769;3811;17;0;0;4691346;3361279;13009;27;3
FR;2;2021-08-16;25063;27234;110;0;0;4716409;3388513;13119;27;3
FR;2;2021-08-17;38242;43478;204;1;0;4754651;3431991;13323;28;3
FR;2;2021-08-18;32234;36380;192;1;1;4786885;3468371;13515;29;4
FR;2;2021-08-19;37418;46601;223;0;0;4824303;3514972;13738;29;4
FR;2;2021-08-20;40550;55574;267;1;0;4864853;3570546;14005;30;4
FR;2;2021-08-21;18112;24290;113;0;0;4882965;3594836;14118;30;4
FR;2;2021-08-22;2899;4322;22;1;1;4885864;3599158;14140;31;5
FR;2;2021-08-23;19239;35132;131;1;1;4905103;3634290;14271;32;6
FR;2;2021-08-24;31928;56027;234;0;0;4937031;3690317;14505;32;6
FR;2;2021-08-25;25923;43421;249;0;0;4962954;3733738;14754;32;6
FR;2;2021-08-26;32338;55750;387;0;0;4995292;3789488;15141;32;6
FR;2;2021-08-27;36990;65553;477;3;1;5032282;3855041;15618;35;7
FR;2;2021-08-28;17807;28436;300;0;0;5050089;3883477;15918;35;7
FR;2;2021-08-29;2653;5042;47;0;0;5052742;3888519;15965;35;7
FR;2;2021-08-30;18405;37744;398;0;761;5071147;3926263;16363;35;768
FR;2;2021-08-31;28062;57503;881;4;1526;5099209;3983766;17244;39;2294
FR;2;2021-09-01;21581;39804;1304;0;2080;5120790;4023570;18548;39;4374
FR;2;2021-09-02;25471;48595;1957;1;3266;5146261;4072165;20505;40;7640
FR;2;2021-09-03;33406;64447;2983;3;4797;5179667;4136612;23488;43;12437
FR;2;2021-09-04;16819;27659;1441;1;2339;5196486;4164271;24929;44;14776
FR;2;2021-09-05;2258;3632;261;0;412;5198744;4167903;25190;44;15188
FR;2;2021-09-06;14023;28728;1768;1;2925;5212767;4196631;26958;45;18113
FR;2;2021-09-07;21092;41033;3019;13;4831;5233859;4237664;29977;58;22944
FR;2;2021-09-08;17229;31912;2729;6;4428;5251088;4269576;32706;64;27372
FR;2;2021-09-09;20969;40422;4424;3;6705;5272057;4309998;37130;67;34077
FR;2;2021-09-10;28184;51084;5276;4;8765;5300241;4361082;42406;71;42842
FR;2;2021-09-11;13648;22314;2401;5;3910;5313889;4383396;44807;76;46752
FR;2;2021-09-12;1819;2796;281;0;495;5315708;4386192;45088;76;47247
FR;2;2021-09-13;11654;21446;2459;4;3980;5327362;4407638;47547;80;51227
FR;2;2021-09-14;18559;32768;5078;13;8987;5345921;4440406;52625;93;60214
FR;2;2021-09-15;14908;28276;5163;3;7777;5360829;4468682;57788;96;67991
FR;2;2021-09-16;16062;32740;6730;14;10509;5376891;4501422;64518;110;78500
FR;2;2021-09-17;20907;47047;8771;10;14553;5397798;4548469;73289;120;93053
FR;2;2021-09-18;9853;20926;3801;6;6024;5407651;4569395;77090;126;99077
FR;2;2021-09-19;1165;2656;395;0;648;5408816;4572051;77485;126;99725
FR;2;2021-09-20;7485;18805;3847;7;6145;5416301;4590856;81332;133;105870
FR;2;2021-09-21;11200;30011;6491;5;10737;5427501;4620867;87823;138;116607
FR;2;2021-09-22;9405;23546;5488;7;8505;5436906;4644413;93311;145;125112
FR;2;2021-09-23;10717;28854;7874;9;12615;5447623;4673267;101185;154;137727
FR;2;2021-09-24;15055;42808;10861;18;17141;5462678;4716075;112046;172;154868
FR;2;2021-09-25;7257;18699;3958;10;6066;5469935;4734774;116004;182;160934
FR;2;2021-09-26;1078;2559;494;0;640;5471013;4737333;116498;182;161574
FR;2;2021-09-27;6307;16448;4283;6;6549;5477320;4753781;120781;188;168123
FR;2;2021-09-28;9241;25534;7757;13;12053;5486561;4779315;128538;201;180176
FR;2;2021-09-29;8072;20195;6065;25;9247;5494633;4799510;134603;226;189423
FR;2;2021-09-30;9860;25767;9494;16;14066;5504493;4825277;144097;242;203489
FR;2;2021-10-01;13961;35606;12902;25;19204;5518454;4860883;156999;267;222693
FR;2;2021-10-02;6870;15850;4845;6;6991;5525324;4876733;161844;273;229684
FR;2;2021-10-03;839;1974;491;1;518;5526163;4878707;162335;274;230202
FR;2;2021-10-04;5815;13927;5511;5;7855;5531978;4892634;167846;279;238057
FR;2;2021-10-05;9045;22535;11118;19;15704;5541023;4915169;178964;298;253761
FR;2;2021-10-06;7771;17757;8233;11;11060;5548794;4932926;187197;309;264821
FR;2;2021-10-07;9192;22180;12367;15;16809;5557986;4955106;199564;324;281630
FR;2;2021-10-08;13419;31992;17336;27;23489;5571405;4987098;216900;351;305119
FR;2;2021-10-09;5993;12802;6039;6;7865;5577398;4999900;222939;357;312984
FR;2;2021-10-10;884;1640;434;2;626;5578282;5001540;223373;359;313610
FR;2;2021-10-11;5599;11617;6453;17;8837;5583881;5013157;229826;376;322447
FR;2;2021-10-12;8030;17756;12531;13;16716;5591911;5030913;242357;389;339163
FR;2;2021-10-13;6933;14857;10242;11;13597;5598844;5045770;252599;400;352760
FR;2;2021-10-14;8311;17920;14984;13;19436;5607155;5063690;267583;413;372196
FR;2;2021-10-15;11842;26239;20893;26;27914;5618997;5089929;288476;439;400110
FR;2;2021-10-16;5137;8713;1815;0;3204;5624134;5098642;290291;439;403314
FR;2;2021-10-17;649;1199;183;0;377;5624783;5099841;290474;439;403691
FR;2;2021-10-18;4555;7457;659;2;1679;5629338;5107298;291133;441;405370
FR;2;2021-10-19;6234;9909;728;5;2064;5635572;5117207;291861;446;407434
FR;2;2021-10-20;5161;8114;756;3;1681;5640733;5125321;292617;449;409115
FR;2;2021-10-21;6083;9964;775;5;2087;5646816;5135285;293392;454;411202
FR;2;2021-10-22;8443;14525;1134;4;2848;5655259;5149810;294526;458;414050
FR;2;2021-10-23;3839;5996;577;0;1236;5659098;5155806;295103;458;415286
FR;2;2021-10-24;493;890;99;0;204;5659591;5156696;295202;458;415490
FR;2;2021-10-25;3356;5390;293;1;826;5662947;5162086;295495;459;416316
FR;2;2021-10-26;4170;7238;1113;4;1989;5667117;5169324;296608;463;418305
FR;2;2021-10-27;3669;6630;1190;5;1998;5670786;5175954;297798;468;420303
FR;2;2021-10-28;4592;7691;1723;3;2734;5675378;5183645;299521;471;423037
FR;2;2021-10-29;5404;11074;2426;4;3661;5680782;5194719;301947;475;426698
FR;2;2021-10-30;2745;4414;971;1;1423;5683527;5199133;302918;476;428121
FR;2;2021-10-31;365;555;138;1;188;5683892;5199688;303056;477;428309
FR;2;2021-11-01;412;551;170;0;255;5684304;5200239;303226;477;428564
FR;2;2021-11-02;3285;6765;1177;0;1757;5687589;5207004;304403;477;430321
FR;2;2021-11-03;3330;6247;1379;2;1959;5690919;5213251;305782;479;432280
FR;2;2021-11-04;3979;7113;1752;4;2486;5694898;5220364;307534;483;434766
FR;2;2021-11-05;5218;10483;2857;5;3930;5700116;5230847;310391;488;438696
FR;2;2021-11-06;2589;4634;1395;0;1799;5702705;5235481;311786;488;440495
FR;2;2021-11-07;505;880;215;0;288;5703210;5236361;312001;488;440783
FR;2;2021-11-08;2570;5373;1198;3;1679;5705780;5241734;313199;491;442462
FR;2;2021-11-09;2748;6957;2386;6;3167;5708528;5248691;315585;497;445629
FR;2;2021-11-10;2580;5704;5083;6;6247;5711108;5254395;320668;503;451876
FR;2;2021-11-11;431;742;729;2;909;5711539;5255137;321397;505;452785
FR;2;2021-11-12;2948;8084;8955;8;10876;5714487;5263221;330352;513;463661
FR;2;2021-11-13;1528;3331;3861;7;4509;5716015;5266552;334213;520;468170
FR;2;2021-11-14;253;625;346;1;493;5716268;5267177;334559;521;468663
FR;2;2021-11-15;1619;3729;4431;9;5324;5717887;5270906;338990;530;473987
FR;2;2021-11-16;2181;5967;8280;14;10050;5720068;5276873;347270;544;484037
FR;2;2021-11-17;1731;4573;6611;8;7829;5721799;5281446;353881;552;491866
FR;2;2021-11-18;2187;5938;9163;11;10979;5723986;5287384;363044;563;502845
FR;2;2021-11-19;2696;7794;12952;19;15447;5726682;5295178;375996;582;518292
FR;2;2021-11-20;1562;3303;5163;5;6056;5728244;5298481;381159;587;524348
FR;2;2021-11-21;246;526;536;0;665;5728490;5299007;381695;587;525013
FR;2;2021-11-22;1274;2644;4466;5;5402;5729764;5301651;386161;592;530415
FR;2;2021-11-23;1611;4323;8183;9;9889;5731375;5305974;394344;601;540304
FR;2;2021-11-24;1421;3820;7451;15;8706;5732796;5309794;401795;616;549010
FR;2;2021-11-25;1811;4893;11438;21;13626;5734607;5314687;413233;637;562636
FR;2;2021-11-26;2533;7776;22636;31;26054;5737140;5322463;435869;668;588690
FR;2;2021-11-27;1498;4132;12252;18;13987;5738638;5326595;448121;686;602677
FR;2;2021-11-28;293;848;1962;3;2291;5738931;5327443;450083;689;604968
FR;2;2021-11-29;1444;4383;15067;23;17225;5740375;5331826;465150;712;622193
FR;2;2021-11-30;1907;6771;26215;36;29968;5742282;5338597;491365;748;652161
FR;2;2021-12-01;1907;6085;26174;29;29477;5744189;5344682;517539;777;681638
FR;2;2021-12-02;1913;6828;37677;52;41909;5746102;5351510;555216;829;723547
FR;2;2021-12-03;2548;10082;53575;112;59280;5748650;5361592;608791;941;782827
FR;2;2021-12-04;1846;6256;37081;38;40731;5750496;5367848;645872;979;823558
FR;2;2021-12-05;458;2295;14246;13;15994;5750954;5370143;660118;992;839552
FR;2;2021-12-06;2453;9879;77669;109;84720;5753407;5380022;737787;1101;924272
FR;2;2021-12-07;3441;15330;122393;238;133659;5756848;5395352;860180;1339;1057931
FR;2;2021-12-08;3717;16049;133146;330;145336;5760565;5411401;993326;1669;1203267
FR;2;2021-12-09;4543;19577;170110;554;185439;5765108;5430978;1163436;2223;1388706
FR;2;2021-12-10;4663;22788;188587;489;205985;5769771;5453766;1352023;2712;1594691
FR;2;2021-12-11;3684;16598;132413;237;144827;5773455;5470364;1484436;2949;1739518
FR;2;2021-12-12;1257;7146;59068;83;65134;5774712;5477510;1543504;3032;1804652
FR;2;2021-12-13;5523;26882;220624;604;242927;5780235;5504392;1764128;3636;2047579
FR;2;2021-12-14;7017;37492;300688;906;332116;5787252;5541884;2064816;4542;2379695
FR;2;2021-12-15;6562;36228;285135;955;315726;5793814;5578112;2349951;5497;2695421
FR;2;2021-12-16;7768;37923;312072;981;343658;5801582;5616035;2662023;6478;3039079
FR;2;2021-12-17;8688;41199;327799;975;360850;5810270;5657234;2989822;7453;3399929
FR;2;2021-12-18;6518;26553;212304;448;233597;5816788;5683787;3202126;7901;3633526
FR;2;2021-12-19;2603;11529;90195;184;100400;5819391;5695316;3292321;8085;3733926
FR;2;2021-12-20;9552;33608;275115;705;303287;5828943;5728924;3567436;8790;4037213
FR;2;2021-12-21;11551;38293;309557;969;341314;5840494;5767217;3876993;9759;4378527
FR;2;2021-12-22;10450;32889;265053;951;292458;5850944;5800106;4142046;10710;4670985
FR;2;2021-12-23;9424;26705;199439;700;221230;5860368;5826811;4341485;11410;4892215
FR;2;2021-12-24;2782;7504;43838;140;49563;5863150;5834315;4385323;11550;4941778
FR;2;2021-12-25;202;712;2000;10;2505;5863352;5835027;4387323;11560;4944283
FR;2;2021-12-26;1322;4206;25141;71;28678;5864674;5839233;4412464;11631;4972961
FR;2;2021-12-27;8072;29928;218362;658;243276;5872746;5869161;4630826;12289;5216237
FR;2;2021-12-28;9843;36352;272045;741;301935;5882589;5905513;4902871;13030;5518172
FR;2;2021-12-29;9494;32288;246078;766;272651;5892083;5937801;5148949;13796;5790823
FR;2;2021-12-30;9449;28123;208791;662;231447;5901532;5965924;5357740;14458;6022270
FR;2;2021-12-31;3008;8401;54970;177;61241;5904540;5974325;5412710;14635;6083511
FR;2;2022-01-01;227;689;2849;7;3338;5904767;5975014;5415559;14642;6086849
FR;2;2022-01-02;1505;4854;29503;74;33394;5906272;5979868;5445062;14716;6120243
FR;2;2022-01-03;9573;35328;266496;807;293837;5915845;6015196;5711558;15523;6414080
FR;2;2022-01-04;12839;45351;342040;1067;376919;5928684;6060547;6053598;16590;6790999
FR;2;2022-01-05;11270;38668;294120;884;323785;5939954;6099215;6347718;17474;7114784
FR;2;2022-01-06;13652;43454;331902;1296;364657;5953606;6142669;6679620;18770;7479441
FR;2;2022-01-07;14226;47625;361042;1269;396367;5967832;6190294;7040662;20039;7875808
FR;2;2022-01-08;7944;28140;201232;514;221656;5975776;6218434;7241894;20553;8097464
FR;2;2022-01-09;2752;9031;62507;137;69528;5978528;6227465;7304401;20690;8166992
FR;2;2022-01-10;10088;31925;232441;857;255045;5988616;6259390;7536842;21547;8422037
FR;2;2022-01-11;11460;36253;265877;1028;290572;6000076;6295643;7802719;22575;8712609
FR;2;2022-01-12;8753;29840;206281;861;226157;6008829;6325483;8009000;23436;8938766
FR;2;2022-01-13;9379;31324;224453;829;244794;6018208;6356807;8233453;24265;9183560
FR;2;2022-01-14;9743;35690;254517;919;277691;6027951;6392497;8487970;25184;9461251
FR;2;2022-01-15;5353;19442;140758;358;153624;6033304;6411939;8628728;25542;9614875
FR;2;2022-01-16;1512;5553;35861;79;39850;6034816;6417492;8664589;25621;9654725
FR;2;2022-01-17;5544;19320;135410;601;147276;6040360;6436812;8799999;26222;9802001
FR;2;2022-01-18;6415;21553;148601;647;160479;6046775;6458365;8948600;26869;9962480
FR;2;2022-01-19;4383;16415;105086;552;113697;6051158;6474780;9053686;27421;10076177
FR;2;2022-01-20;4862;17595;115286;601;123685;6056020;6492375;9168972;28022;10199862
FR;2;2022-01-21;5193;20077;137342;677;147763;6061213;6512452;9306314;28699;10347625
FR;2;2022-01-22;3025;10974;74246;259;80324;6064238;6523426;9380560;28958;10427949
FR;2;2022-01-23;722;2754;15232;41;16838;6064960;6526180;9395792;28999;10444787
FR;2;2022-01-24;3290;12839;75080;428;81033;6068250;6539019;9470872;29427;10525820
FR;2;2022-01-25;3573;14469;79619;494;85462;6071823;6553488;9550491;29921;10611282
FR;2;2022-01-26;2515;10674;58975;363;63011;6074338;6564162;9609466;30284;10674293
FR;2;2022-01-27;2683;11227;64166;386;67894;6077021;6575389;9673632;30670;10742187
FR;2;2022-01-28;3540;18447;91765;430;99030;6080561;6593836;9765397;31100;10841217
FR;2;2022-01-29;1890;9274;48831;163;52919;6082451;6603110;9814228;31263;10894136
FR;2;2022-01-30;466;2256;9453;37;10612;6082917;6605366;9823681;31300;10904748
FR;2;2022-01-31;1882;9616;43812;208;47345;6084799;6614982;9867493;31508;10952093
FR;2;2022-02-01;1906;10059;47013;278;50103;6086705;6625041;9914506;31786;11002196
FR;2;2022-02-02;1605;9038;41086;249;44152;6088310;6634079;9955592;32035;11046348
FR;2;2022-02-03;1710;8941;40495;204;42893;6090020;6643020;9996087;32239;11089241
FR;2;2022-02-04;2147;15227;66598;297;71323;6092167;6658247;10062685;32536;11160564
FR;2;2022-02-05;1357;8548;35920;131;39222;6093524;6666795;10098605;32667;11199786
FR;2;2022-02-06;274;1796;6121;16;6896;6093798;6668591;10104726;32683;11206682
FR;2;2022-02-07;1339;9616;37732;133;41295;6095137;6678207;10142458;32816;11247977
FR;2;2022-02-08;1290;9793;40915;173;43691;6096427;6688000;10183373;32989;11291668
FR;2;2022-02-09;1156;8801;37005;172;40414;6097583;6696801;10220378;33161;11332082
FR;2;2022-02-10;1010;7963;33816;202;36482;6098593;6704764;10254194;33363;11368564
FR;2;2022-02-11;1380;12070;53324;222;57669;6099973;6716834;10307518;33585;11426233
FR;2;2022-02-12;750;6518;27976;83;30793;6100723;6723352;10335494;33668;11457026
FR;2;2022-02-13;198;1331;4828;20;5566;6100921;6724683;10340322;33688;11462592
FR;2;2022-02-14;826;6718;30238;89;33201;6101747;6731401;10370560;33777;11495793
FR;2;2022-02-15;765;6438;28035;140;29969;6102512;6737839;10398595;33917;11525762
FR;2;2022-02-16;647;5329;22011;123;23565;6103159;6743168;10420606;34040;11549327
FR;2;2022-02-17;508;3764;14131;98;14597;6103667;6746932;10434737;34138;11563924
FR;2;2022-02-18;720;5352;20415;133;21105;6104387;6752284;10455152;34271;11585029
FR;2;2022-02-19;427;3035;10514;66;11223;6104814;6755319;10465666;34337;11596252
FR;2;2022-02-20;101;508;1455;3;1601;6104915;6755827;10467121;34340;11597853
FR;2;2022-02-21;413;2678;9097;65;9476;6105328;6758505;10476218;34405;11607329
FR;2;2022-02-22;387;2558;8870;75;8768;6105715;6761063;10485088;34480;11616097
FR;2;2022-02-23;428;2589;8966;81;9244;6106143;6763652;10494054;34561;11625341
FR;2;2022-02-24;310;2020;6771;81;6795;6106453;6765672;10500825;34642;11632136
FR;2;2022-02-25;448;3179;11365;107;11226;6106901;6768851;10512190;34749;11643362
FR;2;2022-02-26;290;1881;6011;49;6319;6107191;6770732;10518201;34798;11649681
FR;2;2022-02-27;71;302;887;4;927;6107262;6771034;10519088;34802;11650608
FR;2;2022-02-28;325;1668;5488;49;5496;6107587;6772702;10524576;34851;11656104
FR;2;2022-03-01;266;1529;5377;44;5098;6107853;6774231;10529953;34895;11661202
FR;2;2022-03-02;292;1417;5169;43;5017;6108145;6775648;10535122;34938;11666219
FR;2;2022-03-03;219;1072;3629;39;3408;6108364;6776720;10538751;34977;11669627
FR;2;2022-03-04;219;1433;4781;72;4423;6108583;6778153;10543532;35049;11674050
FR;2;2022-03-05;161;876;2928;30;2671;6108744;6779029;10546460;35079;11676721
FR;2;2022-03-06;36;166;256;5;293;6108780;6779195;10546716;35084;11677014
FR;2;2022-03-07;142;631;1921;64;1713;6108922;6779826;10548637;35148;11678727
FR;2;2022-03-08;136;618;2214;47;1837;6109058;6780444;10550851;35195;11680564
FR;2;2022-03-09;139;666;2269;36;1973;6109197;6781110;10553120;35231;11682537
FR;2;2022-03-10;107;549;1561;30;1341;6109304;6781659;10554681;35261;11683878
FR;3;2020-12-27;0;0;0;0;0;0;0;0;0;0
FR;3;2020-12-28;0;0;0;0;0;0;0;0;0;0
FR;3;2020-12-29;0;0;0;0;0;0;0;0;0;0
FR;3;2020-12-30;0;0;0;0;0;0;0;0;0;0
FR;3;2020-12-31;0;0;0;0;0;0;0;0;0;0
FR;3;2021-01-01;0;0;0;0;0;0;0;0;0;0
FR;3;2021-01-02;0;0;0;0;0;0;0;0;0;0
FR;3;2021-01-03;0;0;0;0;0;0;0;0;0;0
FR;3;2021-01-04;0;0;0;0;0;0;0;0;0;0
FR;3;2021-01-05;0;0;0;0;0;0;0;0;0;0
FR;3;2021-01-06;0;0;0;0;0;0;0;0;0;0
FR;3;2021-01-07;0;0;0;0;0;0;0;0;0;0
FR;3;2021-01-08;0;0;0;0;0;0;0;0;0;0
FR;3;2021-01-09;0;0;0;0;0;0;0;0;0;0
FR;3;2021-01-10;0;0;0;0;0;0;0;0;0;0
FR;3;2021-01-11;0;0;0;0;0;0;0;0;0;0
FR;3;2021-01-12;0;0;0;0;0;0;0;0;0;0
FR;3;2021-01-13;0;0;0;0;0;0;0;0;0;0
FR;3;2021-01-14;0;0;0;0;0;0;0;0;0;0
FR;3;2021-01-15;0;0;0;0;0;0;0;0;0;0
FR;3;2021-01-16;0;0;0;0;0;0;0;0;0;0
FR;3;2021-01-17;0;0;0;0;0;0;0;0;0;0
FR;3;2021-01-18;0;0;0;0;0;0;0;0;0;0
FR;3;2021-01-19;0;0;0;0;0;0;0;0;0;0
FR;3;2021-01-20;0;0;0;0;0;0;0;0;0;0
FR;3;2021-01-21;0;0;0;0;0;0;0;0;0;0
FR;3;2021-01-22;0;0;0;0;0;0;0;0;0;0
FR;3;2021-01-23;0;0;0;0;0;0;0;0;0;0
FR;3;2021-01-24;0;0;0;0;0;0;0;0;0;0
FR;3;2021-01-25;0;0;0;0;0;0;0;0;0;0
FR;3;2021-01-26;0;0;0;0;0;0;0;0;0;0
FR;3;2021-01-27;0;0;0;0;0;0;0;0;0;0
FR;3;2021-01-28;0;0;0;0;0;0;0;0;0;0
FR;3;2021-01-29;0;0;0;0;0;0;0;0;0;0
FR;3;2021-01-30;0;0;0;0;0;0;0;0;0;0
FR;3;2021-01-31;0;0;0;0;0;0;0;0;0;0
FR;3;2021-02-01;0;0;0;0;0;0;0;0;0;0
FR;3;2021-02-02;0;0;0;0;0;0;0;0;0;0
FR;3;2021-02-03;0;0;0;0;0;0;0;0;0;0
FR;3;2021-02-04;0;0;0;0;0;0;0;0;0;0
FR;3;2021-02-05;0;0;0;0;0;0;0;0;0;0
FR;3;2021-02-06;1705;0;0;0;0;1705;0;0;0;0
FR;3;2021-02-07;1421;0;0;0;0;3126;0;0;0;0
FR;3;2021-02-08;2778;0;0;0;0;5904;0;0;0;0
FR;3;2021-02-09;6779;0;0;0;0;12683;0;0;0;0
FR;3;2021-02-10;9602;0;0;0;0;22285;0;0;0;0
FR;3;2021-02-11;13606;0;0;0;0;35891;0;0;0;0
FR;3;2021-02-12;13391;0;0;0;0;49282;0;0;0;0
FR;3;2021-02-13;3772;0;0;0;0;53054;0;0;0;0
FR;3;2021-02-14;972;0;0;0;0;54026;0;0;0;0
FR;3;2021-02-15;10475;0;0;0;0;64501;0;0;0;0
FR;3;2021-02-16;12541;0;0;0;0;77042;0;0;0;0
FR;3;2021-02-17;11144;0;0;0;0;88186;0;0;0;0
FR;3;2021-02-18;14931;0;0;0;0;103117;0;0;0;0
FR;3;2021-02-19;14357;1;0;0;0;117474;1;0;0;0
FR;3;2021-02-20;3329;0;0;0;0;120803;1;0;0;0
FR;3;2021-02-21;617;0;0;0;0;121420;1;0;0;0
FR;3;2021-02-22;9158;0;0;0;0;130578;1;0;0;0
FR;3;2021-02-23;11392;1;0;0;0;141970;2;0;0;0
FR;3;2021-02-24;14297;0;0;0;0;156267;2;0;0;0
FR;3;2021-02-25;44923;0;0;0;0;201190;2;0;0;0
FR;3;2021-02-26;61880;0;0;0;0;263070;2;0;0;0
FR;3;2021-02-27;34799;5;0;0;0;297869;7;0;0;0
FR;3;2021-02-28;2465;0;0;0;0;300334;7;0;0;0
FR;3;2021-03-01;20498;9;0;0;0;320832;16;0;0;0
FR;3;2021-03-02;38854;16;0;0;0;359686;32;0;0;0
FR;3;2021-03-03;48723;15;0;0;0;408409;47;0;0;0
FR;3;2021-03-04;82210;18;0;0;0;490619;65;0;0;0
FR;3;2021-03-05;118116;37;0;0;0;608735;102;0;0;0
FR;3;2021-03-06;120707;47;1;0;0;729442;149;1;0;0
FR;3;2021-03-07;55173;26;0;0;0;784615;175;1;0;0
FR;3;2021-03-08;42803;20;0;0;0;827418;195;1;0;0
FR;3;2021-03-09;78967;37;0;0;0;906385;232;1;0;0
FR;3;2021-03-10;80956;42;0;0;0;987341;274;1;0;0
FR;3;2021-03-11;128404;46;0;0;0;1115745;320;1;0;0
FR;3;2021-03-12;182715;73;0;0;0;1298460;393;1;0;0
FR;3;2021-03-13;132138;51;0;0;0;1430598;444;1;0;0
FR;3;2021-03-14;14054;4;0;0;0;1444652;448;1;0;0
FR;3;2021-03-15;52211;39;0;0;0;1496863;487;1;0;0
FR;3;2021-03-16;1206;16;0;0;0;1498069;503;1;0;0
FR;3;2021-03-17;939;12;0;0;0;1499008;515;1;0;0
FR;3;2021-03-18;1562;7;0;0;0;1500570;522;1;0;0
FR;3;2021-03-19;70438;42;0;0;0;1571008;564;1;0;0
FR;3;2021-03-20;65222;39;0;0;0;1636230;603;1;0;0
FR;3;2021-03-21;5754;4;0;0;0;1641984;607;1;0;0
FR;3;2021-03-22;37491;35;0;0;0;1679475;642;1;0;0
FR;3;2021-03-23;84643;57;0;0;0;1764118;699;1;0;0
FR;3;2021-03-24;90925;89;0;0;0;1855043;788;1;0;0
FR;3;2021-03-25;150034;119;0;0;0;2005077;907;1;0;0
FR;3;2021-03-26;165403;149;0;0;0;2170480;1056;1;0;0
FR;3;2021-03-27;68452;93;0;0;0;2238932;1149;1;0;0
FR;3;2021-03-28;6468;19;0;0;0;2245400;1168;1;0;0
FR;3;2021-03-29;54149;64;0;0;0;2299549;1232;1;0;0
FR;3;2021-03-30;93150;91;0;0;0;2392699;1323;1;0;0
FR;3;2021-03-31;63513;84;0;0;0;2456212;1407;1;0;0
FR;3;2021-04-01;86114;98;0;0;0;2542326;1505;1;0;0
FR;3;2021-04-02;86882;144;0;0;0;2629208;1649;1;0;0
FR;3;2021-04-03;35866;111;0;0;0;2665074;1760;1;0;0
FR;3;2021-04-04;3569;14;0;0;0;2668643;1774;1;0;0
FR;3;2021-04-05;4480;23;0;0;0;2673123;1797;1;0;0
FR;3;2021-04-06;29736;76;0;0;0;2702859;1873;1;0;0
FR;3;2021-04-07;32332;68;0;0;0;2735191;1941;1;0;0
FR;3;2021-04-08;78805;233;0;0;0;2813996;2174;1;0;0
FR;3;2021-04-09;161744;411;0;0;0;2975740;2585;1;0;0
FR;3;2021-04-10;75747;328;0;0;0;3051487;2913;1;0;0
FR;3;2021-04-11;7305;44;0;0;0;3058792;2957;1;0;0
FR;3;2021-04-12;51463;200;0;0;0;3110255;3157;1;0;0
FR;3;2021-04-13;86219;312;0;0;0;3196474;3469;1;0;0
FR;3;2021-04-14;67831;336;0;0;0;3264305;3805;1;0;0
FR;3;2021-04-15;93219;364;0;0;0;3357524;4169;1;0;0
FR;3;2021-04-16;112513;562;0;0;0;3470037;4731;1;0;0
FR;3;2021-04-17;53309;315;1;0;0;3523346;5046;2;0;0
FR;3;2021-04-18;9740;32;0;0;0;3533086;5078;2;0;0
FR;3;2021-04-19;25102;230;0;0;0;3558188;5308;2;0;0
FR;3;2021-04-20;45663;388;0;0;0;3603851;5696;2;0;0
FR;3;2021-04-21;38959;450;0;0;0;3642810;6146;2;0;0
FR;3;2021-04-22;54696;774;0;0;0;3697506;6920;2;0;0
FR;3;2021-04-23;70474;1010;0;0;0;3767980;7930;2;0;0
FR;3;2021-04-24;37240;971;0;0;0;3805220;8901;2;0;0
FR;3;2021-04-25;6200;155;0;0;0;3811420;9056;2;0;0
FR;3;2021-04-26;19780;644;0;0;0;3831200;9700;2;0;0
FR;3;2021-04-27;34467;1244;0;0;0;3865667;10944;2;0;0
FR;3;2021-04-28;28951;1923;0;0;0;3894618;12867;2;0;0
FR;3;2021-04-29;45367;5943;0;0;0;3939985;18810;2;0;0
FR;3;2021-04-30;55453;8907;1;0;0;3995438;27717;3;0;0
FR;3;2021-05-01;9507;1964;0;0;0;4004945;29681;3;0;0
FR;3;2021-05-02;3069;493;0;0;0;4008014;30174;3;0;0
FR;3;2021-05-03;13051;3881;0;0;0;4021065;34055;3;0;0
FR;3;2021-05-04;23104;8392;0;0;0;4044169;42447;3;0;0
FR;3;2021-05-05;18746;10564;0;0;0;4062915;53011;3;0;0
FR;3;2021-05-06;34612;20863;0;0;0;4097527;73874;3;0;0
FR;3;2021-05-07;44195;28356;0;0;0;4141722;102230;3;0;0
FR;3;2021-05-08;6774;8836;0;0;0;4148496;111066;3;0;0
FR;3;2021-05-09;1790;2649;0;0;0;4150286;113715;3;0;0
FR;3;2021-05-10;14982;12540;0;0;0;4165268;126255;3;0;0
FR;3;2021-05-11;27089;25693;0;0;0;4192357;151948;3;0;0
FR;3;2021-05-12;17258;27421;0;0;0;4209615;179369;3;0;0
FR;3;2021-05-13;2274;3480;0;0;0;4211889;182849;3;0;0
FR;3;2021-05-14;14508;25700;0;0;0;4226397;208549;3;0;0
FR;3;2021-05-15;7225;20717;0;0;0;4233622;229266;3;0;0
FR;3;2021-05-16;972;2672;0;0;0;4234594;231938;3;0;0
FR;3;2021-05-17;7952;19888;0;0;0;4242546;251826;3;0;0
FR;3;2021-05-18;13398;29610;0;0;0;4255944;281436;3;0;0
FR;3;2021-05-19;9253;31813;0;0;0;4265197;313249;3;0;0
FR;3;2021-05-20;12798;53154;3;0;0;4277995;366403;6;0;0
FR;3;2021-05-21;12757;65451;2;0;0;4290752;431854;8;0;0
FR;3;2021-05-22;4958;33257;1;0;0;4295710;465111;9;0;0
FR;3;2021-05-23;648;2664;0;0;0;4296358;467775;9;0;0
FR;3;2021-05-24;875;4920;0;0;0;4297233;472695;9;0;0
FR;3;2021-05-25;5291;45137;1;0;0;4302524;517832;10;0;0
FR;3;2021-05-26;4966;50996;1;0;0;4307490;568828;11;0;0
FR;3;2021-05-27;6316;77743;3;0;0;4313806;646571;14;0;0
FR;3;2021-05-28;7538;98996;2;0;0;4321344;745567;16;0;0
FR;3;2021-05-29;3343;60219;1;0;0;4324687;805786;17;0;0
FR;3;2021-05-30;543;8230;0;0;0;4325230;814016;17;0;0
FR;3;2021-05-31;2426;35937;3;0;0;4327656;849953;20;0;0
FR;3;2021-06-01;3389;64742;10;0;0;4331045;914695;30;0;0
FR;3;2021-06-02;2715;58277;6;0;0;4333760;972972;36;0;0
FR;3;2021-06-03;3488;87484;10;0;0;4337248;1060456;46;0;0
FR;3;2021-06-04;4099;105014;22;0;0;4341347;1165470;68;0;0
FR;3;2021-06-05;1962;52204;4;0;0;4343309;1217674;72;0;0
FR;3;2021-06-06;502;5401;1;0;0;4343811;1223075;73;0;0
FR;3;2021-06-07;1460;31144;11;0;0;4345271;1254219;84;0;0
FR;3;2021-06-08;2039;47220;18;0;0;4347310;1301439;102;0;0
FR;3;2021-06-09;1779;42357;13;0;0;4349089;1343796;115;0;0
FR;3;2021-06-10;2240;67910;17;0;0;4351329;1411706;132;0;0
FR;3;2021-06-11;2467;96706;34;0;0;4353796;1508412;166;0;0
FR;3;2021-06-12;1168;40810;6;0;0;4354964;1549222;172;0;0
FR;3;2021-06-13;275;3820;3;0;0;4355239;1553042;175;0;0
FR;3;2021-06-14;1034;42617;17;0;0;4356273;1595659;192;0;0
FR;3;2021-06-15;1359;80611;20;0;0;4357632;1676270;212;0;0
FR;3;2021-06-16;1250;65717;19;0;0;4358882;1741987;231;0;0
FR;3;2021-06-17;1652;101756;41;0;0;4360534;1843743;272;0;0
FR;3;2021-06-18;1866;117818;61;0;0;4362400;1961561;333;0;0
FR;3;2021-06-19;798;39362;22;0;0;4363198;2000923;355;0;0
FR;3;2021-06-20;156;3389;0;0;0;4363354;2004312;355;0;0
FR;3;2021-06-21;760;39256;16;0;0;4364114;2043568;371;0;0
FR;3;2021-06-22;1060;69959;52;0;0;4365174;2113527;423;0;0
FR;3;2021-06-23;938;50791;38;0;0;4366112;2164318;461;0;0
FR;3;2021-06-24;1298;77129;48;0;0;4367410;2241447;509;0;0
FR;3;2021-06-25;1399;89890;72;0;0;4368809;2331337;581;0;0
FR;3;2021-06-26;623;33120;29;0;0;4369432;2364457;610;0;0
FR;3;2021-06-27;163;4020;1;0;0;4369595;2368477;611;0;0
FR;3;2021-06-28;642;30430;27;0;0;4370237;2398907;638;0;0
FR;3;2021-06-29;848;56124;95;0;0;4371085;2455031;733;0;0
FR;3;2021-06-30;896;45061;93;0;0;4371981;2500092;826;0;0
FR;3;2021-07-01;1158;65630;108;0;0;4373139;2565722;934;0;0
FR;3;2021-07-02;1290;90349;170;0;0;4374429;2656071;1104;0;0
FR;3;2021-07-03;600;31164;52;0;0;4375029;2687235;1156;0;0
FR;3;2021-07-04;139;4280;3;0;0;4375168;2691515;1159;0;0
FR;3;2021-07-05;603;33906;60;0;0;4375771;2725421;1219;0;0
FR;3;2021-07-06;950;56071;88;0;0;4376721;2781492;1307;0;0
FR;3;2021-07-07;865;43041;79;0;0;4377586;2824533;1386;0;0
FR;3;2021-07-08;1119;60709;99;0;0;4378705;2885242;1485;0;0
FR;3;2021-07-09;1257;68794;128;0;0;4379962;2954036;1613;0;0
FR;3;2021-07-10;638;25039;59;0;0;4380600;2979075;1672;0;0
FR;3;2021-07-11;126;3306;4;0;0;4380726;2982381;1676;0;0
FR;3;2021-07-12;656;23896;59;0;0;4381382;3006277;1735;0;0
FR;3;2021-07-13;1644;34737;90;0;0;4383026;3041014;1825;0;0
FR;3;2021-07-14;259;2646;2;0;0;4383285;3043660;1827;0;0
FR;3;2021-07-15;1930;30671;85;0;0;4385215;3074331;1912;0;0
FR;3;2021-07-16;2517;38881;122;0;0;4387732;3113212;2034;0;0
FR;3;2021-07-17;1041;13754;26;0;0;4388773;3126966;2060;0;0
FR;3;2021-07-18;259;2621;3;0;0;4389032;3129587;2063;0;0
FR;3;2021-07-19;1267;17219;37;0;0;4390299;3146806;2100;0;0
FR;3;2021-07-20;1818;27165;98;0;0;4392117;3173971;2198;0;0
FR;3;2021-07-21;1638;19735;44;0;0;4393755;3193706;2242;0;0
FR;3;2021-07-22;1844;27775;82;0;0;4395599;3221481;2324;0;0
FR;3;2021-07-23;2208;30456;117;0;0;4397807;3251937;2441;0;0
FR;3;2021-07-24;819;7012;25;0;0;4398626;3258949;2466;0;0
FR;3;2021-07-25;208;1355;1;0;0;4398834;3260304;2467;0;0
FR;3;2021-07-26;914;10717;28;0;0;4399748;3271021;2495;0;0
FR;3;2021-07-27;1164;16953;56;0;0;4400912;3287974;2551;0;0
FR;3;2021-07-28;982;12124;40;0;0;4401894;3300098;2591;0;0
FR;3;2021-07-29;1125;15856;63;0;0;4403019;3315954;2654;0;0
FR;3;2021-07-30;1122;18116;79;0;0;4404141;3334070;2733;0;0
FR;3;2021-07-31;405;3742;15;0;0;4404546;3337812;2748;0;0
FR;3;2021-08-01;110;482;1;0;0;4404656;3338294;2749;0;0
FR;3;2021-08-02;411;5161;22;0;0;4405067;3343455;2771;0;0
FR;3;2021-08-03;483;7600;27;0;0;4405550;3351055;2798;0;0
FR;3;2021-08-04;432;4899;26;0;0;4405982;3355954;2824;0;0
FR;3;2021-08-05;425;3749;12;0;0;4406407;3359703;2836;0;0
FR;3;2021-08-06;448;4799;30;0;0;4406855;3364502;2866;0;0
FR;3;2021-08-07;212;1921;11;0;0;4407067;3366423;2877;0;0
FR;3;2021-08-08;241;427;2;0;0;4407308;3366850;2879;0;0
FR;3;2021-08-09;309;2524;11;0;0;4407617;3369374;2890;0;0
FR;3;2021-08-10;357;3890;15;0;0;4407974;3373264;2905;0;0
FR;3;2021-08-11;278;2724;15;0;0;4408252;3375988;2920;0;0
FR;3;2021-08-12;270;2639;12;0;0;4408522;3378627;2932;0;0
FR;3;2021-08-13;271;2264;16;0;0;4408793;3380891;2948;0;0
FR;3;2021-08-14;167;924;1;0;0;4408960;3381815;2949;0;0
FR;3;2021-08-15;55;167;0;0;0;4409015;3381982;2949;0;0
FR;3;2021-08-16;121;1095;8;0;0;4409136;3383077;2957;0;0
FR;3;2021-08-17;185;1512;8;0;0;4409321;3384589;2965;0;0
FR;3;2021-08-18;189;1366;8;0;0;4409510;3385955;2973;0;0
FR;3;2021-08-19;160;1433;10;0;0;4409670;3387388;2983;0;0
FR;3;2021-08-20;160;1638;16;0;0;4409830;3389026;2999;0;0
FR;3;2021-08-21;93;586;2;0;0;4409923;3389612;3001;0;0
FR;3;2021-08-22;38;185;1;0;0;4409961;3389797;3002;0;0
FR;3;2021-08-23;139;939;7;0;0;4410100;3390736;3009;0;0
FR;3;2021-08-24;122;969;10;0;0;4410222;3391705;3019;0;0
FR;3;2021-08-25;133;851;2;0;0;4410355;3392556;3021;0;0
FR;3;2021-08-26;168;876;9;0;0;4410523;3393432;3030;0;0
FR;3;2021-08-27;170;964;9;0;0;4410693;3394396;3039;0;0
FR;3;2021-08-28;95;370;4;0;0;4410788;3394766;3043;0;0
FR;3;2021-08-29;119;132;1;0;0;4410907;3394898;3044;0;0
FR;3;2021-08-30;93;599;0;0;139;4411000;3395497;3044;0;139
FR;3;2021-08-31;124;719;7;0;161;4411124;3396216;3051;0;300
FR;3;2021-09-01;109;482;5;0;126;4411233;3396698;3056;0;426
FR;3;2021-09-02;98;636;22;0;125;4411331;3397334;3078;0;551
FR;3;2021-09-03;111;594;17;0;132;4411442;3397928;3095;0;683
FR;3;2021-09-04;49;296;3;0;59;4411491;3398224;3098;0;742
FR;3;2021-09-05;50;68;5;0;30;4411541;3398292;3103;0;772
FR;3;2021-09-06;110;408;4;0;153;4411651;3398700;3107;0;925
FR;3;2021-09-07;117;483;14;0;135;4411768;3399183;3121;0;1060
FR;3;2021-09-08;112;370;2;0;107;4411880;3399553;3123;0;1167
FR;3;2021-09-09;87;401;8;0;118;4411967;3399954;3131;0;1285
FR;3;2021-09-10;94;425;3;0;105;4412061;3400379;3134;0;1390
FR;3;2021-09-11;70;235;4;0;66;4412131;3400614;3138;0;1456
FR;3;2021-09-12;36;48;1;0;16;4412167;3400662;3139;0;1472
FR;3;2021-09-13;63;332;7;0;113;4412230;3400994;3146;0;1585
FR;3;2021-09-14;64;292;6;0;108;4412294;3401286;3152;0;1693
FR;3;2021-09-15;55;262;3;0;6;4412349;3401548;3155;0;1699
FR;3;2021-09-16;56;343;5;0;5;4412405;3401891;3160;0;1704
FR;3;2021-09-17;48;349;3;0;7;4412453;3402240;3163;0;1711
FR;3;2021-09-18;34;176;1;0;1;4412487;3402416;3164;0;1712
FR;3;2021-09-19;26;32;2;0;1;4412513;3402448;3166;0;1713
FR;3;2021-09-20;76;211;0;0;1;4412589;3402659;3166;0;1714
FR;3;2021-09-21;54;287;6;0;7;4412643;3402946;3172;0;1721
FR;3;2021-09-22;61;230;6;0;7;4412704;3403176;3178;0;1728
FR;3;2021-09-23;33;273;10;0;6;4412737;3403449;3188;0;1734
FR;3;2021-09-24;22;313;12;0;19;4412759;3403762;3200;0;1753
FR;3;2021-09-25;28;158;3;0;3;4412787;3403920;3203;0;1756
FR;3;2021-09-26;15;51;1;0;1;4412802;3403971;3204;0;1757
FR;3;2021-09-27;37;286;3;0;5;4412839;3404257;3207;0;1762
FR;3;2021-09-28;47;257;6;0;10;4412886;3404514;3213;0;1772
FR;3;2021-09-29;31;222;10;0;13;4412917;3404736;3223;0;1785
FR;3;2021-09-30;34;197;7;0;9;4412951;3404933;3230;0;1794
FR;3;2021-10-01;17;172;5;0;6;4412968;3405105;3235;0;1800
FR;3;2021-10-02;14;92;0;0;0;4412982;3405197;3235;0;1800
FR;3;2021-10-03;16;18;1;0;2;4412998;3405215;3236;0;1802
FR;3;2021-10-04;27;165;4;0;4;4413025;3405380;3240;0;1806
FR;3;2021-10-05;15;160;10;0;13;4413040;3405540;3250;0;1819
FR;3;2021-10-06;28;161;7;0;8;4413068;3405701;3257;0;1827
FR;3;2021-10-07;16;145;6;0;6;4413084;3405846;3263;0;1833
FR;3;2021-10-08;20;143;10;0;9;4413104;3405989;3273;0;1842
FR;3;2021-10-09;11;73;1;0;1;4413115;3406062;3274;0;1843
FR;3;2021-10-10;7;16;2;0;2;4413122;3406078;3276;0;1845
FR;3;2021-10-11;13;128;4;0;5;4413135;3406206;3280;0;1850
FR;3;2021-10-12;15;115;4;0;4;4413150;3406321;3284;0;1854
FR;3;2021-10-13;22;117;7;0;5;4413172;3406438;3291;0;1859
FR;3;2021-10-14;15;161;3;0;4;4413187;3406599;3294;0;1863
FR;3;2021-10-15;19;155;7;0;10;4413206;3406754;3301;0;1873
FR;3;2021-10-16;10;80;6;0;8;4413216;3406834;3307;0;1881
FR;3;2021-10-17;7;24;0;0;0;4413223;3406858;3307;0;1881
FR;3;2021-10-18;17;129;2;0;1;4413240;3406987;3309;0;1882
FR;3;2021-10-19;12;130;17;0;19;4413252;3407117;3326;0;1901
FR;3;2021-10-20;18;135;5;0;6;4413270;3407252;3331;0;1907
FR;3;2021-10-21;22;135;17;0;13;4413292;3407387;3348;0;1920
FR;3;2021-10-22;17;127;16;0;20;4413309;3407514;3364;0;1940
FR;3;2021-10-23;11;58;2;0;1;4413320;3407572;3366;0;1941
FR;3;2021-10-24;6;25;0;0;0;4413326;3407597;3366;0;1941
FR;3;2021-10-25;20;151;6;0;6;4413346;3407748;3372;0;1947
FR;3;2021-10-26;15;116;22;0;19;4413361;3407864;3394;0;1966
FR;3;2021-10-27;15;116;9;0;9;4413376;3407980;3403;0;1975
FR;3;2021-10-28;14;130;33;0;36;4413390;3408110;3436;0;2011
FR;3;2021-10-29;9;124;64;0;54;4413399;3408234;3500;0;2065
FR;3;2021-10-30;7;74;11;1;10;4413406;3408308;3511;1;2075
FR;3;2021-10-31;5;23;1;0;1;4413411;3408331;3512;1;2076
FR;3;2021-11-01;5;20;2;0;1;4413416;3408351;3514;1;2077
FR;3;2021-11-02;9;109;8;0;10;4413425;3408460;3522;1;2087
FR;3;2021-11-03;19;125;9;0;9;4413444;3408585;3531;1;2096
FR;3;2021-11-04;14;97;3;0;2;4413458;3408682;3534;1;2098
FR;3;2021-11-05;13;145;8;1;5;4413471;3408827;3542;2;2103
FR;3;2021-11-06;6;67;3;0;3;4413477;3408894;3545;2;2106
FR;3;2021-11-07;6;19;1;0;1;4413483;3408913;3546;2;2107
FR;3;2021-11-08;7;141;7;0;5;4413490;3409054;3553;2;2112
FR;3;2021-11-09;9;158;5;0;5;4413499;3409212;3558;2;2117
FR;3;2021-11-10;10;192;13;0;13;4413509;3409404;3571;2;2130
FR;3;2021-11-11;5;52;3;0;3;4413514;3409456;3574;2;2133
FR;3;2021-11-12;8;162;6;0;4;4413522;3409618;3580;2;2137
FR;3;2021-11-13;5;83;8;0;10;4413527;3409701;3588;2;2147
FR;3;2021-11-14;2;17;0;0;0;4413529;3409718;3588;2;2147
FR;3;2021-11-15;3;195;9;0;8;4413532;3409913;3597;2;2155
FR;3;2021-11-16;2;165;10;0;9;4413534;3410078;3607;2;2164
FR;3;2021-11-17;5;184;10;0;7;4413539;3410262;3617;2;2171
FR;3;2021-11-18;10;182;10;0;11;4413549;3410444;3627;2;2182
FR;3;2021-11-19;5;238;21;0;26;4413554;3410682;3648;2;2208
FR;3;2021-11-20;5;118;4;0;4;4413559;3410800;3652;2;2212
FR;3;2021-11-21;2;30;2;0;2;4413561;3410830;3654;2;2214
FR;3;2021-11-22;9;240;10;0;10;4413570;3411070;3664;2;2224
FR;3;2021-11-23;6;229;15;0;14;4413576;3411299;3679;2;2238
FR;3;2021-11-24;4;257;8;0;16;4413580;3411556;3687;2;2254
FR;3;2021-11-25;9;289;11;0;10;4413589;3411845;3698;2;2264
FR;3;2021-11-26;5;382;33;0;30;4413594;3412227;3731;2;2294
FR;3;2021-11-27;5;178;19;0;20;4413599;3412405;3750;2;2314
FR;3;2021-11-28;2;58;7;0;7;4413601;3412463;3757;2;2321
FR;3;2021-11-29;4;335;19;0;21;4413605;3412798;3776;2;2342
FR;3;2021-11-30;3;428;26;0;29;4413608;3413226;3802;2;2371
FR;3;2021-12-01;18;466;33;0;34;4413626;3413692;3835;2;2405
FR;3;2021-12-02;9;503;33;0;36;4413635;3414195;3868;2;2441
FR;3;2021-12-03;3;578;37;0;38;4413638;3414773;3905;2;2479
FR;3;2021-12-04;3;284;26;0;28;4413641;3415057;3931;2;2507
FR;3;2021-12-05;1;83;5;0;5;4413642;3415140;3936;2;2512
FR;3;2021-12-06;5;520;14;0;16;4413647;3415660;3950;2;2528
FR;3;2021-12-07;4;621;20;0;24;4413651;3416281;3970;2;2552
FR;3;2021-12-08;3;547;29;0;29;4413654;3416828;3999;2;2581
FR;3;2021-12-09;3;609;17;0;22;4413657;3417437;4016;2;2603
FR;3;2021-12-10;8;645;29;0;25;4413665;3418082;4045;2;2628
FR;3;2021-12-11;4;397;10;0;9;4413669;3418479;4055;2;2637
FR;3;2021-12-12;1;121;3;0;3;4413670;3418600;4058;2;2640
FR;3;2021-12-13;2;610;19;0;20;4413672;3419210;4077;2;2660
FR;3;2021-12-14;7;772;18;0;21;4413679;3419982;4095;2;2681
FR;3;2021-12-15;7;736;17;0;21;4413686;3420718;4112;2;2702
FR;3;2021-12-16;9;741;19;0;18;4413695;3421459;4131;2;2720
FR;3;2021-12-17;4;811;18;0;19;4413699;3422270;4149;2;2739
FR;3;2021-12-18;4;417;4;0;5;4413703;3422687;4153;2;2744
FR;3;2021-12-19;3;208;2;0;2;4413706;3422895;4155;2;2746
FR;3;2021-12-20;8;731;23;0;28;4413714;3423626;4178;2;2774
FR;3;2021-12-21;3;818;10;0;14;4413717;3424444;4188;2;2788
FR;3;2021-12-22;6;765;9;0;11;4413723;3425209;4197;2;2799
FR;3;2021-12-23;1;658;9;0;8;4413724;3425867;4206;2;2807
FR;3;2021-12-24;2;276;3;0;6;4413726;3426143;4209;2;2813
FR;3;2021-12-25;0;25;0;0;0;4413726;3426168;4209;2;2813
FR;3;2021-12-26;0;95;1;0;1;4413726;3426263;4210;2;2814
FR;3;2021-12-27;7;546;17;0;19;4413733;3426809;4227;2;2833
FR;3;2021-12-28;1;695;6;0;5;4413734;3427504;4233;2;2838
FR;3;2021-12-29;4;576;14;0;16;4413738;3428080;4247;2;2854
FR;3;2021-12-30;1;605;7;0;10;4413739;3428685;4254;2;2864
FR;3;2021-12-31;0;210;5;0;6;4413739;3428895;4259;2;2870
FR;3;2022-01-01;0;27;0;0;2;4413739;3428922;4259;2;2872
FR;3;2022-01-02;0;83;0;0;0;4413739;3429005;4259;2;2872
FR;3;2022-01-03;3;566;17;0;21;4413742;3429571;4276;2;2893
FR;3;2022-01-04;6;628;9;0;8;4413748;3430199;4285;2;2901
FR;3;2022-01-05;3;559;10;0;15;4413751;3430758;4295;2;2916
FR;3;2022-01-06;4;557;9;0;12;4413755;3431315;4304;2;2928
FR;3;2022-01-07;2;579;11;0;14;4413757;3431894;4315;2;2942
FR;3;2022-01-08;2;286;4;0;5;4413759;3432180;4319;2;2947
FR;3;2022-01-09;0;118;0;0;0;4413759;3432298;4319;2;2947
FR;3;2022-01-10;2;481;12;0;12;4413761;3432779;4331;2;2959
FR;3;2022-01-11;2;535;1;0;1;4413763;3433314;4332;2;2960
FR;3;2022-01-12;3;449;9;0;10;4413766;3433763;4341;2;2970
FR;3;2022-01-13;3;428;11;0;12;4413769;3434191;4352;2;2982
FR;3;2022-01-14;3;484;10;0;12;4413772;3434675;4362;2;2994
FR;3;2022-01-15;0;299;2;0;3;4413772;3434974;4364;2;2997
FR;3;2022-01-16;0;116;1;0;1;4413772;3435090;4365;2;2998
FR;3;2022-01-17;2;355;8;0;10;4413774;3435445;4373;2;3008
FR;3;2022-01-18;3;421;1;0;2;4413777;3435866;4374;2;3010
FR;3;2022-01-19;1;351;5;0;10;4413778;3436217;4379;2;3020
FR;3;2022-01-20;1;380;5;0;3;4413779;3436597;4384;2;3023
FR;3;2022-01-21;2;377;5;0;8;4413781;3436974;4389;2;3031
FR;3;2022-01-22;2;234;1;0;3;4413783;3437208;4390;2;3034
FR;3;2022-01-23;0;82;0;0;1;4413783;3437290;4390;2;3035
FR;3;2022-01-24;2;352;1;0;6;4413785;3437642;4391;2;3041
FR;3;2022-01-25;0;194;0;0;0;4413785;3437836;4391;2;3041
FR;3;2022-01-26;0;89;0;0;0;4413785;3437925;4391;2;3041
FR;3;2022-01-27;0;60;0;0;0;4413785;3437985;4391;2;3041
FR;3;2022-01-28;0;134;0;0;0;4413785;3438119;4391;2;3041
FR;3;2022-01-29;0;110;0;0;0;4413785;3438229;4391;2;3041
FR;3;2022-01-30;0;51;0;0;0;4413785;3438280;4391;2;3041
FR;3;2022-01-31;0;98;0;0;0;4413785;3438378;4391;2;3041
FR;3;2022-02-01;0;111;0;0;1;4413785;3438489;4391;2;3042
FR;3;2022-02-02;0;98;0;0;0;4413785;3438587;4391;2;3042
FR;3;2022-02-03;0;101;0;0;0;4413785;3438688;4391;2;3042
FR;3;2022-02-04;0;124;0;0;0;4413785;3438812;4391;2;3042
FR;3;2022-02-05;0;73;0;0;0;4413785;3438885;4391;2;3042
FR;3;2022-02-06;0;11;0;0;0;4413785;3438896;4391;2;3042
FR;3;2022-02-07;0;92;0;0;1;4413785;3438988;4391;2;3043
FR;3;2022-02-08;0;0;0;0;0;4413785;3438988;4391;2;3043
FR;3;2022-02-09;0;0;0;0;0;4413785;3438988;4391;2;3043
FR;3;2022-02-10;0;0;0;0;0;4413785;3438988;4391;2;3043
FR;3;2022-02-11;0;0;0;0;0;4413785;3438988;4391;2;3043
FR;3;2022-02-12;0;0;0;0;0;4413785;3438988;4391;2;3043
FR;3;2022-02-13;0;0;0;0;0;4413785;3438988;4391;2;3043
FR;3;2022-02-14;0;0;0;0;0;4413785;3438988;4391;2;3043
FR;3;2022-02-15;0;0;0;0;0;4413785;3438988;4391;2;3043
FR;3;2022-02-16;0;0;0;0;0;4413785;3438988;4391;2;3043
FR;3;2022-02-17;0;0;0;0;0;4413785;3438988;4391;2;3043
FR;3;2022-02-18;0;0;0;0;0;4413785;3438988;4391;2;3043
FR;3;2022-02-19;0;0;0;0;0;4413785;3438988;4391;2;3043
FR;3;2022-02-20;0;0;0;0;0;4413785;3438988;4391;2;3043
FR;3;2022-02-21;2;0;0;0;0;4413787;3438988;4391;2;3043
FR;3;2022-02-22;0;0;0;0;0;4413787;3438988;4391;2;3043
FR;3;2022-02-23;0;0;0;0;0;4413787;3438988;4391;2;3043
FR;3;2022-02-24;0;0;0;0;0;4413787;3438988;4391;2;3043
FR;3;2022-02-25;0;0;0;0;0;4413787;3438988;4391;2;3043
FR;3;2022-02-26;0;0;0;0;0;4413787;3438988;4391;2;3043
FR;3;2022-02-27;0;0;0;0;0;4413787;3438988;4391;2;3043
FR;3;2022-02-28;1;0;0;0;0;4413788;3438988;4391;2;3043
FR;3;2022-03-01;1;0;0;0;0;4413789;3438988;4391;2;3043
FR;3;2022-03-02;0;0;0;0;0;4413789;3438988;4391;2;3043
FR;3;2022-03-03;0;0;0;0;0;4413789;3438988;4391;2;3043
FR;3;2022-03-04;0;0;0;0;0;4413789;3438988;4391;2;3043
FR;3;2022-03-05;0;0;0;0;0;4413789;3438988;4391;2;3043
FR;3;2022-03-06;1;0;0;0;0;4413790;3438988;4391;2;3043
FR;3;2022-03-07;0;0;0;0;0;4413790;3438988;4391;2;3043
FR;3;2022-03-08;1;0;0;0;0;4413791;3438988;4391;2;3043
FR;3;2022-03-09;0;0;0;0;0;4413791;3438988;4391;2;3043
FR;3;2022-03-10;0;0;0;0;0;4413791;3438988;4391;2;3043
FR;4;2020-12-27;0;0;0;0;0;0;0;0;0;0
FR;4;2020-12-28;0;0;0;0;0;0;0;0;0;0
FR;4;2020-12-29;0;0;0;0;0;0;0;0;0;0
FR;4;2020-12-30;0;0;0;0;0;0;0;0;0;0
FR;4;2020-12-31;0;0;0;0;0;0;0;0;0;0
FR;4;2021-01-01;0;0;0;0;0;0;0;0;0;0
FR;4;2021-01-02;0;0;0;0;0;0;0;0;0;0
FR;4;2021-01-03;0;0;0;0;0;0;0;0;0;0
FR;4;2021-01-04;0;0;0;0;0;0;0;0;0;0
FR;4;2021-01-05;0;0;0;0;0;0;0;0;0;0
FR;4;2021-01-06;0;0;0;0;0;0;0;0;0;0
FR;4;2021-01-07;0;0;0;0;0;0;0;0;0;0
FR;4;2021-01-08;0;0;0;0;0;0;0;0;0;0
FR;4;2021-01-09;0;0;0;0;0;0;0;0;0;0
FR;4;2021-01-10;0;0;0;0;0;0;0;0;0;0
FR;4;2021-01-11;0;0;0;0;0;0;0;0;0;0
FR;4;2021-01-12;0;0;0;0;0;0;0;0;0;0
FR;4;2021-01-13;0;0;0;0;0;0;0;0;0;0
FR;4;2021-01-14;0;0;0;0;0;0;0;0;0;0
FR;4;2021-01-15;0;0;0;0;0;0;0;0;0;0
FR;4;2021-01-16;0;0;0;0;0;0;0;0;0;0
FR;4;2021-01-17;0;0;0;0;0;0;0;0;0;0
FR;4;2021-01-18;0;0;0;0;0;0;0;0;0;0
FR;4;2021-01-19;0;0;0;0;0;0;0;0;0;0
FR;4;2021-01-20;0;0;0;0;0;0;0;0;0;0
FR;4;2021-01-21;0;0;0;0;0;0;0;0;0;0
FR;4;2021-01-22;0;0;0;0;0;0;0;0;0;0
FR;4;2021-01-23;0;0;0;0;0;0;0;0;0;0
FR;4;2021-01-24;0;0;0;0;0;0;0;0;0;0
FR;4;2021-01-25;0;0;0;0;0;0;0;0;0;0
FR;4;2021-01-26;0;0;0;0;0;0;0;0;0;0
FR;4;2021-01-27;0;0;0;0;0;0;0;0;0;0
FR;4;2021-01-28;0;0;0;0;0;0;0;0;0;0
FR;4;2021-01-29;0;0;0;0;0;0;0;0;0;0
FR;4;2021-01-30;0;0;0;0;0;0;0;0;0;0
FR;4;2021-01-31;0;0;0;0;0;0;0;0;0;0
FR;4;2021-02-01;0;0;0;0;0;0;0;0;0;0
FR;4;2021-02-02;0;0;0;0;0;0;0;0;0;0
FR;4;2021-02-03;0;0;0;0;0;0;0;0;0;0
FR;4;2021-02-04;0;0;0;0;0;0;0;0;0;0
FR;4;2021-02-05;0;0;0;0;0;0;0;0;0;0
FR;4;2021-02-06;0;0;0;0;0;0;0;0;0;0
FR;4;2021-02-07;0;0;0;0;0;0;0;0;0;0
FR;4;2021-02-08;0;0;0;0;0;0;0;0;0;0
FR;4;2021-02-09;0;0;0;0;0;0;0;0;0;0
FR;4;2021-02-10;0;0;0;0;0;0;0;0;0;0
FR;4;2021-02-11;0;0;0;0;0;0;0;0;0;0
FR;4;2021-02-12;0;0;0;0;0;0;0;0;0;0
FR;4;2021-02-13;0;0;0;0;0;0;0;0;0;0
FR;4;2021-02-14;0;0;0;0;0;0;0;0;0;0
FR;4;2021-02-15;0;0;0;0;0;0;0;0;0;0
FR;4;2021-02-16;0;0;0;0;0;0;0;0;0;0
FR;4;2021-02-17;0;0;0;0;0;0;0;0;0;0
FR;4;2021-02-18;0;0;0;0;0;0;0;0;0;0
FR;4;2021-02-19;0;0;0;0;0;0;0;0;0;0
FR;4;2021-02-20;0;0;0;0;0;0;0;0;0;0
FR;4;2021-02-21;0;0;0;0;0;0;0;0;0;0
FR;4;2021-02-22;0;0;0;0;0;0;0;0;0;0
FR;4;2021-02-23;0;0;0;0;0;0;0;0;0;0
FR;4;2021-02-24;0;0;0;0;0;0;0;0;0;0
FR;4;2021-02-25;0;0;0;0;0;0;0;0;0;0
FR;4;2021-02-26;0;0;0;0;0;0;0;0;0;0
FR;4;2021-02-27;0;0;0;0;0;0;0;0;0;0
FR;4;2021-02-28;0;0;0;0;0;0;0;0;0;0
FR;4;2021-03-01;0;0;0;0;0;0;0;0;0;0
FR;4;2021-03-02;0;0;0;0;0;0;0;0;0;0
FR;4;2021-03-03;0;0;0;0;0;0;0;0;0;0
FR;4;2021-03-04;0;0;0;0;0;0;0;0;0;0
FR;4;2021-03-05;0;0;0;0;0;0;0;0;0;0
FR;4;2021-03-06;0;0;0;0;0;0;0;0;0;0
FR;4;2021-03-07;0;0;0;0;0;0;0;0;0;0
FR;4;2021-03-08;0;0;0;0;0;0;0;0;0;0
FR;4;2021-03-09;0;0;0;0;0;0;0;0;0;0
FR;4;2021-03-10;0;0;0;0;0;0;0;0;0;0
FR;4;2021-03-11;0;0;0;0;0;0;0;0;0;0
FR;4;2021-03-12;0;0;0;0;0;0;0;0;0;0
FR;4;2021-03-13;0;0;0;0;0;0;0;0;0;0
FR;4;2021-03-14;0;0;0;0;0;0;0;0;0;0
FR;4;2021-03-15;0;0;0;0;0;0;0;0;0;0
FR;4;2021-03-16;0;0;0;0;0;0;0;0;0;0
FR;4;2021-03-17;0;0;0;0;0;0;0;0;0;0
FR;4;2021-03-18;0;0;0;0;0;0;0;0;0;0
FR;4;2021-03-19;0;0;0;0;0;0;0;0;0;0
FR;4;2021-03-20;0;0;0;0;0;0;0;0;0;0
FR;4;2021-03-21;0;0;0;0;0;0;0;0;0;0
FR;4;2021-03-22;0;0;0;0;0;0;0;0;0;0
FR;4;2021-03-23;0;0;0;0;0;0;0;0;0;0
FR;4;2021-03-24;0;0;0;0;0;0;0;0;0;0
FR;4;2021-03-25;0;0;0;0;0;0;0;0;0;0
FR;4;2021-03-26;0;0;0;0;0;0;0;0;0;0
FR;4;2021-03-27;0;0;0;0;0;0;0;0;0;0
FR;4;2021-03-28;0;0;0;0;0;0;0;0;0;0
FR;4;2021-03-29;0;0;0;0;0;0;0;0;0;0
FR;4;2021-03-30;0;0;0;0;0;0;0;0;0;0
FR;4;2021-03-31;0;0;0;0;0;0;0;0;0;0
FR;4;2021-04-01;0;0;0;0;0;0;0;0;0;0
FR;4;2021-04-02;0;0;0;0;0;0;0;0;0;0
FR;4;2021-04-03;0;0;0;0;0;0;0;0;0;0
FR;4;2021-04-04;0;0;0;0;0;0;0;0;0;0
FR;4;2021-04-05;0;0;0;0;0;0;0;0;0;0
FR;4;2021-04-06;0;0;0;0;0;0;0;0;0;0
FR;4;2021-04-07;0;0;0;0;0;0;0;0;0;0
FR;4;2021-04-08;0;0;0;0;0;0;0;0;0;0
FR;4;2021-04-09;0;0;0;0;0;0;0;0;0;0
FR;4;2021-04-10;0;0;0;0;0;0;0;0;0;0
FR;4;2021-04-11;0;0;0;0;0;0;0;0;0;0
FR;4;2021-04-12;0;0;0;0;0;0;0;0;0;0
FR;4;2021-04-13;0;0;0;0;0;0;0;0;0;0
FR;4;2021-04-14;0;0;0;0;0;0;0;0;0;0
FR;4;2021-04-15;0;0;0;0;0;0;0;0;0;0
FR;4;2021-04-16;0;0;0;0;0;0;0;0;0;0
FR;4;2021-04-17;0;0;0;0;0;0;0;0;0;0
FR;4;2021-04-18;0;0;0;0;0;0;0;0;0;0
FR;4;2021-04-19;0;0;0;0;0;0;0;0;0;0
FR;4;2021-04-20;0;0;0;0;0;0;0;0;0;0
FR;4;2021-04-21;0;0;0;0;0;0;0;0;0;0
FR;4;2021-04-22;0;0;0;0;0;0;0;0;0;0
FR;4;2021-04-23;4126;0;0;0;0;4126;0;0;0;0
FR;4;2021-04-24;1569;0;0;0;0;5695;0;0;0;0
FR;4;2021-04-25;124;0;0;0;0;5819;0;0;0;0
FR;4;2021-04-26;2868;0;0;0;0;8687;0;0;0;0
FR;4;2021-04-27;9517;3;0;0;0;18204;3;0;0;0
FR;4;2021-04-28;9902;6;0;0;0;28106;9;0;0;0
FR;4;2021-04-29;15985;8;0;0;0;44091;17;0;0;0
FR;4;2021-04-30;19224;10;0;0;0;63315;27;0;0;0
FR;4;2021-05-01;1989;6;0;0;0;65304;33;0;0;0
FR;4;2021-05-02;481;0;0;0;0;65785;33;0;0;0
FR;4;2021-05-03;5054;2;0;0;0;70839;35;0;0;0
FR;4;2021-05-04;8394;10;0;0;0;79233;45;0;0;0
FR;4;2021-05-05;6179;7;0;0;0;85412;52;0;0;0
FR;4;2021-05-06;11379;11;0;0;0;96791;63;0;0;0
FR;4;2021-05-07;19116;9;0;0;0;115907;72;0;0;0
FR;4;2021-05-08;2375;6;0;0;0;118282;78;0;0;0
FR;4;2021-05-09;683;3;0;0;0;118965;81;0;0;0
FR;4;2021-05-10;7233;5;1;0;0;126198;86;1;0;0
FR;4;2021-05-11;14309;11;0;0;0;140507;97;1;0;0
FR;4;2021-05-12;10153;16;0;0;0;150660;113;1;0;0
FR;4;2021-05-13;1577;3;0;0;0;152237;116;1;0;0
FR;4;2021-05-14;7748;6;0;0;0;159985;122;1;0;0
FR;4;2021-05-15;3711;8;1;0;0;163696;130;2;0;0
FR;4;2021-05-16;418;1;0;0;0;164114;131;2;0;0
FR;4;2021-05-17;4472;6;0;0;0;168586;137;2;0;0
FR;4;2021-05-18;8742;10;0;0;0;177328;147;2;0;0
FR;4;2021-05-19;5685;7;0;0;0;183013;154;2;0;0
FR;4;2021-05-20;9476;7;0;0;0;192489;161;2;0;0
FR;4;2021-05-21;12781;29;0;0;0;205270;190;2;0;0
FR;4;2021-05-22;5048;15;0;0;0;210318;205;2;0;0
FR;4;2021-05-23;494;4;0;0;0;210812;209;2;0;0
FR;4;2021-05-24;1049;7;0;0;0;211861;216;2;0;0
FR;4;2021-05-25;7615;15;0;0;0;219476;231;2;0;0
FR;4;2021-05-26;7718;16;0;0;0;227194;247;2;0;0
FR;4;2021-05-27;14326;35;0;0;0;241520;282;2;0;0
FR;4;2021-05-28;26576;82;1;0;0;268096;364;3;0;0
FR;4;2021-05-29;11379;18;0;0;0;279475;382;3;0;0
FR;4;2021-05-30;970;6;0;0;0;280445;388;3;0;0
FR;4;2021-05-31;12684;21;0;0;0;293129;409;3;0;0
FR;4;2021-06-01;20237;46;1;0;0;313366;455;4;0;0
FR;4;2021-06-02;14513;33;0;0;0;327879;488;4;0;0
FR;4;2021-06-03;19400;24;1;0;0;347279;512;5;0;0
FR;4;2021-06-04;22502;47;0;0;0;369781;559;5;0;0
FR;4;2021-06-05;9709;32;0;0;0;379490;591;5;0;0
FR;4;2021-06-06;1037;0;0;0;0;380527;591;5;0;0
FR;4;2021-06-07;9222;19;0;0;0;389749;610;5;0;0
FR;4;2021-06-08;14607;31;0;0;0;404356;641;5;0;0
FR;4;2021-06-09;12202;25;0;0;0;416558;666;5;0;0
FR;4;2021-06-10;15392;30;0;0;0;431950;696;5;0;0
FR;4;2021-06-11;16970;55;0;0;0;448920;751;5;0;0
FR;4;2021-06-12;7439;27;0;0;0;456359;778;5;0;0
FR;4;2021-06-13;906;2;0;0;0;457265;780;5;0;0
FR;4;2021-06-14;6645;25;0;0;0;463910;805;5;0;0
FR;4;2021-06-15;10872;37;0;0;0;474782;842;5;0;0
FR;4;2021-06-16;8898;14;0;0;0;483680;856;5;0;0
FR;4;2021-06-17;10891;36;0;0;0;494571;892;5;0;0
FR;4;2021-06-18;12415;44;0;0;0;506986;936;5;0;0
FR;4;2021-06-19;5562;25;0;0;0;512548;961;5;0;0
FR;4;2021-06-20;814;5;0;0;0;513362;966;5;0;0
FR;4;2021-06-21;5078;20;0;0;0;518440;986;5;0;0
FR;4;2021-06-22;7900;26;2;0;0;526340;1012;7;0;0
FR;4;2021-06-23;7089;39;2;0;0;533429;1051;9;0;0
FR;4;2021-06-24;8643;44;1;0;0;542072;1095;10;0;0
FR;4;2021-06-25;10163;39;2;0;0;552235;1134;12;0;0
FR;4;2021-06-26;4837;21;0;0;0;557072;1155;12;0;0
FR;4;2021-06-27;757;3;0;0;0;557829;1158;12;0;0
FR;4;2021-06-28;4811;16;1;0;0;562640;1174;13;0;0
FR;4;2021-06-29;7090;27;2;0;0;569730;1201;15;0;0
FR;4;2021-06-30;6699;40;2;0;0;576429;1241;17;0;0
FR;4;2021-07-01;8179;39;0;0;0;584608;1280;17;0;0
FR;4;2021-07-02;9410;52;1;0;0;594018;1332;18;0;0
FR;4;2021-07-03;4839;19;0;0;0;598857;1351;18;0;0
FR;4;2021-07-04;683;5;0;0;0;599540;1356;18;0;0
FR;4;2021-07-05;4760;19;2;0;0;604300;1375;20;0;0
FR;4;2021-07-06;7709;28;4;0;0;612009;1403;24;0;0
FR;4;2021-07-07;7060;34;2;0;0;619069;1437;26;0;0
FR;4;2021-07-08;9213;38;2;0;0;628282;1475;28;0;0
FR;4;2021-07-09;10263;33;1;0;0;638545;1508;29;0;0
FR;4;2021-07-10;4633;14;2;0;0;643178;1522;31;0;0
FR;4;2021-07-11;578;5;1;0;0;643756;1527;32;0;0
FR;4;2021-07-12;5860;28;0;0;0;649616;1555;32;0;0
FR;4;2021-07-13;14228;29;0;0;0;663844;1584;32;0;0
FR;4;2021-07-14;2279;14;0;0;0;666123;1598;32;0;0
FR;4;2021-07-15;18220;36;0;0;0;684343;1634;32;0;0
FR;4;2021-07-16;22813;70;2;0;0;707156;1704;34;0;0
FR;4;2021-07-17;9729;20;0;0;0;716885;1724;34;0;0
FR;4;2021-07-18;1349;4;0;0;0;718234;1728;34;0;0
FR;4;2021-07-19;12962;28;1;0;0;731196;1756;35;0;0
FR;4;2021-07-20;17313;26;1;0;0;748509;1782;36;0;0
FR;4;2021-07-21;15593;33;0;0;0;764102;1815;36;0;0
FR;4;2021-07-22;18227;43;2;0;0;782329;1858;38;0;0
FR;4;2021-07-23;20390;57;7;0;0;802719;1915;45;0;0
FR;4;2021-07-24;9270;32;0;0;0;811989;1947;45;0;0
FR;4;2021-07-25;1339;8;0;0;0;813328;1955;45;0;0
FR;4;2021-07-26;11014;20;0;0;0;824342;1975;45;0;0
FR;4;2021-07-27;14643;34;3;0;0;838985;2009;48;0;0
FR;4;2021-07-28;12898;25;2;0;0;851883;2034;50;0;0
FR;4;2021-07-29;14054;53;4;0;0;865937;2087;54;0;0
FR;4;2021-07-30;15463;45;2;0;0;881400;2132;56;0;0
FR;4;2021-07-31;6810;14;2;0;0;888210;2146;58;0;0
FR;4;2021-08-01;901;1;0;0;0;889111;2147;58;0;0
FR;4;2021-08-02;7882;28;0;0;0;896993;2175;58;0;0
FR;4;2021-08-03;10774;32;2;0;0;907767;2207;60;0;0
FR;4;2021-08-04;9710;29;0;0;0;917477;2236;60;0;0
FR;4;2021-08-05;9794;41;0;0;0;927271;2277;60;0;0
FR;4;2021-08-06;10163;31;3;0;0;937434;2308;63;0;0
FR;4;2021-08-07;5074;29;1;0;0;942508;2337;64;0;0
FR;4;2021-08-08;1210;13;0;0;0;943718;2350;64;0;0
FR;4;2021-08-09;6318;30;0;0;0;950036;2380;64;0;0
FR;4;2021-08-10;8735;20;0;0;0;958771;2400;64;0;0
FR;4;2021-08-11;7919;34;3;0;0;966690;2434;67;0;0
FR;4;2021-08-12;8567;27;1;0;0;975257;2461;68;0;0
FR;4;2021-08-13;7532;24;0;1;0;982789;2485;68;1;0
FR;4;2021-08-14;3775;20;0;0;0;986564;2505;68;1;0
FR;4;2021-08-15;765;5;0;0;0;987329;2510;68;1;0
FR;4;2021-08-16;3991;15;0;0;0;991320;2525;68;1;0
FR;4;2021-08-17;5609;13;1;0;0;996929;2538;69;1;0
FR;4;2021-08-18;5149;35;0;0;0;1002078;2573;69;1;0
FR;4;2021-08-19;5467;34;3;0;0;1007545;2607;72;1;0
FR;4;2021-08-20;5195;23;1;0;0;1012740;2630;73;1;0
FR;4;2021-08-21;2303;21;1;0;0;1015043;2651;74;1;0
FR;4;2021-08-22;400;2;0;0;0;1015443;2653;74;1;0
FR;4;2021-08-23;2910;18;1;0;0;1018353;2671;75;1;0
FR;4;2021-08-24;3730;13;0;0;0;1022083;2684;75;1;0
FR;4;2021-08-25;3523;25;0;0;0;1025606;2709;75;1;0
FR;4;2021-08-26;3697;20;1;0;0;1029303;2729;76;1;0
FR;4;2021-08-27;3595;31;2;0;0;1032898;2760;78;1;0
FR;4;2021-08-28;1715;10;1;0;0;1034613;2770;79;1;0
FR;4;2021-08-29;384;7;1;0;0;1034997;2777;80;1;0
FR;4;2021-08-30;1996;23;0;0;14;1036993;2800;80;1;14
FR;4;2021-08-31;2468;20;0;0;13;1039461;2820;80;1;27
FR;4;2021-09-01;2067;37;1;0;20;1041528;2857;81;1;47
FR;4;2021-09-02;2293;30;4;0;17;1043821;2887;85;1;64
FR;4;2021-09-03;2348;44;5;0;32;1046169;2931;90;1;96
FR;4;2021-09-04;1368;17;0;0;5;1047537;2948;90;1;101
FR;4;2021-09-05;428;2;0;0;2;1047965;2950;90;1;103
FR;4;2021-09-06;1697;61;0;0;23;1049662;3011;90;1;126
FR;4;2021-09-07;1671;19;0;0;9;1051333;3030;90;1;135
FR;4;2021-09-08;1276;26;3;0;19;1052609;3056;93;1;154
FR;4;2021-09-09;1382;23;2;0;9;1053991;3079;95;1;163
FR;4;2021-09-10;1512;30;2;0;22;1055503;3109;97;1;185
FR;4;2021-09-11;733;11;0;0;3;1056236;3120;97;1;188
FR;4;2021-09-12;168;4;0;0;2;1056404;3124;97;1;190
FR;4;2021-09-13;1302;20;1;0;14;1057706;3144;98;1;204
FR;4;2021-09-14;1486;9;2;0;6;1059192;3153;100;1;210
FR;4;2021-09-15;1086;26;1;0;24;1060278;3179;101;1;234
FR;4;2021-09-16;1091;22;2;0;15;1061369;3201;103;1;249
FR;4;2021-09-17;886;21;1;0;12;1062255;3222;104;1;261
FR;4;2021-09-18;457;5;1;0;4;1062712;3227;105;1;265
FR;4;2021-09-19;181;2;0;0;1;1062893;3229;105;1;266
FR;4;2021-09-20;441;19;0;0;13;1063334;3248;105;1;279
FR;4;2021-09-21;418;10;0;0;6;1063752;3258;105;1;285
FR;4;2021-09-22;371;20;2;0;14;1064123;3278;107;1;299
FR;4;2021-09-23;470;12;1;0;11;1064593;3290;108;1;310
FR;4;2021-09-24;407;13;2;0;9;1065000;3303;110;1;319
FR;4;2021-09-25;280;9;1;0;4;1065280;3312;111;1;323
FR;4;2021-09-26;71;2;0;0;1;1065351;3314;111;1;324
FR;4;2021-09-27;258;10;1;0;8;1065609;3324;112;1;332
FR;4;2021-09-28;310;8;0;0;8;1065919;3332;112;1;340
FR;4;2021-09-29;369;19;1;0;13;1066288;3351;113;1;353
FR;4;2021-09-30;354;40;0;0;21;1066642;3391;113;1;374
FR;4;2021-10-01;396;47;0;0;41;1067038;3438;113;1;415
FR;4;2021-10-02;192;22;1;0;13;1067230;3460;114;1;428
FR;4;2021-10-03;82;1;0;0;0;1067312;3461;114;1;428
FR;4;2021-10-04;351;19;1;0;15;1067663;3480;115;1;443
FR;4;2021-10-05;271;19;2;0;15;1067934;3499;117;1;458
FR;4;2021-10-06;241;21;1;0;18;1068175;3520;118;1;476
FR;4;2021-10-07;249;26;2;0;14;1068424;3546;120;1;490
FR;4;2021-10-08;350;22;2;0;18;1068774;3568;122;1;508
FR;4;2021-10-09;188;6;5;0;6;1068962;3574;127;1;514
FR;4;2021-10-10;91;3;2;0;3;1069053;3577;129;1;517
FR;4;2021-10-11;242;14;1;0;13;1069295;3591;130;1;530
FR;4;2021-10-12;201;14;0;0;13;1069496;3605;130;1;543
FR;4;2021-10-13;216;28;1;0;25;1069712;3633;131;1;568
FR;4;2021-10-14;304;20;4;0;14;1070016;3653;135;1;582
FR;4;2021-10-15;313;24;5;0;25;1070329;3677;140;1;607
FR;4;2021-10-16;163;6;2;0;6;1070492;3683;142;1;613
FR;4;2021-10-17;69;3;0;0;1;1070561;3686;142;1;614
FR;4;2021-10-18;272;16;1;0;12;1070833;3702;143;1;626
FR;4;2021-10-19;205;14;2;0;15;1071038;3716;145;1;641
FR;4;2021-10-20;222;27;3;0;14;1071260;3743;148;1;655
FR;4;2021-10-21;228;17;0;0;13;1071488;3760;148;1;668
FR;4;2021-10-22;204;26;2;0;21;1071692;3786;150;1;689
FR;4;2021-10-23;115;16;1;0;15;1071807;3802;151;1;704
FR;4;2021-10-24;37;4;0;0;1;1071844;3806;151;1;705
FR;4;2021-10-25;205;7;2;0;9;1072049;3813;153;1;714
FR;4;2021-10-26;193;13;0;0;11;1072242;3826;153;1;725
FR;4;2021-10-27;188;11;4;0;11;1072430;3837;157;1;736
FR;4;2021-10-28;177;18;4;0;21;1072607;3855;161;1;757
FR;4;2021-10-29;217;16;2;0;14;1072824;3871;163;1;771
FR;4;2021-10-30;98;2;0;0;1;1072922;3873;163;1;772
FR;4;2021-10-31;54;3;2;0;3;1072976;3876;165;1;775
FR;4;2021-11-01;71;27;4;0;24;1073047;3903;169;1;799
FR;4;2021-11-02;146;20;2;0;21;1073193;3923;171;1;820
FR;4;2021-11-03;124;20;8;1;18;1073317;3943;179;2;838
FR;4;2021-11-04;169;13;1;0;10;1073486;3956;180;2;848
FR;4;2021-11-05;123;17;1;0;16;1073609;3973;181;2;864
FR;4;2021-11-06;76;6;1;0;6;1073685;3979;182;2;870
FR;4;2021-11-07;73;2;2;0;4;1073758;3981;184;2;874
FR;4;2021-11-08;157;16;1;0;16;1073915;3997;185;2;890
FR;4;2021-11-09;146;13;3;0;15;1074061;4010;188;2;905
FR;4;2021-11-10;106;25;6;0;27;1074167;4035;194;2;932
FR;4;2021-11-11;78;8;0;0;8;1074245;4043;194;2;940
FR;4;2021-11-12;94;18;2;0;18;1074339;4061;196;2;958
FR;4;2021-11-13;71;15;2;0;14;1074410;4076;198;2;972
FR;4;2021-11-14;51;5;3;0;7;1074461;4081;201;2;979
FR;4;2021-11-15;91;26;2;0;24;1074552;4107;203;2;1003
FR;4;2021-11-16;97;11;2;0;13;1074649;4118;205;2;1016
FR;4;2021-11-17;110;29;4;0;29;1074759;4147;209;2;1045
FR;4;2021-11-18;95;34;11;0;39;1074854;4181;220;2;1084
FR;4;2021-11-19;75;19;3;0;20;1074929;4200;223;2;1104
FR;4;2021-11-20;59;6;1;0;6;1074988;4206;224;2;1110
FR;4;2021-11-21;60;7;2;0;9;1075048;4213;226;2;1119
FR;4;2021-11-22;96;27;6;0;29;1075144;4240;232;2;1148
FR;4;2021-11-23;69;30;5;0;27;1075213;4270;237;2;1175
FR;4;2021-11-24;82;23;9;0;22;1075295;4293;246;2;1197
FR;4;2021-11-25;82;30;14;0;32;1075377;4323;260;2;1229
FR;4;2021-11-26;78;42;12;0;44;1075455;4365;272;2;1273
FR;4;2021-11-27;29;23;18;0;26;1075484;4388;290;2;1299
FR;4;2021-11-28;45;9;0;0;8;1075529;4397;290;2;1307
FR;4;2021-11-29;79;31;14;0;38;1075608;4428;304;2;1345
FR;4;2021-11-30;55;36;13;0;40;1075663;4464;317;2;1385
FR;4;2021-12-01;67;59;19;0;66;1075730;4523;336;2;1451
FR;4;2021-12-02;92;47;17;0;50;1075822;4570;353;2;1501
FR;4;2021-12-03;96;35;15;0;43;1075918;4605;368;2;1544
FR;4;2021-12-04;66;30;19;0;44;1075984;4635;387;2;1588
FR;4;2021-12-05;55;5;1;0;6;1076039;4640;388;2;1594
FR;4;2021-12-06;89;45;21;0;60;1076128;4685;409;2;1654
FR;4;2021-12-07;73;33;10;0;33;1076201;4718;419;2;1687
FR;4;2021-12-08;61;27;18;0;32;1076262;4745;437;2;1719
FR;4;2021-12-09;57;31;11;0;37;1076319;4776;448;2;1756
FR;4;2021-12-10;56;62;21;0;67;1076375;4838;469;2;1823
FR;4;2021-12-11;24;33;8;0;33;1076399;4871;477;2;1856
FR;4;2021-12-12;21;10;3;0;13;1076420;4881;480;2;1869
FR;4;2021-12-13;59;39;12;0;48;1076479;4920;492;2;1917
FR;4;2021-12-14;51;43;14;0;51;1076530;4963;506;2;1968
FR;4;2021-12-15;50;59;29;0;79;1076580;5022;535;2;2047
FR;4;2021-12-16;29;41;19;0;53;1076609;5063;554;2;2100
FR;4;2021-12-17;36;53;12;0;58;1076645;5116;566;2;2158
FR;4;2021-12-18;45;29;2;0;30;1076690;5145;568;2;2188
FR;4;2021-12-19;14;3;1;0;3;1076704;5148;569;2;2191
FR;4;2021-12-20;32;38;12;0;43;1076736;5186;581;2;2234
FR;4;2021-12-21;24;30;14;0;35;1076760;5216;595;2;2269
FR;4;2021-12-22;34;35;11;0;36;1076794;5251;606;2;2305
FR;4;2021-12-23;35;43;10;0;49;1076829;5294;616;2;2354
FR;4;2021-12-24;22;25;10;0;29;1076851;5319;626;2;2383
FR;4;2021-12-25;5;3;3;0;4;1076856;5322;629;2;2387
FR;4;2021-12-26;4;2;1;0;1;1076860;5324;630;2;2388
FR;4;2021-12-27;26;42;9;0;43;1076886;5366;639;2;2431
FR;4;2021-12-28;22;28;10;0;31;1076908;5394;649;2;2462
FR;4;2021-12-29;42;22;10;0;26;1076950;5416;659;2;2488
FR;4;2021-12-30;35;15;12;0;18;1076985;5431;671;2;2506
FR;4;2021-12-31;18;4;8;0;10;1077003;5435;679;2;2516
FR;4;2022-01-01;4;3;4;0;5;1077007;5438;683;2;2521
FR;4;2022-01-02;36;4;14;0;16;1077043;5442;697;2;2537
FR;4;2022-01-03;36;47;21;1;53;1077079;5489;718;3;2590
FR;4;2022-01-04;25;24;10;1;24;1077104;5513;728;4;2614
FR;4;2022-01-05;40;18;16;0;19;1077144;5531;744;4;2633
FR;4;2022-01-06;41;18;20;0;30;1077185;5549;764;4;2663
FR;4;2022-01-07;15;16;15;0;16;1077200;5565;779;4;2679
FR;4;2022-01-08;7;5;9;0;11;1077207;5570;788;4;2690
FR;4;2022-01-09;14;1;1;0;2;1077221;5571;789;4;2692
FR;4;2022-01-10;30;19;15;0;29;1077251;5590;804;4;2721
FR;4;2022-01-11;20;30;12;0;32;1077271;5620;816;4;2753
FR;4;2022-01-12;26;17;12;0;18;1077297;5637;828;4;2771
FR;4;2022-01-13;45;17;25;0;32;1077342;5654;853;4;2803
FR;4;2022-01-14;19;26;12;0;28;1077361;5680;865;4;2831
FR;4;2022-01-15;7;5;6;0;9;1077368;5685;871;4;2840
FR;4;2022-01-16;8;8;9;0;16;1077376;5693;880;4;2856
FR;4;2022-01-17;22;18;10;0;22;1077398;5711;890;4;2878
FR;4;2022-01-18;15;14;7;0;18;1077413;5725;897;4;2896
FR;4;2022-01-19;27;20;9;0;27;1077440;5745;906;4;2923
FR;4;2022-01-20;29;35;13;0;37;1077469;5780;919;4;2960
FR;4;2022-01-21;7;12;18;1;15;1077476;5792;937;5;2975
FR;4;2022-01-22;24;8;2;0;8;1077500;5800;939;5;2983
FR;4;2022-01-23;4;2;4;0;6;1077504;5802;943;5;2989
FR;4;2022-01-24;15;20;8;0;27;1077519;5822;951;5;3016
FR;4;2022-01-25;17;31;8;1;35;1077536;5853;959;6;3051
FR;4;2022-01-26;15;15;6;1;16;1077551;5868;965;7;3067
FR;4;2022-01-27;13;18;5;0;21;1077564;5886;970;7;3088
FR;4;2022-01-28;12;21;7;0;23;1077576;5907;977;7;3111
FR;4;2022-01-29;14;5;3;0;7;1077590;5912;980;7;3118
FR;4;2022-01-30;15;1;0;0;1;1077605;5913;980;7;3119
FR;4;2022-01-31;14;25;6;0;28;1077619;5938;986;7;3147
FR;4;2022-02-01;6;17;11;0;17;1077625;5955;997;7;3164
FR;4;2022-02-02;15;11;9;2;15;1077640;5966;1006;9;3179
FR;4;2022-02-03;10;20;9;0;22;1077650;5986;1015;9;3201
FR;4;2022-02-04;5;4;7;0;8;1077655;5990;1022;9;3209
FR;4;2022-02-05;6;13;1;0;13;1077661;6003;1023;9;3222
FR;4;2022-02-06;5;2;1;0;2;1077666;6005;1024;9;3224
FR;4;2022-02-07;8;16;6;0;16;1077674;6021;1030;9;3240
FR;4;2022-02-08;13;18;12;1;18;1077687;6039;1042;10;3258
FR;4;2022-02-09;10;11;7;0;14;1077697;6050;1049;10;3272
FR;4;2022-02-10;15;22;8;0;22;1077712;6072;1057;10;3294
FR;4;2022-02-11;15;14;6;0;18;1077727;6086;1063;10;3312
FR;4;2022-02-12;23;4;0;0;3;1077750;6090;1063;10;3315
FR;4;2022-02-13;7;2;2;0;4;1077757;6092;1065;10;3319
FR;4;2022-02-14;14;10;6;0;12;1077771;6102;1071;10;3331
FR;4;2022-02-15;13;7;0;0;6;1077784;6109;1071;10;3337
FR;4;2022-02-16;9;8;9;0;13;1077793;6117;1080;10;3350
FR;4;2022-02-17;7;2;3;0;3;1077800;6119;1083;10;3353
FR;4;2022-02-18;16;13;6;0;17;1077816;6132;1089;10;3370
FR;4;2022-02-19;15;1;0;0;1;1077831;6133;1089;10;3371
FR;4;2022-02-20;6;2;0;0;1;1077837;6135;1089;10;3372
FR;4;2022-02-21;22;3;2;0;3;1077859;6138;1091;10;3375
FR;4;2022-02-22;6;1;4;0;2;1077865;6139;1095;10;3377
FR;4;2022-02-23;15;6;6;0;6;1077880;6145;1101;10;3383
FR;4;2022-02-24;7;2;2;0;2;1077887;6147;1103;10;3385
FR;4;2022-02-25;14;4;6;0;4;1077901;6151;1109;10;3389
FR;4;2022-02-26;24;3;0;0;3;1077925;6154;1109;10;3392
FR;4;2022-02-27;8;0;0;0;0;1077933;6154;1109;10;3392
FR;4;2022-02-28;12;2;2;0;3;1077945;6156;1111;10;3395
FR;4;2022-03-01;4;2;2;0;2;1077949;6158;1113;10;3397
FR;4;2022-03-02;8;1;2;0;2;1077957;6159;1115;10;3399
FR;4;2022-03-03;10;2;1;0;1;1077967;6161;1116;10;3400
FR;4;2022-03-04;4;2;0;0;2;1077971;6163;1116;10;3402
FR;4;2022-03-05;8;1;0;0;1;1077979;6164;1116;10;3403
FR;4;2022-03-06;2;0;0;0;0;1077981;6164;1116;10;3403
FR;4;2022-03-07;11;2;1;0;1;1077992;6166;1117;10;3404
FR;4;2022-03-08;11;0;0;0;0;1078003;6166;1117;10;3404
FR;4;2022-03-09;7;2;0;0;1;1078010;6168;1117;10;3405
FR;4;2022-03-10;4;0;1;0;0;1078014;6168;1118;10;3405
FR;5;2020-12-27;0;0;0;0;0;0;0;0;0;0
FR;5;2020-12-28;0;0;0;0;0;0;0;0;0;0
FR;5;2020-12-29;0;0;0;0;0;0;0;0;0;0
FR;5;2020-12-30;0;0;0;0;0;0;0;0;0;0
FR;5;2020-12-31;0;0;0;0;0;0;0;0;0;0
FR;5;2021-01-01;0;0;0;0;0;0;0;0;0;0
FR;5;2021-01-02;0;0;0;0;0;0;0;0;0;0
FR;5;2021-01-03;0;0;0;0;0;0;0;0;0;0
FR;5;2021-01-04;0;0;0;0;0;0;0;0;0;0
FR;5;2021-01-05;0;0;0;0;0;0;0;0;0;0
FR;5;2021-01-06;0;0;0;0;0;0;0;0;0;0
FR;5;2021-01-07;0;0;0;0;0;0;0;0;0;0
FR;5;2021-01-08;0;0;0;0;0;0;0;0;0;0
FR;5;2021-01-09;0;0;0;0;0;0;0;0;0;0
FR;5;2021-01-10;0;0;0;0;0;0;0;0;0;0
FR;5;2021-01-11;0;0;0;0;0;0;0;0;0;0
FR;5;2021-01-12;0;0;0;0;0;0;0;0;0;0
FR;5;2021-01-13;0;0;0;0;0;0;0;0;0;0
FR;5;2021-01-14;0;0;0;0;0;0;0;0;0;0
FR;5;2021-01-15;0;0;0;0;0;0;0;0;0;0
FR;5;2021-01-16;0;0;0;0;0;0;0;0;0;0
FR;5;2021-01-17;0;0;0;0;0;0;0;0;0;0
FR;5;2021-01-18;0;0;0;0;0;0;0;0;0;0
FR;5;2021-01-19;0;0;0;0;0;0;0;0;0;0
FR;5;2021-01-20;0;0;0;0;0;0;0;0;0;0
FR;5;2021-01-21;0;0;0;0;0;0;0;0;0;0
FR;5;2021-01-22;0;0;0;0;0;0;0;0;0;0
FR;5;2021-01-23;0;0;0;0;0;0;0;0;0;0
FR;5;2021-01-24;0;0;0;0;0;0;0;0;0;0
FR;5;2021-01-25;0;0;0;0;0;0;0;0;0;0
FR;5;2021-01-26;0;0;0;0;0;0;0;0;0;0
FR;5;2021-01-27;0;0;0;0;0;0;0;0;0;0
FR;5;2021-01-28;0;0;0;0;0;0;0;0;0;0
FR;5;2021-01-29;0;0;0;0;0;0;0;0;0;0
FR;5;2021-01-30;0;0;0;0;0;0;0;0;0;0
FR;5;2021-01-31;0;0;0;0;0;0;0;0;0;0
FR;5;2021-02-01;0;0;0;0;0;0;0;0;0;0
FR;5;2021-02-02;0;0;0;0;0;0;0;0;0;0
FR;5;2021-02-03;0;0;0;0;0;0;0;0;0;0
FR;5;2021-02-04;0;0;0;0;0;0;0;0;0;0
FR;5;2021-02-05;0;0;0;0;0;0;0;0;0;0
FR;5;2021-02-06;0;0;0;0;0;0;0;0;0;0
FR;5;2021-02-07;0;0;0;0;0;0;0;0;0;0
FR;5;2021-02-08;0;0;0;0;0;0;0;0;0;0
FR;5;2021-02-09;0;0;0;0;0;0;0;0;0;0
FR;5;2021-02-10;0;0;0;0;0;0;0;0;0;0
FR;5;2021-02-11;0;0;0;0;0;0;0;0;0;0
FR;5;2021-02-12;0;0;0;0;0;0;0;0;0;0
FR;5;2021-02-13;0;0;0;0;0;0;0;0;0;0
FR;5;2021-02-14;0;0;0;0;0;0;0;0;0;0
FR;5;2021-02-15;0;0;0;0;0;0;0;0;0;0
FR;5;2021-02-16;0;0;0;0;0;0;0;0;0;0
FR;5;2021-02-17;0;0;0;0;0;0;0;0;0;0
FR;5;2021-02-18;0;0;0;0;0;0;0;0;0;0
FR;5;2021-02-19;0;0;0;0;0;0;0;0;0;0
FR;5;2021-02-20;0;0;0;0;0;0;0;0;0;0
FR;5;2021-02-21;0;0;0;0;0;0;0;0;0;0
FR;5;2021-02-22;0;0;0;0;0;0;0;0;0;0
FR;5;2021-02-23;0;0;0;0;0;0;0;0;0;0
FR;5;2021-02-24;0;0;0;0;0;0;0;0;0;0
FR;5;2021-02-25;0;0;0;0;0;0;0;0;0;0
FR;5;2021-02-26;0;0;0;0;0;0;0;0;0;0
FR;5;2021-02-27;0;0;0;0;0;0;0;0;0;0
FR;5;2021-02-28;0;0;0;0;0;0;0;0;0;0
FR;5;2021-03-01;0;0;0;0;0;0;0;0;0;0
FR;5;2021-03-02;0;0;0;0;0;0;0;0;0;0
FR;5;2021-03-03;0;0;0;0;0;0;0;0;0;0
FR;5;2021-03-04;0;0;0;0;0;0;0;0;0;0
FR;5;2021-03-05;0;0;0;0;0;0;0;0;0;0
FR;5;2021-03-06;0;0;0;0;0;0;0;0;0;0
FR;5;2021-03-07;0;0;0;0;0;0;0;0;0;0
FR;5;2021-03-08;0;0;0;0;0;0;0;0;0;0
FR;5;2021-03-09;0;0;0;0;0;0;0;0;0;0
FR;5;2021-03-10;0;0;0;0;0;0;0;0;0;0
FR;5;2021-03-11;0;0;0;0;0;0;0;0;0;0
FR;5;2021-03-12;0;0;0;0;0;0;0;0;0;0
FR;5;2021-03-13;0;0;0;0;0;0;0;0;0;0
FR;5;2021-03-14;0;0;0;0;0;0;0;0;0;0
FR;5;2021-03-15;0;0;0;0;0;0;0;0;0;0
FR;5;2021-03-16;0;0;0;0;0;0;0;0;0;0
FR;5;2021-03-17;0;0;0;0;0;0;0;0;0;0
FR;5;2021-03-18;0;0;0;0;0;0;0;0;0;0
FR;5;2021-03-19;0;0;0;0;0;0;0;0;0;0
FR;5;2021-03-20;0;0;0;0;0;0;0;0;0;0
FR;5;2021-03-21;0;0;0;0;0;0;0;0;0;0
FR;5;2021-03-22;0;0;0;0;0;0;0;0;0;0
FR;5;2021-03-23;0;0;0;0;0;0;0;0;0;0
FR;5;2021-03-24;0;0;0;0;0;0;0;0;0;0
FR;5;2021-03-25;0;0;0;0;0;0;0;0;0;0
FR;5;2021-03-26;0;0;0;0;0;0;0;0;0;0
FR;5;2021-03-27;0;0;0;0;0;0;0;0;0;0
FR;5;2021-03-28;0;0;0;0;0;0;0;0;0;0
FR;5;2021-03-29;0;0;0;0;0;0;0;0;0;0
FR;5;2021-03-30;0;0;0;0;0;0;0;0;0;0
FR;5;2021-03-31;0;0;0;0;0;0;0;0;0;0
FR;5;2021-04-01;0;0;0;0;0;0;0;0;0;0
FR;5;2021-04-02;0;0;0;0;0;0;0;0;0;0
FR;5;2021-04-03;0;0;0;0;0;0;0;0;0;0
FR;5;2021-04-04;0;0;0;0;0;0;0;0;0;0
FR;5;2021-04-05;0;0;0;0;0;0;0;0;0;0
FR;5;2021-04-06;0;0;0;0;0;0;0;0;0;0
FR;5;2021-04-07;0;0;0;0;0;0;0;0;0;0
FR;5;2021-04-08;0;0;0;0;0;0;0;0;0;0
FR;5;2021-04-09;0;0;0;0;0;0;0;0;0;0
FR;5;2021-04-10;0;0;0;0;0;0;0;0;0;0
FR;5;2021-04-11;0;0;0;0;0;0;0;0;0;0
FR;5;2021-04-12;0;0;0;0;0;0;0;0;0;0
FR;5;2021-04-13;0;0;0;0;0;0;0;0;0;0
FR;5;2021-04-14;0;0;0;0;0;0;0;0;0;0
FR;5;2021-04-15;0;0;0;0;0;0;0;0;0;0
FR;5;2021-04-16;0;0;0;0;0;0;0;0;0;0
FR;5;2021-04-17;0;0;0;0;0;0;0;0;0;0
FR;5;2021-04-18;0;0;0;0;0;0;0;0;0;0
FR;5;2021-04-19;0;0;0;0;0;0;0;0;0;0
FR;5;2021-04-20;0;0;0;0;0;0;0;0;0;0
FR;5;2021-04-21;0;0;0;0;0;0;0;0;0;0
FR;5;2021-04-22;0;0;0;0;0;0;0;0;0;0
FR;5;2021-04-23;0;0;0;0;0;0;0;0;0;0
FR;5;2021-04-24;0;0;0;0;0;0;0;0;0;0
FR;5;2021-04-25;0;0;0;0;0;0;0;0;0;0
FR;5;2021-04-26;0;0;0;0;0;0;0;0;0;0
FR;5;2021-04-27;0;0;0;0;0;0;0;0;0;0
FR;5;2021-04-28;0;0;0;0;0;0;0;0;0;0
FR;5;2021-04-29;0;0;0;0;0;0;0;0;0;0
FR;5;2021-04-30;0;0;0;0;0;0;0;0;0;0
FR;5;2021-05-01;0;0;0;0;0;0;0;0;0;0
FR;5;2021-05-02;0;0;0;0;0;0;0;0;0;0
FR;5;2021-05-03;0;0;0;0;0;0;0;0;0;0
FR;5;2021-05-04;0;0;0;0;0;0;0;0;0;0
FR;5;2021-05-05;0;0;0;0;0;0;0;0;0;0
FR;5;2021-05-06;0;0;0;0;0;0;0;0;0;0
FR;5;2021-05-07;0;0;0;0;0;0;0;0;0;0
FR;5;2021-05-08;0;0;0;0;0;0;0;0;0;0
FR;5;2021-05-09;0;0;0;0;0;0;0;0;0;0
FR;5;2021-05-10;0;0;0;0;0;0;0;0;0;0
FR;5;2021-05-11;0;0;0;0;0;0;0;0;0;0
FR;5;2021-05-12;0;0;0;0;0;0;0;0;0;0
FR;5;2021-05-13;0;0;0;0;0;0;0;0;0;0
FR;5;2021-05-14;0;0;0;0;0;0;0;0;0;0
FR;5;2021-05-15;0;0;0;0;0;0;0;0;0;0
FR;5;2021-05-16;0;0;0;0;0;0;0;0;0;0
FR;5;2021-05-17;0;0;0;0;0;0;0;0;0;0
FR;5;2021-05-18;0;0;0;0;0;0;0;0;0;0
FR;5;2021-05-19;0;0;0;0;0;0;0;0;0;0
FR;5;2021-05-20;0;0;0;0;0;0;0;0;0;0
FR;5;2021-05-21;0;0;0;0;0;0;0;0;0;0
FR;5;2021-05-22;0;0;0;0;0;0;0;0;0;0
FR;5;2021-05-23;0;0;0;0;0;0;0;0;0;0
FR;5;2021-05-24;0;0;0;0;0;0;0;0;0;0
FR;5;2021-05-25;0;0;0;0;0;0;0;0;0;0
FR;5;2021-05-26;0;0;0;0;0;0;0;0;0;0
FR;5;2021-05-27;0;0;0;0;0;0;0;0;0;0
FR;5;2021-05-28;0;0;0;0;0;0;0;0;0;0
FR;5;2021-05-29;0;0;0;0;0;0;0;0;0;0
FR;5;2021-05-30;0;0;0;0;0;0;0;0;0;0
FR;5;2021-05-31;0;0;0;0;0;0;0;0;0;0
FR;5;2021-06-01;0;0;0;0;0;0;0;0;0;0
FR;5;2021-06-02;0;0;0;0;0;0;0;0;0;0
FR;5;2021-06-03;0;0;0;0;0;0;0;0;0;0
FR;5;2021-06-04;0;0;0;0;0;0;0;0;0;0
FR;5;2021-06-05;0;0;0;0;0;0;0;0;0;0
FR;5;2021-06-06;0;0;0;0;0;0;0;0;0;0
FR;5;2021-06-07;0;0;0;0;0;0;0;0;0;0
FR;5;2021-06-08;0;0;0;0;0;0;0;0;0;0
FR;5;2021-06-09;0;0;0;0;0;0;0;0;0;0
FR;5;2021-06-10;0;0;0;0;0;0;0;0;0;0
FR;5;2021-06-11;0;0;0;0;0;0;0;0;0;0
FR;5;2021-06-12;0;0;0;0;0;0;0;0;0;0
FR;5;2021-06-13;0;0;0;0;0;0;0;0;0;0
FR;5;2021-06-14;0;0;0;0;0;0;0;0;0;0
FR;5;2021-06-15;0;0;0;0;0;0;0;0;0;0
FR;5;2021-06-16;0;0;0;0;0;0;0;0;0;0
FR;5;2021-06-17;0;0;0;0;0;0;0;0;0;0
FR;5;2021-06-18;0;0;0;0;0;0;0;0;0;0
FR;5;2021-06-19;0;0;0;0;0;0;0;0;0;0
FR;5;2021-06-20;0;0;0;0;0;0;0;0;0;0
FR;5;2021-06-21;0;0;0;0;0;0;0;0;0;0
FR;5;2021-06-22;0;0;0;0;0;0;0;0;0;0
FR;5;2021-06-23;0;0;0;0;0;0;0;0;0;0
FR;5;2021-06-24;0;0;0;0;0;0;0;0;0;0
FR;5;2021-06-25;0;0;0;0;0;0;0;0;0;0
FR;5;2021-06-26;0;0;0;0;0;0;0;0;0;0
FR;5;2021-06-27;0;0;0;0;0;0;0;0;0;0
FR;5;2021-06-28;0;0;0;0;0;0;0;0;0;0
FR;5;2021-06-29;0;0;0;0;0;0;0;0;0;0
FR;5;2021-06-30;0;0;0;0;0;0;0;0;0;0
FR;5;2021-07-01;0;0;0;0;0;0;0;0;0;0
FR;5;2021-07-02;0;0;0;0;0;0;0;0;0;0
FR;5;2021-07-03;0;0;0;0;0;0;0;0;0;0
FR;5;2021-07-04;0;0;0;0;0;0;0;0;0;0
FR;5;2021-07-05;0;0;0;0;0;0;0;0;0;0
FR;5;2021-07-06;0;0;0;0;0;0;0;0;0;0
FR;5;2021-07-07;0;0;0;0;0;0;0;0;0;0
FR;5;2021-07-08;0;0;0;0;0;0;0;0;0;0
FR;5;2021-07-09;0;0;0;0;0;0;0;0;0;0
FR;5;2021-07-10;0;0;0;0;0;0;0;0;0;0
FR;5;2021-07-11;0;0;0;0;0;0;0;0;0;0
FR;5;2021-07-12;0;0;0;0;0;0;0;0;0;0
FR;5;2021-07-13;0;0;0;0;0;0;0;0;0;0
FR;5;2021-07-14;0;0;0;0;0;0;0;0;0;0
FR;5;2021-07-15;0;0;0;0;0;0;0;0;0;0
FR;5;2021-07-16;0;0;0;0;0;0;0;0;0;0
FR;5;2021-07-17;0;0;0;0;0;0;0;0;0;0
FR;5;2021-07-18;0;0;0;0;0;0;0;0;0;0
FR;5;2021-07-19;0;0;0;0;0;0;0;0;0;0
FR;5;2021-07-20;0;0;0;0;0;0;0;0;0;0
FR;5;2021-07-21;0;0;0;0;0;0;0;0;0;0
FR;5;2021-07-22;0;0;0;0;0;0;0;0;0;0
FR;5;2021-07-23;0;0;0;0;0;0;0;0;0;0
FR;5;2021-07-24;0;0;0;0;0;0;0;0;0;0
FR;5;2021-07-25;0;0;0;0;0;0;0;0;0;0
FR;5;2021-07-26;0;0;0;0;0;0;0;0;0;0
FR;5;2021-07-27;0;0;0;0;0;0;0;0;0;0
FR;5;2021-07-28;0;0;0;0;0;0;0;0;0;0
FR;5;2021-07-29;0;0;0;0;0;0;0;0;0;0
FR;5;2021-07-30;0;0;0;0;0;0;0;0;0;0
FR;5;2021-07-31;0;0;0;0;0;0;0;0;0;0
FR;5;2021-08-01;0;0;0;0;0;0;0;0;0;0
FR;5;2021-08-02;0;0;0;0;0;0;0;0;0;0
FR;5;2021-08-03;0;0;0;0;0;0;0;0;0;0
FR;5;2021-08-04;0;0;0;0;0;0;0;0;0;0
FR;5;2021-08-05;0;0;0;0;0;0;0;0;0;0
FR;5;2021-08-06;0;0;0;0;0;0;0;0;0;0
FR;5;2021-08-07;0;0;0;0;0;0;0;0;0;0
FR;5;2021-08-08;0;0;0;0;0;0;0;0;0;0
FR;5;2021-08-09;0;0;0;0;0;0;0;0;0;0
FR;5;2021-08-10;0;0;0;0;0;0;0;0;0;0
FR;5;2021-08-11;0;0;0;0;0;0;0;0;0;0
FR;5;2021-08-12;0;0;0;0;0;0;0;0;0;0
FR;5;2021-08-13;0;0;0;0;0;0;0;0;0;0
FR;5;2021-08-14;0;0;0;0;0;0;0;0;0;0
FR;5;2021-08-15;0;0;0;0;0;0;0;0;0;0
FR;5;2021-08-16;0;0;0;0;0;0;0;0;0;0
FR;5;2021-08-17;0;0;0;0;0;0;0;0;0;0
FR;5;2021-08-18;0;0;0;0;0;0;0;0;0;0
FR;5;2021-08-19;0;0;0;0;0;0;0;0;0;0
FR;5;2021-08-20;0;0;0;0;0;0;0;0;0;0
FR;5;2021-08-21;0;0;0;0;0;0;0;0;0;0
FR;5;2021-08-22;0;0;0;0;0;0;0;0;0;0
FR;5;2021-08-23;0;0;0;0;0;0;0;0;0;0
FR;5;2021-08-24;0;0;0;0;0;0;0;0;0;0
FR;5;2021-08-25;0;0;0;0;0;0;0;0;0;0
FR;5;2021-08-26;0;0;0;0;0;0;0;0;0;0
FR;5;2021-08-27;0;0;0;0;0;0;0;0;0;0
FR;5;2021-08-28;0;0;0;0;0;0;0;0;0;0
FR;5;2021-08-29;0;0;0;0;0;0;0;0;0;0
FR;5;2021-08-30;0;0;0;0;0;0;0;0;0;0
FR;5;2021-08-31;0;0;0;0;0;0;0;0;0;0
FR;5;2021-09-01;0;0;0;0;0;0;0;0;0;0
FR;5;2021-09-02;0;0;0;0;0;0;0;0;0;0
FR;5;2021-09-03;0;0;0;0;0;0;0;0;0;0
FR;5;2021-09-04;0;0;0;0;0;0;0;0;0;0
FR;5;2021-09-05;0;0;0;0;0;0;0;0;0;0
FR;5;2021-09-06;0;0;0;0;0;0;0;0;0;0
FR;5;2021-09-07;0;0;0;0;0;0;0;0;0;0
FR;5;2021-09-08;0;0;0;0;0;0;0;0;0;0
FR;5;2021-09-09;0;0;0;0;0;0;0;0;0;0
FR;5;2021-09-10;0;0;0;0;0;0;0;0;0;0
FR;5;2021-09-11;0;0;0;0;0;0;0;0;0;0
FR;5;2021-09-12;0;0;0;0;0;0;0;0;0;0
FR;5;2021-09-13;0;0;0;0;0;0;0;0;0;0
FR;5;2021-09-14;0;0;0;0;0;0;0;0;0;0
FR;5;2021-09-15;0;0;0;0;0;0;0;0;0;0
FR;5;2021-09-16;0;0;0;0;0;0;0;0;0;0
FR;5;2021-09-17;0;0;0;0;0;0;0;0;0;0
FR;5;2021-09-18;0;0;0;0;0;0;0;0;0;0
FR;5;2021-09-19;0;0;0;0;0;0;0;0;0;0
FR;5;2021-09-20;0;0;0;0;0;0;0;0;0;0
FR;5;2021-09-21;0;0;0;0;0;0;0;0;0;0
FR;5;2021-09-22;0;0;0;0;0;0;0;0;0;0
FR;5;2021-09-23;0;0;0;0;0;0;0;0;0;0
FR;5;2021-09-24;0;0;0;0;0;0;0;0;0;0
FR;5;2021-09-25;0;0;0;0;0;0;0;0;0;0
FR;5;2021-09-26;0;0;0;0;0;0;0;0;0;0
FR;5;2021-09-27;0;0;0;0;0;0;0;0;0;0
FR;5;2021-09-28;0;0;0;0;0;0;0;0;0;0
FR;5;2021-09-29;0;0;0;0;0;0;0;0;0;0
FR;5;2021-09-30;0;0;0;0;0;0;0;0;0;0
FR;5;2021-10-01;0;0;0;0;0;0;0;0;0;0
FR;5;2021-10-02;0;0;0;0;0;0;0;0;0;0
FR;5;2021-10-03;0;0;0;0;0;0;0;0;0;0
FR;5;2021-10-04;0;0;0;0;0;0;0;0;0;0
FR;5;2021-10-05;0;0;0;0;0;0;0;0;0;0
FR;5;2021-10-06;0;0;0;0;0;0;0;0;0;0
FR;5;2021-10-07;0;0;0;0;0;0;0;0;0;0
FR;5;2021-10-08;0;0;0;0;0;0;0;0;0;0
FR;5;2021-10-09;0;0;0;0;0;0;0;0;0;0
FR;5;2021-10-10;0;0;0;0;0;0;0;0;0;0
FR;5;2021-10-11;0;0;0;0;0;0;0;0;0;0
FR;5;2021-10-12;0;0;0;0;0;0;0;0;0;0
FR;5;2021-10-13;0;0;0;0;0;0;0;0;0;0
FR;5;2021-10-14;0;0;0;0;0;0;0;0;0;0
FR;5;2021-10-15;0;0;0;0;0;0;0;0;0;0
FR;5;2021-10-16;0;0;0;0;0;0;0;0;0;0
FR;5;2021-10-17;0;0;0;0;0;0;0;0;0;0
FR;5;2021-10-18;0;0;0;0;0;0;0;0;0;0
FR;5;2021-10-19;0;0;0;0;0;0;0;0;0;0
FR;5;2021-10-20;0;0;0;0;0;0;0;0;0;0
FR;5;2021-10-21;0;0;0;0;0;0;0;0;0;0
FR;5;2021-10-22;0;0;0;0;0;0;0;0;0;0
FR;5;2021-10-23;0;0;0;0;0;0;0;0;0;0
FR;5;2021-10-24;0;0;0;0;0;0;0;0;0;0
FR;5;2021-10-25;0;0;0;0;0;0;0;0;0;0
FR;5;2021-10-26;0;0;0;0;0;0;0;0;0;0
FR;5;2021-10-27;0;0;0;0;0;0;0;0;0;0
FR;5;2021-10-28;0;0;0;0;0;0;0;0;0;0
FR;5;2021-10-29;0;0;0;0;0;0;0;0;0;0
FR;5;2021-10-30;0;0;0;0;0;0;0;0;0;0
FR;5;2021-10-31;0;0;0;0;0;0;0;0;0;0
FR;5;2021-11-01;0;0;0;0;0;0;0;0;0;0
FR;5;2021-11-02;0;0;0;0;0;0;0;0;0;0
FR;5;2021-11-03;0;0;0;0;0;0;0;0;0;0
FR;5;2021-11-04;0;0;0;0;0;0;0;0;0;0
FR;5;2021-11-05;0;0;0;0;0;0;0;0;0;0
FR;5;2021-11-06;0;0;0;0;0;0;0;0;0;0
FR;5;2021-11-07;0;0;0;0;0;0;0;0;0;0
FR;5;2021-11-08;0;0;0;0;0;0;0;0;0;0
FR;5;2021-11-09;0;0;0;0;0;0;0;0;0;0
FR;5;2021-11-10;0;0;0;0;0;0;0;0;0;0
FR;5;2021-11-11;0;0;0;0;0;0;0;0;0;0
FR;5;2021-11-12;0;0;0;0;0;0;0;0;0;0
FR;5;2021-11-13;0;0;0;0;0;0;0;0;0;0
FR;5;2021-11-14;0;0;0;0;0;0;0;0;0;0
FR;5;2021-11-15;0;0;0;0;0;0;0;0;0;0
FR;5;2021-11-16;0;0;0;0;0;0;0;0;0;0
FR;5;2021-11-17;0;0;0;0;0;0;0;0;0;0
FR;5;2021-11-18;0;0;0;0;0;0;0;0;0;0
FR;5;2021-11-19;0;0;0;0;0;0;0;0;0;0
FR;5;2021-11-20;0;0;0;0;0;0;0;0;0;0
FR;5;2021-11-21;0;0;0;0;0;0;0;0;0;0
FR;5;2021-11-22;0;0;0;0;0;0;0;0;0;0
FR;5;2021-11-23;0;0;0;0;0;0;0;0;0;0
FR;5;2021-11-24;0;0;0;0;0;0;0;0;0;0
FR;5;2021-11-25;0;0;0;0;0;0;0;0;0;0
FR;5;2021-11-26;0;0;0;0;0;0;0;0;0;0
FR;5;2021-11-27;0;0;0;0;0;0;0;0;0;0
FR;5;2021-11-28;0;0;0;0;0;0;0;0;0;0
FR;5;2021-11-29;0;0;0;0;0;0;0;0;0;0
FR;5;2021-11-30;0;0;0;0;0;0;0;0;0;0
FR;5;2021-12-01;0;0;0;0;0;0;0;0;0;0
FR;5;2021-12-02;0;0;0;0;0;0;0;0;0;0
FR;5;2021-12-03;0;0;0;0;0;0;0;0;0;0
FR;5;2021-12-04;0;0;0;0;0;0;0;0;0;0
FR;5;2021-12-05;0;0;0;0;0;0;0;0;0;0
FR;5;2021-12-06;0;0;0;0;0;0;0;0;0;0
FR;5;2021-12-07;0;0;0;0;0;0;0;0;0;0
FR;5;2021-12-08;0;0;0;0;0;0;0;0;0;0
FR;5;2021-12-09;0;0;0;0;0;0;0;0;0;0
FR;5;2021-12-10;0;0;0;0;0;0;0;0;0;0
FR;5;2021-12-11;0;0;0;0;0;0;0;0;0;0
FR;5;2021-12-12;0;0;0;0;0;0;0;0;0;0
FR;5;2021-12-13;0;0;0;0;0;0;0;0;0;0
FR;5;2021-12-14;25;45;77;0;88;25;45;77;0;88
FR;5;2021-12-15;196;44;37;0;49;221;89;114;0;137
FR;5;2021-12-16;180;21;44;0;48;401;110;158;0;185
FR;5;2021-12-17;309;16;72;0;74;710;126;230;0;259
FR;5;2021-12-18;762;24;22;0;29;1472;150;252;0;288
FR;5;2021-12-19;586;15;15;0;17;2058;165;267;0;305
FR;5;2021-12-20;1215;31;35;0;38;3273;196;302;0;343
FR;5;2021-12-21;1534;22;54;1;60;4807;218;356;1;403
FR;5;2021-12-22;4067;40;37;0;46;8874;258;393;1;449
FR;5;2021-12-23;3040;16;21;0;25;11914;274;414;1;474
FR;5;2021-12-24;760;18;9;0;15;12674;292;423;1;489
FR;5;2021-12-25;61;5;1;0;2;12735;297;424;1;491
FR;5;2021-12-26;623;6;3;0;4;13358;303;427;1;495
FR;5;2021-12-27;4080;25;21;0;23;17438;328;448;1;518
FR;5;2021-12-28;5199;22;41;1;42;22637;350;489;2;560
FR;5;2021-12-29;8100;34;65;2;68;30737;384;554;4;628
FR;5;2021-12-30;5171;19;33;0;39;35908;403;587;4;667
FR;5;2021-12-31;1553;8;10;0;11;37461;411;597;4;678
FR;5;2022-01-01;182;1;2;0;2;37643;412;599;4;680
FR;5;2022-01-02;1489;1;1;0;1;39132;413;600;4;681
FR;5;2022-01-03;3054;33;33;0;32;42186;446;633;4;713
FR;5;2022-01-04;3032;39;33;0;42;45218;485;666;4;755
FR;5;2022-01-05;19305;202;97;1;107;64523;687;763;5;862
FR;5;2022-01-06;3740;133;122;0;142;68263;820;885;5;1004
FR;5;2022-01-07;5005;199;48;2;56;73268;1019;933;7;1060
FR;5;2022-01-08;13650;514;45;0;52;86918;1533;978;7;1112
FR;5;2022-01-09;5755;398;15;0;20;92673;1931;993;7;1132
FR;5;2022-01-10;3452;328;25;0;29;96125;2259;1018;7;1161
FR;5;2022-01-11;3667;284;37;0;40;99792;2543;1055;7;1201
FR;5;2022-01-12;22648;3004;90;0;113;122440;5547;1145;7;1314
FR;5;2022-01-13;4031;624;30;0;32;126471;6171;1175;7;1346
FR;5;2022-01-14;4842;580;43;0;50;131313;6751;1218;7;1396
FR;5;2022-01-15;14673;1747;39;3;50;145986;8498;1257;10;1446
FR;5;2022-01-16;4728;666;3;0;5;150714;9164;1260;10;1451
FR;5;2022-01-17;2296;716;26;0;29;153010;9880;1286;10;1480
FR;5;2022-01-18;2429;869;30;0;40;155439;10749;1316;10;1520
FR;5;2022-01-19;18476;6419;74;2;142;173915;17168;1390;12;1662
FR;5;2022-01-20;1918;1069;24;0;33;175833;18237;1414;12;1695
FR;5;2022-01-21;3077;1370;47;1;59;178910;19607;1461;13;1754
FR;5;2022-01-22;10719;3452;33;1;42;189629;23059;1494;14;1796
FR;5;2022-01-23;2627;1413;5;0;8;192256;24472;1499;14;1804
FR;5;2022-01-24;1158;1341;19;0;23;193414;25813;1518;14;1827
FR;5;2022-01-25;1219;1548;19;2;29;194633;27361;1537;16;1856
FR;5;2022-01-26;10744;12011;50;1;89;205377;39372;1587;17;1945
FR;5;2022-01-27;1288;1689;10;0;17;206665;41061;1597;17;1962
FR;5;2022-01-28;1696;3345;16;0;19;208361;44406;1613;17;1981
FR;5;2022-01-29;6237;8040;68;0;96;214598;52446;1681;17;2077
FR;5;2022-01-30;1509;2950;5;0;18;216107;55396;1686;17;2095
FR;5;2022-01-31;586;1772;23;0;24;216693;57168;1709;17;2119
FR;5;2022-02-01;706;1701;10;0;15;217399;58869;1719;17;2134
FR;5;2022-02-02;6947;15650;52;0;94;224346;74519;1771;17;2228
FR;5;2022-02-03;485;1688;13;0;11;224831;76207;1784;17;2239
FR;5;2022-02-04;937;3001;19;0;31;225768;79208;1803;17;2270
FR;5;2022-02-05;3529;8914;23;0;37;229297;88122;1826;17;2307
FR;5;2022-02-06;735;2397;9;0;18;230032;90519;1835;17;2325
FR;5;2022-02-07;877;1595;22;0;24;230909;92114;1857;17;2349
FR;5;2022-02-08;718;1283;18;0;19;231627;93397;1875;17;2368
FR;5;2022-02-09;4532;12874;44;0;76;236159;106271;1919;17;2444
FR;5;2022-02-10;642;1056;13;0;14;236801;107327;1932;17;2458
FR;5;2022-02-11;792;2026;16;0;20;237593;109353;1948;17;2478
FR;5;2022-02-12;2282;6809;32;0;52;239875;116162;1980;17;2530
FR;5;2022-02-13;462;1539;8;0;8;240337;117701;1988;17;2538
FR;5;2022-02-14;674;1287;10;0;13;241011;118988;1998;17;2551
FR;5;2022-02-15;481;883;8;0;13;241492;119871;2006;17;2564
FR;5;2022-02-16;2966;9118;41;1;58;244458;128989;2047;18;2622
FR;5;2022-02-17;434;803;6;0;7;244892;129792;2053;18;2629
FR;5;2022-02-18;647;1407;13;0;17;245539;131199;2066;18;2646
FR;5;2022-02-19;1365;4313;16;0;28;246904;135512;2082;18;2674
FR;5;2022-02-20;244;879;6;0;8;247148;136391;2088;18;2682
FR;5;2022-02-21;218;605;2;0;4;247366;136996;2090;18;2686
FR;5;2022-02-22;258;544;17;0;17;247624;137540;2107;18;2703
FR;5;2022-02-23;1903;6917;22;1;41;249527;144457;2129;19;2744
FR;5;2022-02-24;181;370;5;1;5;249708;144827;2134;20;2749
FR;5;2022-02-25;333;945;13;0;12;250041;145772;2147;20;2761
FR;5;2022-02-26;964;3064;10;0;14;251005;148836;2157;20;2775
FR;5;2022-02-27;145;506;0;0;3;251150;149342;2157;20;2778
FR;5;2022-02-28;159;366;1;0;1;251309;149708;2158;20;2779
FR;5;2022-03-01;122;278;6;0;7;251431;149986;2164;20;2786
FR;5;2022-03-02;1227;4138;28;4;39;252658;154124;2192;24;2825
FR;5;2022-03-03;117;246;6;0;7;252775;154370;2198;24;2832
FR;5;2022-03-04;192;481;12;0;12;252967;154851;2210;24;2844
FR;5;2022-03-05;668;1989;8;0;16;253635;156840;2218;24;2860
FR;5;2022-03-06;107;260;0;0;1;253742;157100;2218;24;2861
FR;5;2022-03-07;69;228;2;0;2;253811;157328;2220;24;2863
FR;5;2022-03-08;45;124;7;1;7;253856;157452;2227;25;2870
FR;5;2022-03-09;884;3074;23;0;37;254740;160526;2250;25;2907
FR;5;2022-03-10;79;194;6;0;9;254819;160720;2256;25;2916
FR;6;2020-12-27;0;0;0;0;0;0;0;0;0;0
FR;6;2020-12-28;0;0;0;0;0;0;0;0;0;0
FR;6;2020-12-29;0;0;0;0;0;0;0;0;0;0
FR;6;2020-12-30;0;0;0;0;0;0;0;0;0;0
FR;6;2020-12-31;0;0;0;0;0;0;0;0;0;0
FR;6;2021-01-01;0;0;0;0;0;0;0;0;0;0
FR;6;2021-01-02;0;0;0;0;0;0;0;0;0;0
FR;6;2021-01-03;0;0;0;0;0;0;0;0;0;0
FR;6;2021-01-04;0;0;0;0;0;0;0;0;0;0
FR;6;2021-01-05;0;0;0;0;0;0;0;0;0;0
FR;6;2021-01-06;0;0;0;0;0;0;0;0;0;0
FR;6;2021-01-07;0;0;0;0;0;0;0;0;0;0
FR;6;2021-01-08;0;0;0;0;0;0;0;0;0;0
FR;6;2021-01-09;0;0;0;0;0;0;0;0;0;0
FR;6;2021-01-10;0;0;0;0;0;0;0;0;0;0
FR;6;2021-01-11;0;0;0;0;0;0;0;0;0;0
FR;6;2021-01-12;0;0;0;0;0;0;0;0;0;0
FR;6;2021-01-13;0;0;0;0;0;0;0;0;0;0
FR;6;2021-01-14;0;0;0;0;0;0;0;0;0;0
FR;6;2021-01-15;0;0;0;0;0;0;0;0;0;0
FR;6;2021-01-16;0;0;0;0;0;0;0;0;0;0
FR;6;2021-01-17;0;0;0;0;0;0;0;0;0;0
FR;6;2021-01-18;0;0;0;0;0;0;0;0;0;0
FR;6;2021-01-19;0;0;0;0;0;0;0;0;0;0
FR;6;2021-01-20;0;0;0;0;0;0;0;0;0;0
FR;6;2021-01-21;0;0;0;0;0;0;0;0;0;0
FR;6;2021-01-22;0;0;0;0;0;0;0;0;0;0
FR;6;2021-01-23;0;0;0;0;0;0;0;0;0;0
FR;6;2021-01-24;0;0;0;0;0;0;0;0;0;0
FR;6;2021-01-25;0;0;0;0;0;0;0;0;0;0
FR;6;2021-01-26;0;0;0;0;0;0;0;0;0;0
FR;6;2021-01-27;0;0;0;0;0;0;0;0;0;0
FR;6;2021-01-28;0;0;0;0;0;0;0;0;0;0
FR;6;2021-01-29;0;0;0;0;0;0;0;0;0;0
FR;6;2021-01-30;0;0;0;0;0;0;0;0;0;0
FR;6;2021-01-31;0;0;0;0;0;0;0;0;0;0
FR;6;2021-02-01;0;0;0;0;0;0;0;0;0;0
FR;6;2021-02-02;0;0;0;0;0;0;0;0;0;0
FR;6;2021-02-03;0;0;0;0;0;0;0;0;0;0
FR;6;2021-02-04;0;0;0;0;0;0;0;0;0;0
FR;6;2021-02-05;0;0;0;0;0;0;0;0;0;0
FR;6;2021-02-06;0;0;0;0;0;0;0;0;0;0
FR;6;2021-02-07;0;0;0;0;0;0;0;0;0;0
FR;6;2021-02-08;0;0;0;0;0;0;0;0;0;0
FR;6;2021-02-09;0;0;0;0;0;0;0;0;0;0
FR;6;2021-02-10;0;0;0;0;0;0;0;0;0;0
FR;6;2021-02-11;0;0;0;0;0;0;0;0;0;0
FR;6;2021-02-12;0;0;0;0;0;0;0;0;0;0
FR;6;2021-02-13;0;0;0;0;0;0;0;0;0;0
FR;6;2021-02-14;0;0;0;0;0;0;0;0;0;0
FR;6;2021-02-15;0;0;0;0;0;0;0;0;0;0
FR;6;2021-02-16;0;0;0;0;0;0;0;0;0;0
FR;6;2021-02-17;0;0;0;0;0;0;0;0;0;0
FR;6;2021-02-18;0;0;0;0;0;0;0;0;0;0
FR;6;2021-02-19;0;0;0;0;0;0;0;0;0;0
FR;6;2021-02-20;0;0;0;0;0;0;0;0;0;0
FR;6;2021-02-21;0;0;0;0;0;0;0;0;0;0
FR;6;2021-02-22;0;0;0;0;0;0;0;0;0;0
FR;6;2021-02-23;0;0;0;0;0;0;0;0;0;0
FR;6;2021-02-24;0;0;0;0;0;0;0;0;0;0
FR;6;2021-02-25;0;0;0;0;0;0;0;0;0;0
FR;6;2021-02-26;0;0;0;0;0;0;0;0;0;0
FR;6;2021-02-27;0;0;0;0;0;0;0;0;0;0
FR;6;2021-02-28;0;0;0;0;0;0;0;0;0;0
FR;6;2021-03-01;0;0;0;0;0;0;0;0;0;0
FR;6;2021-03-02;0;0;0;0;0;0;0;0;0;0
FR;6;2021-03-03;0;0;0;0;0;0;0;0;0;0
FR;6;2021-03-04;0;0;0;0;0;0;0;0;0;0
FR;6;2021-03-05;0;0;0;0;0;0;0;0;0;0
FR;6;2021-03-06;0;0;0;0;0;0;0;0;0;0
FR;6;2021-03-07;0;0;0;0;0;0;0;0;0;0
FR;6;2021-03-08;0;0;0;0;0;0;0;0;0;0
FR;6;2021-03-09;0;0;0;0;0;0;0;0;0;0
FR;6;2021-03-10;0;0;0;0;0;0;0;0;0;0
FR;6;2021-03-11;0;0;0;0;0;0;0;0;0;0
FR;6;2021-03-12;0;0;0;0;0;0;0;0;0;0
FR;6;2021-03-13;0;0;0;0;0;0;0;0;0;0
FR;6;2021-03-14;0;0;0;0;0;0;0;0;0;0
FR;6;2021-03-15;0;0;0;0;0;0;0;0;0;0
FR;6;2021-03-16;0;0;0;0;0;0;0;0;0;0
FR;6;2021-03-17;0;0;0;0;0;0;0;0;0;0
FR;6;2021-03-18;0;0;0;0;0;0;0;0;0;0
FR;6;2021-03-19;0;0;0;0;0;0;0;0;0;0
FR;6;2021-03-20;0;0;0;0;0;0;0;0;0;0
FR;6;2021-03-21;0;0;0;0;0;0;0;0;0;0
FR;6;2021-03-22;0;0;0;0;0;0;0;0;0;0
FR;6;2021-03-23;0;0;0;0;0;0;0;0;0;0
FR;6;2021-03-24;0;0;0;0;0;0;0;0;0;0
FR;6;2021-03-25;0;0;0;0;0;0;0;0;0;0
FR;6;2021-03-26;0;0;0;0;0;0;0;0;0;0
FR;6;2021-03-27;0;0;0;0;0;0;0;0;0;0
FR;6;2021-03-28;0;0;0;0;0;0;0;0;0;0
FR;6;2021-03-29;0;0;0;0;0;0;0;0;0;0
FR;6;2021-03-30;0;0;0;0;0;0;0;0;0;0
FR;6;2021-03-31;0;0;0;0;0;0;0;0;0;0
FR;6;2021-04-01;0;0;0;0;0;0;0;0;0;0
FR;6;2021-04-02;0;0;0;0;0;0;0;0;0;0
FR;6;2021-04-03;0;0;0;0;0;0;0;0;0;0
FR;6;2021-04-04;0;0;0;0;0;0;0;0;0;0
FR;6;2021-04-05;0;0;0;0;0;0;0;0;0;0
FR;6;2021-04-06;0;0;0;0;0;0;0;0;0;0
FR;6;2021-04-07;0;0;0;0;0;0;0;0;0;0
FR;6;2021-04-08;0;0;0;0;0;0;0;0;0;0
FR;6;2021-04-09;0;0;0;0;0;0;0;0;0;0
FR;6;2021-04-10;0;0;0;0;0;0;0;0;0;0
FR;6;2021-04-11;0;0;0;0;0;0;0;0;0;0
FR;6;2021-04-12;0;0;0;0;0;0;0;0;0;0
FR;6;2021-04-13;0;0;0;0;0;0;0;0;0;0
FR;6;2021-04-14;0;0;0;0;0;0;0;0;0;0
FR;6;2021-04-15;0;0;0;0;0;0;0;0;0;0
FR;6;2021-04-16;0;0;0;0;0;0;0;0;0;0
FR;6;2021-04-17;0;0;0;0;0;0;0;0;0;0
FR;6;2021-04-18;0;0;0;0;0;0;0;0;0;0
FR;6;2021-04-19;0;0;0;0;0;0;0;0;0;0
FR;6;2021-04-20;0;0;0;0;0;0;0;0;0;0
FR;6;2021-04-21;0;0;0;0;0;0;0;0;0;0
FR;6;2021-04-22;0;0;0;0;0;0;0;0;0;0
FR;6;2021-04-23;0;0;0;0;0;0;0;0;0;0
FR;6;2021-04-24;0;0;0;0;0;0;0;0;0;0
FR;6;2021-04-25;0;0;0;0;0;0;0;0;0;0
FR;6;2021-04-26;0;0;0;0;0;0;0;0;0;0
FR;6;2021-04-27;0;0;0;0;0;0;0;0;0;0
FR;6;2021-04-28;0;0;0;0;0;0;0;0;0;0
FR;6;2021-04-29;0;0;0;0;0;0;0;0;0;0
FR;6;2021-04-30;0;0;0;0;0;0;0;0;0;0
FR;6;2021-05-01;0;0;0;0;0;0;0;0;0;0
FR;6;2021-05-02;0;0;0;0;0;0;0;0;0;0
FR;6;2021-05-03;0;0;0;0;0;0;0;0;0;0
FR;6;2021-05-04;0;0;0;0;0;0;0;0;0;0
FR;6;2021-05-05;0;0;0;0;0;0;0;0;0;0
FR;6;2021-05-06;0;0;0;0;0;0;0;0;0;0
FR;6;2021-05-07;0;0;0;0;0;0;0;0;0;0
FR;6;2021-05-08;0;0;0;0;0;0;0;0;0;0
FR;6;2021-05-09;0;0;0;0;0;0;0;0;0;0
FR;6;2021-05-10;0;0;0;0;0;0;0;0;0;0
FR;6;2021-05-11;0;0;0;0;0;0;0;0;0;0
FR;6;2021-05-12;0;0;0;0;0;0;0;0;0;0
FR;6;2021-05-13;0;0;0;0;0;0;0;0;0;0
FR;6;2021-05-14;0;0;0;0;0;0;0;0;0;0
FR;6;2021-05-15;0;0;0;0;0;0;0;0;0;0
FR;6;2021-05-16;0;0;0;0;0;0;0;0;0;0
FR;6;2021-05-17;0;0;0;0;0;0;0;0;0;0
FR;6;2021-05-18;0;0;0;0;0;0;0;0;0;0
FR;6;2021-05-19;0;0;0;0;0;0;0;0;0;0
FR;6;2021-05-20;0;0;0;0;0;0;0;0;0;0
FR;6;2021-05-21;0;0;0;0;0;0;0;0;0;0
FR;6;2021-05-22;0;0;0;0;0;0;0;0;0;0
FR;6;2021-05-23;0;0;0;0;0;0;0;0;0;0
FR;6;2021-05-24;0;0;0;0;0;0;0;0;0;0
FR;6;2021-05-25;0;0;0;0;0;0;0;0;0;0
FR;6;2021-05-26;0;0;0;0;0;0;0;0;0;0
FR;6;2021-05-27;0;0;0;0;0;0;0;0;0;0
FR;6;2021-05-28;0;0;0;0;0;0;0;0;0;0
FR;6;2021-05-29;0;0;0;0;0;0;0;0;0;0
FR;6;2021-05-30;0;0;0;0;0;0;0;0;0;0
FR;6;2021-05-31;0;0;0;0;0;0;0;0;0;0
FR;6;2021-06-01;0;0;0;0;0;0;0;0;0;0
FR;6;2021-06-02;0;0;0;0;0;0;0;0;0;0
FR;6;2021-06-03;0;0;0;0;0;0;0;0;0;0
FR;6;2021-06-04;0;0;0;0;0;0;0;0;0;0
FR;6;2021-06-05;0;0;0;0;0;0;0;0;0;0
FR;6;2021-06-06;0;0;0;0;0;0;0;0;0;0
FR;6;2021-06-07;0;0;0;0;0;0;0;0;0;0
FR;6;2021-06-08;0;0;0;0;0;0;0;0;0;0
FR;6;2021-06-09;0;0;0;0;0;0;0;0;0;0
FR;6;2021-06-10;0;0;0;0;0;0;0;0;0;0
FR;6;2021-06-11;0;0;0;0;0;0;0;0;0;0
FR;6;2021-06-12;0;0;0;0;0;0;0;0;0;0
FR;6;2021-06-13;0;0;0;0;0;0;0;0;0;0
FR;6;2021-06-14;0;0;0;0;0;0;0;0;0;0
FR;6;2021-06-15;0;0;0;0;0;0;0;0;0;0
FR;6;2021-06-16;0;0;0;0;0;0;0;0;0;0
FR;6;2021-06-17;0;0;0;0;0;0;0;0;0;0
FR;6;2021-06-18;0;0;0;0;0;0;0;0;0;0
FR;6;2021-06-19;0;0;0;0;0;0;0;0;0;0
FR;6;2021-06-20;0;0;0;0;0;0;0;0;0;0
FR;6;2021-06-21;0;0;0;0;0;0;0;0;0;0
FR;6;2021-06-22;0;0;0;0;0;0;0;0;0;0
FR;6;2021-06-23;0;0;0;0;0;0;0;0;0;0
FR;6;2021-06-24;0;0;0;0;0;0;0;0;0;0
FR;6;2021-06-25;0;0;0;0;0;0;0;0;0;0
FR;6;2021-06-26;0;0;0;0;0;0;0;0;0;0
FR;6;2021-06-27;0;0;0;0;0;0;0;0;0;0
FR;6;2021-06-28;0;0;0;0;0;0;0;0;0;0
FR;6;2021-06-29;0;0;0;0;0;0;0;0;0;0
FR;6;2021-06-30;0;0;0;0;0;0;0;0;0;0
FR;6;2021-07-01;0;0;0;0;0;0;0;0;0;0
FR;6;2021-07-02;0;0;0;0;0;0;0;0;0;0
FR;6;2021-07-03;0;0;0;0;0;0;0;0;0;0
FR;6;2021-07-04;0;0;0;0;0;0;0;0;0;0
FR;6;2021-07-05;0;0;0;0;0;0;0;0;0;0
FR;6;2021-07-06;0;0;0;0;0;0;0;0;0;0
FR;6;2021-07-07;0;0;0;0;0;0;0;0;0;0
FR;6;2021-07-08;0;0;0;0;0;0;0;0;0;0
FR;6;2021-07-09;0;0;0;0;0;0;0;0;0;0
FR;6;2021-07-10;0;0;0;0;0;0;0;0;0;0
FR;6;2021-07-11;0;0;0;0;0;0;0;0;0;0
FR;6;2021-07-12;0;0;0;0;0;0;0;0;0;0
FR;6;2021-07-13;0;0;0;0;0;0;0;0;0;0
FR;6;2021-07-14;0;0;0;0;0;0;0;0;0;0
FR;6;2021-07-15;0;0;0;0;0;0;0;0;0;0
FR;6;2021-07-16;0;0;0;0;0;0;0;0;0;0
FR;6;2021-07-17;0;0;0;0;0;0;0;0;0;0
FR;6;2021-07-18;0;0;0;0;0;0;0;0;0;0
FR;6;2021-07-19;0;0;0;0;0;0;0;0;0;0
FR;6;2021-07-20;0;0;0;0;0;0;0;0;0;0
FR;6;2021-07-21;0;0;0;0;0;0;0;0;0;0
FR;6;2021-07-22;0;0;0;0;0;0;0;0;0;0
FR;6;2021-07-23;0;0;0;0;0;0;0;0;0;0
FR;6;2021-07-24;0;0;0;0;0;0;0;0;0;0
FR;6;2021-07-25;0;0;0;0;0;0;0;0;0;0
FR;6;2021-07-26;0;0;0;0;0;0;0;0;0;0
FR;6;2021-07-27;0;0;0;0;0;0;0;0;0;0
FR;6;2021-07-28;0;0;0;0;0;0;0;0;0;0
FR;6;2021-07-29;0;0;0;0;0;0;0;0;0;0
FR;6;2021-07-30;0;0;0;0;0;0;0;0;0;0
FR;6;2021-07-31;0;0;0;0;0;0;0;0;0;0
FR;6;2021-08-01;0;0;0;0;0;0;0;0;0;0
FR;6;2021-08-02;0;0;0;0;0;0;0;0;0;0
FR;6;2021-08-03;0;0;0;0;0;0;0;0;0;0
FR;6;2021-08-04;0;0;0;0;0;0;0;0;0;0
FR;6;2021-08-05;0;0;0;0;0;0;0;0;0;0
FR;6;2021-08-06;0;0;0;0;0;0;0;0;0;0
FR;6;2021-08-07;0;0;0;0;0;0;0;0;0;0
FR;6;2021-08-08;0;0;0;0;0;0;0;0;0;0
FR;6;2021-08-09;0;0;0;0;0;0;0;0;0;0
FR;6;2021-08-10;0;0;0;0;0;0;0;0;0;0
FR;6;2021-08-11;0;0;0;0;0;0;0;0;0;0
FR;6;2021-08-12;0;0;0;0;0;0;0;0;0;0
FR;6;2021-08-13;0;0;0;0;0;0;0;0;0;0
FR;6;2021-08-14;0;0;0;0;0;0;0;0;0;0
FR;6;2021-08-15;0;0;0;0;0;0;0;0;0;0
FR;6;2021-08-16;0;0;0;0;0;0;0;0;0;0
FR;6;2021-08-17;0;0;0;0;0;0;0;0;0;0
FR;6;2021-08-18;0;0;0;0;0;0;0;0;0;0
FR;6;2021-08-19;0;0;0;0;0;0;0;0;0;0
FR;6;2021-08-20;0;0;0;0;0;0;0;0;0;0
FR;6;2021-08-21;0;0;0;0;0;0;0;0;0;0
FR;6;2021-08-22;0;0;0;0;0;0;0;0;0;0
FR;6;2021-08-23;0;0;0;0;0;0;0;0;0;0
FR;6;2021-08-24;0;0;0;0;0;0;0;0;0;0
FR;6;2021-08-25;0;0;0;0;0;0;0;0;0;0
FR;6;2021-08-26;0;0;0;0;0;0;0;0;0;0
FR;6;2021-08-27;0;0;0;0;0;0;0;0;0;0
FR;6;2021-08-28;0;0;0;0;0;0;0;0;0;0
FR;6;2021-08-29;0;0;0;0;0;0;0;0;0;0
FR;6;2021-08-30;0;0;0;0;0;0;0;0;0;0
FR;6;2021-08-31;0;0;0;0;0;0;0;0;0;0
FR;6;2021-09-01;0;0;0;0;0;0;0;0;0;0
FR;6;2021-09-02;0;0;0;0;0;0;0;0;0;0
FR;6;2021-09-03;0;0;0;0;0;0;0;0;0;0
FR;6;2021-09-04;0;0;0;0;0;0;0;0;0;0
FR;6;2021-09-05;0;0;0;0;0;0;0;0;0;0
FR;6;2021-09-06;0;0;0;0;0;0;0;0;0;0
FR;6;2021-09-07;0;0;0;0;0;0;0;0;0;0
FR;6;2021-09-08;0;0;0;0;0;0;0;0;0;0
FR;6;2021-09-09;0;0;0;0;0;0;0;0;0;0
FR;6;2021-09-10;0;0;0;0;0;0;0;0;0;0
FR;6;2021-09-11;0;0;0;0;0;0;0;0;0;0
FR;6;2021-09-12;0;0;0;0;0;0;0;0;0;0
FR;6;2021-09-13;0;0;0;0;0;0;0;0;0;0
FR;6;2021-09-14;0;0;0;0;0;0;0;0;0;0
FR;6;2021-09-15;0;0;0;0;0;0;0;0;0;0
FR;6;2021-09-16;0;0;0;0;0;0;0;0;0;0
FR;6;2021-09-17;0;0;0;0;0;0;0;0;0;0
FR;6;2021-09-18;0;0;0;0;0;0;0;0;0;0
FR;6;2021-09-19;0;0;0;0;0;0;0;0;0;0
FR;6;2021-09-20;0;0;0;0;0;0;0;0;0;0
FR;6;2021-09-21;0;0;0;0;0;0;0;0;0;0
FR;6;2021-09-22;0;0;0;0;0;0;0;0;0;0
FR;6;2021-09-23;0;0;0;0;0;0;0;0;0;0
FR;6;2021-09-24;0;0;0;0;0;0;0;0;0;0
FR;6;2021-09-25;0;0;0;0;0;0;0;0;0;0
FR;6;2021-09-26;0;0;0;0;0;0;0;0;0;0
FR;6;2021-09-27;0;0;0;0;0;0;0;0;0;0
FR;6;2021-09-28;0;0;0;0;0;0;0;0;0;0
FR;6;2021-09-29;0;0;0;0;0;0;0;0;0;0
FR;6;2021-09-30;0;0;0;0;0;0;0;0;0;0
FR;6;2021-10-01;0;0;0;0;0;0;0;0;0;0
FR;6;2021-10-02;0;0;0;0;0;0;0;0;0;0
FR;6;2021-10-03;0;0;0;0;0;0;0;0;0;0
FR;6;2021-10-04;0;0;0;0;0;0;0;0;0;0
FR;6;2021-10-05;0;0;0;0;0;0;0;0;0;0
FR;6;2021-10-06;0;0;0;0;0;0;0;0;0;0
FR;6;2021-10-07;0;0;0;0;0;0;0;0;0;0
FR;6;2021-10-08;0;0;0;0;0;0;0;0;0;0
FR;6;2021-10-09;0;0;0;0;0;0;0;0;0;0
FR;6;2021-10-10;0;0;0;0;0;0;0;0;0;0
FR;6;2021-10-11;0;0;0;0;0;0;0;0;0;0
FR;6;2021-10-12;0;0;0;0;0;0;0;0;0;0
FR;6;2021-10-13;0;0;0;0;0;0;0;0;0;0
FR;6;2021-10-14;0;0;0;0;0;0;0;0;0;0
FR;6;2021-10-15;0;0;0;0;0;0;0;0;0;0
FR;6;2021-10-16;0;0;0;0;0;0;0;0;0;0
FR;6;2021-10-17;0;0;0;0;0;0;0;0;0;0
FR;6;2021-10-18;0;0;0;0;0;0;0;0;0;0
FR;6;2021-10-19;0;0;0;0;0;0;0;0;0;0
FR;6;2021-10-20;0;0;0;0;0;0;0;0;0;0
FR;6;2021-10-21;0;0;0;0;0;0;0;0;0;0
FR;6;2021-10-22;0;0;0;0;0;0;0;0;0;0
FR;6;2021-10-23;0;0;0;0;0;0;0;0;0;0
FR;6;2021-10-24;0;0;0;0;0;0;0;0;0;0
FR;6;2021-10-25;0;0;0;0;0;0;0;0;0;0
FR;6;2021-10-26;0;0;0;0;0;0;0;0;0;0
FR;6;2021-10-27;0;0;0;0;0;0;0;0;0;0
FR;6;2021-10-28;0;0;0;0;0;0;0;0;0;0
FR;6;2021-10-29;0;0;0;0;0;0;0;0;0;0
FR;6;2021-10-30;0;0;0;0;0;0;0;0;0;0
FR;6;2021-10-31;0;0;0;0;0;0;0;0;0;0
FR;6;2021-11-01;0;0;0;0;0;0;0;0;0;0
FR;6;2021-11-02;0;0;0;0;0;0;0;0;0;0
FR;6;2021-11-03;0;0;0;0;0;0;0;0;0;0
FR;6;2021-11-04;0;0;0;0;0;0;0;0;0;0
FR;6;2021-11-05;0;0;0;0;0;0;0;0;0;0
FR;6;2021-11-06;0;0;0;0;0;0;0;0;0;0
FR;6;2021-11-07;0;0;0;0;0;0;0;0;0;0
FR;6;2021-11-08;0;0;0;0;0;0;0;0;0;0
FR;6;2021-11-09;0;0;0;0;0;0;0;0;0;0
FR;6;2021-11-10;0;0;0;0;0;0;0;0;0;0
FR;6;2021-11-11;0;0;0;0;0;0;0;0;0;0
FR;6;2021-11-12;0;0;0;0;0;0;0;0;0;0
FR;6;2021-11-13;0;0;0;0;0;0;0;0;0;0
FR;6;2021-11-14;0;0;0;0;0;0;0;0;0;0
FR;6;2021-11-15;0;0;0;0;0;0;0;0;0;0
FR;6;2021-11-16;0;0;0;0;0;0;0;0;0;0
FR;6;2021-11-17;0;0;0;0;0;0;0;0;0;0
FR;6;2021-11-18;0;0;0;0;0;0;0;0;0;0
FR;6;2021-11-19;0;0;0;0;0;0;0;0;0;0
FR;6;2021-11-20;0;0;0;0;0;0;0;0;0;0
FR;6;2021-11-21;0;0;0;0;0;0;0;0;0;0
FR;6;2021-11-22;0;0;0;0;0;0;0;0;0;0
FR;6;2021-11-23;0;0;0;0;0;0;0;0;0;0
FR;6;2021-11-24;0;0;0;0;0;0;0;0;0;0
FR;6;2021-11-25;0;0;0;0;0;0;0;0;0;0
FR;6;2021-11-26;0;0;0;0;0;0;0;0;0;0
FR;6;2021-11-27;0;0;0;0;0;0;0;0;0;0
FR;6;2021-11-28;0;0;0;0;0;0;0;0;0;0
FR;6;2021-11-29;0;0;0;0;0;0;0;0;0;0
FR;6;2021-11-30;0;0;0;0;0;0;0;0;0;0
FR;6;2021-12-01;0;0;0;0;0;0;0;0;0;0
FR;6;2021-12-02;0;0;0;0;0;0;0;0;0;0
FR;6;2021-12-03;0;0;0;0;0;0;0;0;0;0
FR;6;2021-12-04;0;0;0;0;0;0;0;0;0;0
FR;6;2021-12-05;0;0;0;0;0;0;0;0;0;0
FR;6;2021-12-06;0;0;0;0;0;0;0;0;0;0
FR;6;2021-12-07;0;0;0;0;0;0;0;0;0;0
FR;6;2021-12-08;0;0;0;0;0;0;0;0;0;0
FR;6;2021-12-09;0;0;0;0;0;0;0;0;0;0
FR;6;2021-12-10;0;0;0;0;0;0;0;0;0;0
FR;6;2021-12-11;0;0;0;0;0;0;0;0;0;0
FR;6;2021-12-12;0;0;0;0;0;0;0;0;0;0
FR;6;2021-12-13;0;0;0;0;0;0;0;0;0;0
FR;6;2021-12-14;0;0;0;0;0;0;0;0;0;0
FR;6;2021-12-15;0;0;0;0;0;0;0;0;0;0
FR;6;2021-12-16;0;0;0;0;0;0;0;0;0;0
FR;6;2021-12-17;0;0;0;0;0;0;0;0;0;0
FR;6;2021-12-18;0;0;0;0;0;0;0;0;0;0
FR;6;2021-12-19;0;0;0;0;0;0;0;0;0;0
FR;6;2021-12-20;0;0;0;0;0;0;0;0;0;0
FR;6;2021-12-21;0;0;0;0;0;0;0;0;0;0
FR;6;2021-12-22;0;0;0;0;0;0;0;0;0;0
FR;6;2021-12-23;0;0;0;0;0;0;0;0;0;0
FR;6;2021-12-24;0;0;0;0;0;0;0;0;0;0
FR;6;2021-12-25;0;0;0;0;0;0;0;0;0;0
FR;6;2021-12-26;0;0;0;0;0;0;0;0;0;0
FR;6;2021-12-27;0;0;0;0;0;0;0;0;0;0
FR;6;2021-12-28;0;0;0;0;0;0;0;0;0;0
FR;6;2021-12-29;0;0;0;0;0;0;0;0;0;0
FR;6;2021-12-30;0;0;0;0;0;0;0;0;0;0
FR;6;2021-12-31;0;0;0;0;0;0;0;0;0;0
FR;6;2022-01-01;0;0;0;0;0;0;0;0;0;0
FR;6;2022-01-02;0;0;0;0;0;0;0;0;0;0
FR;6;2022-01-03;0;0;0;0;0;0;0;0;0;0
FR;6;2022-01-04;0;0;0;0;0;0;0;0;0;0
FR;6;2022-01-05;0;0;0;0;0;0;0;0;0;0
FR;6;2022-01-06;0;0;0;0;0;0;0;0;0;0
FR;6;2022-01-07;0;0;0;0;0;0;0;0;0;0
FR;6;2022-01-08;0;0;0;0;0;0;0;0;0;0
FR;6;2022-01-09;0;0;0;0;0;0;0;0;0;0
FR;6;2022-01-10;0;0;0;0;0;0;0;0;0;0
FR;6;2022-01-11;0;0;0;0;0;0;0;0;0;0
FR;6;2022-01-12;0;0;0;0;0;0;0;0;0;0
FR;6;2022-01-13;0;0;0;0;0;0;0;0;0;0
FR;6;2022-01-14;0;0;0;0;0;0;0;0;0;0
FR;6;2022-01-15;0;0;0;0;0;0;0;0;0;0
FR;6;2022-01-16;0;0;0;0;0;0;0;0;0;0
FR;6;2022-01-17;0;0;0;0;0;0;0;0;0;0
FR;6;2022-01-18;0;0;0;0;0;0;0;0;0;0
FR;6;2022-01-19;0;0;0;0;0;0;0;0;0;0
FR;6;2022-01-20;0;0;0;0;0;0;0;0;0;0
FR;6;2022-01-21;0;0;0;0;0;0;0;0;0;0
FR;6;2022-01-22;0;0;0;0;0;0;0;0;0;0
FR;6;2022-01-23;0;0;0;0;0;0;0;0;0;0
FR;6;2022-01-24;0;0;0;0;0;0;0;0;0;0
FR;6;2022-01-25;0;0;0;0;0;0;0;0;0;0
FR;6;2022-01-26;0;0;0;0;0;0;0;0;0;0
FR;6;2022-01-27;0;0;0;0;0;0;0;0;0;0
FR;6;2022-01-28;0;0;0;0;0;0;0;0;0;0
FR;6;2022-01-29;0;0;0;0;0;0;0;0;0;0
FR;6;2022-01-30;0;0;0;0;0;0;0;0;0;0
FR;6;2022-01-31;0;0;0;0;0;0;0;0;0;0
FR;6;2022-02-01;0;0;0;0;0;0;0;0;0;0
FR;6;2022-02-02;0;0;0;0;0;0;0;0;0;0
FR;6;2022-02-03;0;0;0;0;0;0;0;0;0;0
FR;6;2022-02-04;0;0;0;0;0;0;0;0;0;0
FR;6;2022-02-05;0;0;0;0;0;0;0;0;0;0
FR;6;2022-02-06;0;0;0;0;0;0;0;0;0;0
FR;6;2022-02-07;0;0;0;0;0;0;0;0;0;0
FR;6;2022-02-08;0;0;0;0;0;0;0;0;0;0
FR;6;2022-02-09;0;0;0;0;0;0;0;0;0;0
FR;6;2022-02-10;0;0;0;0;0;0;0;0;0;0
FR;6;2022-02-11;0;0;0;0;0;0;0;0;0;0
FR;6;2022-02-12;0;0;0;0;0;0;0;0;0;0
FR;6;2022-02-13;0;0;0;0;0;0;0;0;0;0
FR;6;2022-02-14;0;0;0;0;0;0;0;0;0;0
FR;6;2022-02-15;0;0;0;0;0;0;0;0;0;0
FR;6;2022-02-16;0;0;0;0;0;0;0;0;0;0
FR;6;2022-02-17;0;0;0;0;0;0;0;0;0;0
FR;6;2022-02-18;0;0;0;0;0;0;0;0;0;0
FR;6;2022-02-19;0;0;0;0;0;0;0;0;0;0
FR;6;2022-02-20;0;0;0;0;0;0;0;0;0;0
FR;6;2022-02-21;0;0;0;0;0;0;0;0;0;0
FR;6;2022-02-22;0;0;0;0;0;0;0;0;0;0
FR;6;2022-02-23;0;0;0;0;0;0;0;0;0;0
FR;6;2022-02-24;0;0;0;0;0;0;0;0;0;0
FR;6;2022-02-25;0;0;0;0;0;0;0;0;0;0
FR;6;2022-02-26;0;0;0;0;0;0;0;0;0;0
FR;6;2022-02-27;0;0;0;0;0;0;0;0;0;0
FR;6;2022-02-28;0;0;0;0;0;0;0;0;0;0
FR;6;2022-03-01;0;0;0;0;0;0;0;0;0;0
FR;6;2022-03-02;96;9;2;0;7;96;9;2;0;7
FR;6;2022-03-03;0;0;0;0;0;96;9;2;0;7
FR;6;2022-03-04;89;4;0;0;4;185;13;2;0;11
FR;6;2022-03-05;389;23;2;0;14;574;36;4;0;25
FR;6;2022-03-06;7;1;0;0;0;581;37;4;0;25
FR;6;2022-03-07;334;19;0;0;13;915;56;4;0;38
FR;6;2022-03-08;227;14;0;0;5;1142;70;4;0;43
FR;6;2022-03-09;517;30;2;0;22;1659;100;6;0;65
FR;6;2022-03-10;207;17;0;0;12;1866;117;6;0;77
FR;0;2020-12-27;587;0;0;0;0;587;0;0;0;0
FR;0;2020-12-28;642;0;0;0;0;1229;0;0;0;0
FR;0;2020-12-29;368;0;0;0;0;1597;0;0;0;0
FR;0;2020-12-30;431;0;0;0;0;2028;0;0;0;0
FR;0;2020-12-31;346;0;0;0;0;2374;0;0;0;0
FR;0;2021-01-01;1173;0;0;0;0;3547;0;0;0;0
FR;0;2021-01-02;348;1;0;0;0;3895;1;0;0;0
FR;0;2021-01-03;414;0;0;0;0;4309;1;0;0;0
FR;0;2021-01-04;2083;0;0;0;0;6392;1;0;0;0
FR;0;2021-01-05;6465;2;0;0;0;12857;3;0;0;0
FR;0;2021-01-06;12198;0;0;0;0;25055;3;0;0;0
FR;0;2021-01-07;29420;2;0;0;0;54475;5;0;0;0
FR;0;2021-01-08;37187;2;0;0;0;91662;7;0;0;0
FR;0;2021-01-09;11214;2;0;0;0;102876;9;0;0;0
FR;0;2021-01-10;6030;0;0;0;0;108906;9;0;0;0
FR;0;2021-01-11;39921;5;0;0;0;148827;14;0;0;0
FR;0;2021-01-12;62102;4;0;0;0;210929;18;0;0;0
FR;0;2021-01-13;65037;13;0;0;0;275966;31;0;0;0
FR;0;2021-01-14;83126;15;0;0;0;359092;46;0;0;0
FR;0;2021-01-15;68971;3;0;0;0;428063;49;0;0;0
FR;0;2021-01-16;20201;75;0;0;0;448264;124;0;0;0
FR;0;2021-01-17;11010;45;0;0;0;459274;169;0;0;0
FR;0;2021-01-18;85823;160;0;0;0;545097;329;0;0;0
FR;0;2021-01-19;130581;138;0;0;0;675678;467;0;0;0
FR;0;2021-01-20;137533;167;0;0;0;813211;634;0;0;0
FR;0;2021-01-21;158364;143;0;0;0;971575;777;0;0;0
FR;0;2021-01-22;121008;171;0;0;0;1092583;948;0;0;0
FR;0;2021-01-23;38454;56;0;0;0;1131037;1004;0;0;0
FR;0;2021-01-24;9755;45;0;0;0;1140792;1049;0;0;0
FR;0;2021-01-25;78218;1219;0;0;0;1219010;2268;0;0;0
FR;0;2021-01-26;100348;3129;1;0;0;1319358;5397;1;0;0
FR;0;2021-01-27;107219;5598;0;0;0;1426577;10995;1;0;0
FR;0;2021-01-28;124314;14340;0;0;0;1550891;25335;1;0;0
FR;0;2021-01-29;92150;17285;0;0;0;1643041;42620;1;0;0
FR;0;2021-01-30;29094;4217;0;0;0;1672135;46837;1;0;0
FR;0;2021-01-31;5218;1685;0;0;0;1677353;48522;1;0;0
FR;0;2021-02-01;53202;21113;0;0;0;1730555;69635;1;0;0
FR;0;2021-02-02;72262;34570;0;0;0;1802817;104205;1;0;0
FR;0;2021-02-03;72252;36940;0;0;0;1875069;141145;1;0;0
FR;0;2021-02-04;82025;50031;0;0;0;1957094;191176;1;0;0
FR;0;2021-02-05;68199;45274;0;0;0;2025293;236450;1;0;0
FR;0;2021-02-06;23143;10395;0;0;0;2048436;246845;1;0;0
FR;0;2021-02-07;5185;5051;0;0;0;2053621;251896;1;0;0
FR;0;2021-02-08;46808;45947;0;0;0;2100429;297843;1;0;0
FR;0;2021-02-09;65980;72379;0;0;0;2166409;370222;1;0;0
FR;0;2021-02-10;70889;76591;0;0;0;2237298;446813;1;0;0
FR;0;2021-02-11;87198;99023;0;0;0;2324496;545836;1;0;0
FR;0;2021-02-12;79248;74180;0;0;0;2403744;620016;1;0;0
FR;0;2021-02-13;22330;19470;0;0;0;2426074;639486;1;0;0
FR;0;2021-02-14;5057;7193;0;0;0;2431131;646679;1;0;0
FR;0;2021-02-15;38048;76403;0;0;0;2469179;723082;1;0;0
FR;0;2021-02-16;50340;100605;0;0;0;2519519;823687;1;0;0
FR;0;2021-02-17;50473;102877;1;0;0;2569992;926564;2;0;0
FR;0;2021-02-18;69701;118448;0;0;0;2639693;1045012;2;0;0
FR;0;2021-02-19;65027;90597;1;0;0;2704720;1135609;3;0;0
FR;0;2021-02-20;18571;28376;0;0;0;2723291;1163985;3;0;0
FR;0;2021-02-21;3305;6378;0;0;0;2726596;1170363;3;0;0
FR;0;2021-02-22;37447;73018;2;0;0;2764043;1243381;5;0;0
FR;0;2021-02-23;53741;83975;1;0;0;2817784;1327356;6;0;0
FR;0;2021-02-24;59947;81010;1;0;0;2877731;1408366;7;0;0
FR;0;2021-02-25;100523;91298;1;0;0;2978254;1499664;8;0;0
FR;0;2021-02-26;113398;70924;0;0;0;3091652;1570588;8;0;0
FR;0;2021-02-27;52083;21951;0;0;0;3143735;1592539;8;0;0
FR;0;2021-02-28;6188;4414;1;0;0;3149923;1596953;9;0;0
FR;0;2021-03-01;65847;52711;1;0;0;3215770;1649664;10;0;0
FR;0;2021-03-02;101322;66155;2;0;0;3317092;1715819;12;0;0
FR;0;2021-03-03;116388;65461;0;0;0;3433480;1781280;12;0;0
FR;0;2021-03-04;163516;68817;3;0;0;3596996;1850097;15;0;0
FR;0;2021-03-05;200840;63276;3;0;0;3797836;1913373;18;0;0
FR;0;2021-03-06;207923;17794;3;0;0;4005759;1931167;21;0;0
FR;0;2021-03-07;121254;5447;1;0;0;4127013;1936614;22;0;0
FR;0;2021-03-08;107091;50738;2;0;0;4234104;1987352;24;0;0
FR;0;2021-03-09;172366;56717;2;0;0;4406470;2044069;26;0;0
FR;0;2021-03-10;178848;57158;5;0;0;4585318;2101227;31;0;0
FR;0;2021-03-11;242718;63018;2;0;0;4828036;2164245;33;0;0
FR;0;2021-03-12;294702;53483;0;0;0;5122738;2217728;33;0;0
FR;0;2021-03-13;231326;15271;1;0;0;5354064;2232999;34;0;0
FR;0;2021-03-14;63314;3425;1;0;0;5417378;2236424;35;0;0
FR;0;2021-03-15;158458;32621;3;0;0;5575836;2269045;38;0;0
FR;0;2021-03-16;141532;39526;5;0;0;5717368;2308571;43;0;0
FR;0;2021-03-17;150405;38782;5;0;0;5867773;2347353;48;0;0
FR;0;2021-03-18;167774;44591;4;0;0;6035547;2391944;52;0;0
FR;0;2021-03-19;229967;37427;2;0;0;6265514;2429371;54;0;0
FR;0;2021-03-20;166627;11775;1;0;0;6432141;2441146;55;0;0
FR;0;2021-03-21;49883;2637;1;0;0;6482024;2443783;56;0;0
FR;0;2021-03-22;169904;34238;1;0;0;6651928;2478021;57;0;0
FR;0;2021-03-23;250288;42387;1;0;0;6902216;2520408;58;0;0
FR;0;2021-03-24;256837;43845;0;0;0;7159053;2564253;58;0;0
FR;0;2021-03-25;341713;44708;5;0;0;7500766;2608961;63;0;0
FR;0;2021-03-26;358716;41840;4;0;0;7859482;2650801;67;0;0
FR;0;2021-03-27;195210;16642;1;0;0;8054692;2667443;68;0;0
FR;0;2021-03-28;59295;3754;3;0;0;8113987;2671197;71;0;0
FR;0;2021-03-29;202898;54249;4;0;0;8316885;2725446;75;0;0
FR;0;2021-03-30;285324;69579;4;0;0;8602209;2795025;79;0;0
FR;0;2021-03-31;262908;72843;4;0;0;8865117;2867868;83;0;0
FR;0;2021-04-01;315403;87747;12;0;0;9180520;2955615;95;0;0
FR;0;2021-04-02;281253;92054;7;0;0;9461773;3047669;102;0;0
FR;0;2021-04-03;141022;61766;5;0;0;9602795;3109435;107;0;0
FR;0;2021-04-04;46380;18665;2;0;0;9649175;3128100;109;0;0
FR;0;2021-04-05;63467;10998;11;0;0;9712642;3139098;120;0;0
FR;0;2021-04-06;217059;107746;16;0;0;9929701;3246844;136;0;0
FR;0;2021-04-07;260143;115342;17;0;0;10189844;3362186;153;0;0
FR;0;2021-04-08;337633;121309;14;0;0;10527477;3483495;167;0;0
FR;0;2021-04-09;410034;116391;48;0;0;10937511;3599886;215;0;0
FR;0;2021-04-10;212548;82664;14;0;0;11150059;3682550;229;0;0
FR;0;2021-04-11;56040;34554;7;0;0;11206099;3717104;236;0;0
FR;0;2021-04-12;236906;115077;45;0;0;11443005;3832181;281;0;0
FR;0;2021-04-13;309348;144744;96;1;0;11752353;3976925;377;1;0
FR;0;2021-04-14;294379;139252;210;0;0;12046732;4116177;587;1;0
FR;0;2021-04-15;337079;147705;335;0;0;12383811;4263882;922;1;0
FR;0;2021-04-16;339177;145605;352;0;0;12722988;4409487;1274;1;0
FR;0;2021-04-17;188597;90159;108;0;0;12911585;4499646;1382;1;0
FR;0;2021-04-18;51558;35413;44;0;0;12963143;4535059;1426;1;0
FR;0;2021-04-19;205509;138196;453;0;0;13168652;4673255;1879;1;0
FR;0;2021-04-20;254260;170525;566;0;0;13422912;4843780;2445;1;0
FR;0;2021-04-21;253096;168706;829;0;0;13676008;5012486;3274;1;0
FR;0;2021-04-22;287345;188093;818;0;0;13963353;5200579;4092;1;0
FR;0;2021-04-23;297993;183089;741;0;0;14261346;5383668;4833;1;0
FR;0;2021-04-24;190389;111471;246;0;0;14451735;5495139;5079;1;0
FR;0;2021-04-25;69455;38822;51;0;0;14521190;5533961;5130;1;0
FR;0;2021-04-26;220819;155905;555;0;0;14742009;5689866;5685;1;0
FR;0;2021-04-27;284491;187255;936;0;0;15026500;5877121;6621;1;0
FR;0;2021-04-28;299374;183011;1416;1;1;15325874;6060132;8037;2;1
FR;0;2021-04-29;356985;195958;1274;0;0;15682859;6256090;9311;2;1
FR;0;2021-04-30;372098;184620;1116;1;0;16054957;6440710;10427;3;1
FR;0;2021-05-01;167596;52506;178;0;0;16222553;6493216;10605;3;1
FR;0;2021-05-02;91764;37783;82;0;0;16314317;6530999;10687;3;1
FR;0;2021-05-03;289076;169488;835;0;0;16603393;6700487;11522;3;1
FR;0;2021-05-04;315538;224157;1228;0;0;16918931;6924644;12750;3;1
FR;0;2021-05-05;327216;224323;1309;0;0;17246147;7148967;14059;3;1
FR;0;2021-05-06;379334;238952;1621;0;0;17625481;7387919;15680;3;1
FR;0;2021-05-07;372728;257025;1222;0;0;17998209;7644944;16902;3;1
FR;0;2021-05-08;222098;66820;294;0;0;18220307;7711764;17196;3;1
FR;0;2021-05-09;129634;46672;242;0;0;18349941;7758436;17438;3;1
FR;0;2021-05-10;313323;228703;1225;0;0;18663264;7987139;18663;3;1
FR;0;2021-05-11;403784;257807;1555;0;0;19067048;8244946;20218;3;1
FR;0;2021-05-12;433989;232980;1527;0;0;19501037;8477926;21745;3;1
FR;0;2021-05-13;338489;56884;428;0;0;19839526;8534810;22173;3;1
FR;0;2021-05-14;454224;167248;1111;0;0;20293750;8702058;23284;3;1
FR;0;2021-05-15;374886;93924;437;0;0;20668636;8795982;23721;3;1
FR;0;2021-05-16;202678;20779;166;0;0;20871314;8816761;23887;3;1
FR;0;2021-05-17;376036;148950;1541;0;0;21247350;8965711;25428;3;1
FR;0;2021-05-18;459755;152964;1979;0;0;21707105;9118675;27407;3;1
FR;0;2021-05-19;467244;145101;2443;0;0;22174349;9263776;29850;3;1
FR;0;2021-05-20;507391;160139;2323;0;0;22681740;9423915;32173;3;1
FR;0;2021-05-21;489552;174323;1977;0;0;23171292;9598238;34150;3;1
FR;0;2021-05-22;347076;79765;667;0;0;23518368;9678003;34817;3;1
FR;0;2021-05-23;161611;14415;246;0;0;23679979;9692418;35063;3;1
FR;0;2021-05-24;263098;33202;596;0;0;23943077;9725620;35659;3;1
FR;0;2021-05-25;400046;189084;2334;1;0;24343123;9914704;37993;4;1
FR;0;2021-05-26;413324;188026;2207;0;0;24756447;10102730;40200;4;1
FR;0;2021-05-27;449647;218416;2146;0;0;25206094;10321146;42346;4;1
FR;0;2021-05-28;429465;259327;1882;0;0;25635559;10580473;44228;4;1
FR;0;2021-05-29;298902;149267;582;0;0;25934461;10729740;44810;4;1
FR;0;2021-05-30;107045;32576;162;0;0;26041506;10762316;44972;4;1
FR;0;2021-05-31;357848;203493;1461;1;1;26399354;10965809;46433;5;2
FR;0;2021-06-01;431055;251392;1950;1;1;26830409;11217201;48383;6;3
FR;0;2021-06-02;419544;230651;1970;0;0;27249953;11447852;50353;6;3
FR;0;2021-06-03;464366;258474;1812;0;0;27714319;11706326;52165;6;3
FR;0;2021-06-04;455518;304675;1718;1;1;28169837;12011001;53883;7;4
FR;0;2021-06-05;304714;188914;650;0;0;28474551;12199915;54533;7;4
FR;0;2021-06-06;133226;49107;226;0;0;28607777;12249022;54759;7;4
FR;0;2021-06-07;338918;262132;1515;0;0;28946695;12511154;56274;7;4
FR;0;2021-06-08;393547;290941;1786;0;0;29340242;12802095;58060;7;4
FR;0;2021-06-09;384594;275647;1717;0;0;29724836;13077742;59777;7;4
FR;0;2021-06-10;404595;289188;1711;1;0;30129431;13366930;61488;8;4
FR;0;2021-06-11;386489;357260;1450;0;0;30515920;13724190;62938;8;4
FR;0;2021-06-12;283184;211260;486;0;0;30799104;13935450;63424;8;4
FR;0;2021-06-13;104806;74000;201;0;0;30903910;14009450;63625;8;4
FR;0;2021-06-14;240761;355772;1419;1;0;31144671;14365222;65044;9;4
FR;0;2021-06-15;307926;385758;1556;1;0;31452597;14750980;66600;10;4
FR;0;2021-06-16;313850;357609;1408;1;0;31766447;15108589;68008;11;4
FR;0;2021-06-17;317690;372070;1418;1;0;32084137;15480659;69426;12;4
FR;0;2021-06-18;321731;442339;1324;1;0;32405868;15922998;70750;13;4
FR;0;2021-06-19;224290;273729;445;0;0;32630158;16196727;71195;13;4
FR;0;2021-06-20;74350;102567;126;0;0;32704508;16299294;71321;13;4
FR;0;2021-06-21;195565;401929;1022;1;1;32900073;16701223;72343;14;5
FR;0;2021-06-22;222997;467223;1257;10;2;33123070;17168446;73600;24;7
FR;0;2021-06-23;233883;439735;1192;1;1;33356953;17608181;74792;25;8
FR;0;2021-06-24;241698;409319;1339;0;0;33598651;18017500;76131;25;8
FR;0;2021-06-25;228226;522093;1394;0;0;33826877;18539593;77525;25;8
FR;0;2021-06-26;153129;370649;581;1;0;33980006;18910242;78106;26;8
FR;0;2021-06-27;55839;156304;165;1;0;34035845;19066546;78271;27;8
FR;0;2021-06-28;154544;453046;1160;0;0;34190389;19519592;79431;27;8
FR;0;2021-06-29;182490;506404;2120;0;0;34372879;20025996;81551;27;8
FR;0;2021-06-30;203803;481455;2005;21;2;34576682;20507451;83556;48;10
FR;0;2021-07-01;231819;457681;2220;5;1;34808501;20965132;85776;53;11
FR;0;2021-07-02;228155;520202;2115;5;3;35036656;21485334;87891;58;14
FR;0;2021-07-03;141958;368705;908;3;1;35178614;21854039;88799;61;15
FR;0;2021-07-04;56693;141267;265;0;0;35235307;21995306;89064;61;15
FR;0;2021-07-05;168460;419342;1665;8;2;35403767;22414648;90729;69;17
FR;0;2021-07-06;196740;474812;1823;43;8;35600507;22889460;92552;112;25
FR;0;2021-07-07;213453;439297;1873;23;5;35813960;23328757;94425;135;30
FR;0;2021-07-08;231475;424128;2088;20;9;36045435;23752885;96513;155;39
FR;0;2021-07-09;228339;510235;2183;4;3;36273774;24263120;98696;159;42
FR;0;2021-07-10;148511;339817;982;1;1;36422285;24602937;99678;160;43
FR;0;2021-07-11;60093;110118;281;0;0;36482378;24713055;99959;160;43
FR;0;2021-07-12;168987;478169;1750;4;0;36651365;25191224;101709;164;43
FR;0;2021-07-13;287149;527481;2043;6;2;36938514;25718705;103752;170;45
FR;0;2021-07-14;180833;157800;432;0;0;37119347;25876505;104184;170;45
FR;0;2021-07-15;346868;502540;2093;1;0;37466215;26379045;106277;171;45
FR;0;2021-07-16;379829;496075;2020;3;1;37846044;26875120;108297;174;46
FR;0;2021-07-17;259664;319823;874;1;0;38105708;27194943;109171;175;46
FR;0;2021-07-18;109679;114841;310;0;0;38215387;27309784;109481;175;46
FR;0;2021-07-19;285344;425339;1625;3;0;38500731;27735123;111106;178;46
FR;0;2021-07-20;376802;452703;1719;0;0;38877533;28187826;112825;178;46
FR;0;2021-07-21;395602;408156;1547;4;2;39273135;28595982;114372;182;48
FR;0;2021-07-22;440717;388449;1708;4;2;39713852;28984431;116080;186;50
FR;0;2021-07-23;438422;423234;1874;4;2;40152274;29407665;117954;190;52
FR;0;2021-07-24;285161;269725;802;1;0;40437435;29677390;118756;191;52
FR;0;2021-07-25;121031;80091;225;0;0;40558466;29757481;118981;191;52
FR;0;2021-07-26;347209;323534;1613;3;2;40905675;30081015;120594;194;54
FR;0;2021-07-27;463846;320542;1697;4;2;41369521;30401557;122291;198;56
FR;0;2021-07-28;459285;290266;1634;4;2;41828806;30691823;123925;202;58
FR;0;2021-07-29;489712;277185;1793;2;1;42318518;30969008;125718;204;59
FR;0;2021-07-30;461541;303046;1935;5;2;42780059;31272054;127653;209;61
FR;0;2021-07-31;285266;185025;911;1;0;43065325;31457079;128564;210;61
FR;0;2021-08-01;111949;49998;248;0;0;43177274;31507077;128812;210;61
FR;0;2021-08-02;341500;234601;1595;1;0;43518774;31741678;130407;211;61
FR;0;2021-08-03;398219;245244;1713;2;1;43916993;31986922;132120;213;62
FR;0;2021-08-04;384663;210212;1589;5;3;44301656;32197134;133709;218;65
FR;0;2021-08-05;365989;228927;1705;0;0;44667645;32426061;135414;218;65
FR;0;2021-08-06;359423;271877;1832;4;1;45027068;32697938;137246;222;66
FR;0;2021-08-07;212928;178365;755;4;3;45239996;32876303;138001;226;69
FR;0;2021-08-08;74046;63259;268;0;0;45314042;32939562;138269;226;69
FR;0;2021-08-09;258540;259835;1537;4;3;45572582;33199397;139806;230;72
FR;0;2021-08-10;306715;278449;1651;2;1;45879297;33477846;141457;232;73
FR;0;2021-08-11;279461;260503;1434;5;1;46158758;33738349;142891;237;74
FR;0;2021-08-12;271220;278619;1655;3;1;46429978;34016968;144546;240;75
FR;0;2021-08-13;251987;277689;1586;3;2;46681965;34294657;146132;243;77
FR;0;2021-08-14;145145;197393;739;0;0;46827110;34492050;146871;243;77
FR;0;2021-08-15;39208;50095;211;1;0;46866318;34542145;147082;244;77
FR;0;2021-08-16;185546;318295;1535;0;0;47051864;34860440;148617;244;77
FR;0;2021-08-17;215383;336759;1630;5;1;47267247;35197199;150247;249;78
FR;0;2021-08-18;198808;324953;1582;7;4;47466055;35522152;151829;256;82
FR;0;2021-08-19;191787;325557;1627;1;0;47657842;35847709;153456;257;82
FR;0;2021-08-20;186142;365569;1801;3;2;47843984;36213278;155257;260;84
FR;0;2021-08-21;104663;238165;700;0;0;47948647;36451443;155957;260;84
FR;0;2021-08-22;31861;87201;252;1;1;47980508;36538644;156209;261;85
FR;0;2021-08-23;140811;357282;1553;3;2;48121319;36895926;157762;264;87
FR;0;2021-08-24;162341;376956;1833;5;1;48283660;37272882;159595;269;88
FR;0;2021-08-25;150925;350909;2023;6;3;48434585;37623791;161618;275;91
FR;0;2021-08-26;142703;342786;2548;10;1;48577288;37966577;164166;285;92
FR;0;2021-08-27;148246;387613;2784;11;4;48725534;38354190;166950;296;96
FR;0;2021-08-28;90475;249477;1402;0;0;48816009;38603667;168352;296;96
FR;0;2021-08-29;27285;83289;507;1;0;48843294;38686956;168859;297;96
FR;0;2021-08-30;117095;324789;4703;6;6072;48960389;39011745;173562;303;6168
FR;0;2021-08-31;128605;334697;10152;17;11872;49088994;39346442;183714;320;18040
FR;0;2021-09-01;135214;285573;22392;7;24132;49224208;39632015;206106;327;42172
FR;0;2021-09-02;112754;247319;26472;13;28730;49336962;39879334;232578;340;70902
FR;0;2021-09-03;118240;292701;29923;24;32807;49455202;40172035;262501;364;103709
FR;0;2021-09-04;89517;217651;12572;12;13986;49544719;40389686;275073;376;117695
FR;0;2021-09-05;21331;44896;4380;2;4717;49566050;40434582;279453;378;122412
FR;0;2021-09-06;75176;180905;31921;16;34078;49641226;40615487;311374;394;156490
FR;0;2021-09-07;78733;181210;33220;39;35965;49719959;40796697;344594;433;192455
FR;0;2021-09-08;88845;206106;29630;26;32214;49808804;41002803;374224;459;224669
FR;0;2021-09-09;75814;165265;33000;26;36307;49884618;41168068;407224;485;260976
FR;0;2021-09-10;95227;203513;35678;25;40279;49979845;41371581;442902;510;301255
FR;0;2021-09-11;66162;169102;12115;17;14168;50046007;41540683;455017;527;315423
FR;0;2021-09-12;12698;32080;2760;2;3132;50058705;41572763;457777;529;318555
FR;0;2021-09-13;64299;126384;41146;32;43715;50123004;41699147;498923;561;362270
FR;0;2021-09-14;73202;129214;56261;80;61588;50196206;41828361;555184;641;423858
FR;0;2021-09-15;76431;167723;55569;58;54657;50272637;41996084;610753;699;478515
FR;0;2021-09-16;63760;114365;59964;86;59869;50336397;42110449;670717;785;538384
FR;0;2021-09-17;74950;156727;53768;71;57121;50411347;42267176;724485;856;595505
FR;0;2021-09-18;48106;139505;15586;25;17270;50459453;42406681;740071;881;612775
FR;0;2021-09-19;7841;23706;2427;2;2618;50467294;42430387;742498;883;615393
FR;0;2021-09-20;45269;93860;49964;76;50099;50512563;42524247;792462;959;665492
FR;0;2021-09-21;45715;98426;62645;78;63203;50558278;42622673;855107;1037;728695
FR;0;2021-09-22;48501;142000;55259;85;55185;50606779;42764673;910366;1122;783880
FR;0;2021-09-23;43094;91711;62286;95;63244;50649873;42856384;972652;1217;847124
FR;0;2021-09-24;52133;132610;54466;110;58961;50702006;42988994;1027118;1327;906085
FR;0;2021-09-25;35094;115288;16252;37;18216;50737100;43104282;1043370;1364;924301
FR;0;2021-09-26;5524;17823;2258;4;2342;50742624;43122105;1045628;1368;926643
FR;0;2021-09-27;33912;76917;47125;95;48056;50776536;43199022;1092753;1463;974699
FR;0;2021-09-28;36407;75211;54851;88;56341;50812943;43274233;1147604;1551;1031040
FR;0;2021-09-29;44209;100680;53242;111;54673;50857152;43374913;1200846;1662;1085713
FR;0;2021-09-30;36151;71573;56921;96;59315;50893303;43446486;1257767;1758;1145028
FR;0;2021-10-01;61665;100181;57729;108;63584;50954968;43546667;1315496;1866;1208612
FR;0;2021-10-02;38742;78136;20938;38;23266;50993710;43624803;1336434;1904;1231878
FR;0;2021-10-03;5229;10597;2516;4;2554;50998939;43635400;1338950;1908;1234432
FR;0;2021-10-04;34531;58332;52564;83;54729;51033470;43693732;1391514;1991;1289161
FR;0;2021-10-05;33236;64237;60891;135;64782;51066706;43757969;1452405;2126;1353943
FR;0;2021-10-06;42106;79033;65617;113;68103;51108812;43837002;1518022;2239;1422046
FR;0;2021-10-07;30249;61896;65316;90;68565;51139061;43898898;1583338;2329;1490611
FR;0;2021-10-08;48417;91579;77655;110;84480;51187478;43990477;1660993;2439;1575091
FR;0;2021-10-09;33441;60685;31492;35;33808;51220919;44051162;1692485;2474;1608899
FR;0;2021-10-10;4526;7343;3175;9;3461;51225445;44058505;1695660;2483;1612360
FR;0;2021-10-11;30401;49908;60974;105;63960;51255846;44108413;1756634;2588;1676320
FR;0;2021-10-12;31172;54388;70496;138;75693;51287018;44162801;1827130;2726;1752013
FR;0;2021-10-13;39879;62641;74362;135;79174;51326897;44225442;1901492;2861;1831187
FR;0;2021-10-14;30272;52659;68681;114;73634;51357169;44278101;1970173;2975;1904821
FR;0;2021-10-15;44592;74837;93176;188;102841;51401761;44352938;2063349;3163;2007662
FR;0;2021-10-16;31123;43958;36666;45;39574;51432884;44396896;2100015;3208;2047236
FR;0;2021-10-17;3807;5231;3585;2;3685;51436691;44402127;2103600;3210;2050921
FR;0;2021-10-18;27249;41174;67435;131;71272;51463940;44443301;2171035;3341;2122193
FR;0;2021-10-19;26896;43055;76338;140;81550;51490836;44486356;2247373;3481;2203743
FR;0;2021-10-20;35186;52191;96857;179;101348;51526022;44538547;2344230;3660;2305091
FR;0;2021-10-21;25795;45079;83863;113;89025;51551817;44583626;2428093;3773;2394116
FR;0;2021-10-22;38151;62020;104804;198;112375;51589968;44645646;2532897;3971;2506491
FR;0;2021-10-23;26828;40565;45412;57;48569;51616796;44686211;2578309;4028;2555060
FR;0;2021-10-24;2901;4783;3675;6;3943;51619697;44690994;2581984;4034;2559003
FR;0;2021-10-25;25924;36179;82253;144;86542;51645621;44727173;2664237;4178;2645545
FR;0;2021-10-26;23619;34926;87153;166;92214;51669240;44762099;2751390;4344;2737759
FR;0;2021-10-27;29913;46235;108906;258;114538;51699153;44808334;2860296;4602;2852297
FR;0;2021-10-28;23258;34674;88617;153;94289;51722411;44843008;2948913;4755;2946586
FR;0;2021-10-29;31426;50886;117220;205;125129;51753837;44893894;3066133;4960;3071715
FR;0;2021-10-30;20325;32952;50294;78;53314;51774162;44926846;3116427;5038;3125029
FR;0;2021-10-31;2487;3809;3576;3;3871;51776649;44930655;3120003;5041;3128900
FR;0;2021-11-01;7639;4415;3184;3;3517;51784288;44935070;3123187;5044;3132417
FR;0;2021-11-02;24929;39865;93486;155;99366;51809217;44974935;3216673;5199;3231783
FR;0;2021-11-03;29494;47554;118789;218;125666;51838711;45022489;3335462;5417;3357449
FR;0;2021-11-04;23537;37358;107435;217;114231;51862248;45059847;3442897;5634;3471680
FR;0;2021-11-05;32168;52617;141522;233;151131;51894416;45112464;3584419;5867;3622811
FR;0;2021-11-06;21348;34444;64815;123;68168;51915764;45146908;3649234;5990;3690979
FR;0;2021-11-07;2358;4297;5160;6;5590;51918122;45151205;3654394;5996;3696569
FR;0;2021-11-08;20188;37726;127079;225;134078;51938310;45188931;3781473;6221;3830647
FR;0;2021-11-09;21951;44716;161552;342;171990;51960261;45233647;3943025;6563;4002637
FR;0;2021-11-10;31111;54621;186867;443;198496;51991372;45288268;4129892;7006;4201133
FR;0;2021-11-11;3969;6336;12888;28;13865;51995341;45294604;4142780;7034;4214998
FR;0;2021-11-12;28923;54919;183656;248;197123;52024264;45349523;4326436;7282;4412121
FR;0;2021-11-13;20151;32591;80644;117;86241;52044415;45382114;4407080;7399;4498362
FR;0;2021-11-14;2299;3985;7151;6;7873;52046714;45386099;4414231;7405;4506235
FR;0;2021-11-15;20166;38664;160700;312;171346;52066880;45424763;4574931;7717;4677581
FR;0;2021-11-16;23149;43832;200228;389;214688;52090029;45468595;4775159;8106;4892269
FR;0;2021-11-17;30197;50300;199726;406;212709;52120226;45518895;4974885;8512;5104978
FR;0;2021-11-18;23200;43768;191511;468;205272;52143426;45562663;5166396;8980;5310250
FR;0;2021-11-19;33568;61283;243045;547;261910;52176994;45623946;5409441;9527;5572160
FR;0;2021-11-20;25201;36570;102078;205;109591;52202195;45660516;5511519;9732;5681751
FR;0;2021-11-21;2604;4609;9625;18;10651;52204799;45665125;5521144;9750;5692402
FR;0;2021-11-22;22671;33222;180211;470;194641;52227470;45698347;5701355;10220;5887043
FR;0;2021-11-23;25426;45480;229217;547;247551;52252896;45743827;5930572;10767;6134594
FR;0;2021-11-24;31696;53536;224686;716;243013;52284592;45797363;6155258;11483;6377607
FR;0;2021-11-25;25315;48723;255761;740;277411;52309907;45846086;6411019;12223;6655018
FR;0;2021-11-26;33097;74559;379288;865;414408;52343004;45920645;6790307;13088;7069426
FR;0;2021-11-27;23154;49347;214801;388;236508;52366158;45969992;7005108;13476;7305934
FR;0;2021-11-28;3475;10610;56705;65;63345;52369633;45980602;7061813;13541;7369279
FR;0;2021-11-29;19311;54045;341306;864;371374;52388944;46034647;7403119;14405;7740653
FR;0;2021-11-30;24385;71806;457177;985;500494;52413329;46106453;7860296;15390;8241147
FR;0;2021-12-01;26391;75638;468868;1158;510995;52439720;46182091;8329164;16548;8752142
FR;0;2021-12-02;21797;71557;526906;1274;574554;52461517;46253648;8856070;17822;9326696
FR;0;2021-12-03;25458;92283;596141;1415;650770;52486975;46345931;9452211;19237;9977466
FR;0;2021-12-04;18249;60391;336103;690;369587;52505224;46406322;9788314;19927;10347053
FR;0;2021-12-05;4137;16310;95738;156;107074;52509361;46422632;9884052;20083;10454127
FR;0;2021-12-06;19193;72786;492947;1171;539710;52528554;46495418;10376999;21254;10993837
FR;0;2021-12-07;23242;91659;645110;1765;705925;52551796;46587077;11022109;23019;11699762
FR;0;2021-12-08;25185;91970;591361;1871;647233;52576981;46679047;11613470;24890;12346995
FR;0;2021-12-09;23910;94039;662824;2179;725981;52600891;46773086;12276294;27069;13072976
FR;0;2021-12-10;27164;110946;735801;2071;805792;52628055;46884032;13012095;29140;13878768
FR;0;2021-12-11;20224;75881;435072;982;480252;52648279;46959913;13447167;30122;14359020
FR;0;2021-12-12;5603;23185;142232;261;159225;52653882;46983098;13589399;30383;14518245
FR;0;2021-12-13;21011;91085;587419;1697;649098;52674893;47074183;14176818;32080;15167343
FR;0;2021-12-14;26955;118408;765252;2641;847197;52701848;47192591;14942070;34721;16014540
FR;0;2021-12-15;28073;114135;694070;2262;768777;52729921;47306726;15636140;36983;16783317
FR;0;2021-12-16;27874;115884;763819;2555;844223;52757795;47422610;16399959;39538;17627540
FR;0;2021-12-17;31470;128654;807652;2709;891860;52789265;47551264;17207611;42247;18519400
FR;0;2021-12-18;24910;81610;469899;1178;522143;52814175;47632874;17677510;43425;19041543
FR;0;2021-12-19;8740;28963;169382;378;191266;52822915;47661837;17846892;43803;19232809
FR;0;2021-12-20;31657;97385;591459;1786;658753;52854572;47759222;18438351;45589;19891562
FR;0;2021-12-21;39164;112165;682278;2390;759428;52893736;47871387;19120629;47979;20650990
FR;0;2021-12-22;39414;99442;575570;2164;641985;52933150;47970829;19696199;50143;21292975
FR;0;2021-12-23;33663;79619;441131;1647;494565;52966813;48050448;20137330;51790;21787540
FR;0;2021-12-24;10626;26065;111027;395;126736;52977439;48076513;20248357;52185;21914276
FR;0;2021-12-25;759;3478;7597;25;9079;52978198;48079991;20255954;52210;21923355
FR;0;2021-12-26;4697;11893;52080;133;60141;52982895;48091884;20308034;52343;21983496
FR;0;2021-12-27;30260;83744;453575;1365;509184;53013155;48175628;20761609;53708;22492680
FR;0;2021-12-28;38261;98869;564183;1763;632253;53051416;48274497;21325792;55471;23124933
FR;0;2021-12-29;39817;88306;501169;1687;560997;53091233;48362803;21826961;57158;23685930
FR;0;2021-12-30;35839;74734;421033;1519;471162;53127072;48437537;22247994;58677;24157092
FR;0;2021-12-31;11824;25032;116963;405;131726;53138896;48462569;22364957;59082;24288818
FR;0;2022-01-01;1221;3201;8535;37;9958;53140117;48465770;22373492;59119;24298776
FR;0;2022-01-02;6063;13007;58470;124;67026;53146180;48478777;22431962;59243;24365802
FR;0;2022-01-03;31490;87340;495955;1592;552535;53177670;48566117;22927917;60835;24918337
FR;0;2022-01-04;40522;110437;641809;2303;714687;53218192;48676554;23569726;63138;25633024
FR;0;2022-01-05;59562;102807;569941;1980;634894;53277754;48779361;24139667;65118;26267918
FR;0;2022-01-06;43769;109927;639549;2687;711970;53321523;48889288;24779216;67805;26979888
FR;0;2022-01-07;50409;122667;711940;2808;791318;53371932;49011955;25491156;70613;27771206
FR;0;2022-01-08;44870;80290;423899;1207;472960;53416802;49092245;25915055;71820;28244166
FR;0;2022-01-09;15595;26819;128584;298;145768;53432397;49119064;26043639;72118;28389934
FR;0;2022-01-10;34812;86190;471619;1809;524467;53467209;49205254;26515258;73927;28914401
FR;0;2022-01-11;41505;99659;549097;2300;609335;53508714;49304913;27064355;76227;29523736
FR;0;2022-01-12;59970;94974;453517;1962;505157;53568684;49399887;27517872;78189;30028893
FR;0;2022-01-13;37756;91996;488077;2078;541722;53606440;49491883;28005949;80267;30570615
FR;0;2022-01-14;42240;103183;569841;2282;630318;53648680;49595066;28575790;82549;31200933
FR;0;2022-01-15;39265;65906;340362;975;377820;53687945;49660972;28916152;83524;31578753
FR;0;2022-01-16;11378;20727;87415;213;99506;53699323;49681699;29003567;83737;31678259
FR;0;2022-01-17;24536;62118;322191;1376;356127;53723859;49743817;29325758;85113;32034386
FR;0;2022-01-18;28056;70232;362112;1796;398624;53751915;49814049;29687870;86909;32433010
FR;0;2022-01-19;42938;68769;282293;1448;312124;53794853;49882818;29970163;88357;32745134
FR;0;2022-01-20;23326;61212;300272;1737;329771;53818179;49944030;30270435;90094;33074905
FR;0;2022-01-21;27918;70356;368041;2076;402886;53846097;50014386;30638476;92170;33477791
FR;0;2022-01-22;27580;47786;219122;838;242100;53873677;50062172;30857598;93008;33719891
FR;0;2022-01-23;6693;13874;48679;171;55236;53880370;50076046;30906277;93179;33775127
FR;0;2022-01-24;16172;49443;218572;1132;240670;53896542;50125489;31124849;94311;34015797
FR;0;2022-01-25;18875;56234;243889;1542;267968;53915417;50181723;31368738;95853;34283765
FR;0;2022-01-26;28060;61274;209885;1290;229985;53943477;50242997;31578623;97143;34513750
FR;0;2022-01-27;16240;47648;208212;1261;226433;53959717;50290645;31786835;98404;34740183
FR;0;2022-01-28;21436;77354;290701;1573;322206;53981153;50367999;32077536;99977;35062389
FR;0;2022-01-29;18382;54687;184344;683;204857;53999535;50422686;32261880;100660;35267246
FR;0;2022-01-30;4457;15682;39127;121;45111;54003992;50438368;32301007;100781;35312357
FR;0;2022-01-31;11179;44054;148350;738;165004;54015171;50482422;32449357;101519;35477361
FR;0;2022-02-01;12514;48731;174578;1132;191831;54027685;50531153;32623935;102651;35669192
FR;0;2022-02-02;19629;66586;171735;1015;190378;54047314;50597739;32795670;103666;35859570
FR;0;2022-02-03;10855;45412;157465;971;173256;54058169;50643151;32953135;104637;36032826
FR;0;2022-02-04;14415;68159;239131;1258;264150;54072584;50711310;33192266;105895;36296976
FR;0;2022-02-05;12554;52958;153501;522;172330;54085138;50764268;33345767;106417;36469306
FR;0;2022-02-06;2698;13264;28863;98;33837;54087836;50777532;33374630;106515;36503143
FR;0;2022-02-07;9168;47201;156767;581;176270;54097004;50824733;33531397;107096;36679413
FR;0;2022-02-08;9464;42434;166495;862;184234;54106468;50867167;33697892;107958;36863647
FR;0;2022-02-09;14045;57441;172219;860;192849;54120513;50924608;33870111;108818;37056496
FR;0;2022-02-10;8165;37832;149985;870;166362;54128678;50962440;34020096;109688;37222858
FR;0;2022-02-11;10673;55217;218257;1090;242807;54139351;51017657;34238353;110778;37465665
FR;0;2022-02-12;8275;40796;134603;460;151604;54147626;51058453;34372956;111238;37617269
FR;0;2022-02-13;1872;8549;26499;81;30855;54149498;51067002;34399455;111319;37648124
FR;0;2022-02-14;6818;34974;148148;479;166130;54156316;51101976;34547603;111798;37814254
FR;0;2022-02-15;6780;35203;146570;747;162079;54163096;51137179;34694173;112545;37976333
FR;0;2022-02-16;9201;42251;132218;715;146374;54172297;51179430;34826391;113260;38122707
FR;0;2022-02-17;5283;23371;87030;578;94519;54177580;51202801;34913421;113838;38217226
FR;0;2022-02-18;6791;32987;119247;799;128856;54184371;51235788;35032668;114637;38346082
FR;0;2022-02-19;5270;24351;69787;367;77062;54189641;51260139;35102455;115004;38423144
FR;0;2022-02-20;1111;4581;12094;38;13859;54190752;51264720;35114549;115042;38437003
FR;0;2022-02-21;3931;17655;61458;351;66672;54194683;51282375;35176007;115393;38503675
FR;0;2022-02-22;4276;18328;60434;563;64021;54198959;51300703;35236441;115956;38567696
FR;0;2022-02-23;6443;26894;66118;589;71473;54205402;51327597;35302559;116545;38639169
FR;0;2022-02-24;3659;14841;49994;512;52771;54209061;51342438;35352553;117057;38691940
FR;0;2022-02-25;5100;23246;75822;793;79517;54214161;51365684;35428375;117850;38771457
FR;0;2022-02-26;3921;17418;47184;351;51247;54218082;51383102;35475559;118201;38822704
FR;0;2022-02-27;851;2960;7959;45;8862;54218933;51386062;35483518;118246;38831566
FR;0;2022-02-28;3008;11917;40094;348;42510;54221941;51397979;35523612;118594;38874076
FR;0;2022-03-01;2900;11680;40956;413;41593;54224841;51409659;35564568;119007;38915669
FR;0;2022-03-02;4921;17115;45080;428;47012;54229762;51426774;35609648;119435;38962681
FR;0;2022-03-03;2536;8424;28191;334;28260;54232298;51435198;35637839;119769;38990941
FR;0;2022-03-04;3070;11810;38670;632;37782;54235368;51447008;35676509;120401;39028723
FR;0;2022-03-05;2831;9036;24313;297;24454;54238199;51456044;35700822;120698;39053177
FR;0;2022-03-06;486;1328;3075;43;3300;54238685;51457372;35703897;120741;39056477
FR;0;2022-03-07;1832;5171;16723;297;15968;54240517;51462543;35720620;121038;39072445
FR;0;2022-03-08;1864;5513;18170;332;16628;54242381;51468056;35738790;121370;39089073
FR;0;2022-03-09;3301;9840;20440;371;19541;54245682;51477896;35759230;121741;39108614
FR;0;2022-03-10;1506;4424;13917;297;12760;54247188;51482320;35773147;122038;39121374
